單字	序號	部首	筆劃	頻次	頻率	累積頻次	累積頻率	見檔次	見檔率
的	1		8	29825	4.534%	29825	4.534%	319	99.69%
一	2		1	11054	1.680%	40879	6.214%	319	99.69%
是	3		9	9755	1.483%	50634	7.697%	319	99.69%
不	4		4	8359	1.271%	58993	8.968%	317	99.06%
人	5		2	7107	1.080%	66100	10.05%	319	99.69%
在	6		6	6931	1.054%	73031	11.10%	319	99.69%
有	7		6	6530	0.9927%	79561	12.09%	317	99.06%
我	8		7	6420	0.976%	85981	13.07%	297	92.81%
了	9		2	4841	0.7359%	90822	13.81%	316	98.75%
中	10		4	4525	0.6879%	95347	14.49%	317	99.06%
國	11		11	3927	0.597%	99274	15.09%	264	82.50%
這	12		10	3820	0.5807%	103094	15.67%	314	98.13%
為	13		9	3791	0.5763%	106885	16.25%	314	98.13%
以	14		5	3512	0.5339%	110397	16.78%	312	97.50%
來	15		8	3449	0.5243%	113846	17.31%	316	98.75%
大	16		3	3421	0.5201%	117267	17.83%	315	98.44%
之	17		4	3364	0.5114%	120631	18.34%	301	94.06%
生	18		5	3341	0.5079%	123972	18.85%	305	95.31%
個	19		10	3311	0.5033%	127283	19.35%	312	97.50%
他	20		5	3307	0.5027%	130590	19.85%	296	92.50%
上	21		3	3244	0.4931%	133834	20.35%	317	99.06%
而	22		6	3087	0.4693%	136921	20.81%	310	96.88%
會	23		13	3027	0.4602%	139948	21.27%	303	94.69%
們	24		10	2942	0.4472%	142890	21.72%	289	90.31%
也	25		3	2934	0.446%	145824	22.17%	310	96.88%
時	26		10	2907	0.4419%	148731	22.61%	307	95.94%
到	27		8	2724	0.4141%	151455	23.02%	315	98.44%
可	28		5	2561	0.3893%	154016	23.41%	308	96.25%
年	29		6	2513	0.382%	156529	23.80%	299	93.44%
自	30		6	2497	0.3796%	159026	24.17%	300	93.75%
地	31		6	2411	0.3665%	161437	24.54%	295	92.19%
要	32		9	2382	0.3621%	163819	24.90%	303	94.69%
對	33		14	2371	0.3604%	166190	25.26%	301	94.06%
與	34		14	2362	0.3591%	168552	25.62%	284	88.75%
能	35		10	2354	0.3579%	170906	25.98%	295	92.19%
那	36		6	2240	0.3405%	173146	26.32%	269	84.06%
就	37		12	2164	0.329%	175310	26.65%	307	95.94%
於	38		8	2124	0.3229%	177434	26.97%	307	95.94%
出	39		5	2113	0.3212%	179547	27.29%	305	95.31%
子	40		3	2103	0.3197%	181650	27.61%	272	85.00%
說	41		14	2093	0.3182%	183743	27.93%	295	92.19%
家	42		10	2055	0.3124%	185798	28.24%	288	90.00%
然	43		12	2050	0.3116%	187848	28.56%	297	92.81%
成	44		6	2045	0.3109%	189893	28.87%	305	95.31%
著	45		12	2034	0.3092%	191927	29.18%	278	86.88%
如	46		6	2026	0.308%	193953	29.48%	297	92.81%
過	47		12	2026	0.308%	195979	29.79%	314	98.13%
得	48		11	2000	0.304%	197979	30.10%	305	95.31%
心	49		4	1979	0.3008%	199958	30.40%	295	92.19%
下	50		3	1877	0.2853%	201835	30.68%	305	95.31%
多	51		6	1877	0.2853%	203712	30.97%	301	94.06%
作	52		7	1863	0.2832%	205575	31.25%	271	84.69%
和	53		8	1858	0.2825%	207433	31.53%	285	89.06%
所	54		8	1820	0.2767%	209253	31.81%	294	91.88%
後	55		9	1803	0.2741%	211056	32.08%	305	95.31%
十	56		2	1799	0.2735%	212855	32.36%	274	85.63%
天	57		4	1738	0.2642%	214593	32.62%	276	86.25%
無	58		12	1730	0.263%	216323	32.89%	298	93.13%
都	59		9	1710	0.260%	218033	33.15%	300	93.75%
情	60		11	1708	0.2596%	219741	33.40%	276	86.25%
民	61		5	1697	0.258%	221438	33.66%	211	65.94%
學	62		16	1690	0.2569%	223128	33.92%	243	75.94%
小	63		3	1674	0.2545%	224802	34.17%	270	84.38%
現	64		11	1572	0.239%	226374	34.41%	293	91.56%
政	65		9	1534	0.2332%	227908	34.65%	161	50.31%
因	66		6	1518	0.2308%	229426	34.88%	287	89.69%
此	67		6	1508	0.2292%	230934	35.11%	280	87.50%
當	68		13	1490	0.2265%	232424	35.33%	296	92.50%
事	69		8	1485	0.2257%	233909	35.56%	287	89.69%
前	70		9	1479	0.2248%	235388	35.78%	296	92.50%
去	71		5	1478	0.2247%	236866	36.01%	291	90.94%
種	72		14	1467	0.223%	238333	36.23%	276	86.25%
其	73		8	1450	0.2204%	239783	36.45%	274	85.63%
行	74		6	1443	0.2194%	241226	36.67%	276	86.25%
意	75		13	1441	0.2191%	242667	36.89%	289	90.31%
方	76		4	1416	0.2153%	244083	37.11%	279	87.19%
文	77		4	1411	0.2145%	245494	37.32%	231	72.19%
日	78		4	1402	0.2131%	246896	37.53%	282	88.13%
好	79		6	1394	0.2119%	248290	37.74%	273	85.31%
實	80		14	1387	0.2109%	249677	37.96%	288	90.00%
但	81		7	1365	0.2075%	251042	38.16%	292	91.25%
想	82		13	1364	0.2074%	252406	38.37%	277	86.56%
發	83		12	1363	0.2072%	253769	38.58%	289	90.31%
經	84		13	1361	0.2069%	255130	38.78%	286	89.38%
性	85		8	1345	0.2045%	256475	38.99%	228	71.25%
者	86		8	1345	0.2045%	257820	39.19%	255	79.69%
分	87		4	1328	0.2019%	259148	39.40%	281	87.81%
看	88		9	1310	0.1991%	260458	39.59%	269	84.06%
三	89		3	1309	0.199%	261767	39.79%	268	83.75%
麼	90		14	1304	0.1982%	263071	39.99%	260	81.25%
法	91		8	1300	0.1976%	264371	40.19%	257	80.31%
美	92		9	1271	0.1932%	265642	40.38%	242	75.63%
起	93		10	1248	0.1897%	266890	40.57%	278	86.88%
只	94		5	1244	0.1891%	268134	40.76%	284	88.75%
用	95		5	1242	0.1888%	269376	40.95%	269	84.06%
最	96		12	1236	0.1879%	270612	41.14%	281	87.81%
她	97		6	1227	0.1865%	271839	41.32%	136	42.50%
外	98		5	1226	0.1864%	273065	41.51%	275	85.94%
本	99		5	1219	0.1853%	274284	41.70%	260	81.25%
長	100		8	1217	0.185%	275501	41.88%	265	82.81%
同	101		6	1214	0.1846%	276715	42.07%	282	88.13%
你	102		7	1201	0.1826%	277916	42.25%	180	56.25%
開	103		12	1186	0.1803%	279102	42.43%	285	89.06%
理	104		11	1185	0.1801%	280287	42.61%	266	83.13%
主	105		5	1177	0.1789%	281464	42.79%	231	72.19%
已	106		3	1176	0.1788%	282640	42.97%	284	88.75%
沒	107		7	1167	0.1774%	283807	43.14%	259	80.94%
面	108		9	1163	0.1768%	284970	43.32%	279	87.19%
代	109		5	1136	0.1727%	286106	43.49%	246	76.88%
動	110		11	1121	0.1704%	287227	43.66%	271	84.69%
間	111		12	1120	0.1703%	288347	43.83%	277	86.56%
及	112		4	1114	0.1693%	289461	44.00%	223	69.69%
力	113		2	1108	0.1684%	290569	44.17%	255	79.69%
些	114		8	1086	0.1651%	291655	44.34%	271	84.69%
二	115		2	1073	0.1631%	292728	44.50%	253	79.06%
重	116		9	1070	0.1627%	293798	44.66%	277	86.56%
由	117		5	1054	0.1602%	294852	44.82%	252	78.75%
定	118		8	1051	0.1598%	295903	44.98%	257	80.31%
道	119		12	1049	0.1595%	296952	45.14%	267	83.44%
還	120		16	1044	0.1587%	297996	45.30%	268	83.75%
新	121		13	1041	0.1583%	299037	45.46%	241	75.31%
裏	122		13	1033	0.157%	300070	45.62%	166	51.88%
樣	123		15	1012	0.1538%	301082	45.77%	257	80.31%
高	124		10	1006	0.1529%	302088	45.92%	263	82.19%
化	125		4	1002	0.1523%	303090	46.08%	232	72.50%
女	126		3	1002	0.1523%	304092	46.23%	172	53.75%
又	127		2	994	0.1511%	305086	46.38%	262	81.88%
共	128		6	989	0.1503%	306075	46.53%	173	54.06%
己	129		3	987	0.150%	307062	46.68%	223	69.69%
進	130		11	987	0.150%	308049	46.83%	262	81.88%
從	131		11	980	0.149%	309029	46.98%	273	85.31%
或	132		8	976	0.1484%	310005	47.13%	252	78.75%
愛	133		13	975	0.1482%	310980	47.27%	196	61.25%
使	134		8	966	0.1469%	311946	47.42%	256	80.00%
公	135		4	951	0.1446%	312897	47.57%	218	68.13%
感	136		13	946	0.1438%	313843	47.71%	239	74.69%
正	137		5	945	0.1437%	314788	47.85%	269	84.06%
關	138		19	944	0.1435%	315732	48.00%	243	75.94%
世	139		5	932	0.1417%	316664	48.14%	242	75.63%
相	140		9	930	0.1414%	317594	48.28%	262	81.88%
知	141		8	929	0.1412%	318523	48.42%	264	82.50%
更	142		7	923	0.1403%	319446	48.56%	262	81.88%
等	143		12	920	0.1399%	320366	48.70%	251	78.44%
明	144		8	918	0.1396%	321284	48.84%	263	82.19%
全	145		6	911	0.1385%	322195	48.98%	248	77.50%
常	146		11	901	0.137%	323096	49.12%	234	73.13%
問	147		11	896	0.1362%	323992	49.25%	246	76.88%
立	148		5	886	0.1347%	324878	49.39%	219	68.44%
社	149		7	885	0.1345%	325763	49.52%	189	59.06%
應	150		17	884	0.1344%	326647	49.66%	239	74.69%
兩	151		8	879	0.1336%	327526	49.79%	261	81.56%
老	152		6	875	0.133%	328401	49.92%	190	59.38%
體	153		23	873	0.1327%	329274	50.06%	233	72.81%
很	154		9	866	0.1316%	330140	50.19%	238	74.38%
教	155		11	852	0.1295%	330992	50.32%	182	56.88%
活	156		9	847	0.1288%	331839	50.45%	230	71.88%
何	157		7	846	0.1286%	332685	50.57%	244	76.25%
卻	158		9	844	0.1283%	333529	50.70%	259	80.94%
書	159		10	844	0.1283%	334373	50.83%	181	56.56%
物	160		8	834	0.1268%	335207	50.96%	216	67.50%
工	161		3	824	0.1253%	336031	51.08%	183	57.19%
並	162		8	815	0.1239%	336846	51.21%	240	75.00%
再	163		6	810	0.1231%	337656	51.33%	267	83.44%
四	164		5	808	0.1228%	338464	51.45%	223	69.69%
表	165		8	801	0.1218%	339265	51.57%	223	69.69%
身	166		7	795	0.1209%	340060	51.70%	238	74.38%
將	167		11	784	0.1192%	340844	51.81%	224	70.00%
果	168		8	784	0.1192%	341628	51.93%	247	77.19%
點	169		17	781	0.1187%	342409	52.05%	251	78.44%
才	170		3	779	0.1184%	343188	52.17%	255	79.69%
真	171		10	773	0.1175%	343961	52.29%	247	77.19%
內	172		4	772	0.1174%	344733	52.41%	234	73.13%
黨	173		20	770	0.1171%	345503	52.52%	64	20.00%
把	174		7	769	0.1169%	346272	52.64%	224	70.00%
度	175		9	764	0.1161%	347036	52.76%	232	72.50%
頭	176		16	763	0.116%	347799	52.87%	236	73.75%
回	177		6	760	0.1155%	348559	52.99%	231	72.19%
向	178		6	753	0.1145%	349312	53.10%	235	73.44%
至	179		6	753	0.1145%	350065	53.22%	248	77.50%
走	180		7	752	0.1143%	350817	53.33%	207	64.69%
受	181		8	741	0.1126%	351558	53.44%	237	74.06%
風	182		9	741	0.1126%	352299	53.56%	219	68.44%
像	183		14	740	0.1125%	353039	53.67%	224	70.00%
什	184		4	733	0.1114%	353772	53.78%	218	68.13%
臺	185		14	733	0.1114%	354505	53.89%	147	45.94%
合	186		6	729	0.1108%	355234	54.00%	208	65.00%
見	187		7	729	0.1108%	355963	54.11%	249	77.81%
水	188		4	724	0.1101%	356687	54.22%	202	63.13%
業	189		13	723	0.1099%	357410	54.33%	175	54.69%
次	190		6	723	0.1099%	358133	54.44%	238	74.38%
界	191		9	717	0.109%	358850	54.55%	219	68.44%
許	192		11	716	0.1088%	359566	54.66%	230	71.88%
少	193		4	715	0.1087%	360281	54.77%	233	72.81%
統	194		11	713	0.1084%	360994	54.88%	162	50.63%
總	195		17	713	0.1084%	361707	54.99%	214	66.88%
題	196		18	713	0.1084%	362420	55.09%	200	62.50%
位	197		7	710	0.1079%	363130	55.20%	222	69.38%
五	198		4	709	0.1078%	363839	55.31%	201	62.81%
月	199		4	707	0.1075%	364546	55.42%	201	62.81%
台	200		5	706	0.1073%	365252	55.53%	94	29.38%
手	201		4	703	0.1069%	365955	55.63%	211	65.94%
幾	202		12	696	0.1058%	366651	55.74%	237	74.06%
被	203		10	681	0.1035%	367332	55.84%	227	70.94%
名	204		6	680	0.1034%	368012	55.94%	213	66.56%
平	205		5	678	0.1031%	368690	56.05%	225	70.31%
處	206		11	678	0.1031%	369368	56.15%	241	75.31%
山	207		3	670	0.1019%	370038	56.25%	159	49.69%
必	208		5	669	0.1017%	370707	56.35%	233	72.81%
觀	209		25	666	0.1012%	371373	56.46%	194	60.63%
選	210		15	664	0.1009%	372037	56.56%	131	40.94%
光	211		6	663	0.1008%	372700	56.66%	211	65.94%
命	212		8	663	0.1008%	373363	56.76%	193	60.31%
九	213		2	661	0.1005%	374024	56.86%	166	51.88%
言	214		7	660	0.1003%	374684	56.96%	207	64.69%
安	215		6	658	0.100%	375342	57.06%	194	60.63%
加	216		5	655	0.09957%	375997	57.16%	213	66.56%
目	217		5	655	0.09957%	376652	57.26%	220	68.75%
提	218		12	654	0.09942%	377306	57.36%	207	64.69%
結	219		12	652	0.09912%	377958	57.46%	233	72.81%
它	220		5	651	0.09896%	378609	57.56%	183	57.19%
員	221		10	649	0.09866%	379258	57.65%	133	41.56%
部	222		10	649	0.09866%	379907	57.75%	196	61.25%
花	223		8	647	0.09836%	380554	57.85%	175	54.69%
每	224		7	646	0.0982%	381200	57.95%	198	61.88%
太	225		4	645	0.09805%	381845	58.05%	213	66.56%
路	226		13	639	0.09714%	382484	58.14%	194	60.63%
治	227		8	638	0.09699%	383122	58.24%	149	46.56%
則	228		9	637	0.09684%	383759	58.34%	212	66.25%
任	229		6	634	0.09638%	384393	58.43%	205	64.06%
機	230		16	633	0.09623%	385026	58.53%	207	64.69%
先	231		6	632	0.09608%	385658	58.63%	212	66.25%
灣	232		25	632	0.09608%	386290	58.72%	154	48.13%
望	233		11	630	0.09577%	386920	58.82%	221	69.06%
便	234		9	628	0.09547%	387548	58.91%	188	58.75%
親	235		16	628	0.09547%	388176	59.01%	161	50.31%
入	236		2	626	0.09516%	388802	59.11%	241	75.31%
義	237		13	626	0.09516%	389428	59.20%	170	53.13%
變	238		23	623	0.09471%	390051	59.30%	228	71.25%
話	239		13	619	0.0941%	390670	59.39%	206	64.38%
流	240		9	618	0.09395%	391288	59.48%	205	64.06%
解	241		13	615	0.09349%	391903	59.58%	216	67.50%
白	242		5	614	0.09334%	392517	59.67%	191	59.69%
各	243		6	610	0.09273%	393127	59.76%	191	59.69%
聲	244		17	606	0.09212%	393733	59.85%	186	58.13%
論	245		15	603	0.09167%	394336	59.95%	196	61.25%
認	246		14	601	0.09136%	394937	60.04%	199	62.19%
場	247		12	599	0.09106%	395536	60.13%	200	62.50%
難	248		19	597	0.09076%	396133	60.22%	233	72.81%
今	249		4	588	0.08939%	396721	60.31%	224	70.00%
交	250		6	587	0.08924%	397308	60.40%	171	53.44%
視	251		12	587	0.08924%	397895	60.49%	206	64.38%
建	252		9	584	0.08878%	398479	60.58%	153	47.81%
未	253		5	581	0.08832%	399060	60.66%	212	66.25%
百	254		6	581	0.08832%	399641	60.75%	185	57.81%
利	255		7	578	0.08787%	400219	60.84%	187	58.44%
做	256		11	576	0.08756%	400795	60.93%	206	64.38%
原	257		10	576	0.08756%	401371	61.02%	223	69.69%
期	258		12	576	0.08756%	401947	61.10%	205	64.06%
第	259		11	576	0.08756%	402523	61.19%	195	60.94%
車	260		7	576	0.08756%	403099	61.28%	132	41.25%
色	261		6	573	0.08711%	403672	61.37%	198	61.88%
詩	262		13	571	0.0868%	404243	61.45%	76	23.75%
氣	263		10	568	0.08635%	404811	61.54%	224	70.00%
放	264		8	566	0.08604%	405377	61.62%	195	60.94%
形	265		7	563	0.08559%	405940	61.71%	193	60.31%
權	266		22	558	0.08483%	406498	61.80%	109	34.06%
深	267		11	552	0.08391%	407050	61.88%	207	64.69%
遠	268		13	548	0.08331%	407598	61.96%	196	61.25%
市	269		5	547	0.08315%	408145	62.05%	134	41.88%
電	270		13	547	0.08315%	408692	62.13%	142	44.38%
傳	271		13	539	0.08194%	409231	62.21%	197	61.56%
孩	272		9	537	0.08163%	409768	62.29%	119	37.19%
育	273		7	534	0.08118%	410302	62.37%	112	35.00%
影	274		15	530	0.08057%	410832	62.45%	197	61.56%
北	275		5	529	0.08042%	411361	62.53%	158	49.38%
八	276		2	527	0.08011%	411888	62.61%	175	54.69%
往	277		8	527	0.08011%	412415	62.69%	202	63.13%
覺	278		20	527	0.08011%	412942	62.77%	204	63.75%
反	279		4	525	0.07981%	413467	62.85%	204	63.75%
口	280		3	525	0.07981%	413992	62.93%	204	63.75%
神	281		9	520	0.07905%	414512	63.01%	186	58.13%
曾	282		12	513	0.07799%	415025	63.09%	200	62.50%
念	283		8	511	0.07768%	415536	63.17%	185	57.81%
金	284		8	508	0.07723%	416044	63.25%	162	50.63%
別	285		7	507	0.07707%	416551	63.32%	206	64.38%
比	286		4	507	0.07707%	417058	63.40%	208	65.00%
特	287		10	507	0.07707%	417565	63.48%	172	53.75%
空	288		8	506	0.07692%	418071	63.55%	184	57.50%
失	289		5	504	0.07662%	418575	63.63%	204	63.75%
師	290		10	500	0.07601%	419075	63.71%	117	36.56%
華	291		12	498	0.07571%	419573	63.78%	151	47.19%
通	292		10	497	0.07555%	420070	63.86%	187	58.44%
夜	293		8	496	0.0754%	420566	63.93%	131	40.94%
清	294		11	496	0.0754%	421062	64.01%	197	61.56%
兒	295		8	495	0.07525%	421557	64.08%	148	46.25%
求	296		7	493	0.07495%	422050	64.16%	178	55.63%
近	297		7	492	0.07479%	422542	64.23%	225	70.31%
制	298		8	489	0.07434%	423031	64.31%	143	44.69%
寫	299		15	489	0.07434%	423520	64.38%	143	44.69%
接	300		11	489	0.07434%	424009	64.46%	210	65.63%
給	301		12	489	0.07434%	424498	64.53%	202	63.13%
七	302		2	487	0.07403%	424985	64.61%	169	52.81%
即	303		7	484	0.07358%	425469	64.68%	205	64.06%
眼	304		11	484	0.07358%	425953	64.75%	189	59.06%
直	305		8	483	0.07343%	426436	64.83%	214	66.88%
信	306		9	482	0.07327%	426918	64.90%	188	58.75%
且	307		5	481	0.07312%	427399	64.97%	204	63.75%
滿	308		14	481	0.07312%	427880	65.05%	219	68.44%
品	309		9	480	0.07297%	428360	65.12%	148	46.25%
非	310		8	476	0.07236%	428836	65.19%	206	64.38%
報	311		12	475	0.07221%	429311	65.26%	158	49.38%
萬	312		13	475	0.07221%	429786	65.34%	171	53.44%
識	313		19	473	0.0719%	430259	65.41%	175	54.69%
門	314		8	472	0.07175%	430731	65.48%	176	55.00%
產	315		11	469	0.0713%	431200	65.55%	168	52.50%
記	316		10	468	0.07114%	431668	65.62%	169	52.81%
象	317		12	468	0.07114%	432136	65.69%	184	57.50%
數	318		15	466	0.07084%	432602	65.76%	189	59.06%
量	319		12	464	0.07054%	433066	65.83%	171	53.44%
落	320		13	457	0.06947%	433523	65.90%	186	58.13%
展	321		10	456	0.06932%	433979	65.97%	163	50.94%
思	322		9	453	0.06886%	434432	66.04%	203	63.44%
改	323		7	453	0.06886%	434885	66.11%	171	53.44%
該	324		13	452	0.06871%	435337	66.18%	200	62.50%
讓	325		24	450	0.06841%	435787	66.25%	196	61.25%
打	326		5	447	0.06795%	436234	66.32%	183	57.19%
院	327		9	447	0.06795%	436681	66.38%	139	43.44%
海	328		10	445	0.06765%	437126	66.45%	146	45.63%
六	329		4	444	0.0675%	437570	66.52%	163	50.94%
西	330		6	444	0.0675%	438014	66.59%	179	55.94%
運	331		12	443	0.06734%	438457	66.65%	163	50.94%
千	332		3	439	0.06674%	438896	66.72%	167	52.19%
談	333		15	438	0.06658%	439334	66.79%	151	47.19%
候	334		10	435	0.06613%	439769	66.85%	170	53.13%
樂	335		15	434	0.06598%	440203	66.92%	159	49.69%
完	336		7	433	0.06582%	440636	66.98%	187	58.44%
式	337		6	433	0.06582%	441069	67.05%	178	55.63%
母	338		5	432	0.06567%	441501	67.12%	108	33.75%
醫	339		18	431	0.06552%	441932	67.18%	62	19.38%
取	340		8	430	0.06537%	442362	67.25%	170	53.13%
呢	341		8	430	0.06537%	442792	67.31%	170	53.13%
整	342		16	430	0.06537%	443222	67.38%	193	60.31%
際	343		13	427	0.06491%	443649	67.44%	159	49.69%
字	344		6	425	0.06461%	444074	67.51%	169	52.81%
程	345		12	425	0.06461%	444499	67.57%	176	55.00%
考	346		6	425	0.06461%	444924	67.64%	141	44.06%
張	347		11	424	0.06446%	445348	67.70%	175	54.69%
務	348		11	423	0.0643%	445771	67.77%	122	38.13%
持	349		9	423	0.0643%	446194	67.83%	177	55.31%
步	350		7	421	0.064%	446615	67.89%	193	60.31%
父	351		4	418	0.06354%	447033	67.96%	109	34.06%
切	352		4	415	0.06309%	447448	68.02%	191	59.69%
造	353		10	414	0.06294%	447862	68.08%	166	51.88%
南	354		9	407	0.06187%	448269	68.15%	127	39.69%
病	355		10	407	0.06187%	448676	68.21%	97	30.31%
資	356		13	407	0.06187%	449083	68.27%	125	39.06%
議	357		20	405	0.06157%	449488	68.33%	126	39.38%
獨	358		16	404	0.06142%	449892	68.39%	139	43.44%
強	359		11	402	0.06111%	450294	68.45%	185	57.81%
質	360		15	402	0.06111%	450696	68.51%	153	47.81%
決	361		7	401	0.06096%	451097	68.58%	160	50.00%
容	362		10	398	0.0605%	451495	68.64%	189	59.06%
聽	363		22	398	0.0605%	451893	68.70%	166	51.88%
死	364		6	397	0.06035%	452290	68.76%	142	44.38%
雖	365		17	397	0.06035%	452687	68.82%	199	62.19%
喜	366		12	396	0.0602%	453083	68.88%	130	40.63%
帶	367		11	396	0.0602%	453479	68.94%	180	56.25%
指	368		9	396	0.0602%	453875	69.00%	178	55.63%
東	369		8	396	0.0602%	454271	69.06%	168	52.50%
靜	370		16	396	0.0602%	454667	69.12%	124	38.75%
音	371		9	395	0.06005%	455062	69.18%	123	38.44%
戰	372		16	390	0.05929%	455452	69.24%	133	41.56%
計	373		9	386	0.05868%	455838	69.30%	149	46.56%
單	374		12	381	0.05792%	456219	69.35%	163	50.94%
濟	375		17	380	0.05777%	456599	69.41%	113	35.31%
語	376		14	380	0.05777%	456979	69.47%	144	45.00%
基	377		11	379	0.05762%	457358	69.53%	153	47.81%
甚	378		9	379	0.05762%	457737	69.58%	186	58.13%
讀	379		22	379	0.05762%	458116	69.64%	120	37.50%
輕	380		14	379	0.05762%	458495	69.70%	164	51.25%
存	381		6	378	0.05746%	458873	69.76%	154	48.13%
若	382		9	376	0.05716%	459249	69.81%	139	43.44%
男	383		7	372	0.05655%	459621	69.87%	101	31.56%
絕	384		12	372	0.05655%	459993	69.93%	172	53.75%
故	385		9	371	0.0564%	460364	69.98%	147	45.94%
示	386		5	371	0.0564%	460735	70.04%	148	46.25%
區	387		11	370	0.05625%	461105	70.10%	121	37.81%
歲	388		13	370	0.05625%	461475	70.15%	134	41.88%
管	389		14	369	0.05609%	461844	70.21%	151	47.19%
設	390		11	369	0.05609%	462213	70.27%	123	38.44%
極	391		13	368	0.05594%	462581	70.32%	183	57.19%
保	392		9	367	0.05579%	462948	70.38%	145	45.31%
眾	393		11	367	0.05579%	463315	70.43%	150	46.88%
似	394		7	366	0.05564%	463681	70.49%	174	54.38%
調	395		15	366	0.05564%	464047	70.54%	160	50.00%
始	396		8	365	0.05549%	464412	70.60%	182	56.88%
離	397		18	365	0.05549%	464777	70.65%	163	50.94%
告	398		7	364	0.05533%	465141	70.71%	160	50.00%
邊	399		18	364	0.05533%	465505	70.77%	146	45.63%
類	400		19	364	0.05533%	465869	70.82%	161	50.31%
條	401		11	363	0.05518%	466232	70.88%	157	49.06%
具	402		8	362	0.05503%	466594	70.93%	153	47.81%
友	403		4	362	0.05503%	466956	70.99%	136	42.50%
係	404		9	359	0.05457%	467315	71.04%	135	42.19%
林	405		8	359	0.05457%	467674	71.10%	117	36.56%
仍	406		4	358	0.05442%	468032	71.15%	172	53.75%
令	407		5	358	0.05442%	468390	71.20%	171	53.44%
境	408		14	356	0.05412%	468746	71.26%	164	51.25%
府	409		8	356	0.05412%	469102	71.31%	115	35.94%
除	410		9	354	0.05381%	469456	71.37%	176	55.00%
爭	411		8	353	0.05366%	469809	71.42%	145	45.31%
裡	412		12	352	0.05351%	470161	71.47%	86	26.88%
需	413		14	352	0.05351%	470513	71.53%	152	47.50%
快	414		7	349	0.05305%	470862	71.58%	162	50.63%
精	415		14	346	0.0526%	471208	71.63%	162	50.63%
根	416		10	345	0.05245%	471553	71.68%	179	55.94%
片	417		4	345	0.05245%	471898	71.74%	139	43.44%
件	418		6	344	0.05229%	472242	71.79%	156	48.75%
苦	419		9	344	0.05229%	472586	71.84%	141	44.06%
值	420		10	343	0.05214%	472929	71.89%	132	41.25%
紅	421		9	343	0.05214%	473272	71.95%	122	38.13%
吃	422		6	341	0.05184%	473613	72.00%	109	34.06%
住	423		7	340	0.05169%	473953	72.05%	156	48.75%
態	424		14	340	0.05169%	474293	72.10%	149	46.56%
須	425		12	340	0.05169%	474633	72.15%	149	46.56%
早	426		6	336	0.05108%	474969	72.20%	164	51.25%
舉	427		17	334	0.05077%	475303	72.26%	141	44.06%
轉	428		18	334	0.05077%	475637	72.31%	173	54.06%
燈	429		16	332	0.05047%	475969	72.36%	78	24.38%
英	430		9	331	0.05032%	476300	72.41%	109	34.06%
笑	431		10	328	0.04986%	476628	72.46%	128	40.00%
連	432		10	328	0.04986%	476956	72.51%	178	55.63%
另	433		5	327	0.04971%	477283	72.56%	165	51.56%
引	434		4	327	0.04971%	477610	72.61%	164	51.25%
易	435		8	326	0.04956%	477936	72.66%	162	50.63%
血	436		6	325	0.04941%	478261	72.70%	107	33.44%
否	437		7	323	0.0491%	478584	72.75%	159	49.69%
導	438		16	323	0.0491%	478907	72.80%	146	45.63%
星	439		9	322	0.04895%	479229	72.85%	98	30.63%
婚	440		11	321	0.0488%	479550	72.90%	70	21.88%
樹	441		16	320	0.04865%	479870	72.95%	100	31.25%
畫	442		12	320	0.04865%	480190	73.00%	130	40.63%
首	443		9	320	0.04865%	480510	73.05%	158	49.38%
熱	444		15	319	0.04849%	480829	73.10%	154	48.13%
斷	445		18	314	0.04773%	481143	73.14%	149	46.56%
廣	446		15	313	0.04758%	481456	73.19%	126	39.38%
段	447		9	313	0.04758%	481769	73.24%	153	47.81%
般	448		10	311	0.04728%	482080	73.29%	158	49.38%
委	449		8	310	0.04713%	482390	73.33%	86	26.88%
局	450		7	310	0.04713%	482700	73.38%	111	34.69%
史	451		5	309	0.04697%	483009	73.43%	130	40.63%
究	452		7	309	0.04697%	483318	73.47%	127	39.69%
乎	453		5	308	0.04682%	483626	73.52%	167	52.19%
夢	454		14	308	0.04682%	483934	73.57%	107	33.44%
夫	455		4	308	0.04682%	484242	73.61%	118	36.88%
歷	456		16	308	0.04682%	484550	73.66%	152	47.50%
馬	457		10	308	0.04682%	484858	73.71%	132	41.25%
價	458		15	306	0.04652%	485164	73.75%	111	34.69%
土	459		3	305	0.04637%	485469	73.80%	125	39.06%
聯	460		17	304	0.04621%	485773	73.85%	119	37.19%
術	461		11	302	0.04591%	486075	73.89%	118	36.88%
軍	462		9	302	0.04591%	486377	73.94%	81	25.31%
較	463		13	302	0.04591%	486679	73.98%	139	43.44%
願	464		19	302	0.04591%	486981	74.03%	144	45.00%
格	465		10	301	0.04576%	487282	74.08%	145	45.31%
顯	466		23	301	0.04576%	487583	74.12%	159	49.69%
錢	467		16	300	0.04561%	487883	74.17%	97	30.31%
希	468		7	299	0.04545%	488182	74.21%	148	46.25%
確	469		15	299	0.04545%	488481	74.26%	163	50.94%
亦	470		6	298	0.0453%	488779	74.30%	124	38.75%
推	471		11	298	0.0453%	489077	74.35%	145	45.31%
半	472		5	296	0.045%	489373	74.39%	155	48.44%
研	473		9	296	0.045%	489669	74.44%	99	30.94%
續	474		21	296	0.045%	489965	74.48%	134	41.88%
香	475		9	295	0.04485%	490260	74.53%	104	32.50%
越	476		12	294	0.04469%	490554	74.57%	125	39.06%
達	477		12	292	0.04439%	490846	74.62%	149	46.56%
雙	478		18	292	0.04439%	491138	74.66%	115	35.94%
響	479		21	292	0.04439%	491430	74.71%	157	49.06%
足	480		7	291	0.04424%	491721	74.75%	164	51.25%
依	481		8	290	0.04409%	492011	74.79%	153	47.81%
朋	482		8	290	0.04409%	492301	74.84%	104	32.50%
懷	483		19	289	0.04393%	492590	74.88%	145	45.31%
角	484		7	289	0.04393%	492879	74.93%	142	44.38%
歡	485		22	287	0.04363%	493166	74.97%	132	41.25%
紀	486		9	286	0.04348%	493452	75.01%	129	40.31%
圖	487		14	285	0.04333%	493737	75.06%	113	35.31%
致	488		9	285	0.04333%	494022	75.10%	148	46.25%
隨	489		15	285	0.04333%	494307	75.14%	169	52.81%
消	490		10	284	0.04317%	494591	75.19%	146	45.63%
鄉	491		11	284	0.04317%	494875	75.23%	91	28.44%
終	492		11	283	0.04302%	495158	75.27%	160	50.00%
竟	493		11	282	0.04287%	495440	75.32%	150	46.88%
據	494		16	281	0.04272%	495721	75.36%	135	42.19%
永	495		5	281	0.04272%	496002	75.40%	121	37.81%
節	496		13	281	0.04272%	496283	75.44%	115	35.94%
校	497		10	280	0.04257%	496563	75.49%	83	25.94%
標	498		15	279	0.04241%	496842	75.53%	128	40.00%
亞	499		8	276	0.04196%	497118	75.57%	88	27.50%
刻	500		8	276	0.04196%	497394	75.61%	140	43.75%
構	501		14	276	0.04196%	497670	75.66%	108	33.75%
火	502		4	276	0.04196%	497946	75.70%	116	36.25%
勢	503		13	275	0.04181%	498221	75.74%	135	42.19%
包	504		5	274	0.04165%	498495	75.78%	144	45.00%
待	505		9	274	0.04165%	498769	75.82%	152	47.50%
怎	506		9	274	0.04165%	499043	75.86%	138	43.13%
服	507		8	274	0.04165%	499317	75.91%	125	39.06%
痛	508		12	274	0.04165%	499591	75.95%	112	35.00%
系	509		7	274	0.04165%	499865	75.99%	94	29.38%
素	510		10	274	0.04165%	500139	76.03%	113	35.31%
商	511		11	271	0.0412%	500410	76.07%	113	35.31%
層	512		15	271	0.0412%	500681	76.11%	125	39.06%
環	513		17	271	0.0412%	500952	76.15%	130	40.63%
韓	514		17	271	0.0412%	501223	76.20%	30	9.38%
衛	515		15	268	0.04074%	501491	76.24%	60	18.75%
歌	516		14	266	0.04044%	501757	76.28%	84	26.25%
青	517		8	266	0.04044%	502023	76.32%	124	38.75%
士	518		3	264	0.04013%	502287	76.36%	126	39.38%
低	519		7	263	0.03998%	502550	76.40%	120	37.50%
傷	520		13	263	0.03998%	502813	76.44%	122	38.13%
免	521		7	263	0.03998%	503076	76.48%	138	43.13%
稱	522		14	263	0.03998%	503339	76.52%	113	35.31%
充	523		5	262	0.03983%	503601	76.56%	136	42.50%
集	524		12	262	0.03983%	503863	76.60%	121	37.81%
項	525		12	261	0.03968%	504124	76.64%	94	29.38%
領	526		14	260	0.03952%	504384	76.68%	136	42.50%
嗎	527		13	259	0.03937%	504643	76.72%	125	39.06%
德	528		15	259	0.03937%	504902	76.75%	103	32.19%
例	529		8	258	0.03922%	505160	76.79%	121	37.81%
約	530		9	258	0.03922%	505418	76.83%	133	41.56%
聞	531		14	258	0.03922%	505676	76.87%	97	30.31%
群	532		13	257	0.03907%	505933	76.91%	116	36.25%
辦	533		16	257	0.03907%	506190	76.95%	116	36.25%
食	534		9	257	0.03907%	506447	76.99%	76	23.75%
嚴	535		20	256	0.03892%	506703	77.03%	134	41.88%
驗	536		23	256	0.03892%	506959	77.07%	118	36.88%
收	537		6	255	0.03876%	507214	77.11%	137	42.81%
族	538		11	255	0.03876%	507469	77.14%	90	28.13%
漸	539		14	255	0.03876%	507724	77.18%	125	39.06%
參	540		11	254	0.03861%	507978	77.22%	130	40.63%
策	541		12	254	0.03861%	508232	77.26%	78	24.38%
陸	542		10	254	0.03861%	508486	77.30%	92	28.75%
木	543		4	253	0.03846%	508739	77.34%	97	30.31%
細	544		11	253	0.03846%	508992	77.38%	126	39.38%
規	545		11	253	0.03846%	509245	77.41%	111	34.69%
底	546		8	252	0.03831%	509497	77.45%	148	46.25%
雨	547		8	252	0.03831%	509749	77.49%	86	26.88%
園	548		13	251	0.03816%	510000	77.53%	94	29.38%
試	549		13	251	0.03816%	510251	77.57%	99	30.94%
房	550		8	250	0.038%	510501	77.61%	100	31.25%
草	551		10	250	0.038%	510751	77.64%	102	31.88%
古	552		5	249	0.03785%	511000	77.68%	112	35.00%
增	553		15	249	0.03785%	511249	77.72%	108	33.75%
黃	554		12	248	0.0377%	511497	77.76%	120	37.50%
密	555		11	247	0.03755%	511744	77.79%	112	35.00%
找	556		7	247	0.03755%	511991	77.83%	131	40.94%
景	557		12	247	0.03755%	512238	77.87%	133	41.56%
創	558		12	246	0.0374%	512484	77.91%	112	35.00%
藥	559		19	246	0.0374%	512730	77.94%	53	16.56%
證	560		19	246	0.0374%	512976	77.98%	112	35.00%
黑	561		12	245	0.03724%	513221	78.02%	119	37.19%
僅	562		13	244	0.03709%	513465	78.06%	118	36.88%
興	563		16	243	0.03694%	513708	78.09%	135	42.19%
功	564		5	242	0.03679%	513950	78.13%	118	36.88%
晚	565		11	242	0.03679%	514192	78.17%	122	38.13%
福	566		13	241	0.03664%	514433	78.20%	104	32.50%
陽	567		11	241	0.03664%	514674	78.24%	105	32.81%
久	568		3	240	0.03648%	514914	78.28%	145	45.31%
劇	569		15	240	0.03648%	515154	78.31%	82	25.63%
倒	570		10	238	0.03618%	515392	78.35%	135	42.19%
斯	571		12	238	0.03618%	515630	78.39%	105	32.81%
悲	572		12	237	0.03603%	515867	78.42%	103	32.19%
況	573		8	237	0.03603%	516104	78.46%	136	42.50%
照	574		13	237	0.03603%	516341	78.49%	127	39.69%
突	575		9	237	0.03603%	516578	78.53%	131	40.94%
坐	576		7	236	0.03588%	516814	78.57%	111	34.69%
追	577		9	236	0.03588%	517050	78.60%	128	40.00%
息	578		10	235	0.03572%	517285	78.64%	124	38.75%
善	579		12	234	0.03557%	517519	78.67%	117	36.56%
科	580		9	234	0.03557%	517753	78.71%	91	28.44%
居	581		8	233	0.03542%	517986	78.74%	117	36.56%
費	582		12	232	0.03527%	518218	78.78%	104	32.50%
元	583		4	231	0.03512%	518449	78.81%	90	28.13%
盡	584		14	231	0.03512%	518680	78.85%	139	43.44%
庭	585		10	229	0.03481%	518909	78.88%	81	25.31%
叫	586		5	227	0.03451%	519136	78.92%	103	32.19%
春	587		9	227	0.03451%	519363	78.95%	98	30.63%
拉	588		8	226	0.03436%	519589	78.99%	106	33.13%
筆	589		12	226	0.03436%	519815	79.02%	104	32.50%
破	590		10	225	0.0342%	520040	79.06%	127	39.69%
級	591		10	224	0.03405%	520264	79.09%	90	28.13%
排	592		11	223	0.0339%	520487	79.12%	125	39.06%
案	593		10	223	0.0339%	520710	79.16%	100	31.25%
注	594		8	223	0.0339%	520933	79.19%	131	40.94%
亮	595		9	222	0.03375%	521155	79.23%	100	31.25%
樓	596		15	222	0.03375%	521377	79.26%	85	26.56%
繼	597		20	222	0.03375%	521599	79.29%	97	30.31%
效	598		10	221	0.0336%	521820	79.33%	95	29.69%
習	599		11	221	0.0336%	522041	79.36%	119	37.19%
專	600		11	220	0.03344%	522261	79.39%	114	35.63%
維	601		14	220	0.03344%	522481	79.43%	100	31.25%
限	602		8	220	0.03344%	522701	79.46%	119	37.19%
責	603		11	219	0.03329%	522920	79.49%	108	33.75%
夠	604		11	218	0.03314%	523138	79.53%	124	38.75%
官	605		8	218	0.03314%	523356	79.56%	84	26.25%
富	606		12	218	0.03314%	523574	79.59%	95	29.69%
準	607		13	218	0.03314%	523792	79.63%	126	39.38%
演	608		14	218	0.03314%	524010	79.66%	115	35.94%
初	609		7	217	0.03299%	524227	79.69%	122	38.13%
港	610		12	217	0.03299%	524444	79.73%	60	18.75%
組	611		11	217	0.03299%	524661	79.76%	94	29.38%
屬	612		21	216	0.03284%	524877	79.79%	127	39.69%
施	613		9	216	0.03284%	525093	79.82%	89	27.81%
王	614		4	216	0.03284%	525309	79.86%	76	23.75%
執	615		11	215	0.03268%	525524	79.89%	96	30.00%
室	616		9	215	0.03268%	525739	79.92%	90	28.13%
康	617		11	215	0.03268%	525954	79.95%	69	21.56%
復	618		12	215	0.03268%	526169	79.99%	117	36.56%
留	619		10	211	0.03208%	526380	80.02%	129	40.31%
簡	620		18	211	0.03208%	526591	80.05%	109	34.06%
陳	621		10	211	0.03208%	526802	80.08%	67	20.94%
客	622		9	210	0.03192%	527012	80.12%	120	37.50%
班	623		10	209	0.03177%	527221	80.15%	86	26.88%
益	624		10	209	0.03177%	527430	80.18%	90	28.13%
街	625		12	209	0.03177%	527639	80.21%	85	26.56%
異	626		11	208	0.03162%	527847	80.24%	129	40.31%
假	627		11	207	0.03147%	528054	80.27%	100	31.25%
怕	628		8	207	0.03147%	528261	80.31%	120	37.50%
查	629		9	207	0.03147%	528468	80.34%	80	25.00%
媽	630		13	206	0.03132%	528674	80.37%	44	13.75%
協	631		8	205	0.03116%	528879	80.40%	79	24.69%
野	632		11	205	0.03116%	529084	80.43%	99	30.94%
靈	633		24	205	0.03116%	529289	80.46%	112	35.00%
投	634		7	204	0.03101%	529493	80.49%	101	31.56%
承	635		8	204	0.03101%	529697	80.52%	92	28.75%
球	636		11	204	0.03101%	529901	80.55%	79	24.69%
職	637		18	204	0.03101%	530105	80.59%	79	24.69%
舊	638		18	204	0.03101%	530309	80.62%	99	30.94%
跟	639		13	204	0.03101%	530513	80.65%	105	32.81%
微	640		13	203	0.03086%	530716	80.68%	106	33.13%
藝	641		19	203	0.03086%	530919	80.71%	77	24.06%
阿	642		7	203	0.03086%	531122	80.74%	57	17.81%
司	643		5	202	0.03071%	531324	80.77%	88	27.50%
幸	644		8	202	0.03071%	531526	80.80%	98	30.63%
爾	645		14	202	0.03071%	531728	80.83%	91	28.44%
份	646		6	201	0.03056%	531929	80.86%	95	29.69%
楊	647		13	201	0.03056%	532130	80.89%	31	9.69%
石	648		5	201	0.03056%	532331	80.92%	82	25.63%
背	649		9	201	0.03056%	532532	80.95%	123	38.44%
送	650		9	201	0.03056%	532733	80.99%	96	30.00%
飛	651		9	201	0.03056%	532934	81.02%	101	31.56%
麗	652		19	201	0.03056%	533135	81.05%	102	31.88%
率	653		11	200	0.0304%	533335	81.08%	89	27.81%
緊	654		14	200	0.0304%	533535	81.11%	103	32.19%
李	655		7	199	0.03025%	533734	81.14%	69	21.56%
站	656		10	199	0.03025%	533933	81.17%	105	32.81%
吧	657		7	198	0.0301%	534131	81.20%	108	33.75%
零	658		13	197	0.02995%	534328	81.23%	73	22.81%
備	659		12	196	0.0298%	534524	81.26%	124	38.75%
播	660		15	196	0.0298%	534720	81.29%	56	17.50%
革	661		9	196	0.0298%	534916	81.32%	71	22.19%
句	662		5	195	0.02964%	535111	81.35%	111	34.69%
綠	663		14	195	0.02964%	535306	81.38%	74	23.13%
請	664		15	195	0.02964%	535501	81.41%	105	32.81%
適	665		14	195	0.02964%	535696	81.44%	113	35.31%
支	666		4	194	0.02949%	535890	81.47%	107	33.44%
講	667		17	194	0.02949%	536084	81.49%	97	30.31%
尤	668		4	193	0.02934%	536277	81.52%	119	37.19%
抗	669		7	193	0.02934%	536470	81.55%	80	25.00%
超	670		12	193	0.02934%	536663	81.58%	102	31.88%
啊	671		11	191	0.02904%	536854	81.61%	85	26.56%
城	672		9	191	0.02904%	537045	81.64%	87	27.19%
預	673		13	191	0.02904%	537236	81.67%	90	28.13%
供	674		8	190	0.02888%	537426	81.70%	98	30.63%
奇	675		8	190	0.02888%	537616	81.73%	103	32.19%
獲	676		17	190	0.02888%	537806	81.76%	101	31.56%
負	677		9	190	0.02888%	537996	81.79%	101	31.56%
浪	678		10	189	0.02873%	538185	81.81%	92	28.75%
曲	679		6	188	0.02858%	538373	81.84%	77	24.06%
穿	680		9	188	0.02858%	538561	81.87%	109	34.06%
篇	681		15	188	0.02858%	538749	81.90%	74	23.13%
雲	682		12	188	0.02858%	538937	81.93%	82	25.63%
助	683		7	187	0.02843%	539124	81.96%	103	32.19%
派	684		9	186	0.02828%	539310	81.99%	71	22.19%
省	685		9	186	0.02828%	539496	82.01%	89	27.81%
階	686		11	186	0.02828%	539682	82.04%	86	26.88%
隻	687		10	186	0.02828%	539868	82.07%	74	23.13%
團	688		14	185	0.02812%	540053	82.10%	86	26.88%
害	689		10	185	0.02812%	540238	82.13%	102	31.88%
算	690		14	185	0.02812%	540423	82.15%	111	34.69%
克	691		7	184	0.02797%	540607	82.18%	80	25.00%
河	692		8	184	0.02797%	540791	82.21%	75	23.44%
溫	693		13	183	0.02782%	540974	82.24%	111	34.69%
謂	694		16	183	0.02782%	541157	82.27%	100	31.25%
討	695		10	182	0.02767%	541339	82.29%	110	34.38%
驚	696		23	182	0.02767%	541521	82.32%	90	28.13%
冷	697		7	181	0.02752%	541702	82.35%	101	31.56%
良	698		7	181	0.02752%	541883	82.38%	104	32.50%
財	699		10	181	0.02752%	542064	82.40%	62	19.38%
借	700		10	180	0.02736%	542244	82.43%	45	14.06%
尋	701		12	180	0.02736%	542424	82.46%	101	31.56%
急	702		9	180	0.02736%	542604	82.49%	87	27.19%
答	703		12	180	0.02736%	542784	82.51%	95	29.69%
評	704		12	180	0.02736%	542964	82.54%	90	28.13%
顧	705		21	180	0.02736%	543144	82.57%	116	36.25%
龍	706		16	180	0.02736%	543324	82.60%	57	17.81%
止	707		4	179	0.02721%	543503	82.62%	109	34.06%
配	708		10	179	0.02721%	543682	82.65%	88	27.50%
忘	709		7	178	0.02706%	543860	82.68%	106	33.13%
愈	710		13	178	0.02706%	544038	82.70%	61	19.06%
味	711		8	177	0.02691%	544215	82.73%	111	34.69%
某	712		9	176	0.02676%	544391	82.76%	94	29.38%
衣	713		6	175	0.0266%	544566	82.78%	92	28.75%
護	714		21	175	0.0266%	544741	82.81%	87	27.19%
停	715		11	174	0.02645%	544915	82.84%	102	31.88%
判	716		7	174	0.02645%	545089	82.86%	70	21.88%
休	717		6	173	0.0263%	545262	82.89%	75	23.44%
呼	718		8	173	0.0263%	545435	82.92%	103	32.19%
誰	719		15	172	0.02615%	545607	82.94%	92	28.75%
均	720		7	171	0.026%	545778	82.97%	90	28.13%
散	721		12	171	0.026%	545949	82.99%	99	30.94%
買	722		12	171	0.026%	546120	83.02%	79	24.69%
館	723		16	171	0.026%	546291	83.05%	56	17.50%
困	724		7	170	0.02584%	546461	83.07%	108	33.75%
積	725		16	170	0.02584%	546631	83.10%	103	32.19%
臨	726		17	170	0.02584%	546801	83.12%	105	32.81%
訴	727		12	170	0.02584%	546971	83.15%	104	32.50%
課	728		15	170	0.02584%	547141	83.18%	84	26.25%
檢	729		17	169	0.02569%	547310	83.20%	72	22.50%
秋	730		9	169	0.02569%	547479	83.23%	66	20.63%
退	731		9	169	0.02569%	547648	83.25%	91	28.44%
固	732		8	168	0.02554%	547816	83.28%	94	29.38%
壓	733		17	168	0.02554%	547984	83.30%	96	30.00%
歐	734		15	168	0.02554%	548152	83.33%	58	18.13%
農	735		13	168	0.02554%	548320	83.35%	59	18.44%
布	736		5	167	0.02539%	548487	83.38%	85	26.56%
短	737		12	167	0.02539%	548654	83.41%	99	30.94%
村	738		7	166	0.02524%	548820	83.43%	54	16.88%
版	739		8	166	0.02524%	548986	83.46%	65	20.31%
腳	740		13	166	0.02524%	549152	83.48%	92	28.75%
雜	741		18	166	0.02524%	549318	83.51%	103	32.19%
婦	742		11	165	0.02508%	549483	83.53%	68	21.25%
營	743		17	165	0.02508%	549648	83.56%	80	25.00%
醒	744		16	165	0.02508%	549813	83.58%	82	25.63%
健	745		11	164	0.02493%	549977	83.61%	71	22.19%
臉	746		17	164	0.02493%	550141	83.63%	85	26.56%
銀	747		14	164	0.02493%	550305	83.66%	50	15.63%
印	748		6	163	0.02478%	550468	83.68%	93	29.06%
唯	749		11	163	0.02478%	550631	83.71%	120	37.50%
宣	750		9	163	0.02478%	550794	83.73%	84	26.25%
律	751		9	163	0.02478%	550957	83.76%	82	25.63%
換	752		12	163	0.02478%	551120	83.78%	104	32.50%
擔	753		16	163	0.02478%	551283	83.81%	102	31.88%
緣	754		15	163	0.02478%	551446	83.83%	83	25.94%
號	755		13	163	0.02478%	551609	83.85%	77	24.06%
述	756		8	163	0.02478%	551772	83.88%	93	29.06%
寧	757		14	162	0.02463%	551934	83.90%	79	24.69%
忽	758		8	162	0.02463%	552096	83.93%	96	30.00%
技	759		7	162	0.02463%	552258	83.95%	80	25.00%
朝	760		12	161	0.02448%	552419	83.98%	90	28.13%
油	761		8	161	0.02448%	552580	84.00%	66	20.63%
皮	762		5	161	0.02448%	552741	84.03%	78	24.38%
線	763		15	161	0.02448%	552902	84.05%	98	30.63%
葉	764		13	160	0.02432%	553062	84.08%	73	22.81%
守	765		6	159	0.02417%	553221	84.10%	96	30.00%
料	766		10	159	0.02417%	553380	84.12%	87	27.19%
源	767		13	159	0.02417%	553539	84.15%	96	30.00%
裝	768		13	159	0.02417%	553698	84.17%	84	26.25%
透	769		10	159	0.02417%	553857	84.20%	100	31.25%
既	770		9	158	0.02402%	554015	84.22%	104	32.50%
逐	771		10	158	0.02402%	554173	84.24%	104	32.50%
養	772		15	158	0.02402%	554331	84.27%	86	26.88%
修	773		10	157	0.02387%	554488	84.29%	86	26.88%
烈	774		10	157	0.02387%	554645	84.32%	99	30.94%
眠	775		10	157	0.02387%	554802	84.34%	23	7.19%
睡	776		14	157	0.02387%	554959	84.36%	59	18.44%
紙	777		10	157	0.02387%	555116	84.39%	96	30.00%
貴	778		12	157	0.02387%	555273	84.41%	85	26.56%
靠	779		15	157	0.02387%	555430	84.44%	89	27.81%
戲	780		17	156	0.02371%	555586	84.46%	72	22.50%
拿	781		10	156	0.02371%	555742	84.48%	94	29.38%
歸	782		18	156	0.02371%	555898	84.51%	99	30.94%
狀	783		8	156	0.02371%	556054	84.53%	80	25.00%
企	784		6	155	0.02356%	556209	84.55%	63	19.69%
列	785		6	155	0.02356%	556364	84.58%	96	30.00%
忍	786		7	154	0.02341%	556518	84.60%	101	31.56%
潮	787		15	154	0.02341%	556672	84.62%	85	26.56%
私	788		7	154	0.02341%	556826	84.65%	79	24.69%
訊	789		10	154	0.02341%	556980	84.67%	62	19.38%
遇	790		12	154	0.02341%	557134	84.69%	93	29.06%
型	791		9	153	0.02326%	557287	84.72%	92	28.75%
堅	792		11	153	0.02326%	557440	84.74%	93	29.06%
沙	793		7	153	0.02326%	557593	84.76%	63	19.69%
亂	794		13	152	0.02311%	557745	84.79%	99	30.94%
差	795		10	152	0.02311%	557897	84.81%	86	26.88%
採	796		11	152	0.02311%	558049	84.83%	82	25.63%
腦	797		13	152	0.02311%	558201	84.86%	78	24.38%
漫	798		14	151	0.02295%	558352	84.88%	83	25.94%
窗	799		12	151	0.02295%	558503	84.90%	77	24.06%
菜	800		12	151	0.02295%	558654	84.93%	43	13.44%
掉	801		11	150	0.0228%	558804	84.95%	94	29.38%
脂	802		10	150	0.0228%	558954	84.97%	11	3.44%
唱	803		11	149	0.02265%	559103	84.99%	57	17.81%
惡	804		12	149	0.02265%	559252	85.02%	85	26.56%
抱	805		8	149	0.02265%	559401	85.04%	95	29.69%
漢	806		14	149	0.02265%	559550	85.06%	48	15.00%
雄	807		12	149	0.02265%	559699	85.08%	70	21.88%
察	808		14	148	0.0225%	559847	85.11%	74	23.13%
擁	809		16	148	0.0225%	559995	85.13%	102	31.88%
童	810		12	148	0.0225%	560143	85.15%	71	22.19%
端	811		14	148	0.0225%	560291	85.17%	86	26.88%
里	812		7	148	0.0225%	560439	85.20%	86	26.88%
戀	813		23	147	0.02235%	560586	85.22%	58	18.13%
概	814		13	147	0.02235%	560733	85.24%	71	22.19%
餘	815		15	147	0.02235%	560880	85.26%	92	28.75%
肯	816		8	146	0.02219%	561026	85.29%	89	27.81%
速	817		10	146	0.02219%	561172	85.31%	91	28.44%
酒	818		10	146	0.02219%	561318	85.33%	59	18.44%
慮	819		15	145	0.02204%	561463	85.35%	92	28.75%
互	820		4	144	0.02189%	561607	85.37%	87	27.19%
威	821		9	143	0.02174%	561750	85.40%	64	20.00%
憶	822		16	143	0.02174%	561893	85.42%	75	23.44%
洲	823		9	143	0.02174%	562036	85.44%	56	17.50%
禮	824		17	143	0.02174%	562179	85.46%	78	24.38%
訪	825		11	143	0.02174%	562322	85.48%	68	21.25%
默	826		16	142	0.02159%	562464	85.51%	74	23.13%
剛	827		10	141	0.02143%	562605	85.53%	90	28.13%
恐	828		10	141	0.02143%	562746	85.55%	90	28.13%
戶	829		4	141	0.02143%	562887	85.57%	44	13.75%
模	830		15	141	0.02143%	563028	85.59%	90	28.13%
激	831		16	141	0.02143%	563169	85.61%	102	31.88%
蛋	832		11	141	0.02143%	563310	85.63%	34	10.63%
迷	833		9	141	0.02143%	563451	85.66%	87	27.19%
露	834		21	141	0.02143%	563592	85.68%	90	28.13%
典	835		8	140	0.02128%	563732	85.70%	80	25.00%
疑	836		14	140	0.02128%	563872	85.72%	98	30.63%
遊	837		12	140	0.02128%	564012	85.74%	87	27.19%
勞	838		12	139	0.02113%	564151	85.76%	59	18.44%
妳	839		8	139	0.02113%	564290	85.78%	26	8.13%
岸	840		8	139	0.02113%	564429	85.80%	60	18.75%
忙	841		6	139	0.02113%	564568	85.82%	75	23.44%
武	842		8	139	0.02113%	564707	85.85%	51	15.94%
防	843		6	139	0.02113%	564846	85.87%	59	18.44%
升	844		4	138	0.02098%	564984	85.89%	73	22.81%
患	845		11	138	0.02098%	565122	85.91%	43	13.44%
掌	846		12	138	0.02098%	565260	85.93%	72	22.50%
織	847		18	138	0.02098%	565398	85.95%	67	20.94%
趣	848		15	138	0.02098%	565536	85.97%	82	25.63%
努	849		7	137	0.02083%	565673	85.99%	76	23.75%
授	850		11	136	0.02067%	565809	86.01%	61	19.06%
握	851		12	136	0.02067%	565945	86.03%	80	25.00%
江	852		6	136	0.02067%	566081	86.06%	61	19.06%
沈	853		7	135	0.02052%	566216	86.08%	63	19.69%
險	854		15	135	0.02052%	566351	86.10%	71	22.19%
午	855		4	134	0.02037%	566485	86.12%	79	24.69%
塊	856		13	134	0.02037%	566619	86.14%	82	25.63%
遍	857		12	134	0.02037%	566753	86.16%	91	28.44%
錯	858		16	134	0.02037%	566887	86.18%	94	29.38%
煙	859		13	133	0.02022%	567020	86.20%	75	23.44%
移	860		11	133	0.02022%	567153	86.22%	79	24.69%
範	861		15	133	0.02022%	567286	86.24%	81	25.31%
危	862		6	132	0.02007%	567418	86.26%	76	23.75%
症	863		10	132	0.02007%	567550	86.28%	32	10.00%
缺	864		10	132	0.02007%	567682	86.30%	88	27.50%
避	865		16	132	0.02007%	567814	86.32%	75	23.44%
陣	866		9	132	0.02007%	567946	86.34%	79	24.69%
	867		11	131	0.01991%	568077	86.36%	11	3.44%
鐵	868		21	131	0.01991%	568208	86.38%	69	21.56%
鞋	869		15	131	0.01991%	568339	86.40%	28	8.75%
額	870		18	131	0.01991%	568470	86.42%	41	12.81%
屋	871		9	130	0.01976%	568600	86.44%	71	22.19%
左	872		5	130	0.01976%	568730	86.46%	74	23.13%
檳	873		18	130	0.01976%	568860	86.48%	10	3.13%
脫	874		11	130	0.01976%	568990	86.50%	82	25.63%
舞	875		14	130	0.01976%	569120	86.52%	70	21.88%
途	876		10	130	0.01976%	569250	86.54%	93	29.06%
乃	877		2	129	0.01961%	569379	86.56%	81	25.31%
座	878		10	129	0.01961%	569508	86.58%	79	24.69%
純	879		10	129	0.01961%	569637	86.60%	83	25.94%
補	880		12	129	0.01961%	569766	86.62%	74	23.13%
遺	881		15	129	0.01961%	569895	86.63%	80	25.00%
哥	882		10	128	0.01946%	570023	86.65%	38	11.88%
店	883		8	128	0.01946%	570151	86.67%	67	20.94%
探	884		11	128	0.01946%	570279	86.69%	79	24.69%
榔	885		13	128	0.01946%	570407	86.71%	9	2.81%
玩	886		8	128	0.01946%	570535	86.73%	66	20.63%
衝	887		15	128	0.01946%	570663	86.75%	82	25.63%
章	888		11	127	0.01931%	570790	86.77%	70	21.88%
吸	889		7	126	0.01915%	570916	86.79%	74	23.13%
圍	890		12	126	0.01915%	571042	86.81%	85	26.56%
席	891		10	126	0.01915%	571168	86.83%	50	15.63%
羅	892		19	126	0.01915%	571294	86.85%	72	22.50%
予	893		4	125	0.019%	571419	86.87%	77	24.06%
周	894		8	125	0.019%	571544	86.89%	82	25.63%
暗	895		13	125	0.019%	571669	86.90%	79	24.69%
爸	896		8	125	0.019%	571794	86.92%	29	9.06%
票	897		11	125	0.019%	571919	86.94%	59	18.44%
賣	898		15	125	0.019%	572044	86.96%	67	20.94%
寂	899		11	124	0.01885%	572168	86.98%	72	22.50%
波	900		8	124	0.01885%	572292	87.00%	81	25.31%
狂	901		7	124	0.01885%	572416	87.02%	63	19.69%
禁	902		13	124	0.01885%	572540	87.04%	84	26.25%
豪	903		14	124	0.01885%	572664	87.06%	41	12.81%
擇	904		16	123	0.0187%	572787	87.07%	80	25.00%
田	905		5	123	0.0187%	572910	87.09%	56	17.50%
紛	906		10	123	0.0187%	573033	87.11%	69	21.56%
莫	907		11	123	0.0187%	573156	87.13%	71	22.19%
閒	908		12	123	0.0187%	573279	87.15%	50	15.63%
頓	909		13	123	0.0187%	573402	87.17%	58	18.13%
徵	910		15	122	0.01855%	573524	87.19%	70	21.88%
括	911		9	122	0.01855%	573646	87.21%	71	22.19%
析	912		8	122	0.01855%	573768	87.22%	53	16.56%
淚	913		11	122	0.01855%	573890	87.24%	67	20.94%
略	914		11	122	0.01855%	574012	87.26%	72	22.50%
觸	915		20	122	0.01855%	574134	87.28%	72	22.50%
減	916		12	121	0.01839%	574255	87.30%	59	18.44%
肉	917		6	121	0.01839%	574376	87.32%	65	20.31%
鐘	918		20	121	0.01839%	574497	87.33%	69	21.56%
順	919		12	121	0.01839%	574618	87.35%	71	22.19%
隱	920		16	120	0.01824%	574738	87.37%	70	21.88%
亡	921		3	119	0.01809%	574857	87.39%	63	19.69%
央	922		5	119	0.01809%	574976	87.41%	47	14.69%
尊	923		12	119	0.01809%	575095	87.43%	76	23.75%
弟	924		7	119	0.01809%	575214	87.44%	53	16.56%
批	925		7	119	0.01809%	575333	87.46%	73	22.81%
擊	926		17	119	0.01809%	575452	87.48%	78	24.38%
棄	927		11	119	0.01809%	575571	87.50%	82	25.63%
淡	928		11	119	0.01809%	575690	87.52%	64	20.00%
湖	929		12	119	0.01809%	575809	87.53%	41	12.81%
藉	930		18	119	0.01809%	575928	87.55%	81	25.31%
降	931		8	119	0.01809%	576047	87.57%	61	19.06%
頁	932		9	119	0.01809%	576166	87.59%	41	12.81%
副	933		11	118	0.01794%	576284	87.61%	61	19.06%
彩	934		11	118	0.01794%	576402	87.62%	71	22.19%
揮	935		12	118	0.01794%	576520	87.64%	74	23.13%
熟	936		15	118	0.01794%	576638	87.66%	81	25.31%
束	937		7	117	0.01779%	576755	87.68%	85	26.56%
療	938		17	117	0.01779%	576872	87.70%	26	8.13%
練	939		15	117	0.01779%	576989	87.71%	60	18.75%
翻	940		18	117	0.01779%	577106	87.73%	84	26.25%
虎	941		8	117	0.01779%	577223	87.75%	26	8.13%
享	942		8	116	0.01763%	577339	87.77%	79	24.69%
含	943		7	116	0.01763%	577455	87.78%	70	21.88%
延	944		8	116	0.01763%	577571	87.80%	81	25.31%
慢	945		14	115	0.01748%	577686	87.82%	59	18.44%
憂	946		15	115	0.01748%	577801	87.84%	82	25.63%
折	947		7	115	0.01748%	577916	87.85%	82	25.63%
製	948		14	115	0.01748%	578031	87.87%	64	20.00%
頂	949		11	115	0.01748%	578146	87.89%	72	22.50%
傾	950		13	114	0.01733%	578260	87.91%	70	21.88%
劃	951		14	114	0.01733%	578374	87.92%	68	21.25%
尚	952		8	114	0.01733%	578488	87.94%	81	25.31%
稅	953		12	114	0.01733%	578602	87.96%	36	11.25%
蕭	954		16	114	0.01733%	578716	87.98%	17	5.31%
壞	955		19	113	0.01718%	578829	87.99%	72	22.50%
志	956		7	113	0.01718%	578942	88.01%	61	19.06%
怪	957		8	113	0.01718%	579055	88.03%	74	23.13%
普	958		12	113	0.01718%	579168	88.04%	71	22.19%
洋	959		9	113	0.01718%	579281	88.06%	69	21.56%
誠	960		13	113	0.01718%	579394	88.08%	74	23.13%
謝	961		17	113	0.01718%	579507	88.10%	52	16.25%
鮮	962		17	113	0.01718%	579620	88.11%	67	20.94%
偶	963		11	112	0.01703%	579732	88.13%	66	20.63%
優	964		17	112	0.01703%	579844	88.15%	74	23.13%
彈	965		15	112	0.01703%	579956	88.16%	63	19.69%
榮	966		14	112	0.01703%	580068	88.18%	71	22.19%
錄	967		16	112	0.01703%	580180	88.20%	55	17.19%
乾	968		11	111	0.01687%	580291	88.22%	69	21.56%
冰	969		6	111	0.01687%	580402	88.23%	40	12.50%
詞	970		12	111	0.01687%	580513	88.25%	73	22.81%
雪	971		11	111	0.01687%	580624	88.27%	48	15.00%
孤	972		8	110	0.01672%	580734	88.28%	59	18.44%
您	973		11	110	0.01672%	580844	88.30%	17	5.31%
智	974		12	110	0.01672%	580954	88.32%	78	24.38%
索	975		10	110	0.01672%	581064	88.33%	79	24.69%
酸	976		14	110	0.01672%	581174	88.35%	34	10.63%
繁	977		17	109	0.01657%	581283	88.37%	70	21.88%
蘇	978		20	109	0.01657%	581392	88.38%	49	15.31%
釋	979		20	109	0.01657%	581501	88.40%	76	23.75%
針	980		10	109	0.01657%	581610	88.42%	68	21.25%
厚	981		9	108	0.01642%	581718	88.43%	76	23.75%
圓	982		13	108	0.01642%	581826	88.45%	64	20.00%
惜	983		11	108	0.01642%	581934	88.46%	78	24.38%
救	984		11	108	0.01642%	582042	88.48%	58	18.13%
沉	985		7	108	0.01642%	582150	88.50%	59	18.44%
祖	986		9	108	0.01642%	582258	88.51%	39	12.19%
跳	987		13	108	0.01642%	582366	88.53%	69	21.56%
髮	988		15	108	0.01642%	582474	88.55%	64	20.00%
序	989		7	107	0.01627%	582581	88.56%	65	20.31%
毒	990		9	107	0.01627%	582688	88.58%	34	10.63%
浮	991		10	107	0.01627%	582795	88.60%	67	20.94%
訓	992		10	107	0.01627%	582902	88.61%	52	16.25%
君	993		7	106	0.01611%	583008	88.63%	35	10.94%
器	994		16	106	0.01611%	583114	88.64%	60	18.75%
妻	995		8	106	0.01611%	583220	88.66%	46	14.38%
寬	996		15	106	0.01611%	583326	88.68%	64	20.00%
架	997		9	106	0.01611%	583432	88.69%	72	22.50%
編	998		15	106	0.01611%	583538	88.71%	58	18.13%
偏	999		11	105	0.01596%	583643	88.72%	69	21.56%
楚	1000		13	105	0.01596%	583748	88.74%	71	22.19%
泥	1001		8	105	0.01596%	583853	88.76%	60	18.75%
飯	1002		12	105	0.01596%	583958	88.77%	59	18.44%
柔	1003		9	104	0.01581%	584062	88.79%	61	19.06%
牽	1004		11	104	0.01581%	584166	88.80%	68	21.25%
畢	1005		11	104	0.01581%	584270	88.82%	67	20.94%
貿	1006		12	104	0.01581%	584374	88.84%	39	12.19%
夏	1007		10	103	0.01566%	584477	88.85%	65	20.31%
廠	1008		15	103	0.01566%	584580	88.87%	34	10.63%
敢	1009		12	103	0.01566%	584683	88.88%	66	20.63%
皆	1010		9	103	0.01566%	584786	88.90%	64	20.00%
哀	1011		9	102	0.01551%	584888	88.91%	50	15.63%
寒	1012		12	102	0.01551%	584990	88.93%	57	17.81%
欣	1013		8	102	0.01551%	585092	88.95%	65	20.31%
置	1014		13	102	0.01551%	585194	88.96%	77	24.06%
銷	1015		15	102	0.01551%	585296	88.98%	57	17.81%
隊	1016		11	102	0.01551%	585398	88.99%	52	16.25%
刀	1017		2	101	0.01535%	585499	89.01%	50	15.63%
掛	1018		11	101	0.01535%	585600	89.02%	70	21.88%
殺	1019		11	101	0.01535%	585701	89.04%	55	17.19%
縣	1020		16	101	0.01535%	585802	89.05%	30	9.38%
遭	1021		14	101	0.01535%	585903	89.07%	82	25.63%
旁	1022		10	100	0.0152%	586003	89.08%	70	21.88%
船	1023		11	100	0.0152%	586103	89.10%	41	12.81%
鼓	1024		13	100	0.0152%	586203	89.11%	61	19.06%
勝	1025		12	99	0.01505%	586302	89.13%	68	21.25%
卡	1026		5	99	0.01505%	586401	89.14%	50	15.63%
堆	1027		11	99	0.01505%	586500	89.16%	59	18.44%
弱	1028		10	99	0.01505%	586599	89.17%	59	18.44%
植	1029		12	99	0.01505%	586698	89.19%	47	14.69%
蘭	1030		21	99	0.01505%	586797	89.20%	55	17.19%
右	1031		5	98	0.0149%	586895	89.22%	62	19.38%
彼	1032		8	98	0.0149%	586993	89.23%	66	20.63%
癌	1033		17	98	0.0149%	587091	89.25%	14	4.38%
登	1034		12	98	0.0149%	587189	89.26%	68	21.25%
競	1035		20	98	0.0149%	587287	89.28%	55	17.19%
飄	1036		20	98	0.0149%	587385	89.29%	58	18.13%
堂	1037		11	97	0.01475%	587482	89.31%	61	19.06%
妹	1038		8	97	0.01475%	587579	89.32%	29	9.06%
島	1039		10	97	0.01475%	587676	89.34%	54	16.88%
床	1040		7	97	0.01475%	587773	89.35%	55	17.19%
染	1041		9	97	0.01475%	587870	89.37%	53	16.56%
渡	1042		12	97	0.01475%	587967	89.38%	29	9.06%
警	1043		20	97	0.01475%	588064	89.40%	46	14.38%
貪	1044		11	97	0.01475%	588161	89.41%	25	7.81%
魚	1045		11	97	0.01475%	588258	89.43%	42	13.13%
劉	1046		15	96	0.01459%	588354	89.44%	26	8.13%
擴	1047		18	96	0.01459%	588450	89.46%	68	21.25%
桌	1048		10	96	0.01459%	588546	89.47%	58	18.13%
溝	1049		13	96	0.01459%	588642	89.48%	52	16.25%
濃	1050		16	96	0.01459%	588738	89.50%	59	18.44%
虛	1051		12	96	0.01459%	588834	89.51%	66	20.63%
巴	1052		4	95	0.01444%	588929	89.53%	59	18.44%
憲	1053		16	95	0.01444%	589024	89.54%	25	7.81%
欲	1054		11	95	0.01444%	589119	89.56%	65	20.31%
毛	1055		4	95	0.01444%	589214	89.57%	57	17.81%
牛	1056		4	95	0.01444%	589309	89.59%	58	18.13%
絲	1057		12	95	0.01444%	589404	89.60%	65	20.31%
複	1058		14	95	0.01444%	589499	89.61%	68	21.25%
凡	1059		3	94	0.01429%	589593	89.63%	65	20.31%
吉	1060		6	94	0.01429%	589687	89.64%	29	9.06%
喝	1061		12	94	0.01429%	589781	89.66%	45	14.06%
域	1062		11	94	0.01429%	589875	89.67%	56	17.50%
幫	1063		17	94	0.01429%	589969	89.69%	65	20.31%
材	1064		7	94	0.01429%	590063	89.70%	49	15.31%
股	1065		8	94	0.01429%	590157	89.72%	60	18.75%
仰	1066		6	93	0.01414%	590250	89.73%	58	18.13%
尼	1067		5	93	0.01414%	590343	89.74%	44	13.75%
招	1068		8	93	0.01414%	590436	89.76%	60	18.75%
麻	1069		11	93	0.01414%	590529	89.77%	67	20.94%
刺	1070		8	92	0.01399%	590621	89.79%	70	21.88%
挑	1071		9	92	0.01399%	590713	89.80%	63	19.69%
旅	1072		10	92	0.01399%	590805	89.81%	53	16.56%
暴	1073		15	92	0.01399%	590897	89.83%	60	18.75%
盛	1074		11	92	0.01399%	590989	89.84%	67	20.94%
藏	1075		18	92	0.01399%	591081	89.86%	69	21.56%
諸	1076		15	92	0.01399%	591173	89.87%	61	19.06%
刊	1077		5	91	0.01383%	591264	89.88%	39	12.19%
套	1078		10	91	0.01383%	591355	89.90%	61	19.06%
媒	1079		12	91	0.01383%	591446	89.91%	52	16.25%
搖	1080		13	91	0.01383%	591537	89.92%	50	15.63%
敗	1081		11	91	0.01383%	591628	89.94%	61	19.06%
朵	1082		6	91	0.01383%	591719	89.95%	54	16.88%
附	1083		7	91	0.01383%	591810	89.97%	73	22.81%
昨	1084		9	90	0.01368%	591900	89.98%	51	15.94%
耳	1085		6	90	0.01368%	591990	89.99%	69	21.56%
胸	1086		10	90	0.01368%	592080	90.01%	65	20.31%
貨	1087		11	90	0.01368%	592170	90.02%	46	14.38%
輝	1088		15	90	0.01368%	592260	90.03%	55	17.19%
隔	1089		12	90	0.01368%	592350	90.05%	65	20.31%
介	1090		4	89	0.01353%	592439	90.06%	52	16.25%
吹	1091		7	89	0.01353%	592528	90.08%	56	17.50%
抽	1092		8	89	0.01353%	592617	90.09%	52	16.25%
映	1093		9	89	0.01353%	592706	90.10%	65	20.31%
秘	1094		10	89	0.01353%	592795	90.12%	43	13.44%
納	1095		10	89	0.01353%	592884	90.13%	55	17.19%
豐	1096		18	89	0.01353%	592973	90.14%	57	17.81%
輪	1097		15	89	0.01353%	593062	90.16%	57	17.81%
帝	1098		9	88	0.01338%	593150	90.17%	46	14.38%
彷	1099		7	88	0.01338%	593238	90.18%	56	17.50%
愁	1100		13	88	0.01338%	593326	90.20%	41	12.81%
泰	1101		10	88	0.01338%	593414	90.21%	40	12.50%
衡	1102		16	88	0.01338%	593502	90.22%	61	19.06%
跑	1103		12	88	0.01338%	593590	90.24%	58	18.13%
乏	1104		5	87	0.01323%	593677	90.25%	62	19.38%
奔	1105		8	87	0.01323%	593764	90.26%	55	17.19%
幻	1106		4	87	0.01323%	593851	90.28%	54	16.88%
怨	1107		9	87	0.01323%	593938	90.29%	52	16.25%
懂	1108		17	87	0.01323%	594025	90.30%	55	17.19%
昏	1109		8	87	0.01323%	594112	90.32%	55	17.19%
牌	1110		12	87	0.01323%	594199	90.33%	43	13.44%
築	1111		16	87	0.01323%	594286	90.34%	29	9.06%
荒	1112		10	87	0.01323%	594373	90.36%	62	19.38%
鬧	1113		15	87	0.01323%	594460	90.37%	62	19.38%
孔	1114		4	86	0.01307%	594546	90.38%	46	14.38%
恨	1115		9	86	0.01307%	594632	90.40%	51	15.94%
晨	1116		11	86	0.01307%	594718	90.41%	51	15.94%
睛	1117		13	86	0.01307%	594804	90.42%	55	17.19%
誤	1118		14	86	0.01307%	594890	90.43%	60	18.75%
趕	1119		14	86	0.01307%	594976	90.45%	68	21.25%
齊	1120		14	86	0.01307%	595062	90.46%	62	19.38%
垂	1121		9	85	0.01292%	595147	90.47%	49	15.31%
寶	1122		20	85	0.01292%	595232	90.49%	54	16.88%
慣	1123		14	85	0.01292%	595317	90.50%	51	15.94%
擺	1124		18	85	0.01292%	595402	90.51%	63	19.69%
替	1125		12	85	0.01292%	595487	90.53%	59	18.44%
茶	1126		10	85	0.01292%	595572	90.54%	33	10.31%
融	1127		16	85	0.01292%	595657	90.55%	46	14.38%
賞	1128		15	85	0.01292%	595742	90.56%	55	17.19%
骨	1129		10	85	0.01292%	595827	90.58%	53	16.56%
塵	1130		14	84	0.01277%	595911	90.59%	62	19.38%
宜	1131		8	84	0.01277%	595995	90.60%	56	17.50%
州	1132		6	84	0.01277%	596079	90.62%	36	11.25%
廳	1133		25	84	0.01277%	596163	90.63%	46	14.38%
彿	1134		8	84	0.01277%	596247	90.64%	52	16.25%
攤	1135		22	84	0.01277%	596331	90.65%	39	12.19%
涉	1136		10	84	0.01277%	596415	90.67%	59	18.44%
緒	1137		14	84	0.01277%	596499	90.68%	59	18.44%
緩	1138		15	84	0.01277%	596583	90.69%	42	13.13%
縱	1139		17	84	0.01277%	596667	90.70%	53	16.56%
聚	1140		14	84	0.01277%	596751	90.72%	63	19.69%
鏡	1141		19	84	0.01277%	596835	90.73%	60	18.75%
鳥	1142		11	84	0.01277%	596919	90.74%	48	15.00%
姻	1143		9	83	0.01262%	597002	90.76%	25	7.81%
揚	1144		12	83	0.01262%	597085	90.77%	64	20.00%
測	1145		12	83	0.01262%	597168	90.78%	47	14.69%
牠	1146		7	83	0.01262%	597251	90.79%	20	6.25%
硬	1147		12	83	0.01262%	597334	90.81%	53	16.56%
縮	1148		17	83	0.01262%	597417	90.82%	53	16.56%
谷	1149		7	83	0.01262%	597500	90.83%	39	12.19%
趨	1150		17	83	0.01262%	597583	90.84%	58	18.13%
遷	1151		14	83	0.01262%	597666	90.86%	48	15.00%
射	1152		10	82	0.01247%	597748	90.87%	50	15.63%
干	1153		3	82	0.01247%	597830	90.88%	54	16.88%
橋	1154		16	82	0.01247%	597912	90.89%	39	12.19%
距	1155		12	82	0.01247%	597994	90.91%	59	18.44%
轎	1156		19	82	0.01247%	598076	90.92%	4	1.25%
郭	1157		10	82	0.01247%	598158	90.93%	18	5.63%
佔	1158		7	81	0.01231%	598239	90.94%	51	15.94%
尺	1159		4	81	0.01231%	598320	90.96%	44	13.75%
敬	1160		13	81	0.01231%	598401	90.97%	57	17.81%
枝	1161		8	81	0.01231%	598482	90.98%	49	15.31%
混	1162		11	81	0.01231%	598563	90.99%	62	19.38%
灰	1163		6	81	0.01231%	598644	91.01%	48	15.00%
狗	1164		8	81	0.01231%	598725	91.02%	32	10.00%
竹	1165		6	81	0.01231%	598806	91.03%	37	11.56%
罪	1166		13	81	0.01231%	598887	91.04%	44	13.75%
雞	1167		18	81	0.01231%	598968	91.05%	32	10.00%
餐	1168		16	81	0.01231%	599049	91.07%	45	14.06%
伸	1169		7	80	0.01216%	599129	91.08%	62	19.38%
嘴	1170		15	80	0.01216%	599209	91.09%	45	14.06%
巧	1171		5	80	0.01216%	599289	91.10%	55	17.19%
彭	1172		12	80	0.01216%	599369	91.12%	9	2.81%
獻	1173		20	80	0.01216%	599449	91.13%	51	15.94%
磨	1174		16	80	0.01216%	599529	91.14%	46	14.38%
籍	1175		20	80	0.01216%	599609	91.15%	39	12.19%
壯	1176		7	79	0.01201%	599688	91.16%	58	18.13%
控	1177		11	79	0.01201%	599767	91.18%	54	16.88%
杜	1178		7	79	0.01201%	599846	91.19%	23	7.19%
毫	1179		11	79	0.01201%	599925	91.20%	58	18.13%
牙	1180		4	79	0.01201%	600004	91.21%	43	13.44%
載	1181		13	79	0.01201%	600083	91.22%	58	18.13%
雷	1182		13	79	0.01201%	600162	91.24%	46	14.38%
顆	1183		17	79	0.01201%	600241	91.25%	41	12.81%
佛	1184		7	78	0.01186%	600319	91.26%	38	11.88%
兵	1185		7	78	0.01186%	600397	91.27%	43	13.44%
培	1186		11	78	0.01186%	600475	91.28%	40	12.50%
審	1187		15	78	0.01186%	600553	91.30%	42	13.13%
旦	1188		5	78	0.01186%	600631	91.31%	58	18.13%
淋	1189		11	78	0.01186%	600709	91.32%	27	8.44%
蓋	1190		14	78	0.01186%	600787	91.33%	61	19.06%
奮	1191		16	77	0.01171%	600864	91.34%	60	18.75%
窮	1192		15	77	0.01171%	600941	91.35%	56	17.50%
罷	1193		15	77	0.01171%	601018	91.37%	42	13.13%
賽	1194		17	77	0.01171%	601095	91.38%	35	10.94%
陷	1195		10	77	0.01171%	601172	91.39%	58	18.13%
頗	1196		14	77	0.01171%	601249	91.40%	56	17.50%
飲	1197		12	77	0.01171%	601326	91.41%	42	13.13%
俗	1198		9	76	0.01155%	601402	91.42%	57	17.81%
婆	1199		11	76	0.01155%	601478	91.44%	27	8.44%
幅	1200		12	76	0.01155%	601554	91.45%	56	17.50%
暫	1201		15	76	0.01155%	601630	91.46%	53	16.56%
曹	1202		11	76	0.01155%	601706	91.47%	12	3.75%
杯	1203		8	76	0.01155%	601782	91.48%	29	9.06%
滋	1204		12	76	0.01155%	601858	91.49%	41	12.81%
牆	1205		17	76	0.01155%	601934	91.51%	42	13.13%
監	1206		14	76	0.01155%	602010	91.52%	36	11.25%
糖	1207		16	76	0.01155%	602086	91.53%	26	8.13%
膽	1208		17	76	0.01155%	602162	91.54%	27	8.44%
莊	1209		11	76	0.01155%	602238	91.55%	46	14.38%
陰	1210		10	76	0.01155%	602314	91.56%	56	17.50%
倫	1211		10	75	0.0114%	602389	91.57%	47	14.69%
嘗	1212		14	75	0.0114%	602464	91.59%	52	16.25%
宗	1213		8	75	0.0114%	602539	91.60%	52	16.25%
擾	1214		18	75	0.0114%	602614	91.61%	54	16.88%
敏	1215		11	75	0.0114%	602689	91.62%	43	13.44%
款	1216		12	75	0.0114%	602764	91.63%	34	10.63%
鬥	1217		10	75	0.0114%	602839	91.64%	51	15.94%
齡	1218		20	75	0.0114%	602914	91.65%	41	12.81%
俄	1219		9	74	0.01125%	602988	91.67%	18	5.63%
抬	1220		8	74	0.01125%	603062	91.68%	36	11.25%
柯	1221		9	74	0.01125%	603136	91.69%	17	5.31%
殘	1222		12	74	0.01125%	603210	91.70%	50	15.63%
涼	1223		11	74	0.01125%	603284	91.71%	49	15.31%
湧	1224		12	74	0.01125%	603358	91.72%	51	15.94%
番	1225		12	74	0.01125%	603432	91.73%	56	17.50%
符	1226		11	74	0.01125%	603506	91.74%	46	14.38%
累	1227		11	74	0.01125%	603580	91.76%	51	15.94%
藍	1228		18	74	0.01125%	603654	91.77%	59	18.44%
閃	1229		10	74	0.01125%	603728	91.78%	46	14.38%
雅	1230		12	74	0.01125%	603802	91.79%	48	15.00%
孫	1231		10	73	0.0111%	603875	91.80%	39	12.19%
板	1232		8	73	0.0111%	603948	91.81%	50	15.63%
森	1233		12	73	0.0111%	604021	91.82%	40	12.50%
碎	1234		13	73	0.0111%	604094	91.83%	54	16.88%
鬆	1235		18	73	0.0111%	604167	91.84%	43	13.44%
丈	1236		3	72	0.01095%	604239	91.86%	36	11.25%
京	1237		8	72	0.01095%	604311	91.87%	39	12.19%
喪	1238		12	72	0.01095%	604383	91.88%	55	17.19%
拜	1239		9	72	0.01095%	604455	91.89%	44	13.75%
珍	1240		9	72	0.01095%	604527	91.90%	55	17.19%
甘	1241		5	72	0.01095%	604599	91.91%	38	11.88%
跡	1242		13	72	0.01095%	604671	91.92%	61	19.06%
返	1243		7	72	0.01095%	604743	91.93%	46	14.38%
促	1244		9	71	0.01079%	604814	91.94%	52	16.25%
哲	1245		10	71	0.01079%	604885	91.95%	43	13.44%
喊	1246		12	71	0.01079%	604956	91.96%	40	12.50%
巨	1247		5	71	0.01079%	605027	91.98%	45	14.06%
拍	1248		8	71	0.01079%	605098	91.99%	46	14.38%
穩	1249		19	71	0.01079%	605169	92.00%	50	15.63%
貧	1250		11	71	0.01079%	605240	92.01%	41	12.81%
付	1251		5	70	0.01064%	605310	92.02%	51	15.94%
估	1252		7	70	0.01064%	605380	92.03%	45	14.06%
儘	1253		16	70	0.01064%	605450	92.04%	50	15.63%
凝	1254		16	70	0.01064%	605520	92.05%	51	15.94%
啟	1255		11	70	0.01064%	605590	92.06%	59	18.44%
妙	1256		7	70	0.01064%	605660	92.07%	54	16.88%
旗	1257		14	70	0.01064%	605730	92.08%	32	10.00%
昇	1258		8	70	0.01064%	605800	92.09%	37	11.56%
礦	1259		20	70	0.01064%	605870	92.10%	10	3.13%
耶	1260		9	70	0.01064%	605940	92.11%	23	7.19%
脅	1261		10	70	0.01064%	606010	92.12%	30	9.38%
辛	1262		7	70	0.01064%	606080	92.14%	47	14.69%
辭	1263		19	70	0.01064%	606150	92.15%	41	12.81%
兄	1264		5	69	0.01049%	606219	92.16%	34	10.63%
哭	1265		10	69	0.01049%	606288	92.17%	37	11.56%
屆	1266		8	69	0.01049%	606357	92.18%	35	10.94%
廢	1267		15	69	0.01049%	606426	92.19%	41	12.81%
暖	1268		13	69	0.01049%	606495	92.20%	42	13.13%
橫	1269		16	69	0.01049%	606564	92.21%	52	16.25%
猶	1270		12	69	0.01049%	606633	92.22%	51	15.94%
聖	1271		13	69	0.01049%	606702	92.23%	55	17.19%
菊	1272		12	69	0.01049%	606771	92.24%	11	3.44%
貌	1273		14	69	0.01049%	606840	92.25%	53	16.56%
賴	1274		16	69	0.01049%	606909	92.26%	47	14.69%
霧	1275		19	69	0.01049%	606978	92.27%	26	8.13%
仔	1276		5	68	0.01034%	607046	92.28%	46	14.38%
勇	1277		9	68	0.01034%	607114	92.29%	46	14.38%
寞	1278		14	68	0.01034%	607182	92.30%	47	14.69%
封	1279		9	68	0.01034%	607250	92.31%	46	14.38%
洗	1280		9	68	0.01034%	607318	92.32%	52	16.25%
琴	1281		12	68	0.01034%	607386	92.33%	31	9.69%
諾	1282		16	68	0.01034%	607454	92.34%	30	9.38%
辯	1283		21	68	0.01034%	607522	92.35%	31	9.69%
週	1284		11	68	0.01034%	607590	92.37%	41	12.81%
麥	1285		11	68	0.01034%	607658	92.38%	24	7.50%
伴	1286		7	67	0.01019%	607725	92.39%	51	15.94%
幕	1287		14	67	0.01019%	607792	92.40%	47	14.69%
敘	1288		11	67	0.01019%	607859	92.41%	30	9.38%
涵	1289		11	67	0.01019%	607926	92.42%	42	13.13%
裂	1290		12	67	0.01019%	607993	92.43%	44	13.75%
壁	1291		16	66	0.01003%	608059	92.44%	46	14.38%
弄	1292		7	66	0.01003%	608125	92.45%	58	18.13%
慧	1293		15	66	0.01003%	608191	92.46%	46	14.38%
焦	1294		12	66	0.01003%	608257	92.47%	48	15.00%
痕	1295		11	66	0.01003%	608323	92.48%	39	12.19%
薄	1296		17	66	0.01003%	608389	92.49%	46	14.38%
裁	1297		12	66	0.01003%	608455	92.50%	32	10.00%
迴	1298		9	66	0.01003%	608521	92.51%	46	14.38%
邱	1299		7	66	0.01003%	608587	92.52%	14	4.38%
障	1300		13	66	0.01003%	608653	92.53%	48	15.00%
坡	1301		8	65	0.009881%	608718	92.54%	28	8.75%
季	1302		8	65	0.009881%	608783	92.55%	36	11.25%
淨	1303		11	65	0.009881%	608848	92.56%	48	15.00%
疾	1304		10	65	0.009881%	608913	92.57%	41	12.81%
皇	1305		9	65	0.009881%	608978	92.58%	33	10.31%
肅	1306		12	65	0.009881%	609043	92.59%	34	10.63%
描	1307		12	64	0.009729%	609107	92.60%	45	14.06%
核	1308		10	64	0.009729%	609171	92.61%	36	11.25%
爬	1309		8	64	0.009729%	609235	92.62%	43	13.44%
蓮	1310		15	64	0.009729%	609299	92.62%	35	10.94%
訂	1311		9	64	0.009729%	609363	92.63%	38	11.88%
仁	1312		4	63	0.009577%	609426	92.64%	44	13.75%
坦	1313		8	63	0.009577%	609489	92.65%	49	15.31%
奈	1314		8	63	0.009577%	609552	92.66%	42	13.13%
滴	1315		14	63	0.009577%	609615	92.67%	35	10.94%
災	1316		7	63	0.009577%	609678	92.68%	26	8.13%
瑞	1317		13	63	0.009577%	609741	92.69%	28	8.75%
盤	1318		15	63	0.009577%	609804	92.70%	47	14.69%
輸	1319		16	63	0.009577%	609867	92.71%	35	10.94%
逃	1320		9	63	0.009577%	609930	92.72%	45	14.06%
遙	1321		13	63	0.009577%	609993	92.73%	43	13.44%
魂	1322		14	63	0.009577%	610056	92.74%	42	13.13%
姿	1323		9	62	0.009425%	610118	92.75%	51	15.94%
徹	1324		14	62	0.009425%	610180	92.76%	48	15.00%
搬	1325		13	62	0.009425%	610242	92.77%	36	11.25%
爐	1326		20	62	0.009425%	610304	92.78%	28	8.75%
盼	1327		9	62	0.009425%	610366	92.79%	43	13.44%
祝	1328		9	62	0.009425%	610428	92.80%	26	8.13%
稍	1329		12	62	0.009425%	610490	92.81%	48	15.00%
胞	1330		9	62	0.009425%	610552	92.82%	34	10.63%
踏	1331		15	62	0.009425%	610614	92.82%	48	15.00%
迎	1332		7	62	0.009425%	610676	92.83%	53	16.56%
博	1333		12	61	0.009273%	610737	92.84%	39	12.19%
姓	1334		8	61	0.009273%	610798	92.85%	36	11.25%
姊	1335		8	61	0.009273%	610859	92.86%	20	6.25%
寄	1336		11	61	0.009273%	610920	92.87%	46	14.38%
幹	1337		13	61	0.009273%	610981	92.88%	38	11.88%
幽	1338		9	61	0.009273%	611042	92.89%	49	15.31%
末	1339		5	61	0.009273%	611103	92.90%	48	15.00%
犯	1340		5	61	0.009273%	611164	92.91%	37	11.56%
督	1341		13	61	0.009273%	611225	92.92%	30	9.38%
稿	1342		15	61	0.009273%	611286	92.93%	33	10.31%
肩	1343		8	61	0.009273%	611347	92.94%	44	13.75%
脈	1344		10	61	0.009273%	611408	92.95%	42	13.13%
貢	1345		10	61	0.009273%	611469	92.95%	29	9.06%
閱	1346		15	61	0.009273%	611530	92.96%	40	12.50%
闊	1347		17	61	0.009273%	611591	92.97%	43	13.44%
飾	1348		13	61	0.009273%	611652	92.98%	41	12.81%
塑	1349		13	60	0.009121%	611712	92.99%	39	12.19%
泛	1350		8	60	0.009121%	611772	93.00%	46	14.38%
溪	1351		13	60	0.009121%	611832	93.01%	28	8.75%
礎	1352		18	60	0.009121%	611892	93.02%	43	13.44%
米	1353		6	60	0.009121%	611952	93.03%	36	11.25%
售	1354		11	59	0.008969%	612011	93.04%	39	12.19%
孕	1355		5	59	0.008969%	612070	93.05%	25	7.81%
川	1356		3	59	0.008969%	612129	93.06%	35	10.94%
幣	1357		14	59	0.008969%	612188	93.06%	20	6.25%
怒	1358		9	59	0.008969%	612247	93.07%	42	13.13%
肪	1359		8	59	0.008969%	612306	93.08%	5	1.56%
裕	1360		12	59	0.008969%	612365	93.09%	32	10.00%
冬	1361		5	58	0.008817%	612423	93.10%	34	10.63%
匆	1362		5	58	0.008817%	612481	93.11%	32	10.00%
宇	1363		6	58	0.008817%	612539	93.12%	30	9.38%
忌	1364		7	58	0.008817%	612597	93.13%	21	6.56%
忠	1365		8	58	0.008817%	612655	93.14%	36	11.25%
旋	1366		11	58	0.008817%	612713	93.14%	30	9.38%
洛	1367		9	58	0.008817%	612771	93.15%	20	6.25%
煩	1368		13	58	0.008817%	612829	93.16%	48	15.00%
粗	1369		11	58	0.008817%	612887	93.17%	37	11.56%
芙	1370		8	58	0.008817%	612945	93.18%	8	2.50%
豈	1371		10	58	0.008817%	613003	93.19%	47	14.69%
躍	1372		21	58	0.008817%	613061	93.20%	42	13.13%
顏	1373		18	58	0.008817%	613119	93.21%	44	13.75%
勵	1374		17	57	0.008665%	613176	93.21%	36	11.25%
圈	1375		11	57	0.008665%	613233	93.22%	42	13.13%
奏	1376		9	57	0.008665%	613290	93.23%	27	8.44%
悅	1377		10	57	0.008665%	613347	93.24%	35	10.94%
慎	1378		13	57	0.008665%	613404	93.25%	43	13.44%
拒	1379		8	57	0.008665%	613461	93.26%	41	12.81%
擦	1380		17	57	0.008665%	613518	93.27%	36	11.25%
曉	1381		16	57	0.008665%	613575	93.27%	28	8.75%
燒	1382		16	57	0.008665%	613632	93.28%	41	12.81%
秀	1383		7	57	0.008665%	613689	93.29%	36	11.25%
伯	1384		7	56	0.008513%	613745	93.30%	32	10.00%
佳	1385		8	56	0.008513%	613801	93.31%	41	12.81%
哈	1386		9	56	0.008513%	613857	93.32%	31	9.69%
戴	1387		17	56	0.008513%	613913	93.33%	37	11.56%
按	1388		9	56	0.008513%	613969	93.33%	42	13.13%
珠	1389		10	56	0.008513%	614025	93.34%	36	11.25%
誌	1390		14	56	0.008513%	614081	93.35%	37	11.56%
豆	1391		7	56	0.008513%	614137	93.36%	22	6.88%
邦	1392		6	56	0.008513%	614193	93.37%	22	6.88%
頻	1393		16	56	0.008513%	614249	93.38%	31	9.69%
魯	1394		15	56	0.008513%	614305	93.39%	27	8.44%
咖	1395		8	55	0.008361%	614360	93.39%	17	5.31%
啡	1396		11	55	0.008361%	614415	93.40%	17	5.31%
埋	1397		10	55	0.008361%	614470	93.41%	40	12.50%
堪	1398		12	55	0.008361%	614525	93.42%	45	14.06%
措	1399		11	55	0.008361%	614580	93.43%	30	9.38%
擠	1400		17	55	0.008361%	614635	93.44%	35	10.94%
槍	1401		14	55	0.008361%	614690	93.44%	26	8.13%
洞	1402		9	55	0.008361%	614745	93.45%	40	12.50%
滅	1403		13	55	0.008361%	614800	93.46%	41	12.81%
濫	1404		17	55	0.008361%	614855	93.47%	36	11.25%
碧	1405		14	55	0.008361%	614910	93.48%	28	8.75%
糊	1406		15	55	0.008361%	614965	93.49%	41	12.81%
署	1407		13	55	0.008361%	615020	93.49%	28	8.75%
讚	1408		26	55	0.008361%	615075	93.50%	37	11.56%
賢	1409		15	55	0.008361%	615130	93.51%	30	9.38%
鬱	1410		29	55	0.008361%	615185	93.52%	28	8.75%
鬼	1411		10	55	0.008361%	615240	93.53%	35	10.94%
佈	1412		7	54	0.008209%	615294	93.54%	33	10.31%
娘	1413		10	54	0.008209%	615348	93.54%	31	9.69%
崇	1414		11	54	0.008209%	615402	93.55%	40	12.50%
損	1415		13	54	0.008209%	615456	93.56%	41	12.81%
操	1416		16	54	0.008209%	615510	93.57%	46	14.38%
殊	1417		10	54	0.008209%	615564	93.58%	45	14.06%
疏	1418		11	54	0.008209%	615618	93.59%	42	13.13%
羽	1419		6	54	0.008209%	615672	93.59%	15	4.69%
軟	1420		11	54	0.008209%	615726	93.60%	41	12.81%
逝	1421		10	54	0.008209%	615780	93.61%	44	13.75%
遲	1422		15	54	0.008209%	615834	93.62%	40	12.50%
呈	1423		7	53	0.008057%	615887	93.63%	41	12.81%
獎	1424		15	53	0.008057%	615940	93.63%	29	9.06%
巿	1425		4	53	0.008057%	615993	93.64%	16	5.00%
拋	1426		8	53	0.008057%	616046	93.65%	36	11.25%
振	1427		10	53	0.008057%	616099	93.66%	30	9.38%
璃	1428		15	53	0.008057%	616152	93.67%	34	10.63%
盆	1429		9	53	0.008057%	616205	93.67%	19	5.94%
瞭	1430		17	53	0.008057%	616258	93.68%	43	13.44%
簽	1431		19	53	0.008057%	616311	93.69%	25	7.81%
網	1432		14	53	0.008057%	616364	93.70%	29	9.06%
茫	1433		10	53	0.008057%	616417	93.71%	35	10.94%
違	1434		12	53	0.008057%	616470	93.72%	35	10.94%
閉	1435		11	53	0.008057%	616523	93.72%	40	12.50%
傘	1436		12	52	0.007905%	616575	93.73%	15	4.69%
兼	1437		10	52	0.007905%	616627	93.74%	40	12.50%
匯	1438		13	52	0.007905%	616679	93.75%	29	9.06%
哪	1439		10	52	0.007905%	616731	93.75%	35	10.94%
奉	1440		8	52	0.007905%	616783	93.76%	38	11.88%
徑	1441		10	52	0.007905%	616835	93.77%	40	12.50%
懼	1442		21	52	0.007905%	616887	93.78%	44	13.75%
拐	1443		8	52	0.007905%	616939	93.79%	10	3.13%
抵	1444		8	52	0.007905%	616991	93.79%	44	13.75%
滾	1445		14	52	0.007905%	617043	93.80%	33	10.31%
煤	1446		13	52	0.007905%	617095	93.81%	12	3.75%
爆	1447		19	52	0.007905%	617147	93.82%	37	11.56%
臟	1448		22	52	0.007905%	617199	93.83%	18	5.63%
航	1449		10	52	0.007905%	617251	93.83%	27	8.44%
袋	1450		11	52	0.007905%	617303	93.84%	33	10.31%
詳	1451		13	52	0.007905%	617355	93.85%	43	13.44%
輩	1452		15	52	0.007905%	617407	93.86%	38	11.88%
迫	1453		8	52	0.007905%	617459	93.87%	43	13.44%
醉	1454		15	52	0.007905%	617511	93.87%	40	12.50%
閣	1455		14	52	0.007905%	617563	93.88%	22	6.88%
震	1456		15	52	0.007905%	617615	93.89%	34	10.63%
龐	1457		19	52	0.007905%	617667	93.90%	39	12.19%
刑	1458		6	51	0.007753%	617718	93.90%	20	6.25%
吳	1459		7	51	0.007753%	617769	93.91%	25	7.81%
塞	1460		13	51	0.007753%	617820	93.92%	42	13.13%
尾	1461		7	51	0.007753%	617871	93.93%	39	12.19%
屈	1462		8	51	0.007753%	617922	93.94%	38	11.88%
撥	1463		15	51	0.007753%	617973	93.94%	27	8.44%
擬	1464		17	51	0.007753%	618024	93.95%	31	9.69%
游	1465		12	51	0.007753%	618075	93.96%	37	11.56%
粉	1466		10	51	0.007753%	618126	93.97%	34	10.63%
艱	1467		17	51	0.007753%	618177	93.97%	41	12.81%
覆	1468		18	51	0.007753%	618228	93.98%	44	13.75%
謀	1469		16	51	0.007753%	618279	93.99%	40	12.50%
購	1470		17	51	0.007753%	618330	94.00%	36	11.25%
邁	1471		16	51	0.007753%	618381	94.01%	35	10.94%
邀	1472		16	51	0.007753%	618432	94.01%	38	11.88%
隆	1473		11	51	0.007753%	618483	94.02%	27	8.44%
偉	1474		11	50	0.007601%	618533	94.03%	38	11.88%
偷	1475		11	50	0.007601%	618583	94.04%	31	9.69%
億	1476		15	50	0.007601%	618633	94.04%	30	9.38%
夕	1477		3	50	0.007601%	618683	94.05%	42	13.13%
姐	1478		8	50	0.007601%	618733	94.06%	29	9.06%
嬰	1479		17	50	0.007601%	618783	94.07%	22	6.88%
尿	1480		7	50	0.007601%	618833	94.07%	11	3.44%
幼	1481		5	50	0.007601%	618883	94.08%	37	11.56%
徒	1482		10	50	0.007601%	618933	94.09%	41	12.81%
恩	1483		10	50	0.007601%	618983	94.10%	30	9.38%
慾	1484		15	50	0.007601%	619033	94.10%	31	9.69%
扮	1485		7	50	0.007601%	619083	94.11%	44	13.75%
淺	1486		11	50	0.007601%	619133	94.12%	37	11.56%
疲	1487		10	50	0.007601%	619183	94.13%	39	12.19%
繞	1488		18	50	0.007601%	619233	94.14%	43	13.44%
蕩	1489		16	50	0.007601%	619283	94.14%	31	9.69%
診	1490		12	50	0.007601%	619333	94.15%	18	5.63%
貼	1491		12	50	0.007601%	619383	94.16%	39	12.19%
鹽	1492		24	50	0.007601%	619433	94.17%	13	4.06%
串	1493		7	49	0.007449%	619482	94.17%	39	12.19%
余	1494		7	49	0.007449%	619531	94.18%	18	5.63%
倍	1495		10	49	0.007449%	619580	94.19%	35	10.94%
剩	1496		12	49	0.007449%	619629	94.20%	40	12.50%
卷	1497		8	49	0.007449%	619678	94.20%	21	6.56%
呀	1498		7	49	0.007449%	619727	94.21%	34	10.63%
峰	1499		10	49	0.007449%	619776	94.22%	35	10.94%
巷	1500		9	49	0.007449%	619825	94.23%	33	10.31%
循	1501		12	49	0.007449%	619874	94.23%	35	10.94%
抑	1502		7	49	0.007449%	619923	94.24%	35	10.94%
敵	1503		15	49	0.007449%	619972	94.25%	35	10.94%
杖	1504		7	49	0.007449%	620021	94.25%	4	1.25%
松	1505		8	49	0.007449%	620070	94.26%	31	9.69%
汗	1506		6	49	0.007449%	620119	94.27%	35	10.94%
滑	1507		13	49	0.007449%	620168	94.28%	37	11.56%
濕	1508		17	49	0.007449%	620217	94.28%	34	10.63%
炸	1509		9	49	0.007449%	620266	94.29%	31	9.69%
爛	1510		21	49	0.007449%	620315	94.30%	40	12.50%
玻	1511		9	49	0.007449%	620364	94.31%	30	9.38%
繫	1512		19	49	0.007449%	620413	94.31%	36	11.25%
蝶	1513		15	49	0.007449%	620462	94.32%	21	6.56%
貓	1514		16	49	0.007449%	620511	94.33%	21	6.56%
販	1515		11	49	0.007449%	620560	94.34%	22	6.88%
逵	1516		11	49	0.007449%	620609	94.34%	1	0.31%
鄰	1517		14	49	0.007449%	620658	94.35%	35	10.94%
醇	1518		15	49	0.007449%	620707	94.36%	8	2.50%
鎮	1519		18	49	0.007449%	620756	94.37%	31	9.69%
陌	1520		8	49	0.007449%	620805	94.37%	36	11.25%
陶	1521		10	49	0.007449%	620854	94.38%	27	8.44%
妥	1522		7	48	0.007297%	620902	94.39%	36	11.25%
彎	1523		22	48	0.007297%	620950	94.40%	30	9.38%
攻	1524		7	48	0.007297%	620998	94.40%	27	8.44%
污	1525		6	48	0.007297%	621046	94.41%	27	8.44%
潤	1526		15	48	0.007297%	621094	94.42%	29	9.06%
玉	1527		5	48	0.007297%	621142	94.43%	37	11.56%
碰	1528		13	48	0.007297%	621190	94.43%	38	11.88%
躺	1529		15	48	0.007297%	621238	94.44%	36	11.25%
陪	1530		10	48	0.007297%	621286	94.45%	33	10.31%
丹	1531		4	47	0.007145%	621333	94.45%	24	7.50%
乘	1532		10	47	0.007145%	621380	94.46%	26	8.13%
仙	1533		5	47	0.007145%	621427	94.47%	23	7.19%
喚	1534		12	47	0.007145%	621474	94.48%	35	10.94%
嘆	1535		14	47	0.007145%	621521	94.48%	38	11.88%
壇	1536		16	47	0.007145%	621568	94.49%	32	10.00%
悟	1537		10	47	0.007145%	621615	94.50%	33	10.31%
扎	1538		4	47	0.007145%	621662	94.50%	34	10.63%
托	1539		6	47	0.007145%	621709	94.51%	36	11.25%
拔	1540		8	47	0.007145%	621756	94.52%	36	11.25%
攝	1541		21	47	0.007145%	621803	94.53%	24	7.50%
柴	1542		10	47	0.007145%	621850	94.53%	15	4.69%
潔	1543		15	47	0.007145%	621897	94.54%	36	11.25%
肺	1544		8	47	0.007145%	621944	94.55%	16	5.00%
腸	1545		13	47	0.007145%	621991	94.55%	28	8.75%
苗	1546		9	47	0.007145%	622038	94.56%	26	8.13%
葛	1547		13	47	0.007145%	622085	94.57%	16	5.00%
蒼	1548		14	47	0.007145%	622132	94.58%	30	9.38%
輛	1549		15	47	0.007145%	622179	94.58%	21	6.56%
鎖	1550		18	47	0.007145%	622226	94.59%	38	11.88%
冒	1551		9	46	0.006993%	622272	94.60%	37	11.56%
宮	1552		10	46	0.006993%	622318	94.60%	23	7.19%
悄	1553		10	46	0.006993%	622364	94.61%	23	7.19%
悔	1554		10	46	0.006993%	622410	94.62%	34	10.63%
搞	1555		13	46	0.006993%	622456	94.63%	33	10.31%
洩	1556		9	46	0.006993%	622502	94.63%	34	10.63%
甲	1557		5	46	0.006993%	622548	94.64%	22	6.88%
跨	1558		13	46	0.006993%	622594	94.65%	36	11.25%
召	1559		5	45	0.006841%	622639	94.65%	29	9.06%
憐	1560		15	45	0.006841%	622684	94.66%	35	10.94%
插	1561		12	45	0.006841%	622729	94.67%	36	11.25%
摸	1562		14	45	0.006841%	622774	94.67%	36	11.25%
昔	1563		8	45	0.006841%	622819	94.68%	33	10.31%
沖	1564		7	45	0.006841%	622864	94.69%	25	7.81%
沿	1565		8	45	0.006841%	622909	94.69%	35	10.94%
添	1566		11	45	0.006841%	622954	94.70%	33	10.31%
淇	1567		11	45	0.006841%	622999	94.71%	4	1.25%
濤	1568		17	45	0.006841%	623044	94.71%	24	7.50%
猛	1569		11	45	0.006841%	623089	94.72%	42	13.13%
甜	1570		11	45	0.006841%	623134	94.73%	30	9.38%
申	1571		5	45	0.006841%	623179	94.73%	23	7.19%
瘦	1572		14	45	0.006841%	623224	94.74%	33	10.31%
綿	1573		14	45	0.006841%	623269	94.75%	33	10.31%
耕	1574		10	45	0.006841%	623314	94.76%	24	7.50%
誕	1575		15	45	0.006841%	623359	94.76%	31	9.69%
譬	1576		20	45	0.006841%	623404	94.77%	32	10.00%
乳	1577		8	44	0.006689%	623448	94.78%	16	5.00%
併	1578		8	44	0.006689%	623492	94.78%	25	7.81%
割	1579		12	44	0.006689%	623536	94.79%	35	10.94%
勤	1580		13	44	0.006689%	623580	94.80%	34	10.63%
慘	1581		14	44	0.006689%	623624	94.80%	33	10.31%
掙	1582		11	44	0.006689%	623668	94.81%	32	10.00%
液	1583		11	44	0.006689%	623712	94.82%	23	7.19%
燕	1584		16	44	0.006689%	623756	94.82%	15	4.69%
粒	1585		11	44	0.006689%	623800	94.83%	25	7.81%
胡	1586		9	44	0.006689%	623844	94.84%	26	8.13%
舒	1587		12	44	0.006689%	623888	94.84%	31	9.69%
袖	1588		10	44	0.006689%	623932	94.85%	31	9.69%
貶	1589		12	44	0.006689%	623976	94.86%	15	4.69%
貸	1590		12	44	0.006689%	624020	94.86%	13	4.06%
赴	1591		9	44	0.006689%	624064	94.87%	35	10.94%
跌	1592		12	44	0.006689%	624108	94.88%	22	6.88%
蹤	1593		18	44	0.006689%	624152	94.88%	33	10.31%
輯	1594		16	44	0.006689%	624196	94.89%	26	8.13%
辜	1595		12	44	0.006689%	624240	94.90%	19	5.94%
逢	1596		10	44	0.006689%	624284	94.90%	39	12.19%
飽	1597		13	44	0.006689%	624328	94.91%	31	9.69%
餅	1598		14	44	0.006689%	624372	94.92%	17	5.31%
魔	1599		21	44	0.006689%	624416	94.92%	28	8.75%
占	1600		5	43	0.006537%	624459	94.93%	19	5.94%
廿	1601		4	43	0.006537%	624502	94.94%	23	7.19%
惑	1602		12	43	0.006537%	624545	94.94%	36	11.25%
愚	1603		13	43	0.006537%	624588	94.95%	29	9.06%
慶	1604		15	43	0.006537%	624631	94.96%	34	10.63%
戒	1605		7	43	0.006537%	624674	94.96%	27	8.44%
枯	1606		9	43	0.006537%	624717	94.97%	26	8.13%
瓦	1607		5	43	0.006537%	624760	94.98%	28	8.75%
瓶	1608		11	43	0.006537%	624803	94.98%	24	7.50%
翠	1609		14	43	0.006537%	624846	94.99%	19	5.94%
胖	1610		9	43	0.006537%	624889	94.99%	19	5.94%
荷	1611		11	43	0.006537%	624932	95.00%	30	9.38%
譯	1612		20	43	0.006537%	624975	95.01%	25	7.81%
鈴	1613		13	43	0.006537%	625018	95.01%	20	6.25%
阻	1614		7	43	0.006537%	625061	95.02%	32	10.00%
鳴	1615		14	43	0.006537%	625104	95.03%	34	10.63%
仇	1616		4	42	0.006385%	625146	95.03%	25	7.81%
坑	1617		7	42	0.006385%	625188	95.04%	15	4.69%
尖	1618		6	42	0.006385%	625230	95.05%	37	11.56%
挖	1619		9	42	0.006385%	625272	95.05%	26	8.13%
拾	1620		9	42	0.006385%	625314	95.06%	28	8.75%
歎	1621		15	42	0.006385%	625356	95.07%	27	8.44%
澤	1622		16	42	0.006385%	625398	95.07%	26	8.13%
獸	1623		19	42	0.006385%	625440	95.08%	26	8.13%
祇	1624		8	42	0.006385%	625482	95.09%	23	7.19%
窄	1625		10	42	0.006385%	625524	95.09%	28	8.75%
耐	1626		9	42	0.006385%	625566	95.10%	30	9.38%
詢	1627		13	42	0.006385%	625608	95.10%	31	9.69%
賓	1628		14	42	0.006385%	625650	95.11%	29	9.06%
贈	1629		19	42	0.006385%	625692	95.12%	22	6.88%
丁	1630		2	41	0.006233%	625733	95.12%	31	9.69%
契	1631		9	41	0.006233%	625774	95.13%	29	9.06%
奶	1632		5	41	0.006233%	625815	95.14%	20	6.25%
宅	1633		6	41	0.006233%	625856	95.14%	23	7.19%
宋	1634		7	41	0.006233%	625897	95.15%	18	5.63%
峽	1635		10	41	0.006233%	625938	95.15%	23	7.19%
徐	1636		10	41	0.006233%	625979	95.16%	20	6.25%
捨	1637		11	41	0.006233%	626020	95.17%	35	10.94%
斥	1638		5	41	0.006233%	626061	95.17%	34	10.63%
昆	1639		8	41	0.006233%	626102	95.18%	11	3.44%
梯	1640		11	41	0.006233%	626143	95.19%	25	7.81%
櫃	1641		18	41	0.006233%	626184	95.19%	22	6.88%
烏	1642		10	41	0.006233%	626225	95.20%	27	8.44%
獄	1643		14	41	0.006233%	626266	95.20%	19	5.94%
盟	1644		13	41	0.006233%	626307	95.21%	16	5.00%
稀	1645		12	41	0.006233%	626348	95.22%	30	9.38%
籠	1646		22	41	0.006233%	626389	95.22%	33	10.31%
蓉	1647		14	41	0.006233%	626430	95.23%	5	1.56%
衰	1648		10	41	0.006233%	626471	95.24%	32	10.00%
赤	1649		7	41	0.006233%	626512	95.24%	31	9.69%
逼	1650		12	41	0.006233%	626553	95.25%	31	9.69%
馳	1651		13	41	0.006233%	626594	95.25%	31	9.69%
啦	1652		11	40	0.006081%	626634	95.26%	27	8.44%
悠	1653		11	40	0.006081%	626674	95.27%	29	9.06%
憑	1654		16	40	0.006081%	626714	95.27%	32	10.00%
掃	1655		11	40	0.006081%	626754	95.28%	26	8.13%
斜	1656		11	40	0.006081%	626794	95.28%	26	8.13%
朗	1657		10	40	0.006081%	626834	95.29%	32	10.00%
歧	1658		8	40	0.006081%	626874	95.30%	27	8.44%
氏	1659		4	40	0.006081%	626914	95.30%	22	6.88%
漂	1660		14	40	0.006081%	626954	95.31%	32	10.00%
潛	1661		15	40	0.006081%	626994	95.31%	32	10.00%
礙	1662		19	40	0.006081%	627034	95.32%	30	9.38%
繪	1663		19	40	0.006081%	627074	95.33%	28	8.75%
腐	1664		14	40	0.006081%	627114	95.33%	25	7.81%
菲	1665		12	40	0.006081%	627154	95.34%	17	5.31%
謹	1666		18	40	0.006081%	627194	95.35%	34	10.63%
迅	1667		6	40	0.006081%	627234	95.35%	26	8.13%
遞	1668		13	40	0.006081%	627274	95.36%	29	9.06%
騰	1669		20	40	0.006081%	627314	95.36%	29	9.06%
准	1670		10	39	0.005929%	627353	95.37%	19	5.94%
匹	1671		4	39	0.005929%	627392	95.38%	17	5.31%
吐	1672		6	39	0.005929%	627431	95.38%	29	9.06%
嚼	1673		20	39	0.005929%	627470	95.39%	13	4.06%
悉	1674		11	39	0.005929%	627509	95.39%	29	9.06%
椅	1675		12	39	0.005929%	627548	95.40%	30	9.38%
棉	1676		12	39	0.005929%	627587	95.41%	17	5.31%
樸	1677		16	39	0.005929%	627626	95.41%	33	10.31%
歉	1678		14	39	0.005929%	627665	95.42%	17	5.31%
汽	1679		7	39	0.005929%	627704	95.42%	25	7.81%
渴	1680		12	39	0.005929%	627743	95.43%	30	9.38%
癡	1681		19	39	0.005929%	627782	95.43%	22	6.88%
禍	1682		13	39	0.005929%	627821	95.44%	27	8.44%
穆	1683		16	39	0.005929%	627860	95.45%	17	5.31%
纏	1684		21	39	0.005929%	627899	95.45%	33	10.31%
罵	1685		15	39	0.005929%	627938	95.46%	26	8.13%
耀	1686		20	39	0.005929%	627977	95.46%	33	10.31%
腿	1687		14	39	0.005929%	628016	95.47%	26	8.13%
芳	1688		8	39	0.005929%	628055	95.48%	33	10.31%
蒙	1689		14	39	0.005929%	628094	95.48%	26	8.13%
襲	1690		22	39	0.005929%	628133	95.49%	28	8.75%
貫	1691		11	39	0.005929%	628172	95.49%	32	10.00%
銳	1692		15	39	0.005929%	628211	95.50%	30	9.38%
鋼	1693		16	39	0.005929%	628250	95.51%	27	8.44%
鍾	1694		17	39	0.005929%	628289	95.51%	15	4.69%
雕	1695		16	39	0.005929%	628328	95.52%	25	7.81%
侵	1696		9	38	0.005777%	628366	95.52%	29	9.06%
傑	1697		12	38	0.005777%	628404	95.53%	24	7.50%
儀	1698		15	38	0.005777%	628442	95.54%	27	8.44%
償	1699		17	38	0.005777%	628480	95.54%	28	8.75%
奧	1700		13	38	0.005777%	628518	95.55%	27	8.44%
宿	1701		11	38	0.005777%	628556	95.55%	30	9.38%
惠	1702		12	38	0.005777%	628594	95.56%	21	6.56%
捕	1703		10	38	0.005777%	628632	95.56%	20	6.25%
撞	1704		15	38	0.005777%	628670	95.57%	33	10.31%
株	1705		10	38	0.005777%	628708	95.58%	28	8.75%
玲	1706		9	38	0.005777%	628746	95.58%	11	3.44%
疊	1707		22	38	0.005777%	628784	95.59%	27	8.44%
盾	1708		9	38	0.005777%	628822	95.59%	26	8.13%
磚	1709		16	38	0.005777%	628860	95.60%	21	6.56%
肥	1710		8	38	0.005777%	628898	95.60%	29	9.06%
胎	1711		9	38	0.005777%	628936	95.61%	21	6.56%
腹	1712		13	38	0.005777%	628974	95.62%	23	7.19%
莎	1713		11	38	0.005777%	629012	95.62%	14	4.38%
蔬	1714		15	38	0.005777%	629050	95.63%	12	3.75%
諧	1715		16	38	0.005777%	629088	95.63%	28	8.75%
鄧	1716		14	38	0.005777%	629126	95.64%	15	4.69%
酬	1717		13	38	0.005777%	629164	95.64%	23	7.19%
騎	1718		18	38	0.005777%	629202	95.65%	27	8.44%
慈	1719		13	37	0.005625%	629239	95.66%	23	7.19%
扭	1720		7	37	0.005625%	629276	95.66%	29	9.06%
援	1721		12	37	0.005625%	629313	95.67%	24	7.50%
摩	1722		15	37	0.005625%	629350	95.67%	31	9.69%
撐	1723		15	37	0.005625%	629387	95.68%	27	8.44%
晶	1724		12	37	0.005625%	629424	95.68%	27	8.44%
柳	1725		9	37	0.005625%	629461	95.69%	16	5.00%
洪	1726		9	37	0.005625%	629498	95.70%	24	7.50%
涯	1727		11	37	0.005625%	629535	95.70%	29	9.06%
燃	1728		16	37	0.005625%	629572	95.71%	30	9.38%
盪	1729		17	37	0.005625%	629609	95.71%	30	9.38%
賦	1730		15	37	0.005625%	629646	95.72%	31	9.69%
贏	1731		20	37	0.005625%	629683	95.72%	23	7.19%
麵	1732		20	37	0.005625%	629720	95.73%	23	7.19%
伏	1733		6	36	0.005473%	629756	95.73%	28	8.75%
冊	1734		5	36	0.005473%	629792	95.74%	20	6.25%
妨	1735		7	36	0.005473%	629828	95.75%	27	8.44%
宴	1736		10	36	0.005473%	629864	95.75%	22	6.88%
憤	1737		15	36	0.005473%	629900	95.76%	29	9.06%
拖	1738		8	36	0.005473%	629936	95.76%	29	9.06%
晴	1739		12	36	0.005473%	629972	95.77%	26	8.13%
淑	1740		11	36	0.005473%	630008	95.77%	14	4.38%
灑	1741		22	36	0.005473%	630044	95.78%	26	8.13%
託	1742		10	36	0.005473%	630080	95.78%	32	10.00%
賺	1743		17	36	0.005473%	630116	95.79%	25	7.81%
辱	1744		10	36	0.005473%	630152	95.80%	26	8.13%
駐	1745		15	36	0.005473%	630188	95.80%	22	6.88%
倡	1746		10	35	0.005321%	630223	95.81%	20	6.25%
傲	1747		13	35	0.005321%	630258	95.81%	26	8.13%
唐	1748		10	35	0.005321%	630293	95.82%	32	10.00%
夾	1749		7	35	0.005321%	630328	95.82%	30	9.38%
愉	1750		12	35	0.005321%	630363	95.83%	28	8.75%
扣	1751		6	35	0.005321%	630398	95.83%	30	9.38%
抓	1752		7	35	0.005321%	630433	95.84%	23	7.19%
桃	1753		10	35	0.005321%	630468	95.84%	28	8.75%
棒	1754		12	35	0.005321%	630503	95.85%	16	5.00%
汙	1755		6	35	0.005321%	630538	95.85%	12	3.75%
盞	1756		13	35	0.005321%	630573	95.86%	14	4.38%
眉	1757		9	35	0.005321%	630608	95.86%	28	8.75%
籲	1758		32	35	0.005321%	630643	95.87%	23	7.19%
糾	1759		8	35	0.005321%	630678	95.87%	31	9.69%
綱	1760		14	35	0.005321%	630713	95.88%	19	5.94%
脆	1761		10	35	0.005321%	630748	95.89%	32	10.00%
菸	1762		12	35	0.005321%	630783	95.89%	11	3.44%
董	1763		13	35	0.005321%	630818	95.90%	24	7.50%
蟲	1764		18	35	0.005321%	630853	95.90%	25	7.81%
衷	1765		10	35	0.005321%	630888	95.91%	29	9.06%
遜	1766		13	35	0.005321%	630923	95.91%	14	4.38%
采	1767		8	35	0.005321%	630958	95.92%	31	9.69%
劍	1768		15	34	0.005169%	630992	95.92%	26	8.13%
叔	1769		8	34	0.005169%	631026	95.93%	18	5.63%
吟	1770		7	34	0.005169%	631060	95.93%	28	8.75%
呵	1771		8	34	0.005169%	631094	95.94%	25	7.81%
嚇	1772		17	34	0.005169%	631128	95.94%	20	6.25%
廟	1773		15	34	0.005169%	631162	95.95%	17	5.31%
憾	1774		16	34	0.005169%	631196	95.95%	30	9.38%
挺	1775		10	34	0.005169%	631230	95.96%	28	8.75%
搭	1776		13	34	0.005169%	631264	95.96%	30	9.38%
殖	1777		12	34	0.005169%	631298	95.97%	22	6.88%
漁	1778		14	34	0.005169%	631332	95.97%	15	4.69%
牲	1779		9	34	0.005169%	631366	95.98%	28	8.75%
狹	1780		10	34	0.005169%	631400	95.98%	31	9.69%
碌	1781		13	34	0.005169%	631434	95.99%	23	7.19%
貝	1782		7	34	0.005169%	631468	96.00%	24	7.50%
鋪	1783		15	34	0.005169%	631502	96.00%	28	8.75%
鍵	1784		17	34	0.005169%	631536	96.01%	25	7.81%
丟	1785		6	33	0.005017%	631569	96.01%	24	7.50%
厭	1786		14	33	0.005017%	631602	96.02%	27	8.44%
孟	1787		8	33	0.005017%	631635	96.02%	16	5.00%
慨	1788		12	33	0.005017%	631668	96.03%	30	9.38%
披	1789		8	33	0.005017%	631701	96.03%	23	7.19%
挫	1790		10	33	0.005017%	631734	96.04%	29	9.06%
捲	1791		11	33	0.005017%	631767	96.04%	26	8.13%
晃	1792		10	33	0.005017%	631800	96.05%	24	7.50%
棵	1793		12	33	0.005017%	631833	96.05%	21	6.56%
淪	1794		11	33	0.005017%	631866	96.06%	27	8.44%
漠	1795		14	33	0.005017%	631899	96.06%	28	8.75%
猜	1796		11	33	0.005017%	631932	96.07%	26	8.13%
盈	1797		9	33	0.005017%	631965	96.07%	18	5.63%
矛	1798		5	33	0.005017%	631998	96.08%	22	6.88%
紹	1799		11	33	0.005017%	632031	96.08%	26	8.13%
羊	1800		6	33	0.005017%	632064	96.09%	12	3.75%
翼	1801		17	33	0.005017%	632097	96.09%	21	6.56%
肚	1802		7	33	0.005017%	632130	96.10%	25	7.81%
蔡	1803		15	33	0.005017%	632163	96.10%	15	4.69%
鼠	1804		13	33	0.005017%	632196	96.11%	12	3.75%
傭	1805		13	32	0.004865%	632228	96.11%	6	1.88%
劑	1806		16	32	0.004865%	632260	96.12%	18	5.63%
叢	1807		18	32	0.004865%	632292	96.12%	25	7.81%
娛	1808		10	32	0.004865%	632324	96.13%	18	5.63%
寸	1809		3	32	0.004865%	632356	96.13%	22	6.88%
岩	1810		8	32	0.004865%	632388	96.13%	14	4.38%
嶺	1811		17	32	0.004865%	632420	96.14%	12	3.75%
帆	1812		6	32	0.004865%	632452	96.14%	12	3.75%
廉	1813		13	32	0.004865%	632484	96.15%	19	5.94%
悶	1814		12	32	0.004865%	632516	96.15%	23	7.19%
懸	1815		20	32	0.004865%	632548	96.16%	28	8.75%
扇	1816		10	32	0.004865%	632580	96.16%	25	7.81%
拓	1817		8	32	0.004865%	632612	96.17%	27	8.44%
掩	1818		11	32	0.004865%	632644	96.17%	28	8.75%
朱	1819		6	32	0.004865%	632676	96.18%	26	8.13%
氓	1820		8	32	0.004865%	632708	96.18%	4	1.25%
燦	1821		17	32	0.004865%	632740	96.19%	25	7.81%
犧	1822		21	32	0.004865%	632772	96.19%	26	8.13%
籌	1823		20	32	0.004865%	632804	96.20%	26	8.13%
紋	1824		10	32	0.004865%	632836	96.20%	24	7.50%
罩	1825		13	32	0.004865%	632868	96.21%	13	4.06%
聰	1826		17	32	0.004865%	632900	96.21%	22	6.88%
腔	1827		12	32	0.004865%	632932	96.22%	24	7.50%
荻	1828		11	32	0.004865%	632964	96.22%	2	0.63%
趙	1829		14	32	0.004865%	632996	96.23%	13	4.06%
蹟	1830		18	32	0.004865%	633028	96.23%	25	7.81%
躲	1831		13	32	0.004865%	633060	96.24%	23	7.19%
輔	1832		14	32	0.004865%	633092	96.24%	27	8.44%
醜	1833		17	32	0.004865%	633124	96.25%	25	7.81%
鑑	1834		22	32	0.004865%	633156	96.25%	28	8.75%
鳳	1835		14	32	0.004865%	633188	96.26%	15	4.69%
仿	1836		6	31	0.004713%	633219	96.26%	20	6.25%
俠	1837		9	31	0.004713%	633250	96.27%	12	3.75%
俱	1838		10	31	0.004713%	633281	96.27%	29	9.06%
儒	1839		16	31	0.004713%	633312	96.28%	18	5.63%
冠	1840		9	31	0.004713%	633343	96.28%	23	7.19%
刷	1841		8	31	0.004713%	633374	96.28%	21	6.56%
娃	1842		9	31	0.004713%	633405	96.29%	11	3.44%
宏	1843		7	31	0.004713%	633436	96.29%	24	7.50%
恒	1844		9	31	0.004713%	633467	96.30%	12	3.75%
慕	1845		15	31	0.004713%	633498	96.30%	26	8.13%
扯	1846		7	31	0.004713%	633529	96.31%	23	7.19%
捐	1847		10	31	0.004713%	633560	96.31%	22	6.88%
掘	1848		11	31	0.004713%	633591	96.32%	22	6.88%
撫	1849		15	31	0.004713%	633622	96.32%	29	9.06%
梅	1850		11	31	0.004713%	633653	96.33%	19	5.94%
汪	1851		7	31	0.004713%	633684	96.33%	13	4.06%
泣	1852		8	31	0.004713%	633715	96.34%	23	7.19%
泊	1853		8	31	0.004713%	633746	96.34%	23	7.19%
炎	1854		8	31	0.004713%	633777	96.35%	23	7.19%
祕	1855		9	31	0.004713%	633808	96.35%	22	6.88%
絡	1856		12	31	0.004713%	633839	96.36%	21	6.56%
聊	1857		11	31	0.004713%	633870	96.36%	27	8.44%
胃	1858		9	31	0.004713%	633901	96.36%	20	6.25%
芽	1859		8	31	0.004713%	633932	96.37%	25	7.81%
賭	1860		15	31	0.004713%	633963	96.37%	16	5.00%
辨	1861		16	31	0.004713%	633994	96.38%	23	7.19%
郎	1862		8	31	0.004713%	634025	96.38%	24	7.50%
駛	1863		15	31	0.004713%	634056	96.39%	17	5.31%
伊	1864		6	30	0.004561%	634086	96.39%	20	6.25%
勁	1865		9	30	0.004561%	634116	96.40%	27	8.44%
吞	1866		7	30	0.004561%	634146	96.40%	26	8.13%
墨	1867		15	30	0.004561%	634176	96.41%	27	8.44%
宙	1868		8	30	0.004561%	634206	96.41%	22	6.88%
寺	1869		6	30	0.004561%	634236	96.42%	13	4.06%
庫	1870		10	30	0.004561%	634266	96.42%	19	5.94%
廈	1871		13	30	0.004561%	634296	96.42%	20	6.25%
弊	1872		14	30	0.004561%	634326	96.43%	18	5.63%
恰	1873		9	30	0.004561%	634356	96.43%	24	7.50%
恆	1874		9	30	0.004561%	634386	96.44%	23	7.19%
恕	1875		10	30	0.004561%	634416	96.44%	5	1.56%
慰	1876		15	30	0.004561%	634446	96.45%	23	7.19%
暮	1877		15	30	0.004561%	634476	96.45%	22	6.88%
棟	1878		12	30	0.004561%	634506	96.46%	16	5.00%
漲	1879		14	30	0.004561%	634536	96.46%	27	8.44%
牢	1880		7	30	0.004561%	634566	96.47%	23	7.19%
祥	1881		10	30	0.004561%	634596	96.47%	18	5.63%
稻	1882		15	30	0.004561%	634626	96.48%	19	5.94%
紐	1883		10	30	0.004561%	634656	96.48%	25	7.81%
績	1884		17	30	0.004561%	634686	96.48%	24	7.50%
縫	1885		17	30	0.004561%	634716	96.49%	27	8.44%
臂	1886		17	30	0.004561%	634746	96.49%	21	6.56%
舍	1887		8	30	0.004561%	634776	96.50%	24	7.50%
蔭	1888		15	30	0.004561%	634806	96.50%	19	5.94%
薪	1889		17	30	0.004561%	634836	96.51%	18	5.63%
踐	1890		15	30	0.004561%	634866	96.51%	22	6.88%
券	1891		8	29	0.004409%	634895	96.52%	8	2.50%
卑	1892		8	29	0.004409%	634924	96.52%	24	7.50%
婉	1893		11	29	0.004409%	634953	96.52%	24	7.50%
敲	1894		14	29	0.004409%	634982	96.53%	20	6.25%
斤	1895		4	29	0.004409%	635011	96.53%	18	5.63%
昂	1896		8	29	0.004409%	635040	96.54%	22	6.88%
暢	1897		14	29	0.004409%	635069	96.54%	26	8.13%
柏	1898		9	29	0.004409%	635098	96.55%	21	6.56%
欄	1899		21	29	0.004409%	635127	96.55%	20	6.25%
欺	1900		12	29	0.004409%	635156	96.56%	20	6.25%
毀	1901		13	29	0.004409%	635185	96.56%	27	8.44%
泡	1902		8	29	0.004409%	635214	96.56%	17	5.31%
泉	1903		9	29	0.004409%	635243	96.57%	25	7.81%
浸	1904		10	29	0.004409%	635272	96.57%	24	7.50%
溶	1905		13	29	0.004409%	635301	96.58%	16	5.00%
溜	1906		13	29	0.004409%	635330	96.58%	21	6.56%
燭	1907		17	29	0.004409%	635359	96.59%	13	4.06%
狠	1908		9	29	0.004409%	635388	96.59%	17	5.31%
矣	1909		7	29	0.004409%	635417	96.60%	21	6.56%
碼	1910		15	29	0.004409%	635446	96.60%	26	8.13%
纖	1911		23	29	0.004409%	635475	96.60%	11	3.44%
翎	1912		11	29	0.004409%	635504	96.61%	5	1.56%
艷	1913		24	29	0.004409%	635533	96.61%	24	7.50%
褲	1914		15	29	0.004409%	635562	96.62%	23	7.19%
遂	1915		12	29	0.004409%	635591	96.62%	25	7.81%
井	1916		4	28	0.004257%	635619	96.63%	20	6.25%
俊	1917		9	28	0.004257%	635647	96.63%	16	5.00%
債	1918		13	28	0.004257%	635675	96.63%	11	3.44%
儲	1919		17	28	0.004257%	635703	96.64%	18	5.63%
勾	1920		4	28	0.004257%	635731	96.64%	24	7.50%
圾	1921		7	28	0.004257%	635759	96.65%	19	5.94%
垃	1922		8	28	0.004257%	635787	96.65%	19	5.94%
弦	1923		8	28	0.004257%	635815	96.66%	16	5.00%
恢	1924		9	28	0.004257%	635843	96.66%	19	5.94%
惱	1925		12	28	0.004257%	635871	96.66%	24	7.50%
捉	1926		10	28	0.004257%	635899	96.67%	26	8.13%
捧	1927		11	28	0.004257%	635927	96.67%	23	7.19%
搶	1928		13	28	0.004257%	635955	96.68%	24	7.50%
暈	1929		13	28	0.004257%	635983	96.68%	15	4.69%
枚	1930		8	28	0.004257%	636011	96.69%	18	5.63%
泳	1931		8	28	0.004257%	636039	96.69%	15	4.69%
瀆	1932		18	28	0.004257%	636067	96.69%	5	1.56%
熬	1933		15	28	0.004257%	636095	96.70%	19	5.94%
矮	1934		13	28	0.004257%	636123	96.70%	21	6.56%
緻	1935		15	28	0.004257%	636151	96.71%	21	6.56%
肝	1936		7	28	0.004257%	636179	96.71%	11	3.44%
蘆	1937		20	28	0.004257%	636207	96.72%	11	3.44%
覓	1938		11	28	0.004257%	636235	96.72%	21	6.56%
郝	1939		9	28	0.004257%	636263	96.72%	13	4.06%
鍊	1940		17	28	0.004257%	636291	96.73%	19	5.94%
黎	1941		15	28	0.004257%	636319	96.73%	20	6.25%
齒	1942		15	28	0.004257%	636347	96.74%	22	6.88%
伍	1943		6	27	0.004105%	636374	96.74%	24	7.50%
俯	1944		10	27	0.004105%	636401	96.74%	22	6.88%
凌	1945		10	27	0.004105%	636428	96.75%	23	7.19%
剪	1946		11	27	0.004105%	636455	96.75%	16	5.00%
劣	1947		6	27	0.004105%	636482	96.76%	22	6.88%
嘛	1948		14	27	0.004105%	636509	96.76%	19	5.94%
奪	1949		14	27	0.004105%	636536	96.77%	23	7.19%
宰	1950		10	27	0.004105%	636563	96.77%	13	4.06%
挽	1951		10	27	0.004105%	636590	96.77%	24	7.50%
曼	1952		11	27	0.004105%	636617	96.78%	20	6.25%
梵	1953		11	27	0.004105%	636644	96.78%	9	2.81%
殷	1954		10	27	0.004105%	636671	96.79%	18	5.63%
氛	1955		8	27	0.004105%	636698	96.79%	23	7.19%
渾	1956		12	27	0.004105%	636725	96.79%	18	5.63%
澳	1957		16	27	0.004105%	636752	96.80%	16	5.00%
瑰	1958		14	27	0.004105%	636779	96.80%	17	5.31%
瘋	1959		14	27	0.004105%	636806	96.81%	19	5.94%
磅	1960		15	27	0.004105%	636833	96.81%	10	3.13%
腎	1961		12	27	0.004105%	636860	96.81%	4	1.25%
膀	1962		14	27	0.004105%	636887	96.82%	22	6.88%
膜	1963		15	27	0.004105%	636914	96.82%	17	5.31%
芒	1964		7	27	0.004105%	636941	96.83%	20	6.25%
蓄	1965		14	27	0.004105%	636968	96.83%	19	5.94%
虔	1966		10	27	0.004105%	636995	96.84%	19	5.94%
躁	1967		20	27	0.004105%	637022	96.84%	19	5.94%
逆	1968		9	27	0.004105%	637049	96.84%	20	6.25%
遵	1969		15	27	0.004105%	637076	96.85%	24	7.50%
雀	1970		11	27	0.004105%	637103	96.85%	21	6.56%
顛	1971		19	27	0.004105%	637130	96.86%	22	6.88%
馨	1972		20	27	0.004105%	637157	96.86%	21	6.56%
騙	1973		19	27	0.004105%	637184	96.86%	19	5.94%
鼻	1974		14	27	0.004105%	637211	96.87%	21	6.56%
傅	1975		12	26	0.003952%	637237	96.87%	12	3.75%
催	1976		13	26	0.003952%	637263	96.88%	16	5.00%
削	1977		9	26	0.003952%	637289	96.88%	22	6.88%
剝	1978		10	26	0.003952%	637315	96.88%	20	6.25%
勉	1979		9	26	0.003952%	637341	96.89%	25	7.81%
勃	1980		9	26	0.003952%	637367	96.89%	19	5.94%
勒	1981		11	26	0.003952%	637393	96.90%	19	5.94%
厲	1982		15	26	0.003952%	637419	96.90%	22	6.88%
孝	1983		7	26	0.003952%	637445	96.90%	13	4.06%
懶	1984		19	26	0.003952%	637471	96.91%	21	6.56%
扶	1985		7	26	0.003952%	637497	96.91%	20	6.25%
攀	1986		19	26	0.003952%	637523	96.92%	24	7.50%
敦	1987		12	26	0.003952%	637549	96.92%	18	5.63%
柱	1988		9	26	0.003952%	637575	96.92%	13	4.06%
梭	1989		11	26	0.003952%	637601	96.93%	23	7.19%
澄	1990		15	26	0.003952%	637627	96.93%	19	5.94%
潑	1991		15	26	0.003952%	637653	96.94%	19	5.94%
灌	1992		21	26	0.003952%	637679	96.94%	24	7.50%
瓜	1993		5	26	0.003952%	637705	96.94%	16	5.00%
畏	1994		9	26	0.003952%	637731	96.95%	19	5.94%
租	1995		10	26	0.003952%	637757	96.95%	17	5.31%
秩	1996		10	26	0.003952%	637783	96.96%	20	6.25%
羞	1997		11	26	0.003952%	637809	96.96%	20	6.25%
翁	1998		10	26	0.003952%	637835	96.96%	17	5.31%
脹	1999		12	26	0.003952%	637861	96.97%	17	5.31%
膚	2000		15	26	0.003952%	637887	96.97%	22	6.88%
蝴	2001		15	26	0.003952%	637913	96.97%	12	3.75%
裔	2002		13	26	0.003952%	637939	96.98%	9	2.81%
謬	2003		18	26	0.003952%	637965	96.98%	21	6.56%
郊	2004		8	26	0.003952%	637991	96.99%	16	5.00%
錶	2005		16	26	0.003952%	638017	96.99%	7	2.19%
霜	2006		17	26	0.003952%	638043	96.99%	20	6.25%
丸	2007		3	25	0.0038%	638068	97.00%	6	1.88%
倦	2008		10	25	0.0038%	638093	97.00%	19	5.94%
勸	2009		20	25	0.0038%	638118	97.01%	21	6.56%
吾	2010		7	25	0.0038%	638143	97.01%	18	5.63%
吻	2011		7	25	0.0038%	638168	97.01%	18	5.63%
喃	2012		12	25	0.0038%	638193	97.02%	13	4.06%
嫁	2013		13	25	0.0038%	638218	97.02%	19	5.94%
嫩	2014		14	25	0.0038%	638243	97.02%	15	4.69%
屏	2015		9	25	0.0038%	638268	97.03%	16	5.00%
抒	2016		7	25	0.0038%	638293	97.03%	13	4.06%
桂	2017		10	25	0.0038%	638318	97.04%	10	3.13%
湯	2018		12	25	0.0038%	638343	97.04%	20	6.25%
漆	2019		14	25	0.0038%	638368	97.04%	15	4.69%
盲	2020		8	25	0.0038%	638393	97.05%	19	5.94%
碗	2021		13	25	0.0038%	638418	97.05%	18	5.63%
祂	2022		7	25	0.0038%	638443	97.06%	5	1.56%
稚	2023		13	25	0.0038%	638468	97.06%	20	6.25%
紫	2024		12	25	0.0038%	638493	97.06%	16	5.00%
綜	2025		14	25	0.0038%	638518	97.07%	20	6.25%
腰	2026		13	25	0.0038%	638543	97.07%	22	6.88%
舟	2027		6	25	0.0038%	638568	97.07%	20	6.25%
芬	2028		8	25	0.0038%	638593	97.08%	20	6.25%
蒂	2029		13	25	0.0038%	638618	97.08%	18	5.63%
誓	2030		14	25	0.0038%	638643	97.09%	20	6.25%
誼	2031		15	25	0.0038%	638668	97.09%	22	6.88%
諒	2032		15	25	0.0038%	638693	97.09%	16	5.00%
譽	2033		21	25	0.0038%	638718	97.10%	20	6.25%
軌	2034		9	25	0.0038%	638743	97.10%	19	5.94%
遮	2035		14	25	0.0038%	638768	97.10%	22	6.88%
銘	2036		14	25	0.0038%	638793	97.11%	18	5.63%
駕	2037		15	25	0.0038%	638818	97.11%	19	5.94%
側	2038		11	24	0.003648%	638842	97.12%	17	5.31%
呆	2039		7	24	0.003648%	638866	97.12%	18	5.63%
喧	2040		12	24	0.003648%	638890	97.12%	20	6.25%
噴	2041		15	24	0.003648%	638914	97.13%	16	5.00%
姑	2042		8	24	0.003648%	638938	97.13%	19	5.94%
崩	2043		11	24	0.003648%	638962	97.13%	23	7.19%
幢	2044		15	24	0.003648%	638986	97.14%	15	4.69%
悵	2045		11	24	0.003648%	639010	97.14%	18	5.63%
截	2046		14	24	0.003648%	639034	97.15%	22	6.88%
扁	2047		9	24	0.003648%	639058	97.15%	13	4.06%
抹	2048		8	24	0.003648%	639082	97.15%	19	5.94%
撲	2049		15	24	0.003648%	639106	97.16%	20	6.25%
撒	2050		15	24	0.003648%	639130	97.16%	17	5.31%
桑	2051		10	24	0.003648%	639154	97.16%	19	5.94%
檔	2052		17	24	0.003648%	639178	97.17%	13	4.06%
沾	2053		8	24	0.003648%	639202	97.17%	20	6.25%
溢	2054		13	24	0.003648%	639226	97.17%	20	6.25%
漏	2055		14	24	0.003648%	639250	97.18%	20	6.25%
煥	2056		13	24	0.003648%	639274	97.18%	11	3.44%
睜	2057		13	24	0.003648%	639298	97.19%	18	5.63%
碑	2058		13	24	0.003648%	639322	97.19%	15	4.69%
筋	2059		12	24	0.003648%	639346	97.19%	23	7.19%
臥	2060		8	24	0.003648%	639370	97.20%	18	5.63%
蛇	2061		11	24	0.003648%	639394	97.20%	14	4.38%
蜜	2062		14	24	0.003648%	639418	97.20%	19	5.94%
謙	2063		17	24	0.003648%	639442	97.21%	21	6.56%
鄭	2064		14	24	0.003648%	639466	97.21%	16	5.00%
鑽	2065		27	24	0.003648%	639490	97.21%	18	5.63%
驕	2066		22	24	0.003648%	639514	97.22%	18	5.63%
鶴	2067		21	24	0.003648%	639538	97.22%	14	4.38%
鹿	2068		11	24	0.003648%	639562	97.23%	11	3.44%
黯	2069		21	24	0.003648%	639586	97.23%	21	6.56%
亭	2070		9	23	0.003496%	639609	97.23%	18	5.63%
叮	2071		5	23	0.003496%	639632	97.24%	15	4.69%
咬	2072		9	23	0.003496%	639655	97.24%	21	6.56%
喻	2073		12	23	0.003496%	639678	97.24%	19	5.94%
嗔	2074		13	23	0.003496%	639701	97.25%	5	1.56%
嚮	2075		18	23	0.003496%	639724	97.25%	20	6.25%
塔	2076		13	23	0.003496%	639747	97.25%	19	5.94%
姆	2077		8	23	0.003496%	639770	97.26%	12	3.75%
嫌	2078		13	23	0.003496%	639793	97.26%	15	4.69%
寓	2079		12	23	0.003496%	639816	97.26%	18	5.63%
帽	2080		12	23	0.003496%	639839	97.27%	16	5.00%
戚	2081		11	23	0.003496%	639862	97.27%	17	5.31%
扛	2082		6	23	0.003496%	639885	97.27%	15	4.69%
柵	2083		9	23	0.003496%	639908	97.28%	7	2.19%
瑪	2084		14	23	0.003496%	639931	97.28%	15	4.69%
甫	2085		7	23	0.003496%	639954	97.29%	16	5.00%
盧	2086		16	23	0.003496%	639977	97.29%	11	3.44%
碩	2087		14	23	0.003496%	640000	97.29%	21	6.56%
箱	2088		15	23	0.003496%	640023	97.30%	16	5.00%
虐	2089		9	23	0.003496%	640046	97.30%	16	5.00%
賄	2090		13	23	0.003496%	640069	97.30%	8	2.50%
逸	2091		11	23	0.003496%	640092	97.31%	19	5.94%
鍋	2092		17	23	0.003496%	640115	97.31%	14	4.38%
云	2093		4	22	0.003344%	640137	97.31%	15	4.69%
伙	2094		6	22	0.003344%	640159	97.32%	18	5.63%
偽	2095		11	22	0.003344%	640181	97.32%	16	5.00%
傻	2096		13	22	0.003344%	640203	97.32%	14	4.38%
吊	2097		6	22	0.003344%	640225	97.33%	18	5.63%
堡	2098		12	22	0.003344%	640247	97.33%	15	4.69%
填	2099		13	22	0.003344%	640269	97.33%	15	4.69%
媳	2100		13	22	0.003344%	640291	97.34%	11	3.44%
宛	2101		8	22	0.003344%	640313	97.34%	11	3.44%
愧	2102		13	22	0.003344%	640335	97.34%	17	5.31%
懇	2103		17	22	0.003344%	640357	97.35%	19	5.94%
拆	2104		8	22	0.003344%	640379	97.35%	19	5.94%
撤	2105		14	22	0.003344%	640401	97.35%	12	3.75%
摯	2106		15	22	0.003344%	640423	97.36%	16	5.00%
暑	2107		12	22	0.003344%	640445	97.36%	16	5.00%
欠	2108		4	22	0.003344%	640467	97.36%	16	5.00%
毅	2109		15	22	0.003344%	640489	97.37%	19	5.94%
津	2110		9	22	0.003344%	640511	97.37%	15	4.69%
潰	2111		15	22	0.003344%	640533	97.37%	18	5.63%
煮	2112		12	22	0.003344%	640555	97.38%	14	4.38%
畔	2113		10	22	0.003344%	640577	97.38%	18	5.63%
眸	2114		11	22	0.003344%	640599	97.38%	18	5.63%
祈	2115		8	22	0.003344%	640621	97.39%	12	3.75%
秤	2116		10	22	0.003344%	640643	97.39%	7	2.19%
糟	2117		17	22	0.003344%	640665	97.39%	18	5.63%
締	2118		15	22	0.003344%	640687	97.40%	16	5.00%
罰	2119		14	22	0.003344%	640709	97.40%	11	3.44%
膨	2120		16	22	0.003344%	640731	97.40%	13	4.06%
菌	2121		12	22	0.003344%	640753	97.41%	10	3.13%
衍	2122		9	22	0.003344%	640775	97.41%	19	5.94%
訝	2123		11	22	0.003344%	640797	97.41%	22	6.88%
諷	2124		16	22	0.003344%	640819	97.42%	16	5.00%
迪	2125		8	22	0.003344%	640841	97.42%	12	3.75%
酷	2126		14	22	0.003344%	640863	97.42%	16	5.00%
銅	2127		14	22	0.003344%	640885	97.43%	16	5.00%
鋒	2128		15	22	0.003344%	640907	97.43%	19	5.94%
陋	2129		8	22	0.003344%	640929	97.43%	16	5.00%
髒	2130		22	22	0.003344%	640951	97.44%	18	5.63%
侶	2131		9	21	0.003192%	640972	97.44%	13	4.06%
儉	2132		15	21	0.003192%	640993	97.44%	9	2.81%
咳	2133		9	21	0.003192%	641014	97.45%	10	3.13%
喉	2134		12	21	0.003192%	641035	97.45%	19	5.94%
嘯	2135		15	21	0.003192%	641056	97.45%	17	5.31%
岡	2136		8	21	0.003192%	641077	97.46%	12	3.75%
崗	2137		11	21	0.003192%	641098	97.46%	16	5.00%
怖	2138		8	21	0.003192%	641119	97.46%	18	5.63%
揭	2139		12	21	0.003192%	641140	97.47%	20	6.25%
擱	2140		17	21	0.003192%	641161	97.47%	18	5.63%
攜	2141		21	21	0.003192%	641182	97.47%	16	5.00%
晰	2142		12	21	0.003192%	641203	97.47%	19	5.94%
朽	2143		6	21	0.003192%	641224	97.48%	17	5.31%
沛	2144		7	21	0.003192%	641245	97.48%	16	5.00%
浩	2145		10	21	0.003192%	641266	97.48%	15	4.69%
滄	2146		13	21	0.003192%	641287	97.49%	17	5.31%
澈	2147		14	21	0.003192%	641308	97.49%	19	5.94%
玫	2148		8	21	0.003192%	641329	97.49%	12	3.75%
瑣	2149		14	21	0.003192%	641350	97.50%	19	5.94%
痴	2150		13	21	0.003192%	641371	97.50%	6	1.88%
癮	2151		22	21	0.003192%	641392	97.50%	10	3.13%
皺	2152		15	21	0.003192%	641413	97.51%	18	5.63%
秒	2153		9	21	0.003192%	641434	97.51%	16	5.00%
窩	2154		14	21	0.003192%	641455	97.51%	19	5.94%
粹	2155		14	21	0.003192%	641476	97.52%	13	4.06%
紮	2156		11	21	0.003192%	641497	97.52%	18	5.63%
縷	2157		17	21	0.003192%	641518	97.52%	15	4.69%
罹	2158		16	21	0.003192%	641539	97.53%	8	2.50%
聳	2159		17	21	0.003192%	641560	97.53%	17	5.31%
莽	2160		11	21	0.003192%	641581	97.53%	15	4.69%
裸	2161		13	21	0.003192%	641602	97.54%	12	3.75%
誇	2162		13	21	0.003192%	641623	97.54%	17	5.31%
謎	2163		17	21	0.003192%	641644	97.54%	11	3.44%
辰	2164		7	21	0.003192%	641665	97.55%	17	5.31%
迄	2165		6	21	0.003192%	641686	97.55%	18	5.63%
邏	2166		22	21	0.003192%	641707	97.55%	12	3.75%
郵	2167		11	21	0.003192%	641728	97.55%	16	5.00%
釀	2168		24	21	0.003192%	641749	97.56%	12	3.75%
闆	2169		17	21	0.003192%	641770	97.56%	14	4.38%
闢	2170		21	21	0.003192%	641791	97.56%	15	4.69%
雇	2171		12	21	0.003192%	641812	97.57%	5	1.56%
顫	2172		22	21	0.003192%	641833	97.57%	14	4.38%
伐	2173		6	20	0.00304%	641853	97.57%	13	4.06%
凍	2174		10	20	0.00304%	641873	97.58%	15	4.69%
凱	2175		12	20	0.00304%	641893	97.58%	12	3.75%
凸	2176		5	20	0.00304%	641913	97.58%	16	5.00%
剎	2177		9	20	0.00304%	641933	97.59%	16	5.00%
吵	2178		7	20	0.00304%	641953	97.59%	16	5.00%
圃	2179		10	20	0.00304%	641973	97.59%	8	2.50%
堤	2180		12	20	0.00304%	641993	97.60%	13	4.06%
塗	2181		13	20	0.00304%	642013	97.60%	15	4.69%
壽	2182		14	20	0.00304%	642033	97.60%	17	5.31%
嬌	2183		15	20	0.00304%	642053	97.60%	16	5.00%
庸	2184		11	20	0.00304%	642073	97.61%	15	4.69%
廊	2185		12	20	0.00304%	642093	97.61%	14	4.38%
廚	2186		15	20	0.00304%	642113	97.61%	16	5.00%
恍	2187		9	20	0.00304%	642133	97.62%	17	5.31%
抉	2188		7	20	0.00304%	642153	97.62%	17	5.31%
拳	2189		10	20	0.00304%	642173	97.62%	15	4.69%
旨	2190		6	20	0.00304%	642193	97.63%	13	4.06%
枕	2191		8	20	0.00304%	642213	97.63%	17	5.31%
榜	2192		14	20	0.00304%	642233	97.63%	15	4.69%
浴	2193		10	20	0.00304%	642253	97.63%	17	5.31%
淒	2194		11	20	0.00304%	642273	97.64%	17	5.31%
滔	2195		13	20	0.00304%	642293	97.64%	10	3.13%
疫	2196		9	20	0.00304%	642313	97.64%	8	2.50%
疼	2197		10	20	0.00304%	642333	97.65%	16	5.00%
碟	2198		14	20	0.00304%	642353	97.65%	14	4.38%
綻	2199		14	20	0.00304%	642373	97.65%	17	5.31%
肌	2200		6	20	0.00304%	642393	97.66%	14	4.38%
臭	2201		10	20	0.00304%	642413	97.66%	13	4.06%
舌	2202		6	20	0.00304%	642433	97.66%	19	5.94%
芭	2203		8	20	0.00304%	642453	97.66%	4	1.25%
葡	2204		13	20	0.00304%	642473	97.67%	8	2.50%
薯	2205		17	20	0.00304%	642493	97.67%	9	2.81%
虧	2206		17	20	0.00304%	642513	97.67%	16	5.00%
螢	2207		16	20	0.00304%	642533	97.68%	16	5.00%
註	2208		12	20	0.00304%	642553	97.68%	16	5.00%
赫	2209		14	20	0.00304%	642573	97.68%	12	3.75%
轟	2210		21	20	0.00304%	642593	97.69%	17	5.31%
迢	2211		8	20	0.00304%	642613	97.69%	10	3.13%
鉅	2212		13	20	0.00304%	642633	97.69%	18	5.63%
鞭	2213		18	20	0.00304%	642653	97.70%	14	4.38%
颱	2214		14	20	0.00304%	642673	97.70%	11	3.44%
騷	2215		20	20	0.00304%	642693	97.70%	14	4.38%
乖	2216		8	19	0.002888%	642712	97.70%	12	3.75%
倚	2217		10	19	0.002888%	642731	97.71%	10	3.13%
哨	2218		10	19	0.002888%	642750	97.71%	10	3.13%
嘩	2219		15	19	0.002888%	642769	97.71%	15	4.69%
嚐	2220		17	19	0.002888%	642788	97.72%	9	2.81%
囊	2221		22	19	0.002888%	642807	97.72%	17	5.31%
墜	2222		15	19	0.002888%	642826	97.72%	14	4.38%
壤	2223		20	19	0.002888%	642845	97.72%	14	4.38%
巾	2224		3	19	0.002888%	642864	97.73%	10	3.13%
帳	2225		11	19	0.002888%	642883	97.73%	14	4.38%
彌	2226		17	19	0.002888%	642902	97.73%	18	5.63%
怯	2227		8	19	0.002888%	642921	97.74%	13	4.06%
惟	2228		11	19	0.002888%	642940	97.74%	17	5.31%
斗	2229		4	19	0.002888%	642959	97.74%	12	3.75%
曠	2230		19	19	0.002888%	642978	97.74%	17	5.31%
樁	2231		15	19	0.002888%	642997	97.75%	15	4.69%
歇	2232		13	19	0.002888%	643016	97.75%	17	5.31%
池	2233		6	19	0.002888%	643035	97.75%	17	5.31%
洶	2234		9	19	0.002888%	643054	97.76%	15	4.69%
淹	2235		11	19	0.002888%	643073	97.76%	13	4.06%
淫	2236		11	19	0.002888%	643092	97.76%	17	5.31%
潭	2237		15	19	0.002888%	643111	97.77%	10	3.13%
濛	2238		17	19	0.002888%	643130	97.77%	9	2.81%
澀	2239		17	19	0.002888%	643149	97.77%	12	3.75%
灘	2240		22	19	0.002888%	643168	97.77%	13	4.06%
烤	2241		10	19	0.002888%	643187	97.78%	11	3.44%
焚	2242		12	19	0.002888%	643206	97.78%	15	4.69%
牧	2243		8	19	0.002888%	643225	97.78%	11	3.44%
矯	2244		17	19	0.002888%	643244	97.79%	14	4.38%
稽	2245		15	19	0.002888%	643263	97.79%	16	5.00%
糙	2246		17	19	0.002888%	643282	97.79%	13	4.06%
繳	2247		19	19	0.002888%	643301	97.79%	15	4.69%
罐	2248		24	19	0.002888%	643320	97.80%	14	4.38%
翅	2249		10	19	0.002888%	643339	97.80%	16	5.00%
翩	2250		15	19	0.002888%	643358	97.80%	12	3.75%
萎	2251		12	19	0.002888%	643377	97.81%	16	5.00%
蔽	2252		15	19	0.002888%	643396	97.81%	17	5.31%
薩	2253		18	19	0.002888%	643415	97.81%	13	4.06%
蠢	2254		21	19	0.002888%	643434	97.81%	15	4.69%
裙	2255		12	19	0.002888%	643453	97.82%	11	3.44%
譜	2256		19	19	0.002888%	643472	97.82%	17	5.31%
贊	2257		19	19	0.002888%	643491	97.82%	14	4.38%
輾	2258		17	19	0.002888%	643510	97.83%	17	5.31%
輿	2259		17	19	0.002888%	643529	97.83%	14	4.38%
閩	2260		14	19	0.002888%	643548	97.83%	10	3.13%
閥	2261		14	19	0.002888%	643567	97.83%	7	2.19%
驅	2262		21	19	0.002888%	643586	97.84%	19	5.94%
鵝	2263		18	19	0.002888%	643605	97.84%	12	3.75%
鼎	2264		13	19	0.002888%	643624	97.84%	13	4.06%
僵	2265		15	18	0.002736%	643642	97.85%	16	5.00%
劫	2266		7	18	0.002736%	643660	97.85%	15	4.69%
卜	2267		2	18	0.002736%	643678	97.85%	8	2.50%
叛	2268		9	18	0.002736%	643696	97.85%	16	5.00%
唸	2269		11	18	0.002736%	643714	97.86%	15	4.69%
喬	2270		12	18	0.002736%	643732	97.86%	9	2.81%
墓	2271		14	18	0.002736%	643750	97.86%	15	4.69%
墮	2272		15	18	0.002736%	643768	97.86%	16	5.00%
墾	2273		16	18	0.002736%	643786	97.87%	10	3.13%
寡	2274		14	18	0.002736%	643804	97.87%	13	4.06%
恥	2275		10	18	0.002736%	643822	97.87%	14	4.38%
拚	2276		8	18	0.002736%	643840	97.88%	16	5.00%
擲	2277		18	18	0.002736%	643858	97.88%	16	5.00%
斬	2278		11	18	0.002736%	643876	97.88%	13	4.06%
栽	2279		10	18	0.002736%	643894	97.88%	10	3.13%
楞	2280		13	18	0.002736%	643912	97.89%	10	3.13%
殿	2281		13	18	0.002736%	643930	97.89%	15	4.69%
渺	2282		12	18	0.002736%	643948	97.89%	15	4.69%
漪	2283		14	18	0.002736%	643966	97.89%	5	1.56%
漿	2284		15	18	0.002736%	643984	97.90%	13	4.06%
炒	2285		8	18	0.002736%	644002	97.90%	13	4.06%
瑋	2286		13	18	0.002736%	644020	97.90%	2	0.63%
疇	2287		19	18	0.002736%	644038	97.91%	10	3.13%
瘤	2288		15	18	0.002736%	644056	97.91%	6	1.88%
瞧	2289		17	18	0.002736%	644074	97.91%	13	4.06%
肆	2290		13	18	0.002736%	644092	97.91%	14	4.38%
膝	2291		15	18	0.002736%	644110	97.92%	14	4.38%
艾	2292		6	18	0.002736%	644128	97.92%	12	3.75%
莉	2293		11	18	0.002736%	644146	97.92%	8	2.50%
萄	2294		12	18	0.002736%	644164	97.93%	7	2.19%
蕾	2295		17	18	0.002736%	644182	97.93%	6	1.88%
襟	2296		18	18	0.002736%	644200	97.93%	17	5.31%
詮	2297		13	18	0.002736%	644218	97.93%	16	5.00%
賀	2298		12	18	0.002736%	644236	97.94%	11	3.44%
蹲	2299		19	18	0.002736%	644254	97.94%	14	4.38%
郁	2300		8	18	0.002736%	644272	97.94%	15	4.69%
頌	2301		13	18	0.002736%	644290	97.94%	15	4.69%
馮	2302		12	18	0.002736%	644308	97.95%	8	2.50%
驟	2303		24	18	0.002736%	644326	97.95%	15	4.69%
亟	2304		8	17	0.002584%	644343	97.95%	14	4.38%
仗	2305		5	17	0.002584%	644360	97.95%	11	3.44%
倆	2306		10	17	0.002584%	644377	97.96%	14	4.38%
允	2307		4	17	0.002584%	644394	97.96%	16	5.00%
凋	2308		10	17	0.002584%	644411	97.96%	13	4.06%
吼	2309		7	17	0.002584%	644428	97.97%	14	4.38%
喘	2310		12	17	0.002584%	644445	97.97%	15	4.69%
囂	2311		21	17	0.002584%	644462	97.97%	16	5.00%
址	2312		7	17	0.002584%	644479	97.97%	9	2.81%
姨	2313		9	17	0.002584%	644496	97.98%	7	2.19%
媚	2314		12	17	0.002584%	644513	97.98%	15	4.69%
媜	2315		12	17	0.002584%	644530	97.98%	1	0.31%
履	2316		15	17	0.002584%	644547	97.98%	11	3.44%
役	2317		7	17	0.002584%	644564	97.99%	13	4.06%
徊	2318		9	17	0.002584%	644581	97.99%	13	4.06%
憬	2319		15	17	0.002584%	644598	97.99%	13	4.06%
抖	2320		7	17	0.002584%	644615	97.99%	14	4.38%
捷	2321		11	17	0.002584%	644632	98.00%	14	4.38%
摘	2322		14	17	0.002584%	644649	98.00%	13	4.06%
撰	2323		15	17	0.002584%	644666	98.00%	14	4.38%
攪	2324		23	17	0.002584%	644683	98.00%	16	5.00%
昭	2325		9	17	0.002584%	644700	98.01%	13	4.06%
曬	2326		23	17	0.002584%	644717	98.01%	13	4.06%
汁	2327		5	17	0.002584%	644734	98.01%	9	2.81%
熙	2328		14	17	0.002584%	644751	98.01%	11	3.44%
爺	2329		13	17	0.002584%	644768	98.02%	12	3.75%
眷	2330		11	17	0.002584%	644785	98.02%	12	3.75%
砍	2331		9	17	0.002584%	644802	98.02%	11	3.44%
筒	2332		12	17	0.002584%	644819	98.02%	13	4.06%
耗	2333		10	17	0.002584%	644836	98.03%	15	4.69%
肖	2334		7	17	0.002584%	644853	98.03%	8	2.50%
脖	2335		11	17	0.002584%	644870	98.03%	11	3.44%
臣	2336		6	17	0.002584%	644887	98.04%	14	4.38%
藩	2337		19	17	0.002584%	644904	98.04%	4	1.25%
蝕	2338		14	17	0.002584%	644921	98.04%	15	4.69%
覽	2339		21	17	0.002584%	644938	98.04%	15	4.69%
誘	2340		14	17	0.002584%	644955	98.05%	15	4.69%
踩	2341		15	17	0.002584%	644972	98.05%	16	5.00%
銜	2342		14	17	0.002584%	644989	98.05%	15	4.69%
錦	2343		16	17	0.002584%	645006	98.05%	15	4.69%
隙	2344		13	17	0.002584%	645023	98.06%	15	4.69%
魁	2345		14	17	0.002584%	645040	98.06%	6	1.88%
乍	2346		5	16	0.002432%	645056	98.06%	15	4.69%
佇	2347		7	16	0.002432%	645072	98.06%	14	4.38%
佩	2348		8	16	0.002432%	645088	98.07%	14	4.38%
函	2349		8	16	0.002432%	645104	98.07%	11	3.44%
哦	2350		10	16	0.002432%	645120	98.07%	12	3.75%
啞	2351		11	16	0.002432%	645136	98.07%	8	2.50%
啼	2352		12	16	0.002432%	645152	98.08%	14	4.38%
嗜	2353		13	16	0.002432%	645168	98.08%	12	3.75%
嘻	2354		15	16	0.002432%	645184	98.08%	7	2.19%
噪	2355		16	16	0.002432%	645200	98.08%	9	2.81%
坎	2356		7	16	0.002432%	645216	98.09%	15	4.69%
埃	2357		10	16	0.002432%	645232	98.09%	10	3.13%
塌	2358		13	16	0.002432%	645248	98.09%	10	3.13%
壘	2359		18	16	0.002432%	645264	98.09%	13	4.06%
夷	2360		6	16	0.002432%	645280	98.09%	12	3.75%
奢	2361		11	16	0.002432%	645296	98.10%	15	4.69%
妄	2362		6	16	0.002432%	645312	98.10%	13	4.06%
尹	2363		4	16	0.002432%	645328	98.10%	8	2.50%
屠	2364		11	16	0.002432%	645344	98.10%	8	2.50%
帕	2365		8	16	0.002432%	645360	98.11%	11	3.44%
廂	2366		12	16	0.002432%	645376	98.11%	14	4.38%
彰	2367		14	16	0.002432%	645392	98.11%	11	3.44%
徘	2368		11	16	0.002432%	645408	98.11%	12	3.75%
慌	2369		13	16	0.002432%	645424	98.12%	14	4.38%
擋	2370		16	16	0.002432%	645440	98.12%	16	5.00%
攘	2371		20	16	0.002432%	645456	98.12%	11	3.44%
斑	2372		12	16	0.002432%	645472	98.12%	11	3.44%
曦	2373		20	16	0.002432%	645488	98.13%	4	1.25%
櫥	2374		19	16	0.002432%	645504	98.13%	12	3.75%
淵	2375		11	16	0.002432%	645520	98.13%	16	5.00%
溺	2376		13	16	0.002432%	645536	98.13%	10	3.13%
濁	2377		16	16	0.002432%	645552	98.14%	13	4.06%
煞	2378		13	16	0.002432%	645568	98.14%	14	4.38%
爽	2379		11	16	0.002432%	645584	98.14%	13	4.06%
狼	2380		10	16	0.002432%	645600	98.14%	15	4.69%
瞎	2381		15	16	0.002432%	645616	98.15%	10	3.13%
祭	2382		11	16	0.002432%	645632	98.15%	12	3.75%
禽	2383		13	16	0.002432%	645648	98.15%	10	3.13%
禿	2384		7	16	0.002432%	645664	98.15%	5	1.56%
秉	2385		8	16	0.002432%	645680	98.16%	12	3.75%
稼	2386		15	16	0.002432%	645696	98.16%	7	2.19%
笨	2387		11	16	0.002432%	645712	98.16%	9	2.81%
箋	2388		14	16	0.002432%	645728	98.16%	5	1.56%
繡	2389		18	16	0.002432%	645744	98.17%	10	3.13%
翔	2390		12	16	0.002432%	645760	98.17%	14	4.38%
聆	2391		11	16	0.002432%	645776	98.17%	13	4.06%
膠	2392		15	16	0.002432%	645792	98.17%	15	4.69%
茁	2393		9	16	0.002432%	645808	98.18%	13	4.06%
茲	2394		10	16	0.002432%	645824	98.18%	11	3.44%
萌	2395		12	16	0.002432%	645840	98.18%	16	5.00%
蓬	2396		15	16	0.002432%	645856	98.18%	14	4.38%
虹	2397		9	16	0.002432%	645872	98.18%	14	4.38%
衫	2398		8	16	0.002432%	645888	98.19%	15	4.69%
襄	2399		17	16	0.002432%	645904	98.19%	5	1.56%
諱	2400		16	16	0.002432%	645920	98.19%	16	5.00%
跋	2401		12	16	0.002432%	645936	98.19%	12	3.75%
輒	2402		14	16	0.002432%	645952	98.20%	14	4.38%
逛	2403		10	16	0.002432%	645968	98.20%	11	3.44%
遣	2404		13	16	0.002432%	645984	98.20%	11	3.44%
邪	2405		6	16	0.002432%	646000	98.20%	14	4.38%
醞	2406		17	16	0.002432%	646016	98.21%	10	3.13%
醬	2407		18	16	0.002432%	646032	98.21%	9	2.81%
霍	2408		16	16	0.002432%	646048	98.21%	9	2.81%
霸	2409		21	16	0.002432%	646064	98.21%	13	4.06%
靖	2410		13	16	0.002432%	646080	98.22%	4	1.25%
頑	2411		13	16	0.002432%	646096	98.22%	15	4.69%
頒	2412		13	16	0.002432%	646112	98.22%	10	3.13%
頹	2413		16	16	0.002432%	646128	98.22%	13	4.06%
魅	2414		15	16	0.002432%	646144	98.23%	13	4.06%
鵑	2415		18	16	0.002432%	646160	98.23%	6	1.88%
僻	2416		15	15	0.00228%	646175	98.23%	13	4.06%
卓	2417		8	15	0.00228%	646190	98.23%	12	3.75%
哺	2418		10	15	0.00228%	646205	98.24%	4	1.25%
唇	2419		10	15	0.00228%	646220	98.24%	13	4.06%
夥	2420		14	15	0.00228%	646235	98.24%	13	4.06%
峻	2421		10	15	0.00228%	646250	98.24%	12	3.75%
惹	2422		13	15	0.00228%	646265	98.24%	12	3.75%
戈	2423		4	15	0.00228%	646280	98.25%	13	4.06%
拂	2424		8	15	0.00228%	646295	98.25%	11	3.44%
撼	2425		16	15	0.00228%	646310	98.25%	13	4.06%
昌	2426		8	15	0.00228%	646325	98.25%	10	3.13%
晉	2427		10	15	0.00228%	646340	98.26%	13	4.06%
桿	2428		11	15	0.00228%	646355	98.26%	10	3.13%
棘	2429		12	15	0.00228%	646370	98.26%	15	4.69%
棋	2430		12	15	0.00228%	646385	98.26%	10	3.13%
歪	2431		9	15	0.00228%	646400	98.27%	13	4.06%
泌	2432		8	15	0.00228%	646415	98.27%	8	2.50%
淘	2433		11	15	0.00228%	646430	98.27%	13	4.06%
湊	2434		12	15	0.00228%	646445	98.27%	14	4.38%
烘	2435		10	15	0.00228%	646460	98.27%	11	3.44%
熄	2436		14	15	0.00228%	646475	98.28%	12	3.75%
爍	2437		19	15	0.00228%	646490	98.28%	14	4.38%
玄	2438		5	15	0.00228%	646505	98.28%	11	3.44%
瑩	2439		15	15	0.00228%	646520	98.28%	14	4.38%
痞	2440		12	15	0.00228%	646535	98.29%	3	0.94%
癖	2441		18	15	0.00228%	646550	98.29%	6	1.88%
盜	2442		12	15	0.00228%	646565	98.29%	11	3.44%
睹	2443		13	15	0.00228%	646580	98.29%	15	4.69%
瞻	2444		18	15	0.00228%	646595	98.29%	12	3.75%
砲	2445		10	15	0.00228%	646610	98.30%	8	2.50%
秦	2446		10	15	0.00228%	646625	98.30%	11	3.44%
穫	2447		19	15	0.00228%	646640	98.30%	13	4.06%
竿	2448		9	15	0.00228%	646655	98.30%	9	2.81%
籤	2449		23	15	0.00228%	646670	98.31%	10	3.13%
糞	2450		17	15	0.00228%	646685	98.31%	6	1.88%
耍	2451		9	15	0.00228%	646700	98.31%	12	3.75%
聘	2452		13	15	0.00228%	646715	98.31%	12	3.75%
脣	2453		11	15	0.00228%	646730	98.32%	10	3.13%
膛	2454		15	15	0.00228%	646745	98.32%	9	2.81%
茂	2455		9	15	0.00228%	646760	98.32%	12	3.75%
蔣	2456		15	15	0.00228%	646775	98.32%	11	3.44%
蘊	2457		20	15	0.00228%	646790	98.32%	14	4.38%
蚊	2458		10	15	0.00228%	646805	98.33%	8	2.50%
蟹	2459		19	15	0.00228%	646820	98.33%	7	2.19%
袱	2460		11	15	0.00228%	646835	98.33%	10	3.13%
褪	2461		15	15	0.00228%	646850	98.33%	14	4.38%
証	2462		12	15	0.00228%	646865	98.34%	8	2.50%
誦	2463		14	15	0.00228%	646880	98.34%	12	3.75%
諮	2464		16	15	0.00228%	646895	98.34%	9	2.81%
謠	2465		17	15	0.00228%	646910	98.34%	11	3.44%
趁	2466		12	15	0.00228%	646925	98.34%	13	4.06%
軀	2467		18	15	0.00228%	646940	98.35%	14	4.38%
酌	2468		10	15	0.00228%	646955	98.35%	13	4.06%
錫	2469		16	15	0.00228%	646970	98.35%	9	2.81%
霞	2470		17	15	0.00228%	646985	98.35%	13	4.06%
韻	2471		19	15	0.00228%	647000	98.36%	13	4.06%
鷹	2472		24	15	0.00228%	647015	98.36%	13	4.06%
倖	2473		10	14	0.002128%	647029	98.36%	13	4.06%
倉	2474		10	14	0.002128%	647043	98.36%	13	4.06%
兢	2475		14	14	0.002128%	647057	98.36%	6	1.88%
冥	2476		10	14	0.002128%	647071	98.37%	12	3.75%
卒	2477		8	14	0.002128%	647085	98.37%	11	3.44%
咯	2478		9	14	0.002128%	647099	98.37%	6	1.88%
唉	2479		10	14	0.002128%	647113	98.37%	12	3.75%
嘉	2480		14	14	0.002128%	647127	98.38%	11	3.44%
嘲	2481		15	14	0.002128%	647141	98.38%	12	3.75%
坷	2482		8	14	0.002128%	647155	98.38%	13	4.06%
墳	2483		15	14	0.002128%	647169	98.38%	10	3.13%
奠	2484		12	14	0.002128%	647183	98.38%	11	3.44%
娜	2485		10	14	0.002128%	647197	98.39%	7	2.19%
寮	2486		15	14	0.002128%	647211	98.39%	6	1.88%
巡	2487		7	14	0.002128%	647225	98.39%	11	3.44%
掠	2488		11	14	0.002128%	647239	98.39%	13	4.06%
摔	2489		14	14	0.002128%	647253	98.39%	10	3.13%
摧	2490		14	14	0.002128%	647267	98.40%	13	4.06%
撿	2491		16	14	0.002128%	647281	98.40%	9	2.81%
框	2492		10	14	0.002128%	647295	98.40%	10	3.13%
梳	2493		10	14	0.002128%	647309	98.40%	12	3.75%
棚	2494		12	14	0.002128%	647323	98.41%	7	2.19%
樑	2495		15	14	0.002128%	647337	98.41%	13	4.06%
殼	2496		12	14	0.002128%	647351	98.41%	12	3.75%
溯	2497		13	14	0.002128%	647365	98.41%	13	4.06%
煌	2498		13	14	0.002128%	647379	98.41%	13	4.06%
甦	2499		12	14	0.002128%	647393	98.42%	13	4.06%
眺	2500		11	14	0.002128%	647407	98.42%	9	2.81%
禪	2501		16	14	0.002128%	647421	98.42%	10	3.13%
簷	2502		19	14	0.002128%	647435	98.42%	13	4.06%
縛	2503		16	14	0.002128%	647449	98.42%	13	4.06%
繩	2504		19	14	0.002128%	647463	98.43%	14	4.38%
肢	2505		8	14	0.002128%	647477	98.43%	11	3.44%
腫	2506		13	14	0.002128%	647491	98.43%	11	3.44%
臘	2507		19	14	0.002128%	647505	98.43%	11	3.44%
舖	2508		15	14	0.002128%	647519	98.44%	13	4.06%
蕉	2509		16	14	0.002128%	647533	98.44%	10	3.13%
藷	2510		19	14	0.002128%	647547	98.44%	2	0.63%
蘿	2511		23	14	0.002128%	647561	98.44%	8	2.50%
蜂	2512		13	14	0.002128%	647575	98.44%	10	3.13%
裳	2513		14	14	0.002128%	647589	98.45%	12	3.75%
裹	2514		14	14	0.002128%	647603	98.45%	13	4.06%
襯	2515		21	14	0.002128%	647617	98.45%	13	4.06%
詭	2516		13	14	0.002128%	647631	98.45%	10	3.13%
豫	2517		16	14	0.002128%	647645	98.45%	11	3.44%
貞	2518		9	14	0.002128%	647659	98.46%	7	2.19%
賤	2519		15	14	0.002128%	647673	98.46%	10	3.13%
逗	2520		10	14	0.002128%	647687	98.46%	12	3.75%
遼	2521		15	14	0.002128%	647701	98.46%	14	4.38%
釘	2522		10	14	0.002128%	647715	98.46%	10	3.13%
餓	2523		15	14	0.002128%	647729	98.47%	12	3.75%
饋	2524		20	14	0.002128%	647743	98.47%	8	2.50%
魄	2525		15	14	0.002128%	647757	98.47%	12	3.75%
鴨	2526		16	14	0.002128%	647771	98.47%	10	3.13%
麟	2527		23	14	0.002128%	647785	98.48%	7	2.19%
丘	2528		5	13	0.001976%	647798	98.48%	10	3.13%
乙	2529		1	13	0.001976%	647811	98.48%	5	1.56%
兔	2530		8	13	0.001976%	647824	98.48%	9	2.81%
冤	2531		10	13	0.001976%	647837	98.48%	11	3.44%
卵	2532		7	13	0.001976%	647850	98.49%	7	2.19%
卸	2533		8	13	0.001976%	647863	98.49%	10	3.13%
卿	2534		10	13	0.001976%	647876	98.49%	9	2.81%
吏	2535		6	13	0.001976%	647889	98.49%	6	1.88%
吱	2536		7	13	0.001976%	647902	98.49%	5	1.56%
啪	2537		11	13	0.001976%	647915	98.50%	5	1.56%
嗽	2538		14	13	0.001976%	647928	98.50%	8	2.50%
囚	2539		5	13	0.001976%	647941	98.50%	7	2.19%
坊	2540		7	13	0.001976%	647954	98.50%	11	3.44%
寵	2541		19	13	0.001976%	647967	98.50%	11	3.44%
屑	2542		10	13	0.001976%	647980	98.51%	11	3.44%
岳	2543		8	13	0.001976%	647993	98.51%	7	2.19%
幟	2544		15	13	0.001976%	648006	98.51%	12	3.75%
廝	2545		15	13	0.001976%	648019	98.51%	12	3.75%
弓	2546		3	13	0.001976%	648032	98.51%	8	2.50%
征	2547		8	13	0.001976%	648045	98.52%	11	3.44%
忡	2548		7	13	0.001976%	648058	98.52%	7	2.19%
惚	2549		11	13	0.001976%	648071	98.52%	12	3.75%
挾	2550		10	13	0.001976%	648084	98.52%	13	4.06%
挨	2551		10	13	0.001976%	648097	98.52%	9	2.81%
擅	2552		16	13	0.001976%	648110	98.52%	12	3.75%
昊	2553		8	13	0.001976%	648123	98.53%	2	0.63%
曰	2554		4	13	0.001976%	648136	98.53%	10	3.13%
毋	2555		4	13	0.001976%	648149	98.53%	10	3.13%
澎	2556		15	13	0.001976%	648162	98.53%	10	3.13%
焉	2557		11	13	0.001976%	648175	98.53%	11	3.44%
煉	2558		13	13	0.001976%	648188	98.54%	11	3.44%
珊	2559		9	13	0.001976%	648201	98.54%	11	3.44%
瑜	2560		13	13	0.001976%	648214	98.54%	5	1.56%
癱	2561		24	13	0.001976%	648227	98.54%	12	3.75%
瞇	2562		15	13	0.001976%	648240	98.54%	8	2.50%
瞬	2563		17	13	0.001976%	648253	98.55%	13	4.06%
硝	2564		12	13	0.001976%	648266	98.55%	1	0.31%
禱	2565		18	13	0.001976%	648279	98.55%	11	3.44%
穎	2566		16	13	0.001976%	648292	98.55%	12	3.75%
簿	2567		19	13	0.001976%	648305	98.55%	11	3.44%
耽	2568		10	13	0.001976%	648318	98.56%	12	3.75%
脊	2569		10	13	0.001976%	648331	98.56%	10	3.13%
膩	2570		16	13	0.001976%	648344	98.56%	11	3.44%
菩	2571		12	13	0.001976%	648357	98.56%	9	2.81%
葬	2572		13	13	0.001976%	648370	98.56%	12	3.75%
蘋	2573		20	13	0.001976%	648383	98.57%	10	3.13%
蟻	2574		19	13	0.001976%	648396	98.57%	8	2.50%
豎	2575		15	13	0.001976%	648409	98.57%	9	2.81%
豔	2576		28	13	0.001976%	648422	98.57%	10	3.13%
跪	2577		13	13	0.001976%	648435	98.57%	8	2.50%
踢	2578		15	13	0.001976%	648448	98.58%	10	3.13%
頃	2579		11	13	0.001976%	648461	98.58%	12	3.75%
頸	2580		16	13	0.001976%	648474	98.58%	13	4.06%
颯	2581		14	13	0.001976%	648487	98.58%	3	0.94%
飢	2582		10	13	0.001976%	648500	98.58%	10	3.13%
餵	2583		17	13	0.001976%	648513	98.59%	7	2.19%
駭	2584		16	13	0.001976%	648526	98.59%	12	3.75%
鴻	2585		17	13	0.001976%	648539	98.59%	12	3.75%
侯	2586		9	12	0.001824%	648551	98.59%	5	1.56%
倬	2587		10	12	0.001824%	648563	98.59%	1	0.31%
僕	2588		14	12	0.001824%	648575	98.60%	7	2.19%
僑	2589		14	12	0.001824%	648587	98.60%	10	3.13%
兮	2590		4	12	0.001824%	648599	98.60%	8	2.50%
剔	2591		10	12	0.001824%	648611	98.60%	11	3.44%
勿	2592		4	12	0.001824%	648623	98.60%	8	2.50%
卅	2593		4	12	0.001824%	648635	98.60%	11	3.44%
吶	2594		7	12	0.001824%	648647	98.61%	10	3.13%
咎	2595		8	12	0.001824%	648659	98.61%	11	3.44%
嗓	2596		13	12	0.001824%	648671	98.61%	9	2.81%
噩	2597		16	12	0.001824%	648683	98.61%	8	2.50%
妝	2598		7	12	0.001824%	648695	98.61%	11	3.44%
屢	2599		14	12	0.001824%	648707	98.62%	10	3.13%
弗	2600		5	12	0.001824%	648719	98.62%	7	2.19%
怡	2601		8	12	0.001824%	648731	98.62%	9	2.81%
慚	2602		14	12	0.001824%	648743	98.62%	10	3.13%
憫	2603		15	12	0.001824%	648755	98.62%	11	3.44%
拘	2604		8	12	0.001824%	648767	98.62%	11	3.44%
拼	2605		9	12	0.001824%	648779	98.63%	12	3.75%
拭	2606		9	12	0.001824%	648791	98.63%	9	2.81%
掀	2607		11	12	0.001824%	648803	98.63%	10	3.13%
搗	2608		13	12	0.001824%	648815	98.63%	8	2.50%
昧	2609		9	12	0.001824%	648827	98.63%	9	2.81%
札	2610		5	12	0.001824%	648839	98.64%	8	2.50%
梁	2611		11	12	0.001824%	648851	98.64%	9	2.81%
梢	2612		11	12	0.001824%	648863	98.64%	9	2.81%
械	2613		11	12	0.001824%	648875	98.64%	9	2.81%
棕	2614		12	12	0.001824%	648887	98.64%	9	2.81%
檯	2615		18	12	0.001824%	648899	98.64%	8	2.50%
氾	2616		5	12	0.001824%	648911	98.65%	11	3.44%
沫	2617		8	12	0.001824%	648923	98.65%	11	3.44%
淌	2618		11	12	0.001824%	648935	98.65%	11	3.44%
渥	2619		12	12	0.001824%	648947	98.65%	3	0.94%
渣	2620		12	12	0.001824%	648959	98.65%	6	1.88%
炭	2621		9	12	0.001824%	648971	98.66%	8	2.50%
獅	2622		13	12	0.001824%	648983	98.66%	11	3.44%
琳	2623		12	12	0.001824%	648995	98.66%	5	1.56%
疆	2624		19	12	0.001824%	649007	98.66%	11	3.44%
砂	2625		9	12	0.001824%	649019	98.66%	8	2.50%
碳	2626		14	12	0.001824%	649031	98.66%	6	1.88%
穴	2627		5	12	0.001824%	649043	98.67%	6	1.88%
竊	2628		23	12	0.001824%	649055	98.67%	8	2.50%
筍	2629		12	12	0.001824%	649067	98.67%	5	1.56%
籬	2630		25	12	0.001824%	649079	98.67%	9	2.81%
糕	2631		16	12	0.001824%	649091	98.67%	7	2.19%
絆	2632		11	12	0.001824%	649103	98.68%	10	3.13%
綺	2633		14	12	0.001824%	649115	98.68%	7	2.19%
罕	2634		7	12	0.001824%	649127	98.68%	11	3.44%
肇	2635		14	12	0.001824%	649139	98.68%	10	3.13%
脾	2636		12	12	0.001824%	649151	98.68%	12	3.75%
芸	2637		8	12	0.001824%	649163	98.69%	5	1.56%
茅	2638		9	12	0.001824%	649175	98.69%	7	2.19%
茄	2639		9	12	0.001824%	649187	98.69%	7	2.19%
苞	2640		9	12	0.001824%	649199	98.69%	6	1.88%
荊	2641		10	12	0.001824%	649211	98.69%	12	3.75%
菁	2642		12	12	0.001824%	649223	98.69%	6	1.88%
葦	2643		13	12	0.001824%	649235	98.70%	5	1.56%
藤	2644		19	12	0.001824%	649247	98.70%	8	2.50%
虞	2645		13	12	0.001824%	649259	98.70%	7	2.19%
蠻	2646		25	12	0.001824%	649271	98.70%	12	3.75%
裴	2647		13	12	0.001824%	649283	98.70%	4	1.25%
豬	2648		11	12	0.001824%	649295	98.71%	10	3.13%
蹈	2649		17	12	0.001824%	649307	98.71%	12	3.75%
辣	2650		14	12	0.001824%	649319	98.71%	9	2.81%
闖	2651		18	12	0.001824%	649331	98.71%	11	3.44%
阮	2652		6	12	0.001824%	649343	98.71%	5	1.56%
隕	2653		12	12	0.001824%	649355	98.71%	2	0.63%
韌	2654		12	12	0.001824%	649367	98.72%	11	3.44%
驀	2655		21	12	0.001824%	649379	98.72%	10	3.13%
鬍	2656		19	12	0.001824%	649391	98.72%	11	3.44%
仞	2657		5	11	0.001672%	649402	98.72%	1	0.31%
佐	2658		7	11	0.001672%	649413	98.72%	9	2.81%
刮	2659		8	11	0.001672%	649424	98.72%	9	2.81%
匈	2660		6	11	0.001672%	649435	98.73%	6	1.88%
匱	2661		14	11	0.001672%	649446	98.73%	10	3.13%
厄	2662		4	11	0.001672%	649457	98.73%	7	2.19%
咄	2663		8	11	0.001672%	649468	98.73%	4	1.25%
啃	2664		11	11	0.001672%	649479	98.73%	8	2.50%
嘶	2665		15	11	0.001672%	649490	98.73%	8	2.50%
嚷	2666		20	11	0.001672%	649501	98.74%	8	2.50%
壺	2667		12	11	0.001672%	649512	98.74%	8	2.50%
妒	2668		7	11	0.001672%	649523	98.74%	8	2.50%
姜	2669		9	11	0.001672%	649534	98.74%	5	1.56%
婿	2670		12	11	0.001672%	649545	98.74%	5	1.56%
嬉	2671		15	11	0.001672%	649556	98.74%	9	2.81%
帥	2672		9	11	0.001672%	649567	98.75%	10	3.13%
忱	2673		7	11	0.001672%	649578	98.75%	7	2.19%
悴	2674		11	11	0.001672%	649589	98.75%	10	3.13%
悽	2675		11	11	0.001672%	649600	98.75%	8	2.50%
愕	2676		12	11	0.001672%	649611	98.75%	8	2.50%
憔	2677		15	11	0.001672%	649622	98.75%	10	3.13%
揉	2678		12	11	0.001672%	649633	98.76%	9	2.81%
搜	2679		12	11	0.001672%	649644	98.76%	10	3.13%
撕	2680		15	11	0.001672%	649655	98.76%	10	3.13%
敷	2681		15	11	0.001672%	649666	98.76%	9	2.81%
斧	2682		8	11	0.001672%	649677	98.76%	7	2.19%
旺	2683		8	11	0.001672%	649688	98.76%	11	3.44%
枉	2684		8	11	0.001672%	649699	98.77%	10	3.13%
椰	2685		13	11	0.001672%	649710	98.77%	8	2.50%
楓	2686		13	11	0.001672%	649721	98.77%	8	2.50%
榕	2687		14	11	0.001672%	649732	98.77%	8	2.50%
毯	2688		12	11	0.001672%	649743	98.77%	11	3.44%
渠	2689		12	11	0.001672%	649754	98.77%	11	3.44%
灼	2690		7	11	0.001672%	649765	98.78%	7	2.19%
炫	2691		9	11	0.001672%	649776	98.78%	9	2.81%
犬	2692		4	11	0.001672%	649787	98.78%	6	1.88%
瑟	2693		13	11	0.001672%	649798	98.78%	5	1.56%
瓷	2694		11	11	0.001672%	649809	98.78%	7	2.19%
町	2695		7	11	0.001672%	649820	98.78%	3	0.94%
瘓	2696		14	11	0.001672%	649831	98.79%	10	3.13%
矩	2697		10	11	0.001672%	649842	98.79%	8	2.50%
砌	2698		9	11	0.001672%	649853	98.79%	8	2.50%
祉	2699		8	11	0.001672%	649864	98.79%	7	2.19%
笛	2700		11	11	0.001672%	649875	98.79%	8	2.50%
箭	2701		15	11	0.001672%	649886	98.79%	9	2.81%
簇	2702		17	11	0.001672%	649897	98.80%	9	2.81%
縈	2703		16	11	0.001672%	649908	98.80%	10	3.13%
羨	2704		13	11	0.001672%	649919	98.80%	10	3.13%
耘	2705		10	11	0.001672%	649930	98.80%	9	2.81%
耿	2706		10	11	0.001672%	649941	98.80%	6	1.88%
艘	2707		15	11	0.001672%	649952	98.80%	7	2.19%
芝	2708		8	11	0.001672%	649963	98.81%	10	3.13%
芹	2709		8	11	0.001672%	649974	98.81%	4	1.25%
萍	2710		12	11	0.001672%	649985	98.81%	10	3.13%
蒸	2711		14	11	0.001672%	649996	98.81%	10	3.13%
蒐	2712		14	11	0.001672%	650007	98.81%	7	2.19%
蔔	2713		15	11	0.001672%	650018	98.82%	5	1.56%
薑	2714		17	11	0.001672%	650029	98.82%	5	1.56%
蟬	2715		18	11	0.001672%	650040	98.82%	10	3.13%
賈	2716		13	11	0.001672%	650051	98.82%	7	2.19%
賠	2717		15	11	0.001672%	650062	98.82%	10	3.13%
釣	2718		11	11	0.001672%	650073	98.82%	9	2.81%
鈔	2719		12	11	0.001672%	650084	98.83%	9	2.81%
鑼	2720		27	11	0.001672%	650095	98.83%	7	2.19%
隘	2721		12	11	0.001672%	650106	98.83%	5	1.56%
頰	2722		16	11	0.001672%	650117	98.83%	9	2.81%
饒	2723		20	11	0.001672%	650128	98.83%	10	3.13%
駁	2724		14	11	0.001672%	650139	98.83%	11	3.44%
鴿	2725		17	11	0.001672%	650150	98.84%	5	1.56%
侈	2726		8	10	0.00152%	650160	98.84%	9	2.81%
侮	2727		9	10	0.00152%	650170	98.84%	8	2.50%
僚	2728		14	10	0.00152%	650180	98.84%	9	2.81%
僱	2729		14	10	0.00152%	650190	98.84%	3	0.94%
剖	2730		10	10	0.00152%	650200	98.84%	7	2.19%
咒	2731		8	10	0.00152%	650210	98.84%	10	3.13%
喟	2732		12	10	0.00152%	650220	98.85%	9	2.81%
嘟	2733		13	10	0.00152%	650230	98.85%	6	1.88%
嘔	2734		14	10	0.00152%	650240	98.85%	7	2.19%
嚀	2735		17	10	0.00152%	650250	98.85%	6	1.88%
嚨	2736		20	10	0.00152%	650260	98.85%	10	3.13%
圳	2737		6	10	0.00152%	650270	98.85%	4	1.25%
坤	2738		8	10	0.00152%	650280	98.85%	6	1.88%
寨	2739		14	10	0.00152%	650290	98.86%	4	1.25%
屁	2740		7	10	0.00152%	650300	98.86%	10	3.13%
屍	2741		9	10	0.00152%	650310	98.86%	10	3.13%
彙	2742		13	10	0.00152%	650320	98.86%	9	2.81%
恭	2743		10	10	0.00152%	650330	98.86%	9	2.81%
惋	2744		11	10	0.00152%	650340	98.86%	10	3.13%
惘	2745		11	10	0.00152%	650350	98.87%	9	2.81%
惕	2746		11	10	0.00152%	650360	98.87%	10	3.13%
憧	2747		15	10	0.00152%	650370	98.87%	10	3.13%
扔	2748		5	10	0.00152%	650380	98.87%	8	2.50%
捏	2749		10	10	0.00152%	650390	98.87%	10	3.13%
摒	2750		12	10	0.00152%	650400	98.87%	7	2.19%
撈	2751		15	10	0.00152%	650410	98.87%	7	2.19%
攸	2752		7	10	0.00152%	650420	98.88%	8	2.50%
曳	2753		6	10	0.00152%	650430	98.88%	7	2.19%
枷	2754		9	10	0.00152%	650440	98.88%	5	1.56%
桶	2755		11	10	0.00152%	650450	98.88%	7	2.19%
沸	2756		8	10	0.00152%	650460	98.88%	7	2.19%
沮	2757		8	10	0.00152%	650470	98.88%	9	2.81%
洽	2758		9	10	0.00152%	650480	98.89%	9	2.81%
淆	2759		11	10	0.00152%	650490	98.89%	8	2.50%
潘	2760		15	10	0.00152%	650500	98.89%	6	1.88%
濺	2761		18	10	0.00152%	650510	98.89%	8	2.50%
烹	2762		11	10	0.00152%	650520	98.89%	7	2.19%
煎	2763		13	10	0.00152%	650530	98.89%	10	3.13%
爪	2764		4	10	0.00152%	650540	98.89%	6	1.88%
犁	2765		11	10	0.00152%	650550	98.90%	6	1.88%
瑕	2766		13	10	0.00152%	650560	98.90%	9	2.81%
甩	2767		5	10	0.00152%	650570	98.90%	7	2.19%
疤	2768		9	10	0.00152%	650580	98.90%	8	2.50%
矚	2769		26	10	0.00152%	650590	98.90%	10	3.13%
窒	2770		11	10	0.00152%	650600	98.90%	10	3.13%
窺	2771		16	10	0.00152%	650610	98.91%	9	2.81%
笙	2772		11	10	0.00152%	650620	98.91%	3	0.94%
篤	2773		16	10	0.00152%	650630	98.91%	8	2.50%
糧	2774		18	10	0.00152%	650640	98.91%	9	2.81%
綑	2775		13	10	0.00152%	650650	98.91%	4	1.25%
緬	2776		15	10	0.00152%	650660	98.91%	7	2.19%
繭	2777		19	10	0.00152%	650670	98.91%	7	2.19%
繽	2778		20	10	0.00152%	650680	98.92%	10	3.13%
纍	2779		21	10	0.00152%	650690	98.92%	5	1.56%
腺	2780		13	10	0.00152%	650700	98.92%	5	1.56%
臼	2781		6	10	0.00152%	650710	98.92%	2	0.63%
苟	2782		9	10	0.00152%	650720	98.92%	10	3.13%
萊	2783		12	10	0.00152%	650730	98.92%	8	2.50%
葫	2784		13	10	0.00152%	650740	98.92%	4	1.25%
蔓	2785		15	10	0.00152%	650750	98.93%	7	2.19%
蕃	2786		16	10	0.00152%	650760	98.93%	3	0.94%
蛛	2787		12	10	0.00152%	650770	98.93%	7	2.19%
趟	2788		15	10	0.00152%	650780	98.93%	10	3.13%
踽	2789		16	10	0.00152%	650790	98.93%	5	1.56%
迭	2790		8	10	0.00152%	650800	98.93%	9	2.81%
逮	2791		11	10	0.00152%	650810	98.94%	7	2.19%
郤	2792		9	10	0.00152%	650820	98.94%	9	2.81%
酣	2793		12	10	0.00152%	650830	98.94%	9	2.81%
鐸	2794		21	10	0.00152%	650840	98.94%	1	0.31%
闌	2795		17	10	0.00152%	650850	98.94%	8	2.50%
闔	2796		18	10	0.00152%	650860	98.94%	10	3.13%
陡	2797		9	10	0.00152%	650870	98.94%	9	2.81%
陵	2798		10	10	0.00152%	650880	98.95%	9	2.81%
雯	2799		12	10	0.00152%	650890	98.95%	4	1.25%
韋	2800		9	10	0.00152%	650900	98.95%	5	1.56%
顱	2801		25	10	0.00152%	650910	98.95%	8	2.50%
鯨	2802		19	10	0.00152%	650920	98.95%	3	0.94%
黏	2803		17	10	0.00152%	650930	98.95%	7	2.19%
龜	2804		16	10	0.00152%	650940	98.96%	6	1.88%
仲	2805		6	9	0.001368%	650949	98.96%	8	2.50%
侷	2806		9	9	0.001368%	650958	98.96%	9	2.81%
倘	2807		10	9	0.001368%	650967	98.96%	8	2.50%
偕	2808		11	9	0.001368%	650976	98.96%	8	2.50%
傢	2809		12	9	0.001368%	650985	98.96%	8	2.50%
兀	2810		3	9	0.001368%	650994	98.96%	8	2.50%
兇	2811		6	9	0.001368%	651003	98.96%	8	2.50%
兆	2812		6	9	0.001368%	651012	98.97%	9	2.81%
凄	2813		10	9	0.001368%	651021	98.97%	6	1.88%
匪	2814		10	9	0.001368%	651030	98.97%	9	2.81%
咕	2815		8	9	0.001368%	651039	98.97%	7	2.19%
咽	2816		9	9	0.001368%	651048	98.97%	6	1.88%
哩	2817		10	9	0.001368%	651057	98.97%	8	2.50%
喳	2818		12	9	0.001368%	651066	98.97%	4	1.25%
嗅	2819		13	9	0.001368%	651075	98.98%	8	2.50%
嘰	2820		15	9	0.001368%	651084	98.98%	5	1.56%
囑	2821		24	9	0.001368%	651093	98.98%	8	2.50%
垢	2822		9	9	0.001368%	651102	98.98%	9	2.81%
奕	2823		9	9	0.001368%	651111	98.98%	5	1.56%
奴	2824		5	9	0.001368%	651120	98.98%	8	2.50%
婪	2825		11	9	0.001368%	651129	98.98%	3	0.94%
寰	2826		16	9	0.001368%	651138	98.99%	5	1.56%
峭	2827		10	9	0.001368%	651147	98.99%	8	2.50%
崖	2828		11	9	0.001368%	651156	98.99%	7	2.19%
巍	2829		21	9	0.001368%	651165	98.99%	6	1.88%
巒	2830		22	9	0.001368%	651174	98.99%	9	2.81%
巢	2831		11	9	0.001368%	651183	98.99%	7	2.19%
徨	2832		12	9	0.001368%	651192	98.99%	9	2.81%
惶	2833		12	9	0.001368%	651201	98.99%	8	2.50%
慄	2834		13	9	0.001368%	651210	99.00%	8	2.50%
愴	2835		13	9	0.001368%	651219	99.00%	8	2.50%
憊	2836		16	9	0.001368%	651228	99.00%	9	2.81%
懲	2837		19	9	0.001368%	651237	99.00%	6	1.88%
扒	2838		5	9	0.001368%	651246	99.00%	4	1.25%
抨	2839		8	9	0.001368%	651255	99.00%	7	2.19%
拱	2840		9	9	0.001368%	651264	99.00%	7	2.19%
拯	2841		9	9	0.001368%	651273	99.01%	8	2.50%
揀	2842		12	9	0.001368%	651282	99.01%	9	2.81%
揣	2843		12	9	0.001368%	651291	99.01%	9	2.81%
擎	2844		17	9	0.001368%	651300	99.01%	8	2.50%
攏	2845		19	9	0.001368%	651309	99.01%	9	2.81%
斌	2846		12	9	0.001368%	651318	99.01%	2	0.63%
晝	2847		11	9	0.001368%	651327	99.01%	7	2.19%
晦	2848		11	9	0.001368%	651336	99.02%	8	2.50%
暇	2849		13	9	0.001368%	651345	99.02%	8	2.50%
柄	2850		9	9	0.001368%	651354	99.02%	7	2.19%
棍	2851		12	9	0.001368%	651363	99.02%	8	2.50%
椎	2852		12	9	0.001368%	651372	99.02%	6	1.88%
榴	2853		14	9	0.001368%	651381	99.02%	6	1.88%
檜	2854		17	9	0.001368%	651390	99.02%	4	1.25%
汲	2855		7	9	0.001368%	651399	99.02%	7	2.19%
涓	2856		10	9	0.001368%	651408	99.03%	5	1.56%
湄	2857		12	9	0.001368%	651417	99.03%	3	0.94%
漾	2858		14	9	0.001368%	651426	99.03%	9	2.81%
滯	2859		14	9	0.001368%	651435	99.03%	9	2.81%
漣	2860		14	9	0.001368%	651444	99.03%	5	1.56%
潺	2861		15	9	0.001368%	651453	99.03%	5	1.56%
澱	2862		16	9	0.001368%	651462	99.03%	8	2.50%
濱	2863		17	9	0.001368%	651471	99.04%	7	2.19%
瀉	2864		18	9	0.001368%	651480	99.04%	8	2.50%
瀟	2865		19	9	0.001368%	651489	99.04%	7	2.19%
瀰	2866		20	9	0.001368%	651498	99.04%	9	2.81%
烽	2867		11	9	0.001368%	651507	99.04%	6	1.88%
燙	2868		16	9	0.001368%	651516	99.04%	9	2.81%
狄	2869		7	9	0.001368%	651525	99.04%	5	1.56%
瓣	2870		19	9	0.001368%	651534	99.05%	5	1.56%
癒	2871		18	9	0.001368%	651543	99.05%	9	2.81%
皂	2872		7	9	0.001368%	651552	99.05%	7	2.19%
盯	2873		7	9	0.001368%	651561	99.05%	9	2.81%
眩	2874		10	9	0.001368%	651570	99.05%	9	2.81%
磋	2875		15	9	0.001368%	651579	99.05%	8	2.50%
穀	2876		15	9	0.001368%	651588	99.05%	9	2.81%
竭	2877		14	9	0.001368%	651597	99.06%	9	2.81%
笠	2878		11	9	0.001368%	651606	99.06%	4	1.25%
簾	2879		19	9	0.001368%	651615	99.06%	9	2.81%
粥	2880		12	9	0.001368%	651624	99.06%	7	2.19%
紡	2881		10	9	0.001368%	651633	99.06%	5	1.56%
紊	2882		10	9	0.001368%	651642	99.06%	8	2.50%
綴	2883		14	9	0.001368%	651651	99.06%	9	2.81%
苛	2884		9	9	0.001368%	651660	99.06%	9	2.81%
茸	2885		10	9	0.001368%	651669	99.07%	4	1.25%
蔥	2886		15	9	0.001368%	651678	99.07%	7	2.19%
藺	2887		20	9	0.001368%	651687	99.07%	1	0.31%
蛙	2888		12	9	0.001368%	651696	99.07%	5	1.56%
蛻	2889		13	9	0.001368%	651705	99.07%	9	2.81%
螞	2890		16	9	0.001368%	651714	99.07%	5	1.56%
豁	2891		17	9	0.001368%	651723	99.07%	8	2.50%
賜	2892		15	9	0.001368%	651732	99.08%	7	2.19%
蹄	2893		16	9	0.001368%	651741	99.08%	6	1.88%
逾	2894		12	9	0.001368%	651750	99.08%	9	2.81%
遁	2895		12	9	0.001368%	651759	99.08%	9	2.81%
釵	2896		11	9	0.001368%	651768	99.08%	1	0.31%
鈍	2897		12	9	0.001368%	651777	99.08%	7	2.19%
霎	2898		16	9	0.001368%	651786	99.08%	6	1.88%
餽	2899		18	9	0.001368%	651795	99.09%	3	0.94%
黝	2900		17	9	0.001368%	651804	99.09%	6	1.88%
亥	2901		6	8	0.001216%	651812	99.09%	5	1.56%
仕	2902		5	8	0.001216%	651820	99.09%	3	0.94%
佣	2903		7	8	0.001216%	651828	99.09%	4	1.25%
傍	2904		12	8	0.001216%	651836	99.09%	7	2.19%
凹	2905		5	8	0.001216%	651844	99.09%	5	1.56%
刃	2906		3	8	0.001216%	651852	99.09%	8	2.50%
匙	2907		11	8	0.001216%	651860	99.10%	7	2.19%
后	2908		6	8	0.001216%	651868	99.10%	7	2.19%
哼	2909		10	8	0.001216%	651876	99.10%	7	2.19%
囉	2910		22	8	0.001216%	651884	99.10%	4	1.25%
塚	2911		13	8	0.001216%	651892	99.10%	5	1.56%
妮	2912		8	8	0.001216%	651900	99.10%	4	1.25%
姥	2913		9	8	0.001216%	651908	99.10%	2	0.63%
嫂	2914		12	8	0.001216%	651916	99.10%	5	1.56%
孰	2915		11	8	0.001216%	651924	99.10%	5	1.56%
孽	2916		20	8	0.001216%	651932	99.11%	6	1.88%
尬	2917		7	8	0.001216%	651940	99.11%	5	1.56%
尷	2918		17	8	0.001216%	651948	99.11%	5	1.56%
庚	2919		8	8	0.001216%	651956	99.11%	6	1.88%
廓	2920		14	8	0.001216%	651964	99.11%	7	2.19%
徬	2921		13	8	0.001216%	651972	99.11%	8	2.50%
怠	2922		9	8	0.001216%	651980	99.11%	8	2.50%
憎	2923		15	8	0.001216%	651988	99.11%	7	2.19%
懊	2924		16	8	0.001216%	651996	99.12%	8	2.50%
懺	2925		20	8	0.001216%	652004	99.12%	8	2.50%
扉	2926		12	8	0.001216%	652012	99.12%	7	2.19%
拙	2927		8	8	0.001216%	652020	99.12%	7	2.19%
掏	2928		11	8	0.001216%	652028	99.12%	7	2.19%
捻	2929		11	8	0.001216%	652036	99.12%	7	2.19%
攬	2930		24	8	0.001216%	652044	99.12%	7	2.19%
敞	2931		12	8	0.001216%	652052	99.12%	8	2.50%
曇	2932		16	8	0.001216%	652060	99.13%	3	0.94%
棲	2933		12	8	0.001216%	652068	99.13%	8	2.50%
槓	2934		14	8	0.001216%	652076	99.13%	4	1.25%
樟	2935		15	8	0.001216%	652084	99.13%	5	1.56%
氧	2936		10	8	0.001216%	652092	99.13%	5	1.56%
淙	2937		11	8	0.001216%	652100	99.13%	3	0.94%
漬	2938		14	8	0.001216%	652108	99.13%	7	2.19%
濡	2939		17	8	0.001216%	652116	99.13%	7	2.19%
炊	2940		8	8	0.001216%	652124	99.14%	6	1.88%
炳	2941		9	8	0.001216%	652132	99.14%	5	1.56%
焰	2942		12	8	0.001216%	652140	99.14%	8	2.50%
熊	2943		14	8	0.001216%	652148	99.14%	6	1.88%
熾	2944		16	8	0.001216%	652156	99.14%	8	2.50%
犀	2945		12	8	0.001216%	652164	99.14%	5	1.56%
疚	2946		8	8	0.001216%	652172	99.14%	7	2.19%
盒	2947		11	8	0.001216%	652180	99.14%	6	1.88%
瞪	2948		17	8	0.001216%	652188	99.14%	7	2.19%
矗	2949		24	8	0.001216%	652196	99.15%	8	2.50%
矜	2950		9	8	0.001216%	652204	99.15%	6	1.88%
磁	2951		14	8	0.001216%	652212	99.15%	5	1.56%
竄	2952		18	8	0.001216%	652220	99.15%	8	2.50%
笈	2953		10	8	0.001216%	652228	99.15%	4	1.25%
篩	2954		16	8	0.001216%	652236	99.15%	6	1.88%
紗	2955		10	8	0.001216%	652244	99.15%	6	1.88%
紓	2956		10	8	0.001216%	652252	99.15%	7	2.19%
舺	2957		11	8	0.001216%	652260	99.16%	2	0.63%
芋	2958		7	8	0.001216%	652268	99.16%	2	0.63%
芯	2959		8	8	0.001216%	652276	99.16%	3	0.94%
苓	2960		9	8	0.001216%	652284	99.16%	4	1.25%
莖	2961		11	8	0.001216%	652292	99.16%	6	1.88%
蔚	2962		15	8	0.001216%	652300	99.16%	6	1.88%
蝦	2963		15	8	0.001216%	652308	99.16%	7	2.19%
裊	2964		13	8	0.001216%	652316	99.16%	4	1.25%
褐	2965		14	8	0.001216%	652324	99.17%	7	2.19%
襪	2966		20	8	0.001216%	652332	99.17%	4	1.25%
蹊	2967		17	8	0.001216%	652340	99.17%	6	1.88%
蹺	2968		19	8	0.001216%	652348	99.17%	2	0.63%
轄	2969		17	8	0.001216%	652356	99.17%	6	1.88%
迥	2970		8	8	0.001216%	652364	99.17%	8	2.50%
迸	2971		9	8	0.001216%	652372	99.17%	8	2.50%
遏	2972		12	8	0.001216%	652380	99.17%	6	1.88%
釐	2973		18	8	0.001216%	652388	99.18%	6	1.88%
鏤	2974		19	8	0.001216%	652396	99.18%	6	1.88%
閡	2975		14	8	0.001216%	652404	99.18%	8	2.50%
閨	2976		14	8	0.001216%	652412	99.18%	3	0.94%
阱	2977		6	8	0.001216%	652420	99.18%	6	1.88%
陀	2978		7	8	0.001216%	652428	99.18%	6	1.88%
雁	2979		12	8	0.001216%	652436	99.18%	8	2.50%
霓	2980		16	8	0.001216%	652444	99.18%	8	2.50%
鬚	2981		22	8	0.001216%	652452	99.19%	7	2.19%
鬢	2982		24	8	0.001216%	652460	99.19%	7	2.19%
鵬	2983		19	8	0.001216%	652468	99.19%	5	1.56%
鵰	2984		19	8	0.001216%	652476	99.19%	3	0.94%
齣	2985		20	8	0.001216%	652484	99.19%	6	1.88%
丑	2986		4	7	0.001064%	652491	99.19%	5	1.56%
于	2987		3	7	0.001064%	652498	99.19%	3	0.94%
伺	2988		7	7	0.001064%	652505	99.19%	5	1.56%
侃	2989		8	7	0.001064%	652512	99.19%	5	1.56%
偎	2990		11	7	0.001064%	652519	99.20%	7	2.19%
剌	2991		9	7	0.001064%	652526	99.20%	6	1.88%
剋	2992		9	7	0.001064%	652533	99.20%	2	0.63%
匠	2993		6	7	0.001064%	652540	99.20%	7	2.19%
叉	2994		3	7	0.001064%	652547	99.20%	6	1.88%
叩	2995		5	7	0.001064%	652554	99.20%	5	1.56%
哎	2996		9	7	0.001064%	652561	99.20%	7	2.19%
哇	2997		9	7	0.001064%	652568	99.20%	4	1.25%
咪	2998		9	7	0.001064%	652575	99.20%	5	1.56%
哄	2999		9	7	0.001064%	652582	99.20%	7	2.19%
啜	3000		11	7	0.001064%	652589	99.21%	6	1.88%
喂	3001		12	7	0.001064%	652596	99.21%	5	1.56%
嘈	3002		14	7	0.001064%	652603	99.21%	7	2.19%
垮	3003		9	7	0.001064%	652610	99.21%	5	1.56%
堵	3004		11	7	0.001064%	652617	99.21%	5	1.56%
墊	3005		14	7	0.001064%	652624	99.21%	7	2.19%
姪	3006		9	7	0.001064%	652631	99.21%	6	1.88%
姦	3007		9	7	0.001064%	652638	99.21%	7	2.19%
嫉	3008		13	7	0.001064%	652645	99.21%	7	2.19%
宵	3009		10	7	0.001064%	652652	99.22%	5	1.56%
寥	3010		14	7	0.001064%	652659	99.22%	5	1.56%
尉	3011		11	7	0.001064%	652666	99.22%	4	1.25%
屎	3012		9	7	0.001064%	652673	99.22%	3	0.94%
屐	3013		10	7	0.001064%	652680	99.22%	3	0.94%
屜	3014		11	7	0.001064%	652687	99.22%	4	1.25%
屯	3015		4	7	0.001064%	652694	99.22%	6	1.88%
峙	3016		9	7	0.001064%	652701	99.22%	5	1.56%
嵐	3017		12	7	0.001064%	652708	99.22%	5	1.56%
庇	3018		7	7	0.001064%	652715	99.23%	7	2.19%
廬	3019		19	7	0.001064%	652722	99.23%	4	1.25%
廷	3020		7	7	0.001064%	652729	99.23%	6	1.88%
恃	3021		9	7	0.001064%	652736	99.23%	7	2.19%
恬	3022		9	7	0.001064%	652743	99.23%	7	2.19%
恣	3023		10	7	0.001064%	652750	99.23%	7	2.19%
悼	3024		11	7	0.001064%	652757	99.23%	6	1.88%
惆	3025		11	7	0.001064%	652764	99.23%	7	2.19%
懦	3026		17	7	0.001064%	652771	99.23%	5	1.56%
揆	3027		12	7	0.001064%	652778	99.23%	2	0.63%
敝	3028		11	7	0.001064%	652785	99.24%	6	1.88%
杞	3029		7	7	0.001064%	652792	99.24%	5	1.56%
杉	3030		7	7	0.001064%	652799	99.24%	6	1.88%
杆	3031		7	7	0.001064%	652806	99.24%	6	1.88%
樊	3032		15	7	0.001064%	652813	99.24%	6	1.88%
橙	3033		16	7	0.001064%	652820	99.24%	5	1.56%
歹	3034		4	7	0.001064%	652827	99.24%	7	2.19%
氯	3035		12	7	0.001064%	652834	99.24%	4	1.25%
汐	3036		6	7	0.001064%	652841	99.24%	5	1.56%
沃	3037		7	7	0.001064%	652848	99.25%	6	1.88%
湃	3038		12	7	0.001064%	652855	99.25%	5	1.56%
漓	3039		14	7	0.001064%	652862	99.25%	7	2.19%
滲	3040		14	7	0.001064%	652869	99.25%	7	2.19%
澆	3041		15	7	0.001064%	652876	99.25%	6	1.88%
瀅	3042		18	7	0.001064%	652883	99.25%	3	0.94%
炮	3043		9	7	0.001064%	652890	99.25%	7	2.19%
烙	3044		10	7	0.001064%	652897	99.25%	6	1.88%
煽	3045		14	7	0.001064%	652904	99.25%	7	2.19%
猴	3046		12	7	0.001064%	652911	99.25%	6	1.88%
獵	3047		18	7	0.001064%	652918	99.26%	7	2.19%
珮	3048		10	7	0.001064%	652925	99.26%	3	0.94%
畸	3049		13	7	0.001064%	652932	99.26%	2	0.63%
瘡	3050		15	7	0.001064%	652939	99.26%	5	1.56%
禦	3051		16	7	0.001064%	652946	99.26%	6	1.88%
稜	3052		13	7	0.001064%	652953	99.26%	6	1.88%
窘	3053		12	7	0.001064%	652960	99.26%	7	2.19%
筷	3054		13	7	0.001064%	652967	99.26%	6	1.88%
籃	3055		20	7	0.001064%	652974	99.26%	7	2.19%
粽	3056		14	7	0.001064%	652981	99.27%	3	0.94%
綁	3057		13	7	0.001064%	652988	99.27%	7	2.19%
緘	3058		15	7	0.001064%	652995	99.27%	6	1.88%
繆	3059		17	7	0.001064%	653002	99.27%	5	1.56%
缸	3060		9	7	0.001064%	653009	99.27%	5	1.56%
羡	3061		12	7	0.001064%	653016	99.27%	6	1.88%
翱	3062		16	7	0.001064%	653023	99.27%	6	1.88%
腕	3063		12	7	0.001064%	653030	99.27%	5	1.56%
膺	3064		17	7	0.001064%	653037	99.27%	5	1.56%
艋	3065		14	7	0.001064%	653044	99.28%	2	0.63%
苔	3066		9	7	0.001064%	653051	99.28%	6	1.88%
蜿	3067		14	7	0.001064%	653058	99.28%	6	1.88%
蜒	3068		14	7	0.001064%	653065	99.28%	7	2.19%
螂	3069		15	7	0.001064%	653072	99.28%	3	0.94%
衲	3070		9	7	0.001064%	653079	99.28%	2	0.63%
詠	3071		12	7	0.001064%	653086	99.28%	6	1.88%
詹	3072		13	7	0.001064%	653093	99.28%	5	1.56%
諦	3073		16	7	0.001064%	653100	99.28%	7	2.19%
謊	3074		17	7	0.001064%	653107	99.28%	7	2.19%
豚	3075		11	7	0.001064%	653114	99.29%	1	0.31%
貯	3076		12	7	0.001064%	653121	99.29%	6	1.88%
軒	3077		10	7	0.001064%	653128	99.29%	4	1.25%
遐	3078		12	7	0.001064%	653135	99.29%	7	2.19%
遑	3079		12	7	0.001064%	653142	99.29%	6	1.88%
遽	3080		16	7	0.001064%	653149	99.29%	7	2.19%
鄙	3081		13	7	0.001064%	653156	99.29%	7	2.19%
酵	3082		14	7	0.001064%	653163	99.29%	3	0.94%
鉛	3083		13	7	0.001064%	653170	99.29%	7	2.19%
鋁	3084		15	7	0.001064%	653177	99.30%	6	1.88%
鑰	3085		25	7	0.001064%	653184	99.30%	6	1.88%
鑿	3086		28	7	0.001064%	653191	99.30%	6	1.88%
饑	3087		20	7	0.001064%	653198	99.30%	6	1.88%
駝	3088		15	7	0.001064%	653205	99.30%	3	0.94%
鹼	3089		24	7	0.001064%	653212	99.30%	5	1.56%
黛	3090		17	7	0.001064%	653219	99.30%	4	1.25%
齋	3091		17	7	0.001064%	653226	99.30%	7	2.19%
丰	3092		4	6	0.0009121%	653232	99.30%	3	0.94%
乞	3093		3	6	0.0009121%	653238	99.30%	5	1.56%
亙	3094		6	6	0.0009121%	653244	99.31%	5	1.56%
佼	3095		8	6	0.0009121%	653250	99.31%	3	0.94%
俐	3096		9	6	0.0009121%	653256	99.31%	6	1.88%
偵	3097		11	6	0.0009121%	653262	99.31%	3	0.94%
僧	3098		14	6	0.0009121%	653268	99.31%	6	1.88%
儼	3099		22	6	0.0009121%	653274	99.31%	5	1.56%
兜	3100		11	6	0.0009121%	653280	99.31%	6	1.88%
冀	3101		16	6	0.0009121%	653286	99.31%	5	1.56%
凶	3102		4	6	0.0009121%	653292	99.31%	6	1.88%
厝	3103		10	6	0.0009121%	653298	99.31%	4	1.25%
叭	3104		5	6	0.0009121%	653304	99.31%	6	1.88%
吆	3105		6	6	0.0009121%	653310	99.32%	4	1.25%
咀	3106		8	6	0.0009121%	653316	99.32%	6	1.88%
咱	3107		9	6	0.0009121%	653322	99.32%	6	1.88%
咻	3108		9	6	0.0009121%	653328	99.32%	3	0.94%
喇	3109		12	6	0.0009121%	653334	99.32%	6	1.88%
嗯	3110		13	6	0.0009121%	653340	99.32%	4	1.25%
噸	3111		16	6	0.0009121%	653346	99.32%	5	1.56%
噬	3112		16	6	0.0009121%	653352	99.32%	6	1.88%
埸	3113		11	6	0.0009121%	653358	99.32%	4	1.25%
壟	3114		19	6	0.0009121%	653364	99.32%	6	1.88%
妃	3115		6	6	0.0009121%	653370	99.32%	4	1.25%
妓	3116		7	6	0.0009121%	653376	99.33%	4	1.25%
姬	3117		10	6	0.0009121%	653382	99.33%	2	0.63%
嫵	3118		15	6	0.0009121%	653388	99.33%	5	1.56%
嬗	3119		16	6	0.0009121%	653394	99.33%	4	1.25%
嬤	3120		17	6	0.0009121%	653400	99.33%	4	1.25%
岱	3121		8	6	0.0009121%	653406	99.33%	5	1.56%
峋	3122		9	6	0.0009121%	653412	99.33%	4	1.25%
嵌	3123		12	6	0.0009121%	653418	99.33%	6	1.88%
帖	3124		8	6	0.0009121%	653424	99.33%	6	1.88%
弔	3125		4	6	0.0009121%	653430	99.33%	6	1.88%
彬	3126		11	6	0.0009121%	653436	99.33%	3	0.94%
怔	3127		8	6	0.0009121%	653442	99.34%	3	0.94%
惻	3128		12	6	0.0009121%	653448	99.34%	3	0.94%
慷	3129		14	6	0.0009121%	653454	99.34%	6	1.88%
憩	3130		16	6	0.0009121%	653460	99.34%	5	1.56%
懵	3131		19	6	0.0009121%	653466	99.34%	5	1.56%
戍	3132		6	6	0.0009121%	653472	99.34%	5	1.56%
戮	3133		15	6	0.0009121%	653478	99.34%	6	1.88%
扳	3134		7	6	0.0009121%	653484	99.34%	4	1.25%
押	3135		8	6	0.0009121%	653490	99.34%	4	1.25%
挪	3136		10	6	0.0009121%	653496	99.34%	6	1.88%
搥	3137		13	6	0.0009121%	653502	99.34%	3	0.94%
摻	3138		14	6	0.0009121%	653508	99.35%	6	1.88%
摹	3139		15	6	0.0009121%	653514	99.35%	4	1.25%
旳	3140		7	6	0.0009121%	653520	99.35%	5	1.56%
晤	3141		11	6	0.0009121%	653526	99.35%	5	1.56%
曖	3142		17	6	0.0009121%	653532	99.35%	6	1.88%
曝	3143		19	6	0.0009121%	653538	99.35%	6	1.88%
杏	3144		7	6	0.0009121%	653544	99.35%	5	1.56%
槳	3145		15	6	0.0009121%	653550	99.35%	5	1.56%
櫻	3146		21	6	0.0009121%	653556	99.35%	4	1.25%
汝	3147		6	6	0.0009121%	653562	99.35%	4	1.25%
沐	3148		7	6	0.0009121%	653568	99.35%	6	1.88%
汰	3149		7	6	0.0009121%	653574	99.36%	6	1.88%
沼	3150		8	6	0.0009121%	653580	99.36%	4	1.25%
渦	3151		12	6	0.0009121%	653586	99.36%	6	1.88%
溉	3152		12	6	0.0009121%	653592	99.36%	4	1.25%
滌	3153		14	6	0.0009121%	653598	99.36%	6	1.88%
瀾	3154		20	6	0.0009121%	653604	99.36%	6	1.88%
炙	3155		8	6	0.0009121%	653610	99.36%	6	1.88%
炯	3156		9	6	0.0009121%	653616	99.36%	4	1.25%
熔	3157		14	6	0.0009121%	653622	99.36%	5	1.56%
燥	3158		17	6	0.0009121%	653628	99.36%	6	1.88%
燼	3159		18	6	0.0009121%	653634	99.36%	5	1.56%
犖	3160		14	6	0.0009121%	653640	99.37%	3	0.94%
狐	3161		8	6	0.0009121%	653646	99.37%	5	1.56%
珂	3162		9	6	0.0009121%	653652	99.37%	1	0.31%
畦	3163		11	6	0.0009121%	653658	99.37%	5	1.56%
疵	3164		11	6	0.0009121%	653664	99.37%	6	1.88%
痰	3165		13	6	0.0009121%	653670	99.37%	3	0.94%
痺	3166		13	6	0.0009121%	653676	99.37%	5	1.56%
皓	3167		12	6	0.0009121%	653682	99.37%	5	1.56%
盅	3168		9	6	0.0009121%	653688	99.37%	2	0.63%
盹	3169		9	6	0.0009121%	653694	99.37%	6	1.88%
眨	3170		10	6	0.0009121%	653700	99.37%	6	1.88%
睫	3171		13	6	0.0009121%	653706	99.38%	4	1.25%
瞄	3172		14	6	0.0009121%	653712	99.38%	5	1.56%
瞳	3173		17	6	0.0009121%	653718	99.38%	5	1.56%
磷	3174		17	6	0.0009121%	653724	99.38%	3	0.94%
礁	3175		17	6	0.0009121%	653730	99.38%	5	1.56%
秧	3176		10	6	0.0009121%	653736	99.38%	3	0.94%
粧	3177		12	6	0.0009121%	653742	99.38%	4	1.25%
絨	3178		12	6	0.0009121%	653748	99.38%	4	1.25%
纜	3179		27	6	0.0009121%	653754	99.38%	5	1.56%
翰	3180		16	6	0.0009121%	653760	99.38%	6	1.88%
肋	3181		6	6	0.0009121%	653766	99.38%	5	1.56%
膏	3182		14	6	0.0009121%	653772	99.39%	6	1.88%
范	3183		9	6	0.0009121%	653778	99.39%	4	1.25%
菠	3184		12	6	0.0009121%	653784	99.39%	1	0.31%
蕪	3185		16	6	0.0009121%	653790	99.39%	5	1.56%
蕻	3186		17	6	0.0009121%	653796	99.39%	2	0.63%
蜘	3187		14	6	0.0009121%	653802	99.39%	3	0.94%
蟑	3188		17	6	0.0009121%	653808	99.39%	3	0.94%
裨	3189		13	6	0.0009121%	653814	99.39%	5	1.56%
詐	3190		12	6	0.0009121%	653820	99.39%	6	1.88%
譚	3191		19	6	0.0009121%	653826	99.39%	6	1.88%
譏	3192		19	6	0.0009121%	653832	99.39%	6	1.88%
踉	3193		14	6	0.0009121%	653838	99.40%	4	1.25%
踱	3194		16	6	0.0009121%	653844	99.40%	6	1.88%
蹌	3195		17	6	0.0009121%	653850	99.40%	4	1.25%
蹣	3196		18	6	0.0009121%	653856	99.40%	6	1.88%
迤	3197		8	6	0.0009121%	653862	99.40%	6	1.88%
迺	3198		9	6	0.0009121%	653868	99.40%	3	0.94%
逄	3199		9	6	0.0009121%	653874	99.40%	2	0.63%
邃	3200		17	6	0.0009121%	653880	99.40%	6	1.88%
鋤	3201		15	6	0.0009121%	653886	99.40%	5	1.56%
闡	3202		20	6	0.0009121%	653892	99.40%	6	1.88%
阪	3203		6	6	0.0009121%	653898	99.40%	5	1.56%
隧	3204		15	6	0.0009121%	653904	99.41%	4	1.25%
霉	3205		15	6	0.0009121%	653910	99.41%	5	1.56%
騁	3206		17	6	0.0009121%	653916	99.41%	6	1.88%
骯	3207		14	6	0.0009121%	653922	99.41%	5	1.56%
骸	3208		16	6	0.0009121%	653928	99.41%	6	1.88%
髓	3209		23	6	0.0009121%	653934	99.41%	4	1.25%
鴉	3210		15	6	0.0009121%	653940	99.41%	6	1.88%
仆	3211		4	5	0.0007601%	653945	99.41%	5	1.56%
佑	3212		7	5	0.0007601%	653950	99.41%	5	1.56%
俺	3213		10	5	0.0007601%	653955	99.41%	1	0.31%
偌	3214		11	5	0.0007601%	653960	99.41%	5	1.56%
倏	3215		11	5	0.0007601%	653965	99.42%	5	1.56%
凰	3216		11	5	0.0007601%	653970	99.42%	5	1.56%
凳	3217		14	5	0.0007601%	653975	99.42%	5	1.56%
划	3218		6	5	0.0007601%	653980	99.42%	5	1.56%
刪	3219		7	5	0.0007601%	653985	99.42%	4	1.25%
劈	3220		15	5	0.0007601%	653990	99.42%	4	1.25%
卉	3221		5	5	0.0007601%	653995	99.42%	3	0.94%
厥	3222		12	5	0.0007601%	654000	99.42%	4	1.25%
吮	3223		7	5	0.0007601%	654005	99.42%	5	1.56%
呻	3224		8	5	0.0007601%	654010	99.42%	5	1.56%
咚	3225		8	5	0.0007601%	654015	99.42%	3	0.94%
哉	3226		9	5	0.0007601%	654020	99.42%	5	1.56%
咫	3227		9	5	0.0007601%	654025	99.42%	5	1.56%
啤	3228		11	5	0.0007601%	654030	99.42%	5	1.56%
唳	3229		11	5	0.0007601%	654035	99.43%	5	1.56%
啻	3230		12	5	0.0007601%	654040	99.43%	5	1.56%
啾	3231		12	5	0.0007601%	654045	99.43%	4	1.25%
嗤	3232		13	5	0.0007601%	654050	99.43%	5	1.56%
嗆	3233		13	5	0.0007601%	654055	99.43%	5	1.56%
噓	3234		15	5	0.0007601%	654060	99.43%	5	1.56%
噎	3235		15	5	0.0007601%	654065	99.43%	3	0.94%
噹	3236		16	5	0.0007601%	654070	99.43%	3	0.94%
嚕	3237		18	5	0.0007601%	654075	99.43%	4	1.25%
嚥	3238		19	5	0.0007601%	654080	99.43%	5	1.56%
垠	3239		9	5	0.0007601%	654085	99.43%	4	1.25%
墟	3240		15	5	0.0007601%	654090	99.43%	4	1.25%
夭	3241		4	5	0.0007601%	654095	99.43%	5	1.56%
妾	3242		8	5	0.0007601%	654100	99.44%	2	0.63%
姚	3243		9	5	0.0007601%	654105	99.44%	3	0.94%
娶	3244		11	5	0.0007601%	654110	99.44%	5	1.56%
婁	3245		11	5	0.0007601%	654115	99.44%	1	0.31%
嫻	3246		15	5	0.0007601%	654120	99.44%	5	1.56%
孺	3247		17	5	0.0007601%	654125	99.44%	3	0.94%
寢	3248		14	5	0.0007601%	654130	99.44%	5	1.56%
峨	3249		10	5	0.0007601%	654135	99.44%	5	1.56%
嶙	3250		15	5	0.0007601%	654140	99.44%	3	0.94%
巳	3251		3	5	0.0007601%	654145	99.44%	5	1.56%
庶	3252		11	5	0.0007601%	654150	99.44%	5	1.56%
庵	3253		11	5	0.0007601%	654155	99.44%	3	0.94%
弛	3254		6	5	0.0007601%	654160	99.44%	3	0.94%
彥	3255		9	5	0.0007601%	654165	99.45%	5	1.56%
怵	3256		8	5	0.0007601%	654170	99.45%	4	1.25%
恫	3257		9	5	0.0007601%	654175	99.45%	3	0.94%
惦	3258		11	5	0.0007601%	654180	99.45%	4	1.25%
悸	3259		11	5	0.0007601%	654185	99.45%	5	1.56%
惰	3260		12	5	0.0007601%	654190	99.45%	5	1.56%
懾	3261		21	5	0.0007601%	654195	99.45%	5	1.56%
戳	3262		18	5	0.0007601%	654200	99.45%	4	1.25%
拈	3263		8	5	0.0007601%	654205	99.45%	5	1.56%
拎	3264		8	5	0.0007601%	654210	99.45%	5	1.56%
捱	3265		11	5	0.0007601%	654215	99.45%	4	1.25%
揹	3266		12	5	0.0007601%	654220	99.45%	5	1.56%
搏	3267		13	5	0.0007601%	654225	99.45%	5	1.56%
撮	3268		15	5	0.0007601%	654230	99.46%	5	1.56%
擷	3269		18	5	0.0007601%	654235	99.46%	5	1.56%
攔	3270		20	5	0.0007601%	654240	99.46%	5	1.56%
攫	3271		23	5	0.0007601%	654245	99.46%	5	1.56%
斲	3272		15	5	0.0007601%	654250	99.46%	5	1.56%
旭	3273		6	5	0.0007601%	654255	99.46%	5	1.56%
旱	3274		7	5	0.0007601%	654260	99.46%	4	1.25%
枒	3275		8	5	0.0007601%	654265	99.46%	2	0.63%
棺	3276		12	5	0.0007601%	654270	99.46%	5	1.56%
椏	3277		12	5	0.0007601%	654275	99.46%	5	1.56%
榷	3278		14	5	0.0007601%	654280	99.46%	5	1.56%
榻	3279		14	5	0.0007601%	654285	99.46%	4	1.25%
榖	3280		14	5	0.0007601%	654290	99.46%	3	0.94%
橘	3281		16	5	0.0007601%	654295	99.47%	5	1.56%
欽	3282		12	5	0.0007601%	654300	99.47%	5	1.56%
殯	3283		18	5	0.0007601%	654305	99.47%	4	1.25%
氟	3284		9	5	0.0007601%	654310	99.47%	3	0.94%
汶	3285		7	5	0.0007601%	654315	99.47%	3	0.94%
淤	3286		11	5	0.0007601%	654320	99.47%	4	1.25%
涸	3287		11	5	0.0007601%	654325	99.47%	4	1.25%
淮	3288		11	5	0.0007601%	654330	99.47%	2	0.63%
湘	3289		12	5	0.0007601%	654335	99.47%	3	0.94%
漩	3290		14	5	0.0007601%	654340	99.47%	5	1.56%
澗	3291		15	5	0.0007601%	654345	99.47%	4	1.25%
濯	3292		17	5	0.0007601%	654350	99.47%	3	0.94%
瀏	3293		18	5	0.0007601%	654355	99.47%	5	1.56%
瀚	3294		19	5	0.0007601%	654360	99.48%	4	1.25%
瀝	3295		19	5	0.0007601%	654365	99.48%	3	0.94%
灶	3296		7	5	0.0007601%	654370	99.48%	3	0.94%
爵	3297		17	5	0.0007601%	654375	99.48%	2	0.63%
	3298		9	5	0.0007601%	654380	99.48%	2	0.63%
琉	3299		10	5	0.0007601%	654385	99.48%	5	1.56%
琦	3300		12	5	0.0007601%	654390	99.48%	4	1.25%
瘍	3301		14	5	0.0007601%	654395	99.48%	4	1.25%
瘴	3302		16	5	0.0007601%	654400	99.48%	5	1.56%
癢	3303		20	5	0.0007601%	654405	99.48%	5	1.56%
盎	3304		10	5	0.0007601%	654410	99.48%	5	1.56%
瞞	3305		16	5	0.0007601%	654415	99.48%	5	1.56%
瞥	3306		16	5	0.0007601%	654420	99.48%	5	1.56%
矇	3307		19	5	0.0007601%	654425	99.48%	4	1.25%
砸	3308		10	5	0.0007601%	654430	99.49%	2	0.63%
硫	3309		11	5	0.0007601%	654435	99.49%	3	0.94%
祗	3310		9	5	0.0007601%	654440	99.49%	4	1.25%
稠	3311		13	5	0.0007601%	654445	99.49%	4	1.25%
窪	3312		14	5	0.0007601%	654450	99.49%	4	1.25%
笆	3313		10	5	0.0007601%	654455	99.49%	4	1.25%
籐	3314		21	5	0.0007601%	654460	99.49%	4	1.25%
籽	3315		9	5	0.0007601%	654465	99.49%	5	1.56%
粱	3316		13	5	0.0007601%	654470	99.49%	3	0.94%
糯	3317		20	5	0.0007601%	654475	99.49%	3	0.94%
紜	3318		10	5	0.0007601%	654480	99.49%	5	1.56%
絮	3319		12	5	0.0007601%	654485	99.49%	5	1.56%
綽	3320		14	5	0.0007601%	654490	99.49%	4	1.25%
緯	3321		15	5	0.0007601%	654495	99.50%	5	1.56%
緝	3322		15	5	0.0007601%	654500	99.50%	5	1.56%
繃	3323		17	5	0.0007601%	654505	99.50%	5	1.56%
纔	3324		23	5	0.0007601%	654510	99.50%	4	1.25%
罈	3325		18	5	0.0007601%	654515	99.50%	2	0.63%
罔	3326		8	5	0.0007601%	654520	99.50%	5	1.56%
聇	3327		11	5	0.0007601%	654525	99.50%	1	0.31%
臻	3328		16	5	0.0007601%	654530	99.50%	4	1.25%
芷	3329		8	5	0.0007601%	654535	99.50%	2	0.63%
茱	3330		10	5	0.0007601%	654540	99.50%	2	0.63%
莞	3331		11	5	0.0007601%	654545	99.50%	2	0.63%
蓊	3332		14	5	0.0007601%	654550	99.50%	4	1.25%
蕙	3333		16	5	0.0007601%	654555	99.50%	5	1.56%
薰	3334		18	5	0.0007601%	654560	99.51%	3	0.94%
薦	3335		18	5	0.0007601%	654565	99.51%	4	1.25%
蛾	3336		13	5	0.0007601%	654570	99.51%	5	1.56%
蝟	3337		15	5	0.0007601%	654575	99.51%	5	1.56%
蟄	3338		17	5	0.0007601%	654580	99.51%	4	1.25%
蠕	3339		20	5	0.0007601%	654585	99.51%	5	1.56%
蠶	3340		24	5	0.0007601%	654590	99.51%	5	1.56%
袍	3341		10	5	0.0007601%	654595	99.51%	5	1.56%
詛	3342		12	5	0.0007601%	654600	99.51%	5	1.56%
諍	3343		15	5	0.0007601%	654605	99.51%	3	0.94%
譎	3344		19	5	0.0007601%	654610	99.51%	5	1.56%
贖	3345		22	5	0.0007601%	654615	99.51%	4	1.25%
趴	3346		9	5	0.0007601%	654620	99.51%	5	1.56%
跚	3347		12	5	0.0007601%	654625	99.52%	5	1.56%
跛	3348		12	5	0.0007601%	654630	99.52%	4	1.25%
踰	3349		16	5	0.0007601%	654635	99.52%	3	0.94%
蹦	3350		18	5	0.0007601%	654640	99.52%	4	1.25%
躓	3351		22	5	0.0007601%	654645	99.52%	2	0.63%
躬	3352		10	5	0.0007601%	654650	99.52%	5	1.56%
輻	3353		16	5	0.0007601%	654655	99.52%	4	1.25%
逅	3354		9	5	0.0007601%	654660	99.52%	4	1.25%
邂	3355		16	5	0.0007601%	654665	99.52%	4	1.25%
邐	3356		22	5	0.0007601%	654670	99.52%	5	1.56%
邸	3357		7	5	0.0007601%	654675	99.52%	2	0.63%
酥	3358		12	5	0.0007601%	654680	99.52%	4	1.25%
錮	3359		16	5	0.0007601%	654685	99.52%	3	0.94%
鎔	3360		18	5	0.0007601%	654690	99.53%	4	1.25%
鏽	3361		20	5	0.0007601%	654695	99.53%	5	1.56%
鐫	3362		21	5	0.0007601%	654700	99.53%	4	1.25%
鑄	3363		22	5	0.0007601%	654705	99.53%	4	1.25%
鑲	3364		25	5	0.0007601%	654710	99.53%	4	1.25%
隅	3365		11	5	0.0007601%	654715	99.53%	5	1.56%
霾	3366		22	5	0.0007601%	654720	99.53%	4	1.25%
靴	3367		13	5	0.0007601%	654725	99.53%	2	0.63%
颳	3368		15	5	0.0007601%	654730	99.53%	4	1.25%
飪	3369		12	5	0.0007601%	654735	99.53%	3	0.94%
飴	3370		13	5	0.0007601%	654740	99.53%	5	1.56%
饞	3371		25	5	0.0007601%	654745	99.53%	5	1.56%
馱	3372		13	5	0.0007601%	654750	99.53%	4	1.25%
馴	3373		13	5	0.0007601%	654755	99.54%	4	1.25%
駱	3374		16	5	0.0007601%	654760	99.54%	4	1.25%
驥	3375		26	5	0.0007601%	654765	99.54%	4	1.25%
魏	3376		18	5	0.0007601%	654770	99.54%	5	1.56%
魘	3377		24	5	0.0007601%	654775	99.54%	5	1.56%
鯉	3378		18	5	0.0007601%	654780	99.54%	3	0.94%
鱗	3379		23	5	0.0007601%	654785	99.54%	5	1.56%
鶯	3380		21	5	0.0007601%	654790	99.54%	4	1.25%
鷺	3381		24	5	0.0007601%	654795	99.54%	4	1.25%
丫	3382		3	4	0.0006081%	654799	99.54%	3	0.94%
么	3383		3	4	0.0006081%	654803	99.54%	4	1.25%
乒	3384		6	4	0.0006081%	654807	99.54%	3	0.94%
伕	3385		6	4	0.0006081%	654811	99.54%	2	0.63%
佃	3386		7	4	0.0006081%	654815	99.54%	3	0.94%
伶	3387		7	4	0.0006081%	654819	99.54%	3	0.94%
俎	3388		9	4	0.0006081%	654823	99.55%	3	0.94%
刁	3389		2	4	0.0006081%	654827	99.55%	3	0.94%
剷	3390		13	4	0.0006081%	654831	99.55%	4	1.25%
勘	3391		11	4	0.0006081%	654835	99.55%	4	1.25%
募	3392		13	4	0.0006081%	654839	99.55%	3	0.94%
勳	3393		16	4	0.0006081%	654843	99.55%	4	1.25%
勺	3394		3	4	0.0006081%	654847	99.55%	3	0.94%
勻	3395		4	4	0.0006081%	654851	99.55%	4	1.25%
匿	3396		11	4	0.0006081%	654855	99.55%	4	1.25%
吭	3397		7	4	0.0006081%	654859	99.55%	4	1.25%
呎	3398		7	4	0.0006081%	654863	99.55%	3	0.94%
吠	3399		7	4	0.0006081%	654867	99.55%	4	1.25%
咐	3400		8	4	0.0006081%	654871	99.55%	4	1.25%
咸	3401		9	4	0.0006081%	654875	99.55%	4	1.25%
咦	3402		9	4	0.0006081%	654879	99.55%	4	1.25%
咧	3403		9	4	0.0006081%	654883	99.55%	4	1.25%
啣	3404		11	4	0.0006081%	654887	99.56%	4	1.25%
啥	3405		11	4	0.0006081%	654891	99.56%	3	0.94%
唾	3406		12	4	0.0006081%	654895	99.56%	4	1.25%
嗣	3407		13	4	0.0006081%	654899	99.56%	4	1.25%
嗚	3408		13	4	0.0006081%	654903	99.56%	4	1.25%
嗡	3409		13	4	0.0006081%	654907	99.56%	2	0.63%
噢	3410		16	4	0.0006081%	654911	99.56%	3	0.94%
嚅	3411		17	4	0.0006081%	654915	99.56%	3	0.94%
囁	3412		21	4	0.0006081%	654919	99.56%	4	1.25%
埔	3413		10	4	0.0006081%	654923	99.56%	4	1.25%
堯	3414		12	4	0.0006081%	654927	99.56%	4	1.25%
壑	3415		17	4	0.0006081%	654931	99.56%	4	1.25%
壢	3416		19	4	0.0006081%	654935	99.56%	1	0.31%
壼	3417		13	4	0.0006081%	654939	99.56%	2	0.63%
奄	3418		8	4	0.0006081%	654943	99.56%	2	0.63%
奸	3419		6	4	0.0006081%	654947	99.56%	4	1.25%
娓	3420		10	4	0.0006081%	654951	99.56%	2	0.63%
娥	3421		10	4	0.0006081%	654955	99.57%	3	0.94%
娼	3422		11	4	0.0006081%	654959	99.57%	4	1.25%
婷	3423		12	4	0.0006081%	654963	99.57%	3	0.94%
嫗	3424		14	4	0.0006081%	654967	99.57%	3	0.94%
寇	3425		11	4	0.0006081%	654971	99.57%	3	0.94%
屹	3426		6	4	0.0006081%	654975	99.57%	4	1.25%
崢	3427		11	4	0.0006081%	654979	99.57%	4	1.25%
嶄	3428		14	4	0.0006081%	654983	99.57%	4	1.25%
嶼	3429		17	4	0.0006081%	654987	99.57%	4	1.25%
嶸	3430		17	4	0.0006081%	654991	99.57%	4	1.25%
巔	3431		22	4	0.0006081%	654995	99.57%	4	1.25%
幀	3432		12	4	0.0006081%	654999	99.57%	2	0.63%
廁	3433		12	4	0.0006081%	655003	99.57%	3	0.94%
弘	3434		5	4	0.0006081%	655007	99.57%	4	1.25%
弭	3435		9	4	0.0006081%	655011	99.57%	4	1.25%
彗	3436		11	4	0.0006081%	655015	99.57%	4	1.25%
徉	3437		9	4	0.0006081%	655019	99.58%	4	1.25%
徙	3438		11	4	0.0006081%	655023	99.58%	3	0.94%
徜	3439		11	4	0.0006081%	655027	99.58%	4	1.25%
忿	3440		8	4	0.0006081%	655031	99.58%	3	0.94%
怦	3441		8	4	0.0006081%	655035	99.58%	3	0.94%
悚	3442		10	4	0.0006081%	655039	99.58%	4	1.25%
愷	3443		13	4	0.0006081%	655043	99.58%	1	0.31%
懈	3444		16	4	0.0006081%	655047	99.58%	4	1.25%
憨	3445		16	4	0.0006081%	655051	99.58%	4	1.25%
戊	3446		5	4	0.0006081%	655055	99.58%	4	1.25%
抄	3447		7	4	0.0006081%	655059	99.58%	3	0.94%
捺	3448		11	4	0.0006081%	655063	99.58%	4	1.25%
据	3449		11	4	0.0006081%	655067	99.58%	4	1.25%
搓	3450		13	4	0.0006081%	655071	99.58%	4	1.25%
搧	3451		13	4	0.0006081%	655075	99.58%	3	0.94%
摺	3452		14	4	0.0006081%	655079	99.58%	4	1.25%
斂	3453		17	4	0.0006081%	655083	99.58%	4	1.25%
斃	3454		17	4	0.0006081%	655087	99.59%	3	0.94%
斟	3455		13	4	0.0006081%	655091	99.59%	4	1.25%
旬	3456		6	4	0.0006081%	655095	99.59%	4	1.25%
暉	3457		13	4	0.0006081%	655099	99.59%	4	1.25%
曆	3458		16	4	0.0006081%	655103	99.59%	4	1.25%
朴	3459		6	4	0.0006081%	655107	99.59%	2	0.63%
柚	3460		9	4	0.0006081%	655111	99.59%	3	0.94%
桔	3461		10	4	0.0006081%	655115	99.59%	1	0.31%
栗	3462		10	4	0.0006081%	655119	99.59%	4	1.25%
梨	3463		11	4	0.0006081%	655123	99.59%	3	0.94%
棠	3464		12	4	0.0006081%	655127	99.59%	3	0.94%
楔	3465		13	4	0.0006081%	655131	99.59%	3	0.94%
樞	3466		15	4	0.0006081%	655135	99.59%	4	1.25%
槽	3467		15	4	0.0006081%	655139	99.59%	3	0.94%
檻	3468		18	4	0.0006081%	655143	99.59%	3	0.94%
櫸	3469		21	4	0.0006081%	655147	99.59%	3	0.94%
殉	3470		10	4	0.0006081%	655151	99.60%	4	1.25%
汀	3471		5	4	0.0006081%	655155	99.60%	3	0.94%
汾	3472		7	4	0.0006081%	655159	99.60%	2	0.63%
泯	3473		8	4	0.0006081%	655163	99.60%	4	1.25%
涕	3474		10	4	0.0006081%	655167	99.60%	4	1.25%
涎	3475		11	4	0.0006081%	655171	99.60%	4	1.25%
淅	3476		11	4	0.0006081%	655175	99.60%	2	0.63%
淬	3477		11	4	0.0006081%	655179	99.60%	4	1.25%
渲	3478		12	4	0.0006081%	655183	99.60%	4	1.25%
渝	3479		12	4	0.0006081%	655187	99.60%	4	1.25%
淼	3480		12	4	0.0006081%	655191	99.60%	2	0.63%
濾	3481		18	4	0.0006081%	655195	99.60%	4	1.25%
瀑	3482		18	4	0.0006081%	655199	99.60%	4	1.25%
炬	3483		9	4	0.0006081%	655203	99.60%	3	0.94%
熒	3484		14	4	0.0006081%	655207	99.60%	2	0.63%
熠	3485		15	4	0.0006081%	655211	99.60%	3	0.94%
燬	3486		17	4	0.0006081%	655215	99.61%	3	0.94%
燻	3487		18	4	0.0006081%	655219	99.61%	2	0.63%
爹	3488		10	4	0.0006081%	655223	99.61%	4	1.25%
牟	3489		6	4	0.0006081%	655227	99.61%	4	1.25%
牡	3490		7	4	0.0006081%	655231	99.61%	3	0.94%
琢	3491		12	4	0.0006081%	655235	99.61%	4	1.25%
璣	3492		16	4	0.0006081%	655239	99.61%	3	0.94%
璞	3493		16	4	0.0006081%	655243	99.61%	4	1.25%
瓊	3494		19	4	0.0006081%	655247	99.61%	3	0.94%
瓢	3495		16	4	0.0006081%	655251	99.61%	4	1.25%
甬	3496		7	4	0.0006081%	655255	99.61%	2	0.63%
癥	3497		20	4	0.0006081%	655259	99.61%	4	1.25%
皎	3498		11	4	0.0006081%	655263	99.61%	4	1.25%
皚	3499		15	4	0.0006081%	655267	99.61%	2	0.63%
矢	3500		5	4	0.0006081%	655271	99.61%	4	1.25%
砰	3501		10	4	0.0006081%	655275	99.61%	3	0.94%
硯	3502		12	4	0.0006081%	655279	99.61%	1	0.31%
磊	3503		15	4	0.0006081%	655283	99.62%	3	0.94%
磯	3504		17	4	0.0006081%	655287	99.62%	4	1.25%
窯	3505		15	4	0.0006081%	655291	99.62%	3	0.94%
箏	3506		14	4	0.0006081%	655295	99.62%	4	1.25%
簑	3507		16	4	0.0006081%	655299	99.62%	2	0.63%
篷	3508		17	4	0.0006081%	655303	99.62%	4	1.25%
簫	3509		18	4	0.0006081%	655307	99.62%	4	1.25%
簸	3510		19	4	0.0006081%	655311	99.62%	3	0.94%
絢	3511		12	4	0.0006081%	655315	99.62%	4	1.25%
綣	3512		14	4	0.0006081%	655319	99.62%	4	1.25%
繚	3513		18	4	0.0006081%	655323	99.62%	4	1.25%
羈	3514		24	4	0.0006081%	655327	99.62%	4	1.25%
胰	3515		10	4	0.0006081%	655331	99.62%	1	0.31%
腋	3516		12	4	0.0006081%	655335	99.62%	2	0.63%
腑	3517		12	4	0.0006081%	655339	99.62%	4	1.25%
腮	3518		13	4	0.0006081%	655343	99.62%	4	1.25%
臆	3519		17	4	0.0006081%	655347	99.63%	4	1.25%
舜	3520		12	4	0.0006081%	655351	99.63%	4	1.25%
艦	3521		20	4	0.0006081%	655355	99.63%	4	1.25%
芻	3522		10	4	0.0006081%	655359	99.63%	4	1.25%
莘	3523		11	4	0.0006081%	655363	99.63%	2	0.63%
蒲	3524		14	4	0.0006081%	655367	99.63%	3	0.94%
蔑	3525		15	4	0.0006081%	655371	99.63%	4	1.25%
蚋	3526		10	4	0.0006081%	655375	99.63%	1	0.31%
蜷	3527		14	4	0.0006081%	655379	99.63%	4	1.25%
蝸	3528		15	4	0.0006081%	655383	99.63%	2	0.63%
螺	3529		17	4	0.0006081%	655387	99.63%	4	1.25%
蠟	3530		21	4	0.0006081%	655391	99.63%	2	0.63%
蠱	3531		23	4	0.0006081%	655395	99.63%	3	0.94%
袞	3532		11	4	0.0006081%	655399	99.63%	2	0.63%
詰	3533		13	4	0.0006081%	655403	99.63%	3	0.94%
詡	3534		13	4	0.0006081%	655407	99.63%	4	1.25%
諺	3535		16	4	0.0006081%	655411	99.63%	4	1.25%
諳	3536		16	4	0.0006081%	655415	99.64%	4	1.25%
賊	3537		13	4	0.0006081%	655419	99.64%	4	1.25%
貲	3538		13	4	0.0006081%	655423	99.64%	2	0.63%
贅	3539		18	4	0.0006081%	655427	99.64%	4	1.25%
踞	3540		15	4	0.0006081%	655431	99.64%	3	0.94%
蹂	3541		16	4	0.0006081%	655435	99.64%	4	1.25%
踵	3542		16	4	0.0006081%	655439	99.64%	4	1.25%
躪	3543		27	4	0.0006081%	655443	99.64%	4	1.25%
輟	3544		15	4	0.0006081%	655447	99.64%	4	1.25%
辟	3545		13	4	0.0006081%	655451	99.64%	4	1.25%
逍	3546		10	4	0.0006081%	655455	99.64%	4	1.25%
逕	3547		10	4	0.0006081%	655459	99.64%	2	0.63%
醃	3548		15	4	0.0006081%	655463	99.64%	4	1.25%
釁	3549		25	4	0.0006081%	655467	99.64%	4	1.25%
釉	3550		13	4	0.0006081%	655471	99.64%	1	0.31%
釦	3551		11	4	0.0006081%	655475	99.64%	3	0.94%
鈣	3552		12	4	0.0006081%	655479	99.65%	1	0.31%
	3553		15	4	0.0006081%	655483	99.65%	3	0.94%
鍛	3554		17	4	0.0006081%	655487	99.65%	3	0.94%
鏟	3555		19	4	0.0006081%	655491	99.65%	3	0.94%
鏗	3556		19	4	0.0006081%	655495	99.65%	4	1.25%
閑	3557		12	4	0.0006081%	655499	99.65%	3	0.94%
閤	3558		14	4	0.0006081%	655503	99.65%	4	1.25%
閻	3559		16	4	0.0006081%	655507	99.65%	3	0.94%
阡	3560		5	4	0.0006081%	655511	99.65%	4	1.25%
霖	3561		16	4	0.0006081%	655515	99.65%	3	0.94%
靡	3562		19	4	0.0006081%	655519	99.65%	3	0.94%
鞦	3563		18	4	0.0006081%	655523	99.65%	2	0.63%
韁	3564		22	4	0.0006081%	655527	99.65%	3	0.94%
韆	3565		24	4	0.0006081%	655531	99.65%	2	0.63%
韶	3566		14	4	0.0006081%	655535	99.65%	3	0.94%
飆	3567		21	4	0.0006081%	655539	99.65%	4	1.25%
飼	3568		13	4	0.0006081%	655543	99.65%	4	1.25%
馥	3569		18	4	0.0006081%	655547	99.66%	4	1.25%
驢	3570		26	4	0.0006081%	655551	99.66%	3	0.94%
鮑	3571		16	4	0.0006081%	655555	99.66%	4	1.25%
鱷	3572		27	4	0.0006081%	655559	99.66%	1	0.31%
鷥	3573		23	4	0.0006081%	655563	99.66%	3	0.94%
麝	3574		21	4	0.0006081%	655567	99.66%	1	0.31%
丐	3575		4	3	0.0004561%	655570	99.66%	3	0.94%
乓	3576		6	3	0.0004561%	655573	99.66%	2	0.63%
仄	3577		4	3	0.0004561%	655576	99.66%	3	0.94%
伽	3578		7	3	0.0004561%	655579	99.66%	2	0.63%
俑	3579		9	3	0.0004561%	655582	99.66%	1	0.31%
俟	3580		9	3	0.0004561%	655585	99.66%	3	0.94%
倥	3581		10	3	0.0004561%	655588	99.66%	3	0.94%
倔	3582		10	3	0.0004561%	655591	99.66%	3	0.94%
倪	3583		10	3	0.0004561%	655594	99.66%	3	0.94%
傚	3584		12	3	0.0004561%	655597	99.66%	3	0.94%
傯	3585		13	3	0.0004561%	655600	99.66%	3	0.94%
僥	3586		14	3	0.0004561%	655603	99.66%	3	0.94%
冕	3587		11	3	0.0004561%	655606	99.66%	3	0.94%
冶	3588		7	3	0.0004561%	655609	99.66%	3	0.94%
冽	3589		8	3	0.0004561%	655612	99.67%	3	0.94%
几	3590		2	3	0.0004561%	655615	99.67%	2	0.63%
卦	3591		8	3	0.0004561%	655618	99.67%	3	0.94%
卯	3592		5	3	0.0004561%	655621	99.67%	3	0.94%
叱	3593		5	3	0.0004561%	655624	99.67%	3	0.94%
呷	3594		8	3	0.0004561%	655627	99.67%	3	0.94%
咆	3595		8	3	0.0004561%	655630	99.67%	3	0.94%
咋	3596		8	3	0.0004561%	655633	99.67%	3	0.94%
哮	3597		10	3	0.0004561%	655636	99.67%	3	0.94%
唬	3598		11	3	0.0004561%	655639	99.67%	3	0.94%
啁	3599		11	3	0.0004561%	655642	99.67%	2	0.63%
喏	3600		12	3	0.0004561%	655645	99.67%	2	0.63%
嘎	3601		14	3	0.0004561%	655648	99.67%	2	0.63%
嘮	3602		15	3	0.0004561%	655651	99.67%	2	0.63%
嚏	3603		17	3	0.0004561%	655654	99.67%	2	0.63%
囿	3604		9	3	0.0004561%	655657	99.67%	3	0.94%
坪	3605		8	3	0.0004561%	655660	99.67%	3	0.94%
垓	3606		9	3	0.0004561%	655663	99.67%	2	0.63%
埂	3607		10	3	0.0004561%	655666	99.67%	2	0.63%
墅	3608		14	3	0.0004561%	655669	99.67%	3	0.94%
壕	3609		17	3	0.0004561%	655672	99.67%	2	0.63%
夸	3610		6	3	0.0004561%	655675	99.67%	2	0.63%
奎	3611		9	3	0.0004561%	655678	99.68%	2	0.63%
妖	3612		7	3	0.0004561%	655681	99.68%	3	0.94%
嫦	3613		14	3	0.0004561%	655684	99.68%	3	0.94%
嫣	3614		14	3	0.0004561%	655687	99.68%	3	0.94%
嬝	3615		16	3	0.0004561%	655690	99.68%	1	0.31%
嬸	3616		18	3	0.0004561%	655693	99.68%	3	0.94%
孜	3617		7	3	0.0004561%	655696	99.68%	2	0.63%
孵	3618		14	3	0.0004561%	655699	99.68%	3	0.94%
孿	3619		22	3	0.0004561%	655702	99.68%	2	0.63%
寅	3620		11	3	0.0004561%	655705	99.68%	3	0.94%
岐	3621		7	3	0.0004561%	655708	99.68%	3	0.94%
崎	3622		11	3	0.0004561%	655711	99.68%	3	0.94%
崛	3623		11	3	0.0004561%	655714	99.68%	3	0.94%
崔	3624		11	3	0.0004561%	655717	99.68%	3	0.94%
帚	3625		8	3	0.0004561%	655720	99.68%	2	0.63%
帛	3626		8	3	0.0004561%	655723	99.68%	3	0.94%
帙	3627		8	3	0.0004561%	655726	99.68%	2	0.63%
并	3628		6	3	0.0004561%	655729	99.68%	2	0.63%
弧	3629		8	3	0.0004561%	655732	99.68%	3	0.94%
弩	3630		8	3	0.0004561%	655735	99.68%	2	0.63%
彆	3631		14	3	0.0004561%	655738	99.68%	2	0.63%
御	3632		11	3	0.0004561%	655741	99.69%	3	0.94%
徽	3633		17	3	0.0004561%	655744	99.69%	3	0.94%
忖	3634		6	3	0.0004561%	655747	99.69%	3	0.94%
忪	3635		7	3	0.0004561%	655750	99.69%	3	0.94%
惺	3636		12	3	0.0004561%	655753	99.69%	3	0.94%
愫	3637		13	3	0.0004561%	655756	99.69%	3	0.94%
慵	3638		14	3	0.0004561%	655759	99.69%	2	0.63%
懨	3639		17	3	0.0004561%	655762	99.69%	2	0.63%
戎	3640		6	3	0.0004561%	655765	99.69%	3	0.94%
戛	3641		11	3	0.0004561%	655768	99.69%	2	0.63%
戢	3642		13	3	0.0004561%	655771	99.69%	3	0.94%
戾	3643		8	3	0.0004561%	655774	99.69%	3	0.94%
扞	3644		6	3	0.0004561%	655777	99.69%	3	0.94%
拌	3645		8	3	0.0004561%	655780	99.69%	3	0.94%
抿	3646		8	3	0.0004561%	655783	99.69%	3	0.94%
拮	3647		9	3	0.0004561%	655786	99.69%	3	0.94%
掄	3648		11	3	0.0004561%	655789	99.69%	3	0.94%
掬	3649		11	3	0.0004561%	655792	99.69%	3	0.94%
捩	3650		11	3	0.0004561%	655795	99.69%	3	0.94%
掣	3651		12	3	0.0004561%	655798	99.69%	3	0.94%
捶	3652		12	3	0.0004561%	655801	99.69%	3	0.94%
搪	3653		13	3	0.0004561%	655804	99.69%	3	0.94%
撇	3654		14	3	0.0004561%	655807	99.70%	3	0.94%
擄	3655		16	3	0.0004561%	655810	99.70%	3	0.94%
擘	3656		17	3	0.0004561%	655813	99.70%	3	0.94%
昀	3657		8	3	0.0004561%	655816	99.70%	2	0.63%
晌	3658		10	3	0.0004561%	655819	99.70%	2	0.63%
暨	3659		14	3	0.0004561%	655822	99.70%	3	0.94%
暱	3660		15	3	0.0004561%	655825	99.70%	3	0.94%
曙	3661		17	3	0.0004561%	655828	99.70%	3	0.94%
朔	3662		10	3	0.0004561%	655831	99.70%	3	0.94%
朦	3663		18	3	0.0004561%	655834	99.70%	3	0.94%
朧	3664		20	3	0.0004561%	655837	99.70%	3	0.94%
杭	3665		8	3	0.0004561%	655840	99.70%	3	0.94%
杰	3666		8	3	0.0004561%	655843	99.70%	2	0.63%
柢	3667		9	3	0.0004561%	655846	99.70%	3	0.94%
桐	3668		10	3	0.0004561%	655849	99.70%	3	0.94%
梗	3669		11	3	0.0004561%	655852	99.70%	2	0.63%
棗	3670		12	3	0.0004561%	655855	99.70%	3	0.94%
棧	3671		12	3	0.0004561%	655858	99.70%	3	0.94%
椒	3672		12	3	0.0004561%	655861	99.70%	2	0.63%
榆	3673		13	3	0.0004561%	655864	99.70%	3	0.94%
椿	3674		13	3	0.0004561%	655867	99.70%	3	0.94%
樺	3675		16	3	0.0004561%	655870	99.70%	3	0.94%
橡	3676		16	3	0.0004561%	655873	99.71%	3	0.94%
檀	3677		17	3	0.0004561%	655876	99.71%	3	0.94%
櫚	3678		19	3	0.0004561%	655879	99.71%	1	0.31%
殃	3679		9	3	0.0004561%	655882	99.71%	3	0.94%
殆	3680		9	3	0.0004561%	655885	99.71%	3	0.94%
氈	3681		17	3	0.0004561%	655888	99.71%	3	0.94%
氤	3682		10	3	0.0004561%	655891	99.71%	2	0.63%
氫	3683		11	3	0.0004561%	655894	99.71%	3	0.94%
氰	3684		12	3	0.0004561%	655897	99.71%	1	0.31%
氳	3685		14	3	0.0004561%	655900	99.71%	2	0.63%
汔	3686		6	3	0.0004561%	655903	99.71%	3	0.94%
沽	3687		8	3	0.0004561%	655906	99.71%	3	0.94%
涇	3688		10	3	0.0004561%	655909	99.71%	3	0.94%
浦	3689		10	3	0.0004561%	655912	99.71%	3	0.94%
涅	3690		10	3	0.0004561%	655915	99.71%	3	0.94%
淳	3691		11	3	0.0004561%	655918	99.71%	3	0.94%
湛	3692		12	3	0.0004561%	655921	99.71%	3	0.94%
渭	3693		12	3	0.0004561%	655924	99.71%	3	0.94%
湍	3694		12	3	0.0004561%	655927	99.71%	3	0.94%
滇	3695		13	3	0.0004561%	655930	99.71%	2	0.63%
漱	3696		14	3	0.0004561%	655933	99.71%	3	0.94%
澡	3697		16	3	0.0004561%	655936	99.71%	3	0.94%
濘	3698		17	3	0.0004561%	655939	99.72%	3	0.94%
濠	3699		17	3	0.0004561%	655942	99.72%	1	0.31%
瀕	3700		19	3	0.0004561%	655945	99.72%	3	0.94%
灸	3701		7	3	0.0004561%	655948	99.72%	1	0.31%
燎	3702		16	3	0.0004561%	655951	99.72%	3	0.94%
燠	3703		17	3	0.0004561%	655954	99.72%	2	0.63%
狎	3704		8	3	0.0004561%	655957	99.72%	3	0.94%
狽	3705		10	3	0.0004561%	655960	99.72%	3	0.94%
狸	3706		10	3	0.0004561%	655963	99.72%	2	0.63%
猖	3707		11	3	0.0004561%	655966	99.72%	2	0.63%
猙	3708		11	3	0.0004561%	655969	99.72%	2	0.63%
獃	3709		14	3	0.0004561%	655972	99.72%	1	0.31%
獗	3710		15	3	0.0004561%	655975	99.72%	2	0.63%
獰	3711		17	3	0.0004561%	655978	99.72%	2	0.63%
獷	3712		18	3	0.0004561%	655981	99.72%	3	0.94%
琛	3713		12	3	0.0004561%	655984	99.72%	2	0.63%
瑯	3714		13	3	0.0004561%	655987	99.72%	3	0.94%
瑚	3715		13	3	0.0004561%	655990	99.72%	3	0.94%
瑤	3716		14	3	0.0004561%	655993	99.72%	3	0.94%
璧	3717		18	3	0.0004561%	655996	99.72%	2	0.63%
瓏	3718		20	3	0.0004561%	655999	99.72%	3	0.94%
甕	3719		18	3	0.0004561%	656002	99.72%	3	0.94%
畝	3720		10	3	0.0004561%	656005	99.73%	3	0.94%
畜	3721		10	3	0.0004561%	656008	99.73%	3	0.94%
痔	3722		11	3	0.0004561%	656011	99.73%	3	0.94%
痳	3723		13	3	0.0004561%	656014	99.73%	3	0.94%
痹	3724		13	3	0.0004561%	656017	99.73%	2	0.63%
瘠	3725		15	3	0.0004561%	656020	99.73%	3	0.94%
癟	3726		19	3	0.0004561%	656023	99.73%	3	0.94%
皈	3727		9	3	0.0004561%	656026	99.73%	3	0.94%
盱	3728		8	3	0.0004561%	656029	99.73%	3	0.94%
眶	3729		11	3	0.0004561%	656032	99.73%	3	0.94%
睦	3730		13	3	0.0004561%	656035	99.73%	3	0.94%
睞	3731		13	3	0.0004561%	656038	99.73%	3	0.94%
睿	3732		14	3	0.0004561%	656041	99.73%	3	0.94%
瞠	3733		16	3	0.0004561%	656044	99.73%	3	0.94%
砭	3734		10	3	0.0004561%	656047	99.73%	2	0.63%
磕	3735		15	3	0.0004561%	656050	99.73%	2	0.63%
礡	3736		19	3	0.0004561%	656053	99.73%	3	0.94%
礫	3737		20	3	0.0004561%	656056	99.73%	3	0.94%
祠	3738		9	3	0.0004561%	656059	99.73%	2	0.63%
祿	3739		12	3	0.0004561%	656062	99.73%	3	0.94%
禧	3740		16	3	0.0004561%	656065	99.73%	2	0.63%
禹	3741		9	3	0.0004561%	656068	99.73%	3	0.94%
稔	3742		13	3	0.0004561%	656071	99.74%	3	0.94%
穌	3743		16	3	0.0004561%	656074	99.74%	3	0.94%
穗	3744		17	3	0.0004561%	656077	99.74%	3	0.94%
穢	3745		18	3	0.0004561%	656080	99.74%	3	0.94%
穹	3746		8	3	0.0004561%	656083	99.74%	3	0.94%
竇	3747		20	3	0.0004561%	656086	99.74%	2	0.63%
竺	3748		8	3	0.0004561%	656089	99.74%	2	0.63%
筐	3749		12	3	0.0004561%	656092	99.74%	3	0.94%
箸	3750		14	3	0.0004561%	656095	99.74%	3	0.94%
箇	3751		14	3	0.0004561%	656098	99.74%	2	0.63%
篋	3752		15	3	0.0004561%	656101	99.74%	2	0.63%
簍	3753		17	3	0.0004561%	656104	99.74%	3	0.94%
籟	3754		22	3	0.0004561%	656107	99.74%	2	0.63%
粘	3755		11	3	0.0004561%	656110	99.74%	2	0.63%
絃	3756		11	3	0.0004561%	656113	99.74%	3	0.94%
紳	3757		11	3	0.0004561%	656116	99.74%	3	0.94%
辮	3758		20	3	0.0004561%	656119	99.74%	2	0.63%
羚	3759		11	3	0.0004561%	656122	99.74%	2	0.63%
羲	3760		16	3	0.0004561%	656125	99.74%	3	0.94%
翡	3761		14	3	0.0004561%	656128	99.74%	2	0.63%
翳	3762		17	3	0.0004561%	656131	99.74%	2	0.63%
聾	3763		22	3	0.0004561%	656134	99.74%	3	0.94%
腥	3764		13	3	0.0004561%	656137	99.75%	3	0.94%
膳	3765		16	3	0.0004561%	656140	99.75%	3	0.94%
臍	3766		18	3	0.0004561%	656143	99.75%	3	0.94%
舐	3767		10	3	0.0004561%	656146	99.75%	2	0.63%
舛	3768		6	3	0.0004561%	656149	99.75%	2	0.63%
舶	3769		11	3	0.0004561%	656152	99.75%	3	0.94%
艙	3770		16	3	0.0004561%	656155	99.75%	3	0.94%
芥	3771		8	3	0.0004561%	656158	99.75%	3	0.94%
茉	3772		9	3	0.0004561%	656161	99.75%	1	0.31%
苯	3773		9	3	0.0004561%	656164	99.75%	2	0.63%
茵	3774		10	3	0.0004561%	656167	99.75%	3	0.94%
荖	3775		10	3	0.0004561%	656170	99.75%	2	0.63%
萃	3776		12	3	0.0004561%	656173	99.75%	2	0.63%
菱	3777		12	3	0.0004561%	656176	99.75%	3	0.94%
蓆	3778		14	3	0.0004561%	656179	99.75%	3	0.94%
蓀	3779		14	3	0.0004561%	656182	99.75%	2	0.63%
蕊	3780		16	3	0.0004561%	656185	99.75%	3	0.94%
薇	3781		17	3	0.0004561%	656188	99.75%	2	0.63%
藜	3782		19	3	0.0004561%	656191	99.75%	2	0.63%
藹	3783		20	3	0.0004561%	656194	99.75%	3	0.94%
虜	3784		13	3	0.0004561%	656197	99.75%	3	0.94%
蜻	3785		14	3	0.0004561%	656200	99.75%	3	0.94%
螃	3786		16	3	0.0004561%	656203	99.76%	3	0.94%
蟀	3787		17	3	0.0004561%	656206	99.76%	2	0.63%
蟋	3788		17	3	0.0004561%	656209	99.76%	2	0.63%
衊	3789		21	3	0.0004561%	656212	99.76%	3	0.94%
衙	3790		13	3	0.0004561%	656215	99.76%	1	0.31%
袁	3791		10	3	0.0004561%	656218	99.76%	3	0.94%
褂	3792		13	3	0.0004561%	656221	99.76%	1	0.31%
褶	3793		16	3	0.0004561%	656224	99.76%	3	0.94%
襉	3794		17	3	0.0004561%	656227	99.76%	1	0.31%
訣	3795		11	3	0.0004561%	656230	99.76%	3	0.94%
訧	3796		11	3	0.0004561%	656233	99.76%	2	0.63%
詫	3797		13	3	0.0004561%	656236	99.76%	3	0.94%
詣	3798		13	3	0.0004561%	656239	99.76%	2	0.63%
誡	3799		14	3	0.0004561%	656242	99.76%	3	0.94%
諭	3800		16	3	0.0004561%	656245	99.76%	3	0.94%
謄	3801		17	3	0.0004561%	656248	99.76%	3	0.94%
謐	3802		17	3	0.0004561%	656251	99.76%	3	0.94%
謾	3803		18	3	0.0004561%	656254	99.76%	3	0.94%
譴	3804		21	3	0.0004561%	656257	99.76%	3	0.94%
豹	3805		10	3	0.0004561%	656260	99.76%	3	0.94%
貂	3806		12	3	0.0004561%	656263	99.76%	2	0.63%
賂	3807		13	3	0.0004561%	656266	99.76%	1	0.31%
贓	3808		21	3	0.0004561%	656269	99.77%	3	0.94%
趾	3809		11	3	0.0004561%	656272	99.77%	3	0.94%
趿	3810		11	3	0.0004561%	656275	99.77%	3	0.94%
跎	3811		12	3	0.0004561%	656278	99.77%	3	0.94%
跫	3812		13	3	0.0004561%	656281	99.77%	3	0.94%
踮	3813		15	3	0.0004561%	656284	99.77%	3	0.94%
踴	3814		16	3	0.0004561%	656287	99.77%	3	0.94%
蹉	3815		17	3	0.0004561%	656290	99.77%	3	0.94%
蹴	3816		19	3	0.0004561%	656293	99.77%	3	0.94%
躅	3817		20	3	0.0004561%	656296	99.77%	3	0.94%
躑	3818		22	3	0.0004561%	656299	99.77%	3	0.94%
軼	3819		12	3	0.0004561%	656302	99.77%	2	0.63%
轍	3820		18	3	0.0004561%	656305	99.77%	3	0.94%
迂	3821		6	3	0.0004561%	656308	99.77%	3	0.94%
迦	3822		8	3	0.0004561%	656311	99.77%	3	0.94%
逞	3823		10	3	0.0004561%	656314	99.77%	3	0.94%
邵	3824		7	3	0.0004561%	656317	99.77%	2	0.63%
醺	3825		21	3	0.0004561%	656320	99.77%	2	0.63%
鈞	3826		12	3	0.0004561%	656323	99.77%	2	0.63%
鉗	3827		13	3	0.0004561%	656326	99.77%	1	0.31%
鉀	3828		13	3	0.0004561%	656329	99.77%	1	0.31%
銓	3829		14	3	0.0004561%	656332	99.77%	2	0.63%
錐	3830		16	3	0.0004561%	656335	99.78%	3	0.94%
鏘	3831		19	3	0.0004561%	656338	99.78%	3	0.94%
鑒	3832		22	3	0.0004561%	656341	99.78%	3	0.94%
闋	3833		17	3	0.0004561%	656344	99.78%	2	0.63%
闕	3834		18	3	0.0004561%	656347	99.78%	3	0.94%
陞	3835		9	3	0.0004561%	656350	99.78%	2	0.63%
隸	3836		17	3	0.0004561%	656353	99.78%	3	0.94%
霏	3837		16	3	0.0004561%	656356	99.78%	2	0.63%
靨	3838		23	3	0.0004561%	656359	99.78%	3	0.94%
鞍	3839		15	3	0.0004561%	656362	99.78%	1	0.31%
鞠	3840		17	3	0.0004561%	656365	99.78%	3	0.94%
顥	3841		21	3	0.0004561%	656368	99.78%	3	0.94%
餿	3842		17	3	0.0004561%	656371	99.78%	2	0.63%
饅	3843		19	3	0.0004561%	656374	99.78%	3	0.94%
骼	3844		16	3	0.0004561%	656377	99.78%	3	0.94%
鮭	3845		17	3	0.0004561%	656380	99.78%	2	0.63%
鴣	3846		16	3	0.0004561%	656383	99.78%	2	0.63%
鶉	3847		19	3	0.0004561%	656386	99.78%	1	0.31%
鵪	3848		19	3	0.0004561%	656389	99.78%	1	0.31%
鷓	3849		22	3	0.0004561%	656392	99.78%	2	0.63%
鹹	3850		20	3	0.0004561%	656395	99.78%	3	0.94%
麴	3851		19	3	0.0004561%	656398	99.78%	3	0.94%
鼾	3852		17	3	0.0004561%	656401	99.79%	3	0.94%
齟	3853		20	3	0.0004561%	656404	99.79%	3	0.94%
齬	3854		22	3	0.0004561%	656407	99.79%	3	0.94%
丕	3855		5	2	0.000304%	656409	99.79%	2	0.63%
亨	3856		7	2	0.000304%	656411	99.79%	2	0.63%
伎	3857		6	2	0.000304%	656413	99.79%	2	0.63%
佰	3858		8	2	0.000304%	656415	99.79%	1	0.31%
俏	3859		9	2	0.000304%	656417	99.79%	2	0.63%
俘	3860		9	2	0.000304%	656419	99.79%	2	0.63%
倌	3861		10	2	0.000304%	656421	99.79%	1	0.31%
倨	3862		10	2	0.000304%	656423	99.79%	2	0.63%
俾	3863		10	2	0.000304%	656425	99.79%	2	0.63%
傀	3864		12	2	0.000304%	656427	99.79%	2	0.63%
儡	3865		17	2	0.000304%	656429	99.79%	2	0.63%
兌	3866		7	2	0.000304%	656431	99.79%	2	0.63%
冗	3867		4	2	0.000304%	656433	99.79%	2	0.63%
凜	3868		15	2	0.000304%	656435	99.79%	2	0.63%
刈	3869		4	2	0.000304%	656437	99.79%	1	0.31%
刎	3870		6	2	0.000304%	656439	99.79%	1	0.31%
刨	3871		7	2	0.000304%	656441	99.79%	2	0.63%
剃	3872		9	2	0.000304%	656443	99.79%	2	0.63%
匍	3873		9	2	0.000304%	656445	99.79%	2	0.63%
匐	3874		11	2	0.000304%	656447	99.79%	2	0.63%
匡	3875		6	2	0.000304%	656449	99.79%	2	0.63%
叨	3876		5	2	0.000304%	656451	99.79%	1	0.31%
吒	3877		6	2	0.000304%	656453	99.79%	2	0.63%
呱	3878		8	2	0.000304%	656455	99.79%	1	0.31%
咿	3879		9	2	0.000304%	656457	99.79%	1	0.31%
唆	3880		10	2	0.000304%	656459	99.79%	2	0.63%
唧	3881		10	2	0.000304%	656461	99.79%	1	0.31%
哽	3882		10	2	0.000304%	656463	99.79%	2	0.63%
唏	3883		10	2	0.000304%	656465	99.80%	2	0.63%
啄	3884		11	2	0.000304%	656467	99.80%	2	0.63%
啖	3885		11	2	0.000304%	656469	99.80%	2	0.63%
喀	3886		12	2	0.000304%	656471	99.80%	2	0.63%
喋	3887		12	2	0.000304%	656473	99.80%	1	0.31%
喑	3888		12	2	0.000304%	656475	99.80%	1	0.31%
嗝	3889		13	2	0.000304%	656477	99.80%	2	0.63%
嘖	3890		14	2	0.000304%	656479	99.80%	1	0.31%
嘓	3891		14	2	0.000304%	656481	99.80%	1	0.31%
嘹	3892		15	2	0.000304%	656483	99.80%	2	0.63%
噁	3893		15	2	0.000304%	656485	99.80%	2	0.63%
噙	3894		16	2	0.000304%	656487	99.80%	1	0.31%
噠	3895		16	2	0.000304%	656489	99.80%	1	0.31%
囀	3896		21	2	0.000304%	656491	99.80%	2	0.63%
囈	3897		22	2	0.000304%	656493	99.80%	2	0.63%
囌	3898		23	2	0.000304%	656495	99.80%	1	0.31%
圇	3899		11	2	0.000304%	656497	99.80%	2	0.63%
圜	3900		16	2	0.000304%	656499	99.80%	2	0.63%
坍	3901		7	2	0.000304%	656501	99.80%	2	0.63%
埕	3902		10	2	0.000304%	656503	99.80%	2	0.63%
埠	3903		11	2	0.000304%	656505	99.80%	1	0.31%
塭	3904		13	2	0.000304%	656507	99.80%	2	0.63%
墀	3905		15	2	0.000304%	656509	99.80%	2	0.63%
壅	3906		16	2	0.000304%	656511	99.80%	1	0.31%
壩	3907		24	2	0.000304%	656513	99.80%	1	0.31%
夙	3908		6	2	0.000304%	656515	99.80%	1	0.31%
娑	3909		10	2	0.000304%	656517	99.80%	2	0.63%
娟	3910		10	2	0.000304%	656519	99.80%	2	0.63%
娩	3911		10	2	0.000304%	656521	99.80%	2	0.63%
娉	3912		10	2	0.000304%	656523	99.80%	2	0.63%
嫄	3913		13	2	0.000304%	656525	99.80%	1	0.31%
嫖	3914		14	2	0.000304%	656527	99.80%	2	0.63%
孀	3915		20	2	0.000304%	656529	99.80%	2	0.63%
宕	3916		8	2	0.000304%	656531	99.81%	2	0.63%
宦	3917		9	2	0.000304%	656533	99.81%	2	0.63%
寐	3918		12	2	0.000304%	656535	99.81%	2	0.63%
岔	3919		7	2	0.000304%	656537	99.81%	2	0.63%
嵯	3920		13	2	0.000304%	656539	99.81%	2	0.63%
嶽	3921		17	2	0.000304%	656541	99.81%	2	0.63%
巫	3922		7	2	0.000304%	656543	99.81%	1	0.31%
帷	3923		11	2	0.000304%	656545	99.81%	2	0.63%
幔	3924		14	2	0.000304%	656547	99.81%	2	0.63%
庖	3925		8	2	0.000304%	656549	99.81%	2	0.63%
廖	3926		14	2	0.000304%	656551	99.81%	2	0.63%
廕	3927		14	2	0.000304%	656553	99.81%	1	0.31%
彀	3928		13	2	0.000304%	656555	99.81%	2	0.63%
彊	3929		16	2	0.000304%	656557	99.81%	2	0.63%
恤	3930		9	2	0.000304%	656559	99.81%	2	0.63%
恂	3931		9	2	0.000304%	656561	99.81%	1	0.31%
恙	3932		10	2	0.000304%	656563	99.81%	2	0.63%
悖	3933		10	2	0.000304%	656565	99.81%	2	0.63%
愣	3934		12	2	0.000304%	656567	99.81%	2	0.63%
憚	3935		15	2	0.000304%	656569	99.81%	2	0.63%
懍	3936		16	2	0.000304%	656571	99.81%	2	0.63%
懣	3937		18	2	0.000304%	656573	99.81%	2	0.63%
懟	3938		18	2	0.000304%	656575	99.81%	2	0.63%
懹	3939		20	2	0.000304%	656577	99.81%	1	0.31%
扼	3940		7	2	0.000304%	656579	99.81%	2	0.63%
拄	3941		8	2	0.000304%	656581	99.81%	2	0.63%
拇	3942		8	2	0.000304%	656583	99.81%	2	0.63%
捎	3943		10	2	0.000304%	656585	99.81%	2	0.63%
捆	3944		10	2	0.000304%	656587	99.81%	1	0.31%
捫	3945		11	2	0.000304%	656589	99.81%	2	0.63%
挲	3946		11	2	0.000304%	656591	99.81%	2	0.63%
掂	3947		11	2	0.000304%	656593	99.81%	2	0.63%
掐	3948		11	2	0.000304%	656595	99.81%	1	0.31%
揩	3949		12	2	0.000304%	656597	99.82%	2	0.63%
揍	3950		12	2	0.000304%	656599	99.82%	2	0.63%
揪	3951		12	2	0.000304%	656601	99.82%	2	0.63%
揶	3952		12	2	0.000304%	656603	99.82%	2	0.63%
揄	3953		12	2	0.000304%	656605	99.82%	2	0.63%
搆	3954		13	2	0.000304%	656607	99.82%	1	0.31%
摃	3955		13	2	0.000304%	656609	99.82%	2	0.63%
搟	3956		13	2	0.000304%	656611	99.82%	2	0.63%
撩	3957		15	2	0.000304%	656613	99.82%	1	0.31%
撚	3958		15	2	0.000304%	656615	99.82%	2	0.63%
擂	3959		16	2	0.000304%	656617	99.82%	2	0.63%
攙	3960		20	2	0.000304%	656619	99.82%	2	0.63%
攢	3961		22	2	0.000304%	656621	99.82%	2	0.63%
攣	3962		23	2	0.000304%	656623	99.82%	2	0.63%
敻	3963		15	2	0.000304%	656625	99.82%	2	0.63%
斕	3964		21	2	0.000304%	656627	99.82%	2	0.63%
旄	3965		10	2	0.000304%	656629	99.82%	1	0.31%
旌	3966		11	2	0.000304%	656631	99.82%	1	0.31%
晏	3967		10	2	0.000304%	656633	99.82%	2	0.63%
朕	3968		10	2	0.000304%	656635	99.82%	1	0.31%
朼	3969		6	2	0.000304%	656637	99.82%	1	0.31%
杳	3970		8	2	0.000304%	656639	99.82%	2	0.63%
柙	3971		9	2	0.000304%	656641	99.82%	1	0.31%
柒	3972		9	2	0.000304%	656643	99.82%	1	0.31%
桓	3973		10	2	0.000304%	656645	99.82%	2	0.63%
桉	3974		10	2	0.000304%	656647	99.82%	1	0.31%
栖	3975		10	2	0.000304%	656649	99.82%	1	0.31%
桎	3976		10	2	0.000304%	656651	99.82%	2	0.63%
梓	3977		11	2	0.000304%	656653	99.82%	1	0.31%
梏	3978		11	2	0.000304%	656655	99.82%	2	0.63%
楠	3979		13	2	0.000304%	656657	99.82%	2	0.63%
楫	3980		13	2	0.000304%	656659	99.82%	2	0.63%
楝	3981		13	2	0.000304%	656661	99.82%	2	0.63%
楣	3982		13	2	0.000304%	656663	99.83%	2	0.63%
楬	3983		13	2	0.000304%	656665	99.83%	2	0.63%
椽	3984		13	2	0.000304%	656667	99.83%	2	0.63%
榨	3985		14	2	0.000304%	656669	99.83%	2	0.63%
槁	3986		14	2	0.000304%	656671	99.83%	2	0.63%
榭	3987		14	2	0.000304%	656673	99.83%	2	0.63%
槭	3988		15	2	0.000304%	656675	99.83%	2	0.63%
槿	3989		15	2	0.000304%	656677	99.83%	1	0.31%
樽	3990		16	2	0.000304%	656679	99.83%	2	0.63%
橢	3991		16	2	0.000304%	656681	99.83%	2	0.63%
櫛	3992		17	2	0.000304%	656683	99.83%	2	0.63%
檬	3993		18	2	0.000304%	656685	99.83%	2	0.63%
檸	3994		18	2	0.000304%	656687	99.83%	2	0.63%
櫫	3995		19	2	0.000304%	656689	99.83%	2	0.63%
櫺	3996		21	2	0.000304%	656691	99.83%	2	0.63%
歛	3997		17	2	0.000304%	656693	99.83%	2	0.63%
殄	3998		9	2	0.000304%	656695	99.83%	1	0.31%
毽	3999		13	2	0.000304%	656697	99.83%	1	0.31%
毿	4000		15	2	0.000304%	656699	99.83%	1	0.31%
氮	4001		12	2	0.000304%	656701	99.83%	2	0.63%
汜	4002		6	2	0.000304%	656703	99.83%	1	0.31%
沌	4003		7	2	0.000304%	656705	99.83%	2	0.63%
沂	4004		7	2	0.000304%	656707	99.83%	2	0.63%
沏	4005		7	2	0.000304%	656709	99.83%	2	0.63%
泄	4006		8	2	0.000304%	656711	99.83%	2	0.63%
泹	4007		8	2	0.000304%	656713	99.83%	1	0.31%
浣	4008		10	2	0.000304%	656715	99.83%	2	0.63%
淦	4009		11	2	0.000304%	656717	99.83%	2	0.63%
淖	4010		11	2	0.000304%	656719	99.83%	2	0.63%
湮	4011		12	2	0.000304%	656721	99.83%	2	0.63%
溲	4012		12	2	0.000304%	656723	99.83%	1	0.31%
滓	4013		13	2	0.000304%	656725	99.83%	2	0.63%
漉	4014		14	2	0.000304%	656727	99.83%	1	0.31%
潢	4015		15	2	0.000304%	656729	99.84%	2	0.63%
澹	4016		16	2	0.000304%	656731	99.84%	2	0.63%
瀋	4017		18	2	0.000304%	656733	99.84%	2	0.63%
瀛	4018		19	2	0.000304%	656735	99.84%	2	0.63%
烯	4019		11	2	0.000304%	656737	99.84%	1	0.31%
煦	4020		13	2	0.000304%	656739	99.84%	2	0.63%
熏	4021		14	2	0.000304%	656741	99.84%	1	0.31%
燄	4022		16	2	0.000304%	656743	99.84%	2	0.63%
牝	4023		6	2	0.000304%	656745	99.84%	1	0.31%
牴	4024		9	2	0.000304%	656747	99.84%	2	0.63%
狡	4025		9	2	0.000304%	656749	99.84%	2	0.63%
猝	4026		11	2	0.000304%	656751	99.84%	1	0.31%
猾	4027		13	2	0.000304%	656753	99.84%	2	0.63%
猻	4028		13	2	0.000304%	656755	99.84%	1	0.31%
玖	4029		7	2	0.000304%	656757	99.84%	1	0.31%
琵	4030		12	2	0.000304%	656759	99.84%	2	0.63%
琶	4031		12	2	0.000304%	656761	99.84%	2	0.63%
璀	4032		15	2	0.000304%	656763	99.84%	2	0.63%
璇	4033		15	2	0.000304%	656765	99.84%	1	0.31%
璜	4034		16	2	0.000304%	656767	99.84%	2	0.63%
璨	4035		17	2	0.000304%	656769	99.84%	2	0.63%
畚	4036		10	2	0.000304%	656771	99.84%	2	0.63%
疪	4037		9	2	0.000304%	656773	99.84%	2	0.63%
痊	4038		11	2	0.000304%	656775	99.84%	2	0.63%
痙	4039		12	2	0.000304%	656777	99.84%	2	0.63%
瘀	4040		13	2	0.000304%	656779	99.84%	2	0.63%
痾	4041		13	2	0.000304%	656781	99.84%	2	0.63%
瘟	4042		15	2	0.000304%	656783	99.84%	2	0.63%
癰	4043		23	2	0.000304%	656785	99.84%	2	0.63%
盃	4044		9	2	0.000304%	656787	99.84%	2	0.63%
眈	4045		9	2	0.000304%	656789	99.84%	1	0.31%
睏	4046		12	2	0.000304%	656791	99.84%	2	0.63%
睬	4047		13	2	0.000304%	656793	99.84%	2	0.63%
睽	4048		14	2	0.000304%	656795	99.85%	1	0.31%
瞌	4049		15	2	0.000304%	656797	99.85%	2	0.63%
碘	4050		13	2	0.000304%	656799	99.85%	2	0.63%
碉	4051		13	2	0.000304%	656801	99.85%	2	0.63%
祼	4052		12	2	0.000304%	656803	99.85%	2	0.63%
稟	4053		13	2	0.000304%	656805	99.85%	2	0.63%
窈	4054		10	2	0.000304%	656807	99.85%	2	0.63%
窕	4055		11	2	0.000304%	656809	99.85%	2	0.63%
窖	4056		12	2	0.000304%	656811	99.85%	1	0.31%
窟	4057		13	2	0.000304%	656813	99.85%	1	0.31%
窣	4058		13	2	0.000304%	656815	99.85%	2	0.63%
窸	4059		16	2	0.000304%	656817	99.85%	2	0.63%
箕	4060		14	2	0.000304%	656819	99.85%	2	0.63%
篆	4061		15	2	0.000304%	656821	99.85%	2	0.63%
簌	4062		17	2	0.000304%	656823	99.85%	1	0.31%
簣	4063		18	2	0.000304%	656825	99.85%	2	0.63%
粕	4064		11	2	0.000304%	656827	99.85%	2	0.63%
粟	4065		12	2	0.000304%	656829	99.85%	2	0.63%
粵	4066		13	2	0.000304%	656831	99.85%	2	0.63%
糜	4067		17	2	0.000304%	656833	99.85%	1	0.31%
紉	4068		9	2	0.000304%	656835	99.85%	2	0.63%
紈	4069		9	2	0.000304%	656837	99.85%	2	0.63%
紿	4070		11	2	0.000304%	656839	99.85%	2	0.63%
絹	4071		13	2	0.000304%	656841	99.85%	2	0.63%
綢	4072		14	2	0.000304%	656843	99.85%	2	0.63%
緞	4073		15	2	0.000304%	656845	99.85%	2	0.63%
緲	4074		15	2	0.000304%	656847	99.85%	2	0.63%
縝	4075		16	2	0.000304%	656849	99.85%	2	0.63%
縹	4076		17	2	0.000304%	656851	99.85%	2	0.63%
繹	4077		19	2	0.000304%	656853	99.85%	2	0.63%
繾	4078		20	2	0.000304%	656855	99.85%	2	0.63%
缽	4079		11	2	0.000304%	656857	99.85%	2	0.63%
羔	4080		10	2	0.000304%	656859	99.85%	2	0.63%
羹	4081		19	2	0.000304%	656861	99.86%	2	0.63%
翌	4082		11	2	0.000304%	656863	99.86%	2	0.63%
翦	4083		15	2	0.000304%	656865	99.86%	2	0.63%
肘	4084		7	2	0.000304%	656867	99.86%	2	0.63%
肴	4085		8	2	0.000304%	656869	99.86%	2	0.63%
胥	4086		9	2	0.000304%	656871	99.86%	2	0.63%
胚	4087		9	2	0.000304%	656873	99.86%	2	0.63%
胝	4088		9	2	0.000304%	656875	99.86%	2	0.63%
胭	4089		10	2	0.000304%	656877	99.86%	2	0.63%
胼	4090		10	2	0.000304%	656879	99.86%	2	0.63%
胯	4091		10	2	0.000304%	656881	99.86%	1	0.31%
胺	4092		10	2	0.000304%	656883	99.86%	2	0.63%
脯	4093		11	2	0.000304%	656885	99.86%	2	0.63%
腴	4094		12	2	0.000304%	656887	99.86%	2	0.63%
腧	4095		13	2	0.000304%	656889	99.86%	1	0.31%
膾	4096		17	2	0.000304%	656891	99.86%	2	0.63%
臊	4097		17	2	0.000304%	656893	99.86%	2	0.63%
舂	4098		11	2	0.000304%	656895	99.86%	1	0.31%
舅	4099		13	2	0.000304%	656897	99.86%	2	0.63%
舵	4100		11	2	0.000304%	656899	99.86%	2	0.63%
艇	4101		13	2	0.000304%	656901	99.86%	2	0.63%
荐	4102		10	2	0.000304%	656903	99.86%	2	0.63%
茴	4103		10	2	0.000304%	656905	99.86%	1	0.31%
荏	4104		10	2	0.000304%	656907	99.86%	2	0.63%
莓	4105		11	2	0.000304%	656909	99.86%	1	0.31%
萋	4106		12	2	0.000304%	656911	99.86%	1	0.31%
菡	4107		12	2	0.000304%	656913	99.86%	2	0.63%
菇	4108		12	2	0.000304%	656915	99.86%	2	0.63%
蓁	4109		14	2	0.000304%	656917	99.86%	2	0.63%
蕨	4110		16	2	0.000304%	656919	99.86%	2	0.63%
薛	4111		17	2	0.000304%	656921	99.86%	2	0.63%
藐	4112		18	2	0.000304%	656923	99.86%	2	0.63%
藻	4113		20	2	0.000304%	656925	99.87%	2	0.63%
虩	4114		18	2	0.000304%	656927	99.87%	1	0.31%
蚓	4115		10	2	0.000304%	656929	99.87%	2	0.63%
蚵	4116		11	2	0.000304%	656931	99.87%	2	0.63%
蚱	4117		11	2	0.000304%	656933	99.87%	2	0.63%
蚯	4118		11	2	0.000304%	656935	99.87%	2	0.63%
蛔	4119		12	2	0.000304%	656937	99.87%	1	0.31%
蛤	4120		12	2	0.000304%	656939	99.87%	2	0.63%
蜀	4121		13	2	0.000304%	656941	99.87%	2	0.63%
蜉	4122		13	2	0.000304%	656943	99.87%	2	0.63%
蜢	4123		14	2	0.000304%	656945	99.87%	2	0.63%
蜥	4124		14	2	0.000304%	656947	99.87%	1	0.31%
蜴	4125		14	2	0.000304%	656949	99.87%	1	0.31%
蝗	4126		15	2	0.000304%	656951	99.87%	1	0.31%
蝣	4127		15	2	0.000304%	656953	99.87%	2	0.63%
螻	4128		17	2	0.000304%	656955	99.87%	2	0.63%
蟈	4129		17	2	0.000304%	656957	99.87%	1	0.31%
袪	4130		10	2	0.000304%	656959	99.87%	2	0.63%
袓	4131		10	2	0.000304%	656961	99.87%	2	0.63%
袤	4132		11	2	0.000304%	656963	99.87%	2	0.63%
褚	4133		13	2	0.000304%	656965	99.87%	1	0.31%
褓	4134		14	2	0.000304%	656967	99.87%	1	0.31%
褒	4135		15	2	0.000304%	656969	99.87%	2	0.63%
褥	4136		15	2	0.000304%	656971	99.87%	1	0.31%
褻	4137		17	2	0.000304%	656973	99.87%	2	0.63%
覷	4138		19	2	0.000304%	656975	99.87%	2	0.63%
訟	4139		11	2	0.000304%	656977	99.87%	2	0.63%
訛	4140		11	2	0.000304%	656979	99.87%	1	0.31%
訢	4141		11	2	0.000304%	656981	99.87%	2	0.63%
詎	4142		12	2	0.000304%	656983	99.87%	2	0.63%
詼	4143		13	2	0.000304%	656985	99.87%	2	0.63%
誅	4144		13	2	0.000304%	656987	99.87%	2	0.63%
詬	4145		13	2	0.000304%	656989	99.87%	2	0.63%
誣	4146		14	2	0.000304%	656991	99.88%	2	0.63%
誨	4147		14	2	0.000304%	656993	99.88%	2	0.63%
諫	4148		16	2	0.000304%	656995	99.88%	2	0.63%
謔	4149		16	2	0.000304%	656997	99.88%	2	0.63%
諤	4150		16	2	0.000304%	656999	99.88%	1	0.31%
謅	4151		17	2	0.000304%	657001	99.88%	1	0.31%
謢	4152		17	2	0.000304%	657003	99.88%	2	0.63%
謨	4153		18	2	0.000304%	657005	99.88%	2	0.63%
謫	4154		18	2	0.000304%	657007	99.88%	2	0.63%
貳	4155		12	2	0.000304%	657009	99.88%	1	0.31%
賃	4156		13	2	0.000304%	657011	99.88%	2	0.63%
賸	4157		17	2	0.000304%	657013	99.88%	2	0.63%
赭	4158		15	2	0.000304%	657015	99.88%	2	0.63%
踄	4159		14	2	0.000304%	657017	99.88%	2	0.63%
踼	4160		16	2	0.000304%	657019	99.88%	2	0.63%
蹋	4161		17	2	0.000304%	657021	99.88%	2	0.63%
蹙	4162		18	2	0.000304%	657023	99.88%	2	0.63%
躇	4163		19	2	0.000304%	657025	99.88%	2	0.63%
蹭	4164		19	2	0.000304%	657027	99.88%	1	0.31%
躊	4165		21	2	0.000304%	657029	99.88%	2	0.63%
躋	4166		21	2	0.000304%	657031	99.88%	2	0.63%
軋	4167		8	2	0.000304%	657033	99.88%	2	0.63%
軔	4168		10	2	0.000304%	657035	99.88%	2	0.63%
軛	4169		11	2	0.000304%	657037	99.88%	2	0.63%
軸	4170		12	2	0.000304%	657039	99.88%	1	0.31%
轅	4171		17	2	0.000304%	657041	99.88%	2	0.63%
逡	4172		10	2	0.000304%	657043	99.88%	1	0.31%
遨	4173		14	2	0.000304%	657045	99.88%	2	0.63%
遴	4174		15	2	0.000304%	657047	99.88%	2	0.63%
邇	4175		17	2	0.000304%	657049	99.88%	2	0.63%
鄒	4176		12	2	0.000304%	657051	99.88%	2	0.63%
鄴	4177		15	2	0.000304%	657053	99.88%	2	0.63%
酢	4178		12	2	0.000304%	657055	99.88%	1	0.31%
	4179		14	2	0.000304%	657057	99.89%	2	0.63%
醋	4180		15	2	0.000304%	657059	99.89%	2	0.63%
醛	4181		17	2	0.000304%	657061	99.89%	1	0.31%
釗	4182		10	2	0.000304%	657063	99.89%	1	0.31%
鈕	4183		12	2	0.000304%	657065	99.89%	1	0.31%
錕	4184		16	2	0.000304%	657067	99.89%	2	0.63%
鑠	4185		23	2	0.000304%	657069	99.89%	2	0.63%
閔	4186		12	2	0.000304%	657071	99.89%	1	0.31%
閘	4187		13	2	0.000304%	657073	99.89%	1	0.31%
閹	4188		16	2	0.000304%	657075	99.89%	2	0.63%
闇	4189		17	2	0.000304%	657077	99.89%	2	0.63%
陛	4190		9	2	0.000304%	657079	99.89%	2	0.63%
隄	4191		11	2	0.000304%	657081	99.89%	1	0.31%
隳	4192		18	2	0.000304%	657083	99.89%	1	0.31%
雌	4193		14	2	0.000304%	657085	99.89%	2	0.63%
雛	4194		18	2	0.000304%	657087	99.89%	2	0.63%
霄	4195		15	2	0.000304%	657089	99.89%	2	0.63%
靂	4196		24	2	0.000304%	657091	99.89%	1	0.31%
靦	4197		16	2	0.000304%	657093	99.89%	2	0.63%
鞘	4198		16	2	0.000304%	657095	99.89%	2	0.63%
韙	4199		18	2	0.000304%	657097	99.89%	2	0.63%
韜	4200		19	2	0.000304%	657099	99.89%	2	0.63%
頷	4201		16	2	0.000304%	657101	99.89%	2	0.63%
顎	4202		18	2	0.000304%	657103	99.89%	2	0.63%
顰	4203		24	2	0.000304%	657105	99.89%	2	0.63%
颶	4204		17	2	0.000304%	657107	99.89%	2	0.63%
飩	4205		12	2	0.000304%	657109	99.89%	1	0.31%
餒	4206		15	2	0.000304%	657111	99.89%	2	0.63%
餛	4207		16	2	0.000304%	657113	99.89%	1	0.31%
饉	4208		19	2	0.000304%	657115	99.89%	2	0.63%
饗	4209		21	2	0.000304%	657117	99.89%	2	0.63%
駒	4210		15	2	0.000304%	657119	99.89%	2	0.63%
駴	4211		17	2	0.000304%	657121	99.89%	1	0.31%
騅	4212		18	2	0.000304%	657123	99.90%	2	0.63%
騾	4213		21	2	0.000304%	657125	99.90%	1	0.31%
驁	4214		21	2	0.000304%	657127	99.90%	2	0.63%
驪	4215		29	2	0.000304%	657129	99.90%	2	0.63%
髻	4216		16	2	0.000304%	657131	99.90%	2	0.63%
鯊	4217		18	2	0.000304%	657133	99.90%	2	0.63%
鰣	4218		21	2	0.000304%	657135	99.90%	1	0.31%
鱒	4219		23	2	0.000304%	657137	99.90%	2	0.63%
鳶	4220		14	2	0.000304%	657139	99.90%	2	0.63%
鴕	4221		16	2	0.000304%	657141	99.90%	2	0.63%
鵠	4222		18	2	0.000304%	657143	99.90%	2	0.63%
鹵	4223		11	2	0.000304%	657145	99.90%	2	0.63%
麒	4224		19	2	0.000304%	657147	99.90%	2	0.63%
麓	4225		19	2	0.000304%	657149	99.90%	2	0.63%
麩	4226		15	2	0.000304%	657151	99.90%	1	0.31%
麾	4227		15	2	0.000304%	657153	99.90%	2	0.63%
黜	4228		17	2	0.000304%	657155	99.90%	1	0.31%
黠	4229		18	2	0.000304%	657157	99.90%	2	0.63%
黴	4230		23	2	0.000304%	657159	99.90%	2	0.63%
鼕	4231		18	2	0.000304%	657161	99.90%	1	0.31%
齪	4232		22	2	0.000304%	657163	99.90%	2	0.63%
齷	4233		24	2	0.000304%	657165	99.90%	2	0.63%
亢	4234		4	1	0.000152%	657166	99.90%	1	0.31%
亳	4235		10	1	0.000152%	657167	99.90%	1	0.31%
仟	4236		5	1	0.000152%	657168	99.90%	1	0.31%
伉	4237		6	1	0.000152%	657169	99.90%	1	0.31%
仳	4238		6	1	0.000152%	657170	99.90%	1	0.31%
佗	4239		7	1	0.000152%	657171	99.90%	1	0.31%
佞	4240		7	1	0.000152%	657172	99.90%	1	0.31%
佚	4241		7	1	0.000152%	657173	99.90%	1	0.31%
侍	4242		8	1	0.000152%	657174	99.90%	1	0.31%
佬	4243		8	1	0.000152%	657175	99.90%	1	0.31%
侖	4244		8	1	0.000152%	657176	99.90%	1	0.31%
俚	4245		9	1	0.000152%	657177	99.90%	1	0.31%
俞	4246		9	1	0.000152%	657178	99.90%	1	0.31%
俸	4247		10	1	0.000152%	657179	99.90%	1	0.31%
傖	4248		12	1	0.000152%	657180	99.90%	1	0.31%
儂	4249		15	1	0.000152%	657181	99.90%	1	0.31%
儐	4250		16	1	0.000152%	657182	99.90%	1	0.31%
儷	4251		21	1	0.000152%	657183	99.90%	1	0.31%
儻	4252		22	1	0.000152%	657184	99.90%	1	0.31%
兀	4253		3	1	0.000152%	657185	99.90%	1	0.31%
剉	4254		9	1	0.000152%	657186	99.90%	1	0.31%
剜	4255		10	1	0.000152%	657187	99.90%	1	0.31%
剿	4256		13	1	0.000152%	657188	99.90%	1	0.31%
勛	4257		12	1	0.000152%	657189	99.91%	1	0.31%
勰	4258		15	1	0.000152%	657190	99.91%	1	0.31%
匭	4259		11	1	0.000152%	657191	99.91%	1	0.31%
匾	4260		11	1	0.000152%	657192	99.91%	1	0.31%
叟	4261		9	1	0.000152%	657193	99.91%	1	0.31%
叼	4262		5	1	0.000152%	657194	99.91%	1	0.31%
吁	4263		6	1	0.000152%	657195	99.91%	1	0.31%
吋	4264		6	1	0.000152%	657196	99.91%	1	0.31%
吝	4265		7	1	0.000152%	657197	99.91%	1	0.31%
呃	4266		7	1	0.000152%	657198	99.91%	1	0.31%
呂	4267		7	1	0.000152%	657199	99.91%	1	0.31%
吩	4268		7	1	0.000152%	657200	99.91%	1	0.31%
呇	4269		7	1	0.000152%	657201	99.91%	1	0.31%
呤	4270		8	1	0.000152%	657202	99.91%	1	0.31%
哂	4271		9	1	0.000152%	657203	99.91%	1	0.31%
哖	4272		9	1	0.000152%	657204	99.91%	1	0.31%
哆	4273		9	1	0.000152%	657205	99.91%	1	0.31%
唔	4274		10	1	0.000152%	657206	99.91%	1	0.31%
唄	4275		10	1	0.000152%	657207	99.91%	1	0.31%
喲	4276		12	1	0.000152%	657208	99.91%	1	0.31%
喫	4277		12	1	0.000152%	657209	99.91%	1	0.31%
喙	4278		12	1	0.000152%	657210	99.91%	1	0.31%
嗟	4279		13	1	0.000152%	657211	99.91%	1	0.31%
嗦	4280		13	1	0.000152%	657212	99.91%	1	0.31%
嗥	4281		13	1	0.000152%	657213	99.91%	1	0.31%
嗩	4282		13	1	0.000152%	657214	99.91%	1	0.31%
嗒	4283		13	1	0.000152%	657215	99.91%	1	0.31%
嗲	4284		13	1	0.000152%	657216	99.91%	1	0.31%
嘀	4285		14	1	0.000152%	657217	99.91%	1	0.31%
噗	4286		15	1	0.000152%	657218	99.91%	1	0.31%
噉	4287		15	1	0.000152%	657219	99.91%	1	0.31%
噘	4288		15	1	0.000152%	657220	99.91%	1	0.31%
噫	4289		16	1	0.000152%	657221	99.91%	1	0.31%
噤	4290		16	1	0.000152%	657222	99.91%	1	0.31%
噥	4291		16	1	0.000152%	657223	99.91%	1	0.31%
噲	4292		16	1	0.000152%	657224	99.91%	1	0.31%
嚎	4293		17	1	0.000152%	657225	99.91%	1	0.31%
嚓	4294		17	1	0.000152%	657226	99.91%	1	0.31%
嚙	4295		18	1	0.000152%	657227	99.91%	1	0.31%
囓	4296		24	1	0.000152%	657228	99.91%	1	0.31%
囝	4297		6	1	0.000152%	657229	99.91%	1	0.31%
囪	4298		7	1	0.000152%	657230	99.91%	1	0.31%
囤	4299		7	1	0.000152%	657231	99.91%	1	0.31%
囫	4300		7	1	0.000152%	657232	99.91%	1	0.31%
圭	4301		6	1	0.000152%	657233	99.91%	1	0.31%
圯	4302		6	1	0.000152%	657234	99.91%	1	0.31%
坌	4303		7	1	0.000152%	657235	99.91%	1	0.31%
垣	4304		9	1	0.000152%	657236	99.91%	1	0.31%
垛	4305		9	1	0.000152%	657237	99.91%	1	0.31%
埆	4306		10	1	0.000152%	657238	99.91%	1	0.31%
堊	4307		11	1	0.000152%	657239	99.91%	1	0.31%
堙	4308		12	1	0.000152%	657240	99.91%	1	0.31%
堭	4309		12	1	0.000152%	657241	99.91%	1	0.31%
塘	4310		13	1	0.000152%	657242	99.91%	1	0.31%
塢	4311		13	1	0.000152%	657243	99.91%	1	0.31%
塹	4312		14	1	0.000152%	657244	99.91%	1	0.31%
墻	4313		16	1	0.000152%	657245	99.91%	1	0.31%
壹	4314		12	1	0.000152%	657246	99.91%	1	0.31%
奐	4315		9	1	0.000152%	657247	99.91%	1	0.31%
妁	4316		6	1	0.000152%	657248	99.91%	1	0.31%
妞	4317		7	1	0.000152%	657249	99.91%	1	0.31%
姍	4318		8	1	0.000152%	657250	99.91%	1	0.31%
姶	4319		9	1	0.000152%	657251	99.91%	1	0.31%
婢	4320		11	1	0.000152%	657252	99.91%	1	0.31%
媛	4321		12	1	0.000152%	657253	99.91%	1	0.31%
媧	4322		12	1	0.000152%	657254	99.92%	1	0.31%
媾	4323		13	1	0.000152%	657255	99.92%	1	0.31%
嬈	4324		15	1	0.000152%	657256	99.92%	1	0.31%
嬏	4325		15	1	0.000152%	657257	99.92%	1	0.31%
嫺	4326		15	1	0.000152%	657258	99.92%	1	0.31%
嬴	4327		16	1	0.000152%	657259	99.92%	1	0.31%
孑	4328		3	1	0.000152%	657260	99.92%	1	0.31%
孚	4329		7	1	0.000152%	657261	99.92%	1	0.31%
屘	4330		10	1	0.000152%	657262	99.92%	1	0.31%
孳	4331		12	1	0.000152%	657263	99.92%	1	0.31%
宥	4332		9	1	0.000152%	657264	99.92%	1	0.31%
宧	4333		10	1	0.000152%	657265	99.92%	1	0.31%
屣	4334		14	1	0.000152%	657266	99.92%	1	0.31%
屧	4335		15	1	0.000152%	657267	99.92%	1	0.31%
屨	4336		17	1	0.000152%	657268	99.92%	1	0.31%
崁	4337		10	1	0.000152%	657269	99.92%	1	0.31%
崙	4338		11	1	0.000152%	657270	99.92%	1	0.31%
崧	4339		11	1	0.000152%	657271	99.92%	1	0.31%
嵋	4340		12	1	0.000152%	657272	99.92%	1	0.31%
嵬	4341		13	1	0.000152%	657273	99.92%	1	0.31%
嶇	4342		14	1	0.000152%	657274	99.92%	1	0.31%
嶂	4343		14	1	0.000152%	657275	99.92%	1	0.31%
巇	4344		20	1	0.000152%	657276	99.92%	1	0.31%
巖	4345		23	1	0.000152%	657277	99.92%	1	0.31%
巘	4346		23	1	0.000152%	657278	99.92%	1	0.31%
幄	4347		12	1	0.000152%	657279	99.92%	1	0.31%
幌	4348		13	1	0.000152%	657280	99.92%	1	0.31%
幗	4349		14	1	0.000152%	657281	99.92%	1	0.31%
幡	4350		15	1	0.000152%	657282	99.92%	1	0.31%
庄	4351		6	1	0.000152%	657283	99.92%	1	0.31%
庛	4352		9	1	0.000152%	657284	99.92%	1	0.31%
庾	4353		11	1	0.000152%	657285	99.92%	1	0.31%
廌	4354		13	1	0.000152%	657286	99.92%	1	0.31%
廇	4355		13	1	0.000152%	657287	99.92%	1	0.31%
廡	4356		15	1	0.000152%	657288	99.92%	1	0.31%
弈	4357		9	1	0.000152%	657289	99.92%	1	0.31%
徂	4358		8	1	0.000152%	657290	99.92%	1	0.31%
徇	4359		9	1	0.000152%	657291	99.92%	1	0.31%
忑	4360		7	1	0.000152%	657292	99.92%	1	0.31%
忐	4361		7	1	0.000152%	657293	99.92%	1	0.31%
忮	4362		7	1	0.000152%	657294	99.92%	1	0.31%
忤	4363		7	1	0.000152%	657295	99.92%	1	0.31%
怍	4364		8	1	0.000152%	657296	99.92%	1	0.31%
恿	4365		11	1	0.000152%	657297	99.92%	1	0.31%
悱	4366		11	1	0.000152%	657298	99.92%	1	0.31%
愎	4367		12	1	0.000152%	657299	99.92%	1	0.31%
愆	4368		13	1	0.000152%	657300	99.92%	1	0.31%
愿	4369		14	1	0.000152%	657301	99.92%	1	0.31%
慟	4370		14	1	0.000152%	657302	99.92%	1	0.31%
慳	4371		14	1	0.000152%	657303	99.92%	1	0.31%
慼	4372		15	1	0.000152%	657304	99.92%	1	0.31%
慫	4373		15	1	0.000152%	657305	99.92%	1	0.31%
戌	4374		6	1	0.000152%	657306	99.92%	1	0.31%
戟	4375		12	1	0.000152%	657307	99.92%	1	0.31%
戡	4376		13	1	0.000152%	657308	99.92%	1	0.31%
扈	4377		11	1	0.000152%	657309	99.92%	1	0.31%
扡	4378		6	1	0.000152%	657310	99.92%	1	0.31%
扙	4379		6	1	0.000152%	657311	99.92%	1	0.31%
拗	4380		8	1	0.000152%	657312	99.92%	1	0.31%
拽	4381		9	1	0.000152%	657313	99.92%	1	0.31%
拷	4382		9	1	0.000152%	657314	99.92%	1	0.31%
拴	4383		9	1	0.000152%	657315	99.92%	1	0.31%
拫	4384		9	1	0.000152%	657316	99.92%	1	0.31%
捍	4385		10	1	0.000152%	657317	99.92%	1	0.31%
捌	4386		10	1	0.000152%	657318	99.92%	1	0.31%
挼	4387		10	1	0.000152%	657319	99.92%	1	0.31%
掮	4388		11	1	0.000152%	657320	99.93%	1	0.31%
捸	4389		11	1	0.000152%	657321	99.93%	1	0.31%
掅	4390		11	1	0.000152%	657322	99.93%	1	0.31%
揖	4391		12	1	0.000152%	657323	99.93%	1	0.31%
揠	4392		12	1	0.000152%	657324	99.93%	1	0.31%
搽	4393		13	1	0.000152%	657325	99.93%	1	0.31%
搔	4394		13	1	0.000152%	657326	99.93%	1	0.31%
搐	4395		13	1	0.000152%	657327	99.93%	1	0.31%
摁	4396		13	1	0.000152%	657328	99.93%	1	0.31%
摟	4397		14	1	0.000152%	657329	99.93%	1	0.31%
摑	4398		14	1	0.000152%	657330	99.93%	1	0.31%
搴	4399		14	1	0.000152%	657331	99.93%	1	0.31%
摭	4400		14	1	0.000152%	657332	99.93%	1	0.31%
撂	4401		14	1	0.000152%	657333	99.93%	1	0.31%
摜	4402		14	1	0.000152%	657334	99.93%	1	0.31%
撓	4403		15	1	0.000152%	657335	99.93%	1	0.31%
撻	4404		16	1	0.000152%	657336	99.93%	1	0.31%
擰	4405		17	1	0.000152%	657337	99.93%	1	0.31%
擢	4406		17	1	0.000152%	657338	99.93%	1	0.31%
擯	4407		17	1	0.000152%	657339	99.93%	1	0.31%
攆	4408		18	1	0.000152%	657340	99.93%	1	0.31%
擻	4409		18	1	0.000152%	657341	99.93%	1	0.31%
晒	4410		10	1	0.000152%	657342	99.93%	1	0.31%
晾	4411		12	1	0.000152%	657343	99.93%	1	0.31%
暄	4412		13	1	0.000152%	657344	99.93%	1	0.31%
暌	4413		13	1	0.000152%	657345	99.93%	1	0.31%
暸	4414		16	1	0.000152%	657346	99.93%	1	0.31%
曜	4415		18	1	0.000152%	657347	99.93%	1	0.31%
曩	4416		21	1	0.000152%	657348	99.93%	1	0.31%
朸	4417		6	1	0.000152%	657349	99.93%	1	0.31%
杌	4418		7	1	0.000152%	657350	99.93%	1	0.31%
杵	4419		8	1	0.000152%	657351	99.93%	1	0.31%
杼	4420		8	1	0.000152%	657352	99.93%	1	0.31%
柬	4421		9	1	0.000152%	657353	99.93%	1	0.31%
枸	4422		9	1	0.000152%	657354	99.93%	1	0.31%
枻	4423		9	1	0.000152%	657355	99.93%	1	0.31%
	4424		10	1	0.000152%	657356	99.93%	1	0.31%
桀	4425		10	1	0.000152%	657357	99.93%	1	0.31%
桅	4426		10	1	0.000152%	657358	99.93%	1	0.31%
梧	4427		11	1	0.000152%	657359	99.93%	1	0.31%
梆	4428		11	1	0.000152%	657360	99.93%	1	0.31%
棹	4429		12	1	0.000152%	657361	99.93%	1	0.31%
楷	4430		13	1	0.000152%	657362	99.93%	1	0.31%
椹	4431		13	1	0.000152%	657363	99.93%	1	0.31%
榛	4432		14	1	0.000152%	657364	99.93%	1	0.31%
槐	4433		14	1	0.000152%	657365	99.93%	1	0.31%
榞	4434		14	1	0.000152%	657366	99.93%	1	0.31%
槤	4435		15	1	0.000152%	657367	99.93%	1	0.31%
樵	4436		16	1	0.000152%	657368	99.93%	1	0.31%
檥	4437		17	1	0.000152%	657369	99.93%	1	0.31%
檮	4438		18	1	0.000152%	657370	99.93%	1	0.31%
櫓	4439		19	1	0.000152%	657371	99.93%	1	0.31%
欒	4440		23	1	0.000152%	657372	99.93%	1	0.31%
欞	4441		28	1	0.000152%	657373	99.93%	1	0.31%
欷	4442		11	1	0.000152%	657374	99.93%	1	0.31%
欸	4443		11	1	0.000152%	657375	99.93%	1	0.31%
歆	4444		13	1	0.000152%	657376	99.93%	1	0.31%
歃	4445		13	1	0.000152%	657377	99.93%	1	0.31%
歟	4446		18	1	0.000152%	657378	99.93%	1	0.31%
殞	4447		14	1	0.000152%	657379	99.93%	1	0.31%
瞉	4448		15	1	0.000152%	657380	99.93%	1	0.31%
毓	4449		13	1	0.000152%	657381	99.93%	1	0.31%
汛	4450		6	1	0.000152%	657382	99.93%	1	0.31%
沁	4451		7	1	0.000152%	657383	99.93%	1	0.31%
汨	4452		7	1	0.000152%	657384	99.93%	1	0.31%
泓	4453		8	1	0.000152%	657385	99.93%	1	0.31%
泅	4454		8	1	0.000152%	657386	99.94%	1	0.31%
沬	4455		8	1	0.000152%	657387	99.94%	1	0.31%
泠	4456		8	1	0.000152%	657388	99.94%	1	0.31%
泫	4457		8	1	0.000152%	657389	99.94%	1	0.31%
泝	4458		8	1	0.000152%	657390	99.94%	1	0.31%
洫	4459		9	1	0.000152%	657391	99.94%	1	0.31%
洒	4460		9	1	0.000152%	657392	99.94%	1	0.31%
洙	4461		9	1	0.000152%	657393	99.94%	1	0.31%
浬	4462		10	1	0.000152%	657394	99.94%	1	0.31%
浹	4463		10	1	0.000152%	657395	99.94%	1	0.31%
浠	4464		10	1	0.000152%	657396	99.94%	1	0.31%
渙	4465		12	1	0.000152%	657397	99.94%	1	0.31%
湎	4466		12	1	0.000152%	657398	99.94%	1	0.31%
湲	4467		12	1	0.000152%	657399	99.94%	1	0.31%
渫	4468		12	1	0.000152%	657400	99.94%	1	0.31%
湫	4469		12	1	0.000152%	657401	99.94%	1	0.31%
渧	4470		12	1	0.000152%	657402	99.94%	1	0.31%
溥	4471		13	1	0.000152%	657403	99.94%	1	0.31%
溼	4472		13	1	0.000152%	657404	99.94%	1	0.31%
漳	4473		14	1	0.000152%	657405	99.94%	1	0.31%
滬	4474		14	1	0.000152%	657406	99.94%	1	0.31%
滷	4475		14	1	0.000152%	657407	99.94%	1	0.31%
潦	4476		15	1	0.000152%	657408	99.94%	1	0.31%
濔	4477		17	1	0.000152%	657409	99.94%	1	0.31%
瀲	4478		20	1	0.000152%	657410	99.94%	1	0.31%
灝	4479		24	1	0.000152%	657411	99.94%	1	0.31%
灩	4480		31	1	0.000152%	657412	99.94%	1	0.31%
炷	4481		9	1	0.000152%	657413	99.94%	1	0.31%
焊	4482		11	1	0.000152%	657414	99.94%	1	0.31%
烷	4483		11	1	0.000152%	657415	99.94%	1	0.31%
烴	4484		11	1	0.000152%	657416	99.94%	1	0.31%
焄	4485		11	1	0.000152%	657417	99.94%	1	0.31%
焙	4486		12	1	0.000152%	657418	99.94%	1	0.31%
煨	4487		13	1	0.000152%	657419	99.94%	1	0.31%
煖	4488		13	1	0.000152%	657420	99.94%	1	0.31%
燧	4489		17	1	0.000152%	657421	99.94%	1	0.31%
爝	4490		21	1	0.000152%	657422	99.94%	1	0.31%
爰	4491		9	1	0.000152%	657423	99.94%	1	0.31%
牒	4492		13	1	0.000152%	657424	99.94%	1	0.31%
牖	4493		15	1	0.000152%	657425	99.94%	1	0.31%
犄	4494		12	1	0.000152%	657426	99.94%	1	0.31%
犢	4495		19	1	0.000152%	657427	99.94%	1	0.31%
狙	4496		8	1	0.000152%	657428	99.94%	1	0.31%
狷	4497		10	1	0.000152%	657429	99.94%	1	0.31%
猥	4498		12	1	0.000152%	657430	99.94%	1	0.31%
猩	4499		12	1	0.000152%	657431	99.94%	1	0.31%
猷	4500		13	1	0.000152%	657432	99.94%	1	0.31%
猿	4501		13	1	0.000152%	657433	99.94%	1	0.31%
玆	4502		10	1	0.000152%	657434	99.94%	1	0.31%
玦	4503		8	1	0.000152%	657435	99.94%	1	0.31%
玷	4504		9	1	0.000152%	657436	99.94%	1	0.31%
珀	4505		9	1	0.000152%	657437	99.94%	1	0.31%
珺	4506		11	1	0.000152%	657438	99.94%	1	0.31%
琪	4507		12	1	0.000152%	657439	99.94%	1	0.31%
琥	4508		12	1	0.000152%	657440	99.94%	1	0.31%
瑙	4509		13	1	0.000152%	657441	99.94%	1	0.31%
瑧	4510		14	1	0.000152%	657442	99.94%	1	0.31%
瑾	4511		15	1	0.000152%	657443	99.94%	1	0.31%
璁	4512		15	1	0.000152%	657444	99.94%	1	0.31%
璐	4513		17	1	0.000152%	657445	99.94%	1	0.31%
瓠	4514		11	1	0.000152%	657446	99.94%	1	0.31%
甄	4515		14	1	0.000152%	657447	99.94%	1	0.31%
甌	4516		16	1	0.000152%	657448	99.94%	1	0.31%
甭	4517		9	1	0.000152%	657449	99.94%	1	0.31%
甯	4518		12	1	0.000152%	657450	99.94%	1	0.31%
甸	4519		7	1	0.000152%	657451	99.94%	1	0.31%
畀	4520		8	1	0.000152%	657452	99.95%	1	0.31%
疋	4521		5	1	0.000152%	657453	99.95%	1	0.31%
疙	4522		8	1	0.000152%	657454	99.95%	1	0.31%
疹	4523		10	1	0.000152%	657455	99.95%	1	0.31%
痂	4524		10	1	0.000152%	657456	99.95%	1	0.31%
痍	4525		11	1	0.000152%	657457	99.95%	1	0.31%
痌	4526		11	1	0.000152%	657458	99.95%	1	0.31%
痣	4527		12	1	0.000152%	657459	99.95%	1	0.31%
痠	4528		12	1	0.000152%	657460	99.95%	1	0.31%
瘁	4529		13	1	0.000152%	657461	99.95%	1	0.31%
瘩	4530		15	1	0.000152%	657462	99.95%	1	0.31%
瘝	4531		15	1	0.000152%	657463	99.95%	1	0.31%
瘸	4532		16	1	0.000152%	657464	99.95%	1	0.31%
癇	4533		17	1	0.000152%	657465	99.95%	1	0.31%
癩	4534		21	1	0.000152%	657466	99.95%	1	0.31%
癲	4535		24	1	0.000152%	657467	99.95%	1	0.31%
盥	4536		16	1	0.000152%	657468	99.95%	1	0.31%
眇	4537		9	1	0.000152%	657469	99.95%	1	0.31%
睇	4538		12	1	0.000152%	657470	99.95%	1	0.31%
睨	4539		13	1	0.000152%	657471	99.95%	1	0.31%
瞅	4540		14	1	0.000152%	657472	99.95%	1	0.31%
瞟	4541		16	1	0.000152%	657473	99.95%	1	0.31%
瞰	4542		17	1	0.000152%	657474	99.95%	1	0.31%
瞿	4543		18	1	0.000152%	657475	99.95%	1	0.31%
矓	4544		21	1	0.000152%	657476	99.95%	1	0.31%
矽	4545		8	1	0.000152%	657477	99.95%	1	0.31%
矸	4546		8	1	0.000152%	657478	99.95%	1	0.31%
砥	4547		10	1	0.000152%	657479	99.95%	1	0.31%
碓	4548		13	1	0.000152%	657480	99.95%	1	0.31%
碇	4549		13	1	0.000152%	657481	99.95%	1	0.31%
碣	4550		14	1	0.000152%	657482	99.95%	1	0.31%
碾	4551		15	1	0.000152%	657483	99.95%	1	0.31%
磐	4552		15	1	0.000152%	657484	99.95%	1	0.31%
磺	4553		17	1	0.000152%	657485	99.95%	1	0.31%
礪	4554		20	1	0.000152%	657486	99.95%	1	0.31%
祀	4555		7	1	0.000152%	657487	99.95%	1	0.31%
祺	4556		12	1	0.000152%	657488	99.95%	1	0.31%
禎	4557		13	1	0.000152%	657489	99.95%	1	0.31%
禋	4558		13	1	0.000152%	657490	99.95%	1	0.31%
禢	4559		14	1	0.000152%	657491	99.95%	1	0.31%
禾	4560		5	1	0.000152%	657492	99.95%	1	0.31%
秏	4561		9	1	0.000152%	657493	99.95%	1	0.31%
稷	4562		15	1	0.000152%	657494	99.95%	1	0.31%
穈	4563		16	1	0.000152%	657495	99.95%	1	0.31%
窠	4564		13	1	0.000152%	657496	99.95%	1	0.31%
窳	4565		15	1	0.000152%	657497	99.95%	1	0.31%
竣	4566		12	1	0.000152%	657498	99.95%	1	0.31%
笳	4567		11	1	0.000152%	657499	99.95%	1	0.31%
筑	4568		12	1	0.000152%	657500	99.95%	1	0.31%
筵	4569		14	1	0.000152%	657501	99.95%	1	0.31%
箝	4570		14	1	0.000152%	657502	99.95%	1	0.31%
箔	4571		14	1	0.000152%	657503	99.95%	1	0.31%
箍	4572		14	1	0.000152%	657504	99.95%	1	0.31%
箴	4573		15	1	0.000152%	657505	99.95%	1	0.31%
篁	4574		15	1	0.000152%	657506	99.95%	1	0.31%
篡	4575		16	1	0.000152%	657507	99.95%	1	0.31%
篾	4576		17	1	0.000152%	657508	99.95%	1	0.31%
篳	4577		17	1	0.000152%	657509	99.95%	1	0.31%
簧	4578		18	1	0.000152%	657510	99.95%	1	0.31%
簪	4579		18	1	0.000152%	657511	99.95%	1	0.31%
簞	4580		18	1	0.000152%	657512	99.95%	1	0.31%
籮	4581		25	1	0.000152%	657513	99.95%	1	0.31%
粲	4582		13	1	0.000152%	657514	99.95%	1	0.31%
糗	4583		16	1	0.000152%	657515	99.95%	1	0.31%
糢	4584		17	1	0.000152%	657516	99.95%	1	0.31%
糰	4585		20	1	0.000152%	657517	99.96%	1	0.31%
紘	4586		10	1	0.000152%	657518	99.96%	1	0.31%
絀	4587		11	1	0.000152%	657519	99.96%	1	0.31%
紽	4588		11	1	0.000152%	657520	99.96%	1	0.31%
紺	4589		11	1	0.000152%	657521	99.96%	1	0.31%
絞	4590		12	1	0.000152%	657522	99.96%	1	0.31%
絳	4591		12	1	0.000152%	657523	99.96%	1	0.31%
綾	4592		14	1	0.000152%	657524	99.96%	1	0.31%
綸	4593		14	1	0.000152%	657525	99.96%	1	0.31%
緇	4594		14	1	0.000152%	657526	99.96%	1	0.31%
緋	4595		14	1	0.000152%	657527	99.96%	1	0.31%
綖	4596		14	1	0.000152%	657528	99.96%	1	0.31%
縉	4597		16	1	0.000152%	657529	99.96%	1	0.31%
縟	4598		16	1	0.000152%	657530	99.96%	1	0.31%
縴	4599		17	1	0.000152%	657531	99.96%	1	0.31%
縻	4600		17	1	0.000152%	657532	99.96%	1	0.31%
繖	4601		18	1	0.000152%	657533	99.96%	1	0.31%
纂	4602		20	1	0.000152%	657534	99.96%	1	0.31%
纓	4603		23	1	0.000152%	657535	99.96%	1	0.31%
罌	4604		20	1	0.000152%	657536	99.96%	1	0.31%
罣	4605		11	1	0.000152%	657537	99.96%	1	0.31%
翟	4606		14	1	0.000152%	657538	99.96%	1	0.31%
翹	4607		18	1	0.000152%	657539	99.96%	1	0.31%
耆	4608		10	1	0.000152%	657540	99.96%	1	0.31%
聒	4609		12	1	0.000152%	657541	99.96%	1	0.31%
聶	4610		18	1	0.000152%	657542	99.96%	1	0.31%
聿	4611		6	1	0.000152%	657543	99.96%	1	0.31%
肄	4612		13	1	0.000152%	657544	99.96%	1	0.31%
肓	4613		7	1	0.000152%	657545	99.96%	1	0.31%
肛	4614		7	1	0.000152%	657546	99.96%	1	0.31%
胱	4615		10	1	0.000152%	657547	99.96%	1	0.31%
胴	4616		10	1	0.000152%	657548	99.96%	1	0.31%
脛	4617		11	1	0.000152%	657549	99.96%	1	0.31%
腆	4618		12	1	0.000152%	657550	99.96%	1	0.31%
膊	4619		14	1	0.000152%	657551	99.96%	1	0.31%
臃	4620		17	1	0.000152%	657552	99.96%	1	0.31%
臀	4621		17	1	0.000152%	657553	99.96%	1	0.31%
臚	4622		20	1	0.000152%	657554	99.96%	1	0.31%
臾	4623		8	1	0.000152%	657555	99.96%	1	0.31%
芵	4624		8	1	0.000152%	657556	99.96%	1	0.31%
芧	4625		8	1	0.000152%	657557	99.96%	1	0.31%
芮	4626		8	1	0.000152%	657558	99.96%	1	0.31%
苣	4627		9	1	0.000152%	657559	99.96%	1	0.31%
苜	4628		9	1	0.000152%	657560	99.96%	1	0.31%
苑	4629		9	1	0.000152%	657561	99.96%	1	0.31%
芔	4630		9	1	0.000152%	657562	99.96%	1	0.31%
茹	4631		10	1	0.000152%	657563	99.96%	1	0.31%
茗	4632		10	1	0.000152%	657564	99.96%	1	0.31%
茨	4633		10	1	0.000152%	657565	99.96%	1	0.31%
茜	4634		10	1	0.000152%	657566	99.96%	1	0.31%
莠	4635		11	1	0.000152%	657567	99.96%	1	0.31%
荼	4636		11	1	0.000152%	657568	99.96%	1	0.31%
堇	4637		11	1	0.000152%	657569	99.96%	1	0.31%
菰	4638		12	1	0.000152%	657570	99.96%	1	0.31%
葵	4639		13	1	0.000152%	657571	99.96%	1	0.31%
萼	4640		13	1	0.000152%	657572	99.96%	1	0.31%
萵	4641		13	1	0.000152%	657573	99.96%	1	0.31%
葩	4642		13	1	0.000152%	657574	99.96%	1	0.31%
葺	4643		13	1	0.000152%	657575	99.96%	1	0.31%
葰	4644		13	1	0.000152%	657576	99.96%	1	0.31%
葯	4645		13	1	0.000152%	657577	99.96%	1	0.31%
蒿	4646		14	1	0.000152%	657578	99.96%	1	0.31%
蒞	4647		14	1	0.000152%	657579	99.96%	1	0.31%
蒜	4648		14	1	0.000152%	657580	99.96%	1	0.31%
蒺	4649		14	1	0.000152%	657581	99.96%	1	0.31%
蒔	4650		14	1	0.000152%	657582	99.96%	1	0.31%
蓿	4651		15	1	0.000152%	657583	99.97%	1	0.31%
蔻	4652		15	1	0.000152%	657584	99.97%	1	0.31%
蔪	4653		15	1	0.000152%	657585	99.97%	1	0.31%
蔘	4654		15	1	0.000152%	657586	99.97%	1	0.31%
薔	4655		17	1	0.000152%	657587	99.97%	1	0.31%
薊	4656		17	1	0.000152%	657588	99.97%	1	0.31%
藪	4657		19	1	0.000152%	657589	99.97%	1	0.31%
藕	4658		19	1	0.000152%	657590	99.97%	1	0.31%
蘑	4659		20	1	0.000152%	657591	99.97%	1	0.31%
蘚	4660		21	1	0.000152%	657592	99.97%	1	0.31%
蘸	4661		23	1	0.000152%	657593	99.97%	1	0.31%
蚪	4662		10	1	0.000152%	657594	99.97%	1	0.31%
蚤	4663		10	1	0.000152%	657595	99.97%	1	0.31%
蚌	4664		10	1	0.000152%	657596	99.97%	1	0.31%
蚣	4665		10	1	0.000152%	657597	99.97%	1	0.31%
蛀	4666		11	1	0.000152%	657598	99.97%	1	0.31%
蛭	4667		12	1	0.000152%	657599	99.97%	1	0.31%
蛩	4668		12	1	0.000152%	657600	99.97%	1	0.31%
蜓	4669		13	1	0.000152%	657601	99.97%	1	0.31%
蜈	4670		13	1	0.000152%	657602	99.97%	1	0.31%
蜃	4671		13	1	0.000152%	657603	99.97%	1	0.31%
蜆	4672		13	1	0.000152%	657604	99.97%	1	0.31%
蛺	4673		13	1	0.000152%	657605	99.97%	1	0.31%
蜚	4674		14	1	0.000152%	657606	99.97%	1	0.31%
蝌	4675		15	1	0.000152%	657607	99.97%	1	0.31%
蟆	4676		17	1	0.000152%	657608	99.97%	1	0.31%
螫	4677		17	1	0.000152%	657609	99.97%	1	0.31%
螯	4678		17	1	0.000152%	657610	99.97%	1	0.31%
蠅	4679		19	1	0.000152%	657611	99.97%	1	0.31%
蠣	4680		21	1	0.000152%	657612	99.97%	1	0.31%
蠹	4681		24	1	0.000152%	657613	99.97%	1	0.31%
衢	4682		24	1	0.000152%	657614	99.97%	1	0.31%
袂	4683		9	1	0.000152%	657615	99.97%	1	0.31%
衿	4684		9	1	0.000152%	657616	99.97%	1	0.31%
袒	4685		10	1	0.000152%	657617	99.97%	1	0.31%
裎	4686		12	1	0.000152%	657618	99.97%	1	0.31%
裘	4687		13	1	0.000152%	657619	99.97%	1	0.31%
裱	4688		13	1	0.000152%	657620	99.97%	1	0.31%
裾	4689		13	1	0.000152%	657621	99.97%	1	0.31%
褊	4690		14	1	0.000152%	657622	99.97%	1	0.31%
褸	4691		16	1	0.000152%	657623	99.97%	1	0.31%
襤	4692		19	1	0.000152%	657624	99.97%	1	0.31%
襬	4693		20	1	0.000152%	657625	99.97%	1	0.31%
覃	4694		12	1	0.000152%	657626	99.97%	1	0.31%
觚	4695		12	1	0.000152%	657627	99.97%	1	0.31%
觴	4696		18	1	0.000152%	657628	99.97%	1	0.31%
訐	4697		10	1	0.000152%	657629	99.97%	1	0.31%
訕	4698		10	1	0.000152%	657630	99.97%	1	0.31%
訖	4699		10	1	0.000152%	657631	99.97%	1	0.31%
訥	4700		11	1	0.000152%	657632	99.97%	1	0.31%
詆	4701		12	1	0.000152%	657633	99.97%	1	0.31%
訶	4702		12	1	0.000152%	657634	99.97%	1	0.31%
諄	4703		15	1	0.000152%	657635	99.97%	1	0.31%
誹	4704		15	1	0.000152%	657636	99.97%	1	0.31%
諓	4705		15	1	0.000152%	657637	99.97%	1	0.31%
諜	4706		16	1	0.000152%	657638	99.97%	1	0.31%
謁	4707		16	1	0.000152%	657639	99.97%	1	0.31%
諡	4708		16	1	0.000152%	657640	99.97%	1	0.31%
謗	4709		17	1	0.000152%	657641	99.97%	1	0.31%
譁	4710		19	1	0.000152%	657642	99.97%	1	0.31%
豇	4711		10	1	0.000152%	657643	99.97%	1	0.31%
豉	4712		11	1	0.000152%	657644	99.97%	1	0.31%
豕	4713		7	1	0.000152%	657645	99.97%	1	0.31%
豳	4714		17	1	0.000152%	657646	99.97%	1	0.31%
貽	4715		12	1	0.000152%	657647	99.97%	1	0.31%
賒	4716		14	1	0.000152%	657648	99.97%	1	0.31%
賬	4717		15	1	0.000152%	657649	99.98%	1	0.31%
赧	4718		11	1	0.000152%	657650	99.98%	1	0.31%
赦	4719		11	1	0.000152%	657651	99.98%	1	0.31%
趺	4720		11	1	0.000152%	657652	99.98%	1	0.31%
跤	4721		13	1	0.000152%	657653	99.98%	1	0.31%
踝	4722		15	1	0.000152%	657654	99.98%	1	0.31%
踟	4723		15	1	0.000152%	657655	99.98%	1	0.31%
蹇	4724		17	1	0.000152%	657656	99.98%	1	0.31%
蹚	4725		18	1	0.000152%	657657	99.98%	1	0.31%
蹩	4726		18	1	0.000152%	657658	99.98%	1	0.31%
躕	4727		22	1	0.000152%	657659	99.98%	1	0.31%
躚	4728		22	1	0.000152%	657660	99.98%	1	0.31%
躡	4729		25	1	0.000152%	657661	99.98%	1	0.31%
軾	4730		13	1	0.000152%	657662	99.98%	1	0.31%
輊	4731		13	1	0.000152%	657663	99.98%	1	0.31%
輀	4732		13	1	0.000152%	657664	99.98%	1	0.31%
輓	4733		14	1	0.000152%	657665	99.98%	1	0.31%
轆	4734		18	1	0.000152%	657666	99.98%	1	0.31%
迆	4735		6	1	0.000152%	657667	99.98%	1	0.31%
迓	4736		7	1	0.000152%	657668	99.98%	1	0.31%
迨	4737		8	1	0.000152%	657669	99.98%	1	0.31%
迼	4738		10	1	0.000152%	657670	99.98%	1	0.31%
逋	4739		10	1	0.000152%	657671	99.98%	1	0.31%
逭	4740		11	1	0.000152%	657672	99.98%	1	0.31%
遄	4741		12	1	0.000152%	657673	99.98%	1	0.31%
遯	4742		14	1	0.000152%	657674	99.98%	1	0.31%
郢	4743		9	1	0.000152%	657675	99.98%	1	0.31%
鄔	4744		12	1	0.000152%	657676	99.98%	1	0.31%
酊	4745		9	1	0.000152%	657677	99.98%	1	0.31%
酐	4746		10	1	0.000152%	657678	99.98%	1	0.31%
酗	4747		11	1	0.000152%	657679	99.98%	1	0.31%
酖	4748		11	1	0.000152%	657680	99.98%	1	0.31%
酡	4749		12	1	0.000152%	657681	99.98%	1	0.31%
酩	4750		13	1	0.000152%	657682	99.98%	1	0.31%
酮	4751		13	1	0.000152%	657683	99.98%	1	0.31%
醐	4752		16	1	0.000152%	657684	99.98%	1	0.31%
醍	4753		16	1	0.000152%	657685	99.98%	1	0.31%
醱	4754		19	1	0.000152%	657686	99.98%	1	0.31%
釜	4755		10	1	0.000152%	657687	99.98%	1	0.31%
鈙	4756		12	1	0.000152%	657688	99.98%	1	0.31%
鈷	4757		13	1	0.000152%	657689	99.98%	1	0.31%
鉤	4758		13	1	0.000152%	657690	99.98%	1	0.31%
鈿	4759		13	1	0.000152%	657691	99.98%	1	0.31%
鉻	4760		14	1	0.000152%	657692	99.98%	1	0.31%
銑	4761		14	1	0.000152%	657693	99.98%	1	0.31%
鋅	4762		15	1	0.000152%	657694	99.98%	1	0.31%
鋏	4763		15	1	0.000152%	657695	99.98%	1	0.31%
鋌	4764		15	1	0.000152%	657696	99.98%	1	0.31%
銹	4765		15	1	0.000152%	657697	99.98%	1	0.31%
錳	4766		16	1	0.000152%	657698	99.98%	1	0.31%
鍍	4767		17	1	0.000152%	657699	99.98%	1	0.31%
鎂	4768		17	1	0.000152%	657700	99.98%	1	0.31%
錨	4769		17	1	0.000152%	657701	99.98%	1	0.31%
錘	4770		17	1	0.000152%	657702	99.98%	1	0.31%
鍬	4771		17	1	0.000152%	657703	99.98%	1	0.31%
鍰	4772		17	1	0.000152%	657704	99.98%	1	0.31%
鎊	4773		18	1	0.000152%	657705	99.98%	1	0.31%
鎳	4774		18	1	0.000152%	657706	99.98%	1	0.31%
鎬	4775		18	1	0.000152%	657707	99.98%	1	0.31%
鎚	4776		18	1	0.000152%	657708	99.98%	1	0.31%
鎗	4777		18	1	0.000152%	657709	99.98%	1	0.31%
鏈	4778		19	1	0.000152%	657710	99.98%	1	0.31%
鏢	4779		19	1	0.000152%	657711	99.98%	1	0.31%
鐮	4780		21	1	0.000152%	657712	99.98%	1	0.31%
鐺	4781		21	1	0.000152%	657713	99.98%	1	0.31%
鐲	4782		21	1	0.000152%	657714	99.98%	1	0.31%
鑣	4783		23	1	0.000152%	657715	99.99%	1	0.31%
鑪	4784		24	1	0.000152%	657716	99.99%	1	0.31%
鑾	4785		27	1	0.000152%	657717	99.99%	1	0.31%
閏	4786		12	1	0.000152%	657718	99.99%	1	0.31%
閶	4787		16	1	0.000152%	657719	99.99%	1	0.31%
闃	4788		17	1	0.000152%	657720	99.99%	1	0.31%
闓	4789		18	1	0.000152%	657721	99.99%	1	0.31%
阨	4790		6	1	0.000152%	657722	99.99%	1	0.31%
隋	4791		11	1	0.000152%	657723	99.99%	1	0.31%
陲	4792		11	1	0.000152%	657724	99.99%	1	0.31%
隼	4793		10	1	0.000152%	657725	99.99%	1	0.31%
雍	4794		13	1	0.000152%	657726	99.99%	1	0.31%
雋	4795		13	1	0.000152%	657727	99.99%	1	0.31%
雉	4796		13	1	0.000152%	657728	99.99%	1	0.31%
雩	4797		11	1	0.000152%	657729	99.99%	1	0.31%
霆	4798		15	1	0.000152%	657730	99.99%	1	0.31%
霹	4799		21	1	0.000152%	657731	99.99%	1	0.31%
霽	4800		22	1	0.000152%	657732	99.99%	1	0.31%
靶	4801		13	1	0.000152%	657733	99.99%	1	0.31%
靳	4802		13	1	0.000152%	657734	99.99%	1	0.31%
鞏	4803		15	1	0.000152%	657735	99.99%	1	0.31%
鞬	4804		18	1	0.000152%	657736	99.99%	1	0.31%
韭	4805		9	1	0.000152%	657737	99.99%	1	0.31%
韾	4806		20	1	0.000152%	657738	99.99%	1	0.31%
頇	4807		12	1	0.000152%	657739	99.99%	1	0.31%
頡	4808		15	1	0.000152%	657740	99.99%	1	0.31%
頤	4809		16	1	0.000152%	657741	99.99%	1	0.31%
餌	4810		14	1	0.000152%	657742	99.99%	1	0.31%
餞	4811		16	1	0.000152%	657743	99.99%	1	0.31%
餡	4812		16	1	0.000152%	657744	99.99%	1	0.31%
餚	4813		16	1	0.000152%	657745	99.99%	1	0.31%
餬	4814		17	1	0.000152%	657746	99.99%	1	0.31%
餮	4815		18	1	0.000152%	657747	99.99%	1	0.31%
饌	4816		20	1	0.000152%	657748	99.99%	1	0.31%
饕	4817		22	1	0.000152%	657749	99.99%	1	0.31%
饜	4818		23	1	0.000152%	657750	99.99%	1	0.31%
馭	4819		12	1	0.000152%	657751	99.99%	1	0.31%
駟	4820		15	1	0.000152%	657752	99.99%	1	0.31%
駿	4821		17	1	0.000152%	657753	99.99%	1	0.31%
騖	4822		19	1	0.000152%	657754	99.99%	1	0.31%
驄	4823		21	1	0.000152%	657755	99.99%	1	0.31%
骷	4824		15	1	0.000152%	657756	99.99%	1	0.31%
髏	4825		21	1	0.000152%	657757	99.99%	1	0.31%
髦	4826		14	1	0.000152%	657758	99.99%	1	0.31%
髫	4827		15	1	0.000152%	657759	99.99%	1	0.31%
髭	4828		16	1	0.000152%	657760	99.99%	1	0.31%
鬃	4829		18	1	0.000152%	657761	99.99%	1	0.31%
鬨	4830		16	1	0.000152%	657762	99.99%	1	0.31%
鬩	4831		18	1	0.000152%	657763	99.99%	1	0.31%
魷	4832		15	1	0.000152%	657764	99.99%	1	0.31%
鯽	4833		18	1	0.000152%	657765	99.99%	1	0.31%
鯖	4834		19	1	0.000152%	657766	99.99%	1	0.31%
鰓	4835		20	1	0.000152%	657767	99.99%	1	0.31%
鰻	4836		22	1	0.000152%	657768	99.99%	1	0.31%
鴝	4837		16	1	0.000152%	657769	99.99%	1	0.31%
鵲	4838		19	1	0.000152%	657770	99.99%	1	0.31%
鶚	4839		20	1	0.000152%	657771	99.99%	1	0.31%
鶩	4840		20	1	0.000152%	657772	99.99%	1	0.31%
鷂	4841		21	1	0.000152%	657773	99.99%	1	0.31%
鸝	4842		30	1	0.000152%	657774	99.99%	1	0.31%
黥	4843		20	1	0.000152%	657775	99.99%	1	0.31%
黧	4844		20	1	0.000152%	657776	99.99%	1	0.31%
黷	4845		27	1	0.000152%	657777	99.99%	1	0.31%
齧	4846		21	1	0.000152%	657778	99.99%	1	0.31%
