單字	序號	部首	筆劃	頻次	頻率	累積頻次	累積頻率	見檔次	見檔率
的	1		8	26987	4.074%	26987	4.074%	358	98.62%
一	2		1	10843	1.637%	37830	5.711%	360	99.17%
是	3		9	8712	1.315%	46542	7.027%	346	95.32%
不	4		4	7660	1.156%	54202	8.183%	346	95.32%
我	5		7	7375	1.113%	61577	9.297%	305	84.02%
在	6		6	6756	1.020%	68333	10.32%	358	98.62%
有	7		6	6694	1.011%	75027	11.33%	352	96.97%
人	8		2	5809	0.877%	80836	12.20%	336	92.56%
了	9		2	5211	0.7867%	86047	12.99%	318	87.60%
之	10		4	5162	0.7793%	91209	13.77%	314	86.50%
為	11		9	4682	0.7069%	95891	14.48%	336	92.56%
以	12		5	4427	0.6684%	100318	15.15%	334	92.01%
中	13		4	3872	0.5846%	104190	15.73%	337	92.84%
這	14		10	3833	0.5787%	108023	16.31%	318	87.60%
國	15		11	3592	0.5423%	111615	16.85%	266	73.28%
上	16		3	3548	0.5357%	115163	17.39%	341	93.94%
大	17		3	3431	0.518%	118594	17.90%	333	91.74%
時	18		10	3410	0.5148%	122004	18.42%	330	90.91%
而	19		6	3261	0.4923%	125265	18.91%	325	89.53%
來	20		8	3207	0.4842%	128472	19.40%	333	91.74%
他	21		5	3179	0.480%	131651	19.88%	296	81.54%
們	22		10	3138	0.4738%	134789	20.35%	293	80.72%
個	23		10	2999	0.4528%	137788	20.80%	320	88.15%
生	24		5	2998	0.4526%	140786	21.26%	322	88.71%
可	25		5	2908	0.439%	143694	21.69%	323	88.98%
於	26		8	2882	0.4351%	146576	22.13%	322	88.71%
地	27		6	2714	0.4097%	149290	22.54%	319	87.88%
到	28		8	2618	0.3953%	151908	22.93%	316	87.05%
也	29		3	2540	0.3835%	154448	23.32%	296	81.54%
所	30		8	2385	0.3601%	156833	23.68%	305	84.02%
年	31		6	2357	0.3559%	159190	24.03%	298	82.09%
要	32		9	2310	0.3488%	161500	24.38%	320	88.15%
得	33		11	2304	0.3478%	163804	24.73%	313	86.23%
說	34		14	2268	0.3424%	166072	25.07%	287	79.06%
那	35		6	2208	0.3334%	168280	25.41%	252	69.42%
其	36		8	2168	0.3273%	170448	25.73%	289	79.61%
會	37		13	2159	0.326%	172607	26.06%	302	83.20%
作	38		7	2141	0.3232%	174748	26.38%	283	77.96%
如	39		6	2122	0.3204%	176870	26.70%	309	85.12%
自	40		6	2112	0.3189%	178982	27.02%	327	90.08%
與	41		14	2073	0.313%	181055	27.33%	277	76.31%
用	42		5	2069	0.3124%	183124	27.65%	271	74.66%
能	43		10	2033	0.3069%	185157	27.95%	295	81.27%
多	44		6	2014	0.3041%	187171	28.26%	310	85.40%
學	45		16	2006	0.3029%	189177	28.56%	226	62.26%
就	46		12	1969	0.2973%	191146	28.86%	284	78.24%
子	47		3	1951	0.2946%	193097	29.15%	259	71.35%
出	48		5	1897	0.2864%	194994	29.44%	309	85.12%
對	49		14	1897	0.2864%	196891	29.73%	304	83.75%
和	50		8	1881	0.284%	198772	30.01%	275	75.76%
家	51		10	1861	0.281%	200633	30.29%	284	78.24%
然	52		12	1855	0.2801%	202488	30.57%	310	85.40%
工	53		3	1844	0.2784%	204332	30.85%	222	61.16%
成	54		6	1831	0.2764%	206163	31.13%	307	84.57%
此	55		6	1787	0.2698%	207950	31.40%	287	79.06%
後	56		9	1780	0.2687%	209730	31.66%	312	85.95%
種	57		14	1750	0.2642%	211480	31.93%	274	75.48%
十	58		2	1745	0.2635%	213225	32.19%	274	75.48%
發	59		12	1734	0.2618%	214959	32.45%	291	80.17%
因	60		6	1711	0.2583%	216670	32.71%	286	78.79%
過	61		12	1704	0.2573%	218374	32.97%	304	83.75%
下	62		3	1690	0.2551%	220064	33.22%	309	85.12%
方	63		4	1679	0.2535%	221743	33.48%	282	77.69%
小	64		3	1677	0.2532%	223420	33.73%	268	73.83%
你	65		7	1675	0.2529%	225095	33.98%	153	42.15%
業	66		13	1646	0.2485%	226741	34.23%	183	50.41%
天	67		4	1645	0.2484%	228386	34.48%	282	77.69%
經	68		13	1637	0.2471%	230023	34.73%	292	80.44%
及	69		4	1615	0.2438%	231638	34.97%	240	66.12%
本	70		5	1599	0.2414%	233237	35.21%	248	68.32%
心	71		4	1568	0.2367%	234805	35.45%	274	75.48%
面	72		9	1563	0.236%	236368	35.69%	284	78.24%
日	73		4	1548	0.2337%	237916	35.92%	284	78.24%
都	74		9	1530	0.231%	239446	36.15%	285	78.51%
者	75		8	1498	0.2262%	240944	36.38%	251	69.15%
無	76		12	1497	0.226%	242441	36.60%	286	78.79%
去	77		5	1455	0.2197%	243896	36.82%	277	76.31%
但	78		7	1445	0.2182%	245341	37.04%	300	82.64%
法	79		8	1424	0.215%	246765	37.26%	226	62.26%
三	80		3	1397	0.2109%	248162	37.47%	259	71.35%
外	81		5	1386	0.2093%	249548	37.68%	272	74.93%
水	82		4	1385	0.2091%	250933	37.88%	204	56.20%
理	83		11	1384	0.209%	252317	38.09%	246	67.77%
同	84		6	1381	0.2085%	253698	38.30%	293	80.72%
已	85		3	1356	0.2047%	255054	38.51%	289	79.61%
事	86		8	1350	0.2038%	256404	38.71%	273	75.21%
當	87		13	1350	0.2038%	257754	38.91%	285	78.51%
文	88		4	1332	0.2011%	259086	39.12%	192	52.89%
前	89		9	1331	0.2009%	260417	39.32%	294	80.99%
現	90		11	1301	0.1964%	261718	39.51%	273	75.21%
起	91		10	1299	0.1961%	263017	39.71%	280	77.13%
分	92		4	1298	0.196%	264315	39.91%	263	72.45%
由	93		5	1285	0.194%	265600	40.10%	264	72.73%
行	94		6	1277	0.1928%	266877	40.29%	272	74.93%
好	95		6	1274	0.1923%	268151	40.48%	264	72.73%
想	96		13	1256	0.1896%	269407	40.67%	235	64.74%
實	97		14	1227	0.1852%	270634	40.86%	264	72.73%
使	98		8	1221	0.1843%	271855	41.04%	270	74.38%
美	99		9	1219	0.184%	273074	41.23%	245	67.49%
等	100		12	1214	0.1833%	274288	41.41%	251	69.15%
二	101		2	1211	0.1828%	275499	41.59%	264	72.73%
著	102		12	1193	0.1801%	276692	41.77%	215	59.23%
她	103		6	1190	0.1797%	277882	41.95%	103	28.37%
看	104		9	1141	0.1723%	279023	42.13%	231	63.64%
又	105		2	1135	0.1714%	280158	42.30%	262	72.18%
產	106		11	1131	0.1708%	281289	42.47%	156	42.98%
間	107		12	1131	0.1708%	282420	42.64%	270	74.38%
長	108		8	1122	0.1694%	283542	42.81%	250	68.87%
麼	109		14	1120	0.1691%	284662	42.98%	209	57.58%
公	110		4	1116	0.1685%	285778	43.15%	197	54.27%
開	111		12	1103	0.1665%	286881	43.31%	274	75.48%
意	112		13	1101	0.1662%	287982	43.48%	268	73.83%
重	113		9	1101	0.1662%	289083	43.64%	260	71.63%
部	114		10	1091	0.1647%	290174	43.81%	219	60.33%
高	115		10	1090	0.1646%	291264	43.97%	254	69.97%
最	116		12	1076	0.1625%	292340	44.14%	278	76.58%
或	117		8	1071	0.1617%	293411	44.30%	222	61.16%
沒	118		7	1063	0.1605%	294474	44.46%	234	64.46%
加	119		5	1050	0.1585%	295524	44.62%	237	65.29%
主	120		5	1039	0.1569%	296563	44.77%	213	58.68%
情	121		11	1039	0.1569%	297602	44.93%	252	69.42%
動	122		11	1022	0.1543%	298624	45.09%	247	68.04%
樣	123		15	1019	0.1538%	299643	45.24%	227	62.53%
品	124		9	1017	0.1535%	300660	45.39%	138	38.02%
些	125		8	987	0.149%	301647	45.54%	237	65.29%
進	126		11	986	0.1489%	302633	45.69%	252	69.42%
它	127		5	984	0.1486%	303617	45.84%	196	53.99%
民	128		5	982	0.1483%	304599	45.99%	165	45.45%
新	129		13	979	0.1478%	305578	46.14%	226	62.26%
五	130		4	976	0.1474%	306554	46.28%	223	61.43%
四	131		5	972	0.1467%	307526	46.43%	238	65.56%
兩	132		8	971	0.1466%	308497	46.58%	250	68.87%
並	133		8	965	0.1457%	309462	46.72%	266	73.28%
定	134		8	956	0.1443%	310418	46.87%	242	66.67%
代	135		5	953	0.1439%	311371	47.01%	220	60.61%
將	136		11	941	0.1421%	312312	47.15%	262	72.18%
海	137		10	933	0.1409%	313245	47.29%	175	48.21%
着	138		11	933	0.1409%	314178	47.43%	113	31.13%
點	139		17	923	0.1394%	315101	47.57%	244	67.22%
常	140		11	922	0.1392%	316023	47.71%	252	69.42%
全	141		6	920	0.1389%	316943	47.85%	244	67.22%
知	142		8	915	0.1381%	317858	47.99%	233	64.19%
從	143		11	912	0.1377%	318770	48.13%	257	70.80%
還	144		16	911	0.1375%	319681	48.26%	231	63.64%
道	145		12	908	0.1371%	320589	48.40%	226	62.26%
只	146		5	907	0.1369%	321496	48.54%	230	63.36%
至	147		6	906	0.1368%	322402	48.68%	241	66.39%
應	148		17	895	0.1351%	323297	48.81%	230	63.36%
像	149		14	889	0.1342%	324186	48.94%	205	56.47%
正	150		5	889	0.1342%	325075	49.08%	255	70.25%
各	151		6	884	0.1335%	325959	49.21%	197	54.27%
力	152		2	881	0.133%	326840	49.35%	236	65.01%
則	153		9	875	0.1321%	327715	49.48%	207	57.02%
果	154		8	871	0.1315%	328586	49.61%	240	66.12%
相	155		9	862	0.1301%	329448	49.74%	240	66.12%
利	156		7	858	0.1295%	330306	49.87%	189	52.07%
物	157		8	851	0.1285%	331157	50.00%	199	54.82%
很	158		9	850	0.1283%	332007	50.13%	212	58.40%
月	159		4	844	0.1274%	332851	50.25%	207	57.02%
把	160		7	831	0.1255%	333682	50.38%	212	58.40%
少	161		4	825	0.1246%	334507	50.50%	254	69.97%
更	162		7	822	0.1241%	335329	50.63%	239	65.84%
明	163		8	817	0.1233%	336146	50.75%	223	61.43%
太	164		4	812	0.1226%	336958	50.87%	188	51.79%
化	165		4	811	0.1224%	337769	51.00%	180	49.59%
見	166		7	806	0.1217%	338575	51.12%	245	67.49%
先	167		6	801	0.1209%	339376	51.24%	201	55.37%
處	168		11	799	0.1206%	340175	51.36%	225	61.98%
臺	169		14	797	0.1203%	340972	51.48%	145	39.94%
頭	170		16	797	0.1203%	341769	51.60%	215	59.23%
場	171		12	794	0.1199%	342563	51.72%	152	41.87%
花	172		8	794	0.1199%	343357	51.84%	172	47.38%
色	173		6	790	0.1193%	344147	51.96%	184	50.69%
合	174		6	789	0.1191%	344936	52.08%	206	56.75%
形	175		7	782	0.1181%	345718	52.20%	188	51.79%
問	176		11	776	0.1172%	346494	52.31%	215	59.23%
次	177		6	773	0.1167%	347267	52.43%	224	61.71%
原	178		10	763	0.1152%	348030	52.54%	216	59.50%
教	179		11	762	0.115%	348792	52.66%	165	45.45%
平	180		5	760	0.1147%	349552	52.77%	213	58.68%
位	181		7	757	0.1143%	350309	52.89%	210	57.85%
政	182		9	756	0.1141%	351065	53.00%	133	36.64%
活	183		9	755	0.114%	351820	53.12%	202	55.65%
內	184		4	751	0.1134%	352571	53.23%	215	59.23%
機	185		16	751	0.1134%	353322	53.34%	205	56.47%
世	186		5	741	0.1119%	354063	53.46%	205	56.47%
關	187		19	740	0.1117%	354803	53.57%	222	61.16%
市	188		5	736	0.1111%	355539	53.68%	120	33.06%
每	189		7	727	0.1098%	356266	53.79%	220	60.61%
裏	190		13	727	0.1098%	356993	53.90%	134	36.91%
性	191		8	726	0.1096%	357719	54.01%	187	51.52%
魚	192		11	723	0.1092%	358442	54.12%	70	19.28%
向	193		6	713	0.1076%	359155	54.22%	253	69.70%
立	194		5	708	0.1069%	359863	54.33%	211	58.13%
感	195		13	707	0.1067%	360570	54.44%	198	54.55%
展	196		10	706	0.1066%	361276	54.54%	157	43.25%
西	197		6	682	0.103%	361958	54.65%	191	52.62%
氣	198		10	678	0.1024%	362636	54.75%	188	51.79%
表	199		8	678	0.1024%	363314	54.85%	214	58.95%
必	200		5	676	0.1021%	363990	54.95%	217	59.78%
回	201		6	674	0.1018%	364664	55.06%	195	53.72%
口	202		3	672	0.1015%	365336	55.16%	179	49.31%
亦	203		6	670	0.1012%	366006	55.26%	142	39.12%
己	204		3	670	0.1012%	366676	55.36%	180	49.59%
手	205		4	667	0.1007%	367343	55.46%	212	58.40%
再	206		6	661	0.0998%	368004	55.56%	220	60.61%
體	207		23	661	0.0998%	368665	55.66%	190	52.34%
光	208		6	659	0.09949%	369324	55.76%	204	56.20%
女	209		3	659	0.09949%	369983	55.86%	140	38.57%
真	210		10	658	0.09934%	370641	55.96%	191	52.62%
設	211		11	658	0.09934%	371299	56.06%	152	41.87%
何	212		7	656	0.09904%	371955	56.16%	222	61.16%
度	213		9	649	0.09798%	372604	56.25%	195	53.72%
今	214		4	644	0.09723%	373248	56.35%	213	58.68%
便	215		9	641	0.09678%	373889	56.45%	186	51.24%
目	216		5	640	0.09662%	374529	56.54%	212	58.40%
百	217		6	639	0.09647%	375168	56.64%	173	47.66%
類	218		19	639	0.09647%	375807	56.74%	162	44.63%
運	219		12	634	0.09572%	376441	56.83%	153	42.15%
比	220		4	631	0.09527%	377072	56.93%	202	55.65%
書	221		10	630	0.09512%	377702	57.02%	145	39.94%
員	222		10	629	0.09496%	378331	57.12%	149	41.05%
山	223		3	627	0.09466%	378958	57.21%	131	36.09%
期	224		12	627	0.09466%	379585	57.31%	187	51.52%
給	225		12	627	0.09466%	380212	57.40%	193	53.17%
名	226		6	626	0.09451%	380838	57.50%	188	51.79%
漁	227		14	623	0.09406%	381461	57.59%	32	8.82%
白	228		5	623	0.09406%	382084	57.69%	182	50.14%
聲	229		17	623	0.09406%	382707	57.78%	165	45.45%
第	230		11	621	0.09376%	383328	57.87%	184	50.69%
受	231		8	620	0.09361%	383948	57.97%	206	56.75%
幾	232		12	618	0.0933%	384566	58.06%	217	59.78%
特	233		10	617	0.09315%	385183	58.15%	191	52.62%
義	234		13	614	0.0927%	385797	58.25%	141	38.84%
界	235		9	611	0.09225%	386408	58.34%	194	53.44%
風	236		9	609	0.09194%	387017	58.43%	185	50.96%
即	237		7	604	0.09119%	387621	58.52%	185	50.96%
入	238		2	602	0.09089%	388223	58.61%	208	57.30%
數	239		15	601	0.09074%	388824	58.70%	195	53.72%
身	240		7	598	0.09028%	389422	58.79%	204	56.20%
計	241		9	595	0.08983%	390017	58.88%	155	42.70%
曾	242		12	591	0.08923%	390608	58.97%	219	60.33%
非	243		8	591	0.08923%	391199	59.06%	197	54.27%
總	244		17	590	0.08908%	391789	59.15%	211	58.13%
量	245		12	589	0.08892%	392378	59.24%	161	44.35%
究	246		7	588	0.08877%	392966	59.33%	142	39.12%
且	247		5	581	0.08772%	393547	59.42%	215	59.23%
裡	248		12	580	0.08757%	394127	59.50%	112	30.85%
共	249		6	574	0.08666%	394701	59.59%	139	38.29%
較	250		13	573	0.08651%	395274	59.68%	154	42.42%
老	251		6	570	0.08606%	395844	59.76%	160	44.08%
許	252		11	570	0.08606%	396414	59.85%	216	59.50%
愛	253		13	563	0.085%	396977	59.93%	168	46.28%
建	254		9	561	0.0847%	397538	60.02%	138	38.02%
別	255		7	559	0.0844%	398097	60.10%	210	57.85%
神	256		9	559	0.0844%	398656	60.19%	166	45.73%
題	257		18	556	0.08394%	399212	60.27%	162	44.63%
近	258		7	552	0.08334%	399764	60.35%	208	57.30%
兒	259		8	551	0.08319%	400315	60.44%	121	33.33%
商	260		11	550	0.08304%	400865	60.52%	101	27.82%
六	261		4	549	0.08289%	401414	60.60%	167	46.01%
才	262		3	548	0.08273%	401962	60.69%	188	51.79%
易	263		8	546	0.08243%	402508	60.77%	148	40.77%
望	264		11	544	0.08213%	403052	60.85%	206	56.75%
車	265		7	544	0.08213%	403596	60.93%	93	25.62%
該	266		13	540	0.08153%	404136	61.01%	183	50.41%
論	267		15	540	0.08153%	404676	61.10%	184	50.69%
萬	268		13	536	0.08092%	405212	61.18%	177	48.76%
研	269		9	535	0.08077%	405747	61.26%	105	28.93%
區	270		11	533	0.08047%	406280	61.34%	110	30.30%
接	271		11	529	0.07987%	406809	61.42%	186	51.24%
流	272		9	526	0.07941%	407335	61.50%	174	47.93%
往	273		8	523	0.07896%	407858	61.58%	170	46.83%
保	274		9	520	0.07851%	408378	61.66%	149	41.05%
被	275		10	520	0.07851%	408898	61.73%	199	54.82%
通	276		10	515	0.07775%	409413	61.81%	178	49.04%
安	277		6	514	0.0776%	409927	61.89%	158	43.53%
社	278		7	513	0.07745%	410440	61.97%	138	38.02%
話	279		13	513	0.07745%	410953	62.04%	151	41.60%
命	280		8	512	0.0773%	411465	62.12%	166	45.73%
難	281		19	511	0.07715%	411976	62.20%	217	59.78%
觀	282		25	509	0.07685%	412485	62.28%	172	47.38%
影	283		15	504	0.07609%	412989	62.35%	172	47.38%
做	284		11	503	0.07594%	413492	62.43%	175	48.21%
報	285		12	502	0.07579%	413994	62.50%	125	34.44%
提	286		12	502	0.07579%	414496	62.58%	175	48.21%
故	287		9	502	0.07579%	414998	62.65%	169	46.56%
裝	288		13	502	0.07579%	415500	62.73%	116	31.96%
東	289		8	501	0.07564%	416001	62.81%	181	49.86%
結	290		12	501	0.07564%	416502	62.88%	182	50.14%
變	291		23	501	0.07564%	417003	62.96%	201	55.37%
術	292		11	498	0.07519%	417501	63.03%	142	39.12%
資	293		13	498	0.07519%	417999	63.11%	100	27.55%
科	294		9	497	0.07504%	418496	63.18%	83	22.87%
雖	295		17	497	0.07504%	418993	63.26%	204	56.20%
樂	296		15	495	0.07473%	419488	63.33%	155	42.70%
須	297		12	494	0.07458%	419982	63.41%	158	43.53%
解	298		13	491	0.07413%	420473	63.48%	182	50.14%
直	299		8	490	0.07398%	420963	63.56%	199	54.82%
石	300		5	489	0.07383%	421452	63.63%	115	31.68%
空	301		8	488	0.07368%	421940	63.70%	160	44.08%
片	302		4	487	0.07353%	422427	63.78%	137	37.74%
灣	303		25	486	0.07337%	422913	63.85%	104	28.65%
深	304		11	485	0.07322%	423398	63.92%	198	54.55%
遠	305		13	485	0.07322%	423883	64.00%	177	48.76%
醫	306		18	485	0.07322%	424368	64.07%	56	15.43%
記	307		10	483	0.07292%	424851	64.14%	161	44.35%
任	308		6	482	0.07277%	425333	64.22%	185	50.96%
寫	309		15	482	0.07277%	425815	64.29%	131	36.09%
甚	310		9	482	0.07277%	426297	64.36%	178	49.04%
需	311		14	482	0.07277%	426779	64.43%	142	39.12%
造	312		10	481	0.07262%	427260	64.51%	154	42.42%
字	313		6	480	0.07247%	427740	64.58%	151	41.60%
什	314		4	475	0.07171%	428215	64.65%	139	38.29%
未	315		5	473	0.07141%	428688	64.72%	189	52.07%
管	316		14	473	0.07141%	429161	64.79%	152	41.87%
覺	317		20	473	0.07141%	429634	64.86%	160	44.08%
言	318		7	468	0.07066%	430102	64.94%	171	47.11%
張	319		11	467	0.07051%	430569	65.01%	144	39.67%
認	320		14	467	0.07051%	431036	65.08%	168	46.28%
式	321		6	466	0.07035%	431502	65.15%	148	40.77%
九	322		2	462	0.06975%	431964	65.22%	139	38.29%
反	323		4	460	0.06945%	432424	65.29%	175	48.21%
治	324		8	460	0.06945%	432884	65.36%	108	29.75%
交	325		6	455	0.06869%	433339	65.42%	150	41.32%
價	326		15	455	0.06869%	433794	65.49%	129	35.54%
候	327		10	454	0.06854%	434248	65.56%	154	42.42%
銷	328		15	453	0.06839%	434701	65.63%	60	16.53%
八	329		2	450	0.06794%	435151	65.70%	160	44.08%
具	330		8	450	0.06794%	435601	65.77%	153	42.15%
求	331		7	450	0.06794%	436051	65.83%	171	47.11%
木	332		4	449	0.06779%	436500	65.90%	102	28.10%
信	333		9	445	0.06718%	436945	65.97%	141	38.84%
北	334		5	445	0.06718%	437390	66.04%	128	35.26%
份	335		6	444	0.06703%	437834	66.10%	160	44.08%
金	336		8	443	0.06688%	438277	66.17%	149	41.05%
似	337		7	442	0.06673%	438719	66.24%	178	49.04%
制	338		8	442	0.06673%	439161	66.30%	125	34.44%
興	339		16	442	0.06673%	439603	66.37%	163	44.90%
音	340		9	442	0.06673%	440045	66.44%	105	28.93%
料	341		10	438	0.06613%	440483	66.50%	117	32.23%
走	342		7	437	0.06598%	440920	66.57%	151	41.60%
藝	343		19	435	0.06567%	441355	66.63%	85	23.42%
條	344		11	434	0.06552%	441789	66.70%	147	40.50%
象	345		12	434	0.06552%	442223	66.77%	138	38.02%
完	346		7	433	0.06537%	442656	66.83%	179	49.31%
病	347		10	432	0.06522%	443088	66.90%	90	24.79%
船	348		11	432	0.06522%	443520	66.96%	68	18.73%
達	349		12	430	0.06492%	443950	67.03%	162	44.63%
約	350		9	428	0.06462%	444378	67.09%	137	37.74%
切	351		4	426	0.06432%	444804	67.15%	177	48.76%
雨	352		8	425	0.06416%	445229	67.22%	78	21.49%
門	353		8	424	0.06401%	445653	67.28%	151	41.60%
親	354		16	423	0.06386%	446076	67.35%	111	30.58%
電	355		13	423	0.06386%	446499	67.41%	111	30.58%
司	356		5	422	0.06371%	446921	67.47%	85	23.42%
打	357		5	420	0.06341%	447341	67.54%	165	45.45%
路	358		13	419	0.06326%	447760	67.60%	148	40.77%
極	359		13	418	0.06311%	448178	67.66%	153	42.15%
樹	360		16	418	0.06311%	448596	67.73%	98	27.00%
邊	361		18	415	0.06266%	449011	67.79%	144	39.67%
際	362		13	413	0.06235%	449424	67.85%	129	35.54%
放	363		8	412	0.0622%	449836	67.91%	162	44.63%
德	364		15	410	0.0619%	450246	67.98%	115	31.68%
孩	365		9	409	0.06175%	450655	68.04%	87	23.97%
始	366		8	407	0.06145%	451062	68.10%	173	47.66%
千	367		3	404	0.06099%	451466	68.16%	167	46.01%
除	368		9	402	0.06069%	451868	68.22%	175	48.21%
南	369		9	401	0.06054%	452269	68.28%	119	32.78%
滿	370		14	399	0.06024%	452668	68.34%	168	46.28%
識	371		19	398	0.06009%	453066	68.40%	122	33.61%
半	372		5	397	0.05994%	453463	68.46%	153	42.15%
質	373		15	396	0.05979%	453859	68.52%	120	33.06%
思	374		9	394	0.05948%	454253	68.58%	131	36.09%
據	375		16	394	0.05948%	454647	68.64%	146	40.22%
眼	376		11	394	0.05948%	455041	68.70%	157	43.25%
務	377		11	392	0.05918%	455433	68.76%	135	37.19%
聽	378		22	392	0.05918%	455825	68.82%	145	39.94%
步	379		7	391	0.05903%	456216	68.88%	177	48.76%
統	380		11	391	0.05903%	456607	68.94%	130	35.81%
製	381		14	391	0.05903%	456998	69.00%	96	26.45%
七	382		2	389	0.05873%	457387	69.05%	151	41.60%
件	383		6	388	0.05858%	457775	69.11%	142	39.12%
失	384		5	388	0.05858%	458163	69.17%	169	46.56%
材	385		7	388	0.05858%	458551	69.23%	72	19.83%
包	386		5	386	0.05828%	458937	69.29%	138	38.02%
清	387		11	386	0.05828%	459323	69.35%	156	42.98%
油	388		8	383	0.05782%	459706	69.40%	76	20.94%
青	389		8	383	0.05782%	460089	69.46%	129	35.54%
養	390		15	383	0.05782%	460472	69.52%	121	33.33%
參	391		11	381	0.05752%	460853	69.58%	122	33.61%
呢	392		8	381	0.05752%	461234	69.64%	131	36.09%
推	393		11	380	0.05737%	461614	69.69%	139	38.29%
改	394		7	380	0.05737%	461994	69.75%	135	37.19%
母	395		5	380	0.05737%	462374	69.81%	85	23.42%
紅	396		9	380	0.05737%	462754	69.86%	114	31.40%
華	397		12	378	0.05707%	463132	69.92%	141	38.84%
藥	398		19	377	0.05692%	463509	69.98%	56	15.43%
容	399		10	376	0.05677%	463885	70.04%	177	48.76%
帶	400		11	376	0.05677%	464261	70.09%	147	40.50%
辦	401		16	376	0.05677%	464637	70.15%	123	33.88%
戰	402		16	373	0.05631%	465010	70.21%	113	31.13%
落	403		13	372	0.05616%	465382	70.26%	155	42.70%
士	404		3	371	0.05601%	465753	70.32%	136	37.47%
育	405		7	371	0.05601%	466124	70.37%	99	27.27%
費	406		12	369	0.05571%	466493	70.43%	117	32.23%
住	407		7	363	0.0548%	466856	70.48%	129	35.54%
刻	408		8	362	0.05465%	467218	70.54%	111	30.58%
整	409		16	360	0.05435%	467578	70.59%	166	45.73%
畫	410		12	359	0.0542%	467937	70.65%	67	18.46%
項	411		12	358	0.05405%	468295	70.70%	100	27.55%
夜	412		8	357	0.0539%	468652	70.76%	130	35.81%
熱	413		15	357	0.0539%	469009	70.81%	130	35.81%
格	414		10	355	0.0536%	469364	70.86%	139	38.29%
般	415		10	355	0.0536%	469719	70.92%	155	42.70%
例	416		8	353	0.05329%	470072	70.97%	127	34.99%
句	417		5	352	0.05314%	470424	71.02%	102	28.10%
照	418		13	352	0.05314%	470776	71.08%	158	43.53%
增	419		15	351	0.05299%	471127	71.13%	123	33.88%
筆	420		12	351	0.05299%	471478	71.18%	101	27.82%
乎	421		5	349	0.05269%	471827	71.23%	159	43.80%
足	422		7	349	0.05269%	472176	71.29%	171	47.11%
備	423		12	348	0.05254%	472524	71.34%	140	38.57%
土	424		3	348	0.05254%	472872	71.39%	88	24.24%
係	425		9	347	0.05239%	473219	71.44%	139	38.29%
取	426		8	347	0.05239%	473566	71.50%	165	45.45%
單	427		12	346	0.05224%	473912	71.55%	156	42.98%
視	428		12	346	0.05224%	474258	71.60%	162	44.63%
傳	429		13	345	0.05209%	474603	71.65%	144	39.67%
收	430		6	345	0.05209%	474948	71.71%	138	38.02%
林	431		8	345	0.05209%	475293	71.76%	113	31.13%
節	432		13	345	0.05209%	475638	71.81%	133	36.64%
農	433		13	345	0.05209%	475983	71.86%	67	18.46%
卻	434		9	344	0.05194%	476327	71.91%	120	33.06%
輕	435		14	344	0.05194%	476671	71.97%	133	36.64%
均	436		7	343	0.05178%	477014	72.02%	104	28.65%
院	437		9	343	0.05178%	477357	72.07%	107	29.48%
馬	438		10	343	0.05178%	477700	72.12%	118	32.51%
友	439		4	342	0.05163%	478042	72.17%	116	31.96%
指	440		9	342	0.05163%	478384	72.22%	158	43.53%
精	441		14	341	0.05148%	478725	72.28%	147	40.50%
消	442		10	338	0.05103%	479063	72.33%	146	40.22%
型	443		9	337	0.05088%	479400	72.38%	87	23.97%
離	444		18	337	0.05088%	479737	72.43%	151	41.60%
快	445		7	336	0.05073%	480073	72.48%	130	35.81%
器	446		16	334	0.05043%	480407	72.53%	91	25.07%
府	447		8	334	0.05043%	480741	72.58%	109	30.03%
讀	448		22	334	0.05043%	481075	72.63%	111	30.58%
基	449		11	330	0.04982%	481405	72.68%	120	33.06%
火	450		4	330	0.04982%	481735	72.73%	105	28.93%
根	451		10	329	0.04967%	482064	72.78%	146	40.22%
決	452		7	328	0.04952%	482392	72.83%	146	40.22%
調	453		15	326	0.04922%	482718	72.88%	143	39.39%
另	454		5	323	0.04877%	483041	72.93%	166	45.73%
廠	455		15	323	0.04877%	483364	72.98%	58	15.98%
紙	456		10	323	0.04877%	483687	73.03%	66	18.18%
驗	457		23	323	0.04877%	484010	73.07%	100	27.55%
古	458		5	322	0.04861%	484332	73.12%	128	35.26%
轉	459		18	321	0.04846%	484653	73.17%	139	38.29%
早	460		6	320	0.04831%	484973	73.22%	148	40.77%
適	461		14	320	0.04831%	485293	73.27%	137	37.74%
省	462		9	318	0.04801%	485611	73.32%	97	26.72%
濟	463		17	317	0.04786%	485928	73.36%	81	22.31%
詩	464		13	317	0.04786%	486245	73.41%	73	20.11%
談	465		15	316	0.04771%	486561	73.46%	136	37.47%
毛	466		4	315	0.04756%	486876	73.51%	85	23.42%
效	467		10	314	0.04741%	487190	73.55%	99	27.27%
復	468		12	313	0.04726%	487503	73.60%	111	30.58%
劇	469		15	312	0.0471%	487815	73.65%	52	14.33%
若	470		9	312	0.0471%	488127	73.70%	132	36.36%
境	471		14	310	0.0468%	488437	73.74%	135	37.19%
仍	472		4	308	0.0465%	488745	73.79%	158	43.53%
血	473		6	308	0.0465%	489053	73.84%	68	18.73%
喜	474		12	307	0.04635%	489360	73.88%	116	31.96%
念	475		8	307	0.04635%	489667	73.93%	130	35.81%
採	476		11	305	0.04605%	489972	73.97%	99	27.27%
師	477		10	304	0.0459%	490276	74.02%	94	25.90%
軍	478		9	304	0.0459%	490580	74.07%	78	21.49%
香	479		9	304	0.0459%	490884	74.11%	101	27.82%
校	480		10	302	0.04559%	491186	74.16%	89	24.52%
連	481		10	302	0.04559%	491488	74.20%	147	40.50%
令	482		5	301	0.04544%	491789	74.25%	126	34.71%
講	483		17	301	0.04544%	492090	74.29%	102	28.10%
導	484		16	300	0.04529%	492390	74.34%	117	32.23%
持	485		9	300	0.04529%	492690	74.38%	133	36.64%
笑	486		10	300	0.04529%	492990	74.43%	102	28.10%
春	487		9	299	0.04514%	493289	74.47%	97	26.72%
死	488		6	299	0.04514%	493588	74.52%	106	29.20%
告	489		7	298	0.04499%	493886	74.57%	137	37.74%
值	490		10	297	0.04484%	494183	74.61%	132	36.36%
構	491		14	297	0.04484%	494480	74.65%	91	25.07%
響	492		21	296	0.04469%	494776	74.70%	136	37.47%
星	493		9	295	0.04454%	495071	74.74%	103	28.37%
黃	494		12	295	0.04454%	495366	74.79%	113	31.13%
致	495		9	294	0.04439%	495660	74.83%	144	39.67%
房	496		8	293	0.04424%	495953	74.88%	98	27.00%
稱	497		14	293	0.04424%	496246	74.92%	118	32.51%
劃	498		14	292	0.04409%	496538	74.97%	100	27.55%
引	499		4	292	0.04409%	496830	75.01%	140	38.57%
準	500		13	292	0.04409%	497122	75.05%	126	34.71%
斯	501		12	291	0.04393%	497413	75.10%	85	23.42%
服	502		8	290	0.04378%	497703	75.14%	125	34.44%
餘	503		15	290	0.04378%	497993	75.19%	126	34.71%
夢	504		14	289	0.04363%	498282	75.23%	79	21.76%
久	505		3	288	0.04348%	498570	75.27%	156	42.98%
元	506		4	288	0.04348%	498858	75.32%	101	27.82%
細	507		11	287	0.04333%	499145	75.36%	119	32.78%
苦	508		9	286	0.04318%	499431	75.40%	134	36.91%
尼	509		5	285	0.04303%	499716	75.45%	54	14.88%
算	510		14	284	0.04288%	500000	75.49%	124	34.16%
僅	511		13	281	0.04242%	500281	75.53%	128	35.26%
食	512		9	281	0.04242%	500562	75.57%	82	22.59%
專	513		11	280	0.04227%	500842	75.62%	115	31.68%
拉	514		8	280	0.04227%	501122	75.66%	73	20.11%
讓	515		24	279	0.04212%	501401	75.70%	125	34.44%
屬	516		21	278	0.04197%	501679	75.74%	130	35.81%
球	517		11	278	0.04197%	501957	75.78%	55	15.15%
冷	518		7	277	0.04182%	502234	75.83%	92	25.34%
越	519		12	276	0.04167%	502510	75.87%	91	25.07%
圖	520		14	275	0.04152%	502785	75.91%	99	27.27%
父	521		4	275	0.04152%	503060	75.95%	78	21.49%
級	522		10	275	0.04152%	503335	75.99%	90	24.79%
漸	523		14	274	0.04137%	503609	76.03%	117	32.23%
積	524		16	274	0.04137%	503883	76.07%	102	28.10%
限	525		8	273	0.04122%	504156	76.12%	144	39.67%
黑	526		12	272	0.04107%	504428	76.16%	109	30.03%
斷	527		18	271	0.04091%	504699	76.20%	142	39.12%
施	528		9	271	0.04091%	504970	76.24%	87	23.97%
營	529		17	271	0.04091%	505241	76.28%	76	20.94%
皮	530		5	271	0.04091%	505512	76.32%	81	22.31%
顯	531		23	271	0.04091%	505783	76.36%	128	35.26%
希	532		7	270	0.04076%	506053	76.40%	145	39.94%
洲	533		9	270	0.04076%	506323	76.44%	75	20.66%
留	534		10	270	0.04076%	506593	76.48%	137	37.74%
供	535		8	269	0.04061%	506862	76.52%	109	30.03%
夫	536		4	269	0.04061%	507131	76.56%	100	27.55%
獲	537		17	269	0.04061%	507400	76.61%	116	31.96%
示	538		5	269	0.04061%	507669	76.65%	132	36.36%
歡	539		22	268	0.04046%	507937	76.69%	112	30.85%
洋	540		9	267	0.04031%	508204	76.73%	104	28.65%
確	541		15	267	0.04031%	508471	76.77%	135	37.19%
靜	542		16	267	0.04031%	508738	76.81%	103	28.37%
程	543		12	266	0.04016%	509004	76.85%	119	32.78%
習	544		11	266	0.04016%	509270	76.89%	109	30.03%
語	545		14	266	0.04016%	509536	76.93%	111	30.58%
低	546		7	265	0.04001%	509801	76.97%	116	31.96%
強	547		11	263	0.03971%	510064	77.01%	133	36.64%
線	548		15	261	0.0394%	510325	77.05%	87	23.97%
試	549		13	261	0.0394%	510586	77.09%	102	28.10%
港	550		12	260	0.03925%	510846	77.13%	58	15.98%
隨	551		15	260	0.03925%	511106	77.16%	144	39.67%
存	552		6	259	0.0391%	511365	77.20%	120	33.06%
永	553		5	259	0.0391%	511624	77.24%	108	29.75%
列	554		6	258	0.03895%	511882	77.28%	117	32.23%
標	555		15	256	0.03865%	512138	77.32%	100	27.55%
草	556		10	256	0.03865%	512394	77.36%	102	28.10%
底	557		8	255	0.0385%	512649	77.40%	120	33.06%
燈	558		16	255	0.0385%	512904	77.44%	69	19.01%
爭	559		8	255	0.0385%	513159	77.47%	112	30.85%
獨	560		16	255	0.0385%	513414	77.51%	128	35.26%
印	561		6	254	0.03835%	513668	77.55%	87	23.97%
尚	562		8	254	0.03835%	513922	77.59%	118	32.51%
規	563		11	254	0.03835%	514176	77.63%	107	29.48%
述	564		8	254	0.03835%	514430	77.67%	101	27.82%
置	565		13	253	0.0382%	514683	77.70%	93	25.62%
亞	566		8	252	0.03805%	514935	77.74%	88	24.24%
夠	567		11	252	0.03805%	515187	77.78%	133	36.64%
充	568		5	251	0.0379%	515438	77.82%	139	38.29%
初	569		7	251	0.0379%	515689	77.86%	127	34.99%
助	570		7	250	0.03774%	515939	77.89%	105	28.93%
英	571		9	249	0.03759%	516188	77.93%	97	26.72%
層	572		15	248	0.03744%	516436	77.97%	85	23.42%
尤	573		4	247	0.03729%	516683	78.01%	126	34.71%
依	574		8	244	0.03684%	516927	78.04%	126	34.71%
功	575		5	244	0.03684%	517171	78.08%	119	32.78%
證	576		19	244	0.03684%	517415	78.12%	94	25.90%
晚	577		11	243	0.03669%	517658	78.15%	113	31.13%
却	578		7	242	0.03654%	517900	78.19%	79	21.76%
技	579		7	241	0.03639%	518141	78.23%	82	22.59%
注	580		8	241	0.03639%	518382	78.26%	123	33.88%
免	581		7	240	0.03623%	518622	78.30%	121	33.33%
羅	582		19	239	0.03608%	518861	78.34%	70	19.28%
否	583		7	238	0.03593%	519099	78.37%	130	35.81%
段	584		9	238	0.03593%	519337	78.41%	117	32.23%
組	585		11	238	0.03593%	519575	78.44%	88	24.24%
查	586		9	237	0.03578%	519812	78.48%	83	22.87%
待	587		9	236	0.03563%	520048	78.51%	130	35.81%
舉	588		17	236	0.03563%	520284	78.55%	115	31.68%
謂	589		16	235	0.03548%	520519	78.59%	120	33.06%
終	590		11	234	0.03533%	520753	78.62%	130	35.81%
選	591		15	233	0.03518%	520986	78.66%	113	31.13%
防	592		6	233	0.03518%	521219	78.69%	60	16.53%
河	593		8	232	0.03503%	521451	78.73%	71	19.56%
集	594		12	232	0.03503%	521683	78.76%	106	29.20%
叫	595		5	231	0.03488%	521914	78.80%	108	29.75%
媽	596		13	231	0.03488%	522145	78.83%	29	7.99%
居	597		8	231	0.03488%	522376	78.87%	113	31.13%
貨	598		11	231	0.03488%	522607	78.90%	54	14.88%
乃	599		2	229	0.03457%	522836	78.94%	96	26.45%
吃	600		6	229	0.03457%	523065	78.97%	86	23.69%
紀	601		9	229	0.03457%	523294	79.00%	96	26.45%
客	602		9	228	0.03442%	523522	79.04%	100	27.55%
廣	603		15	227	0.03427%	523749	79.07%	114	31.40%
排	604		11	227	0.03427%	523976	79.11%	88	24.24%
飛	605		9	227	0.03427%	524203	79.14%	100	27.55%
考	606		6	226	0.03412%	524429	79.18%	119	32.78%
聯	607		17	226	0.03412%	524655	79.21%	84	23.14%
權	608		22	225	0.03397%	524880	79.24%	83	22.87%
歲	609		13	225	0.03397%	525105	79.28%	90	24.79%
牠	610		7	224	0.03382%	525329	79.31%	15	4.13%
演	611		14	223	0.03367%	525552	79.35%	69	19.01%
輪	612		15	223	0.03367%	525775	79.38%	58	15.98%
巴	613		4	222	0.03352%	525997	79.41%	58	15.98%
短	614		12	222	0.03352%	526219	79.45%	112	30.85%
議	615		20	222	0.03352%	526441	79.48%	92	25.34%
普	616		12	221	0.03337%	526662	79.51%	93	25.62%
景	617		12	221	0.03337%	526883	79.55%	94	25.90%
假	618		11	219	0.03306%	527102	79.58%	106	29.20%
局	619		7	219	0.03306%	527321	79.61%	91	25.07%
苗	620		9	219	0.03306%	527540	79.65%	11	3.03%
靈	621		24	219	0.03306%	527759	79.68%	103	28.37%
吧	622		7	218	0.03291%	527977	79.71%	91	25.07%
陸	623		10	218	0.03291%	528195	79.74%	80	22.04%
陽	624		11	217	0.03276%	528412	79.78%	102	28.10%
願	625		19	217	0.03276%	528629	79.81%	119	32.78%
竟	626		11	216	0.03261%	528845	79.84%	123	33.88%
良	627		7	216	0.03261%	529061	79.88%	95	26.17%
怕	628		8	215	0.03246%	529276	79.91%	100	27.55%
怎	629		9	215	0.03246%	529491	79.94%	96	26.45%
支	630		4	215	0.03246%	529706	79.97%	106	29.20%
密	631		11	214	0.03231%	529920	80.01%	96	26.45%
請	632		15	213	0.03216%	530133	80.04%	100	27.55%
淡	633		11	210	0.03171%	530343	80.07%	79	21.76%
乾	634		11	209	0.03155%	530552	80.10%	72	19.83%
善	635		12	209	0.03155%	530761	80.13%	110	30.30%
減	636		12	209	0.03155%	530970	80.16%	82	22.59%
跟	637		13	209	0.03155%	531179	80.20%	71	19.56%
止	638		4	208	0.0314%	531387	80.23%	127	34.99%
盡	639		14	208	0.0314%	531595	80.26%	123	33.88%
史	640		5	207	0.03125%	531802	80.29%	92	25.34%
角	641		7	206	0.0311%	532008	80.32%	110	30.30%
站	642		10	205	0.03095%	532213	80.35%	97	26.72%
號	643		13	205	0.03095%	532418	80.38%	93	25.62%
息	644		10	204	0.0308%	532622	80.41%	117	32.23%
曲	645		6	204	0.0308%	532826	80.44%	72	19.83%
首	646		9	204	0.0308%	533030	80.47%	122	33.61%
剪	647		11	203	0.03065%	533233	80.51%	30	8.26%
織	648		18	203	0.03065%	533436	80.54%	98	27.00%
雲	649		12	203	0.03065%	533639	80.57%	80	22.04%
簡	650		18	202	0.0305%	533841	80.60%	104	28.65%
奇	651		8	201	0.03035%	534042	80.63%	102	28.10%
環	652		17	201	0.03035%	534243	80.66%	106	29.20%
葉	653		13	201	0.03035%	534444	80.69%	73	20.11%
衣	654		6	201	0.03035%	534645	80.72%	80	22.04%
創	655		12	200	0.0302%	534845	80.75%	87	23.97%
狀	656		8	200	0.0302%	535045	80.78%	88	24.24%
味	657		8	198	0.02989%	535243	80.81%	103	28.37%
素	658		10	198	0.02989%	535441	80.84%	85	23.42%
坐	659		7	197	0.02974%	535638	80.87%	88	24.24%
板	660		8	197	0.02974%	535835	80.90%	73	20.11%
討	661		10	197	0.02974%	536032	80.93%	105	28.93%
館	662		16	197	0.02974%	536229	80.96%	53	14.60%
城	663		9	196	0.02959%	536425	80.99%	82	22.59%
富	664		12	196	0.02959%	536621	81.02%	106	29.20%
職	665		18	196	0.02959%	536817	81.05%	65	17.91%
麗	666		19	196	0.02959%	537013	81.08%	83	22.87%
沙	667		7	195	0.02944%	537208	81.11%	64	17.63%
田	668		5	195	0.02944%	537403	81.14%	42	11.57%
肉	669		6	195	0.02944%	537598	81.16%	59	16.25%
陳	670		10	195	0.02944%	537793	81.19%	70	19.28%
律	671		9	194	0.02929%	537987	81.22%	83	22.87%
案	672		10	194	0.02929%	538181	81.25%	66	18.18%
于	673		3	193	0.02914%	538374	81.28%	31	8.54%
派	674		9	193	0.02914%	538567	81.31%	78	21.49%
窗	675		12	193	0.02914%	538760	81.34%	70	19.28%
維	676		14	193	0.02914%	538953	81.37%	94	25.90%
黨	677		20	193	0.02914%	539146	81.40%	42	11.57%
爾	678		14	192	0.02899%	539338	81.43%	69	19.01%
眾	679		11	192	0.02899%	539530	81.46%	84	23.14%
雙	680		18	192	0.02899%	539722	81.49%	97	26.72%
散	681		12	191	0.02884%	539913	81.51%	92	25.34%
益	682		10	191	0.02884%	540104	81.54%	78	21.49%
嚴	683		20	189	0.02853%	540293	81.57%	117	32.23%
季	684		8	189	0.02853%	540482	81.60%	67	18.46%
鄉	685		11	189	0.02853%	540671	81.63%	71	19.56%
配	686		10	189	0.02853%	540860	81.66%	91	25.07%
予	687		4	188	0.02838%	541048	81.69%	98	27.00%
既	688		9	188	0.02838%	541236	81.71%	103	28.37%
歌	689		14	188	0.02838%	541424	81.74%	69	19.01%
沉	690		7	188	0.02838%	541612	81.77%	89	24.52%
篇	691		15	188	0.02838%	541800	81.80%	68	18.73%
顧	692		21	188	0.02838%	541988	81.83%	93	25.62%
停	693		11	187	0.02823%	542175	81.86%	99	27.27%
絕	694		12	187	0.02823%	542362	81.88%	104	28.65%
送	695		9	187	0.02823%	542549	81.91%	91	25.07%
修	696		10	186	0.02808%	542735	81.94%	82	22.59%
圓	697		13	186	0.02808%	542921	81.97%	81	22.31%
源	698		13	186	0.02808%	543107	82.00%	85	23.42%
域	699		11	185	0.02793%	543292	82.02%	57	15.70%
態	700		14	185	0.02793%	543477	82.05%	104	28.65%
福	701		13	185	0.02793%	543662	82.08%	74	20.39%
舊	702		18	185	0.02793%	543847	82.11%	95	26.17%
團	703		14	184	0.02778%	544031	82.14%	83	22.87%
竹	704		6	184	0.02778%	544215	82.16%	59	16.25%
聞	705		14	184	0.02778%	544399	82.19%	77	21.21%
害	706		10	183	0.02763%	544582	82.22%	84	23.14%
革	707		9	183	0.02763%	544765	82.25%	55	15.15%
缺	708		10	182	0.02748%	544947	82.27%	101	27.82%
佔	709		7	181	0.02733%	545128	82.30%	87	23.97%
嗎	710		13	181	0.02733%	545309	82.33%	85	23.42%
植	711		12	181	0.02733%	545490	82.36%	51	14.05%
歷	712		16	181	0.02733%	545671	82.38%	101	27.82%
負	713		9	181	0.02733%	545852	82.41%	114	31.40%
找	714		7	180	0.02718%	546032	82.44%	89	24.52%
投	715		7	180	0.02718%	546212	82.47%	76	20.94%
貿	716		12	180	0.02718%	546392	82.49%	29	7.99%
隊	717		11	180	0.02718%	546572	82.52%	50	13.77%
倫	718		10	179	0.02702%	546751	82.55%	48	13.22%
克	719		7	179	0.02702%	546930	82.57%	78	21.49%
室	720		9	179	0.02702%	547109	82.60%	85	23.42%
戲	721		17	179	0.02702%	547288	82.63%	52	14.33%
氏	722		4	179	0.02702%	547467	82.65%	41	11.29%
溫	723		13	179	0.02702%	547646	82.68%	91	25.07%
錢	724		16	179	0.02702%	547825	82.71%	71	19.56%
委	725		8	178	0.02687%	548003	82.74%	56	15.43%
愈	726		13	178	0.02687%	548181	82.76%	56	15.43%
毒	727		9	178	0.02687%	548359	82.79%	28	7.71%
況	728		8	178	0.02687%	548537	82.82%	104	28.65%
續	729		21	178	0.02687%	548715	82.84%	105	28.93%
蘭	730		21	178	0.02687%	548893	82.87%	53	14.60%
蛇	731		11	178	0.02687%	549071	82.90%	16	4.41%
里	732		7	178	0.02687%	549249	82.92%	83	22.87%
亮	733		9	177	0.02672%	549426	82.95%	79	21.76%
哲	734		10	177	0.02672%	549603	82.98%	38	10.47%
破	735		10	177	0.02672%	549780	83.00%	104	28.65%
傷	736		13	175	0.02642%	549955	83.03%	77	21.21%
答	737		12	175	0.02642%	550130	83.06%	80	22.04%
速	738		10	175	0.02642%	550305	83.08%	87	23.97%
尺	739		4	174	0.02627%	550479	83.11%	59	16.25%
徵	740		15	174	0.02627%	550653	83.14%	58	15.98%
慢	741		14	174	0.02627%	550827	83.16%	68	18.73%
款	742		12	174	0.02627%	551001	83.19%	44	12.12%
輸	743		16	174	0.02627%	551175	83.21%	45	12.40%
圍	744		12	173	0.02612%	551348	83.24%	101	27.82%
朋	745		8	173	0.02612%	551521	83.27%	73	20.11%
異	746		11	173	0.02612%	551694	83.29%	102	28.10%
端	747		14	173	0.02612%	551867	83.32%	84	23.14%
絲	748		12	173	0.02612%	552040	83.34%	71	19.56%
鐵	749		21	173	0.02612%	552213	83.37%	64	17.63%
隻	750		10	173	0.02612%	552386	83.40%	71	19.56%
屋	751		9	172	0.02597%	552558	83.42%	71	19.56%
某	752		9	172	0.02597%	552730	83.45%	72	19.83%
稅	753		12	172	0.02597%	552902	83.48%	30	8.26%
勢	754		13	171	0.02582%	553073	83.50%	88	24.24%
幸	755		8	170	0.02567%	553243	83.53%	81	22.31%
綠	756		14	170	0.02567%	553413	83.55%	69	19.01%
責	757		11	170	0.02567%	553583	83.58%	97	26.72%
退	758		9	170	0.02567%	553753	83.60%	68	18.73%
企	759		6	169	0.02551%	553922	83.63%	51	14.05%
座	760		10	169	0.02551%	554091	83.65%	81	22.31%
率	761		11	168	0.02536%	554259	83.68%	69	19.01%
趣	762		15	168	0.02536%	554427	83.71%	104	28.65%
藏	763		18	167	0.02521%	554594	83.73%	72	19.83%
遊	764		12	167	0.02521%	554761	83.76%	78	21.49%
皆	765		9	166	0.02506%	554927	83.78%	78	21.49%
酒	766		10	166	0.02506%	555093	83.81%	53	14.60%
王	767		4	165	0.02491%	555258	83.83%	77	21.21%
腦	768		13	165	0.02491%	555423	83.86%	53	14.60%
險	769		15	165	0.02491%	555588	83.88%	65	17.91%
領	770		14	165	0.02491%	555753	83.91%	97	26.72%
倒	771		10	164	0.02476%	555917	83.93%	88	24.24%
匪	772		10	164	0.02476%	556081	83.96%	36	9.92%
固	773		8	164	0.02476%	556245	83.98%	90	24.79%
微	774		13	164	0.02476%	556409	84.00%	90	24.79%
急	775		9	164	0.02476%	556573	84.03%	84	23.14%
症	776		10	164	0.02476%	556737	84.05%	17	4.68%
夏	777		10	163	0.02461%	556900	84.08%	71	19.56%
左	778		5	163	0.02461%	557063	84.10%	89	24.52%
凡	779		3	162	0.02446%	557225	84.13%	100	27.55%
官	780		8	161	0.02431%	557386	84.15%	74	20.39%
批	781		7	161	0.02431%	557547	84.18%	68	18.73%
緊	782		14	161	0.02431%	557708	84.20%	93	25.62%
諸	783		15	161	0.02431%	557869	84.22%	76	20.94%
繼	784		20	160	0.02416%	558029	84.25%	99	27.27%
買	785		12	160	0.02416%	558189	84.27%	67	18.46%
括	786		9	159	0.02401%	558348	84.30%	84	23.14%
族	787		11	159	0.02401%	558507	84.32%	55	15.15%
睡	788		14	159	0.02401%	558666	84.35%	60	16.53%
蘇	789		20	159	0.02401%	558825	84.37%	53	14.60%
訴	790		12	159	0.02401%	558984	84.39%	70	19.28%
川	791		3	158	0.02385%	559142	84.42%	30	8.26%
干	792		3	158	0.02385%	559300	84.44%	78	21.49%
鐘	793		20	158	0.02385%	559458	84.46%	62	17.08%
階	794		11	158	0.02385%	559616	84.49%	66	18.18%
優	795		17	157	0.0237%	559773	84.51%	86	23.69%
妳	796		8	157	0.0237%	559930	84.54%	6	1.65%
威	797		9	157	0.0237%	560087	84.56%	71	19.56%
探	798		11	157	0.0237%	560244	84.58%	58	15.98%
園	799		13	156	0.02355%	560400	84.61%	72	19.83%
痛	800		12	156	0.02355%	560556	84.63%	78	21.49%
布	801		5	155	0.0234%	560711	84.65%	69	19.01%
班	802		10	155	0.0234%	560866	84.68%	62	17.08%
秋	803		9	155	0.0234%	561021	84.70%	58	15.98%
阿	804		7	155	0.0234%	561176	84.72%	50	13.77%
波	805		8	154	0.02325%	561330	84.75%	79	21.76%
頂	806		11	154	0.02325%	561484	84.77%	78	21.49%
頗	807		14	154	0.02325%	561638	84.79%	80	22.04%
售	808		11	153	0.0231%	561791	84.82%	39	10.74%
李	809		7	153	0.0231%	561944	84.84%	50	13.77%
樓	810		15	153	0.0231%	562097	84.86%	58	15.98%
默	811		16	153	0.0231%	562250	84.89%	56	15.43%
困	812		7	152	0.02295%	562402	84.91%	101	27.82%
按	813		9	152	0.02295%	562554	84.93%	79	21.76%
純	814		10	152	0.02295%	562706	84.96%	72	19.83%
課	815		15	152	0.02295%	562858	84.98%	59	16.25%
途	816		10	152	0.02295%	563010	85.00%	90	24.79%
雜	817		18	152	0.02295%	563162	85.02%	83	22.87%
彩	818		11	151	0.0228%	563313	85.05%	77	21.21%
宜	819		8	150	0.02265%	563463	85.07%	79	21.76%
懷	820		19	150	0.02265%	563613	85.09%	92	25.34%
檢	821		17	150	0.02265%	563763	85.11%	66	18.18%
預	822		13	150	0.02265%	563913	85.14%	80	22.04%
杜	823		7	149	0.0225%	564062	85.16%	26	7.16%
突	824		9	149	0.0225%	564211	85.18%	78	21.49%
系	825		7	149	0.0225%	564360	85.20%	63	17.36%
零	826		13	148	0.02234%	564508	85.23%	73	20.11%
飾	827		13	148	0.02234%	564656	85.25%	41	11.29%
勞	828		12	147	0.02219%	564803	85.27%	63	17.36%
載	829		13	147	0.02219%	564950	85.29%	59	16.25%
雄	830		12	147	0.02219%	565097	85.32%	68	18.73%
男	831		7	146	0.02204%	565243	85.34%	64	17.63%
穿	832		9	146	0.02204%	565389	85.36%	70	19.28%
莫	833		11	146	0.02204%	565535	85.38%	71	19.56%
右	834		5	144	0.02174%	565679	85.40%	84	23.14%
江	835		6	144	0.02174%	565823	85.43%	47	12.95%
背	836		9	144	0.02174%	565967	85.45%	77	21.21%
腳	837		13	144	0.02174%	566111	85.47%	76	20.94%
差	838		10	143	0.02159%	566254	85.49%	85	23.42%
略	839		11	143	0.02159%	566397	85.51%	88	24.24%
菜	840		12	143	0.02159%	566540	85.53%	43	11.85%
壓	841		17	142	0.02144%	566682	85.56%	66	18.18%
島	842		10	142	0.02144%	566824	85.58%	57	15.70%
爸	843		8	142	0.02144%	566966	85.60%	15	4.13%
脫	844		11	142	0.02144%	567108	85.62%	74	20.39%
貴	845		12	142	0.02144%	567250	85.64%	88	24.24%
核	846		10	141	0.02129%	567391	85.66%	50	13.77%
章	847		11	141	0.02129%	567532	85.68%	61	16.80%
範	848		15	141	0.02129%	567673	85.71%	85	23.42%
詞	849		12	141	0.02129%	567814	85.73%	58	15.98%
哥	850		10	140	0.02114%	567954	85.75%	33	9.09%
架	851		9	140	0.02114%	568094	85.77%	60	16.53%
淺	852		11	140	0.02114%	568234	85.79%	52	14.33%
湖	853		12	140	0.02114%	568374	85.81%	36	9.92%
繁	854		17	140	0.02114%	568514	85.83%	68	18.73%
誰	855		15	140	0.02114%	568654	85.85%	82	22.59%
追	856		9	140	0.02114%	568794	85.87%	75	20.66%
拿	857		10	139	0.02099%	568933	85.90%	75	20.66%
浪	858		10	139	0.02099%	569072	85.92%	72	19.83%
策	859		12	139	0.02099%	569211	85.94%	52	14.33%
宗	860		8	138	0.02083%	569349	85.96%	46	12.67%
憶	861		16	138	0.02083%	569487	85.98%	71	19.56%
擴	862		18	138	0.02083%	569625	86.00%	65	17.91%
歸	863		18	138	0.02083%	569763	86.02%	92	25.34%
舞	864		14	137	0.02068%	569900	86.04%	57	15.70%
護	865		21	137	0.02068%	570037	86.06%	62	17.08%
康	866		11	136	0.02053%	570173	86.08%	51	14.05%
惡	867		12	136	0.02053%	570309	86.10%	78	21.49%
航	868		10	136	0.02053%	570445	86.12%	40	11.02%
遇	869		12	136	0.02053%	570581	86.14%	83	22.87%
模	870		15	135	0.02038%	570716	86.16%	78	21.49%
髮	871		15	135	0.02038%	570851	86.18%	56	15.43%
唱	872		11	134	0.02023%	570985	86.21%	54	14.88%
察	873		14	134	0.02023%	571119	86.23%	75	20.66%
尾	874		7	134	0.02023%	571253	86.25%	49	13.50%
忘	875		7	134	0.02023%	571387	86.27%	84	23.14%
替	876		12	134	0.02023%	571521	86.29%	74	20.39%
財	877		10	134	0.02023%	571655	86.31%	54	14.88%
佛	878		7	133	0.02008%	571788	86.33%	33	9.09%
呼	879		8	133	0.02008%	571921	86.35%	72	19.83%
壞	880		19	133	0.02008%	572054	86.37%	70	19.28%
尋	881		12	133	0.02008%	572187	86.39%	77	21.21%
悲	882		12	133	0.02008%	572320	86.41%	63	17.36%
臉	883		17	133	0.02008%	572453	86.43%	59	16.25%
補	884		12	133	0.02008%	572586	86.45%	73	20.11%
鬥	885		10	133	0.02008%	572719	86.47%	53	14.60%
塊	886		13	132	0.01993%	572851	86.49%	63	17.36%
忽	887		8	132	0.01993%	572983	86.51%	78	21.49%
超	888		12	132	0.01993%	573115	86.53%	75	20.66%
逐	889		10	132	0.01993%	573247	86.55%	76	20.94%
附	890		7	132	0.01993%	573379	86.57%	78	21.49%
額	891		18	132	0.01993%	573511	86.59%	44	12.12%
付	892		5	131	0.01978%	573642	86.61%	65	17.91%
協	893		8	131	0.01978%	573773	86.63%	58	15.98%
庭	894		10	131	0.01978%	573904	86.65%	78	21.49%
狗	895		8	131	0.01978%	574035	86.67%	24	6.61%
含	896		7	130	0.01963%	574165	86.69%	60	16.53%
練	897		15	130	0.01963%	574295	86.70%	55	15.15%
臨	898		17	130	0.01963%	574425	86.72%	86	23.69%
啊	899		11	129	0.01948%	574554	86.74%	53	14.60%
堂	900		11	129	0.01948%	574683	86.76%	68	18.73%
療	901		17	129	0.01948%	574812	86.78%	27	7.44%
編	902		15	129	0.01948%	574941	86.80%	59	16.25%
刀	903		2	128	0.01932%	575069	86.82%	32	8.82%
卡	904		5	128	0.01932%	575197	86.84%	30	8.26%
擊	905		17	128	0.01932%	575325	86.86%	56	15.43%
錯	906		16	128	0.01932%	575453	86.88%	79	21.76%
雕	907		16	128	0.01932%	575581	86.90%	27	7.44%
岸	908		8	127	0.01917%	575708	86.92%	62	17.08%
暗	909		13	127	0.01917%	575835	86.94%	79	21.76%
枝	910		8	127	0.01917%	575962	86.96%	64	17.63%
畢	911		11	127	0.01917%	576089	86.98%	65	17.91%
孔	912		4	126	0.01902%	576215	86.99%	50	13.77%
群	913		13	126	0.01902%	576341	87.01%	59	16.25%
副	914		11	125	0.01887%	576466	87.03%	74	20.39%
測	915		12	125	0.01887%	576591	87.05%	51	14.05%
築	916		16	125	0.01887%	576716	87.07%	50	13.77%
網	917		14	125	0.01887%	576841	87.09%	33	9.09%
吸	918		7	124	0.01872%	576965	87.11%	75	20.66%
帝	919		9	124	0.01872%	577089	87.13%	51	14.05%
惟	920		11	124	0.01872%	577213	87.15%	53	14.60%
歐	921		15	124	0.01872%	577337	87.16%	56	15.43%
雪	922		11	124	0.01872%	577461	87.18%	60	16.53%
俄	923		9	123	0.01857%	577584	87.20%	21	5.79%
烈	924		10	123	0.01857%	577707	87.22%	75	20.66%
透	925		10	123	0.01857%	577830	87.24%	88	24.24%
驚	926		23	123	0.01857%	577953	87.26%	85	23.42%
典	927		8	122	0.01842%	578075	87.28%	56	15.43%
換	928		12	122	0.01842%	578197	87.29%	88	24.24%
擔	929		16	122	0.01842%	578319	87.31%	68	18.73%
評	930		12	122	0.01842%	578441	87.33%	59	16.25%
露	931		21	122	0.01842%	578563	87.35%	79	21.76%
亂	932		13	121	0.01827%	578684	87.37%	73	20.11%
奮	933		16	121	0.01827%	578805	87.39%	63	17.36%
池	934		6	121	0.01827%	578926	87.40%	38	10.47%
街	935		12	121	0.01827%	579047	87.42%	48	13.22%
健	936		11	120	0.01812%	579167	87.44%	64	17.63%
台	937		5	120	0.01812%	579287	87.46%	43	11.85%
寧	938		14	120	0.01812%	579407	87.48%	59	16.25%
忙	939		6	120	0.01812%	579527	87.49%	59	16.25%
版	940		8	120	0.01812%	579647	87.51%	29	7.99%
貝	941		7	120	0.01812%	579767	87.53%	32	8.82%
野	942		11	120	0.01812%	579887	87.55%	65	17.91%
厚	943		9	119	0.01797%	580006	87.57%	77	21.21%
盛	944		11	119	0.01797%	580125	87.59%	74	20.39%
禮	945		17	119	0.01797%	580244	87.60%	71	19.56%
救	946		11	118	0.01782%	580362	87.62%	55	15.15%
玩	947		8	118	0.01782%	580480	87.64%	58	15.98%
楊	948		13	117	0.01766%	580597	87.66%	30	8.26%
銀	949		14	117	0.01766%	580714	87.67%	55	15.15%
陣	950		9	117	0.01766%	580831	87.69%	67	18.46%
堅	951		11	116	0.01751%	580947	87.71%	66	18.18%
旁	952		10	116	0.01751%	581063	87.73%	69	19.01%
漢	953		14	116	0.01751%	581179	87.74%	50	13.77%
賞	954		15	116	0.01751%	581295	87.76%	68	18.73%
飄	955		20	116	0.01751%	581411	87.78%	51	14.05%
飯	956		12	116	0.01751%	581527	87.80%	51	14.05%
授	957		11	115	0.01736%	581642	87.81%	41	11.29%
揚	958		12	115	0.01736%	581757	87.83%	65	17.91%
激	959		16	115	0.01736%	581872	87.85%	70	19.28%
聖	960		13	115	0.01736%	581987	87.87%	54	14.88%
訓	961		10	115	0.01736%	582102	87.88%	62	17.08%
黎	962		15	115	0.01736%	582217	87.90%	32	8.82%
促	963		9	114	0.01721%	582331	87.92%	50	13.77%
偶	964		11	114	0.01721%	582445	87.94%	69	19.01%
周	965		8	114	0.01721%	582559	87.95%	67	18.46%
恐	966		10	114	0.01721%	582673	87.97%	75	20.66%
貸	967		12	114	0.01721%	582787	87.99%	18	4.96%
麻	968		11	114	0.01721%	582901	88.00%	57	15.70%
店	969		8	113	0.01706%	583014	88.02%	48	13.22%
橋	970		16	113	0.01706%	583127	88.04%	31	8.54%
灰	971		6	113	0.01706%	583240	88.06%	60	16.53%
購	972		17	113	0.01706%	583353	88.07%	44	12.12%
陶	973		10	113	0.01706%	583466	88.09%	35	9.64%
俗	974		9	112	0.01691%	583578	88.11%	65	17.91%
冬	975		5	112	0.01691%	583690	88.12%	58	15.98%
勝	976		12	112	0.01691%	583802	88.14%	59	16.25%
岩	977		8	112	0.01691%	583914	88.16%	17	4.68%
弱	978		10	112	0.01691%	584026	88.17%	58	15.98%
承	979		8	112	0.01691%	584138	88.19%	74	20.39%
榮	980		14	112	0.01691%	584250	88.21%	55	15.15%
登	981		12	112	0.01691%	584362	88.22%	53	14.60%
藉	982		18	112	0.01691%	584474	88.24%	64	17.63%
遍	983		12	112	0.01691%	584586	88.26%	70	19.28%
龍	984		16	112	0.01691%	584698	88.28%	60	16.53%
仁	985		4	110	0.01661%	584808	88.29%	45	12.40%
博	986		12	110	0.01661%	584918	88.31%	51	14.05%
床	987		7	110	0.01661%	585028	88.33%	62	17.08%
朝	988		12	110	0.01661%	585138	88.34%	63	17.36%
殖	989		12	110	0.01661%	585248	88.36%	21	5.79%
藍	990		18	110	0.01661%	585358	88.38%	52	14.33%
互	991		4	109	0.01646%	585467	88.39%	67	18.46%
享	992		8	109	0.01646%	585576	88.41%	65	17.91%
圃	993		10	109	0.01646%	585685	88.42%	4	1.10%
寒	994		12	109	0.01646%	585794	88.44%	58	15.98%
抗	995		7	109	0.01646%	585903	88.46%	58	15.98%
損	996		13	109	0.01646%	586012	88.47%	51	14.05%
概	997		13	109	0.01646%	586121	88.49%	71	19.56%
癌	998		17	109	0.01646%	586230	88.51%	7	1.93%
佈	999		7	108	0.01631%	586338	88.52%	66	18.18%
佳	1000		8	108	0.01631%	586446	88.54%	65	17.91%
抽	1001		8	108	0.01631%	586554	88.56%	54	14.88%
操	1002		16	108	0.01631%	586662	88.57%	45	12.40%
澳	1003		16	108	0.01631%	586770	88.59%	18	4.96%
婚	1004		11	107	0.01615%	586877	88.60%	36	9.92%
滑	1005		13	107	0.01615%	586984	88.62%	34	9.37%
煙	1006		13	107	0.01615%	587091	88.64%	60	16.53%
移	1007		11	107	0.01615%	587198	88.65%	61	16.80%
衛	1008		15	107	0.01615%	587305	88.67%	52	14.33%
順	1009		12	107	0.01615%	587412	88.69%	67	18.46%
泥	1010		8	106	0.016%	587518	88.70%	48	13.22%
獻	1011		20	106	0.016%	587624	88.72%	67	18.46%
鮮	1012		17	106	0.016%	587730	88.73%	65	17.91%
鳥	1013		11	106	0.016%	587836	88.75%	49	13.50%
鼓	1014		13	106	0.016%	587942	88.77%	65	17.91%
偏	1015		11	105	0.01585%	588047	88.78%	61	16.80%
努	1016		7	105	0.01585%	588152	88.80%	68	18.73%
午	1017		4	105	0.01585%	588257	88.81%	67	18.46%
寂	1018		11	105	0.01585%	588362	88.83%	60	16.53%
搖	1019		13	105	0.01585%	588467	88.84%	67	18.46%
箱	1020		15	105	0.01585%	588572	88.86%	35	9.64%
訂	1021		9	105	0.01585%	588677	88.88%	51	14.05%
守	1022		6	104	0.0157%	588781	88.89%	65	17.91%
束	1023		7	104	0.0157%	588885	88.91%	64	17.63%
松	1024		8	104	0.0157%	588989	88.92%	34	9.37%
殊	1025		10	104	0.0157%	589093	88.94%	64	17.63%
熟	1026		15	104	0.0157%	589197	88.95%	58	15.98%
跳	1027		13	104	0.0157%	589301	88.97%	50	13.77%
週	1028		11	104	0.0157%	589405	88.99%	66	18.18%
亡	1029		3	103	0.01555%	589508	89.00%	44	12.12%
宣	1030		9	103	0.01555%	589611	89.02%	54	14.88%
溪	1031		13	103	0.01555%	589714	89.03%	24	6.61%
盤	1032		15	103	0.01555%	589817	89.05%	48	13.22%
私	1033		7	103	0.01555%	589920	89.06%	49	13.50%
索	1034		10	103	0.01555%	590023	89.08%	57	15.70%
俱	1035		10	102	0.0154%	590125	89.09%	41	11.29%
潮	1036		15	102	0.0154%	590227	89.11%	50	13.77%
劑	1037		16	101	0.01525%	590328	89.13%	25	6.89%
蒙	1038		14	101	0.01525%	590429	89.14%	38	10.47%
央	1039		5	100	0.0151%	590529	89.16%	59	16.25%
巧	1040		5	100	0.0151%	590629	89.17%	57	15.70%
幹	1041		13	100	0.0151%	590729	89.19%	56	15.43%
緣	1042		15	100	0.0151%	590829	89.20%	59	16.25%
靠	1043		15	100	0.0151%	590929	89.22%	61	16.80%
志	1044		7	99	0.01495%	591028	89.23%	66	18.18%
怪	1045		8	99	0.01495%	591127	89.25%	67	18.46%
濃	1046		16	99	0.01495%	591226	89.26%	60	16.53%
剛	1047		10	98	0.0148%	591324	89.28%	58	15.98%
孟	1048		8	98	0.0148%	591422	89.29%	24	6.61%
揮	1049		12	98	0.0148%	591520	89.31%	66	18.18%
梅	1050		11	98	0.0148%	591618	89.32%	34	9.37%
疑	1051		14	98	0.0148%	591716	89.34%	65	17.91%
賣	1052		15	98	0.0148%	591814	89.35%	53	14.60%
卵	1053		7	97	0.01464%	591911	89.36%	14	3.86%
懂	1054		17	97	0.01464%	592008	89.38%	49	13.50%
旅	1055		10	97	0.01464%	592105	89.39%	47	12.95%
鰭	1056		21	97	0.01464%	592202	89.41%	6	1.65%
擇	1057		16	96	0.01449%	592298	89.42%	62	17.08%
緩	1058		15	96	0.01449%	592394	89.44%	50	13.77%
弟	1059		7	95	0.01434%	592489	89.45%	34	9.37%
盆	1060		9	95	0.01434%	592584	89.47%	23	6.34%
齊	1061		14	95	0.01434%	592679	89.48%	56	15.43%
塔	1062		13	94	0.01419%	592773	89.49%	25	6.89%
折	1063		7	94	0.01419%	592867	89.51%	62	17.08%
殘	1064		12	94	0.01419%	592961	89.52%	53	14.60%
殺	1065		11	94	0.01419%	593055	89.54%	37	10.19%
紛	1066		10	94	0.01419%	593149	89.55%	42	11.57%
縣	1067		16	94	0.01419%	593243	89.57%	36	9.92%
駛	1068		15	94	0.01419%	593337	89.58%	25	6.89%
鬧	1069		15	94	0.01419%	593431	89.59%	58	15.98%
執	1070		11	93	0.01404%	593524	89.61%	52	14.33%
慣	1071		14	93	0.01404%	593617	89.62%	55	15.15%
拍	1072		8	93	0.01404%	593710	89.64%	41	11.29%
欲	1073		11	93	0.01404%	593803	89.65%	62	17.08%
誤	1074		14	93	0.01404%	593896	89.66%	44	12.12%
噸	1075		16	92	0.01389%	593988	89.68%	24	6.61%
寶	1076		20	92	0.01389%	594080	89.69%	57	15.70%
州	1077		6	92	0.01389%	594172	89.71%	45	12.40%
旋	1078		11	92	0.01389%	594264	89.72%	37	10.19%
紋	1079		10	92	0.01389%	594356	89.73%	27	7.44%
迷	1080		9	92	0.01389%	594448	89.75%	54	14.88%
鋼	1081		16	92	0.01389%	594540	89.76%	32	8.82%
鞋	1082		15	92	0.01389%	594632	89.78%	35	9.64%
奏	1083		9	91	0.01374%	594723	89.79%	34	9.37%
捕	1084		10	91	0.01374%	594814	89.80%	31	8.54%
武	1085		8	91	0.01374%	594905	89.82%	48	13.22%
滅	1086		13	91	0.01374%	594996	89.83%	55	15.15%
玉	1087		5	91	0.01374%	595087	89.84%	49	13.50%
童	1088		12	91	0.01374%	595178	89.86%	52	14.33%
谷	1089		7	91	0.01374%	595269	89.87%	28	7.71%
遺	1090		15	91	0.01374%	595360	89.89%	67	18.46%
寬	1091		15	90	0.01359%	595450	89.90%	52	14.33%
映	1092		9	90	0.01359%	595540	89.91%	53	14.60%
欣	1093		8	90	0.01359%	595630	89.93%	59	16.25%
毫	1094		11	90	0.01359%	595720	89.94%	63	17.36%
瞭	1095		17	90	0.01359%	595810	89.95%	51	14.05%
趕	1096		14	90	0.01359%	595900	89.97%	62	17.08%
骨	1097		10	90	0.01359%	595990	89.98%	52	14.33%
休	1098		6	89	0.01344%	596079	89.99%	54	14.88%
借	1099		10	89	0.01344%	596168	90.01%	49	13.50%
廳	1100		25	89	0.01344%	596257	90.02%	43	11.85%
沿	1101		8	89	0.01344%	596346	90.03%	51	14.05%
芳	1102		8	89	0.01344%	596435	90.05%	31	8.54%
荷	1103		11	89	0.01344%	596524	90.06%	26	7.16%
避	1104		16	89	0.01344%	596613	90.07%	64	17.63%
刺	1105		8	88	0.01329%	596701	90.09%	55	15.15%
劉	1106		15	88	0.01329%	596789	90.10%	25	6.89%
升	1107		4	88	0.01329%	596877	90.11%	53	14.60%
妙	1108		7	88	0.01329%	596965	90.13%	58	15.98%
幽	1109		9	88	0.01329%	597053	90.14%	49	13.50%
智	1110		12	88	0.01329%	597141	90.15%	52	14.33%
洗	1111		9	88	0.01329%	597229	90.17%	51	14.05%
糖	1112		16	88	0.01329%	597317	90.18%	30	8.26%
乏	1113		5	87	0.01313%	597404	90.19%	59	16.25%
培	1114		11	87	0.01313%	597491	90.21%	43	11.85%
桌	1115		10	87	0.01313%	597578	90.22%	45	12.40%
汽	1116		7	87	0.01313%	597665	90.23%	32	8.82%
睛	1117		13	87	0.01313%	597752	90.25%	55	15.15%
稍	1118		12	87	0.01313%	597839	90.26%	60	16.53%
耳	1119		6	87	0.01313%	597926	90.27%	55	15.15%
蓋	1120		14	87	0.01313%	598013	90.29%	63	17.36%
衝	1121		15	87	0.01313%	598100	90.30%	56	15.43%
衡	1122		16	87	0.01313%	598187	90.31%	26	7.16%
貓	1123		16	87	0.01313%	598274	90.33%	17	4.68%
陰	1124		10	87	0.01313%	598361	90.34%	52	14.33%
鳴	1125		14	87	0.01313%	598448	90.35%	45	12.40%
麥	1126		11	87	0.01313%	598535	90.36%	17	4.68%
傘	1127		12	86	0.01298%	598621	90.38%	21	5.79%
寄	1128		11	86	0.01298%	598707	90.39%	51	14.05%
封	1129		9	86	0.01298%	598793	90.40%	44	12.12%
射	1130		10	86	0.01298%	598879	90.42%	39	10.74%
控	1131		11	86	0.01298%	598965	90.43%	46	12.67%
燥	1132		17	86	0.01298%	599051	90.44%	21	5.79%
籍	1133		20	86	0.01298%	599137	90.46%	43	11.85%
納	1134		10	86	0.01298%	599223	90.47%	55	15.15%
翅	1135		10	86	0.01298%	599309	90.48%	25	6.89%
訪	1136		11	86	0.01298%	599395	90.49%	43	11.85%
降	1137		8	86	0.01298%	599481	90.51%	53	14.60%
儘	1138		16	85	0.01283%	599566	90.52%	65	17.91%
哭	1139		10	85	0.01283%	599651	90.53%	41	11.29%
掛	1140		11	85	0.01283%	599736	90.55%	50	13.77%
末	1141		5	85	0.01283%	599821	90.56%	61	16.80%
析	1142		8	85	0.01283%	599906	90.57%	47	12.95%
棄	1143		11	85	0.01283%	599991	90.58%	59	16.25%
浮	1144		10	85	0.01283%	600076	90.60%	51	14.05%
祖	1145		9	85	0.01283%	600161	90.61%	38	10.47%
粗	1146		11	85	0.01283%	600246	90.62%	46	12.67%
紫	1147		12	85	0.01283%	600331	90.64%	32	8.82%
縮	1148		17	85	0.01283%	600416	90.65%	49	13.50%
誠	1149		13	85	0.01283%	600501	90.66%	56	15.43%
凍	1150		10	84	0.01268%	600585	90.67%	25	6.89%
婦	1151		11	84	0.01268%	600669	90.69%	49	13.50%
尖	1152		6	84	0.01268%	600753	90.70%	45	12.40%
擁	1153		16	84	0.01268%	600837	90.71%	54	14.88%
敢	1154		12	84	0.01268%	600921	90.72%	60	16.53%
淚	1155		11	84	0.01268%	601005	90.74%	50	13.77%
競	1156		20	84	0.01268%	601089	90.75%	35	9.64%
虛	1157		12	84	0.01268%	601173	90.76%	58	15.98%
輔	1158		14	84	0.01268%	601257	90.78%	31	8.54%
遭	1159		14	84	0.01268%	601341	90.79%	57	15.70%
隱	1160		16	84	0.01268%	601425	90.80%	44	12.12%
兼	1161		10	83	0.01253%	601508	90.81%	58	15.98%
妻	1162		8	83	0.01253%	601591	90.83%	32	8.82%
忍	1163		7	83	0.01253%	601674	90.84%	51	14.05%
掉	1164		11	83	0.01253%	601757	90.85%	49	13.50%
秘	1165		10	83	0.01253%	601840	90.86%	56	15.43%
縱	1166		17	83	0.01253%	601923	90.88%	58	15.98%
膠	1167		15	83	0.01253%	602006	90.89%	30	8.26%
閃	1168		10	83	0.01253%	602089	90.90%	44	12.12%
壁	1169		16	82	0.01238%	602171	90.91%	38	10.47%
朵	1170		6	82	0.01238%	602253	90.93%	48	13.22%
涼	1171		11	82	0.01238%	602335	90.94%	38	10.47%
警	1172		20	82	0.01238%	602417	90.95%	41	11.29%
仰	1173		6	81	0.01223%	602498	90.96%	50	13.77%
弄	1174		7	81	0.01223%	602579	90.98%	56	15.43%
惜	1175		11	81	0.01223%	602660	90.99%	56	15.43%
村	1176		7	81	0.01223%	602741	91.00%	37	10.19%
謝	1177		17	81	0.01223%	602822	91.01%	51	14.05%
迎	1178		7	81	0.01223%	602903	91.02%	57	15.70%
釣	1179		11	81	0.01223%	602984	91.04%	16	4.41%
危	1180		6	80	0.01208%	603064	91.05%	51	14.05%
套	1181		10	80	0.01208%	603144	91.06%	54	14.88%
延	1182		8	80	0.01208%	603224	91.07%	57	15.70%
慮	1183		15	80	0.01208%	603304	91.08%	64	17.63%
染	1184		9	80	0.01208%	603384	91.10%	47	12.95%
漂	1185		14	80	0.01208%	603464	91.11%	32	8.82%
潔	1186		15	80	0.01208%	603544	91.12%	51	14.05%
蒼	1187		14	80	0.01208%	603624	91.13%	40	11.02%
賴	1188		16	80	0.01208%	603704	91.14%	47	12.95%
丘	1189		5	79	0.01193%	603783	91.16%	5	1.38%
京	1190		8	79	0.01193%	603862	91.17%	30	8.26%
巨	1191		5	79	0.01193%	603941	91.18%	51	14.05%
幫	1192		17	79	0.01193%	604020	91.19%	49	13.50%
庫	1193		10	79	0.01193%	604099	91.20%	28	7.71%
混	1194		11	79	0.01193%	604178	91.22%	48	13.22%
牆	1195		17	79	0.01193%	604257	91.23%	46	12.67%
薄	1196		17	79	0.01193%	604336	91.24%	47	12.95%
覆	1197		18	79	0.01193%	604415	91.25%	57	15.70%
豐	1198		18	79	0.01193%	604494	91.26%	55	15.15%
君	1199		7	78	0.01178%	604572	91.28%	46	12.67%
坡	1200		8	78	0.01178%	604650	91.29%	26	7.16%
招	1201		8	78	0.01178%	604728	91.30%	53	14.60%
抱	1202		8	78	0.01178%	604806	91.31%	57	15.70%
液	1203		11	78	0.01178%	604884	91.32%	24	6.61%
胡	1204		9	78	0.01178%	604962	91.33%	34	9.37%
舍	1205		8	78	0.01178%	605040	91.35%	28	7.71%
融	1206		16	78	0.01178%	605118	91.36%	28	7.71%
頃	1207		11	78	0.01178%	605196	91.37%	19	5.23%
顏	1208		18	78	0.01178%	605274	91.38%	45	12.40%
唯	1209		11	77	0.01163%	605351	91.39%	52	14.33%
橫	1210		16	77	0.01163%	605428	91.41%	48	13.22%
詳	1211		13	77	0.01163%	605505	91.42%	60	16.53%
距	1212		12	77	0.01163%	605582	91.43%	50	13.77%
傢	1213		12	76	0.01147%	605658	91.44%	14	3.86%
嘗	1214		14	76	0.01147%	605734	91.45%	50	13.77%
娃	1215		9	76	0.01147%	605810	91.46%	9	2.48%
戀	1216		23	76	0.01147%	605886	91.47%	40	11.02%
斜	1217		11	76	0.01147%	605962	91.49%	39	10.74%
暖	1218		13	76	0.01147%	606038	91.50%	43	11.85%
柔	1219		9	76	0.01147%	606114	91.51%	45	12.40%
災	1220		7	76	0.01147%	606190	91.52%	16	4.41%
窮	1221		15	76	0.01147%	606266	91.53%	45	12.40%
胃	1222		9	76	0.01147%	606342	91.54%	15	4.13%
鎮	1223		18	76	0.01147%	606418	91.55%	35	9.64%
隔	1224		12	76	0.01147%	606494	91.57%	54	14.88%
嘴	1225		15	75	0.01132%	606569	91.58%	50	13.77%
孤	1226		8	75	0.01132%	606644	91.59%	48	13.22%
彈	1227		15	75	0.01132%	606719	91.60%	35	9.64%
濕	1228		17	75	0.01132%	606794	91.61%	34	9.37%
米	1229		6	75	0.01132%	606869	91.62%	42	11.57%
紹	1230		11	75	0.01132%	606944	91.63%	41	11.29%
傾	1231		13	74	0.01117%	607018	91.65%	51	14.05%
刊	1232		5	74	0.01117%	607092	91.66%	40	11.02%
吹	1233		7	74	0.01117%	607166	91.67%	46	12.67%
妹	1234		8	74	0.01117%	607240	91.68%	18	4.96%
戴	1235		17	74	0.01117%	607314	91.69%	27	7.44%
敗	1236		11	74	0.01117%	607388	91.70%	52	14.33%
晨	1237		11	74	0.01117%	607462	91.71%	43	11.85%
瑪	1238		14	74	0.01117%	607536	91.72%	12	3.31%
番	1239		12	74	0.01117%	607610	91.73%	49	13.50%
肯	1240		8	74	0.01117%	607684	91.75%	48	13.22%
複	1241		14	74	0.01117%	607758	91.76%	44	12.12%
跑	1242		12	74	0.01117%	607832	91.77%	43	11.85%
郵	1243		11	74	0.01117%	607906	91.78%	8	2.20%
頓	1244		13	74	0.01117%	607980	91.79%	53	14.60%
判	1245		7	73	0.01102%	608053	91.80%	40	11.02%
吳	1246		7	73	0.01102%	608126	91.81%	22	6.06%
啟	1247		11	73	0.01102%	608199	91.82%	46	12.67%
患	1248		11	73	0.01102%	608272	91.83%	30	8.26%
旗	1249		14	73	0.01102%	608345	91.85%	27	7.44%
昂	1250		8	73	0.01102%	608418	91.86%	24	6.61%
珍	1251		9	73	0.01102%	608491	91.87%	49	13.50%
閒	1252		12	73	0.01102%	608564	91.88%	46	12.67%
偷	1253		11	72	0.01087%	608636	91.89%	31	8.54%
席	1254		10	72	0.01087%	608708	91.90%	44	12.12%
您	1255		11	72	0.01087%	608780	91.91%	15	4.13%
措	1256		11	72	0.01087%	608852	91.92%	31	8.54%
泡	1257		8	72	0.01087%	608924	91.93%	21	5.79%
琴	1258		12	72	0.01087%	608996	91.94%	28	7.71%
茶	1259		10	72	0.01087%	609068	91.95%	31	8.54%
觸	1260		20	72	0.01087%	609140	91.97%	53	14.60%
赤	1261		7	72	0.01087%	609212	91.98%	37	10.19%
鏡	1262		19	72	0.01087%	609284	91.99%	43	11.85%
韓	1263		17	72	0.01087%	609356	92.00%	12	3.31%
井	1264		4	71	0.01072%	609427	92.01%	24	6.61%
介	1265		4	71	0.01072%	609498	92.02%	51	14.05%
冰	1266		6	71	0.01072%	609569	92.03%	38	10.47%
堆	1267		11	71	0.01072%	609640	92.04%	46	12.67%
徑	1268		10	71	0.01072%	609711	92.05%	49	13.50%
株	1269		10	71	0.01072%	609782	92.06%	25	6.89%
溶	1270		13	71	0.01072%	609853	92.07%	25	6.89%
穩	1271		19	71	0.01072%	609924	92.08%	46	12.67%
股	1272		8	71	0.01072%	609995	92.09%	51	14.05%
醒	1273		16	71	0.01072%	610066	92.11%	49	13.50%
釋	1274		20	71	0.01072%	610137	92.12%	50	13.77%
霧	1275		19	71	0.01072%	610208	92.13%	30	8.26%
塑	1276		13	70	0.01057%	610278	92.14%	29	7.99%
幼	1277		5	70	0.01057%	610348	92.15%	42	11.57%
彼	1278		8	70	0.01057%	610418	92.16%	49	13.50%
悠	1279		11	70	0.01057%	610488	92.17%	42	11.57%
昨	1280		9	70	0.01057%	610558	92.18%	43	11.85%
森	1281		12	70	0.01057%	610628	92.19%	29	7.99%
漫	1282		14	70	0.01057%	610698	92.20%	50	13.77%
燒	1283		16	70	0.01057%	610768	92.21%	37	10.19%
甘	1284		5	70	0.01057%	610838	92.22%	44	12.12%
脈	1285		10	70	0.01057%	610908	92.23%	22	6.06%
蓮	1286		15	70	0.01057%	610978	92.24%	15	4.13%
返	1287		7	70	0.01057%	611048	92.25%	44	12.12%
醉	1288		15	70	0.01057%	611118	92.26%	40	11.02%
勵	1289		17	69	0.01042%	611187	92.27%	40	11.02%
幻	1290		4	69	0.01042%	611256	92.29%	44	12.12%
隆	1291		11	69	0.01042%	611325	92.30%	39	10.74%
偉	1292		11	68	0.01027%	611393	92.31%	43	11.85%
寞	1293		14	68	0.01027%	611461	92.32%	46	12.67%
廿	1294		4	68	0.01027%	611529	92.33%	40	11.02%
慶	1295		15	68	0.01027%	611597	92.34%	31	8.54%
抵	1296		8	68	0.01027%	611665	92.35%	43	11.85%
泉	1297		9	68	0.01027%	611733	92.36%	28	7.71%
疾	1298		10	68	0.01027%	611801	92.37%	35	9.64%
礎	1299		18	68	0.01027%	611869	92.38%	44	12.12%
禁	1300		13	68	0.01027%	611937	92.39%	44	12.12%
罐	1301		24	68	0.01027%	612005	92.40%	21	5.79%
胞	1302		9	68	0.01027%	612073	92.41%	26	7.16%
裂	1303		12	68	0.01027%	612141	92.42%	26	7.16%
錄	1304		16	68	0.01027%	612209	92.43%	44	12.12%
餐	1305		16	68	0.01027%	612277	92.44%	35	9.64%
伸	1306		7	67	0.01012%	612344	92.45%	49	13.50%
伯	1307		7	67	0.01012%	612411	92.46%	23	6.34%
億	1308		15	67	0.01012%	612478	92.47%	27	7.44%
喝	1309		12	67	0.01012%	612545	92.48%	32	8.82%
圈	1310		11	67	0.01012%	612612	92.49%	45	12.40%
拖	1311		8	67	0.01012%	612679	92.50%	36	9.92%
握	1312		12	67	0.01012%	612746	92.51%	45	12.40%
曼	1313		11	67	0.01012%	612813	92.52%	18	4.96%
椅	1314		12	67	0.01012%	612880	92.53%	25	6.89%
殼	1315		12	67	0.01012%	612947	92.54%	23	6.34%
濛	1316		17	67	0.01012%	613014	92.55%	14	3.86%
牛	1317		4	67	0.01012%	613081	92.56%	44	12.12%
輝	1318		15	67	0.01012%	613148	92.57%	44	12.12%
震	1319		15	67	0.01012%	613215	92.58%	32	8.82%
兵	1320		7	66	0.009964%	613281	92.59%	34	9.37%
獎	1321		15	66	0.009964%	613347	92.60%	32	8.82%
彷	1322		7	66	0.009964%	613413	92.61%	36	9.92%
忠	1323		8	66	0.009964%	613479	92.62%	34	9.37%
拜	1324		9	66	0.009964%	613545	92.63%	41	11.29%
粉	1325		10	66	0.009964%	613611	92.64%	35	9.64%
糊	1326		15	66	0.009964%	613677	92.65%	34	9.37%
翻	1327		18	66	0.009964%	613743	92.66%	48	13.22%
鮪	1328		17	66	0.009964%	613809	92.67%	8	2.20%
壯	1329		7	65	0.009813%	613874	92.68%	43	11.85%
彿	1330		8	65	0.009813%	613939	92.69%	36	9.92%
楚	1331		13	65	0.009813%	614004	92.70%	42	11.57%
爛	1332		21	65	0.009813%	614069	92.71%	47	12.95%
獅	1333		13	65	0.009813%	614134	92.72%	8	2.20%
硬	1334		12	65	0.009813%	614199	92.73%	44	12.12%
緒	1335		14	65	0.009813%	614264	92.74%	39	10.74%
胎	1336		9	65	0.009813%	614329	92.75%	14	3.86%
荒	1337		10	65	0.009813%	614394	92.76%	42	11.57%
蔬	1338		15	65	0.009813%	614459	92.77%	13	3.58%
蟲	1339		18	65	0.009813%	614524	92.78%	30	8.26%
誕	1340		15	65	0.009813%	614589	92.79%	29	7.99%
貧	1341		11	65	0.009813%	614654	92.80%	37	10.19%
乘	1342		10	64	0.009662%	614718	92.81%	48	13.22%
側	1343		11	64	0.009662%	614782	92.82%	30	8.26%
噴	1344		15	64	0.009662%	614846	92.83%	26	7.16%
憑	1345		16	64	0.009662%	614910	92.84%	47	12.95%
祝	1346		9	64	0.009662%	614974	92.85%	33	9.09%
舒	1347		12	64	0.009662%	615038	92.86%	45	12.40%
軟	1348		11	64	0.009662%	615102	92.87%	32	8.82%
丈	1349		3	63	0.009512%	615165	92.88%	29	7.99%
塞	1350		13	63	0.009512%	615228	92.88%	46	12.67%
塵	1351		14	63	0.009512%	615291	92.89%	36	9.92%
悉	1352		11	63	0.009512%	615354	92.90%	40	11.02%
振	1353		10	63	0.009512%	615417	92.91%	34	9.37%
描	1354		12	63	0.009512%	615480	92.92%	35	9.64%
牙	1355		4	63	0.009512%	615543	92.93%	34	9.37%
讚	1356		26	63	0.009512%	615606	92.94%	42	11.57%
貢	1357		10	63	0.009512%	615669	92.95%	41	11.29%
趨	1358		17	63	0.009512%	615732	92.96%	50	13.77%
跡	1359		13	63	0.009512%	615795	92.97%	51	14.05%
雅	1360		12	63	0.009512%	615858	92.98%	36	9.92%
顆	1361		17	63	0.009512%	615921	92.99%	37	10.19%
攻	1362		7	62	0.009361%	615983	93.00%	35	9.64%
爬	1363		8	62	0.009361%	616045	93.01%	33	9.09%
腹	1364		13	62	0.009361%	616107	93.02%	31	8.54%
菲	1365		12	62	0.009361%	616169	93.03%	27	7.44%
袋	1366		11	62	0.009361%	616231	93.04%	36	9.92%
辛	1367		7	62	0.009361%	616293	93.05%	40	11.02%
鑽	1368		27	62	0.009361%	616355	93.05%	24	6.61%
魂	1369		14	62	0.009361%	616417	93.06%	42	11.57%
儀	1370		15	61	0.00921%	616478	93.07%	33	9.09%
幕	1371		14	61	0.00921%	616539	93.08%	35	9.64%
悄	1372		10	61	0.00921%	616600	93.09%	26	7.16%
擬	1373		17	61	0.00921%	616661	93.10%	46	12.67%
籌	1374		20	61	0.00921%	616722	93.11%	32	8.82%
肥	1375		8	61	0.00921%	616783	93.12%	25	6.89%
蔗	1376		15	61	0.00921%	616844	93.13%	6	1.65%
閉	1377		11	61	0.00921%	616905	93.14%	42	11.57%
阻	1378		7	61	0.00921%	616966	93.15%	44	12.12%
陪	1379		10	61	0.00921%	617027	93.16%	35	9.64%
駐	1380		15	61	0.00921%	617088	93.17%	44	12.12%
伴	1381		7	60	0.009059%	617148	93.17%	42	11.57%
叔	1382		8	60	0.009059%	617208	93.18%	11	3.03%
呀	1383		7	60	0.009059%	617268	93.19%	37	10.19%
塘	1384		13	60	0.009059%	617328	93.20%	17	4.68%
尊	1385		12	60	0.009059%	617388	93.21%	38	10.47%
徒	1386		10	60	0.009059%	617448	93.22%	41	11.29%
怨	1387		9	60	0.009059%	617508	93.23%	29	7.99%
掌	1388		12	60	0.009059%	617568	93.24%	42	11.57%
斤	1389		4	60	0.009059%	617628	93.25%	14	3.86%
暴	1390		15	60	0.009059%	617688	93.26%	39	10.74%
杯	1391		8	60	0.009059%	617748	93.27%	28	7.71%
柳	1392		9	60	0.009059%	617808	93.27%	26	7.16%
煩	1393		13	60	0.009059%	617868	93.28%	45	12.40%
珠	1394		10	60	0.009059%	617928	93.29%	42	11.57%
祗	1395		9	60	0.009059%	617988	93.30%	30	8.26%
罪	1396		13	60	0.009059%	618048	93.31%	32	8.82%
貼	1397		12	60	0.009059%	618108	93.32%	33	9.09%
賽	1398		17	60	0.009059%	618168	93.33%	28	7.71%
辭	1399		19	60	0.009059%	618228	93.34%	35	9.64%
酸	1400		14	60	0.009059%	618288	93.35%	33	9.09%
針	1401		10	60	0.009059%	618348	93.36%	37	10.19%
凝	1402		16	59	0.008908%	618407	93.36%	35	9.64%
匯	1403		13	59	0.008908%	618466	93.37%	30	8.26%
哀	1404		9	59	0.008908%	618525	93.38%	38	10.47%
擺	1405		18	59	0.008908%	618584	93.39%	39	10.74%
旦	1406		5	59	0.008908%	618643	93.40%	35	9.64%
淨	1407		11	59	0.008908%	618702	93.41%	37	10.19%
潤	1408		15	59	0.008908%	618761	93.42%	30	8.26%
燃	1409		16	59	0.008908%	618820	93.43%	31	8.54%
瑞	1410		13	59	0.008908%	618879	93.44%	22	6.06%
績	1411		17	59	0.008908%	618938	93.44%	43	11.85%
蟬	1412		18	59	0.008908%	618997	93.45%	12	3.31%
譬	1413		20	59	0.008908%	619056	93.46%	32	8.82%
軸	1414		12	59	0.008908%	619115	93.47%	10	2.76%
倍	1415		10	58	0.008757%	619173	93.48%	37	10.19%
勇	1416		9	58	0.008757%	619231	93.49%	37	10.19%
匆	1417		5	58	0.008757%	619289	93.50%	30	8.26%
姑	1418		8	58	0.008757%	619347	93.51%	23	6.34%
幅	1419		12	58	0.008757%	619405	93.52%	32	8.82%
狂	1420		7	58	0.008757%	619463	93.52%	39	10.74%
玲	1421		9	58	0.008757%	619521	93.53%	19	5.23%
覽	1422		21	58	0.008757%	619579	93.54%	26	7.16%
豪	1423		14	58	0.008757%	619637	93.55%	36	9.92%
迫	1424		8	58	0.008757%	619695	93.56%	43	11.85%
遲	1425		15	58	0.008757%	619753	93.57%	37	10.19%
飲	1426		12	58	0.008757%	619811	93.58%	33	9.09%
刷	1427		8	57	0.008606%	619868	93.59%	22	6.06%
吾	1428		7	57	0.008606%	619925	93.59%	20	5.51%
哈	1429		9	57	0.008606%	619982	93.60%	29	7.99%
墨	1430		15	57	0.008606%	620039	93.61%	35	9.64%
序	1431		7	57	0.008606%	620096	93.62%	45	12.40%
恨	1432		9	57	0.008606%	620153	93.63%	35	9.64%
援	1433		12	57	0.008606%	620210	93.64%	30	8.26%
汁	1434		5	57	0.008606%	620267	93.65%	13	3.58%
璃	1435		15	57	0.008606%	620324	93.65%	33	9.09%
豈	1436		10	57	0.008606%	620381	93.66%	45	12.40%
迴	1437		9	57	0.008606%	620438	93.67%	38	10.47%
倦	1438		10	56	0.008455%	620494	93.68%	35	9.64%
呈	1439		7	56	0.008455%	620550	93.69%	29	7.99%
唐	1440		10	56	0.008455%	620606	93.70%	38	10.47%
奔	1441		8	56	0.008455%	620662	93.71%	42	11.57%
廢	1442		15	56	0.008455%	620718	93.71%	38	10.47%
憂	1443		15	56	0.008455%	620774	93.72%	36	9.92%
牌	1444		12	56	0.008455%	620830	93.73%	31	8.54%
犯	1445		5	56	0.008455%	620886	93.74%	34	9.37%
玻	1446		9	56	0.008455%	620942	93.75%	32	8.82%
鄰	1447		14	56	0.008455%	620998	93.76%	34	9.37%
陷	1448		10	56	0.008455%	621054	93.76%	43	11.85%
僑	1449		14	55	0.008304%	621109	93.77%	26	7.16%
屆	1450		8	55	0.008304%	621164	93.78%	32	8.82%
沖	1451		7	55	0.008304%	621219	93.79%	30	8.26%
游	1452		12	55	0.008304%	621274	93.80%	27	7.44%
烟	1453		10	55	0.008304%	621329	93.81%	17	4.68%
綜	1454		14	55	0.008304%	621384	93.81%	37	10.19%
繫	1455		19	55	0.008304%	621439	93.82%	39	10.74%
賓	1456		14	55	0.008304%	621494	93.83%	30	8.26%
逃	1457		9	55	0.008304%	621549	93.84%	36	9.92%
鼻	1458		14	55	0.008304%	621604	93.85%	39	10.74%
叢	1459		18	54	0.008153%	621658	93.86%	38	10.47%
奉	1460		8	54	0.008153%	621712	93.86%	43	11.85%
强	1461		12	54	0.008153%	621766	93.87%	24	6.61%
懸	1462		20	54	0.008153%	621820	93.88%	33	9.09%
猶	1463		12	54	0.008153%	621874	93.89%	43	11.85%
磨	1464		16	54	0.008153%	621928	93.90%	40	11.02%
秀	1465		7	54	0.008153%	621982	93.90%	42	11.57%
蓄	1466		14	54	0.008153%	622036	93.91%	31	8.54%
仙	1467		5	53	0.008002%	622089	93.92%	30	8.26%
剩	1468		12	53	0.008002%	622142	93.93%	39	10.74%
咬	1469		9	53	0.008002%	622195	93.94%	22	6.06%
哪	1470		10	53	0.008002%	622248	93.94%	28	7.71%
廉	1471		13	53	0.008002%	622301	93.95%	35	9.64%
昏	1472		8	53	0.008002%	622354	93.96%	45	12.40%
暑	1473		12	53	0.008002%	622407	93.97%	25	6.89%
洞	1474		9	53	0.008002%	622460	93.98%	35	9.64%
泰	1475		10	53	0.008002%	622513	93.98%	28	7.71%
溝	1476		13	53	0.008002%	622566	93.99%	28	7.71%
烏	1477		10	53	0.008002%	622619	94.00%	31	8.54%
牽	1478		11	53	0.008002%	622672	94.01%	38	10.47%
砂	1479		9	53	0.008002%	622725	94.02%	17	4.68%
繩	1480		19	53	0.008002%	622778	94.02%	16	4.41%
註	1481		12	53	0.008002%	622831	94.03%	19	5.23%
逝	1482		10	53	0.008002%	622884	94.04%	40	11.02%
雷	1483		13	53	0.008002%	622937	94.05%	24	6.61%
魯	1484		15	53	0.008002%	622990	94.06%	22	6.06%
丹	1485		4	52	0.007851%	623042	94.06%	26	7.16%
倡	1486		10	52	0.007851%	623094	94.07%	27	7.44%
偽	1487		11	52	0.007851%	623146	94.08%	22	6.06%
厭	1488		14	52	0.007851%	623198	94.09%	43	11.85%
妨	1489		7	52	0.007851%	623250	94.10%	42	11.57%
娘	1490		10	52	0.007851%	623302	94.10%	28	7.71%
嫌	1491		13	52	0.007851%	623354	94.11%	33	9.09%
宮	1492		10	52	0.007851%	623406	94.12%	31	8.54%
慕	1493		15	52	0.007851%	623458	94.13%	36	9.92%
槽	1494		15	52	0.007851%	623510	94.14%	7	1.93%
汪	1495		7	52	0.007851%	623562	94.14%	12	3.31%
碎	1496		13	52	0.007851%	623614	94.15%	42	11.57%
紐	1497		10	52	0.007851%	623666	94.16%	27	7.44%
累	1498		11	52	0.007851%	623718	94.17%	42	11.57%
胸	1499		10	52	0.007851%	623770	94.17%	38	10.47%
艇	1500		13	52	0.007851%	623822	94.18%	19	5.23%
茲	1501		10	52	0.007851%	623874	94.19%	38	10.47%
診	1502		12	52	0.007851%	623926	94.20%	11	3.03%
譽	1503		21	52	0.007851%	623978	94.21%	33	9.09%
鬆	1504		18	52	0.007851%	624030	94.21%	35	9.64%
吉	1505		6	51	0.0077%	624081	94.22%	22	6.06%
愉	1506		12	51	0.0077%	624132	94.23%	33	9.09%
慈	1507		13	51	0.0077%	624183	94.24%	31	8.54%
愁	1508		13	51	0.0077%	624234	94.24%	31	8.54%
抑	1509		7	51	0.0077%	624285	94.25%	30	8.26%
摸	1510		14	51	0.0077%	624336	94.26%	35	9.64%
敏	1511		11	51	0.0077%	624387	94.27%	27	7.44%
桐	1512		10	51	0.0077%	624438	94.28%	12	3.31%
污	1513		6	51	0.0077%	624489	94.28%	26	7.16%
繞	1514		18	51	0.0077%	624540	94.29%	33	9.09%
耐	1515		9	51	0.0077%	624591	94.30%	38	10.47%
聚	1516		14	51	0.0077%	624642	94.31%	29	7.99%
肌	1517		6	51	0.0077%	624693	94.31%	10	2.76%
蕩	1518		16	51	0.0077%	624744	94.32%	34	9.37%
衰	1519		10	51	0.0077%	624795	94.33%	29	7.99%
襲	1520		22	51	0.0077%	624846	94.34%	34	9.37%
赴	1521		9	51	0.0077%	624897	94.34%	37	10.19%
障	1522		13	51	0.0077%	624948	94.35%	38	10.47%
塗	1523		13	50	0.007549%	624998	94.36%	30	8.26%
審	1524		15	50	0.007549%	625048	94.37%	30	8.26%
擠	1525		17	50	0.007549%	625098	94.37%	34	9.37%
淑	1526		11	50	0.007549%	625148	94.38%	8	2.20%
炎	1527		8	50	0.007549%	625198	94.39%	22	6.06%
眠	1528		10	50	0.007549%	625248	94.40%	23	6.34%
緻	1529		15	50	0.007549%	625298	94.41%	33	9.09%
茫	1530		10	50	0.007549%	625348	94.41%	33	9.09%
郎	1531		8	50	0.007549%	625398	94.42%	21	5.79%
削	1532		9	49	0.007398%	625447	94.43%	21	5.79%
垂	1533		9	49	0.007398%	625496	94.44%	36	9.92%
夾	1534		7	49	0.007398%	625545	94.44%	31	8.54%
姊	1535		8	49	0.007398%	625594	94.45%	12	3.31%
寸	1536		3	49	0.007398%	625643	94.46%	30	8.26%
慧	1537		15	49	0.007398%	625692	94.46%	29	7.99%
桃	1538		10	49	0.007398%	625741	94.47%	34	9.37%
氧	1539		10	49	0.007398%	625790	94.48%	12	3.31%
泛	1540		8	49	0.007398%	625839	94.49%	34	9.37%
滴	1541		14	49	0.007398%	625888	94.49%	25	6.89%
皇	1542		9	49	0.007398%	625937	94.50%	32	8.82%
碼	1543		15	49	0.007398%	625986	94.51%	27	7.44%
菊	1544		12	49	0.007398%	626035	94.52%	12	3.31%
謀	1545		16	49	0.007398%	626084	94.52%	34	9.37%
丁	1546		2	48	0.007247%	626132	94.53%	29	7.99%
儲	1547		17	48	0.007247%	626180	94.54%	25	6.89%
冒	1548		9	48	0.007247%	626228	94.55%	38	10.47%
宇	1549		6	48	0.007247%	626276	94.55%	31	8.54%
彎	1550		22	48	0.007247%	626324	94.56%	27	7.44%
柱	1551		9	48	0.007247%	626372	94.57%	20	5.51%
沫	1552		8	48	0.007247%	626420	94.57%	6	1.65%
繪	1553		19	48	0.007247%	626468	94.58%	19	5.23%
耕	1554		10	48	0.007247%	626516	94.59%	15	4.13%
臟	1555		22	48	0.007247%	626564	94.60%	22	6.06%
豆	1556		7	48	0.007247%	626612	94.60%	27	7.44%
踐	1557		15	48	0.007247%	626660	94.61%	14	3.86%
闊	1558		17	48	0.007247%	626708	94.62%	36	9.92%
兄	1559		5	47	0.007096%	626755	94.63%	29	7.99%
喊	1560		12	47	0.007096%	626802	94.63%	25	6.89%
嘆	1561		14	47	0.007096%	626849	94.64%	31	8.54%
寺	1562		6	47	0.007096%	626896	94.65%	11	3.03%
慰	1563		15	47	0.007096%	626943	94.65%	35	9.64%
懼	1564		21	47	0.007096%	626990	94.66%	31	8.54%
捐	1565		10	47	0.007096%	627037	94.67%	15	4.13%
敬	1566		13	47	0.007096%	627084	94.67%	36	9.92%
梯	1567		11	47	0.007096%	627131	94.68%	17	4.68%
瓶	1568		11	47	0.007096%	627178	94.69%	29	7.99%
疏	1569		11	47	0.007096%	627225	94.70%	37	10.19%
粹	1570		14	47	0.007096%	627272	94.70%	22	6.06%
縫	1571		17	47	0.007096%	627319	94.71%	32	8.82%
莊	1572		11	47	0.007096%	627366	94.72%	33	9.09%
輛	1573		15	47	0.007096%	627413	94.72%	19	5.23%
迅	1574		6	47	0.007096%	627460	94.73%	34	9.37%
錨	1575		17	47	0.007096%	627507	94.74%	8	2.20%
侵	1576		9	46	0.006945%	627553	94.75%	28	7.71%
嘉	1577		14	46	0.006945%	627599	94.75%	18	4.96%
埋	1578		10	46	0.006945%	627645	94.76%	34	9.37%
姿	1579		9	46	0.006945%	627691	94.77%	32	8.82%
崇	1580		11	46	0.006945%	627737	94.77%	33	9.09%
托	1581		6	46	0.006945%	627783	94.78%	33	9.09%
插	1582		12	46	0.006945%	627829	94.79%	29	7.99%
擾	1583		18	46	0.006945%	627875	94.79%	36	9.92%
攝	1584		21	46	0.006945%	627921	94.80%	25	6.89%
敵	1585		15	46	0.006945%	627967	94.81%	31	8.54%
滋	1586		12	46	0.006945%	628013	94.82%	38	10.47%
濤	1587		17	46	0.006945%	628059	94.82%	20	5.51%
票	1588		11	46	0.006945%	628105	94.83%	25	6.89%
稻	1589		15	46	0.006945%	628151	94.84%	13	3.58%
絡	1590		12	46	0.006945%	628197	94.84%	24	6.61%
罷	1591		15	46	0.006945%	628243	94.85%	36	9.92%
舅	1592		13	46	0.006945%	628289	94.86%	3	0.83%
艘	1593		15	46	0.006945%	628335	94.86%	17	4.68%
亭	1594		9	45	0.006794%	628380	94.87%	17	4.68%
准	1595		10	45	0.006794%	628425	94.88%	32	8.82%
剝	1596		10	45	0.006794%	628470	94.88%	19	5.23%
召	1597		5	45	0.006794%	628515	94.89%	30	8.26%
呵	1598		8	45	0.006794%	628560	94.90%	22	6.06%
埃	1599		10	45	0.006794%	628605	94.90%	13	3.58%
奧	1600		13	45	0.006794%	628650	94.91%	28	7.71%
幣	1601		14	45	0.006794%	628695	94.92%	26	7.16%
摩	1602		15	45	0.006794%	628740	94.92%	27	7.44%
暫	1603		15	45	0.006794%	628785	94.93%	37	10.19%
曉	1604		16	45	0.006794%	628830	94.94%	31	8.54%
毀	1605		13	45	0.006794%	628875	94.95%	24	6.61%
浸	1606		10	45	0.006794%	628920	94.95%	28	7.71%
涉	1607		10	45	0.006794%	628965	94.96%	30	8.26%
潛	1608		15	45	0.006794%	629010	94.97%	31	8.54%
申	1609		5	45	0.006794%	629055	94.97%	22	6.06%
籠	1610		22	45	0.006794%	629100	94.98%	30	8.26%
羽	1611		6	45	0.006794%	629145	94.99%	14	3.86%
裸	1612		13	45	0.006794%	629190	94.99%	13	3.58%
轆	1613		18	45	0.006794%	629235	95.00%	2	0.55%
轤	1614		23	45	0.006794%	629280	95.01%	2	0.55%
邀	1615		16	45	0.006794%	629325	95.01%	32	8.82%
哩	1616		10	44	0.006643%	629369	95.02%	24	6.61%
堪	1617		12	44	0.006643%	629413	95.03%	36	9.92%
悟	1618		10	44	0.006643%	629457	95.03%	28	7.71%
敲	1619		14	44	0.006643%	629501	95.04%	27	7.44%
朗	1620		10	44	0.006643%	629545	95.05%	31	8.54%
疲	1621		10	44	0.006643%	629589	95.05%	30	8.26%
符	1622		11	44	0.006643%	629633	95.06%	33	9.09%
聊	1623		11	44	0.006643%	629677	95.07%	34	9.37%
蕉	1624		16	44	0.006643%	629721	95.07%	18	4.96%
褐	1625		14	44	0.006643%	629765	95.08%	12	3.31%
輩	1626		15	44	0.006643%	629809	95.09%	32	8.82%
遜	1627		13	44	0.006643%	629853	95.09%	20	5.51%
倘	1628		10	43	0.006492%	629896	95.10%	27	7.44%
勘	1629		11	43	0.006492%	629939	95.11%	2	0.55%
姆	1630		8	43	0.006492%	629982	95.11%	20	5.51%
徐	1631		10	43	0.006492%	630025	95.12%	20	5.51%
戶	1632		4	43	0.006492%	630068	95.13%	27	7.44%
搬	1633		13	43	0.006492%	630111	95.13%	29	7.99%
渡	1634		12	43	0.006492%	630154	95.14%	27	7.44%
甜	1635		11	43	0.006492%	630197	95.14%	26	7.16%
甲	1636		5	43	0.006492%	630240	95.15%	30	8.26%
瘦	1637		14	43	0.006492%	630283	95.16%	26	7.16%
碧	1638		14	43	0.006492%	630326	95.16%	30	8.26%
罵	1639		15	43	0.006492%	630369	95.17%	23	6.34%
腸	1640		13	43	0.006492%	630412	95.18%	18	4.96%
蒸	1641		14	43	0.006492%	630455	95.18%	17	4.68%
賊	1642		13	43	0.006492%	630498	95.19%	11	3.03%
醬	1643		18	43	0.006492%	630541	95.20%	8	2.20%
雞	1644		18	43	0.006492%	630584	95.20%	32	8.82%
鬱	1645		29	43	0.006492%	630627	95.21%	30	8.26%
夕	1646		3	42	0.006341%	630669	95.22%	37	10.19%
嶺	1647		17	42	0.006341%	630711	95.22%	12	3.31%
悅	1648		10	42	0.006341%	630753	95.23%	29	7.99%
播	1649		15	42	0.006341%	630795	95.24%	26	7.16%
敘	1650		11	42	0.006341%	630837	95.24%	22	6.06%
曰	1651		4	42	0.006341%	630879	95.25%	19	5.23%
洽	1652		9	42	0.006341%	630921	95.25%	17	4.68%
賢	1653		15	42	0.006341%	630963	95.26%	25	6.89%
吐	1654		6	41	0.00619%	631004	95.27%	28	7.71%
壽	1655		14	41	0.00619%	631045	95.27%	26	7.16%
挑	1656		9	41	0.00619%	631086	95.28%	29	7.99%
灘	1657		22	41	0.00619%	631127	95.29%	17	4.68%
羊	1658		6	41	0.00619%	631168	95.29%	25	6.89%
贊	1659		19	41	0.00619%	631209	95.30%	32	8.82%
踏	1660		15	41	0.00619%	631250	95.30%	32	8.82%
遷	1661		14	41	0.00619%	631291	95.31%	30	8.26%
飽	1662		13	41	0.00619%	631332	95.32%	32	8.82%
鱗	1663		23	41	0.00619%	631373	95.32%	11	3.03%
伊	1664		6	40	0.006039%	631413	95.33%	23	6.34%
估	1665		7	40	0.006039%	631453	95.33%	33	9.09%
勒	1666		11	40	0.006039%	631493	95.34%	20	5.51%
坦	1667		8	40	0.006039%	631533	95.35%	30	8.26%
宿	1668		11	40	0.006039%	631573	95.35%	26	7.16%
撲	1669		15	40	0.006039%	631613	95.36%	22	6.06%
枯	1670		9	40	0.006039%	631653	95.36%	33	9.09%
械	1671		11	40	0.006039%	631693	95.37%	29	7.99%
稀	1672		12	40	0.006039%	631733	95.38%	32	8.82%
纖	1673		23	40	0.006039%	631773	95.38%	23	6.34%
署	1674		13	40	0.006039%	631813	95.39%	15	4.13%
逸	1675		11	40	0.006039%	631853	95.39%	25	6.89%
閱	1676		15	40	0.006039%	631893	95.40%	21	5.79%
駕	1677		15	40	0.006039%	631933	95.41%	22	6.06%
齡	1678		20	40	0.006039%	631973	95.41%	30	8.26%
云	1679		4	39	0.005888%	632012	95.42%	25	6.89%
仔	1680		5	39	0.005888%	632051	95.42%	26	7.16%
冊	1681		5	39	0.005888%	632090	95.43%	25	6.89%
孫	1682		10	39	0.005888%	632129	95.44%	23	6.34%
廚	1683		15	39	0.005888%	632168	95.44%	26	7.16%
戒	1684		7	39	0.005888%	632207	95.45%	20	5.51%
暢	1685		14	39	0.005888%	632246	95.45%	28	7.71%
滾	1686		14	39	0.005888%	632285	95.46%	26	7.16%
紗	1687		10	39	0.005888%	632324	95.47%	25	6.89%
胖	1688		9	39	0.005888%	632363	95.47%	20	5.51%
膽	1689		17	39	0.005888%	632402	95.48%	27	7.44%
舖	1690		15	39	0.005888%	632441	95.48%	28	7.71%
艦	1691		20	39	0.005888%	632480	95.49%	9	2.48%
蜜	1692		14	39	0.005888%	632519	95.50%	23	6.34%
貌	1693		14	39	0.005888%	632558	95.50%	33	9.09%
銅	1694		14	39	0.005888%	632597	95.51%	25	6.89%
伏	1695		6	38	0.005737%	632635	95.51%	32	8.82%
伶	1696		7	38	0.005737%	632673	95.52%	6	1.65%
匹	1697		4	38	0.005737%	632711	95.52%	16	4.41%
宋	1698		7	38	0.005737%	632749	95.53%	23	6.34%
宙	1699		8	38	0.005737%	632787	95.54%	22	6.06%
峰	1700		10	38	0.005737%	632825	95.54%	18	4.96%
廟	1701		15	38	0.005737%	632863	95.55%	19	5.23%
怒	1702		9	38	0.005737%	632901	95.55%	25	6.89%
拒	1703		8	38	0.005737%	632939	95.56%	29	7.99%
柏	1704		9	38	0.005737%	632977	95.56%	30	8.26%
棉	1705		12	38	0.005737%	633015	95.57%	20	5.51%
湯	1706		12	38	0.005737%	633053	95.58%	19	5.23%
滲	1707		14	38	0.005737%	633091	95.58%	24	6.61%
爐	1708		20	38	0.005737%	633129	95.59%	19	5.23%
盪	1709		17	38	0.005737%	633167	95.59%	22	6.06%
祇	1710		8	38	0.005737%	633205	95.60%	18	4.96%
筋	1711		12	38	0.005737%	633243	95.60%	16	4.41%
罰	1712		14	38	0.005737%	633281	95.61%	15	4.13%
臘	1713		19	38	0.005737%	633319	95.62%	20	5.51%
譯	1714		20	38	0.005737%	633357	95.62%	26	7.16%
辨	1715		16	38	0.005737%	633395	95.63%	26	7.16%
逢	1716		10	38	0.005737%	633433	95.63%	30	8.26%
遮	1717		14	38	0.005737%	633471	95.64%	25	6.89%
釘	1718		10	38	0.005737%	633509	95.64%	18	4.96%
鈎	1719		12	38	0.005737%	633547	95.65%	6	1.65%
噪	1720		16	37	0.005586%	633584	95.66%	5	1.38%
扣	1721		6	37	0.005586%	633621	95.66%	25	6.89%
披	1722		8	37	0.005586%	633658	95.67%	17	4.68%
泊	1723		8	37	0.005586%	633695	95.67%	22	6.06%
獸	1724		19	37	0.005586%	633732	95.68%	22	6.06%
瑙	1725		13	37	0.005586%	633769	95.68%	4	1.10%
監	1726		14	37	0.005586%	633806	95.69%	21	5.79%
盾	1727		9	37	0.005586%	633843	95.70%	18	4.96%
碗	1728		13	37	0.005586%	633880	95.70%	21	5.79%
礙	1729		19	37	0.005586%	633917	95.71%	29	7.99%
礦	1730		20	37	0.005586%	633954	95.71%	10	2.76%
祥	1731		10	37	0.005586%	633991	95.72%	22	6.06%
筍	1732		12	37	0.005586%	634028	95.72%	4	1.10%
腐	1733		14	37	0.005586%	634065	95.73%	26	7.16%
腿	1734		14	37	0.005586%	634102	95.73%	22	6.06%
蕭	1735		16	37	0.005586%	634139	95.74%	20	5.51%
虎	1736		8	37	0.005586%	634176	95.75%	25	6.89%
詢	1737		13	37	0.005586%	634213	95.75%	19	5.23%
韻	1738		19	37	0.005586%	634250	95.76%	21	5.79%
齒	1739		15	37	0.005586%	634287	95.76%	26	7.16%
啦	1740		11	36	0.005435%	634323	95.77%	18	4.96%
啡	1741		11	36	0.005435%	634359	95.77%	17	4.68%
喻	1742		12	36	0.005435%	634395	95.78%	24	6.61%
宅	1743		6	36	0.005435%	634431	95.78%	19	5.23%
恰	1744		9	36	0.005435%	634467	95.79%	29	7.99%
慾	1745		15	36	0.005435%	634503	95.79%	20	5.51%
捉	1746		10	36	0.005435%	634539	95.80%	22	6.06%
撥	1747		15	36	0.005435%	634575	95.81%	22	6.06%
棵	1748		12	36	0.005435%	634611	95.81%	19	5.23%
澤	1749		16	36	0.005435%	634647	95.82%	26	7.16%
煮	1750		12	36	0.005435%	634683	95.82%	17	4.68%
瓦	1751		5	36	0.005435%	634719	95.83%	27	7.44%
粒	1752		11	36	0.005435%	634755	95.83%	24	6.61%
舟	1753		6	36	0.005435%	634791	95.84%	20	5.51%
衫	1754		8	36	0.005435%	634827	95.84%	17	4.68%
訊	1755		10	36	0.005435%	634863	95.85%	21	5.79%
誼	1756		15	36	0.005435%	634899	95.85%	20	5.51%
貫	1757		11	36	0.005435%	634935	95.86%	32	8.82%
躍	1758		21	36	0.005435%	634971	95.87%	25	6.89%
軌	1759		9	36	0.005435%	635007	95.87%	16	4.41%
輯	1760		16	36	0.005435%	635043	95.88%	18	4.96%
飼	1761		13	36	0.005435%	635079	95.88%	7	1.93%
騰	1762		20	36	0.005435%	635115	95.89%	24	6.61%
冠	1763		9	35	0.005284%	635150	95.89%	23	6.34%
奈	1764		8	35	0.005284%	635185	95.90%	26	7.16%
奶	1765		5	35	0.005284%	635220	95.90%	20	5.51%
婆	1766		11	35	0.005284%	635255	95.91%	21	5.79%
恢	1767		9	35	0.005284%	635290	95.91%	27	7.44%
慎	1768		13	35	0.005284%	635325	95.92%	28	7.71%
扇	1769		10	35	0.005284%	635360	95.92%	21	5.79%
柯	1770		9	35	0.005284%	635395	95.93%	14	3.86%
碰	1771		13	35	0.005284%	635430	95.93%	24	6.61%
稿	1772		15	35	0.005284%	635465	95.94%	25	6.89%
綴	1773		14	35	0.005284%	635500	95.95%	27	7.44%
翼	1774		17	35	0.005284%	635535	95.95%	24	6.61%
脆	1775		10	35	0.005284%	635570	95.96%	30	8.26%
謬	1776		18	35	0.005284%	635605	95.96%	16	4.41%
違	1777		12	35	0.005284%	635640	95.97%	25	6.89%
頁	1778		9	35	0.005284%	635675	95.97%	27	7.44%
驅	1779		21	35	0.005284%	635710	95.98%	26	7.16%
佩	1780		8	34	0.005133%	635744	95.98%	26	7.16%
喪	1781		12	34	0.005133%	635778	95.99%	25	6.89%
妥	1782		7	34	0.005133%	635812	95.99%	28	7.71%
姐	1783		8	34	0.005133%	635846	96.00%	22	6.06%
廊	1784		12	34	0.005133%	635880	96.00%	22	6.06%
憐	1785		15	34	0.005133%	635914	96.01%	25	6.89%
撤	1786		14	34	0.005133%	635948	96.01%	19	5.23%
柴	1787		10	34	0.005133%	635982	96.02%	21	5.79%
棲	1788		12	34	0.005133%	636016	96.02%	13	3.58%
湧	1789		12	34	0.005133%	636050	96.03%	27	7.44%
濱	1790		17	34	0.005133%	636084	96.03%	18	4.96%
炸	1791		9	34	0.005133%	636118	96.04%	21	5.79%
耶	1792		9	34	0.005133%	636152	96.04%	17	4.68%
肝	1793		7	34	0.005133%	636186	96.05%	16	4.41%
肚	1794		7	34	0.005133%	636220	96.05%	27	7.44%
膜	1795		15	34	0.005133%	636254	96.06%	12	3.31%
虧	1796		17	34	0.005133%	636288	96.06%	26	7.16%
郊	1797		8	34	0.005133%	636322	96.07%	20	5.51%
龐	1798		19	34	0.005133%	636356	96.07%	18	4.96%
串	1799		7	33	0.004982%	636389	96.08%	22	6.06%
劣	1800		6	33	0.004982%	636422	96.08%	26	7.16%
坯	1801		8	33	0.004982%	636455	96.09%	1	0.28%
弊	1802		14	33	0.004982%	636488	96.09%	19	5.23%
惑	1803		12	33	0.004982%	636521	96.10%	27	7.44%
慘	1804		14	33	0.004982%	636554	96.10%	25	6.89%
憤	1805		15	33	0.004982%	636587	96.11%	22	6.06%
懶	1806		19	33	0.004982%	636620	96.11%	25	6.89%
捧	1807		11	33	0.004982%	636653	96.12%	22	6.06%
捨	1808		11	33	0.004982%	636686	96.12%	29	7.99%
摘	1809		14	33	0.004982%	636719	96.13%	26	7.16%
泣	1810		8	33	0.004982%	636752	96.13%	24	6.61%
涯	1811		11	33	0.004982%	636785	96.14%	20	5.51%
燦	1812		17	33	0.004982%	636818	96.14%	25	6.89%
狹	1813		10	33	0.004982%	636851	96.15%	28	7.71%
督	1814		13	33	0.004982%	636884	96.15%	18	4.96%
翠	1815		14	33	0.004982%	636917	96.16%	19	5.23%
肅	1816		12	33	0.004982%	636950	96.16%	25	6.89%
腰	1817		13	33	0.004982%	636983	96.17%	20	5.51%
艾	1818		6	33	0.004982%	637016	96.17%	17	4.68%
裁	1819		12	33	0.004982%	637049	96.18%	19	5.23%
誌	1820		14	33	0.004982%	637082	96.18%	23	6.34%
躲	1821		13	33	0.004982%	637115	96.19%	24	6.61%
醜	1822		17	33	0.004982%	637148	96.19%	22	6.06%
馳	1823		13	33	0.004982%	637181	96.20%	27	7.44%
傑	1824		12	32	0.004831%	637213	96.20%	22	6.06%
勉	1825		9	32	0.004831%	637245	96.21%	28	7.71%
卅	1826		4	32	0.004831%	637277	96.21%	24	6.61%
喚	1827		12	32	0.004831%	637309	96.22%	23	6.34%
尿	1828		7	32	0.004831%	637341	96.22%	9	2.48%
惱	1829		12	32	0.004831%	637373	96.23%	25	6.89%
愚	1830		13	32	0.004831%	637405	96.23%	25	6.89%
抓	1831		7	32	0.004831%	637437	96.24%	24	6.61%
掩	1832		11	32	0.004831%	637469	96.24%	28	7.71%
掙	1833		11	32	0.004831%	637501	96.25%	23	6.34%
擦	1834		17	32	0.004831%	637533	96.25%	24	6.61%
灌	1835		21	32	0.004831%	637565	96.26%	15	4.13%
爆	1836		19	32	0.004831%	637597	96.26%	19	5.23%
罩	1837		13	32	0.004831%	637629	96.27%	22	6.06%
耀	1838		20	32	0.004831%	637661	96.27%	22	6.06%
腺	1839		13	32	0.004831%	637693	96.28%	6	1.65%
蝦	1840		15	32	0.004831%	637725	96.28%	14	3.86%
辯	1841		21	32	0.004831%	637757	96.29%	21	5.79%
勤	1842		13	31	0.00468%	637788	96.29%	23	6.34%
咖	1843		8	31	0.00468%	637819	96.30%	17	4.68%
孝	1844		7	31	0.00468%	637850	96.30%	18	4.96%
彙	1845		13	31	0.00468%	637881	96.30%	13	3.58%
悔	1846		10	31	0.00468%	637912	96.31%	21	5.79%
悶	1847		12	31	0.00468%	637943	96.31%	26	7.16%
拓	1848		8	31	0.00468%	637974	96.32%	23	6.34%
挺	1849		10	31	0.00468%	638005	96.32%	22	6.06%
桂	1850		10	31	0.00468%	638036	96.33%	13	3.58%
楓	1851		13	31	0.00468%	638067	96.33%	6	1.65%
氛	1852		8	31	0.00468%	638098	96.34%	20	5.51%
爺	1853		13	31	0.00468%	638129	96.34%	13	3.58%
玄	1854		5	31	0.00468%	638160	96.35%	21	5.79%
瑰	1855		14	31	0.00468%	638191	96.35%	18	4.96%
璐	1856		17	31	0.00468%	638222	96.36%	3	0.83%
瓊	1857		19	31	0.00468%	638253	96.36%	7	1.93%
眉	1858		9	31	0.00468%	638284	96.37%	23	6.34%
糧	1859		18	31	0.00468%	638315	96.37%	19	5.23%
紡	1860		10	31	0.00468%	638346	96.38%	16	4.41%
膚	1861		15	31	0.00468%	638377	96.38%	23	6.34%
芝	1862		8	31	0.00468%	638408	96.38%	10	2.76%
遂	1863		12	31	0.00468%	638439	96.39%	22	6.06%
遙	1864		13	31	0.00468%	638470	96.39%	25	6.89%
鳳	1865		14	31	0.00468%	638501	96.40%	21	5.79%
傲	1866		13	30	0.004529%	638531	96.40%	25	6.89%
双	1867		6	30	0.004529%	638561	96.41%	10	2.76%
吵	1868		7	30	0.004529%	638591	96.41%	18	4.96%
唇	1869		10	30	0.004529%	638621	96.42%	19	5.23%
填	1870		13	30	0.004529%	638651	96.42%	18	4.96%
恒	1871		9	30	0.004529%	638681	96.43%	21	5.79%
恥	1872		10	30	0.004529%	638711	96.43%	16	4.41%
懋	1873		17	30	0.004529%	638741	96.43%	3	0.83%
拋	1874		8	30	0.004529%	638771	96.44%	24	6.61%
掘	1875		11	30	0.004529%	638801	96.44%	19	5.23%
棒	1876		12	30	0.004529%	638831	96.45%	6	1.65%
槍	1877		14	30	0.004529%	638861	96.45%	18	4.96%
汗	1878		6	30	0.004529%	638891	96.46%	25	6.89%
淋	1879		11	30	0.004529%	638921	96.46%	19	5.23%
滯	1880		14	30	0.004529%	638951	96.47%	19	5.23%
澈	1881		14	30	0.004529%	638981	96.47%	24	6.61%
盒	1882		11	30	0.004529%	639011	96.48%	14	3.86%
箭	1883		15	30	0.004529%	639041	96.48%	13	3.58%
簾	1884		19	30	0.004529%	639071	96.48%	16	4.41%
臥	1885		8	30	0.004529%	639101	96.49%	23	6.34%
艱	1886		17	30	0.004529%	639131	96.49%	23	6.34%
蛋	1887		11	30	0.004529%	639161	96.50%	15	4.13%
裙	1888		12	30	0.004529%	639191	96.50%	16	4.41%
襯	1889		21	30	0.004529%	639221	96.51%	21	5.79%
託	1890		10	30	0.004529%	639251	96.51%	20	5.51%
詹	1891		13	30	0.004529%	639281	96.52%	10	2.76%
謹	1892		18	30	0.004529%	639311	96.52%	24	6.61%
迄	1893		6	30	0.004529%	639341	96.53%	27	7.44%
逼	1894		12	30	0.004529%	639371	96.53%	22	6.06%
鼠	1895		13	30	0.004529%	639401	96.53%	10	2.76%
丟	1896		6	29	0.004378%	639430	96.54%	22	6.06%
傻	1897		13	29	0.004378%	639459	96.54%	14	3.86%
剖	1898		10	29	0.004378%	639488	96.55%	15	4.13%
勃	1899		9	29	0.004378%	639517	96.55%	18	4.96%
喧	1900		12	29	0.004378%	639546	96.56%	13	3.58%
奪	1901		14	29	0.004378%	639575	96.56%	24	6.61%
姓	1902		8	29	0.004378%	639604	96.56%	20	5.51%
寓	1903		12	29	0.004378%	639633	96.57%	17	4.68%
帽	1904		12	29	0.004378%	639662	96.57%	15	4.13%
彬	1905		11	29	0.004378%	639691	96.58%	3	0.83%
循	1906		12	29	0.004378%	639720	96.58%	26	7.16%
扎	1907		4	29	0.004378%	639749	96.59%	21	5.79%
掃	1908		11	29	0.004378%	639778	96.59%	24	6.61%
搜	1909		12	29	0.004378%	639807	96.60%	19	5.23%
搭	1910		13	29	0.004378%	639836	96.60%	21	5.79%
撒	1911		15	29	0.004378%	639865	96.60%	22	6.06%
斑	1912		12	29	0.004378%	639894	96.61%	20	5.51%
旱	1913		7	29	0.004378%	639923	96.61%	11	3.03%
旺	1914		8	29	0.004378%	639952	96.62%	18	4.96%
晉	1915		10	29	0.004378%	639981	96.62%	9	2.48%
暮	1916		15	29	0.004378%	640010	96.63%	23	6.34%
枚	1917		8	29	0.004378%	640039	96.63%	17	4.68%
欠	1918		4	29	0.004378%	640068	96.64%	23	6.34%
沈	1919		7	29	0.004378%	640097	96.64%	13	3.58%
沼	1920		8	29	0.004378%	640126	96.64%	9	2.48%
渺	1921		12	29	0.004378%	640155	96.65%	20	5.51%
漠	1922		14	29	0.004378%	640184	96.65%	24	6.61%
漏	1923		14	29	0.004378%	640213	96.66%	22	6.06%
潑	1924		15	29	0.004378%	640242	96.66%	26	7.16%
羨	1925		13	29	0.004378%	640271	96.67%	16	4.41%
肩	1926		8	29	0.004378%	640300	96.67%	23	6.34%
萊	1927		12	29	0.004378%	640329	96.67%	16	4.41%
蔭	1928		15	29	0.004378%	640358	96.68%	22	6.06%
諾	1929		16	29	0.004378%	640387	96.68%	21	5.79%
豬	1930		11	29	0.004378%	640416	96.69%	11	3.03%
贈	1931		19	29	0.004378%	640445	96.69%	19	5.23%
遵	1932		15	29	0.004378%	640474	96.70%	17	4.68%
郭	1933		10	29	0.004378%	640503	96.70%	7	1.93%
閣	1934		14	29	0.004378%	640532	96.71%	12	3.31%
霞	1935		17	29	0.004378%	640561	96.71%	17	4.68%
騎	1936		18	29	0.004378%	640590	96.71%	18	4.96%
俯	1937		10	28	0.004227%	640618	96.72%	25	6.89%
堤	1938		12	28	0.004227%	640646	96.72%	11	3.03%
屏	1939		9	28	0.004227%	640674	96.73%	16	4.41%
役	1940		7	28	0.004227%	640702	96.73%	19	5.23%
敦	1941		12	28	0.004227%	640730	96.73%	14	3.86%
梁	1942		11	28	0.004227%	640758	96.74%	12	3.31%
梢	1943		11	28	0.004227%	640786	96.74%	16	4.41%
桶	1944		11	28	0.004227%	640814	96.75%	16	4.41%
欄	1945		21	28	0.004227%	640842	96.75%	19	5.23%
牢	1946		7	28	0.004227%	640870	96.76%	21	5.79%
瓣	1947		19	28	0.004227%	640898	96.76%	17	4.68%
痕	1948		11	28	0.004227%	640926	96.76%	23	6.34%
盈	1949		9	28	0.004227%	640954	96.77%	23	6.34%
綿	1950		14	28	0.004227%	640982	96.77%	20	5.51%
袖	1951		10	28	0.004227%	641010	96.78%	19	5.23%
誘	1952		14	28	0.004227%	641038	96.78%	22	6.06%
邵	1953		7	28	0.004227%	641066	96.79%	4	1.10%
勁	1954		9	27	0.004076%	641093	96.79%	23	6.34%
勸	1955		20	27	0.004076%	641120	96.79%	21	5.79%
呆	1956		7	27	0.004076%	641147	96.80%	22	6.06%
巿	1957		4	27	0.004076%	641174	96.80%	10	2.76%
惠	1958		12	27	0.004076%	641201	96.81%	17	4.68%
扭	1959		7	27	0.004076%	641228	96.81%	16	4.41%
旨	1960		6	27	0.004076%	641255	96.81%	16	4.41%
昔	1961		8	27	0.004076%	641282	96.82%	21	5.79%
昇	1962		8	27	0.004076%	641309	96.82%	18	4.96%
栽	1963		10	27	0.004076%	641336	96.83%	15	4.13%
樸	1964		16	27	0.004076%	641363	96.83%	17	4.68%
津	1965		9	27	0.004076%	641390	96.83%	13	3.58%
漿	1966		15	27	0.004076%	641417	96.84%	13	3.58%
煌	1967		13	27	0.004076%	641444	96.84%	20	5.51%
燭	1968		17	27	0.004076%	641471	96.85%	13	3.58%
牧	1969		8	27	0.004076%	641498	96.85%	12	3.31%
牲	1970		9	27	0.004076%	641525	96.86%	18	4.96%
疊	1971		22	27	0.004076%	641552	96.86%	18	4.96%
盞	1972		13	27	0.004076%	641579	96.86%	12	3.31%
祈	1973		8	27	0.004076%	641606	96.87%	16	4.41%
禱	1974		18	27	0.004076%	641633	96.87%	13	3.58%
糾	1975		8	27	0.004076%	641660	96.88%	25	6.89%
羣	1976		13	27	0.004076%	641687	96.88%	18	4.96%
腔	1977		12	27	0.004076%	641714	96.88%	19	5.23%
薩	1978		18	27	0.004076%	641741	96.89%	17	4.68%
逆	1979		9	27	0.004076%	641768	96.89%	20	5.51%
錶	1980		16	27	0.004076%	641795	96.90%	7	1.93%
鎖	1981		18	27	0.004076%	641822	96.90%	17	4.68%
陋	1982		8	27	0.004076%	641849	96.90%	19	5.23%
頸	1983		16	27	0.004076%	641876	96.91%	16	4.41%
鬼	1984		10	27	0.004076%	641903	96.91%	23	6.34%
併	1985		8	26	0.003925%	641929	96.92%	24	6.61%
卑	1986		8	26	0.003925%	641955	96.92%	18	4.96%
嚮	1987		18	26	0.003925%	641981	96.92%	19	5.23%
憲	1988		16	26	0.003925%	642007	96.93%	13	3.58%
戈	1989		4	26	0.003925%	642033	96.93%	4	1.10%
扶	1990		7	26	0.003925%	642059	96.94%	16	4.41%
拔	1991		8	26	0.003925%	642085	96.94%	19	5.23%
拘	1992		8	26	0.003925%	642111	96.94%	23	6.34%
拾	1993		9	26	0.003925%	642137	96.95%	23	6.34%
撈	1994		15	26	0.003925%	642163	96.95%	14	3.86%
晒	1995		10	26	0.003925%	642189	96.96%	17	4.68%
晶	1996		12	26	0.003925%	642215	96.96%	18	4.96%
洪	1997		9	26	0.003925%	642241	96.96%	14	3.86%
渴	1998		12	26	0.003925%	642267	96.97%	18	4.96%
澗	1999		15	26	0.003925%	642293	96.97%	4	1.10%
濫	2000		17	26	0.003925%	642319	96.97%	20	5.51%
烘	2001		10	26	0.003925%	642345	96.98%	13	3.58%
焦	2002		12	26	0.003925%	642371	96.98%	16	4.41%
犧	2003		21	26	0.003925%	642397	96.99%	17	4.68%
玫	2004		8	26	0.003925%	642423	96.99%	15	4.13%
窄	2005		10	26	0.003925%	642449	96.99%	18	4.96%
籃	2006		20	26	0.003925%	642475	97.00%	17	4.68%
纔	2007		23	26	0.003925%	642501	97.00%	13	3.58%
脅	2008		10	26	0.003925%	642527	97.01%	20	5.51%
艷	2009		24	26	0.003925%	642553	97.01%	18	4.96%
蓬	2010		15	26	0.003925%	642579	97.01%	16	4.41%
蘆	2011		20	26	0.003925%	642605	97.02%	10	2.76%
蝕	2012		14	26	0.003925%	642631	97.02%	14	3.86%
諒	2013		15	26	0.003925%	642657	97.03%	20	5.51%
躺	2014		15	26	0.003925%	642683	97.03%	20	5.51%
遣	2015		13	26	0.003925%	642709	97.03%	23	6.34%
遞	2016		13	26	0.003925%	642735	97.04%	13	3.58%
邦	2017		6	26	0.003925%	642761	97.04%	20	5.51%
鈴	2018		13	26	0.003925%	642787	97.05%	16	4.41%
鍵	2019		17	26	0.003925%	642813	97.05%	20	5.51%
鴿	2020		17	26	0.003925%	642839	97.05%	6	1.65%
俾	2021		10	25	0.003774%	642864	97.06%	20	5.51%
凱	2022		12	25	0.003774%	642889	97.06%	10	2.76%
吞	2023		7	25	0.003774%	642914	97.06%	22	6.06%
夷	2024		6	25	0.003774%	642939	97.07%	15	4.13%
嫩	2025		14	25	0.003774%	642964	97.07%	18	4.96%
屈	2026		8	25	0.003774%	642989	97.08%	19	5.23%
弦	2027		8	25	0.003774%	643014	97.08%	18	4.96%
慨	2028		12	25	0.003774%	643039	97.08%	20	5.51%
截	2029		14	25	0.003774%	643064	97.09%	21	5.79%
捲	2030		11	25	0.003774%	643089	97.09%	20	5.51%
晴	2031		12	25	0.003774%	643114	97.09%	19	5.23%
札	2032		5	25	0.003774%	643139	97.10%	7	1.93%
朱	2033		6	25	0.003774%	643164	97.10%	20	5.51%
枕	2034		8	25	0.003774%	643189	97.11%	15	4.13%
榴	2035		14	25	0.003774%	643214	97.11%	7	1.93%
殿	2036		13	25	0.003774%	643239	97.11%	13	3.58%
泌	2037		8	25	0.003774%	643264	97.12%	3	0.83%
添	2038		11	25	0.003774%	643289	97.12%	21	5.79%
淒	2039		11	25	0.003774%	643314	97.13%	12	3.31%
漆	2040		14	25	0.003774%	643339	97.13%	17	4.68%
瓜	2041		5	25	0.003774%	643364	97.13%	20	5.51%
畜	2042		10	25	0.003774%	643389	97.14%	14	3.86%
盲	2043		8	25	0.003774%	643414	97.14%	20	5.51%
盼	2044		9	25	0.003774%	643439	97.14%	22	6.06%
矣	2045		7	25	0.003774%	643464	97.15%	18	4.96%
筒	2046		12	25	0.003774%	643489	97.15%	12	3.31%
翰	2047		16	25	0.003774%	643514	97.16%	6	1.65%
聰	2048		17	25	0.003774%	643539	97.16%	20	5.51%
臭	2049		10	25	0.003774%	643564	97.16%	23	6.34%
芽	2050		8	25	0.003774%	643589	97.17%	18	4.96%
褲	2051		15	25	0.003774%	643614	97.17%	17	4.68%
賈	2052		13	25	0.003774%	643639	97.17%	5	1.38%
轟	2053		21	25	0.003774%	643664	97.18%	16	4.41%
鯉	2054		18	25	0.003774%	643689	97.18%	2	0.55%
乳	2055		8	24	0.003623%	643713	97.19%	14	3.86%
侯	2056		9	24	0.003623%	643737	97.19%	13	3.58%
傍	2057		12	24	0.003623%	643761	97.19%	21	5.79%
函	2058		8	24	0.003623%	643785	97.20%	16	4.41%
剎	2059		9	24	0.003623%	643809	97.20%	18	4.96%
卓	2060		8	24	0.003623%	643833	97.20%	20	5.51%
壇	2061		16	24	0.003623%	643857	97.21%	20	5.51%
宴	2062		10	24	0.003623%	643881	97.21%	17	4.68%
撫	2063		15	24	0.003623%	643905	97.21%	19	5.23%
擎	2064		17	24	0.003623%	643929	97.22%	16	4.41%
攤	2065		22	24	0.003623%	643953	97.22%	19	5.23%
昌	2066		8	24	0.003623%	643977	97.23%	14	3.86%
泳	2067		8	24	0.003623%	644001	97.23%	11	3.03%
涵	2068		11	24	0.003623%	644025	97.23%	17	4.68%
溢	2069		13	24	0.003623%	644049	97.24%	17	4.68%
焉	2070		11	24	0.003623%	644073	97.24%	19	5.23%
皿	2071		5	24	0.003623%	644097	97.24%	2	0.55%
矛	2072		5	24	0.003623%	644121	97.25%	15	4.13%
碍	2073		13	24	0.003623%	644145	97.25%	13	3.58%
耗	2074		10	24	0.003623%	644169	97.25%	17	4.68%
脹	2075		12	24	0.003623%	644193	97.26%	18	4.96%
茂	2076		9	24	0.003623%	644217	97.26%	18	4.96%
裕	2077		12	24	0.003623%	644241	97.27%	20	5.51%
誇	2078		13	24	0.003623%	644265	97.27%	21	5.79%
賺	2079		17	24	0.003623%	644289	97.27%	17	4.68%
鉅	2080		13	24	0.003623%	644313	97.28%	18	4.96%
仇	2081		4	23	0.003472%	644336	97.28%	16	4.41%
仗	2082		5	23	0.003472%	644359	97.28%	9	2.48%
僱	2083		14	23	0.003472%	644382	97.29%	12	3.31%
勾	2084		4	23	0.003472%	644405	97.29%	20	5.51%
匠	2085		6	23	0.003472%	644428	97.29%	16	4.41%
唉	2086		10	23	0.003472%	644451	97.30%	13	3.58%
姨	2087		9	23	0.003472%	644474	97.30%	8	2.20%
姻	2088		9	23	0.003472%	644497	97.30%	16	4.41%
巷	2089		9	23	0.003472%	644520	97.31%	19	5.23%
恆	2090		9	23	0.003472%	644543	97.31%	10	2.76%
斗	2091		4	23	0.003472%	644566	97.31%	19	5.23%
洛	2092		9	23	0.003472%	644589	97.32%	16	4.41%
漲	2093		14	23	0.003472%	644612	97.32%	17	4.68%
煤	2094		13	23	0.003472%	644635	97.32%	16	4.41%
珊	2095		9	23	0.003472%	644658	97.33%	13	3.58%
畔	2096		10	23	0.003472%	644681	97.33%	17	4.68%
盟	2097		13	23	0.003472%	644704	97.33%	15	4.13%
禍	2098		13	23	0.003472%	644727	97.34%	15	4.13%
租	2099		10	23	0.003472%	644750	97.34%	12	3.31%
秦	2100		10	23	0.003472%	644773	97.35%	14	3.86%
稚	2101		13	23	0.003472%	644796	97.35%	21	5.79%
纏	2102		21	23	0.003472%	644819	97.35%	19	5.23%
臂	2103		17	23	0.003472%	644842	97.36%	20	5.51%
萎	2104		12	23	0.003472%	644865	97.36%	18	4.96%
蔽	2105		15	23	0.003472%	644888	97.36%	21	5.79%
蜂	2106		13	23	0.003472%	644911	97.37%	18	4.96%
貪	2107		11	23	0.003472%	644934	97.37%	21	5.79%
賦	2108		15	23	0.003472%	644957	97.37%	19	5.23%
跌	2109		12	23	0.003472%	644980	97.38%	19	5.23%
鍋	2110		17	23	0.003472%	645003	97.38%	13	3.58%
餓	2111		15	23	0.003472%	645026	97.38%	19	5.23%
驟	2112		24	23	0.003472%	645049	97.39%	15	4.13%
伍	2113		6	22	0.003321%	645071	97.39%	15	4.13%
伐	2114		6	22	0.003321%	645093	97.39%	15	4.13%
倉	2115		10	22	0.003321%	645115	97.40%	19	5.23%
吻	2116		7	22	0.003321%	645137	97.40%	20	5.51%
吟	2117		7	22	0.003321%	645159	97.40%	16	4.41%
壤	2118		20	22	0.003321%	645181	97.41%	7	1.93%
奠	2119		12	22	0.003321%	645203	97.41%	16	4.41%
嬌	2120		15	22	0.003321%	645225	97.41%	17	4.68%
岳	2121		8	22	0.003321%	645247	97.42%	8	2.20%
巡	2122		7	22	0.003321%	645269	97.42%	15	4.13%
幢	2123		15	22	0.003321%	645291	97.42%	10	2.76%
恕	2124		10	22	0.003321%	645313	97.43%	17	4.68%
抹	2125		8	22	0.003321%	645335	97.43%	19	5.23%
搶	2126		13	22	0.003321%	645357	97.43%	17	4.68%
撐	2127		15	22	0.003321%	645379	97.44%	14	3.86%
撰	2128		15	22	0.003321%	645401	97.44%	18	4.96%
暇	2129		13	22	0.003321%	645423	97.44%	17	4.68%
棠	2130		12	22	0.003321%	645445	97.45%	4	1.10%
樑	2131		15	22	0.003321%	645467	97.45%	18	4.96%
溉	2132		12	22	0.003321%	645489	97.45%	7	1.93%
溜	2133		13	22	0.003321%	645511	97.46%	15	4.13%
燕	2134		16	22	0.003321%	645533	97.46%	11	3.03%
狄	2135		7	22	0.003321%	645555	97.46%	6	1.65%
碌	2136		13	22	0.003321%	645577	97.47%	13	3.58%
磅	2137		15	22	0.003321%	645599	97.47%	16	4.41%
磚	2138		16	22	0.003321%	645621	97.47%	14	3.86%
穫	2139		19	22	0.003321%	645643	97.48%	16	4.41%
窩	2140		14	22	0.003321%	645665	97.48%	17	4.68%
肺	2141		8	22	0.003321%	645687	97.48%	15	4.13%
蛙	2142		12	22	0.003321%	645709	97.49%	9	2.48%
螺	2143		17	22	0.003321%	645731	97.49%	10	2.76%
衷	2144		10	22	0.003321%	645753	97.49%	19	5.23%
豎	2145		15	22	0.003321%	645775	97.50%	17	4.68%
販	2146		11	22	0.003321%	645797	97.50%	14	3.86%
蹤	2147		18	22	0.003321%	645819	97.50%	13	3.58%
邏	2148		22	22	0.003321%	645841	97.51%	12	3.31%
銳	2149		15	22	0.003321%	645863	97.51%	19	5.23%
鋒	2150		15	22	0.003321%	645885	97.51%	18	4.96%
鍊	2151		17	22	0.003321%	645907	97.52%	15	4.13%
伙	2152		6	21	0.003171%	645928	97.52%	13	3.58%
凌	2153		10	21	0.003171%	645949	97.52%	18	4.96%
凋	2154		10	21	0.003171%	645970	97.53%	15	4.13%
割	2155		12	21	0.003171%	645991	97.53%	15	4.13%
勻	2156		4	21	0.003171%	646012	97.53%	11	3.03%
卷	2157		8	21	0.003171%	646033	97.54%	17	4.68%
卸	2158		8	21	0.003171%	646054	97.54%	8	2.20%
吊	2159		6	21	0.003171%	646075	97.54%	16	4.41%
娛	2160		10	21	0.003171%	646096	97.55%	14	3.86%
崗	2161		11	21	0.003171%	646117	97.55%	16	4.41%
庸	2162		11	21	0.003171%	646138	97.55%	19	5.23%
彝	2163		18	21	0.003171%	646159	97.55%	7	1.93%
抖	2164		7	21	0.003171%	646180	97.56%	14	3.86%
斥	2165		5	21	0.003171%	646201	97.56%	18	4.96%
晃	2166		10	21	0.003171%	646222	97.56%	9	2.48%
晤	2167		11	21	0.003171%	646243	97.57%	15	4.13%
晰	2168		12	21	0.003171%	646264	97.57%	18	4.96%
朽	2169		6	21	0.003171%	646285	97.57%	16	4.41%
框	2170		10	21	0.003171%	646306	97.58%	6	1.65%
梳	2171		10	21	0.003171%	646327	97.58%	10	2.76%
浴	2172		10	21	0.003171%	646348	97.58%	18	4.96%
溺	2173		13	21	0.003171%	646369	97.59%	15	4.13%
煉	2174		13	21	0.003171%	646390	97.59%	12	3.31%
猛	2175		11	21	0.003171%	646411	97.59%	18	4.96%
畏	2176		9	21	0.003171%	646432	97.60%	14	3.86%
瞧	2177		17	21	0.003171%	646453	97.60%	15	4.13%
簽	2178		19	21	0.003171%	646474	97.60%	15	4.13%
籐	2179		21	21	0.003171%	646495	97.61%	5	1.38%
翁	2180		10	21	0.003171%	646516	97.61%	17	4.68%
腫	2181		13	21	0.003171%	646537	97.61%	9	2.48%
芒	2182		7	21	0.003171%	646558	97.61%	17	4.68%
菌	2183		12	21	0.003171%	646579	97.62%	6	1.65%
薰	2184		18	21	0.003171%	646600	97.62%	10	2.76%
藤	2185		19	21	0.003171%	646621	97.62%	13	3.58%
酷	2186		14	21	0.003171%	646642	97.63%	18	4.96%
鑑	2187		22	21	0.003171%	646663	97.63%	18	4.96%
鑿	2188		28	21	0.003171%	646684	97.63%	14	3.86%
霍	2189		16	21	0.003171%	646705	97.64%	14	3.86%
餌	2190		14	21	0.003171%	646726	97.64%	8	2.20%
騷	2191		20	21	0.003171%	646747	97.64%	11	3.03%
鱒	2192		23	21	0.003171%	646768	97.65%	2	0.55%
鹽	2193		24	21	0.003171%	646789	97.65%	15	4.13%
嚼	2194		20	20	0.00302%	646809	97.65%	17	4.68%
妓	2195		7	20	0.00302%	646829	97.66%	9	2.48%
娣	2196		10	20	0.00302%	646849	97.66%	2	0.55%
孕	2197		5	20	0.00302%	646869	97.66%	16	4.41%
宏	2198		7	20	0.00302%	646889	97.66%	15	4.13%
寡	2199		14	20	0.00302%	646909	97.67%	16	4.41%
巢	2200		11	20	0.00302%	646929	97.67%	4	1.10%
挽	2201		10	20	0.00302%	646949	97.67%	15	4.13%
昭	2202		9	20	0.00302%	646969	97.68%	12	3.31%
杭	2203		8	20	0.00302%	646989	97.68%	6	1.65%
柄	2204		9	20	0.00302%	647009	97.68%	14	3.86%
湊	2205		12	20	0.00302%	647029	97.69%	16	4.41%
潭	2206		15	20	0.00302%	647049	97.69%	8	2.20%
犬	2207		4	20	0.00302%	647069	97.69%	10	2.76%
眷	2208		11	20	0.00302%	647089	97.70%	15	4.13%
綱	2209		14	20	0.00302%	647109	97.70%	14	3.86%
艙	2210		16	20	0.00302%	647129	97.70%	11	3.03%
芬	2211		8	20	0.00302%	647149	97.70%	17	4.68%
誦	2212		14	20	0.00302%	647169	97.71%	18	4.96%
賀	2213		12	20	0.00302%	647189	97.71%	14	3.86%
赫	2214		14	20	0.00302%	647209	97.71%	13	3.58%
趁	2215		12	20	0.00302%	647229	97.72%	17	4.68%
遼	2216		15	20	0.00302%	647249	97.72%	12	3.31%
邁	2217		16	20	0.00302%	647269	97.72%	20	5.51%
鍾	2218		17	20	0.00302%	647289	97.73%	14	3.86%
陵	2219		10	20	0.00302%	647309	97.73%	5	1.38%
顛	2220		19	20	0.00302%	647329	97.73%	14	3.86%
乙	2221		1	19	0.002869%	647348	97.73%	12	3.31%
仿	2222		6	19	0.002869%	647367	97.74%	16	4.41%
佐	2223		7	19	0.002869%	647386	97.74%	12	3.31%
倚	2224		10	19	0.002869%	647405	97.74%	17	4.68%
儒	2225		16	19	0.002869%	647424	97.75%	11	3.03%
償	2226		17	19	0.002869%	647443	97.75%	16	4.41%
叉	2227		3	19	0.002869%	647462	97.75%	14	3.86%
咀	2228		8	19	0.002869%	647481	97.75%	16	4.41%
唸	2229		11	19	0.002869%	647500	97.76%	15	4.13%
堡	2230		12	19	0.002869%	647519	97.76%	13	3.58%
奸	2231		6	19	0.002869%	647538	97.76%	8	2.20%
婉	2232		11	19	0.002869%	647557	97.77%	11	3.03%
嶼	2233		17	19	0.002869%	647576	97.77%	10	2.76%
帆	2234		6	19	0.002869%	647595	97.77%	10	2.76%
徊	2235		9	19	0.002869%	647614	97.77%	14	3.86%
忌	2236		7	19	0.002869%	647633	97.78%	16	4.41%
悵	2237		11	19	0.002869%	647652	97.78%	15	4.13%
抄	2238		7	19	0.002869%	647671	97.78%	7	1.93%
扮	2239		7	19	0.002869%	647690	97.79%	15	4.13%
抬	2240		8	19	0.002869%	647709	97.79%	18	4.96%
挨	2241		10	19	0.002869%	647728	97.79%	13	3.58%
掀	2242		11	19	0.002869%	647747	97.79%	14	3.86%
曳	2243		6	19	0.002869%	647766	97.80%	16	4.41%
曹	2244		11	19	0.002869%	647785	97.80%	12	3.31%
梨	2245		11	19	0.002869%	647804	97.80%	10	2.76%
樁	2246		15	19	0.002869%	647823	97.81%	12	3.31%
殷	2247		10	19	0.002869%	647842	97.81%	15	4.13%
淵	2248		11	19	0.002869%	647861	97.81%	15	4.13%
漬	2249		14	19	0.002869%	647880	97.81%	9	2.48%
盜	2250		12	19	0.002869%	647899	97.82%	14	3.86%
硫	2251		11	19	0.002869%	647918	97.82%	6	1.65%
竭	2252		14	19	0.002869%	647937	97.82%	18	4.96%
糕	2253		16	19	0.002869%	647956	97.83%	14	3.86%
莎	2254		11	19	0.002869%	647975	97.83%	10	2.76%
莖	2255		11	19	0.002869%	647994	97.83%	8	2.20%
葛	2256		13	19	0.002869%	648013	97.83%	12	3.31%
董	2257		13	19	0.002869%	648032	97.84%	13	3.58%
酬	2258		13	19	0.002869%	648051	97.84%	16	4.41%
頑	2259		13	19	0.002869%	648070	97.84%	16	4.41%
鶴	2260		21	19	0.002869%	648089	97.85%	10	2.76%
債	2261		13	18	0.002718%	648107	97.85%	9	2.48%
催	2262		13	18	0.002718%	648125	97.85%	13	3.58%
刑	2263		6	18	0.002718%	648143	97.85%	10	2.76%
劍	2264		15	18	0.002718%	648161	97.86%	10	2.76%
卜	2265		2	18	0.002718%	648179	97.86%	11	3.03%
厲	2266		15	18	0.002718%	648197	97.86%	15	4.13%
叭	2267		5	18	0.002718%	648215	97.87%	10	2.76%
喇	2268		12	18	0.002718%	648233	97.87%	10	2.76%
嗚	2269		13	18	0.002718%	648251	97.87%	12	3.31%
埠	2270		11	18	0.002718%	648269	97.87%	5	1.38%
墊	2271		14	18	0.002718%	648287	97.88%	10	2.76%
奴	2272		5	18	0.002718%	648305	97.88%	15	4.13%
嫁	2273		13	18	0.002718%	648323	97.88%	9	2.48%
嬰	2274		17	18	0.002718%	648341	97.88%	10	2.76%
廈	2275		13	18	0.002718%	648359	97.89%	10	2.76%
征	2276		8	18	0.002718%	648377	97.89%	13	3.58%
恩	2277		10	18	0.002718%	648395	97.89%	15	4.13%
拙	2278		8	18	0.002718%	648413	97.89%	14	3.86%
捏	2279		10	18	0.002718%	648431	97.90%	9	2.48%
攏	2280		19	18	0.002718%	648449	97.90%	17	4.68%
晝	2281		11	18	0.002718%	648467	97.90%	14	3.86%
楨	2282		13	18	0.002718%	648485	97.91%	3	0.83%
樞	2283		15	18	0.002718%	648503	97.91%	5	1.38%
欺	2284		12	18	0.002718%	648521	97.91%	17	4.68%
沸	2285		8	18	0.002718%	648539	97.91%	10	2.76%
渾	2286		12	18	0.002718%	648557	97.92%	13	3.58%
炮	2287		9	18	0.002718%	648575	97.92%	8	2.20%
笨	2288		11	18	0.002718%	648593	97.92%	14	3.86%
紮	2289		11	18	0.002718%	648611	97.92%	12	3.31%
縛	2290		16	18	0.002718%	648629	97.93%	13	3.58%
缸	2291		9	18	0.002718%	648647	97.93%	7	1.93%
膀	2292		14	18	0.002718%	648665	97.93%	15	4.13%
膨	2293		16	18	0.002718%	648683	97.94%	14	3.86%
臣	2294		6	18	0.002718%	648701	97.94%	11	3.03%
萄	2295		12	18	0.002718%	648719	97.94%	12	3.31%
蔣	2296		15	18	0.002718%	648737	97.94%	11	3.03%
蔡	2297		15	18	0.002718%	648755	97.95%	9	2.48%
覓	2298		11	18	0.002718%	648773	97.95%	13	3.58%
跨	2299		13	18	0.002718%	648791	97.95%	15	4.13%
跪	2300		13	18	0.002718%	648809	97.95%	12	3.31%
蹟	2301		18	18	0.002718%	648827	97.96%	14	3.86%
辰	2302		7	18	0.002718%	648845	97.96%	11	3.03%
鄭	2303		14	18	0.002718%	648863	97.96%	12	3.31%
錦	2304		16	18	0.002718%	648881	97.97%	14	3.86%
鑒	2305		22	18	0.002718%	648899	97.97%	16	4.41%
閑	2306		12	18	0.002718%	648917	97.97%	16	4.41%
饒	2307		20	18	0.002718%	648935	97.97%	13	3.58%
驕	2308		22	18	0.002718%	648953	97.98%	18	4.96%
鮑	2309		16	18	0.002718%	648971	97.98%	3	0.83%
鮭	2310		17	18	0.002718%	648989	97.98%	1	0.28%
鴨	2311		16	18	0.002718%	649007	97.98%	14	3.86%
乍	2312		5	17	0.002567%	649024	97.99%	13	3.58%
乖	2313		8	17	0.002567%	649041	97.99%	12	3.31%
偵	2314		11	17	0.002567%	649058	97.99%	7	1.93%
叛	2315		9	17	0.002567%	649075	97.99%	15	4.13%
叠	2316		13	17	0.002567%	649092	98.00%	9	2.48%
后	2317		6	17	0.002567%	649109	98.00%	13	3.58%
咒	2318		8	17	0.002567%	649126	98.00%	15	4.13%
啼	2319		12	17	0.002567%	649143	98.01%	12	3.31%
嚐	2320		17	17	0.002567%	649160	98.01%	9	2.48%
墓	2321		14	17	0.002567%	649177	98.01%	9	2.48%
妄	2322		6	17	0.002567%	649194	98.01%	13	3.58%
屢	2323		14	17	0.002567%	649211	98.02%	14	3.86%
怯	2324		8	17	0.002567%	649228	98.02%	14	3.86%
拼	2325		9	17	0.002567%	649245	98.02%	14	3.86%
摧	2326		14	17	0.002567%	649262	98.02%	14	3.86%
敷	2327		15	17	0.002567%	649279	98.03%	12	3.31%
斃	2328		17	17	0.002567%	649296	98.03%	10	2.76%
昧	2329		9	17	0.002567%	649313	98.03%	16	4.41%
桑	2330		10	17	0.002567%	649330	98.03%	13	3.58%
毋	2331		4	17	0.002567%	649347	98.04%	11	3.03%
淪	2332		11	17	0.002567%	649364	98.04%	16	4.41%
灑	2333		22	17	0.002567%	649381	98.04%	16	4.41%
煞	2334		13	17	0.002567%	649398	98.04%	12	3.31%
熊	2335		14	17	0.002567%	649415	98.05%	10	2.76%
爽	2336		11	17	0.002567%	649432	98.05%	16	4.41%
猜	2337		11	17	0.002567%	649449	98.05%	15	4.13%
瞎	2338		15	17	0.002567%	649466	98.05%	8	2.20%
矮	2339		13	17	0.002567%	649483	98.06%	15	4.13%
矯	2340		17	17	0.002567%	649500	98.06%	14	3.86%
礁	2341		17	17	0.002567%	649517	98.06%	6	1.65%
稽	2342		15	17	0.002567%	649534	98.06%	15	4.13%
穎	2343		16	17	0.002567%	649551	98.07%	16	4.41%
簿	2344		19	17	0.002567%	649568	98.07%	10	2.76%
簷	2345		19	17	0.002567%	649585	98.07%	10	2.76%
粘	2346		11	17	0.002567%	649602	98.07%	7	1.93%
粵	2347		13	17	0.002567%	649619	98.08%	5	1.38%
繳	2348		19	17	0.002567%	649636	98.08%	13	3.58%
舌	2349		6	17	0.002567%	649653	98.08%	13	3.58%
蔚	2350		15	17	0.002567%	649670	98.08%	14	3.86%
薪	2351		17	17	0.002567%	649687	98.09%	11	3.03%
蘿	2352		23	17	0.002567%	649704	98.09%	10	2.76%
袛	2353		10	17	0.002567%	649721	98.09%	8	2.20%
趙	2354		14	17	0.002567%	649738	98.09%	8	2.20%
邪	2355		6	17	0.002567%	649755	98.10%	12	3.31%
釀	2356		24	17	0.002567%	649772	98.10%	15	4.13%
闢	2357		21	17	0.002567%	649789	98.10%	12	3.31%
隙	2358		13	17	0.002567%	649806	98.11%	13	3.58%
騙	2359		19	17	0.002567%	649823	98.11%	15	4.13%
鴻	2360		17	17	0.002567%	649840	98.11%	9	2.48%
亟	2361		8	16	0.002416%	649856	98.11%	13	3.58%
倆	2362		10	16	0.002416%	649872	98.12%	12	3.31%
僧	2363		14	16	0.002416%	649888	98.12%	10	2.76%
卿	2364		10	16	0.002416%	649904	98.12%	9	2.48%
吼	2365		7	16	0.002416%	649920	98.12%	10	2.76%
囊	2366		22	16	0.002416%	649936	98.12%	15	4.13%
壺	2367		12	16	0.002416%	649952	98.13%	10	2.76%
婷	2368		12	16	0.002416%	649968	98.13%	7	1.93%
寵	2369		19	16	0.002416%	649984	98.13%	14	3.86%
屜	2370		11	16	0.002416%	650000	98.13%	8	2.20%
峽	2371		10	16	0.002416%	650016	98.14%	11	3.03%
嵌	2372		12	16	0.002416%	650032	98.14%	11	3.03%
嵇	2373		12	16	0.002416%	650048	98.14%	1	0.28%
徘	2374		11	16	0.002416%	650064	98.14%	13	3.58%
恍	2375		9	16	0.002416%	650080	98.15%	11	3.03%
惶	2376		12	16	0.002416%	650096	98.15%	12	3.31%
愧	2377		13	16	0.002416%	650112	98.15%	14	3.86%
憾	2378		16	16	0.002416%	650128	98.15%	13	3.58%
扔	2379		5	16	0.002416%	650144	98.16%	10	2.76%
捆	2380		10	16	0.002416%	650160	98.16%	6	1.65%
揭	2381		12	16	0.002416%	650176	98.16%	13	3.58%
搞	2382		13	16	0.002416%	650192	98.16%	13	3.58%
摺	2383		14	16	0.002416%	650208	98.17%	6	1.65%
攀	2384		19	16	0.002416%	650224	98.17%	13	3.58%
旬	2385		6	16	0.002416%	650240	98.17%	13	3.58%
昆	2386		8	16	0.002416%	650256	98.17%	11	3.03%
曬	2387		23	16	0.002416%	650272	98.18%	8	2.20%
杏	2388		7	16	0.002416%	650288	98.18%	9	2.48%
桿	2389		11	16	0.002416%	650304	98.18%	7	1.93%
棚	2390		12	16	0.002416%	650320	98.18%	6	1.65%
歇	2391		13	16	0.002416%	650336	98.19%	12	3.31%
洩	2392		9	16	0.002416%	650352	98.19%	16	4.41%
淹	2393		11	16	0.002416%	650368	98.19%	12	3.31%
濁	2394		16	16	0.002416%	650384	98.19%	13	3.58%
濾	2395		18	16	0.002416%	650400	98.19%	2	0.55%
炭	2396		9	16	0.002416%	650416	98.20%	12	3.31%
焰	2397		12	16	0.002416%	650432	98.20%	4	1.10%
瘋	2398		14	16	0.002416%	650448	98.20%	15	4.13%
瘡	2399		15	16	0.002416%	650464	98.20%	7	1.93%
碩	2400		14	16	0.002416%	650480	98.21%	15	4.13%
秒	2401		9	16	0.002416%	650496	98.21%	8	2.20%
穌	2402		16	16	0.002416%	650512	98.21%	7	1.93%
羞	2403		11	16	0.002416%	650528	98.21%	9	2.48%
蒂	2404		13	16	0.002416%	650544	98.22%	13	3.58%
葡	2405		13	16	0.002416%	650560	98.22%	11	3.03%
蝶	2406		15	16	0.002416%	650576	98.22%	8	2.20%
諧	2407		16	16	0.002416%	650592	98.22%	11	3.03%
謙	2408		17	16	0.002416%	650608	98.23%	13	3.58%
邱	2409		7	16	0.002416%	650624	98.23%	9	2.48%
采	2410		8	16	0.002416%	650640	98.23%	13	3.58%
陌	2411		8	16	0.002416%	650656	98.23%	14	3.86%
韌	2412		12	16	0.002416%	650672	98.24%	6	1.65%
頰	2413		16	16	0.002416%	650688	98.24%	10	2.76%
鮫	2414		17	16	0.002416%	650704	98.24%	3	0.83%
鰱	2415		22	16	0.002416%	650720	98.24%	5	1.38%
兇	2416		6	15	0.002265%	650735	98.25%	8	2.20%
几	2417		2	15	0.002265%	650750	98.25%	10	2.76%
喘	2418		12	15	0.002265%	650765	98.25%	11	3.03%
嘩	2419		15	15	0.002265%	650780	98.25%	6	1.65%
坑	2420		7	15	0.002265%	650795	98.25%	10	2.76%
岷	2421		8	15	0.002265%	650810	98.26%	4	1.10%
忱	2422		7	15	0.002265%	650825	98.26%	12	3.31%
恬	2423		9	15	0.002265%	650840	98.26%	13	3.58%
懇	2424		17	15	0.002265%	650855	98.26%	13	3.58%
杉	2425		7	15	0.002265%	650870	98.27%	8	2.20%
栗	2426		10	15	0.002265%	650885	98.27%	6	1.65%
榻	2427		14	15	0.002265%	650900	98.27%	9	2.48%
櫃	2428		18	15	0.002265%	650915	98.27%	3	0.83%
渠	2429		12	15	0.002265%	650930	98.27%	7	1.93%
澄	2430		15	15	0.002265%	650945	98.28%	12	3.31%
爍	2431		19	15	0.002265%	650960	98.28%	13	3.58%
甫	2432		7	15	0.002265%	650975	98.28%	12	3.31%
疼	2433		10	15	0.002265%	650990	98.28%	12	3.31%
祭	2434		11	15	0.002265%	651005	98.29%	11	3.03%
禪	2435		16	15	0.002265%	651020	98.29%	9	2.48%
禿	2436		7	15	0.002265%	651035	98.29%	11	3.03%
竿	2437		9	15	0.002265%	651050	98.29%	10	2.76%
縵	2438		17	15	0.002265%	651065	98.30%	2	0.55%
聘	2439		13	15	0.002265%	651080	98.30%	13	3.58%
聳	2440		17	15	0.002265%	651095	98.30%	13	3.58%
腕	2441		12	15	0.002265%	651110	98.30%	11	3.03%
膝	2442		15	15	0.002265%	651125	98.30%	12	3.31%
袍	2443		10	15	0.002265%	651140	98.31%	10	2.76%
軀	2444		18	15	0.002265%	651155	98.31%	11	3.03%
鑲	2445		25	15	0.002265%	651170	98.31%	11	3.03%
雀	2446		11	15	0.002265%	651185	98.31%	14	3.86%
鞭	2447		18	15	0.002265%	651200	98.32%	9	2.48%
頌	2448		13	15	0.002265%	651215	98.32%	13	3.58%
鰻	2449		22	15	0.002265%	651230	98.32%	2	0.55%
俟	2450		9	14	0.002114%	651244	98.32%	11	3.03%
刮	2451		8	14	0.002114%	651258	98.32%	8	2.20%
囂	2452		21	14	0.002114%	651272	98.33%	12	3.31%
坪	2453		8	14	0.002114%	651286	98.33%	10	2.76%
埔	2454		10	14	0.002114%	651300	98.33%	6	1.65%
墳	2455		15	14	0.002114%	651314	98.33%	9	2.48%
屑	2456		10	14	0.002114%	651328	98.34%	12	3.31%
履	2457		15	14	0.002114%	651342	98.34%	14	3.86%
峨	2458		10	14	0.002114%	651356	98.34%	6	1.65%
崖	2459		11	14	0.002114%	651370	98.34%	9	2.48%
巫	2460		7	14	0.002114%	651384	98.34%	7	1.93%
彰	2461		14	14	0.002114%	651398	98.35%	10	2.76%
悽	2462		11	14	0.002114%	651412	98.35%	9	2.48%
戚	2463		11	14	0.002114%	651426	98.35%	11	3.03%
扁	2464		9	14	0.002114%	651440	98.35%	11	3.03%
拌	2465		8	14	0.002114%	651454	98.35%	9	2.48%
拆	2466		8	14	0.002114%	651468	98.36%	13	3.58%
挪	2467		10	14	0.002114%	651482	98.36%	10	2.76%
揉	2468		12	14	0.002114%	651496	98.36%	11	3.03%
撕	2469		15	14	0.002114%	651510	98.36%	9	2.48%
擲	2470		18	14	0.002114%	651524	98.36%	10	2.76%
梧	2471		11	14	0.002114%	651538	98.37%	9	2.48%
棕	2472		12	14	0.002114%	651552	98.37%	9	2.48%
橘	2473		16	14	0.002114%	651566	98.37%	7	1.93%
檯	2474		18	14	0.002114%	651580	98.37%	7	1.93%
櫥	2475		19	14	0.002114%	651594	98.38%	9	2.48%
毅	2476		15	14	0.002114%	651608	98.38%	11	3.03%
沾	2477		8	14	0.002114%	651622	98.38%	11	3.03%
澀	2478		17	14	0.002114%	651636	98.38%	11	3.03%
獄	2479		14	14	0.002114%	651650	98.38%	8	2.20%
瑣	2480		14	14	0.002114%	651664	98.39%	12	3.31%
瓏	2481		20	14	0.002114%	651678	98.39%	12	3.31%
瓷	2482		11	14	0.002114%	651692	98.39%	5	1.38%
瞬	2483		17	14	0.002114%	651706	98.39%	14	3.86%
碳	2484		14	14	0.002114%	651720	98.39%	3	0.83%
祺	2485		12	14	0.002114%	651734	98.40%	2	0.55%
禽	2486		13	14	0.002114%	651748	98.40%	12	3.31%
窺	2487		16	14	0.002114%	651762	98.40%	13	3.58%
笛	2488		11	14	0.002114%	651776	98.40%	7	1.93%
篩	2489		16	14	0.002114%	651790	98.40%	4	1.10%
籬	2490		25	14	0.002114%	651804	98.41%	12	3.31%
綁	2491		13	14	0.002114%	651818	98.41%	6	1.65%
縷	2492		17	14	0.002114%	651832	98.41%	7	1.93%
脾	2493		12	14	0.002114%	651846	98.41%	12	3.31%
茄	2494		9	14	0.002114%	651860	98.42%	10	2.76%
葬	2495		13	14	0.002114%	651874	98.42%	9	2.48%
藕	2496		19	14	0.002114%	651888	98.42%	4	1.10%
蘊	2497		20	14	0.002114%	651902	98.42%	12	3.31%
虔	2498		10	14	0.002114%	651916	98.42%	9	2.48%
蠟	2499		21	14	0.002114%	651930	98.43%	10	2.76%
豫	2500		16	14	0.002114%	651944	98.43%	13	3.58%
貶	2501		12	14	0.002114%	651958	98.43%	8	2.20%
辜	2502		12	14	0.002114%	651972	98.43%	10	2.76%
辣	2503		14	14	0.002114%	651986	98.43%	12	3.31%
酣	2504		12	14	0.002114%	652000	98.44%	12	3.31%
鋸	2505		16	14	0.002114%	652014	98.44%	10	2.76%
錫	2506		16	14	0.002114%	652028	98.44%	12	3.31%
鏍	2507		19	14	0.002114%	652042	98.44%	1	0.28%
閩	2508		14	14	0.002114%	652056	98.44%	5	1.38%
顫	2509		22	14	0.002114%	652070	98.45%	13	3.58%
馨	2510		20	14	0.002114%	652084	98.45%	11	3.03%
魔	2511		21	14	0.002114%	652098	98.45%	13	3.58%
鵑	2512		18	14	0.002114%	652112	98.45%	6	1.65%
鸞	2513		30	14	0.002114%	652126	98.46%	1	0.28%
麵	2514		20	14	0.002114%	652140	98.46%	10	2.76%
黯	2515		21	14	0.002114%	652154	98.46%	14	3.86%
丫	2516		3	13	0.001963%	652167	98.46%	8	2.20%
仲	2517		6	13	0.001963%	652180	98.46%	12	3.31%
侶	2518		9	13	0.001963%	652193	98.47%	11	3.03%
僵	2519		15	13	0.001963%	652206	98.47%	10	2.76%
儉	2520		15	13	0.001963%	652219	98.47%	7	1.93%
允	2521		4	13	0.001963%	652232	98.47%	11	3.03%
凸	2522		5	13	0.001963%	652245	98.47%	8	2.20%
劫	2523		7	13	0.001963%	652258	98.48%	13	3.58%
哉	2524		9	13	0.001963%	652271	98.48%	9	2.48%
嗣	2525		13	13	0.001963%	652284	98.48%	9	2.48%
嘻	2526		15	13	0.001963%	652297	98.48%	6	1.65%
奢	2527		11	13	0.001963%	652310	98.48%	10	2.76%
峻	2528		10	13	0.001963%	652323	98.49%	9	2.48%
崩	2529		11	13	0.001963%	652336	98.49%	10	2.76%
彌	2530		17	13	0.001963%	652349	98.49%	13	3.58%
彭	2531		12	13	0.001963%	652362	98.49%	5	1.38%
惘	2532		11	13	0.001963%	652375	98.49%	9	2.48%
捷	2533		11	13	0.001963%	652388	98.50%	12	3.31%
撞	2534		15	13	0.001963%	652401	98.50%	13	3.58%
擋	2535		16	13	0.001963%	652414	98.50%	9	2.48%
攜	2536		21	13	0.001963%	652427	98.50%	12	3.31%
暈	2537		13	13	0.001963%	652440	98.50%	9	2.48%
暨	2538		14	13	0.001963%	652453	98.50%	9	2.48%
曆	2539		16	13	0.001963%	652466	98.51%	9	2.48%
杆	2540		7	13	0.001963%	652479	98.51%	8	2.20%
榜	2541		14	13	0.001963%	652492	98.51%	7	1.93%
橡	2542		16	13	0.001963%	652505	98.51%	11	3.03%
檻	2543		18	13	0.001963%	652518	98.51%	6	1.65%
洒	2544		9	13	0.001963%	652531	98.52%	8	2.20%
滌	2545		14	13	0.001963%	652544	98.52%	13	3.58%
灶	2546		7	13	0.001963%	652557	98.52%	11	3.03%
烤	2547		10	13	0.001963%	652570	98.52%	8	2.20%
疆	2548		19	13	0.001963%	652583	98.52%	5	1.38%
癒	2549		18	13	0.001963%	652596	98.53%	8	2.20%
癡	2550		19	13	0.001963%	652609	98.53%	10	2.76%
穆	2551		16	13	0.001963%	652622	98.53%	10	2.76%
竊	2552		23	13	0.001963%	652635	98.53%	7	1.93%
簍	2553		17	13	0.001963%	652648	98.53%	7	1.93%
締	2554		15	13	0.001963%	652661	98.54%	8	2.20%
縐	2555		16	13	0.001963%	652674	98.54%	10	2.76%
羡	2556		12	13	0.001963%	652687	98.54%	13	3.58%
茅	2557		9	13	0.001963%	652700	98.54%	10	2.76%
苟	2558		9	13	0.001963%	652713	98.54%	12	3.31%
菱	2559		12	13	0.001963%	652726	98.55%	7	1.93%
蕃	2560		16	13	0.001963%	652739	98.55%	5	1.38%
蘋	2561		20	13	0.001963%	652752	98.55%	11	3.03%
裹	2562		14	13	0.001963%	652765	98.55%	7	1.93%
謎	2563		17	13	0.001963%	652778	98.55%	10	2.76%
譜	2564		19	13	0.001963%	652791	98.56%	10	2.76%
賤	2565		15	13	0.001963%	652804	98.56%	10	2.76%
踩	2566		15	13	0.001963%	652817	98.56%	11	3.03%
辱	2567		10	13	0.001963%	652830	98.56%	10	2.76%
迪	2568		8	13	0.001963%	652843	98.56%	11	3.03%
醇	2569		15	13	0.001963%	652856	98.57%	9	2.48%
陡	2570		9	13	0.001963%	652869	98.57%	8	2.20%
麓	2571		19	13	0.001963%	652882	98.57%	7	1.93%
俊	2572		9	12	0.001812%	652894	98.57%	11	3.03%
劾	2573		8	12	0.001812%	652906	98.57%	2	0.55%
勿	2574		4	12	0.001812%	652918	98.58%	12	3.31%
占	2575		5	12	0.001812%	652930	98.58%	6	1.65%
叮	2576		5	12	0.001812%	652942	98.58%	7	1.93%
喬	2577		12	12	0.001812%	652954	98.58%	8	2.20%
嗅	2578		13	12	0.001812%	652966	98.58%	8	2.20%
嘯	2579		15	12	0.001812%	652978	98.58%	11	3.03%
墜	2580		15	12	0.001812%	652990	98.59%	10	2.76%
壩	2581		24	12	0.001812%	653002	98.59%	5	1.38%
妒	2582		7	12	0.001812%	653014	98.59%	8	2.20%
妮	2583		8	12	0.001812%	653026	98.59%	3	0.83%
媚	2584		12	12	0.001812%	653038	98.59%	10	2.76%
孵	2585		14	12	0.001812%	653050	98.60%	6	1.65%
寥	2586		14	12	0.001812%	653062	98.60%	8	2.20%
寮	2587		15	12	0.001812%	653074	98.60%	4	1.10%
屍	2588		9	12	0.001812%	653086	98.60%	5	1.38%
帳	2589		11	12	0.001812%	653098	98.60%	6	1.65%
廓	2590		14	12	0.001812%	653110	98.60%	10	2.76%
徹	2591		14	12	0.001812%	653122	98.61%	12	3.31%
怖	2592		8	12	0.001812%	653134	98.61%	10	2.76%
敝	2593		11	12	0.001812%	653146	98.61%	5	1.38%
浩	2594		10	12	0.001812%	653158	98.61%	10	2.76%
淘	2595		11	12	0.001812%	653170	98.61%	10	2.76%
瀾	2596		20	12	0.001812%	653182	98.61%	11	3.03%
燻	2597		18	12	0.001812%	653194	98.62%	6	1.65%
皺	2598		15	12	0.001812%	653206	98.62%	7	1.93%
砲	2599		10	12	0.001812%	653218	98.62%	6	1.65%
秩	2600		10	12	0.001812%	653230	98.62%	12	3.31%
穴	2601		5	12	0.001812%	653242	98.62%	8	2.20%
糟	2602		17	12	0.001812%	653254	98.63%	8	2.20%
糙	2603		17	12	0.001812%	653266	98.63%	10	2.76%
綢	2604		14	12	0.001812%	653278	98.63%	11	3.03%
緯	2605		15	12	0.001812%	653290	98.63%	3	0.83%
繡	2606		18	12	0.001812%	653302	98.63%	8	2.20%
脊	2607		10	12	0.001812%	653314	98.63%	8	2.20%
膩	2608		16	12	0.001812%	653326	98.64%	10	2.76%
芭	2609		8	12	0.001812%	653338	98.64%	11	3.03%
范	2610		9	12	0.001812%	653350	98.64%	5	1.38%
苛	2611		9	12	0.001812%	653362	98.64%	10	2.76%
薇	2612		17	12	0.001812%	653374	98.64%	8	2.20%
虐	2613		9	12	0.001812%	653386	98.65%	10	2.76%
蜀	2614		13	12	0.001812%	653398	98.65%	6	1.65%
褒	2615		15	12	0.001812%	653410	98.65%	7	1.93%
諱	2616		16	12	0.001812%	653422	98.65%	12	3.31%
諷	2617		16	12	0.001812%	653434	98.65%	10	2.76%
譚	2618		19	12	0.001812%	653446	98.65%	8	2.20%
賜	2619		15	12	0.001812%	653458	98.66%	7	1.93%
贏	2620		20	12	0.001812%	653470	98.66%	10	2.76%
逗	2621		10	12	0.001812%	653482	98.66%	9	2.48%
逾	2622		12	12	0.001812%	653494	98.66%	10	2.76%
鈞	2623		12	12	0.001812%	653506	98.66%	4	1.10%
鉛	2624		13	12	0.001812%	653518	98.67%	10	2.76%
闆	2625		17	12	0.001812%	653530	98.67%	9	2.48%
頻	2626		16	12	0.001812%	653542	98.67%	11	3.03%
飢	2627		10	12	0.001812%	653554	98.67%	8	2.20%
駁	2628		14	12	0.001812%	653566	98.67%	9	2.48%
鴉	2629		15	12	0.001812%	653578	98.67%	7	1.93%
倩	2630		10	11	0.001661%	653589	98.68%	6	1.65%
兜	2631		11	11	0.001661%	653600	98.68%	10	2.76%
凹	2632		5	11	0.001661%	653611	98.68%	5	1.38%
券	2633		8	11	0.001661%	653622	98.68%	6	1.65%
剔	2634		10	11	0.001661%	653633	98.68%	8	2.20%
卒	2635		8	11	0.001661%	653644	98.68%	10	2.76%
咳	2636		9	11	0.001661%	653655	98.69%	6	1.65%
咽	2637		9	11	0.001661%	653666	98.69%	8	2.20%
啞	2638		11	11	0.001661%	653677	98.69%	11	3.03%
喃	2639		12	11	0.001661%	653688	98.69%	6	1.65%
喉	2640		12	11	0.001661%	653699	98.69%	10	2.76%
喫	2641		12	11	0.001661%	653710	98.69%	4	1.10%
嗜	2642		13	11	0.001661%	653721	98.70%	10	2.76%
契	2643		9	11	0.001661%	653732	98.70%	8	2.20%
姚	2644		9	11	0.001661%	653743	98.70%	5	1.38%
嬉	2645		15	11	0.001661%	653754	98.70%	8	2.20%
宰	2646		10	11	0.001661%	653765	98.70%	6	1.65%
寢	2647		14	11	0.001661%	653776	98.70%	11	3.03%
巍	2648		21	11	0.001661%	653787	98.71%	7	1.93%
幌	2649		13	11	0.001661%	653798	98.71%	9	2.48%
恭	2650		10	11	0.001661%	653809	98.71%	10	2.76%
惹	2651		13	11	0.001661%	653820	98.71%	11	3.03%
慌	2652		13	11	0.001661%	653831	98.71%	10	2.76%
扯	2653		7	11	0.001661%	653842	98.71%	11	3.03%
拂	2654		8	11	0.001661%	653853	98.72%	10	2.76%
拳	2655		10	11	0.001661%	653864	98.72%	8	2.20%
搗	2656		13	11	0.001661%	653875	98.72%	8	2.20%
朦	2657		18	11	0.001661%	653886	98.72%	11	3.03%
杖	2658		7	11	0.001661%	653897	98.72%	9	2.48%
榆	2659		13	11	0.001661%	653908	98.72%	3	0.83%
檀	2660		17	11	0.001661%	653919	98.73%	6	1.65%
歉	2661		14	11	0.001661%	653930	98.73%	10	2.76%
歧	2662		8	11	0.001661%	653941	98.73%	9	2.48%
淞	2663		11	11	0.001661%	653952	98.73%	2	0.55%
淫	2664		11	11	0.001661%	653963	98.73%	9	2.48%
炒	2665		8	11	0.001661%	653974	98.73%	7	1.93%
焚	2666		12	11	0.001661%	653985	98.74%	9	2.48%
牡	2667		7	11	0.001661%	653996	98.74%	5	1.38%
疫	2668		9	11	0.001661%	654007	98.74%	6	1.65%
痰	2669		13	11	0.001661%	654018	98.74%	5	1.38%
眸	2670		11	11	0.001661%	654029	98.74%	9	2.48%
砍	2671		9	11	0.001661%	654040	98.74%	9	2.48%
碟	2672		14	11	0.001661%	654051	98.75%	8	2.20%
篤	2673		16	11	0.001661%	654062	98.75%	9	2.48%
籲	2674		32	11	0.001661%	654073	98.75%	10	2.76%
絨	2675		12	11	0.001661%	654084	98.75%	10	2.76%
翌	2676		11	11	0.001661%	654095	98.75%	11	3.03%
翩	2677		15	11	0.001661%	654106	98.75%	6	1.65%
脂	2678		10	11	0.001661%	654117	98.76%	11	3.03%
舶	2679		11	11	0.001661%	654128	98.76%	7	1.93%
虞	2680		13	11	0.001661%	654139	98.76%	9	2.48%
虱	2681		8	11	0.001661%	654150	98.76%	3	0.83%
虹	2682		9	11	0.001661%	654161	98.76%	10	2.76%
褪	2683		15	11	0.001661%	654172	98.76%	9	2.48%
褶	2684		16	11	0.001661%	654183	98.77%	3	0.83%
諜	2685		16	11	0.001661%	654194	98.77%	3	0.83%
赦	2686		11	11	0.001661%	654205	98.77%	7	1.93%
軋	2687		8	11	0.001661%	654216	98.77%	7	1.93%
輿	2688		17	11	0.001661%	654227	98.77%	3	0.83%
酌	2689		10	11	0.001661%	654238	98.77%	11	3.03%
鏟	2690		19	11	0.001661%	654249	98.78%	8	2.20%
鑼	2691		27	11	0.001661%	654260	98.78%	9	2.48%
霄	2692		15	11	0.001661%	654271	98.78%	10	2.76%
颱	2693		14	11	0.001661%	654282	98.78%	6	1.65%
馮	2694		12	11	0.001661%	654293	98.78%	5	1.38%
鬚	2695		22	11	0.001661%	654304	98.78%	7	1.93%
魄	2696		15	11	0.001661%	654315	98.79%	8	2.20%
鱷	2697		27	11	0.001661%	654326	98.79%	2	0.55%
鵝	2698		18	11	0.001661%	654337	98.79%	9	2.48%
鵬	2699		19	11	0.001661%	654348	98.79%	4	1.10%
鹹	2700		20	11	0.001661%	654359	98.79%	9	2.48%
鹿	2701		11	11	0.001661%	654370	98.79%	6	1.65%
刃	2702		3	10	0.00151%	654380	98.80%	8	2.20%
划	2703		6	10	0.00151%	654390	98.80%	7	1.93%
吏	2704		6	10	0.00151%	654400	98.80%	4	1.10%
吱	2705		7	10	0.00151%	654410	98.80%	5	1.38%
咚	2706		8	10	0.00151%	654420	98.80%	2	0.55%
嗡	2707		13	10	0.00151%	654430	98.80%	4	1.10%
址	2708		7	10	0.00151%	654440	98.80%	7	1.93%
夥	2709		14	10	0.00151%	654450	98.81%	8	2.20%
娼	2710		11	10	0.00151%	654460	98.81%	4	1.10%
廁	2711		12	10	0.00151%	654470	98.81%	8	2.20%
徽	2712		17	10	0.00151%	654480	98.81%	3	0.83%
悴	2713		11	10	0.00151%	654490	98.81%	10	2.76%
惆	2714		11	10	0.00151%	654500	98.81%	9	2.48%
慚	2715		14	10	0.00151%	654510	98.82%	8	2.20%
挾	2716		10	10	0.00151%	654520	98.82%	9	2.48%
掠	2717		11	10	0.00151%	654530	98.82%	10	2.76%
掏	2718		11	10	0.00151%	654540	98.82%	8	2.20%
擱	2719		17	10	0.00151%	654550	98.82%	7	1.93%
朧	2720		20	10	0.00151%	654560	98.82%	10	2.76%
柑	2721		9	10	0.00151%	654570	98.82%	7	1.93%
柚	2722		9	10	0.00151%	654580	98.83%	3	0.83%
梗	2723		11	10	0.00151%	654590	98.83%	7	1.93%
棗	2724		12	10	0.00151%	654600	98.83%	6	1.65%
棟	2725		12	10	0.00151%	654610	98.83%	9	2.48%
棍	2726		12	10	0.00151%	654620	98.83%	6	1.65%
楷	2727		13	10	0.00151%	654630	98.83%	5	1.38%
橢	2728		16	10	0.00151%	654640	98.84%	8	2.20%
樵	2729		16	10	0.00151%	654650	98.84%	3	0.83%
檜	2730		17	10	0.00151%	654660	98.84%	6	1.65%
欽	2731		12	10	0.00151%	654670	98.84%	9	2.48%
歪	2732		9	10	0.00151%	654680	98.84%	8	2.20%
沛	2733		7	10	0.00151%	654690	98.84%	9	2.48%
洶	2734		9	10	0.00151%	654700	98.84%	9	2.48%
瀟	2735		19	10	0.00151%	654710	98.85%	7	1.93%
爪	2736		4	10	0.00151%	654720	98.85%	9	2.48%
爵	2737		17	10	0.00151%	654730	98.85%	5	1.38%
甸	2738		7	10	0.00151%	654740	98.85%	6	1.65%
痊	2739		11	10	0.00151%	654750	98.85%	8	2.20%
癮	2740		22	10	0.00151%	654760	98.85%	9	2.48%
眩	2741		10	10	0.00151%	654770	98.85%	8	2.20%
砌	2742		9	10	0.00151%	654780	98.86%	8	2.20%
祂	2743		7	10	0.00151%	654790	98.86%	8	2.20%
籟	2744		22	10	0.00151%	654800	98.86%	3	0.83%
絞	2745		12	10	0.00151%	654810	98.86%	7	1.93%
纍	2746		21	10	0.00151%	654820	98.86%	6	1.65%
翹	2747		18	10	0.00151%	654830	98.86%	10	2.76%
菩	2748		12	10	0.00151%	654840	98.87%	7	1.93%
萌	2749		12	10	0.00151%	654850	98.87%	8	2.20%
薔	2750		17	10	0.00151%	654860	98.87%	7	1.93%
蚊	2751		10	10	0.00151%	654870	98.87%	6	1.65%
蜻	2752		14	10	0.00151%	654880	98.87%	2	0.55%
蠶	2753		24	10	0.00151%	654890	98.87%	9	2.48%
衍	2754		9	10	0.00151%	654900	98.87%	9	2.48%
裳	2755		14	10	0.00151%	654910	98.88%	9	2.48%
襟	2756		18	10	0.00151%	654920	98.88%	8	2.20%
賠	2757		15	10	0.00151%	654930	98.88%	7	1.93%
逕	2758		10	10	0.00151%	654940	98.88%	7	1.93%
郁	2759		8	10	0.00151%	654950	98.88%	8	2.20%
銜	2760		14	10	0.00151%	654960	98.88%	9	2.48%
闖	2761		18	10	0.00151%	654970	98.88%	9	2.48%
霜	2762		17	10	0.00151%	654980	98.89%	8	2.20%
頒	2763		13	10	0.00151%	654990	98.89%	8	2.20%
頹	2764		16	10	0.00151%	655000	98.89%	8	2.20%
駭	2765		16	10	0.00151%	655010	98.89%	10	2.76%
鬍	2766		19	10	0.00151%	655020	98.89%	4	1.10%
鯨	2767		19	10	0.00151%	655030	98.89%	6	1.65%
亨	2768		7	9	0.001359%	655039	98.90%	6	1.65%
侍	2769		8	9	0.001359%	655048	98.90%	7	1.93%
倖	2770		10	9	0.001359%	655057	98.90%	9	2.48%
僻	2771		15	9	0.001359%	655066	98.90%	9	2.48%
冀	2772		16	9	0.001359%	655075	98.90%	7	1.93%
咸	2773		9	9	0.001359%	655084	98.90%	9	2.48%
喟	2774		12	9	0.001359%	655093	98.90%	6	1.65%
嘈	2775		14	9	0.001359%	655102	98.90%	6	1.65%
娜	2776		10	9	0.001359%	655111	98.91%	6	1.65%
宵	2777		10	9	0.001359%	655120	98.91%	9	2.48%
寐	2778		12	9	0.001359%	655129	98.91%	8	2.20%
岡	2779		8	9	0.001359%	655138	98.91%	7	1.93%
崔	2780		11	9	0.001359%	655147	98.91%	3	0.83%
嶄	2781		14	9	0.001359%	655156	98.91%	9	2.48%
巒	2782		22	9	0.001359%	655165	98.91%	6	1.65%
巾	2783		3	9	0.001359%	655174	98.92%	7	1.93%
并	2784		6	9	0.001359%	655183	98.92%	6	1.65%
憫	2785		15	9	0.001359%	655192	98.92%	6	1.65%
憎	2786		15	9	0.001359%	655201	98.92%	8	2.20%
抒	2787		7	9	0.001359%	655210	98.92%	8	2.20%
拭	2788		9	9	0.001359%	655219	98.92%	8	2.20%
摯	2789		15	9	0.001359%	655228	98.92%	9	2.48%
攪	2790		23	9	0.001359%	655237	98.93%	7	1.93%
斬	2791		11	9	0.001359%	655246	98.93%	9	2.48%
旳	2792		7	9	0.001359%	655255	98.93%	9	2.48%
枉	2793		8	9	0.001359%	655264	98.93%	9	2.48%
棘	2794		12	9	0.001359%	655273	98.93%	8	2.20%
氫	2795		11	9	0.001359%	655282	98.93%	3	0.83%
汕	2796		6	9	0.001359%	655291	98.93%	4	1.10%
浦	2797		10	9	0.001359%	655300	98.93%	5	1.38%
渦	2798		12	9	0.001359%	655309	98.94%	7	1.93%
漪	2799		14	9	0.001359%	655318	98.94%	8	2.20%
漉	2800		14	9	0.001359%	655327	98.94%	5	1.38%
潺	2801		15	9	0.001359%	655336	98.94%	5	1.38%
灸	2802		7	9	0.001359%	655345	98.94%	4	1.10%
燄	2803		16	9	0.001359%	655354	98.94%	8	2.20%
獵	2804		18	9	0.001359%	655363	98.94%	8	2.20%
琉	2805		10	9	0.001359%	655372	98.95%	6	1.65%
瑋	2806		13	9	0.001359%	655381	98.95%	1	0.28%
疇	2807		19	9	0.001359%	655390	98.95%	8	2.20%
癢	2808		20	9	0.001359%	655399	98.95%	7	1.93%
皂	2809		7	9	0.001359%	655408	98.95%	7	1.93%
盯	2810		7	9	0.001359%	655417	98.95%	7	1.93%
眺	2811		11	9	0.001359%	655426	98.95%	8	2.20%
睜	2812		13	9	0.001359%	655435	98.96%	8	2.20%
磁	2813		14	9	0.001359%	655444	98.96%	6	1.65%
祠	2814		9	9	0.001359%	655453	98.96%	5	1.38%
秧	2815		10	9	0.001359%	655462	98.96%	4	1.10%
稜	2816		13	9	0.001359%	655471	98.96%	3	0.83%
簫	2817		18	9	0.001359%	655480	98.96%	5	1.38%
簧	2818		18	9	0.001359%	655489	98.96%	3	0.83%
絢	2819		12	9	0.001359%	655498	98.96%	6	1.65%
絹	2820		13	9	0.001359%	655507	98.97%	3	0.83%
繽	2821		20	9	0.001359%	655516	98.97%	9	2.48%
肆	2822		13	9	0.001359%	655525	98.97%	8	2.20%
肖	2823		7	9	0.001359%	655534	98.97%	9	2.48%
腎	2824		12	9	0.001359%	655543	98.97%	5	1.38%
臻	2825		16	9	0.001359%	655552	98.97%	9	2.48%
芸	2826		8	9	0.001359%	655561	98.97%	2	0.55%
茸	2827		10	9	0.001359%	655570	98.98%	5	1.38%
茵	2828		10	9	0.001359%	655579	98.98%	3	0.83%
莓	2829		11	9	0.001359%	655588	98.98%	3	0.83%
葱	2830		13	9	0.001359%	655597	98.98%	1	0.28%
蒜	2831		14	9	0.001359%	655606	98.98%	4	1.10%
蔔	2832		15	9	0.001359%	655615	98.98%	5	1.38%
藩	2833		19	9	0.001359%	655624	98.98%	9	2.48%
藻	2834		20	9	0.001359%	655633	98.98%	5	1.38%
蛀	2835		11	9	0.001359%	655642	98.99%	2	0.55%
蜓	2836		13	9	0.001359%	655651	98.99%	1	0.28%
蝴	2837		15	9	0.001359%	655660	98.99%	5	1.38%
螢	2838		16	9	0.001359%	655669	98.99%	8	2.20%
袁	2839		10	9	0.001359%	655678	98.99%	5	1.38%
貯	2840		12	9	0.001359%	655687	98.99%	8	2.20%
迥	2841		8	9	0.001359%	655696	98.99%	9	2.48%
鋁	2842		15	9	0.001359%	655705	99.00%	6	1.65%
錐	2843		16	9	0.001359%	655714	99.00%	6	1.65%
顱	2844		25	9	0.001359%	655723	99.00%	6	1.65%
髒	2845		22	9	0.001359%	655732	99.00%	9	2.48%
魏	2846		18	9	0.001359%	655741	99.00%	4	1.10%
鯰	2847		19	9	0.001359%	655750	99.00%	1	0.28%
鰓	2848		20	9	0.001359%	655759	99.00%	5	1.38%
鼎	2849		13	9	0.001359%	655768	99.01%	7	1.93%
丸	2850		3	8	0.001208%	655776	99.01%	6	1.65%
乞	2851		3	8	0.001208%	655784	99.01%	5	1.38%
佇	2852		7	8	0.001208%	655792	99.01%	7	1.93%
余	2853		7	8	0.001208%	655800	99.01%	7	1.93%
兮	2854		4	8	0.001208%	655808	99.01%	4	1.10%
冉	2855		5	8	0.001208%	655816	99.01%	4	1.10%
冥	2856		10	8	0.001208%	655824	99.01%	6	1.65%
冶	2857		7	8	0.001208%	655832	99.02%	8	2.20%
凄	2858		10	8	0.001208%	655840	99.02%	6	1.65%
劈	2859		15	8	0.001208%	655848	99.02%	4	1.10%
匱	2860		14	8	0.001208%	655856	99.02%	5	1.38%
吋	2861		6	8	0.001208%	655864	99.02%	6	1.65%
唧	2862		10	8	0.001208%	655872	99.02%	4	1.10%
啃	2863		11	8	0.001208%	655880	99.02%	5	1.38%
喀	2864		12	8	0.001208%	655888	99.02%	5	1.38%
嗽	2865		14	8	0.001208%	655896	99.02%	5	1.38%
嘲	2866		15	8	0.001208%	655904	99.03%	8	2.20%
嘶	2867		15	8	0.001208%	655912	99.03%	6	1.65%
嚇	2868		17	8	0.001208%	655920	99.03%	7	1.93%
囑	2869		24	8	0.001208%	655928	99.03%	8	2.20%
囚	2870		5	8	0.001208%	655936	99.03%	5	1.38%
圭	2871		6	8	0.001208%	655944	99.03%	7	1.93%
墮	2872		15	8	0.001208%	655952	99.03%	5	1.38%
嫉	2873		13	8	0.001208%	655960	99.03%	7	1.93%
媳	2874		13	8	0.001208%	655968	99.04%	5	1.38%
崎	2875		11	8	0.001208%	655976	99.04%	6	1.65%
帖	2876		8	8	0.001208%	655984	99.04%	7	1.93%
帥	2877		9	8	0.001208%	655992	99.04%	2	0.55%
庇	2878		7	8	0.001208%	656000	99.04%	6	1.65%
庶	2879		11	8	0.001208%	656008	99.04%	5	1.38%
廖	2880		14	8	0.001208%	656016	99.04%	4	1.10%
廷	2881		7	8	0.001208%	656024	99.04%	8	2.20%
弧	2882		8	8	0.001208%	656032	99.05%	6	1.65%
惦	2883		11	8	0.001208%	656040	99.05%	4	1.10%
惕	2884		11	8	0.001208%	656048	99.05%	8	2.20%
悸	2885		11	8	0.001208%	656056	99.05%	5	1.38%
愴	2886		13	8	0.001208%	656064	99.05%	5	1.38%
憔	2887		15	8	0.001208%	656072	99.05%	8	2.20%
懊	2888		16	8	0.001208%	656080	99.05%	5	1.38%
懲	2889		19	8	0.001208%	656088	99.05%	5	1.38%
拈	2890		8	8	0.001208%	656096	99.05%	7	1.93%
押	2891		8	8	0.001208%	656104	99.06%	4	1.10%
挖	2892		9	8	0.001208%	656112	99.06%	7	1.93%
挫	2893		10	8	0.001208%	656120	99.06%	6	1.65%
撩	2894		15	8	0.001208%	656128	99.06%	8	2.20%
攔	2895		20	8	0.001208%	656136	99.06%	7	1.93%
斌	2896		12	8	0.001208%	656144	99.06%	3	0.83%
曦	2897		20	8	0.001208%	656152	99.06%	7	1.93%
桁	2898		10	8	0.001208%	656160	99.06%	2	0.55%
椒	2899		12	8	0.001208%	656168	99.07%	5	1.38%
檳	2900		18	8	0.001208%	656176	99.07%	4	1.10%
殆	2901		9	8	0.001208%	656184	99.07%	8	2.20%
殉	2902		10	8	0.001208%	656192	99.07%	7	1.93%
渲	2903		12	8	0.001208%	656200	99.07%	8	2.20%
溯	2904		13	8	0.001208%	656208	99.07%	6	1.65%
漾	2905		14	8	0.001208%	656216	99.07%	8	2.20%
澆	2906		15	8	0.001208%	656224	99.07%	7	1.93%
澎	2907		15	8	0.001208%	656232	99.08%	7	1.93%
潘	2908		15	8	0.001208%	656240	99.08%	7	1.93%
濺	2909		18	8	0.001208%	656248	99.08%	6	1.65%
瀰	2910		20	8	0.001208%	656256	99.08%	7	1.93%
炙	2911		8	8	0.001208%	656264	99.08%	8	2.20%
燙	2912		16	8	0.001208%	656272	99.08%	6	1.65%
琢	2913		12	8	0.001208%	656280	99.08%	7	1.93%
瑚	2914		13	8	0.001208%	656288	99.08%	7	1.93%
癱	2915		24	8	0.001208%	656296	99.09%	5	1.38%
眨	2916		10	8	0.001208%	656304	99.09%	6	1.65%
瞇	2917		15	8	0.001208%	656312	99.09%	6	1.65%
矢	2918		5	8	0.001208%	656320	99.09%	7	1.93%
紊	2919		10	8	0.001208%	656328	99.09%	5	1.38%
繹	2920		19	8	0.001208%	656336	99.09%	8	2.20%
翔	2921		12	8	0.001208%	656344	99.09%	8	2.20%
肢	2922		8	8	0.001208%	656352	99.09%	8	2.20%
苔	2923		9	8	0.001208%	656360	99.09%	6	1.65%
萍	2924		12	8	0.001208%	656368	99.10%	4	1.10%
蒲	2925		14	8	0.001208%	656376	99.10%	6	1.65%
蛤	2926		12	8	0.001208%	656384	99.10%	5	1.38%
蛻	2927		13	8	0.001208%	656392	99.10%	6	1.65%
蠣	2928		21	8	0.001208%	656400	99.10%	2	0.55%
訝	2929		11	8	0.001208%	656408	99.10%	5	1.38%
誓	2930		14	8	0.001208%	656416	99.10%	7	1.93%
譏	2931		19	8	0.001208%	656424	99.10%	6	1.65%
貞	2932		9	8	0.001208%	656432	99.11%	6	1.65%
賭	2933		15	8	0.001208%	656440	99.11%	7	1.93%
蹈	2934		17	8	0.001208%	656448	99.11%	7	1.93%
躬	2935		10	8	0.001208%	656456	99.11%	7	1.93%
轍	2936		18	8	0.001208%	656464	99.11%	8	2.20%
鄙	2937		13	8	0.001208%	656472	99.11%	7	1.93%
酋	2938		9	8	0.001208%	656480	99.11%	2	0.55%
釐	2939		18	8	0.001208%	656488	99.11%	8	2.20%
鈕	2940		12	8	0.001208%	656496	99.12%	5	1.38%
錘	2941		17	8	0.001208%	656504	99.12%	6	1.65%
鑄	2942		22	8	0.001208%	656512	99.12%	7	1.93%
闡	2943		20	8	0.001208%	656520	99.12%	7	1.93%
雛	2944		18	8	0.001208%	656528	99.12%	7	1.93%
霉	2945		15	8	0.001208%	656536	99.12%	5	1.38%
靄	2946		24	8	0.001208%	656544	99.12%	7	1.93%
鰹	2947		22	8	0.001208%	656552	99.12%	4	1.10%
鱸	2948		27	8	0.001208%	656560	99.12%	1	0.28%
黍	2949		12	8	0.001208%	656568	99.13%	4	1.10%
丙	2950		5	7	0.001057%	656575	99.13%	6	1.65%
侮	2951		9	7	0.001057%	656582	99.13%	6	1.65%
倪	2952		10	7	0.001057%	656589	99.13%	2	0.55%
偎	2953		11	7	0.001057%	656596	99.13%	4	1.10%
剌	2954		9	7	0.001057%	656603	99.13%	6	1.65%
匙	2955		11	7	0.001057%	656610	99.13%	3	0.83%
厘	2956		9	7	0.001057%	656617	99.13%	4	1.10%
咪	2957		9	7	0.001057%	656624	99.13%	4	1.10%
哄	2958		9	7	0.001057%	656631	99.14%	6	1.65%
咧	2959		9	7	0.001057%	656638	99.14%	5	1.38%
哼	2960		10	7	0.001057%	656645	99.14%	6	1.65%
哺	2961		10	7	0.001057%	656652	99.14%	3	0.83%
嗓	2962		13	7	0.001057%	656659	99.14%	6	1.65%
嘛	2963		14	7	0.001057%	656666	99.14%	4	1.10%
噩	2964		16	7	0.001057%	656673	99.14%	4	1.10%
囉	2965		22	7	0.001057%	656680	99.14%	6	1.65%
垮	2966		9	7	0.001057%	656687	99.14%	4	1.10%
堵	2967		11	7	0.001057%	656694	99.15%	7	1.93%
墅	2968		14	7	0.001057%	656701	99.15%	5	1.38%
壘	2969		18	7	0.001057%	656708	99.15%	7	1.93%
夭	2970		4	7	0.001057%	656715	99.15%	7	1.93%
姬	2971		10	7	0.001057%	656722	99.15%	4	1.10%
娶	2972		11	7	0.001057%	656729	99.15%	7	1.93%
媒	2973		12	7	0.001057%	656736	99.15%	5	1.38%
嫂	2974		12	7	0.001057%	656743	99.15%	3	0.83%
孱	2975		12	7	0.001057%	656750	99.15%	3	0.83%
宛	2976		8	7	0.001057%	656757	99.15%	5	1.38%
尉	2977		11	7	0.001057%	656764	99.16%	3	0.83%
屠	2978		11	7	0.001057%	656771	99.16%	4	1.10%
帛	2979		8	7	0.001057%	656778	99.16%	5	1.38%
廸	2980		8	7	0.001057%	656785	99.16%	4	1.10%
弓	2981		3	7	0.001057%	656792	99.16%	6	1.65%
弛	2982		6	7	0.001057%	656799	99.16%	6	1.65%
怡	2983		8	7	0.001057%	656806	99.16%	7	1.93%
慵	2984		14	7	0.001057%	656813	99.16%	5	1.38%
憧	2985		15	7	0.001057%	656820	99.16%	6	1.65%
憬	2986		15	7	0.001057%	656827	99.17%	6	1.65%
憩	2987		16	7	0.001057%	656834	99.17%	6	1.65%
拱	2988		9	7	0.001057%	656841	99.17%	6	1.65%
揀	2989		12	7	0.001057%	656848	99.17%	5	1.38%
搏	2990		13	7	0.001057%	656855	99.17%	5	1.38%
摔	2991		14	7	0.001057%	656862	99.17%	7	1.93%
撼	2992		16	7	0.001057%	656869	99.17%	7	1.93%
楂	2993		13	7	0.001057%	656876	99.17%	4	1.10%
櫻	2994		21	7	0.001057%	656883	99.17%	6	1.65%
歎	2995		15	7	0.001057%	656890	99.17%	6	1.65%
浬	2996		10	7	0.001057%	656897	99.18%	3	0.83%
淆	2997		11	7	0.001057%	656904	99.18%	6	1.65%
漩	2998		14	7	0.001057%	656911	99.18%	5	1.38%
澱	2999		16	7	0.001057%	656918	99.18%	4	1.10%
澡	3000		16	7	0.001057%	656925	99.18%	7	1.93%
瀉	3001		18	7	0.001057%	656932	99.18%	6	1.65%
灼	3002		7	7	0.001057%	656939	99.18%	6	1.65%
烹	3003		11	7	0.001057%	656946	99.18%	6	1.65%
煥	3004		13	7	0.001057%	656953	99.18%	6	1.65%
熄	3005		14	7	0.001057%	656960	99.19%	6	1.65%
熬	3006		15	7	0.001057%	656967	99.19%	6	1.65%
爰	3007		9	7	0.001057%	656974	99.19%	6	1.65%
狠	3008		9	7	0.001057%	656981	99.19%	6	1.65%
猖	3009		11	7	0.001057%	656988	99.19%	7	1.93%
猝	3010		11	7	0.001057%	656995	99.19%	2	0.55%
琶	3011		12	7	0.001057%	657002	99.19%	2	0.55%
瑟	3012		13	7	0.001057%	657009	99.19%	5	1.38%
甄	3013		14	7	0.001057%	657016	99.19%	2	0.55%
痴	3014		13	7	0.001057%	657023	99.19%	5	1.38%
瘓	3015		14	7	0.001057%	657030	99.20%	4	1.10%
盎	3016		10	7	0.001057%	657037	99.20%	7	1.93%
盧	3017		16	7	0.001057%	657044	99.20%	6	1.65%
眶	3018		11	7	0.001057%	657051	99.20%	6	1.65%
睹	3019		13	7	0.001057%	657058	99.20%	6	1.65%
矜	3020		9	7	0.001057%	657065	99.20%	7	1.93%
矩	3021		10	7	0.001057%	657072	99.20%	6	1.65%
磺	3022		17	7	0.001057%	657079	99.20%	4	1.10%
禦	3023		16	7	0.001057%	657086	99.20%	4	1.10%
稠	3024		13	7	0.001057%	657093	99.21%	5	1.38%
竣	3025		12	7	0.001057%	657100	99.21%	5	1.38%
箋	3026		14	7	0.001057%	657107	99.21%	4	1.10%
簀	3027		17	7	0.001057%	657114	99.21%	2	0.55%
簪	3028		18	7	0.001057%	657121	99.21%	2	0.55%
粧	3029		12	7	0.001057%	657128	99.21%	3	0.83%
綫	3030		14	7	0.001057%	657135	99.21%	2	0.55%
緞	3031		15	7	0.001057%	657142	99.21%	6	1.65%
縴	3032		17	7	0.001057%	657149	99.21%	2	0.55%
罕	3033		7	7	0.001057%	657156	99.21%	7	1.93%
罔	3034		8	7	0.001057%	657163	99.22%	5	1.38%
耍	3035		9	7	0.001057%	657170	99.22%	6	1.65%
聆	3036		11	7	0.001057%	657177	99.22%	7	1.93%
肇	3037		14	7	0.001057%	657184	99.22%	6	1.65%
腥	3038		13	7	0.001057%	657191	99.22%	7	1.93%
臆	3039		17	7	0.001057%	657198	99.22%	6	1.65%
舵	3040		11	7	0.001057%	657205	99.22%	4	1.10%
舷	3041		11	7	0.001057%	657212	99.22%	4	1.10%
莘	3042		11	7	0.001057%	657219	99.22%	3	0.83%
莽	3043		11	7	0.001057%	657226	99.23%	3	0.83%
莉	3044		11	7	0.001057%	657233	99.23%	5	1.38%
蒔	3045		14	7	0.001057%	657240	99.23%	3	0.83%
蛛	3046		12	7	0.001057%	657247	99.23%	5	1.38%
蟻	3047		19	7	0.001057%	657254	99.23%	5	1.38%
蠅	3048		19	7	0.001057%	657261	99.23%	5	1.38%
蠢	3049		21	7	0.001057%	657268	99.23%	6	1.65%
蠻	3050		25	7	0.001057%	657275	99.23%	6	1.65%
衹	3051		9	7	0.001057%	657282	99.23%	6	1.65%
詐	3052		12	7	0.001057%	657289	99.24%	7	1.93%
詭	3053		13	7	0.001057%	657296	99.24%	7	1.93%
賬	3054		15	7	0.001057%	657303	99.24%	5	1.38%
踱	3055		16	7	0.001057%	657310	99.24%	4	1.10%
躁	3056		20	7	0.001057%	657317	99.24%	6	1.65%
軒	3057		10	7	0.001057%	657324	99.24%	7	1.93%
轎	3058		19	7	0.001057%	657331	99.24%	5	1.38%
逛	3059		10	7	0.001057%	657338	99.24%	5	1.38%
郤	3060		9	7	0.001057%	657345	99.24%	5	1.38%
醋	3061		15	7	0.001057%	657352	99.24%	7	1.93%
釁	3062		25	7	0.001057%	657359	99.25%	4	1.10%
鋪	3063		15	7	0.001057%	657366	99.25%	7	1.93%
闕	3064		18	7	0.001057%	657373	99.25%	7	1.93%
雁	3065		12	7	0.001057%	657380	99.25%	5	1.38%
鞠	3066		17	7	0.001057%	657387	99.25%	6	1.65%
騁	3067		17	7	0.001057%	657394	99.25%	7	1.93%
驢	3068		26	7	0.001057%	657401	99.25%	4	1.10%
髦	3069		14	7	0.001057%	657408	99.25%	6	1.65%
鬢	3070		24	7	0.001057%	657415	99.25%	7	1.93%
魅	3071		15	7	0.001057%	657422	99.26%	5	1.38%
黝	3072		17	7	0.001057%	657429	99.26%	4	1.10%
龜	3073		16	7	0.001057%	657436	99.26%	5	1.38%
佑	3074		7	6	0.0009059%	657442	99.26%	5	1.38%
侈	3075		8	6	0.0009059%	657448	99.26%	4	1.10%
侖	3076		8	6	0.0009059%	657454	99.26%	4	1.10%
偕	3077		11	6	0.0009059%	657460	99.26%	5	1.38%
傅	3078		12	6	0.0009059%	657466	99.26%	5	1.38%
傖	3079		12	6	0.0009059%	657472	99.26%	4	1.10%
傭	3080		13	6	0.0009059%	657478	99.26%	5	1.38%
儼	3081		22	6	0.0009059%	657484	99.26%	6	1.65%
兔	3082		8	6	0.0009059%	657490	99.27%	5	1.38%
凳	3083		14	6	0.0009059%	657496	99.27%	5	1.38%
卉	3084		5	6	0.0009059%	657502	99.27%	3	0.83%
叩	3085		5	6	0.0009059%	657508	99.27%	6	1.65%
吓	3086		6	6	0.0009059%	657514	99.27%	4	1.10%
吆	3087		6	6	0.0009059%	657520	99.27%	4	1.10%
呎	3088		7	6	0.0009059%	657526	99.27%	3	0.83%
呂	3089		7	6	0.0009059%	657532	99.27%	5	1.38%
咐	3090		8	6	0.0009059%	657538	99.27%	5	1.38%
咎	3091		8	6	0.0009059%	657544	99.27%	6	1.65%
啜	3092		11	6	0.0009059%	657550	99.27%	5	1.38%
噎	3093		15	6	0.0009059%	657556	99.28%	5	1.38%
噹	3094		16	6	0.0009059%	657562	99.28%	2	0.55%
嚀	3095		17	6	0.0009059%	657568	99.28%	5	1.38%
嚶	3096		20	6	0.0009059%	657574	99.28%	3	0.83%
囀	3097		21	6	0.0009059%	657580	99.28%	6	1.65%
坎	3098		7	6	0.0009059%	657586	99.28%	6	1.65%
圾	3099		7	6	0.0009059%	657592	99.28%	5	1.38%
垃	3100		8	6	0.0009059%	657598	99.28%	5	1.38%
塭	3101		13	6	0.0009059%	657604	99.28%	3	0.83%
塢	3102		13	6	0.0009059%	657610	99.28%	6	1.65%
壹	3103		12	6	0.0009059%	657616	99.28%	5	1.38%
奚	3104		10	6	0.0009059%	657622	99.29%	5	1.38%
孜	3105		7	6	0.0009059%	657628	99.29%	3	0.83%
屁	3106		7	6	0.0009059%	657634	99.29%	5	1.38%
峯	3107		10	6	0.0009059%	657640	99.29%	3	0.83%
廝	3108		15	6	0.0009059%	657646	99.29%	6	1.65%
恤	3109		9	6	0.0009059%	657652	99.29%	4	1.10%
恙	3110		10	6	0.0009059%	657658	99.29%	5	1.38%
惋	3111		11	6	0.0009059%	657664	99.29%	6	1.65%
惚	3112		11	6	0.0009059%	657670	99.29%	4	1.10%
懺	3113		20	6	0.0009059%	657676	99.29%	5	1.38%
拴	3114		9	6	0.0009059%	657682	99.29%	5	1.38%
摒	3115		12	6	0.0009059%	657688	99.30%	6	1.65%
携	3116		13	6	0.0009059%	657694	99.30%	6	1.65%
搓	3117		13	6	0.0009059%	657700	99.30%	5	1.38%
撓	3118		15	6	0.0009059%	657706	99.30%	6	1.65%
擅	3119		16	6	0.0009059%	657712	99.30%	6	1.65%
斛	3120		11	6	0.0009059%	657718	99.30%	3	0.83%
斟	3121		13	6	0.0009059%	657724	99.30%	5	1.38%
曠	3122		19	6	0.0009059%	657730	99.30%	6	1.65%
棋	3123		12	6	0.0009059%	657736	99.30%	5	1.38%
榔	3124		13	6	0.0009059%	657742	99.30%	4	1.10%
楠	3125		13	6	0.0009059%	657748	99.30%	3	0.83%
楞	3126		13	6	0.0009059%	657754	99.31%	3	0.83%
槓	3127		14	6	0.0009059%	657760	99.31%	3	0.83%
榖	3128		14	6	0.0009059%	657766	99.31%	4	1.10%
櫈	3129		17	6	0.0009059%	657772	99.31%	4	1.10%
檔	3130		17	6	0.0009059%	657778	99.31%	2	0.55%
歹	3131		4	6	0.0009059%	657784	99.31%	6	1.65%
毯	3132		12	6	0.0009059%	657790	99.31%	6	1.65%
氤	3133		10	6	0.0009059%	657796	99.31%	4	1.10%
氯	3134		12	6	0.0009059%	657802	99.31%	4	1.10%
汀	3135		5	6	0.0009059%	657808	99.31%	4	1.10%
汲	3136		7	6	0.0009059%	657814	99.31%	4	1.10%
沱	3137		8	6	0.0009059%	657820	99.32%	1	0.28%
涕	3138		10	6	0.0009059%	657826	99.32%	5	1.38%
浣	3139		10	6	0.0009059%	657832	99.32%	4	1.10%
淤	3140		11	6	0.0009059%	657838	99.32%	2	0.55%
涸	3141		11	6	0.0009059%	657844	99.32%	3	0.83%
漣	3142		14	6	0.0009059%	657850	99.32%	6	1.65%
滬	3143		14	6	0.0009059%	657856	99.32%	5	1.38%
潰	3144		15	6	0.0009059%	657862	99.32%	5	1.38%
濡	3145		17	6	0.0009059%	657868	99.32%	5	1.38%
煽	3146		14	6	0.0009059%	657874	99.32%	5	1.38%
狼	3147		10	6	0.0009059%	657880	99.32%	6	1.65%
璜	3148		16	6	0.0009059%	657886	99.33%	5	1.38%
甦	3149		12	6	0.0009059%	657892	99.33%	5	1.38%
畸	3150		13	6	0.0009059%	657898	99.33%	5	1.38%
疵	3151		11	6	0.0009059%	657904	99.33%	6	1.65%
皓	3152		12	6	0.0009059%	657910	99.33%	5	1.38%
睦	3153		13	6	0.0009059%	657916	99.33%	4	1.10%
瞪	3154		17	6	0.0009059%	657922	99.33%	6	1.65%
瞻	3155		18	6	0.0009059%	657928	99.33%	6	1.65%
碑	3156		13	6	0.0009059%	657934	99.33%	6	1.65%
祕	3157		9	6	0.0009059%	657940	99.33%	4	1.10%
禧	3158		16	6	0.0009059%	657946	99.33%	2	0.55%
秉	3159		8	6	0.0009059%	657952	99.34%	4	1.10%
穀	3160		15	6	0.0009059%	657958	99.34%	4	1.10%
窒	3161		11	6	0.0009059%	657964	99.34%	5	1.38%
筷	3162		13	6	0.0009059%	657970	99.34%	5	1.38%
籤	3163		23	6	0.0009059%	657976	99.34%	5	1.38%
籽	3164		9	6	0.0009059%	657982	99.34%	4	1.10%
絃	3165		11	6	0.0009059%	657988	99.34%	4	1.10%
絀	3166		11	6	0.0009059%	657994	99.34%	6	1.65%
綻	3167		14	6	0.0009059%	658000	99.34%	6	1.65%
綺	3168		14	6	0.0009059%	658006	99.34%	6	1.65%
緬	3169		15	6	0.0009059%	658012	99.34%	4	1.10%
繆	3170		17	6	0.0009059%	658018	99.35%	6	1.65%
缽	3171		11	6	0.0009059%	658024	99.35%	4	1.10%
羈	3172		24	6	0.0009059%	658030	99.35%	6	1.65%
聾	3173		22	6	0.0009059%	658036	99.35%	5	1.38%
胰	3174		10	6	0.0009059%	658042	99.35%	4	1.10%
舢	3175		9	6	0.0009059%	658048	99.35%	5	1.38%
芥	3176		8	6	0.0009059%	658054	99.35%	3	0.83%
茁	3177		9	6	0.0009059%	658060	99.35%	5	1.38%
荃	3178		10	6	0.0009059%	658066	99.35%	3	0.83%
薑	3179		17	6	0.0009059%	658072	99.35%	4	1.10%
裔	3180		13	6	0.0009059%	658078	99.35%	2	0.55%
裊	3181		13	6	0.0009059%	658084	99.36%	3	0.83%
裨	3182		13	6	0.0009059%	658090	99.36%	5	1.38%
謠	3183		17	6	0.0009059%	658096	99.36%	6	1.65%
贅	3184		18	6	0.0009059%	658102	99.36%	6	1.65%
踪	3185		14	6	0.0009059%	658108	99.36%	5	1.38%
踞	3186		15	6	0.0009059%	658114	99.36%	5	1.38%
蹲	3187		19	6	0.0009059%	658120	99.36%	6	1.65%
躊	3188		21	6	0.0009059%	658126	99.36%	5	1.38%
躭	3189		11	6	0.0009059%	658132	99.36%	5	1.38%
轄	3190		17	6	0.0009059%	658138	99.36%	5	1.38%
輾	3191		17	6	0.0009059%	658144	99.36%	6	1.65%
鄧	3192		14	6	0.0009059%	658150	99.36%	5	1.38%
醞	3193		17	6	0.0009059%	658156	99.37%	6	1.65%
銘	3194		14	6	0.0009059%	658162	99.37%	6	1.65%
閨	3195		14	6	0.0009059%	658168	99.37%	6	1.65%
雇	3196		12	6	0.0009059%	658174	99.37%	4	1.10%
雋	3197		13	6	0.0009059%	658180	99.37%	5	1.38%
霓	3198		16	6	0.0009059%	658186	99.37%	6	1.65%
靖	3199		13	6	0.0009059%	658192	99.37%	5	1.38%
靡	3200		19	6	0.0009059%	658198	99.37%	5	1.38%
靨	3201		23	6	0.0009059%	658204	99.37%	3	0.83%
靴	3202		13	6	0.0009059%	658210	99.37%	3	0.83%
餵	3203		17	6	0.0009059%	658216	99.37%	3	0.83%
鯖	3204		19	6	0.0009059%	658222	99.38%	3	0.83%
鷹	3205		24	6	0.0009059%	658228	99.38%	4	1.10%
麟	3206		23	6	0.0009059%	658234	99.38%	5	1.38%
黴	3207		23	6	0.0009059%	658240	99.38%	3	0.83%
亘	3208		6	5	0.0007549%	658245	99.38%	5	1.38%
亢	3209		4	5	0.0007549%	658250	99.38%	5	1.38%
俠	3210		9	5	0.0007549%	658255	99.38%	4	1.10%
俘	3211		9	5	0.0007549%	658260	99.38%	5	1.38%
倣	3212		10	5	0.0007549%	658265	99.38%	5	1.38%
兆	3213		6	5	0.0007549%	658270	99.38%	5	1.38%
兌	3214		7	5	0.0007549%	658275	99.38%	3	0.83%
冕	3215		11	5	0.0007549%	658280	99.38%	5	1.38%
冤	3216		10	5	0.0007549%	658285	99.39%	5	1.38%
凈	3217		10	5	0.0007549%	658290	99.39%	3	0.83%
刁	3218		2	5	0.0007549%	658295	99.39%	3	0.83%
剋	3219		9	5	0.0007549%	658300	99.39%	5	1.38%
匿	3220		11	5	0.0007549%	658305	99.39%	5	1.38%
咆	3221		8	5	0.0007549%	658310	99.39%	4	1.10%
哇	3222		9	5	0.0007549%	658315	99.39%	5	1.38%
咱	3223		9	5	0.0007549%	658320	99.39%	5	1.38%
哨	3224		10	5	0.0007549%	658325	99.39%	5	1.38%
啣	3225		11	5	0.0007549%	658330	99.39%	5	1.38%
喂	3226		12	5	0.0007549%	658335	99.39%	4	1.10%
喲	3227		12	5	0.0007549%	658340	99.39%	3	0.83%
啾	3228		12	5	0.0007549%	658345	99.39%	2	0.55%
嗯	3229		13	5	0.0007549%	658350	99.40%	3	0.83%
嘟	3230		13	5	0.0007549%	658355	99.40%	2	0.55%
嗒	3231		13	5	0.0007549%	658360	99.40%	4	1.10%
噤	3232		16	5	0.0007549%	658365	99.40%	4	1.10%
嚕	3233		18	5	0.0007549%	658370	99.40%	4	1.10%
囿	3234		9	5	0.0007549%	658375	99.40%	4	1.10%
坊	3235		7	5	0.0007549%	658380	99.40%	5	1.38%
塌	3236		13	5	0.0007549%	658385	99.40%	5	1.38%
墟	3237		15	5	0.0007549%	658390	99.40%	4	1.10%
墾	3238		16	5	0.0007549%	658395	99.40%	3	0.83%
墻	3239		16	5	0.0007549%	658400	99.40%	3	0.83%
壟	3240		19	5	0.0007549%	658405	99.40%	4	1.10%
姘	3241		9	5	0.0007549%	658410	99.40%	2	0.55%
嫣	3242		14	5	0.0007549%	658415	99.41%	5	1.38%
嬤	3243		17	5	0.0007549%	658420	99.41%	1	0.28%
巔	3244		22	5	0.0007549%	658425	99.41%	5	1.38%
巳	3245		3	5	0.0007549%	658430	99.41%	2	0.55%
幟	3246		15	5	0.0007549%	658435	99.41%	5	1.38%
庵	3247		11	5	0.0007549%	658440	99.41%	2	0.55%
廂	3248		12	5	0.0007549%	658445	99.41%	5	1.38%
廼	3249		9	5	0.0007549%	658450	99.41%	2	0.55%
弗	3250		5	5	0.0007549%	658455	99.41%	5	1.38%
彥	3251		9	5	0.0007549%	658460	99.41%	3	0.83%
徉	3252		9	5	0.0007549%	658465	99.41%	5	1.38%
徙	3253		11	5	0.0007549%	658470	99.41%	4	1.10%
怔	3254		8	5	0.0007549%	658475	99.41%	5	1.38%
恃	3255		9	5	0.0007549%	658480	99.41%	5	1.38%
悖	3256		10	5	0.0007549%	658485	99.42%	3	0.83%
慄	3257		13	5	0.0007549%	658490	99.42%	5	1.38%
愫	3258		13	5	0.0007549%	658495	99.42%	4	1.10%
慷	3259		14	5	0.0007549%	658500	99.42%	5	1.38%
懈	3260		16	5	0.0007549%	658505	99.42%	5	1.38%
戎	3261		6	5	0.0007549%	658510	99.42%	5	1.38%
戕	3262		8	5	0.0007549%	658515	99.42%	4	1.10%
戳	3263		18	5	0.0007549%	658520	99.42%	4	1.10%
扉	3264		12	5	0.0007549%	658525	99.42%	5	1.38%
拚	3265		8	5	0.0007549%	658530	99.42%	3	0.83%
拮	3266		9	5	0.0007549%	658535	99.42%	3	0.83%
廼	3267		12	5	0.0007549%	658540	99.42%	5	1.38%
撇	3268		14	5	0.0007549%	658545	99.42%	5	1.38%
撮	3269		15	5	0.0007549%	658550	99.43%	5	1.38%
擄	3270		16	5	0.0007549%	658555	99.43%	5	1.38%
敊	3271		10	5	0.0007549%	658560	99.43%	4	1.10%
敞	3272		12	5	0.0007549%	658565	99.43%	5	1.38%
斧	3273		8	5	0.0007549%	658570	99.43%	3	0.83%
晦	3274		11	5	0.0007549%	658575	99.43%	4	1.10%
枷	3275		9	5	0.0007549%	658580	99.43%	4	1.10%
桓	3276		10	5	0.0007549%	658585	99.43%	5	1.38%
梭	3277		11	5	0.0007549%	658590	99.43%	4	1.10%
椎	3278		12	5	0.0007549%	658595	99.43%	3	0.83%
椏	3279		12	5	0.0007549%	658600	99.43%	4	1.10%
椰	3280		13	5	0.0007549%	658605	99.43%	3	0.83%
楯	3281		13	5	0.0007549%	658610	99.43%	2	0.55%
榕	3282		14	5	0.0007549%	658615	99.44%	3	0.83%
樟	3283		15	5	0.0007549%	658620	99.44%	2	0.55%
樊	3284		15	5	0.0007549%	658625	99.44%	4	1.10%
欖	3285		25	5	0.0007549%	658630	99.44%	3	0.83%
毗	3286		9	5	0.0007549%	658635	99.44%	3	0.83%
氓	3287		8	5	0.0007549%	658640	99.44%	5	1.38%
汰	3288		7	5	0.0007549%	658645	99.44%	5	1.38%
沃	3289		7	5	0.0007549%	658650	99.44%	3	0.83%
泅	3290		8	5	0.0007549%	658655	99.44%	2	0.55%
浙	3291		10	5	0.0007549%	658660	99.44%	5	1.38%
涓	3292		10	5	0.0007549%	658665	99.44%	3	0.83%
涅	3293		10	5	0.0007549%	658670	99.44%	4	1.10%
淇	3294		11	5	0.0007549%	658675	99.44%	2	0.55%
涪	3295		11	5	0.0007549%	658680	99.45%	1	0.28%
滄	3296		13	5	0.0007549%	658685	99.45%	5	1.38%
滷	3297		14	5	0.0007549%	658690	99.45%	2	0.55%
瀚	3298		19	5	0.0007549%	658695	99.45%	5	1.38%
炊	3299		8	5	0.0007549%	658700	99.45%	4	1.10%
烙	3300		10	5	0.0007549%	658705	99.45%	5	1.38%
煎	3301		13	5	0.0007549%	658710	99.45%	4	1.10%
熙	3302		14	5	0.0007549%	658715	99.45%	4	1.10%
狐	3303		8	5	0.0007549%	658720	99.45%	5	1.38%
猴	3304		12	5	0.0007549%	658725	99.45%	5	1.38%
玆	3305		10	5	0.0007549%	658730	99.45%	4	1.10%
瑯	3306		13	5	0.0007549%	658735	99.45%	4	1.10%
瑜	3307		13	5	0.0007549%	658740	99.45%	2	0.55%
痺	3308		13	5	0.0007549%	658745	99.45%	4	1.10%
瘤	3309		15	5	0.0007549%	658750	99.46%	4	1.10%
癥	3310		20	5	0.0007549%	658755	99.46%	5	1.38%
盔	3311		11	5	0.0007549%	658760	99.46%	1	0.28%
瞞	3312		16	5	0.0007549%	658765	99.46%	5	1.38%
瞟	3313		16	5	0.0007549%	658770	99.46%	5	1.38%
瞥	3314		16	5	0.0007549%	658775	99.46%	5	1.38%
瞰	3315		17	5	0.0007549%	658780	99.46%	5	1.38%
矗	3316		24	5	0.0007549%	658785	99.46%	5	1.38%
砒	3317		9	5	0.0007549%	658790	99.46%	3	0.83%
硯	3318		12	5	0.0007549%	658795	99.46%	3	0.83%
碚	3319		13	5	0.0007549%	658800	99.46%	1	0.28%
礫	3320		20	5	0.0007549%	658805	99.46%	2	0.55%
禎	3321		13	5	0.0007549%	658810	99.46%	2	0.55%
穢	3322		18	5	0.0007549%	658815	99.47%	5	1.38%
窖	3323		12	5	0.0007549%	658820	99.47%	2	0.55%
竄	3324		18	5	0.0007549%	658825	99.47%	5	1.38%
箕	3325		14	5	0.0007549%	658830	99.47%	5	1.38%
箇	3326		14	5	0.0007549%	658835	99.47%	2	0.55%
簇	3327		17	5	0.0007549%	658840	99.47%	5	1.38%
篾	3328		17	5	0.0007549%	658845	99.47%	3	0.83%
篷	3329		17	5	0.0007549%	658850	99.47%	4	1.10%
粱	3330		13	5	0.0007549%	658855	99.47%	1	0.28%
紳	3331		11	5	0.0007549%	658860	99.47%	4	1.10%
絮	3332		12	5	0.0007549%	658865	99.47%	4	1.10%
綽	3333		14	5	0.0007549%	658870	99.47%	5	1.38%
罄	3334		17	5	0.0007549%	658875	99.47%	5	1.38%
翡	3335		14	5	0.0007549%	658880	99.48%	5	1.38%
翽	3336		19	5	0.0007549%	658885	99.48%	3	0.83%
耘	3337		10	5	0.0007549%	658890	99.48%	5	1.38%
肛	3338		7	5	0.0007549%	658895	99.48%	2	0.55%
胚	3339		9	5	0.0007549%	658900	99.48%	4	1.10%
胱	3340		10	5	0.0007549%	658905	99.48%	2	0.55%
腮	3341		13	5	0.0007549%	658910	99.48%	5	1.38%
膏	3342		14	5	0.0007549%	658915	99.48%	4	1.10%
膊	3343		14	5	0.0007549%	658920	99.48%	3	0.83%
膺	3344		17	5	0.0007549%	658925	99.48%	4	1.10%
臀	3345		17	5	0.0007549%	658930	99.48%	5	1.38%
臍	3346		18	5	0.0007549%	658935	99.48%	3	0.83%
臧	3347		14	5	0.0007549%	658940	99.48%	2	0.55%
芋	3348		7	5	0.0007549%	658945	99.49%	3	0.83%
芹	3349		8	5	0.0007549%	658950	99.49%	3	0.83%
苑	3350		9	5	0.0007549%	658955	99.49%	4	1.10%
芻	3351		10	5	0.0007549%	658960	99.49%	5	1.38%
茗	3352		10	5	0.0007549%	658965	99.49%	2	0.55%
莧	3353		11	5	0.0007549%	658970	99.49%	1	0.28%
萣	3354		12	5	0.0007549%	658975	99.49%	4	1.10%
葦	3355		13	5	0.0007549%	658980	99.49%	3	0.83%
蔓	3356		15	5	0.0007549%	658985	99.49%	5	1.38%
薯	3357		17	5	0.0007549%	658990	99.49%	4	1.10%
蘸	3358		23	5	0.0007549%	658995	99.49%	3	0.83%
蛾	3359		13	5	0.0007549%	659000	99.49%	3	0.83%
蜘	3360		14	5	0.0007549%	659005	99.49%	4	1.10%
蟆	3361		17	5	0.0007549%	659010	99.49%	3	0.83%
蠕	3362		20	5	0.0007549%	659015	99.50%	3	0.83%
褚	3363		13	5	0.0007549%	659020	99.50%	3	0.83%
褔	3364		14	5	0.0007549%	659025	99.50%	4	1.10%
詠	3365		12	5	0.0007549%	659030	99.50%	3	0.83%
詫	3366		13	5	0.0007549%	659035	99.50%	3	0.83%
諦	3367		16	5	0.0007549%	659040	99.50%	4	1.10%
諺	3368		16	5	0.0007549%	659045	99.50%	4	1.10%
謊	3369		17	5	0.0007549%	659050	99.50%	4	1.10%
謐	3370		17	5	0.0007549%	659055	99.50%	5	1.38%
豁	3371		17	5	0.0007549%	659060	99.50%	5	1.38%
贓	3372		21	5	0.0007549%	659065	99.50%	2	0.55%
躇	3373		19	5	0.0007549%	659070	99.50%	4	1.10%
輒	3374		14	5	0.0007549%	659075	99.50%	5	1.38%
迨	3375		8	5	0.0007549%	659080	99.51%	5	1.38%
逞	3376		10	5	0.0007549%	659085	99.51%	5	1.38%
逮	3377		11	5	0.0007549%	659090	99.51%	3	0.83%
遐	3378		12	5	0.0007549%	659095	99.51%	5	1.38%
遑	3379		12	5	0.0007549%	659100	99.51%	5	1.38%
酵	3380		14	5	0.0007549%	659105	99.51%	4	1.10%
鈔	3381		12	5	0.0007549%	659110	99.51%	4	1.10%
鈍	3382		12	5	0.0007549%	659115	99.51%	5	1.38%
錚	3383		16	5	0.0007549%	659120	99.51%	1	0.28%
鍛	3384		17	5	0.0007549%	659125	99.51%	4	1.10%
鏈	3385		19	5	0.0007549%	659130	99.51%	4	1.10%
鐲	3386		21	5	0.0007549%	659135	99.51%	2	0.55%
鑛	3387		23	5	0.0007549%	659140	99.51%	3	0.83%
閭	3388		15	5	0.0007549%	659145	99.52%	4	1.10%
闌	3389		17	5	0.0007549%	659150	99.52%	4	1.10%
阱	3390		6	5	0.0007549%	659155	99.52%	5	1.38%
陀	3391		7	5	0.0007549%	659160	99.52%	5	1.38%
隸	3392		17	5	0.0007549%	659165	99.52%	5	1.38%
雌	3393		14	5	0.0007549%	659170	99.52%	3	0.83%
霸	3394		21	5	0.0007549%	659175	99.52%	5	1.38%
韙	3395		18	5	0.0007549%	659180	99.52%	3	0.83%
韶	3396		14	5	0.0007549%	659185	99.52%	4	1.10%
飭	3397		12	5	0.0007549%	659190	99.52%	3	0.83%
饑	3398		20	5	0.0007549%	659195	99.52%	5	1.38%
駿	3399		17	5	0.0007549%	659200	99.52%	3	0.83%
驀	3400		21	5	0.0007549%	659205	99.52%	5	1.38%
驛	3401		23	5	0.0007549%	659210	99.53%	2	0.55%
髯	3402		15	5	0.0007549%	659215	99.53%	4	1.10%
魁	3403		14	5	0.0007549%	659220	99.53%	5	1.38%
鯛	3404		19	5	0.0007549%	659225	99.53%	1	0.28%
鶯	3405		21	5	0.0007549%	659230	99.53%	4	1.10%
麴	3406		19	5	0.0007549%	659235	99.53%	2	0.55%
黏	3407		17	5	0.0007549%	659240	99.53%	4	1.10%
丑	3408		4	4	0.0006039%	659244	99.53%	3	0.83%
佣	3409		7	4	0.0006039%	659248	99.53%	4	1.10%
佬	3410		8	4	0.0006039%	659252	99.53%	3	0.83%
侃	3411		8	4	0.0006039%	659256	99.53%	3	0.83%
佼	3412		8	4	0.0006039%	659260	99.53%	2	0.55%
倔	3413		10	4	0.0006039%	659264	99.53%	2	0.55%
兢	3414		14	4	0.0006039%	659268	99.53%	2	0.55%
冗	3415		4	4	0.0006039%	659272	99.53%	2	0.55%
决	3416		6	4	0.0006039%	659276	99.53%	3	0.83%
凜	3417		15	4	0.0006039%	659280	99.54%	4	1.10%
凰	3418		11	4	0.0006039%	659284	99.54%	4	1.10%
剷	3419		13	4	0.0006039%	659288	99.54%	1	0.28%
効	3420		8	4	0.0006039%	659292	99.54%	2	0.55%
厄	3421		4	4	0.0006039%	659296	99.54%	4	1.10%
吶	3422		7	4	0.0006039%	659300	99.54%	4	1.10%
吠	3423		7	4	0.0006039%	659304	99.54%	2	0.55%
咦	3424		9	4	0.0006039%	659308	99.54%	1	0.28%
哮	3425		10	4	0.0006039%	659312	99.54%	3	0.83%
哦	3426		10	4	0.0006039%	659316	99.54%	4	1.10%
哽	3427		10	4	0.0006039%	659320	99.54%	3	0.83%
唏	3428		10	4	0.0006039%	659324	99.54%	2	0.55%
嗇	3429		13	4	0.0006039%	659328	99.54%	2	0.55%
嘔	3430		14	4	0.0006039%	659332	99.54%	3	0.83%
嘹	3431		15	4	0.0006039%	659336	99.54%	3	0.83%
嘿	3432		15	4	0.0006039%	659340	99.54%	1	0.28%
噯	3433		16	4	0.0006039%	659344	99.55%	3	0.83%
噢	3434		16	4	0.0006039%	659348	99.55%	3	0.83%
囌	3435		23	4	0.0006039%	659352	99.55%	4	1.10%
垠	3436		9	4	0.0006039%	659356	99.55%	3	0.83%
垣	3437		9	4	0.0006039%	659360	99.55%	4	1.10%
埕	3438		10	4	0.0006039%	659364	99.55%	1	0.28%
壑	3439		17	4	0.0006039%	659368	99.55%	2	0.55%
壬	3440		4	4	0.0006039%	659372	99.55%	3	0.83%
壼	3441		13	4	0.0006039%	659376	99.55%	2	0.55%
妝	3442		7	4	0.0006039%	659380	99.55%	4	1.10%
孽	3443		20	4	0.0006039%	659384	99.55%	4	1.10%
窰	3444		15	4	0.0006039%	659388	99.55%	2	0.55%
尬	3445		7	4	0.0006039%	659392	99.55%	3	0.83%
尷	3446		17	4	0.0006039%	659396	99.55%	3	0.83%
屎	3447		9	4	0.0006039%	659400	99.55%	2	0.55%
峙	3448		9	4	0.0006039%	659404	99.55%	4	1.10%
崑	3449		11	4	0.0006039%	659408	99.55%	4	1.10%
嶇	3450		14	4	0.0006039%	659412	99.56%	4	1.10%
帘	3451		8	4	0.0006039%	659416	99.56%	4	1.10%
廛	3452		15	4	0.0006039%	659420	99.56%	2	0.55%
徜	3453		11	4	0.0006039%	659424	99.56%	4	1.10%
徨	3454		12	4	0.0006039%	659428	99.56%	3	0.83%
徬	3455		13	4	0.0006039%	659432	99.56%	3	0.83%
忖	3456		6	4	0.0006039%	659436	99.56%	4	1.10%
怏	3457		8	4	0.0006039%	659440	99.56%	2	0.55%
怵	3458		8	4	0.0006039%	659444	99.56%	4	1.10%
怠	3459		9	4	0.0006039%	659448	99.56%	4	1.10%
恂	3460		9	4	0.0006039%	659452	99.56%	2	0.55%
悼	3461		11	4	0.0006039%	659456	99.56%	4	1.10%
慇	3462		14	4	0.0006039%	659460	99.56%	4	1.10%
憊	3463		16	4	0.0006039%	659464	99.56%	4	1.10%
懦	3464		17	4	0.0006039%	659468	99.56%	4	1.10%
懿	3465		22	4	0.0006039%	659472	99.56%	4	1.10%
戍	3466		6	4	0.0006039%	659476	99.57%	2	0.55%
扼	3467		7	4	0.0006039%	659480	99.57%	4	1.10%
拐	3468		8	4	0.0006039%	659484	99.57%	4	1.10%
担	3469		8	4	0.0006039%	659488	99.57%	3	0.83%
揍	3470		12	4	0.0006039%	659492	99.57%	2	0.55%
揣	3471		12	4	0.0006039%	659496	99.57%	4	1.10%
攣	3472		23	4	0.0006039%	659500	99.57%	3	0.83%
攬	3473		24	4	0.0006039%	659504	99.57%	4	1.10%
旭	3474		6	4	0.0006039%	659508	99.57%	3	0.83%
晌	3475		10	4	0.0006039%	659512	99.57%	3	0.83%
暪	3476		15	4	0.0006039%	659516	99.57%	1	0.28%
曙	3477		17	4	0.0006039%	659520	99.57%	4	1.10%
柬	3478		9	4	0.0006039%	659524	99.57%	4	1.10%
栩	3479		10	4	0.0006039%	659528	99.57%	2	0.55%
栖	3480		10	4	0.0006039%	659532	99.57%	2	0.55%
梵	3481		11	4	0.0006039%	659536	99.57%	3	0.83%
楣	3482		13	4	0.0006039%	659540	99.57%	1	0.28%
榷	3483		14	4	0.0006039%	659544	99.58%	4	1.10%
榭	3484		14	4	0.0006039%	659548	99.58%	3	0.83%
橄	3485		16	4	0.0006039%	659552	99.58%	2	0.55%
檐	3486		17	4	0.0006039%	659556	99.58%	1	0.28%
櫚	3487		19	4	0.0006039%	659560	99.58%	3	0.83%
毆	3488		15	4	0.0006039%	659564	99.58%	4	1.10%
氈	3489		17	4	0.0006039%	659568	99.58%	1	0.28%
氳	3490		14	4	0.0006039%	659572	99.58%	3	0.83%
汹	3491		7	4	0.0006039%	659576	99.58%	4	1.10%
沽	3492		8	4	0.0006039%	659580	99.58%	4	1.10%
泓	3493		8	4	0.0006039%	659584	99.58%	2	0.55%
沮	3494		8	4	0.0006039%	659588	99.58%	3	0.83%
沬	3495		8	4	0.0006039%	659592	99.58%	3	0.83%
泯	3496		8	4	0.0006039%	659596	99.58%	3	0.83%
淌	3497		11	4	0.0006039%	659600	99.58%	4	1.10%
淅	3498		11	4	0.0006039%	659604	99.58%	2	0.55%
淮	3499		11	4	0.0006039%	659608	99.59%	4	1.10%
渥	3500		12	4	0.0006039%	659612	99.59%	3	0.83%
湃	3501		12	4	0.0006039%	659616	99.59%	4	1.10%
渝	3502		12	4	0.0006039%	659620	99.59%	3	0.83%
漳	3503		14	4	0.0006039%	659624	99.59%	4	1.10%
漓	3504		14	4	0.0006039%	659628	99.59%	4	1.10%
澹	3505		16	4	0.0006039%	659632	99.59%	3	0.83%
瀑	3506		18	4	0.0006039%	659636	99.59%	3	0.83%
瀕	3507		19	4	0.0006039%	659640	99.59%	4	1.10%
炫	3508		9	4	0.0006039%	659644	99.59%	4	1.10%
烽	3509		11	4	0.0006039%	659648	99.59%	3	0.83%
煊	3510		13	4	0.0006039%	659652	99.59%	2	0.55%
熔	3511		14	4	0.0006039%	659656	99.59%	3	0.83%
熾	3512		16	4	0.0006039%	659660	99.59%	4	1.10%
犀	3513		12	4	0.0006039%	659664	99.59%	4	1.10%
獗	3514		15	4	0.0006039%	659668	99.59%	4	1.10%
琤	3515		12	4	0.0006039%	659672	99.59%	2	0.55%
瑤	3516		14	4	0.0006039%	659676	99.60%	3	0.83%
瑩	3517		15	4	0.0006039%	659680	99.60%	4	1.10%
瑾	3518		15	4	0.0006039%	659684	99.60%	3	0.83%
疚	3519		8	4	0.0006039%	659688	99.60%	3	0.83%
疹	3520		10	4	0.0006039%	659692	99.60%	3	0.83%
痙	3521		12	4	0.0006039%	659696	99.60%	3	0.83%
瘧	3522		14	4	0.0006039%	659700	99.60%	3	0.83%
瘌	3523		14	4	0.0006039%	659704	99.60%	1	0.28%
瘠	3524		15	4	0.0006039%	659708	99.60%	4	1.10%
瘴	3525		16	4	0.0006039%	659712	99.60%	4	1.10%
癆	3526		17	4	0.0006039%	659716	99.60%	3	0.83%
癖	3527		18	4	0.0006039%	659720	99.60%	3	0.83%
盂	3528		8	4	0.0006039%	659724	99.60%	3	0.83%
睫	3529		13	4	0.0006039%	659728	99.60%	3	0.83%
瞄	3530		14	4	0.0006039%	659732	99.60%	4	1.10%
瞅	3531		14	4	0.0006039%	659736	99.60%	3	0.83%
瞌	3532		15	4	0.0006039%	659740	99.61%	3	0.83%
矇	3533		19	4	0.0006039%	659744	99.61%	4	1.10%
砰	3534		10	4	0.0006039%	659748	99.61%	3	0.83%
砥	3535		10	4	0.0006039%	659752	99.61%	4	1.10%
磋	3536		15	4	0.0006039%	659756	99.61%	4	1.10%
祀	3537		7	4	0.0006039%	659760	99.61%	4	1.10%
穹	3538		8	4	0.0006039%	659764	99.61%	4	1.10%
竅	3539		18	4	0.0006039%	659768	99.61%	4	1.10%
竇	3540		20	4	0.0006039%	659772	99.61%	4	1.10%
篡	3541		16	4	0.0006039%	659776	99.61%	3	0.83%
簌	3542		17	4	0.0006039%	659780	99.61%	2	0.55%
紉	3543		9	4	0.0006039%	659784	99.61%	3	0.83%
緘	3544		15	4	0.0006039%	659788	99.61%	4	1.10%
緝	3545		15	4	0.0006039%	659792	99.61%	4	1.10%
縈	3546		16	4	0.0006039%	659796	99.61%	3	0.83%
繃	3547		17	4	0.0006039%	659800	99.61%	4	1.10%
縹	3548		17	4	0.0006039%	659804	99.61%	4	1.10%
羹	3549		19	4	0.0006039%	659808	99.62%	2	0.55%
翳	3550		17	4	0.0006039%	659812	99.62%	3	0.83%
肘	3551		7	4	0.0006039%	659816	99.62%	3	0.83%
胳	3552		10	4	0.0006039%	659820	99.62%	3	0.83%
腑	3553		12	4	0.0006039%	659824	99.62%	4	1.10%
腭	3554		13	4	0.0006039%	659828	99.62%	1	0.28%
臼	3555		6	4	0.0006039%	659832	99.62%	4	1.10%
芍	3556		7	4	0.0006039%	659836	99.62%	4	1.10%
芙	3557		8	4	0.0006039%	659840	99.62%	4	1.10%
荊	3558		10	4	0.0006039%	659844	99.62%	4	1.10%
菸	3559		12	4	0.0006039%	659848	99.62%	2	0.55%
蓆	3560		14	4	0.0006039%	659852	99.62%	2	0.55%
蓊	3561		14	4	0.0006039%	659856	99.62%	4	1.10%
蔑	3562		15	4	0.0006039%	659860	99.62%	4	1.10%
蕾	3563		17	4	0.0006039%	659864	99.62%	4	1.10%
薦	3564		18	4	0.0006039%	659868	99.62%	4	1.10%
藹	3565		20	4	0.0006039%	659872	99.62%	4	1.10%
蜷	3566		14	4	0.0006039%	659876	99.63%	4	1.10%
螞	3567		16	4	0.0006039%	659880	99.63%	2	0.55%
蟹	3568		19	4	0.0006039%	659884	99.63%	4	1.10%
蠱	3569		23	4	0.0006039%	659888	99.63%	4	1.10%
袱	3570		11	4	0.0006039%	659892	99.63%	3	0.83%
裘	3571		13	4	0.0006039%	659896	99.63%	3	0.83%
褓	3572		14	4	0.0006039%	659900	99.63%	4	1.10%
訐	3573		10	4	0.0006039%	659904	99.63%	4	1.10%
訣	3574		11	4	0.0006039%	659908	99.63%	4	1.10%
訥	3575		11	4	0.0006039%	659912	99.63%	2	0.55%
諄	3576		15	4	0.0006039%	659916	99.63%	2	0.55%
謳	3577		18	4	0.0006039%	659920	99.63%	4	1.10%
譴	3578		21	4	0.0006039%	659924	99.63%	3	0.83%
豌	3579		15	4	0.0006039%	659928	99.63%	3	0.83%
豹	3580		10	4	0.0006039%	659932	99.63%	3	0.83%
貽	3581		12	4	0.0006039%	659936	99.63%	4	1.10%
趟	3582		15	4	0.0006039%	659940	99.64%	3	0.83%
跚	3583		12	4	0.0006039%	659944	99.64%	4	1.10%
踢	3584		15	4	0.0006039%	659948	99.64%	4	1.10%
蹄	3585		16	4	0.0006039%	659952	99.64%	4	1.10%
踽	3586		16	4	0.0006039%	659956	99.64%	2	0.55%
蹣	3587		18	4	0.0006039%	659960	99.64%	4	1.10%
蹬	3588		19	4	0.0006039%	659964	99.64%	4	1.10%
迂	3589		6	4	0.0006039%	659968	99.64%	4	1.10%
迺	3590		9	4	0.0006039%	659972	99.64%	4	1.10%
逅	3591		9	4	0.0006039%	659976	99.64%	3	0.83%
迸	3592		9	4	0.0006039%	659980	99.64%	4	1.10%
逍	3593		10	4	0.0006039%	659984	99.64%	4	1.10%
遨	3594		14	4	0.0006039%	659988	99.64%	4	1.10%
邂	3595		16	4	0.0006039%	659992	99.64%	3	0.83%
鄒	3596		12	4	0.0006039%	659996	99.64%	3	0.83%
酗	3597		11	4	0.0006039%	660000	99.64%	2	0.55%
鉋	3598		13	4	0.0006039%	660004	99.64%	2	0.55%
銹	3599		15	4	0.0006039%	660008	99.65%	3	0.83%
錡	3600		16	4	0.0006039%	660012	99.65%	2	0.55%
鏢	3601		19	4	0.0006039%	660016	99.65%	4	1.10%
闔	3602		18	4	0.0006039%	660020	99.65%	4	1.10%
隋	3603		11	4	0.0006039%	660024	99.65%	3	0.83%
雍	3604		13	4	0.0006039%	660028	99.65%	3	0.83%
霽	3605		22	4	0.0006039%	660032	99.65%	3	0.83%
颯	3606		14	4	0.0006039%	660036	99.65%	2	0.55%
饅	3607		19	4	0.0006039%	660040	99.65%	2	0.55%
馭	3608		12	4	0.0006039%	660044	99.65%	2	0.55%
骸	3609		16	4	0.0006039%	660048	99.65%	4	1.10%
骼	3610		16	4	0.0006039%	660052	99.65%	4	1.10%
髓	3611		23	4	0.0006039%	660056	99.65%	4	1.10%
髻	3612		16	4	0.0006039%	660060	99.65%	4	1.10%
鷗	3613		22	4	0.0006039%	660064	99.65%	4	1.10%
黛	3614		17	4	0.0006039%	660068	99.65%	2	0.55%
齋	3615		17	4	0.0006039%	660072	99.66%	3	0.83%
齣	3616		20	4	0.0006039%	660076	99.66%	3	0.83%
亙	3617		6	3	0.0004529%	660079	99.66%	3	0.83%
亥	3618		6	3	0.0004529%	660082	99.66%	3	0.83%
仄	3619		4	3	0.0004529%	660085	99.66%	1	0.28%
佗	3620		7	3	0.0004529%	660088	99.66%	1	0.28%
伺	3621		7	3	0.0004529%	660091	99.66%	3	0.83%
侏	3622		8	3	0.0004529%	660094	99.66%	3	0.83%
俏	3623		9	3	0.0004529%	660097	99.66%	3	0.83%
侷	3624		9	3	0.0004529%	660100	99.66%	3	0.83%
偌	3625		11	3	0.0004529%	660103	99.66%	2	0.55%
倏	3626		11	3	0.0004529%	660106	99.66%	3	0.83%
傀	3627		12	3	0.0004529%	660109	99.66%	3	0.83%
僂	3628		13	3	0.0004529%	660112	99.66%	2	0.55%
僥	3629		14	3	0.0004529%	660115	99.66%	3	0.83%
儈	3630		15	3	0.0004529%	660118	99.66%	2	0.55%
儡	3631		17	3	0.0004529%	660121	99.66%	3	0.83%
兀	3632		3	3	0.0004529%	660124	99.66%	3	0.83%
冽	3633		8	3	0.0004529%	660127	99.66%	2	0.55%
剃	3634		9	3	0.0004529%	660130	99.66%	2	0.55%
勳	3635		16	3	0.0004529%	660133	99.66%	3	0.83%
勺	3636		3	3	0.0004529%	660136	99.66%	2	0.55%
匈	3637		6	3	0.0004529%	660139	99.67%	2	0.55%
匣	3638		7	3	0.0004529%	660142	99.67%	3	0.83%
厥	3639		12	3	0.0004529%	660145	99.67%	3	0.83%
吝	3640		7	3	0.0004529%	660148	99.67%	3	0.83%
吩	3641		7	3	0.0004529%	660151	99.67%	2	0.55%
唔	3642		10	3	0.0004529%	660154	99.67%	2	0.55%
喋	3643		12	3	0.0004529%	660157	99.67%	2	0.55%
唾	3644		12	3	0.0004529%	660160	99.67%	3	0.83%
喙	3645		12	3	0.0004529%	660163	99.67%	3	0.83%
嗟	3646		13	3	0.0004529%	660166	99.67%	2	0.55%
嗔	3647		13	3	0.0004529%	660169	99.67%	2	0.55%
噁	3648		15	3	0.0004529%	660172	99.67%	3	0.83%
噀	3649		15	3	0.0004529%	660175	99.67%	1	0.28%
噬	3650		16	3	0.0004529%	660178	99.67%	3	0.83%
嚏	3651		17	3	0.0004529%	660181	99.67%	2	0.55%
嚥	3652		19	3	0.0004529%	660184	99.67%	3	0.83%
嚷	3653		20	3	0.0004529%	660187	99.67%	3	0.83%
囈	3654		22	3	0.0004529%	660190	99.67%	3	0.83%
囱	3655		7	3	0.0004529%	660193	99.67%	2	0.55%
坷	3656		8	3	0.0004529%	660196	99.67%	3	0.83%
坤	3657		8	3	0.0004529%	660199	99.67%	3	0.83%
坵	3658		8	3	0.0004529%	660202	99.67%	1	0.28%
垢	3659		9	3	0.0004529%	660205	99.68%	3	0.83%
埂	3660		10	3	0.0004529%	660208	99.68%	3	0.83%
奎	3661		9	3	0.0004529%	660211	99.68%	3	0.83%
妃	3662		6	3	0.0004529%	660214	99.68%	3	0.83%
妊	3663		7	3	0.0004529%	660217	99.68%	3	0.83%
姪	3664		9	3	0.0004529%	660220	99.68%	3	0.83%
婿	3665		12	3	0.0004529%	660223	99.68%	2	0.55%
嫦	3666		14	3	0.0004529%	660226	99.68%	2	0.55%
嫻	3667		15	3	0.0004529%	660229	99.68%	2	0.55%
嬝	3668		16	3	0.0004529%	660232	99.68%	2	0.55%
孃	3669		20	3	0.0004529%	660235	99.68%	3	0.83%
孳	3670		12	3	0.0004529%	660238	99.68%	3	0.83%
孺	3671		17	3	0.0004529%	660241	99.68%	3	0.83%
寇	3672		11	3	0.0004529%	660244	99.68%	3	0.83%
屹	3673		6	3	0.0004529%	660247	99.68%	3	0.83%
峭	3674		10	3	0.0004529%	660250	99.68%	2	0.55%
嵐	3675		12	3	0.0004529%	660253	99.68%	2	0.55%
嵋	3676		12	3	0.0004529%	660256	99.68%	2	0.55%
巖	3677		23	3	0.0004529%	660259	99.68%	3	0.83%
帕	3678		8	3	0.0004529%	660262	99.68%	2	0.55%
幀	3679		12	3	0.0004529%	660265	99.68%	3	0.83%
异	3680		6	3	0.0004529%	660268	99.68%	2	0.55%
弔	3681		4	3	0.0004529%	660271	99.69%	3	0.83%
彆	3682		14	3	0.0004529%	660274	99.69%	3	0.83%
彪	3683		11	3	0.0004529%	660277	99.69%	2	0.55%
御	3684		11	3	0.0004529%	660280	99.69%	3	0.83%
悚	3685		10	3	0.0004529%	660283	99.69%	3	0.83%
惰	3686		12	3	0.0004529%	660286	99.69%	3	0.83%
慬	3687		14	3	0.0004529%	660289	99.69%	3	0.83%
憚	3688		15	3	0.0004529%	660292	99.69%	3	0.83%
懃	3689		17	3	0.0004529%	660295	99.69%	3	0.83%
懣	3690		18	3	0.0004529%	660298	99.69%	3	0.83%
扳	3691		7	3	0.0004529%	660301	99.69%	2	0.55%
拇	3692		8	3	0.0004529%	660304	99.69%	2	0.55%
掄	3693		11	3	0.0004529%	660307	99.69%	3	0.83%
捩	3694		11	3	0.0004529%	660310	99.69%	3	0.83%
捶	3695		12	3	0.0004529%	660313	99.69%	2	0.55%
搾	3696		13	3	0.0004529%	660316	99.69%	2	0.55%
摟	3697		14	3	0.0004529%	660319	99.69%	3	0.83%
摻	3698		14	3	0.0004529%	660322	99.69%	3	0.83%
摹	3699		15	3	0.0004529%	660325	99.69%	3	0.83%
撚	3700		15	3	0.0004529%	660328	99.69%	1	0.28%
攘	3701		20	3	0.0004529%	660331	99.69%	3	0.83%
攫	3702		23	3	0.0004529%	660334	99.69%	3	0.83%
晏	3703		10	3	0.0004529%	660337	99.70%	2	0.55%
晢	3704		11	3	0.0004529%	660340	99.70%	2	0.55%
暉	3705		13	3	0.0004529%	660343	99.70%	3	0.83%
曄	3706		16	3	0.0004529%	660346	99.70%	1	0.28%
胆	3707		9	3	0.0004529%	660349	99.70%	3	0.83%
杞	3708		7	3	0.0004529%	660352	99.70%	3	0.83%
杳	3709		8	3	0.0004529%	660355	99.70%	3	0.83%
栓	3710		10	3	0.0004529%	660358	99.70%	3	0.83%
桎	3711		10	3	0.0004529%	660361	99.70%	3	0.83%
梏	3712		11	3	0.0004529%	660364	99.70%	3	0.83%
棻	3713		12	3	0.0004529%	660367	99.70%	1	0.28%
楫	3714		13	3	0.0004529%	660370	99.70%	2	0.55%
楹	3715		13	3	0.0004529%	660373	99.70%	2	0.55%
樅	3716		15	3	0.0004529%	660376	99.70%	1	0.28%
橙	3717		16	3	0.0004529%	660379	99.70%	2	0.55%
櫸	3718		21	3	0.0004529%	660382	99.70%	3	0.83%
沁	3719		7	3	0.0004529%	660385	99.70%	2	0.55%
沐	3720		7	3	0.0004529%	660388	99.70%	3	0.83%
泵	3721		9	3	0.0004529%	660391	99.70%	1	0.28%
涎	3722		11	3	0.0004529%	660394	99.70%	3	0.83%
湛	3723		12	3	0.0004529%	660397	99.70%	3	0.83%
湘	3724		12	3	0.0004529%	660400	99.70%	2	0.55%
湍	3725		12	3	0.0004529%	660403	99.71%	3	0.83%
湄	3726		12	3	0.0004529%	660406	99.71%	3	0.83%
溼	3727		13	3	0.0004529%	660409	99.71%	3	0.83%
滔	3728		13	3	0.0004529%	660412	99.71%	3	0.83%
潦	3729		15	3	0.0004529%	660415	99.71%	3	0.83%
濮	3730		17	3	0.0004529%	660418	99.71%	1	0.28%
瀨	3731		19	3	0.0004529%	660421	99.71%	1	0.28%
瀝	3732		19	3	0.0004529%	660424	99.71%	3	0.83%
灩	3733		31	3	0.0004529%	660427	99.71%	2	0.55%
炳	3734		9	3	0.0004529%	660430	99.71%	3	0.83%
炬	3735		9	3	0.0004529%	660433	99.71%	2	0.55%
煦	3736		13	3	0.0004529%	660436	99.71%	3	0.83%
燉	3737		16	3	0.0004529%	660439	99.71%	3	0.83%
燼	3738		18	3	0.0004529%	660442	99.71%	3	0.83%
牟	3739		6	3	0.0004529%	660445	99.71%	3	0.83%
猩	3740		12	3	0.0004529%	660448	99.71%	1	0.28%
獃	3741		14	3	0.0004529%	660451	99.71%	2	0.55%
獷	3742		18	3	0.0004529%	660454	99.71%	3	0.83%
珞	3743		10	3	0.0004529%	660457	99.71%	1	0.28%
琅	3744		11	3	0.0004529%	660460	99.71%	2	0.55%
琳	3745		12	3	0.0004529%	660463	99.71%	3	0.83%
璧	3746		18	3	0.0004529%	660466	99.71%	3	0.83%
瓬	3747		9	3	0.0004529%	660469	99.72%	1	0.28%
甩	3748		5	3	0.0004529%	660472	99.72%	3	0.83%
疋	3749		5	3	0.0004529%	660475	99.72%	3	0.83%
疤	3750		9	3	0.0004529%	660478	99.72%	3	0.83%
疥	3751		9	3	0.0004529%	660481	99.72%	2	0.55%
疸	3752		10	3	0.0004529%	660484	99.72%	3	0.83%
痢	3753		12	3	0.0004529%	660487	99.72%	3	0.83%
痞	3754		12	3	0.0004529%	660490	99.72%	1	0.28%
瘀	3755		13	3	0.0004529%	660493	99.72%	2	0.55%
癩	3756		21	3	0.0004529%	660496	99.72%	2	0.55%
皈	3757		9	3	0.0004529%	660499	99.72%	2	0.55%
瞿	3758		18	3	0.0004529%	660502	99.72%	3	0.83%
矚	3759		26	3	0.0004529%	660505	99.72%	3	0.83%
矼	3760		8	3	0.0004529%	660508	99.72%	1	0.28%
砸	3761		10	3	0.0004529%	660511	99.72%	3	0.83%
砵	3762		10	3	0.0004529%	660514	99.72%	1	0.28%
碉	3763		13	3	0.0004529%	660517	99.72%	1	0.28%
磯	3764		17	3	0.0004529%	660520	99.72%	3	0.83%
礪	3765		20	3	0.0004529%	660523	99.72%	3	0.83%
祉	3766		8	3	0.0004529%	660526	99.72%	3	0.83%
禾	3767		5	3	0.0004529%	660529	99.72%	2	0.55%
秤	3768		10	3	0.0004529%	660532	99.72%	3	0.83%
穗	3769		17	3	0.0004529%	660535	99.73%	2	0.55%
窟	3770		13	3	0.0004529%	660538	99.73%	3	0.83%
窪	3771		14	3	0.0004529%	660541	99.73%	3	0.83%
笆	3772		10	3	0.0004529%	660544	99.73%	2	0.55%
笠	3773		11	3	0.0004529%	660547	99.73%	2	0.55%
筏	3774		12	3	0.0004529%	660550	99.73%	3	0.83%
筵	3775		14	3	0.0004529%	660553	99.73%	2	0.55%
箍	3776		14	3	0.0004529%	660556	99.73%	2	0.55%
篋	3777		15	3	0.0004529%	660559	99.73%	3	0.83%
粟	3778		12	3	0.0004529%	660562	99.73%	2	0.55%
粥	3779		12	3	0.0004529%	660565	99.73%	3	0.83%
粽	3780		14	3	0.0004529%	660568	99.73%	2	0.55%
糜	3781		17	3	0.0004529%	660571	99.73%	2	0.55%
糞	3782		17	3	0.0004529%	660574	99.73%	3	0.83%
糢	3783		17	3	0.0004529%	660577	99.73%	3	0.83%
緲	3784		15	3	0.0004529%	660580	99.73%	3	0.83%
繚	3785		18	3	0.0004529%	660583	99.73%	3	0.83%
辮	3786		20	3	0.0004529%	660586	99.73%	3	0.83%
纂	3787		20	3	0.0004529%	660589	99.73%	3	0.83%
纜	3788		27	3	0.0004529%	660592	99.73%	2	0.55%
羔	3789		10	3	0.0004529%	660595	99.73%	3	0.83%
翱	3790		16	3	0.0004529%	660598	99.73%	3	0.83%
耽	3791		10	3	0.0004529%	660601	99.74%	2	0.55%
肴	3792		8	3	0.0004529%	660604	99.74%	3	0.83%
胥	3793		9	3	0.0004529%	660607	99.74%	3	0.83%
胭	3794		10	3	0.0004529%	660610	99.74%	3	0.83%
脯	3795		11	3	0.0004529%	660613	99.74%	3	0.83%
脛	3796		11	3	0.0004529%	660616	99.74%	3	0.83%
腋	3797		12	3	0.0004529%	660619	99.74%	3	0.83%
膳	3798		16	3	0.0004529%	660622	99.74%	1	0.28%
臬	3799		10	3	0.0004529%	660625	99.74%	3	0.83%
艉	3800		13	3	0.0004529%	660628	99.74%	1	0.28%
苣	3801		9	3	0.0004529%	660631	99.74%	1	0.28%
苓	3802		9	3	0.0004529%	660634	99.74%	2	0.55%
苡	3803		9	3	0.0004529%	660637	99.74%	2	0.55%
茯	3804		10	3	0.0004529%	660640	99.74%	1	0.28%
菇	3805		12	3	0.0004529%	660643	99.74%	3	0.83%
萼	3806		13	3	0.0004529%	660646	99.74%	2	0.55%
萵	3807		13	3	0.0004529%	660649	99.74%	1	0.28%
葺	3808		13	3	0.0004529%	660652	99.74%	2	0.55%
蓉	3809		14	3	0.0004529%	660655	99.74%	2	0.55%
蕊	3810		16	3	0.0004529%	660658	99.74%	3	0.83%
蕪	3811		16	3	0.0004529%	660661	99.74%	3	0.83%
薏	3812		17	3	0.0004529%	660664	99.74%	2	0.55%
藷	3813		19	3	0.0004529%	660667	99.75%	3	0.83%
蚌	3814		10	3	0.0004529%	660670	99.75%	2	0.55%
蚕	3815		10	3	0.0004529%	660673	99.75%	2	0.55%
蜊	3816		13	3	0.0004529%	660676	99.75%	1	0.28%
蜒	3817		14	3	0.0004529%	660679	99.75%	3	0.83%
裒	3818		12	3	0.0004529%	660682	99.75%	1	0.28%
褥	3819		15	3	0.0004529%	660685	99.75%	3	0.83%
襪	3820		20	3	0.0004529%	660688	99.75%	3	0.83%
訛	3821		11	3	0.0004529%	660691	99.75%	2	0.55%
誡	3822		14	3	0.0004529%	660694	99.75%	3	0.83%
誨	3823		14	3	0.0004529%	660697	99.75%	2	0.55%
謁	3824		16	3	0.0004529%	660700	99.75%	3	0.83%
諳	3825		16	3	0.0004529%	660703	99.75%	3	0.83%
諤	3826		16	3	0.0004529%	660706	99.75%	2	0.55%
譎	3827		19	3	0.0004529%	660709	99.75%	3	0.83%
豢	3828		13	3	0.0004529%	660712	99.75%	3	0.83%
赭	3829		15	3	0.0004529%	660715	99.75%	3	0.83%
蹂	3830		16	3	0.0004529%	660718	99.75%	3	0.83%
踵	3831		16	3	0.0004529%	660721	99.75%	3	0.83%
蹦	3832		18	3	0.0004529%	660724	99.75%	2	0.55%
蹶	3833		19	3	0.0004529%	660727	99.75%	3	0.83%
輊	3834		13	3	0.0004529%	660730	99.75%	3	0.83%
轅	3835		17	3	0.0004529%	660733	99.75%	3	0.83%
辟	3836		13	3	0.0004529%	660736	99.76%	2	0.55%
迢	3837		8	3	0.0004529%	660739	99.76%	2	0.55%
迤	3838		8	3	0.0004529%	660742	99.76%	3	0.83%
逡	3839		10	3	0.0004529%	660745	99.76%	3	0.83%
遏	3840		12	3	0.0004529%	660748	99.76%	2	0.55%
遽	3841		16	3	0.0004529%	660751	99.76%	3	0.83%
邃	3842		17	3	0.0004529%	660754	99.76%	3	0.83%
邈	3843		17	3	0.0004529%	660757	99.76%	2	0.55%
酶	3844		14	3	0.0004529%	660760	99.76%	1	0.28%
醺	3845		21	3	0.0004529%	660763	99.76%	2	0.55%
釧	3846		11	3	0.0004529%	660766	99.76%	3	0.83%
鈣	3847		12	3	0.0004529%	660769	99.76%	3	0.83%
鈿	3848		13	3	0.0004529%	660772	99.76%	3	0.83%
銹	3849		15	3	0.0004529%	660775	99.76%	3	0.83%
鏃	3850		19	3	0.0004529%	660778	99.76%	1	0.28%
鏘	3851		19	3	0.0004529%	660781	99.76%	2	0.55%
鏽	3852		20	3	0.0004529%	660784	99.76%	2	0.55%
鑾	3853		27	3	0.0004529%	660787	99.76%	3	0.83%
閥	3854		14	3	0.0004529%	660790	99.76%	3	0.83%
閤	3855		14	3	0.0004529%	660793	99.76%	2	0.55%
阮	3856		6	3	0.0004529%	660796	99.76%	2	0.55%
隅	3857		11	3	0.0004529%	660799	99.76%	3	0.83%
隘	3858		12	3	0.0004529%	660802	99.77%	3	0.83%
霎	3859		16	3	0.0004529%	660805	99.77%	3	0.83%
霖	3860		16	3	0.0004529%	660808	99.77%	3	0.83%
靉	3861		25	3	0.0004529%	660811	99.77%	2	0.55%
颶	3862		17	3	0.0004529%	660814	99.77%	3	0.83%
餅	3863		14	3	0.0004529%	660817	99.77%	3	0.83%
馱	3864		13	3	0.0004529%	660820	99.77%	1	0.28%
駝	3865		15	3	0.0004529%	660823	99.77%	3	0.83%
鰒	3866		20	3	0.0004529%	660826	99.77%	1	0.28%
鱧	3867		24	3	0.0004529%	660829	99.77%	1	0.28%
鴛	3868		16	3	0.0004529%	660832	99.77%	3	0.83%
鶻	3869		21	3	0.0004529%	660835	99.77%	1	0.28%
黔	3870		16	3	0.0004529%	660838	99.77%	2	0.55%
黽	3871		13	3	0.0004529%	660841	99.77%	1	0.28%
鼾	3872		17	3	0.0004529%	660844	99.77%	2	0.55%
丐	3873		4	2	0.000302%	660846	99.77%	2	0.55%
丕	3874		5	2	0.000302%	660848	99.77%	2	0.55%
丞	3875		6	2	0.000302%	660850	99.77%	2	0.55%
丰	3876		4	2	0.000302%	660852	99.77%	2	0.55%
仕	3877		5	2	0.000302%	660854	99.77%	2	0.55%
伽	3878		7	2	0.000302%	660856	99.77%	2	0.55%
佃	3879		7	2	0.000302%	660858	99.77%	2	0.55%
佝	3880		7	2	0.000302%	660860	99.77%	1	0.28%
俑	3881		9	2	0.000302%	660862	99.77%	2	0.55%
俐	3882		9	2	0.000302%	660864	99.77%	2	0.55%
俚	3883		9	2	0.000302%	660866	99.78%	2	0.55%
俳	3884		10	2	0.000302%	660868	99.78%	2	0.55%
偑	3885		11	2	0.000302%	660870	99.78%	1	0.28%
僮	3886		14	2	0.000302%	660872	99.78%	2	0.55%
僚	3887		14	2	0.000302%	660874	99.78%	2	0.55%
僕	3888		14	2	0.000302%	660876	99.78%	2	0.55%
儷	3889		21	2	0.000302%	660878	99.78%	2	0.55%
凶	3890		4	2	0.000302%	660880	99.78%	2	0.55%
刪	3891		7	2	0.000302%	660882	99.78%	2	0.55%
刨	3892		7	2	0.000302%	660884	99.78%	2	0.55%
剡	3893		10	2	0.000302%	660886	99.78%	2	0.55%
劭	3894		7	2	0.000302%	660888	99.78%	2	0.55%
匝	3895		5	2	0.000302%	660890	99.78%	2	0.55%
叨	3896		5	2	0.000302%	660892	99.78%	2	0.55%
吭	3897		7	2	0.000302%	660894	99.78%	2	0.55%
咕	3898		8	2	0.000302%	660896	99.78%	1	0.28%
呷	3899		8	2	0.000302%	660898	99.78%	1	0.28%
呱	3900		8	2	0.000302%	660900	99.78%	1	0.28%
呣	3901		8	2	0.000302%	660902	99.78%	1	0.28%
哎	3902		9	2	0.000302%	660904	99.78%	2	0.55%
咯	3903		9	2	0.000302%	660906	99.78%	1	0.28%
咻	3904		9	2	0.000302%	660908	99.78%	1	0.28%
咿	3905		9	2	0.000302%	660910	99.78%	1	0.28%
唷	3906		10	2	0.000302%	660912	99.78%	1	0.28%
啄	3907		11	2	0.000302%	660914	99.78%	2	0.55%
唬	3908		11	2	0.000302%	660916	99.78%	2	0.55%
唳	3909		11	2	0.000302%	660918	99.78%	2	0.55%
啻	3910		12	2	0.000302%	660920	99.78%	2	0.55%
喔	3911		12	2	0.000302%	660922	99.78%	2	0.55%
喳	3912		12	2	0.000302%	660924	99.78%	1	0.28%
嗨	3913		13	2	0.000302%	660926	99.78%	2	0.55%
嗦	3914		13	2	0.000302%	660928	99.78%	2	0.55%
嗄	3915		13	2	0.000302%	660930	99.78%	2	0.55%
嗷	3916		14	2	0.000302%	660932	99.79%	1	0.28%
噓	3917		15	2	0.000302%	660934	99.79%	2	0.55%
嚎	3918		17	2	0.000302%	660936	99.79%	2	0.55%
嚅	3919		17	2	0.000302%	660938	99.79%	1	0.28%
嚙	3920		18	2	0.000302%	660940	99.79%	2	0.55%
嚨	3921		20	2	0.000302%	660942	99.79%	2	0.55%
囫	3922		7	2	0.000302%	660944	99.79%	2	0.55%
圇	3923		11	2	0.000302%	660946	99.79%	2	0.55%
圮	3924		6	2	0.000302%	660948	99.79%	2	0.55%
㘭	3925		7	2	0.000302%	660950	99.79%	2	0.55%
坍	3926		7	2	0.000302%	660952	99.79%	1	0.28%
堿	3927		12	2	0.000302%	660954	99.79%	2	0.55%
塍	3928		13	2	0.000302%	660956	99.79%	1	0.28%
壕	3929		17	2	0.000302%	660958	99.79%	2	0.55%
奄	3930		8	2	0.000302%	660960	99.79%	1	0.28%
奕	3931		9	2	0.000302%	660962	99.79%	1	0.28%
妾	3932		8	2	0.000302%	660964	99.79%	2	0.55%
姍	3933		8	2	0.000302%	660966	99.79%	1	0.28%
妲	3934		8	2	0.000302%	660968	99.79%	1	0.28%
姥	3935		9	2	0.000302%	660970	99.79%	1	0.28%
姦	3936		9	2	0.000302%	660972	99.79%	2	0.55%
娑	3937		10	2	0.000302%	660974	99.79%	2	0.55%
娓	3938		10	2	0.000302%	660976	99.79%	1	0.28%
娠	3939		10	2	0.000302%	660978	99.79%	2	0.55%
娉	3940		10	2	0.000302%	660980	99.79%	2	0.55%
婪	3941		11	2	0.000302%	660982	99.79%	2	0.55%
媲	3942		13	2	0.000302%	660984	99.79%	2	0.55%
嫋	3943		13	2	0.000302%	660986	99.79%	1	0.28%
嫵	3944		15	2	0.000302%	660988	99.79%	2	0.55%
嬴	3945		16	2	0.000302%	660990	99.79%	2	0.55%
嬸	3946		18	2	0.000302%	660992	99.79%	1	0.28%
孛	3947		7	2	0.000302%	660994	99.79%	2	0.55%
孰	3948		11	2	0.000302%	660996	99.79%	2	0.55%
宓	3949		8	2	0.000302%	660998	99.79%	1	0.28%
宦	3950		9	2	0.000302%	661000	99.80%	2	0.55%
寨	3951		14	2	0.000302%	661002	99.80%	2	0.55%
寰	3952		16	2	0.000302%	661004	99.80%	2	0.55%
尹	3953		4	2	0.000302%	661006	99.80%	1	0.28%
屐	3954		10	2	0.000302%	661008	99.80%	2	0.55%
屯	3955		4	2	0.000302%	661010	99.80%	2	0.55%
岑	3956		7	2	0.000302%	661012	99.80%	2	0.55%
岫	3957		8	2	0.000302%	661014	99.80%	2	0.55%
峋	3958		9	2	0.000302%	661016	99.80%	2	0.55%
崛	3959		11	2	0.000302%	661018	99.80%	2	0.55%
嶙	3960		15	2	0.000302%	661020	99.80%	2	0.55%
巽	3961		12	2	0.000302%	661022	99.80%	1	0.28%
帑	3962		8	2	0.000302%	661024	99.80%	1	0.28%
帷	3963		11	2	0.000302%	661026	99.80%	2	0.55%
幛	3964		14	2	0.000302%	661028	99.80%	2	0.55%
幔	3965		14	2	0.000302%	661030	99.80%	2	0.55%
庄	3966		6	2	0.000302%	661032	99.80%	1	0.28%
廬	3967		19	2	0.000302%	661034	99.80%	2	0.55%
弁	3968		5	2	0.000302%	661036	99.80%	2	0.55%
弋	3969		3	2	0.000302%	661038	99.80%	1	0.28%
弒	3970		13	2	0.000302%	661040	99.80%	2	0.55%
弩	3971		8	2	0.000302%	661042	99.80%	2	0.55%
弭	3972		9	2	0.000302%	661044	99.80%	2	0.55%
彗	3973		11	2	0.000302%	661046	99.80%	2	0.55%
徠	3974		11	2	0.000302%	661048	99.80%	2	0.55%
徼	3975		16	2	0.000302%	661050	99.80%	2	0.55%
忪	3976		7	2	0.000302%	661052	99.80%	2	0.55%
忿	3977		8	2	0.000302%	661054	99.80%	1	0.28%
怱	3978		9	2	0.000302%	661056	99.80%	1	0.28%
恪	3979		9	2	0.000302%	661058	99.80%	2	0.55%
恣	3980		10	2	0.000302%	661060	99.80%	2	0.55%
悻	3981		11	2	0.000302%	661062	99.80%	1	0.28%
惺	3982		12	2	0.000302%	661064	99.80%	2	0.55%
惴	3983		12	2	0.000302%	661066	99.81%	1	0.28%
愨	3984		14	2	0.000302%	661068	99.81%	1	0.28%
懨	3985		17	2	0.000302%	661070	99.81%	1	0.28%
懾	3986		21	2	0.000302%	661072	99.81%	2	0.55%
戡	3987		13	2	0.000302%	661074	99.81%	2	0.55%
戢	3988		13	2	0.000302%	661076	99.81%	2	0.55%
戾	3989		8	2	0.000302%	661078	99.81%	2	0.55%
抉	3990		7	2	0.000302%	661080	99.81%	2	0.55%
拯	3991		9	2	0.000302%	661082	99.81%	2	0.55%
挈	3992		10	2	0.000302%	661084	99.81%	1	0.28%
挐	3993		10	2	0.000302%	661086	99.81%	2	0.55%
掬	3994		11	2	0.000302%	661088	99.81%	2	0.55%
据	3995		11	2	0.000302%	661090	99.81%	2	0.55%
揆	3996		12	2	0.000302%	661092	99.81%	2	0.55%
揖	3997		12	2	0.000302%	661094	99.81%	2	0.55%
摭	3998		14	2	0.000302%	661096	99.81%	2	0.55%
摰	3999		15	2	0.000302%	661098	99.81%	1	0.28%
㩗	4000		16	2	0.000302%	661100	99.81%	2	0.55%
擘	4001		17	2	0.000302%	661102	99.81%	2	0.55%
擢	4002		17	2	0.000302%	661104	99.81%	2	0.55%
擯	4003		17	2	0.000302%	661106	99.81%	2	0.55%
擻	4004		18	2	0.000302%	661108	99.81%	2	0.55%
斂	4005		17	2	0.000302%	661110	99.81%	2	0.55%
昊	4006		8	2	0.000302%	661112	99.81%	2	0.55%
曇	4007		16	2	0.000302%	661114	99.81%	2	0.55%
曝	4008		19	2	0.000302%	661116	99.81%	2	0.55%
杓	4009		7	2	0.000302%	661118	99.81%	2	0.55%
杷	4010		8	2	0.000302%	661120	99.81%	2	0.55%
杵	4011		8	2	0.000302%	661122	99.81%	2	0.55%
枒	4012		8	2	0.000302%	661124	99.81%	2	0.55%
棱	4013		12	2	0.000302%	661126	99.81%	1	0.28%
楝	4014		13	2	0.000302%	661128	99.81%	2	0.55%
楸	4015		13	2	0.000302%	661130	99.81%	2	0.55%
榨	4016		14	2	0.000302%	661132	99.82%	2	0.55%
槁	4017		14	2	0.000302%	661134	99.82%	2	0.55%
槐	4018		14	2	0.000302%	661136	99.82%	2	0.55%
榦	4019		14	2	0.000302%	661138	99.82%	2	0.55%
槎	4020		14	2	0.000302%	661140	99.82%	2	0.55%
榑	4021		14	2	0.000302%	661142	99.82%	1	0.28%
槳	4022		15	2	0.000302%	661144	99.82%	2	0.55%
樽	4023		16	2	0.000302%	661146	99.82%	2	0.55%
檬	4024		18	2	0.000302%	661148	99.82%	2	0.55%
檸	4025		18	2	0.000302%	661150	99.82%	2	0.55%
櫓	4026		19	2	0.000302%	661152	99.82%	1	0.28%
欸	4027		11	2	0.000302%	661154	99.82%	1	0.28%
歛	4028		17	2	0.000302%	661156	99.82%	2	0.55%
殮	4029		17	2	0.000302%	661158	99.82%	2	0.55%
殲	4030		21	2	0.000302%	661160	99.82%	2	0.55%
毓	4031		13	2	0.000302%	661162	99.82%	2	0.55%
氮	4032		12	2	0.000302%	661164	99.82%	2	0.55%
氾	4033		5	2	0.000302%	661166	99.82%	2	0.55%
沌	4034		7	2	0.000302%	661168	99.82%	2	0.55%
汶	4035		7	2	0.000302%	661170	99.82%	2	0.55%
沏	4036		7	2	0.000302%	661172	99.82%	2	0.55%
泗	4037		8	2	0.000302%	661174	99.82%	2	0.55%
淳	4038		11	2	0.000302%	661176	99.82%	2	0.55%
淙	4039		11	2	0.000302%	661178	99.82%	1	0.28%
淩	4040		11	2	0.000302%	661180	99.82%	2	0.55%
淍	4041		11	2	0.000302%	661182	99.82%	2	0.55%
湎	4042		12	2	0.000302%	661184	99.82%	2	0.55%
溲	4043		12	2	0.000302%	661186	99.82%	1	0.28%
滸	4044		14	2	0.000302%	661188	99.82%	2	0.55%
潸	4045		15	2	0.000302%	661190	99.82%	1	0.28%
濘	4046		17	2	0.000302%	661192	99.82%	2	0.55%
濯	4047		17	2	0.000302%	661194	99.82%	2	0.55%
瀋	4048		18	2	0.000302%	661196	99.82%	2	0.55%
瀛	4049		19	2	0.000302%	661198	99.83%	1	0.28%
瀘	4050		19	2	0.000302%	661200	99.83%	1	0.28%
瀲	4051		20	2	0.000302%	661202	99.83%	2	0.55%
灕	4052		22	2	0.000302%	661204	99.83%	1	0.28%
烯	4053		11	2	0.000302%	661206	99.83%	1	0.28%
煜	4054		13	2	0.000302%	661208	99.83%	2	0.55%
熨	4055		15	2	0.000302%	661210	99.83%	2	0.55%
燬	4056		17	2	0.000302%	661212	99.83%	2	0.55%
燠	4057		17	2	0.000302%	661214	99.83%	2	0.55%
爹	4058		10	2	0.000302%	661216	99.83%	2	0.55%
犄	4059		12	2	0.000302%	661218	99.83%	1	0.28%
犖	4060		14	2	0.000302%	661220	99.83%	1	0.28%
狡	4061		9	2	0.000302%	661222	99.83%	2	0.55%
狽	4062		10	2	0.000302%	661224	99.83%	2	0.55%
狸	4063		10	2	0.000302%	661226	99.83%	2	0.55%
猥	4064		12	2	0.000302%	661228	99.83%	2	0.55%
猷	4065		13	2	0.000302%	661230	99.83%	2	0.55%
獰	4066		17	2	0.000302%	661232	99.83%	2	0.55%
玳	4067		9	2	0.000302%	661234	99.83%	2	0.55%
珮	4068		10	2	0.000302%	661236	99.83%	2	0.55%
瑕	4069		13	2	0.000302%	661238	99.83%	2	0.55%
瑁	4070		13	2	0.000302%	661240	99.83%	2	0.55%
璞	4071		16	2	0.000302%	661242	99.83%	2	0.55%
璫	4072		17	2	0.000302%	661244	99.83%	1	0.28%
甑	4073		17	2	0.000302%	661246	99.83%	2	0.55%
畝	4074		10	2	0.000302%	661248	99.83%	2	0.55%
畦	4075		11	2	0.000302%	661250	99.83%	2	0.55%
疙	4076		8	2	0.000302%	661252	99.83%	2	0.55%
痘	4077		12	2	0.000302%	661254	99.83%	1	0.28%
痧	4078		12	2	0.000302%	661256	99.83%	1	0.28%
瘁	4079		13	2	0.000302%	661258	99.83%	2	0.55%
瘖	4080		14	2	0.000302%	661260	99.83%	2	0.55%
瘟	4081		15	2	0.000302%	661262	99.83%	2	0.55%
癤	4082		18	2	0.000302%	661264	99.84%	2	0.55%
癹	4083		9	2	0.000302%	661266	99.84%	1	0.28%
皎	4084		11	2	0.000302%	661268	99.84%	1	0.28%
盍	4085		10	2	0.000302%	661270	99.84%	2	0.55%
盹	4086		9	2	0.000302%	661272	99.84%	2	0.55%
眥	4087		11	2	0.000302%	661274	99.84%	1	0.28%
睏	4088		12	2	0.000302%	661276	99.84%	1	0.28%
睨	4089		13	2	0.000302%	661278	99.84%	2	0.55%
睿	4090		14	2	0.000302%	661280	99.84%	2	0.55%
矓	4091		21	2	0.000302%	661282	99.84%	2	0.55%
矽	4092		8	2	0.000302%	661284	99.84%	2	0.55%
矻	4093		8	2	0.000302%	661286	99.84%	1	0.28%
硝	4094		12	2	0.000302%	661288	99.84%	2	0.55%
硜	4095		12	2	0.000302%	661290	99.84%	1	0.28%
碘	4096		13	2	0.000302%	661292	99.84%	2	0.55%
碓	4097		13	2	0.000302%	661294	99.84%	2	0.55%
磊	4098		15	2	0.000302%	661296	99.84%	1	0.28%
磕	4099		15	2	0.000302%	661298	99.84%	2	0.55%
磷	4100		17	2	0.000302%	661300	99.84%	2	0.55%
礬	4101		20	2	0.000302%	661302	99.84%	1	0.28%
禹	4102		9	2	0.000302%	661304	99.84%	1	0.28%
禺	4103		9	2	0.000302%	661306	99.84%	2	0.55%
稔	4104		13	2	0.000302%	661308	99.84%	2	0.55%
稼	4105		15	2	0.000302%	661310	99.84%	1	0.28%
窘	4106		12	2	0.000302%	661312	99.84%	2	0.55%
笈	4107		10	2	0.000302%	661314	99.84%	2	0.55%
筲	4108		13	2	0.000302%	661316	99.84%	2	0.55%
箴	4109		15	2	0.000302%	661318	99.84%	2	0.55%
篆	4110		15	2	0.000302%	661320	99.84%	2	0.55%
簋	4111		17	2	0.000302%	661322	99.84%	2	0.55%
籀	4112		19	2	0.000302%	661324	99.84%	1	0.28%
粲	4113		13	2	0.000302%	661326	99.84%	2	0.55%
紆	4114		9	2	0.000302%	661328	99.84%	2	0.55%
絆	4115		11	2	0.000302%	661330	99.85%	2	0.55%
絳	4116		12	2	0.000302%	661332	99.85%	2	0.55%
緋	4117		14	2	0.000302%	661334	99.85%	2	0.55%
縝	4118		16	2	0.000302%	661336	99.85%	2	0.55%
罟	4119		10	2	0.000302%	661338	99.85%	2	0.55%
罹	4120		16	2	0.000302%	661340	99.85%	1	0.28%
羸	4121		19	2	0.000302%	661342	99.85%	2	0.55%
翎	4122		11	2	0.000302%	661344	99.85%	2	0.55%
耙	4123		10	2	0.000302%	661346	99.85%	1	0.28%
耿	4124		10	2	0.000302%	661348	99.85%	1	0.28%
聒	4125		12	2	0.000302%	661350	99.85%	2	0.55%
肫	4126		8	2	0.000302%	661352	99.85%	2	0.55%
肪	4127		8	2	0.000302%	661354	99.85%	2	0.55%
胺	4128		10	2	0.000302%	661356	99.85%	2	0.55%
膛	4129		15	2	0.000302%	661358	99.85%	2	0.55%
膿	4130		17	2	0.000302%	661360	99.85%	1	0.28%
膾	4131		17	2	0.000302%	661362	99.85%	2	0.55%
舐	4132		10	2	0.000302%	661364	99.85%	1	0.28%
舔	4133		14	2	0.000302%	661366	99.85%	1	0.28%
舜	4134		12	2	0.000302%	661368	99.85%	2	0.55%
舫	4135		10	2	0.000302%	661370	99.85%	2	0.55%
舨	4136		10	2	0.000302%	661372	99.85%	2	0.55%
茉	4137		9	2	0.000302%	661374	99.85%	1	0.28%
苜	4138		9	2	0.000302%	661376	99.85%	2	0.55%
苪	4139		9	2	0.000302%	661378	99.85%	1	0.28%
荔	4140		10	2	0.000302%	661380	99.85%	2	0.55%
茹	4141		10	2	0.000302%	661382	99.85%	2	0.55%
茜	4142		10	2	0.000302%	661384	99.85%	1	0.28%
莞	4143		11	2	0.000302%	661386	99.85%	2	0.55%
荼	4144		11	2	0.000302%	661388	99.85%	2	0.55%
菠	4145		12	2	0.000302%	661390	99.85%	1	0.28%
萋	4146		12	2	0.000302%	661392	99.85%	1	0.28%
菁	4147		12	2	0.000302%	661394	99.85%	2	0.55%
葷	4148		13	2	0.000302%	661396	99.86%	2	0.55%
葵	4149		13	2	0.000302%	661398	99.86%	2	0.55%
蒐	4150		14	2	0.000302%	661400	99.86%	2	0.55%
蔥	4151		15	2	0.000302%	661402	99.86%	2	0.55%
蔦	4152		15	2	0.000302%	661404	99.86%	1	0.28%
蕙	4153		16	2	0.000302%	661406	99.86%	2	0.55%
薈	4154		17	2	0.000302%	661408	99.86%	2	0.55%
虜	4155		13	2	0.000302%	661410	99.86%	2	0.55%
虬	4156		7	2	0.000302%	661412	99.86%	2	0.55%
蚩	4157		10	2	0.000302%	661414	99.86%	1	0.28%
蛆	4158		11	2	0.000302%	661416	99.86%	2	0.55%
蛟	4159		12	2	0.000302%	661418	99.86%	1	0.28%
蜿	4160		14	2	0.000302%	661420	99.86%	2	0.55%
蜚	4161		14	2	0.000302%	661422	99.86%	2	0.55%
蝠	4162		15	2	0.000302%	661424	99.86%	1	0.28%
蝙	4163		15	2	0.000302%	661426	99.86%	1	0.28%
蝟	4164		15	2	0.000302%	661428	99.86%	2	0.55%
蝮	4165		15	2	0.000302%	661430	99.86%	1	0.28%
螃	4166		16	2	0.000302%	661432	99.86%	2	0.55%
袪	4167		10	2	0.000302%	661434	99.86%	2	0.55%
裴	4168		13	2	0.000302%	661436	99.86%	2	0.55%
裾	4169		13	2	0.000302%	661438	99.86%	2	0.55%
褸	4170		16	2	0.000302%	661440	99.86%	2	0.55%
褵	4171		16	2	0.000302%	661442	99.86%	2	0.55%
襁	4172		16	2	0.000302%	661444	99.86%	2	0.55%
褻	4173		17	2	0.000302%	661446	99.86%	2	0.55%
觴	4174		18	2	0.000302%	661448	99.86%	2	0.55%
訟	4175		11	2	0.000302%	661450	99.86%	2	0.55%
証	4176		12	2	0.000302%	661452	99.86%	1	0.28%
詛	4177		12	2	0.000302%	661454	99.86%	2	0.55%
詰	4178		13	2	0.000302%	661456	99.86%	2	0.55%
誣	4179		14	2	0.000302%	661458	99.86%	2	0.55%
誚	4180		14	2	0.000302%	661460	99.86%	2	0.55%
誹	4181		15	2	0.000302%	661462	99.87%	2	0.55%
諛	4182		15	2	0.000302%	661464	99.87%	1	0.28%
諮	4183		16	2	0.000302%	661466	99.87%	2	0.55%
諢	4184		16	2	0.000302%	661468	99.87%	2	0.55%
謗	4185		17	2	0.000302%	661470	99.87%	2	0.55%
謅	4186		17	2	0.000302%	661472	99.87%	1	0.28%
謫	4187		18	2	0.000302%	661474	99.87%	1	0.28%
貳	4188		12	2	0.000302%	661476	99.87%	2	0.55%
賒	4189		14	2	0.000302%	661478	99.87%	1	0.28%
賸	4190		17	2	0.000302%	661480	99.87%	2	0.55%
跋	4191		12	2	0.000302%	661482	99.87%	2	0.55%
跣	4192		13	2	0.000302%	661484	99.87%	1	0.28%
踉	4193		14	2	0.000302%	661486	99.87%	1	0.28%
踝	4194		15	2	0.000302%	661488	99.87%	2	0.55%
踴	4195		16	2	0.000302%	661490	99.87%	2	0.55%
踰	4196		16	2	0.000302%	661492	99.87%	2	0.55%
蹊	4197		17	2	0.000302%	661494	99.87%	2	0.55%
蹌	4198		17	2	0.000302%	661496	99.87%	1	0.28%
蹕	4199		18	2	0.000302%	661498	99.87%	2	0.55%
蹴	4200		19	2	0.000302%	661500	99.87%	2	0.55%
蹻	4201		19	2	0.000302%	661502	99.87%	2	0.55%
躅	4202		20	2	0.000302%	661504	99.87%	1	0.28%
躑	4203		22	2	0.000302%	661506	99.87%	1	0.28%
躝	4204		24	2	0.000302%	661508	99.87%	2	0.55%
軾	4205		13	2	0.000302%	661510	99.87%	2	0.55%
輓	4206		14	2	0.000302%	661512	99.87%	2	0.55%
輞	4207		15	2	0.000302%	661514	99.87%	1	0.28%
轔	4208		19	2	0.000302%	661516	99.87%	1	0.28%
迦	4209		8	2	0.000302%	661518	99.87%	1	0.28%
迭	4210		8	2	0.000302%	661520	99.87%	2	0.55%
遴	4211		15	2	0.000302%	661522	99.87%	2	0.55%
邇	4212		17	2	0.000302%	661524	99.87%	2	0.55%
邐	4213		22	2	0.000302%	661526	99.87%	2	0.55%
郡	4214		9	2	0.000302%	661528	99.87%	2	0.55%
酉	4215		7	2	0.000302%	661530	99.88%	2	0.55%
酊	4216		9	2	0.000302%	661532	99.88%	2	0.55%
酩	4217		13	2	0.000302%	661534	99.88%	2	0.55%
釆	4218		7	2	0.000302%	661536	99.88%	2	0.55%
鉗	4219		13	2	0.000302%	661538	99.88%	2	0.55%
鉚	4220		13	2	0.000302%	661540	99.88%	1	0.28%
銓	4221		14	2	0.000302%	661542	99.88%	2	0.55%
錮	4222		16	2	0.000302%	661544	99.88%	2	0.55%
鍥	4223		17	2	0.000302%	661546	99.88%	2	0.55%
鎏	4224		17	2	0.000302%	661548	99.88%	1	0.28%
鎚	4225		18	2	0.000302%	661550	99.88%	2	0.55%
鎗	4226		18	2	0.000302%	661552	99.88%	2	0.55%
鏤	4227		19	2	0.000302%	661554	99.88%	2	0.55%
鑰	4228		25	2	0.000302%	661556	99.88%	2	0.55%
阡	4229		5	2	0.000302%	661558	99.88%	1	0.28%
陂	4230		7	2	0.000302%	661560	99.88%	1	0.28%
陝	4231		9	2	0.000302%	661562	99.88%	2	0.55%
隴	4232		18	2	0.000302%	661564	99.88%	2	0.55%
霆	4233		15	2	0.000302%	661566	99.88%	2	0.55%
霏	4234		16	2	0.000302%	661568	99.88%	1	0.28%
頦	4235		15	2	0.000302%	661570	99.88%	2	0.55%
頤	4236		16	2	0.000302%	661572	99.88%	2	0.55%
顥	4237		21	2	0.000302%	661574	99.88%	2	0.55%
顳	4238		26	2	0.000302%	661576	99.88%	1	0.28%
颳	4239		15	2	0.000302%	661578	99.88%	2	0.55%
飪	4240		12	2	0.000302%	661580	99.88%	2	0.55%
餃	4241		14	2	0.000302%	661582	99.88%	2	0.55%
餒	4242		15	2	0.000302%	661584	99.88%	2	0.55%
餚	4243		16	2	0.000302%	661586	99.88%	2	0.55%
餽	4244		18	2	0.000302%	661588	99.88%	2	0.55%
饌	4245		20	2	0.000302%	661590	99.88%	1	0.28%
饞	4246		25	2	0.000302%	661592	99.88%	1	0.28%
駢	4247		16	2	0.000302%	661594	99.88%	2	0.55%
骷	4248		15	2	0.000302%	661596	99.89%	2	0.55%
髏	4249		21	2	0.000302%	661598	99.89%	2	0.55%
髣	4250		14	2	0.000302%	661600	99.89%	2	0.55%
鬣	4251		25	2	0.000302%	661602	99.89%	2	0.55%
鮒	4252		16	2	0.000302%	661604	99.89%	1	0.28%
鯊	4253		18	2	0.000302%	661606	99.89%	2	0.55%
鯽	4254		18	2	0.000302%	661608	99.89%	2	0.55%
鰤	4255		21	2	0.000302%	661610	99.89%	2	0.55%
鱈	4256		22	2	0.000302%	661612	99.89%	1	0.28%
鱠	4257		24	2	0.000302%	661614	99.89%	1	0.28%
鳩	4258		13	2	0.000302%	661616	99.89%	1	0.28%
鴦	4259		16	2	0.000302%	661618	99.89%	2	0.55%
鵠	4260		18	2	0.000302%	661620	99.89%	2	0.55%
鶉	4261		19	2	0.000302%	661622	99.89%	2	0.55%
麇	4262		16	2	0.000302%	661624	99.89%	2	0.55%
黠	4263		18	2	0.000302%	661626	99.89%	2	0.55%
齪	4264		22	2	0.000302%	661628	99.89%	2	0.55%
齷	4265		24	2	0.000302%	661630	99.89%	2	0.55%
么	4266		3	1	0.000151%	661631	99.89%	1	0.28%
义	4267		3	1	0.000151%	661632	99.89%	1	0.28%
仆	4268		4	1	0.000151%	661633	99.89%	1	0.28%
仞	4269		5	1	0.000151%	661634	99.89%	1	0.28%
仟	4270		5	1	0.000151%	661635	99.89%	1	0.28%
伉	4271		6	1	0.000151%	661636	99.89%	1	0.28%
伎	4272		6	1	0.000151%	661637	99.89%	1	0.28%
佞	4273		7	1	0.000151%	661638	99.89%	1	0.28%
佟	4274		7	1	0.000151%	661639	99.89%	1	0.28%
佘	4275		7	1	0.000151%	661640	99.89%	1	0.28%
佰	4276		8	1	0.000151%	661641	99.89%	1	0.28%
俎	4277		9	1	0.000151%	661642	99.89%	1	0.28%
俞	4278		9	1	0.000151%	661643	99.89%	1	0.28%
倮	4279		10	1	0.000151%	661644	99.89%	1	0.28%
俸	4280		10	1	0.000151%	661645	99.89%	1	0.28%
俺	4281		10	1	0.000151%	661646	99.89%	1	0.28%
倨	4282		10	1	0.000151%	661647	99.89%	1	0.28%
倜	4283		10	1	0.000151%	661648	99.89%	1	0.28%
偃	4284		11	1	0.000151%	661649	99.89%	1	0.28%
傴	4285		13	1	0.000151%	661650	99.89%	1	0.28%
僈	4286		13	1	0.000151%	661651	99.89%	1	0.28%
儆	4287		15	1	0.000151%	661652	99.89%	1	0.28%
儕	4288		16	1	0.000151%	661653	99.89%	1	0.28%
儗	4289		16	1	0.000151%	661654	99.89%	1	0.28%
儻	4290		22	1	0.000151%	661655	99.89%	1	0.28%
冢	4291		10	1	0.000151%	661656	99.89%	1	0.28%
刳	4292		8	1	0.000151%	661657	99.89%	1	0.28%
劊	4293		15	1	0.000151%	661658	99.89%	1	0.28%
劬	4294		7	1	0.000151%	661659	99.89%	1	0.28%
募	4295		13	1	0.000151%	661660	99.89%	1	0.28%
匍	4296		9	1	0.000151%	661661	99.90%	1	0.28%
匐	4297		11	1	0.000151%	661662	99.90%	1	0.28%
匕	4298		2	1	0.000151%	661663	99.90%	1	0.28%
匜	4299		5	1	0.000151%	661664	99.90%	1	0.28%
匾	4300		11	1	0.000151%	661665	99.90%	1	0.28%
卍	4301		6	1	0.000151%	661666	99.90%	1	0.28%
卯	4302		5	1	0.000151%	661667	99.90%	1	0.28%
卮	4303		5	1	0.000151%	661668	99.90%	1	0.28%
卹	4304		8	1	0.000151%	661669	99.90%	1	0.28%
厝	4305		10	1	0.000151%	661670	99.90%	1	0.28%
叁	4306		8	1	0.000151%	661671	99.90%	1	0.28%
吮	4307		7	1	0.000151%	661672	99.90%	1	0.28%
呸	4308		8	1	0.000151%	661673	99.90%	1	0.28%
呶	4309		8	1	0.000151%	661674	99.90%	1	0.28%
咨	4310		9	1	0.000151%	661675	99.90%	1	0.28%
咫	4311		9	1	0.000151%	661676	99.90%	1	0.28%
唆	4312		10	1	0.000151%	661677	99.90%	1	0.28%
啖	4313		11	1	0.000151%	661678	99.90%	1	0.28%
啤	4314		11	1	0.000151%	661679	99.90%	1	0.28%
啁	4315		11	1	0.000151%	661680	99.90%	1	0.28%
唪	4316		11	1	0.000151%	661681	99.90%	1	0.28%
啥	4317		11	1	0.000151%	661682	99.90%	1	0.28%
喱	4318		12	1	0.000151%	661683	99.90%	1	0.28%
喏	4319		12	1	0.000151%	661684	99.90%	1	0.28%
嗑	4320		13	1	0.000151%	661685	99.90%	1	0.28%
嗤	4321		13	1	0.000151%	661686	99.90%	1	0.28%
嗲	4322		13	1	0.000151%	661687	99.90%	1	0.28%
嘖	4323		14	1	0.000151%	661688	99.90%	1	0.28%
噘	4324		15	1	0.000151%	661689	99.90%	1	0.28%
嚆	4325		17	1	0.000151%	661690	99.90%	1	0.28%
嚜	4326		18	1	0.000151%	661691	99.90%	1	0.28%
囓	4327		24	1	0.000151%	661692	99.90%	1	0.28%
圜	4328		16	1	0.000151%	661693	99.90%	1	0.28%
圪	4329		6	1	0.000151%	661694	99.90%	1	0.28%
坂	4330		7	1	0.000151%	661695	99.90%	1	0.28%
坳	4331		8	1	0.000151%	661696	99.90%	1	0.28%
垓	4332		9	1	0.000151%	661697	99.90%	1	0.28%
埒	4333		10	1	0.000151%	661698	99.90%	1	0.28%
埤	4334		11	1	0.000151%	661699	99.90%	1	0.28%
埸	4335		11	1	0.000151%	661700	99.90%	1	0.28%
埏	4336		11	1	0.000151%	661701	99.90%	1	0.28%
堯	4337		12	1	0.000151%	661702	99.90%	1	0.28%
墁	4338		14	1	0.000151%	661703	99.90%	1	0.28%
墩	4339		15	1	0.000151%	661704	99.90%	1	0.28%
墺	4340		16	1	0.000151%	661705	99.90%	1	0.28%
壢	4341		19	1	0.000151%	661706	99.90%	1	0.28%
壚	4342		19	1	0.000151%	661707	99.90%	1	0.28%
奐	4343		9	1	0.000151%	661708	99.90%	1	0.28%
奩	4344		14	1	0.000151%	661709	99.90%	1	0.28%
妁	4345		6	1	0.000151%	661710	99.90%	1	0.28%
妞	4346		7	1	0.000151%	661711	99.90%	1	0.28%
妣	4347		7	1	0.000151%	661712	99.90%	1	0.28%
妖	4348		7	1	0.000151%	661713	99.90%	1	0.28%
妍	4349		7	1	0.000151%	661714	99.90%	1	0.28%
妯	4350		8	1	0.000151%	661715	99.90%	1	0.28%
姒	4351		8	1	0.000151%	661716	99.90%	1	0.28%
姹	4352		9	1	0.000151%	661717	99.90%	1	0.28%
姜	4353		9	1	0.000151%	661718	99.90%	1	0.28%
娩	4354		10	1	0.000151%	661719	99.90%	1	0.28%
娥	4355		10	1	0.000151%	661720	99.90%	1	0.28%
娌	4356		10	1	0.000151%	661721	99.90%	1	0.28%
婢	4357		11	1	0.000151%	661722	99.90%	1	0.28%
媼	4358		13	1	0.000151%	661723	99.90%	1	0.28%
媵	4359		13	1	0.000151%	661724	99.90%	1	0.28%
嫗	4360		14	1	0.000151%	661725	99.90%	1	0.28%
嫖	4361		14	1	0.000151%	661726	99.90%	1	0.28%
嫺	4362		15	1	0.000151%	661727	99.91%	1	0.28%
嬪	4363		17	1	0.000151%	661728	99.91%	1	0.28%
孚	4364		7	1	0.000151%	661729	99.91%	1	0.28%
孿	4365		22	1	0.000151%	661730	99.91%	1	0.28%
宕	4366		8	1	0.000151%	661731	99.91%	1	0.28%
宥	4367		9	1	0.000151%	661732	99.91%	1	0.28%
寅	4368		11	1	0.000151%	661733	99.91%	1	0.28%
寖	4369		13	1	0.000151%	661734	99.91%	1	0.28%
尢	4370		3	1	0.000151%	661735	99.91%	1	0.28%
岔	4371		7	1	0.000151%	661736	99.91%	1	0.28%
崙	4372		11	1	0.000151%	661737	99.91%	1	0.28%
崚	4373		11	1	0.000151%	661738	99.91%	1	0.28%
嵩	4374		13	1	0.000151%	661739	99.91%	1	0.28%
嶒	4375		15	1	0.000151%	661740	99.91%	1	0.28%
巉	4376		20	1	0.000151%	661741	99.91%	1	0.28%
帮	4377		9	1	0.000151%	661742	99.91%	1	0.28%
幃	4378		12	1	0.000151%	661743	99.91%	1	0.28%
幄	4379		12	1	0.000151%	661744	99.91%	1	0.28%
庚	4380		8	1	0.000151%	661745	99.91%	1	0.28%
庖	4381		8	1	0.000151%	661746	99.91%	1	0.28%
廩	4382		16	1	0.000151%	661747	99.91%	1	0.28%
廨	4383		16	1	0.000151%	661748	99.91%	1	0.28%
弘	4384		5	1	0.000151%	661749	99.91%	1	0.28%
弼	4385		12	1	0.000151%	661750	99.91%	1	0.28%
彀	4386		13	1	0.000151%	661751	99.91%	1	0.28%
彫	4387		11	1	0.000151%	661752	99.91%	1	0.28%
徇	4388		9	1	0.000151%	661753	99.91%	1	0.28%
忸	4389		7	1	0.000151%	661754	99.91%	1	0.28%
忑	4390		7	1	0.000151%	661755	99.91%	1	0.28%
忐	4391		7	1	0.000151%	661756	99.91%	1	0.28%
忡	4392		7	1	0.000151%	661757	99.91%	1	0.28%
忝	4393		8	1	0.000151%	661758	99.91%	1	0.28%
怩	4394		8	1	0.000151%	661759	99.91%	1	0.28%
怍	4395		8	1	0.000151%	661760	99.91%	1	0.28%
恫	4396		9	1	0.000151%	661761	99.91%	1	0.28%
悍	4397		10	1	0.000151%	661762	99.91%	1	0.28%
悌	4398		10	1	0.000151%	661763	99.91%	1	0.28%
恁	4399		10	1	0.000151%	661764	99.91%	1	0.28%
恿	4400		11	1	0.000151%	661765	99.91%	1	0.28%
悱	4401		11	1	0.000151%	661766	99.91%	1	0.28%
愜	4402		12	1	0.000151%	661767	99.91%	1	0.28%
惲	4403		12	1	0.000151%	661768	99.91%	1	0.28%
慍	4404		13	1	0.000151%	661769	99.91%	1	0.28%
愾	4405		13	1	0.000151%	661770	99.91%	1	0.28%
愍	4406		13	1	0.000151%	661771	99.91%	1	0.28%
慟	4407		14	1	0.000151%	661772	99.91%	1	0.28%
慓	4408		14	1	0.000151%	661773	99.91%	1	0.28%
慫	4409		15	1	0.000151%	661774	99.91%	1	0.28%
憟	4410		15	1	0.000151%	661775	99.91%	1	0.28%
懍	4411		16	1	0.000151%	661776	99.91%	1	0.28%
憨	4412		16	1	0.000151%	661777	99.91%	1	0.28%
懵	4413		19	1	0.000151%	661778	99.91%	1	0.28%
戊	4414		5	1	0.000151%	661779	99.91%	1	0.28%
戌	4415		6	1	0.000151%	661780	99.91%	1	0.28%
戛	4416		11	1	0.000151%	661781	99.91%	1	0.28%
戮	4417		15	1	0.000151%	661782	99.91%	1	0.28%
扒	4418		5	1	0.000151%	661783	99.91%	1	0.28%
扦	4419		6	1	0.000151%	661784	99.91%	1	0.28%
扺	4420		7	1	0.000151%	661785	99.91%	1	0.28%
拗	4421		8	1	0.000151%	661786	99.91%	1	0.28%
拽	4422		9	1	0.000151%	661787	99.91%	1	0.28%
拷	4423		9	1	0.000151%	661788	99.91%	1	0.28%
捂	4424		10	1	0.000151%	661789	99.91%	1	0.28%
捍	4425		10	1	0.000151%	661790	99.91%	1	0.28%
捋	4426		10	1	0.000151%	661791	99.91%	1	0.28%
挴	4427		10	1	0.000151%	661792	99.91%	1	0.28%
掖	4428		11	1	0.000151%	661793	99.92%	1	0.28%
捻	4429		11	1	0.000151%	661794	99.92%	1	0.28%
掎	4430		11	1	0.000151%	661795	99.92%	1	0.28%
掇	4431		11	1	0.000151%	661796	99.92%	1	0.28%
挻	4432		11	1	0.000151%	661797	99.92%	1	0.28%
掁	4433		11	1	0.000151%	661798	99.92%	1	0.28%
掣	4434		12	1	0.000151%	661799	99.92%	1	0.28%
揹	4435		12	1	0.000151%	661800	99.92%	1	0.28%
揄	4436		12	1	0.000151%	661801	99.92%	1	0.28%
搪	4437		13	1	0.000151%	661802	99.92%	1	0.28%
搆	4438		13	1	0.000151%	661803	99.92%	1	0.28%
摑	4439		14	1	0.000151%	661804	99.92%	1	0.28%
摶	4440		14	1	0.000151%	661805	99.92%	1	0.28%
摽	4441		14	1	0.000151%	661806	99.92%	1	0.28%
撢	4442		15	1	0.000151%	661807	99.92%	1	0.28%
撳	4443		15	1	0.000151%	661808	99.92%	1	0.28%
撻	4444		16	1	0.000151%	661809	99.92%	1	0.28%
擂	4445		16	1	0.000151%	661810	99.92%	1	0.28%
擷	4446		18	1	0.000151%	661811	99.92%	1	0.28%
攄	4447		18	1	0.000151%	661812	99.92%	1	0.28%
攙	4448		20	1	0.000151%	661813	99.92%	1	0.28%
攛	4449		21	1	0.000151%	661814	99.92%	1	0.28%
攢	4450		22	1	0.000151%	661815	99.92%	1	0.28%
攸	4451		7	1	0.000151%	661816	99.92%	1	0.28%
攷	4452		7	1	0.000151%	661817	99.92%	1	0.28%
敕	4453		11	1	0.000151%	661818	99.92%	1	0.28%
旃	4454		10	1	0.000151%	661819	99.92%	1	0.28%
旎	4455		11	1	0.000151%	661820	99.92%	1	0.28%
旖	4456		14	1	0.000151%	661821	99.92%	1	0.28%
昃	4457		8	1	0.000151%	661822	99.92%	1	0.28%
昶	4458		9	1	0.000151%	661823	99.92%	1	0.28%
晷	4459		12	1	0.000151%	661824	99.92%	1	0.28%
晹	4460		12	1	0.000151%	661825	99.92%	1	0.28%
暄	4461		13	1	0.000151%	661826	99.92%	1	0.28%
暾	4462		16	1	0.000151%	661827	99.92%	1	0.28%
曖	4463		17	1	0.000151%	661828	99.92%	1	0.28%
曷	4464		9	1	0.000151%	661829	99.92%	1	0.28%
朕	4465		10	1	0.000151%	661830	99.92%	1	0.28%
朮	4466		5	1	0.000151%	661831	99.92%	1	0.28%
朴	4467		6	1	0.000151%	661832	99.92%	1	0.28%
杈	4468		7	1	0.000151%	661833	99.92%	1	0.28%
枋	4469		8	1	0.000151%	661834	99.92%	1	0.28%
杪	4470		8	1	0.000151%	661835	99.92%	1	0.28%
枆	4471		8	1	0.000151%	661836	99.92%	1	0.28%
柵	4472		9	1	0.000151%	661837	99.92%	1	0.28%
柝	4473		9	1	0.000151%	661838	99.92%	1	0.28%
枳	4474		9	1	0.000151%	661839	99.92%	1	0.28%
枹	4475		9	1	0.000151%	661840	99.92%	1	0.28%
桀	4476		10	1	0.000151%	661841	99.92%	1	0.28%
桅	4477		10	1	0.000151%	661842	99.92%	1	0.28%
梃	4478		11	1	0.000151%	661843	99.92%	1	0.28%
梟	4479		11	1	0.000151%	661844	99.92%	1	0.28%
桮	4480		11	1	0.000151%	661845	99.92%	1	0.28%
桷	4481		11	1	0.000151%	661846	99.92%	1	0.28%
梠	4482		11	1	0.000151%	661847	99.92%	1	0.28%
棺	4483		12	1	0.000151%	661848	99.92%	1	0.28%
棧	4484		12	1	0.000151%	661849	99.92%	1	0.28%
棹	4485		12	1	0.000151%	661850	99.92%	1	0.28%
棣	4486		12	1	0.000151%	661851	99.92%	1	0.28%
楮	4487		12	1	0.000151%	661852	99.92%	1	0.28%
椪	4488		12	1	0.000151%	661853	99.92%	1	0.28%
棬	4489		12	1	0.000151%	661854	99.92%	1	0.28%
椑	4490		12	1	0.000151%	661855	99.92%	1	0.28%
楢	4491		13	1	0.000151%	661856	99.92%	1	0.28%
椿	4492		13	1	0.000151%	661857	99.92%	1	0.28%
椹	4493		13	1	0.000151%	661858	99.92%	1	0.28%
椵	4494		13	1	0.000151%	661859	99.92%	1	0.28%
榫	4495		14	1	0.000151%	661860	99.93%	1	0.28%
槌	4496		14	1	0.000151%	661861	99.93%	1	0.28%
槃	4497		14	1	0.000151%	661862	99.93%	1	0.28%
樺	4498		16	1	0.000151%	661863	99.93%	1	0.28%
樾	4499		16	1	0.000151%	661864	99.93%	1	0.28%
樨	4500		16	1	0.000151%	661865	99.93%	1	0.28%
櫛	4501		17	1	0.000151%	661866	99.93%	1	0.28%
檎	4502		17	1	0.000151%	661867	99.93%	1	0.28%
檽	4503		18	1	0.000151%	661868	99.93%	1	0.28%
櫪	4504		20	1	0.000151%	661869	99.93%	1	0.28%
櫺	4505		21	1	0.000151%	661870	99.93%	1	0.28%
歟	4506		18	1	0.000151%	661871	99.93%	1	0.28%
歿	4507		8	1	0.000151%	661872	99.93%	1	0.28%
殃	4508		9	1	0.000151%	661873	99.93%	1	0.28%
殞	4509		14	1	0.000151%	661874	99.93%	1	0.28%
殯	4510		18	1	0.000151%	661875	99.93%	1	0.28%
毌	4511		4	1	0.000151%	661876	99.93%	1	0.28%
毽	4512		13	1	0.000151%	661877	99.93%	1	0.28%
氨	4513		10	1	0.000151%	661878	99.93%	1	0.28%
汐	4514		6	1	0.000151%	661879	99.93%	1	0.28%
汛	4515		6	1	0.000151%	661880	99.93%	1	0.28%
汔	4516		6	1	0.000151%	661881	99.93%	1	0.28%
汞	4517		7	1	0.000151%	661882	99.93%	1	0.28%
汨	4518		7	1	0.000151%	661883	99.93%	1	0.28%
汴	4519		7	1	0.000151%	661884	99.93%	1	0.28%
沔	4520		7	1	0.000151%	661885	99.93%	1	0.28%
泄	4521		8	1	0.000151%	661886	99.93%	1	0.28%
泱	4522		8	1	0.000151%	661887	99.93%	1	0.28%
沓	4523		8	1	0.000151%	661888	99.93%	1	0.28%
泫	4524		8	1	0.000151%	661889	99.93%	1	0.28%
洫	4525		9	1	0.000151%	661890	99.93%	1	0.28%
𣵀	4526		10	1	0.000151%	661891	99.93%	1	0.28%
涇	4527		10	1	0.000151%	661892	99.93%	1	0.28%
浹	4528		10	1	0.000151%	661893	99.93%	1	0.28%
浥	4529		10	1	0.000151%	661894	99.93%	1	0.28%
涂	4530		10	1	0.000151%	661895	99.93%	1	0.28%
淬	4531		11	1	0.000151%	661896	99.93%	1	0.28%
淖	4532		11	1	0.000151%	661897	99.93%	1	0.28%
淝	4533		11	1	0.000151%	661898	99.93%	1	0.28%
淭	4534		11	1	0.000151%	661899	99.93%	1	0.28%
湔	4535		12	1	0.000151%	661900	99.93%	1	0.28%
渣	4536		12	1	0.000151%	661901	99.93%	1	0.28%
湮	4537		12	1	0.000151%	661902	99.93%	1	0.28%
渭	4538		12	1	0.000151%	661903	99.93%	1	0.28%
渙	4539		12	1	0.000151%	661904	99.93%	1	0.28%
湲	4540		12	1	0.000151%	661905	99.93%	1	0.28%
滓	4541		13	1	0.000151%	661906	99.93%	1	0.28%
滇	4542		13	1	0.000151%	661907	99.93%	1	0.28%
溥	4543		13	1	0.000151%	661908	99.93%	1	0.28%
滃	4544		13	1	0.000151%	661909	99.93%	1	0.28%
漱	4545		14	1	0.000151%	661910	99.93%	1	0.28%
滕	4546		15	1	0.000151%	661911	99.93%	1	0.28%
濂	4547		16	1	0.000151%	661912	99.93%	1	0.28%
澠	4548		16	1	0.000151%	661913	99.93%	1	0.28%
澣	4549		16	1	0.000151%	661914	99.93%	1	0.28%
濇	4550		16	1	0.000151%	661915	99.93%	1	0.28%
濬	4551		17	1	0.000151%	661916	99.93%	1	0.28%
瀆	4552		18	1	0.000151%	661917	99.93%	1	0.28%
瀏	4553		18	1	0.000151%	661918	99.93%	1	0.28%
灯	4554		6	1	0.000151%	661919	99.93%	1	0.28%
烊	4555		10	1	0.000151%	661920	99.93%	1	0.28%
烶	4556		11	1	0.000151%	661921	99.93%	1	0.28%
焙	4557		12	1	0.000151%	661922	99.93%	1	0.28%
煨	4558		13	1	0.000151%	661923	99.93%	1	0.28%
熲	4559		15	1	0.000151%	661924	99.93%	1	0.28%
熠	4560		15	1	0.000151%	661925	99.93%	1	0.28%
燐	4561		16	1	0.000151%	661926	99.94%	1	0.28%
熹	4562		16	1	0.000151%	661927	99.94%	1	0.28%
燾	4563		18	1	0.000151%	661928	99.94%	1	0.28%
爻	4564		4	1	0.000151%	661929	99.94%	1	0.28%
牋	4565		12	1	0.000151%	661930	99.94%	1	0.28%
牘	4566		19	1	0.000151%	661931	99.94%	1	0.28%
牴	4567		9	1	0.000151%	661932	99.94%	1	0.28%
犁	4568		11	1	0.000151%	661933	99.94%	1	0.28%
犍	4569		13	1	0.000151%	661934	99.94%	1	0.28%
狃	4570		7	1	0.000151%	661935	99.94%	1	0.28%
狷	4571		10	1	0.000151%	661936	99.94%	1	0.28%
猙	4572		11	1	0.000151%	661937	99.94%	1	0.28%
猢	4573		12	1	0.000151%	661938	99.94%	1	0.28%
猿	4574		13	1	0.000151%	661939	99.94%	1	0.28%
猻	4575		13	1	0.000151%	661940	99.94%	1	0.28%
玀	4576		22	1	0.000151%	661941	99.94%	1	0.28%
玢	4577		8	1	0.000151%	661942	99.94%	1	0.28%
玷	4578		9	1	0.000151%	661943	99.94%	1	0.28%
珂	4579		9	1	0.000151%	661944	99.94%	1	0.28%
琪	4580		12	1	0.000151%	661945	99.94%	1	0.28%
琥	4581		12	1	0.000151%	661946	99.94%	1	0.28%
琵	4582		12	1	0.000151%	661947	99.94%	1	0.28%
琛	4583		12	1	0.000151%	661948	99.94%	1	0.28%
璀	4584		15	1	0.000151%	661949	99.94%	1	0.28%
璇	4585		15	1	0.000151%	661950	99.94%	1	0.28%
璽	4586		19	1	0.000151%	661951	99.94%	1	0.28%
瓢	4587		16	1	0.000151%	661952	99.94%	1	0.28%
瓤	4588		22	1	0.000151%	661953	99.94%	1	0.28%
甌	4589		16	1	0.000151%	661954	99.94%	1	0.28%
甗	4590		21	1	0.000151%	661955	99.94%	1	0.28%
甬	4591		7	1	0.000151%	661956	99.94%	1	0.28%
甯	4592		12	1	0.000151%	661957	99.94%	1	0.28%
畛	4593		10	1	0.000151%	661958	99.94%	1	0.28%
疔	4594		7	1	0.000151%	661959	99.94%	1	0.28%
疴	4595		10	1	0.000151%	661960	99.94%	1	0.28%
疱	4596		10	1	0.000151%	661961	99.94%	1	0.28%
疽	4597		10	1	0.000151%	661962	99.94%	1	0.28%
痔	4598		11	1	0.000151%	661963	99.94%	1	0.28%
痍	4599		11	1	0.000151%	661964	99.94%	1	0.28%
痣	4600		12	1	0.000151%	661965	99.94%	1	0.28%
痲	4601		13	1	0.000151%	661966	99.94%	1	0.28%
痿	4602		13	1	0.000151%	661967	99.94%	1	0.28%
痳	4603		13	1	0.000151%	661968	99.94%	1	0.28%
痼	4604		13	1	0.000151%	661969	99.94%	1	0.28%
瘩	4605		15	1	0.000151%	661970	99.94%	1	0.28%
瘼	4606		16	1	0.000151%	661971	99.94%	1	0.28%
瘰	4607		16	1	0.000151%	661972	99.94%	1	0.28%
癘	4608		18	1	0.000151%	661973	99.94%	1	0.28%
癭	4609		22	1	0.000151%	661974	99.94%	1	0.28%
癲	4610		24	1	0.000151%	661975	99.94%	1	0.28%
癸	4611		9	1	0.000151%	661976	99.94%	1	0.28%
皋	4612		10	1	0.000151%	661977	99.94%	1	0.28%
盥	4613		16	1	0.000151%	661978	99.94%	1	0.28%
睬	4614		13	1	0.000151%	661979	99.94%	1	0.28%
睥	4615		13	1	0.000151%	661980	99.94%	1	0.28%
睢	4616		13	1	0.000151%	661981	99.94%	1	0.28%
瞠	4617		16	1	0.000151%	661982	99.94%	1	0.28%
瞳	4618		17	1	0.000151%	661983	99.94%	1	0.28%
瞶	4619		17	1	0.000151%	661984	99.94%	1	0.28%
瞼	4620		18	1	0.000151%	661985	99.94%	1	0.28%
矧	4621		9	1	0.000151%	661986	99.94%	1	0.28%
砉	4622		9	1	0.000151%	661987	99.94%	1	0.28%
砧	4623		10	1	0.000151%	661988	99.94%	1	0.28%
砝	4624		10	1	0.000151%	661989	99.94%	1	0.28%
砷	4625		10	1	0.000151%	661990	99.94%	1	0.28%
砭	4626		10	1	0.000151%	661991	99.94%	1	0.28%
砫	4627		10	1	0.000151%	661992	99.95%	1	0.28%
硃	4628		11	1	0.000151%	661993	99.95%	1	0.28%
砦	4629		11	1	0.000151%	661994	99.95%	1	0.28%
碇	4630		13	1	0.000151%	661995	99.95%	1	0.28%
碞	4631		14	1	0.000151%	661996	99.95%	1	0.28%
礡	4632		19	1	0.000151%	661997	99.95%	1	0.28%
礱	4633		21	1	0.000151%	661998	99.95%	1	0.28%
祁	4634		7	1	0.000151%	661999	99.95%	1	0.28%
祐	4635		9	1	0.000151%	662000	99.95%	1	0.28%
祚	4636		9	1	0.000151%	662001	99.95%	1	0.28%
祟	4637		10	1	0.000151%	662002	99.95%	1	0.28%
祿	4638		12	1	0.000151%	662003	99.95%	1	0.28%
祼	4639		12	1	0.000151%	662004	99.95%	1	0.28%
禳	4640		21	1	0.000151%	662005	99.95%	1	0.28%
种	4641		9	1	0.000151%	662006	99.95%	1	0.28%
稷	4642		15	1	0.000151%	662007	99.95%	1	0.28%
窠	4643		13	1	0.000151%	662008	99.95%	1	0.28%
窳	4644		15	1	0.000151%	662009	99.95%	1	0.28%
窿	4645		17	1	0.000151%	662010	99.95%	1	0.28%
竺	4646		8	1	0.000151%	662011	99.95%	1	0.28%
竽	4647		9	1	0.000151%	662012	99.95%	1	0.28%
笋	4648		10	1	0.000151%	662013	99.95%	1	0.28%
笄	4649		10	1	0.000151%	662014	99.95%	1	0.28%
笙	4650		11	1	0.000151%	662015	99.95%	1	0.28%
筐	4651		12	1	0.000151%	662016	99.95%	1	0.28%
笻	4652		12	1	0.000151%	662017	99.95%	1	0.28%
筠	4653		13	1	0.000151%	662018	99.95%	1	0.28%
簑	4654		16	1	0.000151%	662019	99.95%	1	0.28%
篝	4655		16	1	0.000151%	662020	99.95%	1	0.28%
篔	4656		16	1	0.000151%	662021	99.95%	1	0.28%
簣	4657		18	1	0.000151%	662022	99.95%	1	0.28%
簠	4658		18	1	0.000151%	662023	99.95%	1	0.28%
簸	4659		19	1	0.000151%	662024	99.95%	1	0.28%
簹	4660		19	1	0.000151%	662025	99.95%	1	0.28%
籮	4661		25	1	0.000151%	662026	99.95%	1	0.28%
粼	4662		14	1	0.000151%	662027	99.95%	1	0.28%
糰	4663		20	1	0.000151%	662028	99.95%	1	0.28%
紜	4664		10	1	0.000151%	662029	99.95%	1	0.28%
紏	4665		10	1	0.000151%	662030	99.95%	1	0.28%
紬	4666		11	1	0.000151%	662031	99.95%	1	0.28%
紿	4667		11	1	0.000151%	662032	99.95%	1	0.28%
絜	4668		12	1	0.000151%	662033	99.95%	1	0.28%
綉	4669		13	1	0.000151%	662034	99.95%	1	0.28%
綑	4670		13	1	0.000151%	662035	99.95%	1	0.28%
綏	4671		13	1	0.000151%	662036	99.95%	1	0.28%
綃	4672		13	1	0.000151%	662037	99.95%	1	0.28%
綰	4673		14	1	0.000151%	662038	99.95%	1	0.28%
綵	4674		14	1	0.000151%	662039	99.95%	1	0.28%
綟	4675		14	1	0.000151%	662040	99.95%	1	0.28%
綦	4676		14	1	0.000151%	662041	99.95%	1	0.28%
縊	4677		16	1	0.000151%	662042	99.95%	1	0.28%
縉	4678		16	1	0.000151%	662043	99.95%	1	0.28%
縟	4679		16	1	0.000151%	662044	99.95%	1	0.28%
顈	4680		17	1	0.000151%	662045	99.95%	1	0.28%
繕	4681		18	1	0.000151%	662046	99.95%	1	0.28%
繭	4682		19	1	0.000151%	662047	99.95%	1	0.28%
纙	4683		25	1	0.000151%	662048	99.95%	1	0.28%
罈	4684		18	1	0.000151%	662049	99.95%	1	0.28%
罌	4685		20	1	0.000151%	662050	99.95%	1	0.28%
罣	4686		11	1	0.000151%	662051	99.95%	1	0.28%
羌	4687		8	1	0.000151%	662052	99.95%	1	0.28%
翕	4688		12	1	0.000151%	662053	99.95%	1	0.28%
耒	4689		6	1	0.000151%	662054	99.95%	1	0.28%
耨	4690		16	1	0.000151%	662055	99.95%	1	0.28%
聃	4691		11	1	0.000151%	662056	99.95%	1	0.28%
聿	4692		6	1	0.000151%	662057	99.95%	1	0.28%
肄	4693		13	1	0.000151%	662058	99.96%	1	0.28%
胤	4694		9	1	0.000151%	662059	99.96%	1	0.28%
胝	4695		9	1	0.000151%	662060	99.96%	1	0.28%
胠	4696		9	1	0.000151%	662061	99.96%	1	0.28%
胼	4697		10	1	0.000151%	662062	99.96%	1	0.28%
脖	4698		11	1	0.000151%	662063	99.96%	1	0.28%
腆	4699		12	1	0.000151%	662064	99.96%	1	0.28%
腓	4700		12	1	0.000151%	662065	99.96%	1	0.28%
腱	4701		13	1	0.000151%	662066	99.96%	1	0.28%
臃	4702		17	1	0.000151%	662067	99.96%	1	0.28%
臊	4703		17	1	0.000151%	662068	99.96%	1	0.28%
臚	4704		20	1	0.000151%	662069	99.96%	1	0.28%
臾	4705		8	1	0.000151%	662070	99.96%	1	0.28%
芷	4706		8	1	0.000151%	662071	99.96%	1	0.28%
芮	4707		8	1	0.000151%	662072	99.96%	1	0.28%
苞	4708		9	1	0.000151%	662073	99.96%	1	0.28%
苕	4709		9	1	0.000151%	662074	99.96%	1	0.28%
荐	4710		10	1	0.000151%	662075	99.96%	1	0.28%
荀	4711		10	1	0.000151%	662076	99.96%	1	0.28%
茨	4712		10	1	0.000151%	662077	99.96%	1	0.28%
荸	4713		11	1	0.000151%	662078	99.96%	1	0.28%
萃	4714		12	1	0.000151%	662079	99.96%	1	0.28%
菅	4715		12	1	0.000151%	662080	99.96%	1	0.28%
菖	4716		12	1	0.000151%	662081	99.96%	1	0.28%
韮	4717		13	1	0.000151%	662082	99.96%	1	0.28%
葫	4718		13	1	0.000151%	662083	99.96%	1	0.28%
葆	4719		13	1	0.000151%	662084	99.96%	1	0.28%
蒞	4720		14	1	0.000151%	662085	99.96%	1	0.28%
蓀	4721		14	1	0.000151%	662086	99.96%	1	0.28%
蒺	4722		14	1	0.000151%	662087	99.96%	1	0.28%
蔻	4723		15	1	0.000151%	662088	99.96%	1	0.28%
蓼	4724		15	1	0.000151%	662089	99.96%	1	0.28%
蕖	4725		16	1	0.000151%	662090	99.96%	1	0.28%
薤	4726		17	1	0.000151%	662091	99.96%	1	0.28%
藐	4727		18	1	0.000151%	662092	99.96%	1	0.28%
薺	4728		18	1	0.000151%	662093	99.96%	1	0.28%
藪	4729		19	1	0.000151%	662094	99.96%	1	0.28%
藜	4730		19	1	0.000151%	662095	99.96%	1	0.28%
蘚	4731		21	1	0.000151%	662096	99.96%	1	0.28%
蘘	4732		21	1	0.000151%	662097	99.96%	1	0.28%
蘧	4733		21	1	0.000151%	662098	99.96%	1	0.28%
蘼	4734		23	1	0.000151%	662099	99.96%	1	0.28%
虌	4735		29	1	0.000151%	662100	99.96%	1	0.28%
虫	4736		6	1	0.000151%	662101	99.96%	1	0.28%
蚪	4737		10	1	0.000151%	662102	99.96%	1	0.28%
蚓	4738		10	1	0.000151%	662103	99.96%	1	0.28%
蚣	4739		10	1	0.000151%	662104	99.96%	1	0.28%
蚋	4740		10	1	0.000151%	662105	99.96%	1	0.28%
蚶	4741		11	1	0.000151%	662106	99.96%	1	0.28%
蚯	4742		11	1	0.000151%	662107	99.96%	1	0.28%
蛹	4743		13	1	0.000151%	662108	99.96%	1	0.28%
蜈	4744		13	1	0.000151%	662109	99.96%	1	0.28%
蜉	4745		13	1	0.000151%	662110	99.96%	1	0.28%
蜩	4746		14	1	0.000151%	662111	99.96%	1	0.28%
蜮	4747		14	1	0.000151%	662112	99.96%	1	0.28%
螂	4748		15	1	0.000151%	662113	99.96%	1	0.28%
蝸	4749		15	1	0.000151%	662114	99.96%	1	0.28%
蝗	4750		15	1	0.000151%	662115	99.96%	1	0.28%
蝌	4751		15	1	0.000151%	662116	99.96%	1	0.28%
蝣	4752		15	1	0.000151%	662117	99.96%	1	0.28%
蝎	4753		15	1	0.000151%	662118	99.96%	1	0.28%
螗	4754		16	1	0.000151%	662119	99.96%	1	0.28%
螳	4755		17	1	0.000151%	662120	99.96%	1	0.28%
蟒	4756		17	1	0.000151%	662121	99.96%	1	0.28%
螫	4757		17	1	0.000151%	662122	99.96%	1	0.28%
螻	4758		17	1	0.000151%	662123	99.96%	1	0.28%
蟠	4759		18	1	0.000151%	662124	99.96%	1	0.28%
蠹	4760		24	1	0.000151%	662125	99.97%	1	0.28%
衙	4761		13	1	0.000151%	662126	99.97%	1	0.28%
衢	4762		24	1	0.000151%	662127	99.97%	1	0.28%
袂	4763		9	1	0.000151%	662128	99.97%	1	0.28%
衲	4764		9	1	0.000151%	662129	99.97%	1	0.28%
袒	4765		10	1	0.000151%	662130	99.97%	1	0.28%
衾	4766		10	1	0.000151%	662131	99.97%	1	0.28%
袞	4767		11	1	0.000151%	662132	99.97%	1	0.28%
褂	4768		13	1	0.000151%	662133	99.97%	1	0.28%
裱	4769		13	1	0.000151%	662134	99.97%	1	0.28%
襌	4770		17	1	0.000151%	662135	99.97%	1	0.28%
襖	4771		18	1	0.000151%	662136	99.97%	1	0.28%
襤	4772		19	1	0.000151%	662137	99.97%	1	0.28%
覈	4773		19	1	0.000151%	662138	99.97%	1	0.28%
覡	4774		14	1	0.000151%	662139	99.97%	1	0.28%
覲	4775		18	1	0.000151%	662140	99.97%	1	0.28%
覷	4776		19	1	0.000151%	662141	99.97%	1	0.28%
覿	4777		22	1	0.000151%	662142	99.97%	1	0.28%
觫	4778		14	1	0.000151%	662143	99.97%	1	0.28%
觳	4779		17	1	0.000151%	662144	99.97%	1	0.28%
訏	4780		10	1	0.000151%	662145	99.97%	1	0.28%
訢	4781		11	1	0.000151%	662146	99.97%	1	0.28%
詎	4782		12	1	0.000151%	662147	99.97%	1	0.28%
詑	4783		12	1	0.000151%	662148	99.97%	1	0.28%
詣	4784		13	1	0.000151%	662149	99.97%	1	0.28%
詮	4785		13	1	0.000151%	662150	99.97%	1	0.28%
詬	4786		13	1	0.000151%	662151	99.97%	1	0.28%
詵	4787		13	1	0.000151%	662152	99.97%	1	0.28%
諉	4788		15	1	0.000151%	662153	99.97%	1	0.28%
諫	4789		16	1	0.000151%	662154	99.97%	1	0.28%
諼	4790		16	1	0.000151%	662155	99.97%	1	0.28%
謔	4791		16	1	0.000151%	662156	99.97%	1	0.28%
謄	4792		17	1	0.000151%	662157	99.97%	1	0.28%
謤	4793		18	1	0.000151%	662158	99.97%	1	0.28%
譪	4794		20	1	0.000151%	662159	99.97%	1	0.28%
讞	4795		26	1	0.000151%	662160	99.97%	1	0.28%
谿	4796		17	1	0.000151%	662161	99.97%	1	0.28%
豉	4797		11	1	0.000151%	662162	99.97%	1	0.28%
豔	4798		28	1	0.000151%	662163	99.97%	1	0.28%
豸	4799		7	1	0.000151%	662164	99.97%	1	0.28%
賄	4800		13	1	0.000151%	662165	99.97%	1	0.28%
貲	4801		13	1	0.000151%	662166	99.97%	1	0.28%
賻	4802		17	1	0.000151%	662167	99.97%	1	0.28%
贖	4803		22	1	0.000151%	662168	99.97%	1	0.28%
趄	4804		12	1	0.000151%	662169	99.97%	1	0.28%
趑	4805		13	1	0.000151%	662170	99.97%	1	0.28%
趾	4806		11	1	0.000151%	662171	99.97%	1	0.28%
跛	4807		12	1	0.000151%	662172	99.97%	1	0.28%
跺	4808		13	1	0.000151%	662173	99.97%	1	0.28%
跫	4809		13	1	0.000151%	662174	99.97%	1	0.28%
踟	4810		15	1	0.000151%	662175	99.97%	1	0.28%
踮	4811		15	1	0.000151%	662176	99.97%	1	0.28%
踜	4812		15	1	0.000151%	662177	99.97%	1	0.28%
蹉	4813		17	1	0.000151%	662178	99.97%	1	0.28%
蹋	4814		17	1	0.000151%	662179	99.97%	1	0.28%
蹓	4815		17	1	0.000151%	662180	99.97%	1	0.28%
蹧	4816		18	1	0.000151%	662181	99.97%	1	0.28%
蹩	4817		18	1	0.000151%	662182	99.97%	1	0.28%
蹺	4818		19	1	0.000151%	662183	99.97%	1	0.28%
躓	4819		22	1	0.000151%	662184	99.97%	1	0.28%
躕	4820		22	1	0.000151%	662185	99.97%	1	0.28%
躚	4821		22	1	0.000151%	662186	99.97%	1	0.28%
躣	4822		25	1	0.000151%	662187	99.97%	1	0.28%
躦	4823		26	1	0.000151%	662188	99.97%	1	0.28%
躪	4824		27	1	0.000151%	662189	99.97%	1	0.28%
軻	4825		12	1	0.000151%	662190	99.97%	1	0.28%
軼	4826		12	1	0.000151%	662191	99.98%	1	0.28%
輻	4827		16	1	0.000151%	662192	99.98%	1	0.28%
輳	4828		16	1	0.000151%	662193	99.98%	1	0.28%
轢	4829		22	1	0.000151%	662194	99.98%	1	0.28%
逶	4830		11	1	0.000151%	662195	99.98%	1	0.28%
遁	4831		12	1	0.000151%	662196	99.98%	1	0.28%
邑	4832		7	1	0.000151%	662197	99.98%	1	0.28%
郝	4833		9	1	0.000151%	662198	99.98%	1	0.28%
酆	4834		20	1	0.000151%	662199	99.98%	1	0.28%
酢	4835		12	1	0.000151%	662200	99.98%	1	0.28%
酪	4836		13	1	0.000151%	662201	99.98%	1	0.28%
醐	4837		16	1	0.000151%	662202	99.98%	1	0.28%
醍	4838		16	1	0.000151%	662203	99.98%	1	0.28%
醪	4839		18	1	0.000151%	662204	99.98%	1	0.28%
醱	4840		19	1	0.000151%	662205	99.98%	1	0.28%
醵	4841		20	1	0.000151%	662206	99.98%	1	0.28%
釉	4842		13	1	0.000151%	662207	99.98%	1	0.28%
釵	4843		11	1	0.000151%	662208	99.98%	1	0.28%
鈉	4844		12	1	0.000151%	662209	99.98%	1	0.28%
鈐	4845		12	1	0.000151%	662210	99.98%	1	0.28%
鈄	4846		12	1	0.000151%	662211	99.98%	1	0.28%
鉤	4847		13	1	0.000151%	662212	99.98%	1	0.28%
鉸	4848		14	1	0.000151%	662213	99.98%	1	0.28%
鋅	4849		15	1	0.000151%	662214	99.98%	1	0.28%
鋓	4850		15	1	0.000151%	662215	99.98%	1	0.28%
鍍	4851		17	1	0.000151%	662216	99.98%	1	0.28%
鍔	4852		17	1	0.000151%	662217	99.98%	1	0.28%
鍼	4853		17	1	0.000151%	662218	99.98%	1	0.28%
鎔	4854		18	1	0.000151%	662219	99.98%	1	0.28%
鎊	4855		18	1	0.000151%	662220	99.98%	1	0.28%
鎳	4856		18	1	0.000151%	662221	99.98%	1	0.28%
鏑	4857		19	1	0.000151%	662222	99.98%	1	0.28%
鏗	4858		19	1	0.000151%	662223	99.98%	1	0.28%
鏇	4859		19	1	0.000151%	662224	99.98%	1	0.28%
鏐	4860		19	1	0.000151%	662225	99.98%	1	0.28%
鐺	4861		21	1	0.000151%	662226	99.98%	1	0.28%
鐫	4862		21	1	0.000151%	662227	99.98%	1	0.28%
鑣	4863		23	1	0.000151%	662228	99.98%	1	0.28%
鑠	4864		23	1	0.000151%	662229	99.98%	1	0.28%
閘	4865		13	1	0.000151%	662230	99.98%	1	0.28%
閞	4866		13	1	0.000151%	662231	99.98%	1	0.28%
閡	4867		14	1	0.000151%	662232	99.98%	1	0.28%
閬	4868		15	1	0.000151%	662233	99.98%	1	0.28%
闋	4869		17	1	0.000151%	662234	99.98%	1	0.28%
闇	4870		17	1	0.000151%	662235	99.98%	1	0.28%
闓	4871		18	1	0.000151%	662236	99.98%	1	0.28%
阜	4872		8	1	0.000151%	662237	99.98%	1	0.28%
陔	4873		8	1	0.000151%	662238	99.98%	1	0.28%
陟	4874		9	1	0.000151%	662239	99.98%	1	0.28%
隈	4875		11	1	0.000151%	662240	99.98%	1	0.28%
隕	4876		12	1	0.000151%	662241	99.98%	1	0.28%
雉	4877		13	1	0.000151%	662242	99.98%	1	0.28%
雒	4878		14	1	0.000151%	662243	99.98%	1	0.28%
霾	4879		22	1	0.000151%	662244	99.98%	1	0.28%
靆	4880		24	1	0.000151%	662245	99.98%	1	0.28%
靛	4881		16	1	0.000151%	662246	99.98%	1	0.28%
靦	4882		16	1	0.000151%	662247	99.98%	1	0.28%
靭	4883		12	1	0.000151%	662248	99.98%	1	0.28%
靼	4884		14	1	0.000151%	662249	99.98%	1	0.28%
鞍	4885		15	1	0.000151%	662250	99.98%	1	0.28%
鞏	4886		15	1	0.000151%	662251	99.98%	1	0.28%
鞘	4887		16	1	0.000151%	662252	99.98%	1	0.28%
鞣	4888		18	1	0.000151%	662253	99.98%	1	0.28%
鞦	4889		18	1	0.000151%	662254	99.98%	1	0.28%
韃	4890		22	1	0.000151%	662255	99.98%	1	0.28%
韆	4891		24	1	0.000151%	662256	99.98%	1	0.28%
韋	4892		9	1	0.000151%	662257	99.99%	1	0.28%
頜	4893		15	1	0.000151%	662258	99.99%	1	0.28%
頷	4894		16	1	0.000151%	662259	99.99%	1	0.28%
飴	4895		13	1	0.000151%	662260	99.99%	1	0.28%
餉	4896		14	1	0.000151%	662261	99.99%	1	0.28%
餡	4897		16	1	0.000151%	662262	99.99%	1	0.28%
饈	4898		19	1	0.000151%	662263	99.99%	1	0.28%
饗	4899		21	1	0.000151%	662264	99.99%	1	0.28%
饕	4900		22	1	0.000151%	662265	99.99%	1	0.28%
駒	4901		15	1	0.000151%	662266	99.99%	1	0.28%
駖	4902		15	1	0.000151%	662267	99.99%	1	0.28%
駰	4903		16	1	0.000151%	662268	99.99%	1	0.28%
騫	4904		20	1	0.000151%	662269	99.99%	1	0.28%
驥	4905		26	1	0.000151%	662270	99.99%	1	0.28%
骯	4906		14	1	0.000151%	662271	99.99%	1	0.28%
髲	4907		15	1	0.000151%	662272	99.99%	1	0.28%
鬨	4908		16	1	0.000151%	662273	99.99%	1	0.28%
鬮	4909		26	1	0.000151%	662274	99.99%	1	0.28%
鬲	4910		10	1	0.000151%	662275	99.99%	1	0.28%
魽	4911		15	1	0.000151%	662276	99.99%	1	0.28%
鮐	4912		16	1	0.000151%	662277	99.99%	1	0.28%
鯇	4913		18	1	0.000151%	662278	99.99%	1	0.28%
鯧	4914		19	1	0.000151%	662279	99.99%	1	0.28%
鯕	4915		19	1	0.000151%	662280	99.99%	1	0.28%
鰍	4916		20	1	0.000151%	662281	99.99%	1	0.28%
鰥	4917		21	1	0.000151%	662282	99.99%	1	0.28%
鱉	4918		22	1	0.000151%	662283	99.99%	1	0.28%
鰲	4919		22	1	0.000151%	662284	99.99%	1	0.28%
鱔	4920		23	1	0.000151%	662285	99.99%	1	0.28%
鱟	4921		24	1	0.000151%	662286	99.99%	1	0.28%
鳶	4922		14	1	0.000151%	662287	99.99%	1	0.28%
鴕	4923		16	1	0.000151%	662288	99.99%	1	0.28%
鴣	4924		16	1	0.000151%	662289	99.99%	1	0.28%
鵲	4925		19	1	0.000151%	662290	99.99%	1	0.28%
鵪	4926		19	1	0.000151%	662291	99.99%	1	0.28%
鶩	4927		20	1	0.000151%	662292	99.99%	1	0.28%
鷓	4928		22	1	0.000151%	662293	99.99%	1	0.28%
鷺	4929		24	1	0.000151%	662294	99.99%	1	0.28%
鸁	4930		24	1	0.000151%	662295	99.99%	1	0.28%
鹵	4931		11	1	0.000151%	662296	99.99%	1	0.28%
鹼	4932		24	1	0.000151%	662297	99.99%	1	0.28%
麃	4933		15	1	0.000151%	662298	99.99%	1	0.28%
麜	4934		21	1	0.000151%	662299	99.99%	1	0.28%
齧	4935		21	1	0.000151%	662300	99.99%	1	0.28%
龔	4936		22	1	0.000151%	662301	99.99%	1	0.28%
龕	4937		22	1	0.000151%	662302	99.99%	1	0.28%
