單字	序號	部首	筆劃	頻次	頻率	累積頻次	累積頻率	見檔次	見檔率
一	2		1	10843	1.637%	10843	5.711%	360	99.17%
的	1		8	26987	4.074%	37830	4.074%	358	98.62%
在	6		6	6756	1.020%	44586	10.32%	358	98.62%
有	7		6	6694	1.011%	51280	11.33%	352	96.97%
是	3		9	8712	1.315%	59992	7.027%	346	95.32%
不	4		4	7660	1.156%	67652	8.183%	346	95.32%
上	16		3	3548	0.5357%	71200	17.39%	341	93.94%
中	13		4	3872	0.5846%	75072	15.73%	337	92.84%
人	8		2	5809	0.877%	80881	12.20%	336	92.56%
為	11		9	4682	0.7069%	85563	14.48%	336	92.56%
以	12		5	4427	0.6684%	89990	15.15%	334	92.01%
大	17		3	3431	0.518%	93421	17.90%	333	91.74%
來	20		8	3207	0.4842%	96628	19.40%	333	91.74%
時	18		10	3410	0.5148%	100038	18.42%	330	90.91%
自	40		6	2112	0.3189%	102150	27.02%	327	90.08%
而	19		6	3261	0.4923%	105411	18.91%	325	89.53%
可	25		5	2908	0.439%	108319	21.69%	323	88.98%
生	24		5	2998	0.4526%	111317	21.26%	322	88.71%
於	26		8	2882	0.4351%	114199	22.13%	322	88.71%
個	23		10	2999	0.4528%	117198	20.80%	320	88.15%
要	32		9	2310	0.3488%	119508	24.38%	320	88.15%
地	27		6	2714	0.4097%	122222	22.54%	319	87.88%
了	9		2	5211	0.7867%	127433	12.99%	318	87.60%
這	14		10	3833	0.5787%	131266	16.31%	318	87.60%
到	28		8	2618	0.3953%	133884	22.93%	316	87.05%
之	10		4	5162	0.7793%	139046	13.77%	314	86.50%
得	33		11	2304	0.3478%	141350	24.73%	313	86.23%
後	56		9	1780	0.2687%	143130	31.66%	312	85.95%
多	44		6	2014	0.3041%	145144	28.26%	310	85.40%
然	52		12	1855	0.2801%	146999	30.57%	310	85.40%
如	39		6	2122	0.3204%	149121	26.70%	309	85.12%
出	48		5	1897	0.2864%	151018	29.44%	309	85.12%
下	62		3	1690	0.2551%	152708	33.22%	309	85.12%
成	54		6	1831	0.2764%	154539	31.13%	307	84.57%
我	5		7	7375	1.113%	161914	9.297%	305	84.02%
所	30		8	2385	0.3601%	164299	23.68%	305	84.02%
對	49		14	1897	0.2864%	166196	29.73%	304	83.75%
過	61		12	1704	0.2573%	167900	32.97%	304	83.75%
會	37		13	2159	0.326%	170059	26.06%	302	83.20%
但	78		7	1445	0.2182%	171504	37.04%	300	82.64%
年	31		6	2357	0.3559%	173861	24.03%	298	82.09%
他	21		5	3179	0.480%	177040	19.88%	296	81.54%
也	29		3	2540	0.3835%	179580	23.32%	296	81.54%
能	43		10	2033	0.3069%	181613	27.95%	295	81.27%
前	89		9	1331	0.2009%	182944	39.32%	294	80.99%
們	22		10	3138	0.4738%	186082	20.35%	293	80.72%
同	84		6	1381	0.2085%	187463	38.30%	293	80.72%
經	68		13	1637	0.2471%	189100	34.73%	292	80.44%
發	59		12	1734	0.2618%	190834	32.45%	291	80.17%
其	36		8	2168	0.3273%	193002	25.73%	289	79.61%
已	85		3	1356	0.2047%	194358	38.51%	289	79.61%
說	34		14	2268	0.3424%	196626	25.07%	287	79.06%
此	55		6	1787	0.2698%	198413	31.40%	287	79.06%
因	60		6	1711	0.2583%	200124	32.71%	286	78.79%
無	76		12	1497	0.226%	201621	36.60%	286	78.79%
都	74		9	1530	0.231%	203151	36.15%	285	78.51%
當	87		13	1350	0.2038%	204501	38.91%	285	78.51%
就	46		12	1969	0.2973%	206470	28.86%	284	78.24%
家	51		10	1861	0.281%	208331	30.29%	284	78.24%
面	72		9	1563	0.236%	209894	35.69%	284	78.24%
日	73		4	1548	0.2337%	211442	35.92%	284	78.24%
作	38		7	2141	0.3232%	213583	26.38%	283	77.96%
方	63		4	1679	0.2535%	215262	33.48%	282	77.69%
天	67		4	1645	0.2484%	216907	34.48%	282	77.69%
起	91		10	1299	0.1961%	218206	39.71%	280	77.13%
最	116		12	1076	0.1625%	219282	44.14%	278	76.58%
與	41		14	2073	0.313%	221355	27.33%	277	76.31%
去	77		5	1455	0.2197%	222810	36.82%	277	76.31%
和	50		8	1881	0.284%	224691	30.01%	275	75.76%
種	57		14	1750	0.2642%	226441	31.93%	274	75.48%
十	58		2	1745	0.2635%	228186	32.19%	274	75.48%
心	71		4	1568	0.2367%	229754	35.45%	274	75.48%
開	111		12	1103	0.1665%	230857	43.31%	274	75.48%
事	86		8	1350	0.2038%	232207	38.71%	273	75.21%
現	90		11	1301	0.1964%	233508	39.51%	273	75.21%
外	81		5	1386	0.2093%	234894	37.68%	272	74.93%
行	94		6	1277	0.1928%	236171	40.29%	272	74.93%
用	42		5	2069	0.3124%	238240	27.65%	271	74.66%
使	98		8	1221	0.1843%	239461	41.04%	270	74.38%
間	107		12	1131	0.1708%	240592	42.64%	270	74.38%
小	64		3	1677	0.2532%	242269	33.73%	268	73.83%
意	112		13	1101	0.1662%	243370	43.48%	268	73.83%
國	15		11	3592	0.5423%	246962	16.85%	266	73.28%
並	133		8	965	0.1457%	247927	46.72%	266	73.28%
由	93		5	1285	0.194%	249212	40.10%	264	72.73%
好	95		6	1274	0.1923%	250486	40.48%	264	72.73%
實	97		14	1227	0.1852%	251713	40.86%	264	72.73%
二	101		2	1211	0.1828%	252924	41.59%	264	72.73%
分	92		4	1298	0.196%	254222	39.91%	263	72.45%
又	105		2	1135	0.1714%	255357	42.30%	262	72.18%
將	136		11	941	0.1421%	256298	47.15%	262	72.18%
重	113		9	1101	0.1662%	257399	43.64%	260	71.63%
子	47		3	1951	0.2946%	259350	29.15%	259	71.35%
三	80		3	1397	0.2109%	260747	37.47%	259	71.35%
從	143		11	912	0.1377%	261659	48.13%	257	70.80%
正	150		5	889	0.1342%	262548	49.08%	255	70.25%
高	115		10	1090	0.1646%	263638	43.97%	254	69.97%
少	161		4	825	0.1246%	264463	50.50%	254	69.97%
向	193		6	713	0.1076%	265176	54.22%	253	69.70%
那	35		6	2208	0.3334%	267384	25.41%	252	69.42%
情	121		11	1039	0.1569%	268423	44.93%	252	69.42%
進	126		11	986	0.1489%	269409	45.69%	252	69.42%
常	140		11	922	0.1392%	270331	47.71%	252	69.42%
者	75		8	1498	0.2262%	271829	36.38%	251	69.15%
等	100		12	1214	0.1833%	273043	41.41%	251	69.15%
長	108		8	1122	0.1694%	274165	42.81%	250	68.87%
兩	132		8	971	0.1466%	275136	46.58%	250	68.87%
本	70		5	1599	0.2414%	276735	35.21%	248	68.32%
動	122		11	1022	0.1543%	277757	45.09%	247	68.04%
理	83		11	1384	0.209%	279141	38.09%	246	67.77%
美	99		9	1219	0.184%	280360	41.23%	245	67.49%
見	166		7	806	0.1217%	281166	51.12%	245	67.49%
點	139		17	923	0.1394%	282089	47.57%	244	67.22%
全	141		6	920	0.1389%	283009	47.85%	244	67.22%
定	134		8	956	0.1443%	283965	46.87%	242	66.67%
至	147		6	906	0.1368%	284871	48.68%	241	66.39%
及	69		4	1615	0.2438%	286486	34.97%	240	66.12%
果	154		8	871	0.1315%	287357	49.61%	240	66.12%
相	155		9	862	0.1301%	288219	49.74%	240	66.12%
更	162		7	822	0.1241%	289041	50.63%	239	65.84%
四	131		5	972	0.1467%	290013	46.43%	238	65.56%
加	119		5	1050	0.1585%	291063	44.62%	237	65.29%
些	125		8	987	0.149%	292050	45.54%	237	65.29%
力	152		2	881	0.133%	292931	49.35%	236	65.01%
想	96		13	1256	0.1896%	294187	40.67%	235	64.74%
沒	118		7	1063	0.1605%	295250	44.46%	234	64.46%
知	142		8	915	0.1381%	296165	47.99%	233	64.19%
看	104		9	1141	0.1723%	297306	42.13%	231	63.64%
還	144		16	911	0.1375%	298217	48.26%	231	63.64%
只	146		5	907	0.1369%	299124	48.54%	230	63.36%
應	148		17	895	0.1351%	300019	48.81%	230	63.36%
樣	123		15	1019	0.1538%	301038	45.24%	227	62.53%
學	45		16	2006	0.3029%	303044	28.56%	226	62.26%
法	79		8	1424	0.215%	304468	37.26%	226	62.26%
新	129		13	979	0.1478%	305447	46.14%	226	62.26%
道	145		12	908	0.1371%	306355	48.40%	226	62.26%
處	168		11	799	0.1206%	307154	51.36%	225	61.98%
次	177		6	773	0.1167%	307927	52.43%	224	61.71%
五	130		4	976	0.1474%	308903	46.28%	223	61.43%
明	163		8	817	0.1233%	309720	50.75%	223	61.43%
工	53		3	1844	0.2784%	311564	30.85%	222	61.16%
或	117		8	1071	0.1617%	312635	44.30%	222	61.16%
關	187		19	740	0.1117%	313375	53.57%	222	61.16%
何	212		7	656	0.09904%	314031	56.16%	222	61.16%
代	135		5	953	0.1439%	314984	47.01%	220	60.61%
每	189		7	727	0.1098%	315711	53.79%	220	60.61%
再	206		6	661	0.0998%	316372	55.56%	220	60.61%
部	114		10	1091	0.1647%	317463	43.81%	219	60.33%
曾	242		12	591	0.08923%	318054	58.97%	219	60.33%
必	200		5	676	0.1021%	318730	54.95%	217	59.78%
幾	232		12	618	0.0933%	319348	58.06%	217	59.78%
難	281		19	511	0.07715%	319859	62.20%	217	59.78%
原	178		10	763	0.1152%	320622	52.54%	216	59.50%
許	252		11	570	0.08606%	321192	59.85%	216	59.50%
著	102		12	1193	0.1801%	322385	41.77%	215	59.23%
頭	170		16	797	0.1203%	323182	51.60%	215	59.23%
問	176		11	776	0.1172%	323958	52.31%	215	59.23%
內	184		4	751	0.1134%	324709	53.23%	215	59.23%
且	247		5	581	0.08772%	325290	59.42%	215	59.23%
表	199		8	678	0.1024%	325968	54.85%	214	58.95%
主	120		5	1039	0.1569%	327007	44.77%	213	58.68%
平	180		5	760	0.1147%	327767	52.77%	213	58.68%
今	214		4	644	0.09723%	328411	56.35%	213	58.68%
很	158		9	850	0.1283%	329261	50.13%	212	58.40%
把	160		7	831	0.1255%	330092	50.38%	212	58.40%
手	205		4	667	0.1007%	330759	55.46%	212	58.40%
目	216		5	640	0.09662%	331399	56.54%	212	58.40%
立	194		5	708	0.1069%	332107	54.33%	211	58.13%
總	244		17	590	0.08908%	332697	59.15%	211	58.13%
位	181		7	757	0.1143%	333454	52.89%	210	57.85%
別	255		7	559	0.0844%	334013	60.10%	210	57.85%
麼	109		14	1120	0.1691%	335133	42.98%	209	57.58%
入	238		2	602	0.09089%	335735	58.61%	208	57.30%
近	258		7	552	0.08334%	336287	60.35%	208	57.30%
則	153		9	875	0.1321%	337162	49.48%	207	57.02%
月	159		4	844	0.1274%	338006	50.25%	207	57.02%
合	174		6	789	0.1191%	338795	52.08%	206	56.75%
受	231		8	620	0.09361%	339415	57.97%	206	56.75%
望	264		11	544	0.08213%	339959	60.85%	206	56.75%
像	149		14	889	0.1342%	340848	48.94%	205	56.47%
機	185		16	751	0.1134%	341599	53.34%	205	56.47%
世	186		5	741	0.1119%	342340	53.46%	205	56.47%
水	82		4	1385	0.2091%	343725	37.88%	204	56.20%
光	208		6	659	0.09949%	344384	55.76%	204	56.20%
身	240		7	598	0.09028%	344982	58.79%	204	56.20%
雖	295		17	497	0.07504%	345479	63.26%	204	56.20%
活	183		9	755	0.114%	346234	53.12%	202	55.65%
比	220		4	631	0.09527%	346865	56.93%	202	55.65%
先	167		6	801	0.1209%	347666	51.24%	201	55.37%
變	291		23	501	0.07564%	348167	62.96%	201	55.37%
物	157		8	851	0.1285%	349018	50.00%	199	54.82%
被	275		10	520	0.07851%	349538	61.73%	199	54.82%
直	299		8	490	0.07398%	350028	63.56%	199	54.82%
感	195		13	707	0.1067%	350735	54.44%	198	54.55%
深	304		11	485	0.07322%	351220	63.92%	198	54.55%
公	110		4	1116	0.1685%	352336	43.15%	197	54.27%
各	151		6	884	0.1335%	353220	49.21%	197	54.27%
非	243		8	591	0.08923%	353811	59.06%	197	54.27%
它	127		5	984	0.1486%	354795	45.84%	196	53.99%
回	201		6	674	0.1018%	355469	55.06%	195	53.72%
度	213		9	649	0.09798%	356118	56.25%	195	53.72%
數	239		15	601	0.09074%	356719	58.70%	195	53.72%
界	235		9	611	0.09225%	357330	58.34%	194	53.44%
給	225		12	627	0.09466%	357957	57.40%	193	53.17%
文	88		4	1332	0.2011%	359289	39.12%	192	52.89%
西	197		6	682	0.103%	359971	54.65%	191	52.62%
真	210		10	658	0.09934%	360629	55.96%	191	52.62%
特	233		10	617	0.09315%	361246	58.15%	191	52.62%
體	207		23	661	0.0998%	361907	55.66%	190	52.34%
利	156		7	858	0.1295%	362765	49.87%	189	52.07%
未	315		5	473	0.07141%	363238	64.72%	189	52.07%
太	164		4	812	0.1226%	364050	50.87%	188	51.79%
形	175		7	782	0.1181%	364832	52.20%	188	51.79%
氣	198		10	678	0.1024%	365510	54.75%	188	51.79%
名	226		6	626	0.09451%	366136	57.50%	188	51.79%
才	262		3	548	0.08273%	366684	60.69%	188	51.79%
性	191		8	726	0.1096%	367410	54.01%	187	51.52%
期	224		12	627	0.09466%	368037	57.31%	187	51.52%
便	215		9	641	0.09678%	368678	56.45%	186	51.24%
接	271		11	529	0.07987%	369207	61.42%	186	51.24%
風	236		9	609	0.09194%	369816	58.43%	185	50.96%
即	237		7	604	0.09119%	370420	58.52%	185	50.96%
任	308		6	482	0.07277%	370902	64.22%	185	50.96%
色	173		6	790	0.1193%	371692	51.96%	184	50.69%
第	230		11	621	0.09376%	372313	57.87%	184	50.69%
論	267		15	540	0.08153%	372853	61.10%	184	50.69%
業	66		13	1646	0.2485%	374499	34.23%	183	50.41%
該	266		13	540	0.08153%	375039	61.01%	183	50.41%
白	228		5	623	0.09406%	375662	57.69%	182	50.14%
結	290		12	501	0.07564%	376163	62.88%	182	50.14%
解	298		13	491	0.07413%	376654	63.48%	182	50.14%
東	289		8	501	0.07564%	377155	62.81%	181	49.86%
化	165		4	811	0.1224%	377966	51.00%	180	49.59%
己	204		3	670	0.1012%	378636	55.36%	180	49.59%
口	202		3	672	0.1015%	379308	55.16%	179	49.31%
完	346		7	433	0.06537%	379741	66.83%	179	49.31%
通	276		10	515	0.07775%	380256	61.81%	178	49.04%
甚	310		9	482	0.07277%	380738	64.36%	178	49.04%
似	337		7	442	0.06673%	381180	66.24%	178	49.04%
萬	268		13	536	0.08092%	381716	61.18%	177	48.76%
遠	305		13	485	0.07322%	382201	64.00%	177	48.76%
切	351		4	426	0.06432%	382627	67.15%	177	48.76%
步	379		7	391	0.05903%	383018	68.88%	177	48.76%
容	399		10	376	0.05677%	383394	70.04%	177	48.76%
海	137		10	933	0.1409%	384327	47.29%	175	48.21%
做	284		11	503	0.07594%	384830	62.43%	175	48.21%
提	286		12	502	0.07579%	385332	62.58%	175	48.21%
反	323		4	460	0.06945%	385792	65.29%	175	48.21%
除	368		9	402	0.06069%	386194	68.22%	175	48.21%
流	272		9	526	0.07941%	386720	61.50%	174	47.93%
百	217		6	639	0.09647%	387359	56.64%	173	47.66%
始	366		8	407	0.06145%	387766	68.10%	173	47.66%
花	172		8	794	0.1199%	388560	51.84%	172	47.38%
觀	282		25	509	0.07685%	389069	62.28%	172	47.38%
影	283		15	504	0.07609%	389573	62.35%	172	47.38%
言	318		7	468	0.07066%	390041	64.94%	171	47.11%
求	331		7	450	0.06794%	390491	65.83%	171	47.11%
足	422		7	349	0.05269%	390840	71.29%	171	47.11%
往	273		8	523	0.07896%	391363	61.58%	170	46.83%
故	287		9	502	0.07579%	391865	62.65%	169	46.56%
失	384		5	388	0.05858%	392253	69.17%	169	46.56%
愛	253		13	563	0.085%	392816	59.93%	168	46.28%
認	320		14	467	0.07051%	393283	65.08%	168	46.28%
滿	370		14	399	0.06024%	393682	68.34%	168	46.28%
六	261		4	549	0.08289%	394231	60.60%	167	46.01%
千	367		3	404	0.06099%	394635	68.16%	167	46.01%
神	256		9	559	0.0844%	395194	60.19%	166	45.73%
命	280		8	512	0.0773%	395706	62.12%	166	45.73%
整	409		16	360	0.05435%	396066	70.59%	166	45.73%
另	454		5	323	0.04877%	396389	72.93%	166	45.73%
民	128		5	982	0.1483%	397371	45.99%	165	45.45%
教	179		11	762	0.115%	398133	52.66%	165	45.45%
聲	229		17	623	0.09406%	398756	57.78%	165	45.45%
打	357		5	420	0.06341%	399176	67.54%	165	45.45%
取	426		8	347	0.05239%	399523	71.50%	165	45.45%
興	339		16	442	0.06673%	399965	66.37%	163	44.90%
類	218		19	639	0.09647%	400604	56.74%	162	44.63%
題	257		18	556	0.08394%	401160	60.27%	162	44.63%
達	349		12	430	0.06492%	401590	67.03%	162	44.63%
放	363		8	412	0.0622%	402002	67.91%	162	44.63%
視	428		12	346	0.05224%	402348	71.60%	162	44.63%
量	245		12	589	0.08892%	402937	59.24%	161	44.35%
記	307		10	483	0.07292%	403420	64.14%	161	44.35%
老	251		6	570	0.08606%	403990	59.76%	160	44.08%
空	301		8	488	0.07368%	404478	63.70%	160	44.08%
覺	317		20	473	0.07141%	404951	64.86%	160	44.08%
八	329		2	450	0.06794%	405401	65.70%	160	44.08%
份	335		6	444	0.06703%	405845	66.10%	160	44.08%
乎	421		5	349	0.05269%	406194	71.23%	159	43.80%
安	277		6	514	0.0776%	406708	61.89%	158	43.53%
須	297		12	494	0.07458%	407202	63.41%	158	43.53%
照	418		13	352	0.05314%	407554	71.08%	158	43.53%
指	440		9	342	0.05163%	407896	72.22%	158	43.53%
仍	472		4	308	0.0465%	408204	73.79%	158	43.53%
展	196		10	706	0.1066%	408910	54.54%	157	43.25%
眼	376		11	394	0.05948%	409304	68.70%	157	43.25%
產	106		11	1131	0.1708%	410435	42.47%	156	42.98%
清	387		11	386	0.05828%	410821	69.35%	156	42.98%
單	427		12	346	0.05224%	411167	71.55%	156	42.98%
久	505		3	288	0.04348%	411455	75.27%	156	42.98%
計	241		9	595	0.08983%	412050	58.88%	155	42.70%
樂	296		15	495	0.07473%	412545	63.33%	155	42.70%
落	403		13	372	0.05616%	412917	70.26%	155	42.70%
般	415		10	355	0.0536%	413272	70.92%	155	42.70%
較	250		13	573	0.08651%	413845	59.68%	154	42.42%
造	312		10	481	0.07262%	414326	64.51%	154	42.42%
候	327		10	454	0.06854%	414780	65.56%	154	42.42%
你	65		7	1675	0.2529%	416455	33.98%	153	42.15%
運	219		12	634	0.09572%	417089	56.83%	153	42.15%
具	330		8	450	0.06794%	417539	65.77%	153	42.15%
極	359		13	418	0.06311%	417957	67.66%	153	42.15%
半	372		5	397	0.05994%	418354	68.46%	153	42.15%
場	171		12	794	0.1199%	419148	51.72%	152	41.87%
設	211		11	658	0.09934%	419806	56.06%	152	41.87%
管	316		14	473	0.07141%	420279	64.79%	152	41.87%
話	279		13	513	0.07745%	420792	62.04%	151	41.60%
字	313		6	480	0.07247%	421272	64.58%	151	41.60%
走	342		7	437	0.06598%	421709	66.57%	151	41.60%
門	353		8	424	0.06401%	422133	67.28%	151	41.60%
七	382		2	389	0.05873%	422522	69.05%	151	41.60%
離	444		18	337	0.05088%	422859	72.43%	151	41.60%
交	325		6	455	0.06869%	423314	65.42%	150	41.32%
員	222		10	629	0.09496%	423943	57.12%	149	41.05%
保	274		9	520	0.07851%	424463	61.66%	149	41.05%
金	336		8	443	0.06688%	424906	66.17%	149	41.05%
易	263		8	546	0.08243%	425452	60.77%	148	40.77%
式	321		6	466	0.07035%	425918	65.15%	148	40.77%
路	358		13	419	0.06326%	426337	67.60%	148	40.77%
早	460		6	320	0.04831%	426657	73.22%	148	40.77%
條	344		11	434	0.06552%	427091	66.70%	147	40.50%
帶	400		11	376	0.05677%	427467	70.09%	147	40.50%
精	441		14	341	0.05148%	427808	72.28%	147	40.50%
連	481		10	302	0.04559%	428110	74.20%	147	40.50%
據	375		16	394	0.05948%	428504	68.64%	146	40.22%
消	442		10	338	0.05103%	428842	72.33%	146	40.22%
根	451		10	329	0.04967%	429171	72.78%	146	40.22%
決	452		7	328	0.04952%	429499	72.83%	146	40.22%
臺	169		14	797	0.1203%	430296	51.48%	145	39.94%
書	221		10	630	0.09512%	430926	57.02%	145	39.94%
聽	378		22	392	0.05918%	431318	68.82%	145	39.94%
希	532		7	270	0.04076%	431588	76.40%	145	39.94%
張	319		11	467	0.07051%	432055	65.01%	144	39.67%
邊	361		18	415	0.06266%	432470	67.79%	144	39.67%
傳	429		13	345	0.05209%	432815	71.65%	144	39.67%
致	495		9	294	0.04439%	433109	74.83%	144	39.67%
限	525		8	273	0.04122%	433382	76.12%	144	39.67%
隨	551		15	260	0.03925%	433642	77.16%	144	39.67%
調	453		15	326	0.04922%	433968	72.88%	143	39.39%
亦	203		6	670	0.1012%	434638	55.26%	142	39.12%
究	246		7	588	0.08877%	435226	59.33%	142	39.12%
術	292		11	498	0.07519%	435724	63.03%	142	39.12%
需	311		14	482	0.07277%	436206	64.43%	142	39.12%
件	383		6	388	0.05858%	436594	69.11%	142	39.12%
斷	527		18	271	0.04091%	436865	76.20%	142	39.12%
義	234		13	614	0.0927%	437479	58.25%	141	38.84%
信	333		9	445	0.06718%	437924	65.97%	141	38.84%
華	397		12	378	0.05707%	438302	69.92%	141	38.84%
女	209		3	659	0.09949%	438961	55.86%	140	38.57%
備	423		12	348	0.05254%	439309	71.34%	140	38.57%
引	499		4	292	0.04409%	439601	75.01%	140	38.57%
共	249		6	574	0.08666%	440175	59.59%	139	38.29%
什	314		4	475	0.07171%	440650	64.65%	139	38.29%
九	322		2	462	0.06975%	441112	65.22%	139	38.29%
推	393		11	380	0.05737%	441492	69.69%	139	38.29%
格	414		10	355	0.0536%	441847	70.86%	139	38.29%
係	425		9	347	0.05239%	442194	71.44%	139	38.29%
轉	459		18	321	0.04846%	442515	73.17%	139	38.29%
充	568		5	251	0.0379%	442766	77.82%	139	38.29%
品	124		9	1017	0.1535%	443783	45.39%	138	38.02%
建	254		9	561	0.0847%	444344	60.02%	138	38.02%
社	278		7	513	0.07745%	444857	61.97%	138	38.02%
象	345		12	434	0.06552%	445291	66.77%	138	38.02%
包	386		5	386	0.05828%	445677	69.29%	138	38.02%
收	430		6	345	0.05209%	446022	71.71%	138	38.02%
片	302		4	487	0.07353%	446509	63.78%	137	37.74%
約	350		9	428	0.06462%	446937	67.09%	137	37.74%
適	461		14	320	0.04831%	447257	73.27%	137	37.74%
告	489		7	298	0.04499%	447555	74.57%	137	37.74%
留	534		10	270	0.04076%	447825	76.48%	137	37.74%
士	404		3	371	0.05601%	448196	70.32%	136	37.47%
談	465		15	316	0.04771%	448512	73.46%	136	37.47%
響	492		21	296	0.04469%	448808	74.70%	136	37.47%
務	377		11	392	0.05918%	449200	68.76%	135	37.19%
改	394		7	380	0.05737%	449580	69.75%	135	37.19%
境	471		14	310	0.0468%	449890	73.74%	135	37.19%
確	541		15	267	0.04031%	450157	76.77%	135	37.19%
裏	190		13	727	0.1098%	450884	53.90%	134	36.91%
苦	508		9	286	0.04318%	451170	75.40%	134	36.91%
政	182		9	756	0.1141%	451926	53.00%	133	36.64%
節	432		13	345	0.05209%	452271	71.81%	133	36.64%
輕	435		14	344	0.05194%	452615	71.97%	133	36.64%
持	485		9	300	0.04529%	452915	74.38%	133	36.64%
強	547		11	263	0.03971%	453178	77.01%	133	36.64%
夠	567		11	252	0.03805%	453430	77.78%	133	36.64%
若	470		9	312	0.0471%	453742	73.70%	132	36.36%
值	490		10	297	0.04484%	454039	74.61%	132	36.36%
示	538		5	269	0.04061%	454308	76.65%	132	36.36%
山	223		3	627	0.09466%	454935	57.21%	131	36.09%
寫	309		15	482	0.07277%	455417	64.29%	131	36.09%
思	374		9	394	0.05948%	455811	68.58%	131	36.09%
呢	392		8	381	0.05752%	456192	69.64%	131	36.09%
統	380		11	391	0.05903%	456583	68.94%	130	35.81%
夜	412		8	357	0.0539%	456940	70.76%	130	35.81%
熱	413		15	357	0.0539%	457297	70.81%	130	35.81%
快	445		7	336	0.05073%	457633	72.48%	130	35.81%
念	475		8	307	0.04635%	457940	73.93%	130	35.81%
屬	516		21	278	0.04197%	458218	75.74%	130	35.81%
否	583		7	238	0.03593%	458456	78.37%	130	35.81%
待	587		9	236	0.03563%	458692	78.51%	130	35.81%
終	590		11	234	0.03533%	458926	78.62%	130	35.81%
價	326		15	455	0.06869%	459381	65.49%	129	35.54%
際	362		13	413	0.06235%	459794	67.85%	129	35.54%
青	389		8	383	0.05782%	460177	69.46%	129	35.54%
住	407		7	363	0.0548%	460540	70.48%	129	35.54%
北	334		5	445	0.06718%	460985	66.04%	128	35.26%
古	458		5	322	0.04861%	461307	73.12%	128	35.26%
僅	511		13	281	0.04242%	461588	75.53%	128	35.26%
顯	531		23	271	0.04091%	461859	76.36%	128	35.26%
獨	560		16	255	0.0385%	462114	77.51%	128	35.26%
例	416		8	353	0.05329%	462467	70.97%	127	34.99%
初	569		7	251	0.0379%	462718	77.86%	127	34.99%
止	638		4	208	0.0314%	462926	80.23%	127	34.99%
令	482		5	301	0.04544%	463227	74.25%	126	34.71%
準	500		13	292	0.04409%	463519	75.05%	126	34.71%
餘	503		15	290	0.04378%	463809	75.19%	126	34.71%
尤	573		4	247	0.03729%	464056	78.01%	126	34.71%
依	574		8	244	0.03684%	464300	78.04%	126	34.71%
報	285		12	502	0.07579%	464802	62.50%	125	34.44%
制	338		8	442	0.06673%	465244	66.30%	125	34.44%
服	502		8	290	0.04378%	465534	75.14%	125	34.44%
讓	515		24	279	0.04212%	465813	75.70%	125	34.44%
算	510		14	284	0.04288%	466097	75.49%	124	34.16%
辦	401		16	376	0.05677%	466473	70.15%	123	33.88%
增	419		15	351	0.05299%	466824	71.13%	123	33.88%
注	580		8	241	0.03639%	467065	78.26%	123	33.88%
竟	626		11	216	0.03261%	467281	79.84%	123	33.88%
盡	639		14	208	0.0314%	467489	80.26%	123	33.88%
識	371		19	398	0.06009%	467887	68.40%	122	33.61%
參	391		11	381	0.05752%	468268	69.58%	122	33.61%
首	646		9	204	0.0308%	468472	80.47%	122	33.61%
兒	259		8	551	0.08319%	469023	60.44%	121	33.33%
養	390		15	383	0.05782%	469406	69.52%	121	33.33%
免	581		7	240	0.03623%	469646	78.30%	121	33.33%
市	188		5	736	0.1111%	470382	53.68%	120	33.06%
質	373		15	396	0.05979%	470778	68.52%	120	33.06%
卻	434		9	344	0.05194%	471122	71.91%	120	33.06%
基	449		11	330	0.04982%	471452	72.68%	120	33.06%
存	552		6	259	0.0391%	471711	77.20%	120	33.06%
底	557		8	255	0.0385%	471966	77.40%	120	33.06%
謂	589		16	235	0.03548%	472201	78.59%	120	33.06%
南	369		9	401	0.06054%	472602	68.28%	119	32.78%
細	507		11	287	0.04333%	472889	75.36%	119	32.78%
程	543		12	266	0.04016%	473155	76.85%	119	32.78%
功	575		5	244	0.03684%	473399	78.08%	119	32.78%
考	606		6	226	0.03412%	473625	79.18%	119	32.78%
願	625		19	217	0.03276%	473842	79.81%	119	32.78%
馬	438		10	343	0.05178%	474185	72.12%	118	32.51%
稱	497		14	293	0.04424%	474478	74.92%	118	32.51%
尚	562		8	254	0.03835%	474732	77.59%	118	32.51%
料	341		10	438	0.06613%	475170	66.50%	117	32.23%
費	406		12	369	0.05571%	475539	70.43%	117	32.23%
導	484		16	300	0.04529%	475839	74.34%	117	32.23%
漸	523		14	274	0.04137%	476113	76.03%	117	32.23%
列	554		6	258	0.03895%	476371	77.28%	117	32.23%
段	584		9	238	0.03593%	476609	78.41%	117	32.23%
息	644		10	204	0.0308%	476813	80.41%	117	32.23%
嚴	683		20	189	0.02853%	477002	81.57%	117	32.23%
裝	288		13	502	0.07579%	477504	62.73%	116	31.96%
友	439		4	342	0.05163%	477846	72.17%	116	31.96%
喜	474		12	307	0.04635%	478153	73.88%	116	31.96%
獲	537		17	269	0.04061%	478422	76.61%	116	31.96%
低	546		7	265	0.04001%	478687	76.97%	116	31.96%
石	300		5	489	0.07383%	479176	63.63%	115	31.68%
德	364		15	410	0.0619%	479586	67.98%	115	31.68%
專	513		11	280	0.04227%	479866	75.62%	115	31.68%
舉	588		17	236	0.03563%	480102	78.55%	115	31.68%
紅	396		9	380	0.05737%	480482	69.86%	114	31.40%
廣	603		15	227	0.03427%	480709	79.07%	114	31.40%
負	713		9	181	0.02733%	480890	82.41%	114	31.40%
	138		11	933	0.1409%	481823	47.43%	113	31.13%
戰	402		16	373	0.05631%	482196	70.21%	113	31.13%
林	431		8	345	0.05209%	482541	71.76%	113	31.13%
黃	494		12	295	0.04454%	482836	74.79%	113	31.13%
晚	577		11	243	0.03669%	483079	78.15%	113	31.13%
選	591		15	233	0.03518%	483312	78.66%	113	31.13%
居	597		8	231	0.03488%	483543	78.87%	113	31.13%
裡	248		12	580	0.08757%	484123	59.50%	112	30.85%
歡	539		22	268	0.04046%	484391	76.69%	112	30.85%
爭	559		8	255	0.0385%	484646	77.47%	112	30.85%
短	614		12	222	0.03352%	484868	79.45%	112	30.85%
親	354		16	423	0.06386%	485291	67.35%	111	30.58%
電	355		13	423	0.06386%	485714	67.41%	111	30.58%
刻	408		8	362	0.05465%	486076	70.54%	111	30.58%
讀	448		22	334	0.05043%	486410	72.63%	111	30.58%
復	468		12	313	0.04726%	486723	73.60%	111	30.58%
語	545		14	266	0.04016%	486989	76.93%	111	30.58%
區	270		11	533	0.08047%	487522	61.34%	110	30.30%
善	635		12	209	0.03155%	487731	80.13%	110	30.30%
角	641		7	206	0.0311%	487937	80.32%	110	30.30%
府	447		8	334	0.05043%	488271	72.58%	109	30.03%
黑	526		12	272	0.04107%	488543	76.16%	109	30.03%
供	535		8	269	0.04061%	488812	76.52%	109	30.03%
習	544		11	266	0.04016%	489078	76.89%	109	30.03%
治	324		8	460	0.06945%	489538	65.36%	108	29.75%
永	553		5	259	0.0391%	489797	77.24%	108	29.75%
叫	595		5	231	0.03488%	490028	78.80%	108	29.75%
院	437		9	343	0.05178%	490371	72.07%	107	29.48%
規	563		11	254	0.03835%	490625	77.63%	107	29.48%
死	488		6	299	0.04514%	490924	74.52%	106	29.20%
集	594		12	232	0.03503%	491156	78.76%	106	29.20%
假	618		11	219	0.03306%	491375	79.58%	106	29.20%
支	630		4	215	0.03246%	491590	79.97%	106	29.20%
環	652		17	201	0.03035%	491791	80.66%	106	29.20%
富	664		12	196	0.02959%	491987	81.02%	106	29.20%
研	269		9	535	0.08077%	492522	61.26%	105	28.93%
音	340		9	442	0.06673%	492964	66.44%	105	28.93%
火	450		4	330	0.04982%	493294	72.73%	105	28.93%
助	570		7	250	0.03774%	493544	77.89%	105	28.93%
討	661		10	197	0.02974%	493741	80.93%	105	28.93%
續	729		21	178	0.02687%	493919	82.84%	105	28.93%
灣	303		25	486	0.07337%	494405	63.85%	104	28.65%
均	436		7	343	0.05178%	494748	72.02%	104	28.65%
洋	540		9	267	0.04031%	495015	76.73%	104	28.65%
簡	650		18	202	0.0305%	495217	80.60%	104	28.65%
絕	694		12	187	0.02823%	495404	81.88%	104	28.65%
態	700		14	185	0.02793%	495589	82.05%	104	28.65%
況	728		8	178	0.02687%	495767	82.82%	104	28.65%
破	735		10	177	0.02672%	495944	83.00%	104	28.65%
趣	762		15	168	0.02536%	496112	83.71%	104	28.65%
她	103		6	1190	0.1797%	497302	41.95%	103	28.37%
星	493		9	295	0.04454%	497597	74.74%	103	28.37%
靜	542		16	267	0.04031%	497864	76.81%	103	28.37%
靈	621		24	219	0.03306%	498083	79.68%	103	28.37%
味	657		8	198	0.02989%	498281	80.81%	103	28.37%
既	688		9	188	0.02838%	498469	81.71%	103	28.37%
木	332		4	449	0.06779%	498918	65.90%	102	28.10%
句	417		5	352	0.05314%	499270	71.02%	102	28.10%
講	483		17	301	0.04544%	499571	74.29%	102	28.10%
笑	486		10	300	0.04529%	499871	74.43%	102	28.10%
積	524		16	274	0.04137%	500145	76.07%	102	28.10%
試	549		13	261	0.0394%	500406	77.09%	102	28.10%
草	556		10	256	0.03865%	500662	77.36%	102	28.10%
陽	624		11	217	0.03276%	500879	79.78%	102	28.10%
奇	651		8	201	0.03035%	501080	80.63%	102	28.10%
異	746		11	173	0.02612%	501253	83.29%	102	28.10%
商	260		11	550	0.08304%	501803	60.52%	101	27.82%
筆	420		12	351	0.05299%	502154	71.18%	101	27.82%
香	479		9	304	0.0459%	502458	74.11%	101	27.82%
元	506		4	288	0.04348%	502746	75.32%	101	27.82%
述	564		8	254	0.03835%	503000	77.67%	101	27.82%
缺	708		10	182	0.02748%	503182	82.27%	101	27.82%
歷	712		16	181	0.02733%	503363	82.38%	101	27.82%
圍	744		12	173	0.02612%	503536	83.24%	101	27.82%
困	812		7	152	0.02295%	503688	84.91%	101	27.82%
資	293		13	498	0.07519%	504186	63.11%	100	27.55%
項	411		12	358	0.05405%	504544	70.70%	100	27.55%
驗	457		23	323	0.04877%	504867	73.07%	100	27.55%
劃	498		14	292	0.04409%	505159	74.97%	100	27.55%
夫	536		4	269	0.04061%	505428	76.56%	100	27.55%
標	555		15	256	0.03865%	505684	77.32%	100	27.55%
客	602		9	228	0.03442%	505912	79.04%	100	27.55%
飛	605		9	227	0.03427%	506139	79.14%	100	27.55%
怕	628		8	215	0.03246%	506354	79.91%	100	27.55%
請	632		15	213	0.03216%	506567	80.04%	100	27.55%
凡	779		3	162	0.02446%	506729	84.13%	100	27.55%
育	405		7	371	0.05601%	507100	70.37%	99	27.27%
效	467		10	314	0.04741%	507414	73.55%	99	27.27%
採	476		11	305	0.04605%	507719	73.97%	99	27.27%
圖	520		14	275	0.04152%	507994	75.91%	99	27.27%
停	693		11	187	0.02823%	508181	81.86%	99	27.27%
繼	784		20	160	0.02416%	508341	84.25%	99	27.27%
樹	360		16	418	0.06311%	508759	67.73%	98	27.00%
房	496		8	293	0.04424%	509052	74.88%	98	27.00%
織	648		18	203	0.03065%	509255	80.54%	98	27.00%
予	687		4	188	0.02838%	509443	81.69%	98	27.00%
省	462		9	318	0.04801%	509761	73.32%	97	26.72%
春	487		9	299	0.04514%	510060	74.47%	97	26.72%
英	571		9	249	0.03759%	510309	77.93%	97	26.72%
站	642		10	205	0.03095%	510514	80.35%	97	26.72%
雙	680		18	192	0.02899%	510706	81.49%	97	26.72%
責	757		11	170	0.02567%	510876	83.58%	97	26.72%
領	770		14	165	0.02491%	511041	83.91%	97	26.72%
製	381		14	391	0.05903%	511432	69.00%	96	26.45%
乃	599		2	229	0.03457%	511661	78.94%	96	26.45%
紀	601		9	229	0.03457%	511890	79.00%	96	26.45%
怎	629		9	215	0.03246%	512105	79.94%	96	26.45%
密	631		11	214	0.03231%	512319	80.01%	96	26.45%
良	627		7	216	0.03261%	512535	79.88%	95	26.17%
舊	702		18	185	0.02793%	512720	82.11%	95	26.17%
師	477		10	304	0.0459%	513024	74.02%	94	25.90%
證	576		19	244	0.03684%	513268	78.12%	94	25.90%
景	617		12	221	0.03337%	513489	79.55%	94	25.90%
維	676		14	193	0.02914%	513682	81.37%	94	25.90%
車	265		7	544	0.08213%	514226	60.93%	93	25.62%
置	565		13	253	0.0382%	514479	77.70%	93	25.62%
普	616		12	221	0.03337%	514700	79.51%	93	25.62%
號	643		13	205	0.03095%	514905	80.38%	93	25.62%
顧	692		21	188	0.02838%	515093	81.83%	93	25.62%
緊	782		14	161	0.02431%	515254	84.20%	93	25.62%
冷	518		7	277	0.04182%	515531	75.83%	92	25.34%
議	615		20	222	0.03352%	515753	79.48%	92	25.34%
史	640		5	207	0.03125%	515960	80.29%	92	25.34%
散	681		12	191	0.02884%	516151	81.51%	92	25.34%
懷	820		19	150	0.02265%	516301	85.09%	92	25.34%
歸	863		18	138	0.02083%	516439	86.02%	92	25.34%
器	446		16	334	0.05043%	516773	72.53%	91	25.07%
構	491		14	297	0.04484%	517070	74.65%	91	25.07%
越	519		12	276	0.04167%	517346	75.87%	91	25.07%
局	619		7	219	0.03306%	517565	79.61%	91	25.07%
吧	622		7	218	0.03291%	517783	79.71%	91	25.07%
配	686		10	189	0.02853%	517972	81.66%	91	25.07%
送	695		9	187	0.02823%	518159	81.91%	91	25.07%
溫	723		13	179	0.02702%	518338	82.68%	91	25.07%
病	347		10	432	0.06522%	518770	66.90%	90	24.79%
級	522		10	275	0.04152%	519045	75.99%	90	24.79%
歲	609		13	225	0.03397%	519270	79.28%	90	24.79%
固	773		8	164	0.02476%	519434	83.98%	90	24.79%
微	774		13	164	0.02476%	519598	84.00%	90	24.79%
途	816		10	152	0.02295%	519750	85.00%	90	24.79%
校	480		10	302	0.04559%	520052	74.16%	89	24.52%
沉	690		7	188	0.02838%	520240	81.77%	89	24.52%
找	714		7	180	0.02718%	520420	82.44%	89	24.52%
左	778		5	163	0.02461%	520583	84.10%	89	24.52%
土	424		3	348	0.05254%	520931	71.39%	88	24.24%
亞	566		8	252	0.03805%	521183	77.74%	88	24.24%
組	585		11	238	0.03593%	521421	78.44%	88	24.24%
排	604		11	227	0.03427%	521648	79.11%	88	24.24%
狀	656		8	200	0.0302%	521848	80.78%	88	24.24%
坐	659		7	197	0.02974%	522045	80.87%	88	24.24%
勢	754		13	171	0.02582%	522216	83.50%	88	24.24%
倒	771		10	164	0.02476%	522380	83.93%	88	24.24%
略	839		11	143	0.02159%	522523	85.51%	88	24.24%
貴	845		12	142	0.02144%	522665	85.64%	88	24.24%
透	925		10	123	0.01857%	522788	87.24%	88	24.24%
換	928		12	122	0.01842%	522910	87.29%	88	24.24%
孩	365		9	409	0.06175%	523319	68.04%	87	23.97%
型	443		9	337	0.05088%	523656	72.38%	87	23.97%
施	528		9	271	0.04091%	523927	76.24%	87	23.97%
線	548		15	261	0.0394%	524188	77.05%	87	23.97%
印	561		6	254	0.03835%	524442	77.55%	87	23.97%
創	655		12	200	0.0302%	524642	80.75%	87	23.97%
佔	709		7	181	0.02733%	524823	82.30%	87	23.97%
速	738		10	175	0.02642%	524998	83.08%	87	23.97%
吃	600		6	229	0.03457%	525227	78.97%	86	23.69%
優	795		17	157	0.0237%	525384	84.51%	86	23.69%
臨	898		17	130	0.01963%	525514	86.72%	86	23.69%
藝	343		19	435	0.06567%	525949	66.63%	85	23.42%
司	356		5	422	0.06371%	526371	67.47%	85	23.42%
母	395		5	380	0.05737%	526751	69.81%	85	23.42%
毛	466		4	315	0.04756%	527066	73.51%	85	23.42%
斯	501		12	291	0.04393%	527357	75.10%	85	23.42%
層	572		15	248	0.03744%	527605	77.97%	85	23.42%
素	658		10	198	0.02989%	527803	80.84%	85	23.42%
源	698		13	186	0.02808%	527989	82.00%	85	23.42%
嗎	710		13	181	0.02733%	528170	82.33%	85	23.42%
室	720		9	179	0.02702%	528349	82.60%	85	23.42%
差	838		10	143	0.02159%	528492	85.49%	85	23.42%
範	848		15	141	0.02129%	528633	85.71%	85	23.42%
驚	926		23	123	0.01857%	528756	87.26%	85	23.42%
聯	607		17	226	0.03412%	528982	79.21%	84	23.14%
眾	679		11	192	0.02899%	529174	81.46%	84	23.14%
害	706		10	183	0.02763%	529357	82.22%	84	23.14%
端	747		14	173	0.02612%	529530	83.32%	84	23.14%
急	775		9	164	0.02476%	529694	84.03%	84	23.14%
括	786		9	159	0.02401%	529853	84.30%	84	23.14%
右	834		5	144	0.02174%	529997	85.40%	84	23.14%
忘	875		7	134	0.02023%	530131	86.27%	84	23.14%
科	294		9	497	0.07504%	530628	63.18%	83	22.87%
查	586		9	237	0.03578%	530865	78.48%	83	22.87%
權	608		22	225	0.03397%	531090	79.24%	83	22.87%
麗	666		19	196	0.02959%	531286	81.08%	83	22.87%
律	671		9	194	0.02929%	531480	81.22%	83	22.87%
團	703		14	184	0.02778%	531664	82.14%	83	22.87%
里	732		7	178	0.02687%	531842	82.92%	83	22.87%
雜	817		18	152	0.02295%	531994	85.02%	83	22.87%
遇	869		12	136	0.02053%	532130	86.14%	83	22.87%
食	512		9	281	0.04242%	532411	75.57%	82	22.59%
技	579		7	241	0.03639%	532652	78.23%	82	22.59%
減	636		12	209	0.03155%	532861	80.16%	82	22.59%
城	663		9	196	0.02959%	533057	80.99%	82	22.59%
修	696		10	186	0.02808%	533243	81.94%	82	22.59%
誰	855		15	140	0.02114%	533383	85.85%	82	22.59%
濟	463		17	317	0.04786%	533700	73.36%	81	22.31%
皮	530		5	271	0.04091%	533971	76.32%	81	22.31%
圓	697		13	186	0.02808%	534157	81.97%	81	22.31%
幸	755		8	170	0.02567%	534327	83.53%	81	22.31%
座	760		10	169	0.02551%	534496	83.65%	81	22.31%
陸	623		10	218	0.03291%	534714	79.74%	80	22.04%
雲	649		12	203	0.03065%	534917	80.57%	80	22.04%
衣	654		6	201	0.03035%	535118	80.72%	80	22.04%
答	737		12	175	0.02642%	535293	83.06%	80	22.04%
頗	807		14	154	0.02325%	535447	84.79%	80	22.04%
預	822		13	150	0.02265%	535597	85.14%	80	22.04%
夢	504		14	289	0.04363%	535886	75.23%	79	21.76%
	578		7	242	0.03654%	536128	78.19%	79	21.76%
淡	633		11	210	0.03171%	536338	80.07%	79	21.76%
亮	733		9	177	0.02672%	536515	82.95%	79	21.76%
波	805		8	154	0.02325%	536669	84.75%	79	21.76%
按	813		9	152	0.02295%	536821	84.93%	79	21.76%
宜	819		8	150	0.02265%	536971	85.07%	79	21.76%
錯	906		16	128	0.01932%	537099	86.88%	79	21.76%
暗	909		13	127	0.01917%	537226	86.94%	79	21.76%
露	931		21	122	0.01842%	537348	87.35%	79	21.76%
雨	352		8	425	0.06416%	537773	67.22%	78	21.49%
軍	478		9	304	0.0459%	538077	74.07%	78	21.49%
父	521		4	275	0.04152%	538352	75.95%	78	21.49%
派	674		9	193	0.02914%	538545	81.31%	78	21.49%
益	682		10	191	0.02884%	538736	81.54%	78	21.49%
克	719		7	179	0.02702%	538915	82.57%	78	21.49%
遊	764		12	167	0.02521%	539082	83.76%	78	21.49%
皆	765		9	166	0.02506%	539248	83.78%	78	21.49%
干	792		3	158	0.02385%	539406	84.44%	78	21.49%
痛	800		12	156	0.02355%	539562	84.63%	78	21.49%
頂	806		11	154	0.02325%	539716	84.77%	78	21.49%
突	824		9	149	0.0225%	539865	85.18%	78	21.49%
惡	867		12	136	0.02053%	540001	86.10%	78	21.49%
模	870		15	135	0.02038%	540136	86.16%	78	21.49%
忽	887		8	132	0.01993%	540268	86.51%	78	21.49%
附	890		7	132	0.01993%	540400	86.57%	78	21.49%
庭	894		10	131	0.01978%	540531	86.65%	78	21.49%
聞	705		14	184	0.02778%	540715	82.19%	77	21.21%
傷	736		13	175	0.02642%	540890	83.03%	77	21.21%
王	767		4	165	0.02491%	541055	83.83%	77	21.21%
彩	818		11	151	0.0228%	541206	85.05%	77	21.21%
背	836		9	144	0.02174%	541350	85.45%	77	21.21%
尋	881		12	133	0.02008%	541483	86.39%	77	21.21%
厚	943		9	119	0.01797%	541602	87.57%	77	21.21%
油	388		8	383	0.05782%	541985	69.40%	76	20.94%
營	529		17	271	0.04091%	542256	76.28%	76	20.94%
投	715		7	180	0.02718%	542436	82.47%	76	20.94%
諸	783		15	161	0.02431%	542597	84.22%	76	20.94%
腳	837		13	144	0.02174%	542741	85.47%	76	20.94%
逐	889		10	132	0.01993%	542873	86.55%	76	20.94%
洲	533		9	270	0.04076%	543143	76.44%	75	20.66%
追	856		9	140	0.02114%	543283	85.87%	75	20.66%
拿	857		10	139	0.02099%	543422	85.90%	75	20.66%
察	873		14	134	0.02023%	543556	86.23%	75	20.66%
超	888		12	132	0.01993%	543688	86.53%	75	20.66%
吸	918		7	124	0.01872%	543812	87.11%	75	20.66%
烈	924		10	123	0.01857%	543935	87.22%	75	20.66%
恐	966		10	114	0.01721%	544049	87.97%	75	20.66%
福	701		13	185	0.02793%	544234	82.08%	74	20.39%
官	780		8	161	0.02431%	544395	84.15%	74	20.39%
脫	844		11	142	0.02144%	544537	85.62%	74	20.39%
替	876		12	134	0.02023%	544671	86.29%	74	20.39%
副	914		11	125	0.01887%	544796	87.03%	74	20.39%
盛	944		11	119	0.01797%	544915	87.59%	74	20.39%
承	979		8	112	0.01691%	545027	88.19%	74	20.39%
詩	464		13	317	0.04786%	545344	73.41%	73	20.11%
拉	514		8	280	0.04227%	545624	75.66%	73	20.11%
葉	653		13	201	0.03035%	545825	80.69%	73	20.11%
板	660		8	197	0.02974%	546022	80.90%	73	20.11%
朋	745		8	173	0.02612%	546195	83.27%	73	20.11%
零	826		13	148	0.02234%	546343	85.23%	73	20.11%
補	884		12	133	0.02008%	546476	86.45%	73	20.11%
亂	932		13	121	0.01827%	546597	87.37%	73	20.11%
材	385		7	388	0.05858%	546985	69.23%	72	19.83%
乾	634		11	209	0.03155%	547194	80.10%	72	19.83%
曲	645		6	204	0.0308%	547398	80.44%	72	19.83%
某	752		9	172	0.02597%	547570	83.45%	72	19.83%
藏	763		18	167	0.02521%	547737	83.73%	72	19.83%
園	799		13	156	0.02355%	547893	84.61%	72	19.83%
純	814		10	152	0.02295%	548045	84.96%	72	19.83%
浪	858		10	139	0.02099%	548184	85.92%	72	19.83%
呼	879		8	133	0.02008%	548317	86.35%	72	19.83%
河	593		8	232	0.03503%	548549	78.73%	71	19.56%
跟	637		13	209	0.03155%	548758	80.20%	71	19.56%
鄉	685		11	189	0.02853%	548947	81.63%	71	19.56%
錢	724		16	179	0.02702%	549126	82.71%	71	19.56%
絲	748		12	173	0.02612%	549299	83.34%	71	19.56%
隻	750		10	173	0.02612%	549472	83.40%	71	19.56%
屋	751		9	172	0.02597%	549644	83.42%	71	19.56%
夏	777		10	163	0.02461%	549807	84.08%	71	19.56%
威	797		9	157	0.0237%	549964	84.56%	71	19.56%
莫	833		11	146	0.02204%	550110	85.38%	71	19.56%
憶	861		16	138	0.02083%	550248	85.98%	71	19.56%
禮	945		17	119	0.01797%	550367	87.60%	71	19.56%
概	997		13	109	0.01646%	550476	88.49%	71	19.56%
魚	192		11	723	0.1092%	551199	54.12%	70	19.28%
羅	582		19	239	0.03608%	551438	78.34%	70	19.28%
陳	670		10	195	0.02944%	551633	81.19%	70	19.28%
窗	675		12	193	0.02914%	551826	81.34%	70	19.28%
訴	790		12	159	0.02401%	551985	84.39%	70	19.28%
穿	832		9	146	0.02204%	552131	85.36%	70	19.28%
壞	880		19	133	0.02008%	552264	86.37%	70	19.28%
激	959		16	115	0.01736%	552379	87.85%	70	19.28%
遍	983		12	112	0.01691%	552491	88.26%	70	19.28%
燈	558		16	255	0.0385%	552746	77.44%	69	19.01%
演	611		14	223	0.03367%	552969	79.35%	69	19.01%
爾	678		14	192	0.02899%	553161	81.43%	69	19.01%
歌	689		14	188	0.02838%	553349	81.74%	69	19.01%
綠	756		14	170	0.02567%	553519	83.55%	69	19.01%
率	761		11	168	0.02536%	553687	83.68%	69	19.01%
布	801		5	155	0.0234%	553842	84.65%	69	19.01%
旁	952		10	116	0.01751%	553958	87.73%	69	19.01%
偶	964		11	114	0.01721%	554072	87.94%	69	19.01%
船	348		11	432	0.06522%	554504	66.96%	68	18.73%
血	473		6	308	0.0465%	554812	73.84%	68	18.73%
篇	691		15	188	0.02838%	555000	81.80%	68	18.73%
慢	741		14	174	0.02627%	555174	83.16%	68	18.73%
退	758		9	170	0.02567%	555344	83.60%	68	18.73%
批	781		7	161	0.02431%	555505	84.18%	68	18.73%
雄	830		12	147	0.02219%	555652	85.32%	68	18.73%
繁	854		17	140	0.02114%	555792	85.83%	68	18.73%
堂	900		11	129	0.01948%	555921	86.76%	68	18.73%
擔	929		16	122	0.01842%	556043	87.31%	68	18.73%
賞	954		15	116	0.01751%	556159	87.76%	68	18.73%
努	1016		7	105	0.01585%	556264	88.80%	68	18.73%
畫	410		12	359	0.0542%	556623	70.65%	67	18.46%
農	433		13	345	0.05209%	556968	71.86%	67	18.46%
季	684		8	189	0.02853%	557157	81.60%	67	18.46%
買	785		12	160	0.02416%	557317	84.27%	67	18.46%
陣	950		9	117	0.01766%	557434	87.69%	67	18.46%
周	965		8	114	0.01721%	557548	87.95%	67	18.46%
互	991		4	109	0.01646%	557657	88.39%	67	18.46%
順	1009		12	107	0.01615%	557764	88.69%	67	18.46%
獻	1011		20	106	0.016%	557870	88.72%	67	18.46%
午	1017		4	105	0.01585%	557975	88.81%	67	18.46%
搖	1019		13	105	0.01585%	558080	88.84%	67	18.46%
怪	1045		8	99	0.01495%	558179	89.25%	67	18.46%
遺	1090		15	91	0.01374%	558270	89.89%	67	18.46%
紙	456		10	323	0.04877%	558593	73.03%	66	18.18%
案	672		10	194	0.02929%	558787	81.25%	66	18.18%
階	794		11	158	0.02385%	558945	84.49%	66	18.18%
檢	821		17	150	0.02265%	559095	85.11%	66	18.18%
壓	841		17	142	0.02144%	559237	85.56%	66	18.18%
堅	951		11	116	0.01751%	559353	87.71%	66	18.18%
佈	999		7	108	0.01631%	559461	88.52%	66	18.18%
週	1028		11	104	0.0157%	559565	88.99%	66	18.18%
志	1044		7	99	0.01495%	559664	89.23%	66	18.18%
揮	1049		12	98	0.0148%	559762	89.31%	66	18.18%
職	665		18	196	0.02959%	559958	81.05%	65	17.91%
險	769		15	165	0.02491%	560123	83.88%	65	17.91%
擴	862		18	138	0.02083%	560261	86.00%	65	17.91%
付	892		5	131	0.01978%	560392	86.61%	65	17.91%
畢	911		11	127	0.01917%	560519	86.98%	65	17.91%
野	942		11	120	0.01812%	560639	87.55%	65	17.91%
揚	958		12	115	0.01736%	560754	87.83%	65	17.91%
俗	974		9	112	0.01691%	560866	88.11%	65	17.91%
享	992		8	109	0.01646%	560975	88.41%	65	17.91%
佳	1000		8	108	0.01631%	561083	88.54%	65	17.91%
鮮	1012		17	106	0.016%	561189	88.73%	65	17.91%
鼓	1014		13	106	0.016%	561295	88.77%	65	17.91%
守	1022		6	104	0.0157%	561399	88.89%	65	17.91%
疑	1051		14	98	0.0148%	561497	89.34%	65	17.91%
儘	1138		16	85	0.01283%	561582	90.52%	65	17.91%
沙	667		7	195	0.02944%	561777	81.11%	64	17.63%
鐵	749		21	173	0.02612%	561950	83.37%	64	17.63%
男	831		7	146	0.02204%	562096	85.34%	64	17.63%
枝	910		8	127	0.01917%	562223	86.96%	64	17.63%
健	936		11	120	0.01812%	562343	87.44%	64	17.63%
藉	982		18	112	0.01691%	562455	88.24%	64	17.63%
束	1023		7	104	0.0157%	562559	88.91%	64	17.63%
殊	1025		10	104	0.0157%	562663	88.94%	64	17.63%
避	1104		16	89	0.01344%	562752	90.07%	64	17.63%
慮	1183		15	80	0.01208%	562832	91.08%	64	17.63%
系	825		7	149	0.0225%	562981	85.20%	63	17.36%
勞	828		12	147	0.02219%	563128	85.27%	63	17.36%
悲	882		12	133	0.02008%	563261	86.41%	63	17.36%
塊	886		13	132	0.01993%	563393	86.49%	63	17.36%
奮	933		16	121	0.01827%	563514	87.39%	63	17.36%
朝	988		12	110	0.01661%	563624	88.34%	63	17.36%
毫	1094		11	90	0.01359%	563714	89.94%	63	17.36%
蓋	1120		14	87	0.01313%	563801	90.29%	63	17.36%
鐘	793		20	158	0.02385%	563959	84.46%	62	17.08%
班	802		10	155	0.0234%	564114	84.68%	62	17.08%
護	865		21	137	0.02068%	564251	86.06%	62	17.08%
岸	908		8	127	0.01917%	564378	86.92%	62	17.08%
訓	961		10	115	0.01736%	564493	87.88%	62	17.08%
床	987		7	110	0.01661%	564603	88.33%	62	17.08%
擇	1057		16	96	0.01449%	564699	89.42%	62	17.08%
折	1063		7	94	0.01419%	564793	89.51%	62	17.08%
欲	1073		11	93	0.01404%	564886	89.65%	62	17.08%
趕	1096		14	90	0.01359%	564976	89.97%	62	17.08%
章	847		11	141	0.02129%	565117	85.68%	61	16.80%
移	1007		11	107	0.01615%	565224	88.65%	61	16.80%
偏	1015		11	105	0.01585%	565329	88.78%	61	16.80%
靠	1043		15	100	0.0151%	565429	89.22%	61	16.80%
末	1141		5	85	0.01283%	565514	90.56%	61	16.80%
銷	328		15	453	0.06839%	565967	65.63%	60	16.53%
防	592		6	233	0.03518%	566200	78.69%	60	16.53%
睡	788		14	159	0.02401%	566359	84.35%	60	16.53%
架	851		9	140	0.02114%	566499	85.77%	60	16.53%
含	896		7	130	0.01963%	566629	86.69%	60	16.53%
雪	922		11	124	0.01872%	566753	87.18%	60	16.53%
灰	971		6	113	0.01706%	566866	88.06%	60	16.53%
龍	984		16	112	0.01691%	566978	88.28%	60	16.53%
煙	1006		13	107	0.01615%	567085	88.64%	60	16.53%
寂	1018		11	105	0.01585%	567190	88.83%	60	16.53%
濃	1046		16	99	0.01495%	567289	89.26%	60	16.53%
稍	1118		12	87	0.01313%	567376	90.26%	60	16.53%
敢	1154		12	84	0.01268%	567460	90.72%	60	16.53%
詳	1211		13	77	0.01163%	567537	91.42%	60	16.53%
肉	669		6	195	0.02944%	567732	81.16%	59	16.25%
竹	704		6	184	0.02778%	567916	82.16%	59	16.25%
尺	739		4	174	0.02627%	568090	83.11%	59	16.25%
課	815		15	152	0.02295%	568242	84.98%	59	16.25%
載	829		13	147	0.02219%	568389	85.29%	59	16.25%
臉	883		17	133	0.02008%	568522	86.43%	59	16.25%
編	902		15	129	0.01948%	568651	86.80%	59	16.25%
群	913		13	126	0.01902%	568777	87.01%	59	16.25%
評	930		12	122	0.01842%	568899	87.33%	59	16.25%
寧	938		14	120	0.01812%	569019	87.48%	59	16.25%
忙	939		6	120	0.01812%	569139	87.49%	59	16.25%
勝	976		12	112	0.01691%	569251	88.14%	59	16.25%
央	1039		5	100	0.0151%	569351	89.16%	59	16.25%
緣	1042		15	100	0.0151%	569451	89.20%	59	16.25%
欣	1093		8	90	0.01359%	569541	89.93%	59	16.25%
乏	1113		5	87	0.01313%	569628	90.19%	59	16.25%
棄	1143		11	85	0.01283%	569713	90.58%	59	16.25%
廠	455		15	323	0.04877%	570036	72.98%	58	15.98%
港	550		12	260	0.03925%	570296	77.13%	58	15.98%
輪	612		15	223	0.03367%	570519	79.38%	58	15.98%
巴	613		4	222	0.03352%	570741	79.41%	58	15.98%
徵	740		15	174	0.02627%	570915	83.14%	58	15.98%
探	798		11	157	0.0237%	571072	84.58%	58	15.98%
秋	803		9	155	0.0234%	571227	84.70%	58	15.98%
樓	810		15	153	0.0231%	571380	84.86%	58	15.98%
詞	849		12	141	0.02129%	571521	85.73%	58	15.98%
協	893		8	131	0.01978%	571652	86.63%	58	15.98%
玩	947		8	118	0.01782%	571770	87.64%	58	15.98%
冬	975		5	112	0.01691%	571882	88.12%	58	15.98%
弱	978		10	112	0.01691%	571994	88.17%	58	15.98%
寒	994		12	109	0.01646%	572103	88.44%	58	15.98%
抗	995		7	109	0.01646%	572212	88.46%	58	15.98%
熟	1026		15	104	0.0157%	572316	88.95%	58	15.98%
剛	1047		10	98	0.0148%	572414	89.28%	58	15.98%
鬧	1069		15	94	0.01419%	572508	89.59%	58	15.98%
妙	1108		7	88	0.01329%	572596	90.13%	58	15.98%
虛	1157		12	84	0.01268%	572680	90.76%	58	15.98%
兼	1161		10	83	0.01253%	572763	90.81%	58	15.98%
縱	1166		17	83	0.01253%	572846	90.88%	58	15.98%
域	699		11	185	0.02793%	573031	82.02%	57	15.70%
島	842		10	142	0.02144%	573173	85.58%	57	15.70%
舞	864		14	137	0.02068%	573310	86.04%	57	15.70%
麻	968		11	114	0.01721%	573424	88.00%	57	15.70%
索	1034		10	103	0.01555%	573527	89.08%	57	15.70%
巧	1040		5	100	0.0151%	573627	89.17%	57	15.70%
寶	1076		20	92	0.01389%	573719	89.69%	57	15.70%
遭	1159		14	84	0.01268%	573803	90.79%	57	15.70%
迎	1178		7	81	0.01223%	573884	91.02%	57	15.70%
延	1182		8	80	0.01208%	573964	91.07%	57	15.70%
覆	1197		18	79	0.01193%	574043	91.25%	57	15.70%
抱	1202		8	78	0.01178%	574121	91.31%	57	15.70%
醫	306		18	485	0.07322%	574606	64.07%	56	15.43%
藥	398		19	377	0.05692%	574983	69.98%	56	15.43%
委	725		8	178	0.02687%	575161	82.74%	56	15.43%
愈	726		13	178	0.02687%	575339	82.76%	56	15.43%
默	811		16	153	0.0231%	575492	84.89%	56	15.43%
髮	871		15	135	0.02038%	575627	86.18%	56	15.43%
擊	905		17	128	0.01932%	575755	86.86%	56	15.43%
歐	921		15	124	0.01872%	575879	87.16%	56	15.43%
典	927		8	122	0.01842%	576001	87.28%	56	15.43%
幹	1041		13	100	0.0151%	576101	89.19%	56	15.43%
齊	1061		14	95	0.01434%	576196	89.48%	56	15.43%
衝	1121		15	87	0.01313%	576283	90.30%	56	15.43%
誠	1149		13	85	0.01283%	576368	90.66%	56	15.43%
秘	1165		10	83	0.01253%	576451	90.86%	56	15.43%
弄	1174		7	81	0.01223%	576532	90.98%	56	15.43%
惜	1175		11	81	0.01223%	576613	90.99%	56	15.43%
球	517		11	278	0.04197%	576891	75.78%	55	15.15%
革	707		9	183	0.02763%	577074	82.25%	55	15.15%
族	787		11	159	0.02401%	577233	84.32%	55	15.15%
練	897		15	130	0.01963%	577363	86.70%	55	15.15%
救	946		11	118	0.01782%	577481	87.62%	55	15.15%
銀	949		14	117	0.01766%	577598	87.67%	55	15.15%
榮	980		14	112	0.01691%	577710	88.21%	55	15.15%
慣	1071		14	93	0.01404%	577803	89.62%	55	15.15%
滅	1086		13	91	0.01374%	577894	89.83%	55	15.15%
刺	1105		8	88	0.01329%	577982	90.09%	55	15.15%
睛	1117		13	87	0.01313%	578069	90.25%	55	15.15%
耳	1119		6	87	0.01313%	578156	90.27%	55	15.15%
納	1134		10	86	0.01298%	578242	90.47%	55	15.15%
豐	1198		18	79	0.01193%	578321	91.26%	55	15.15%
尼	509		5	285	0.04303%	578606	75.45%	54	14.88%
貨	598		11	231	0.03488%	578837	78.90%	54	14.88%
唱	872		11	134	0.02023%	578971	86.21%	54	14.88%
財	877		10	134	0.02023%	579105	86.31%	54	14.88%
聖	960		13	115	0.01736%	579220	87.87%	54	14.88%
抽	1001		8	108	0.01631%	579328	88.56%	54	14.88%
宣	1030		9	103	0.01555%	579431	89.02%	54	14.88%
迷	1080		9	92	0.01389%	579523	89.75%	54	14.88%
休	1098		6	89	0.01344%	579612	89.99%	54	14.88%
擁	1153		16	84	0.01268%	579696	90.71%	54	14.88%
套	1181		10	80	0.01208%	579776	91.06%	54	14.88%
隔	1224		12	76	0.01147%	579852	91.57%	54	14.88%
館	662		16	197	0.02974%	580049	80.96%	53	14.60%
蘭	730		21	178	0.02687%	580227	82.87%	53	14.60%
酒	766		10	166	0.02506%	580393	83.81%	53	14.60%
腦	768		13	165	0.02491%	580558	83.86%	53	14.60%
蘇	789		20	159	0.02401%	580717	84.37%	53	14.60%
鬥	885		10	133	0.02008%	580850	86.47%	53	14.60%
啊	899		11	129	0.01948%	580979	86.74%	53	14.60%
惟	920		11	124	0.01872%	581103	87.15%	53	14.60%
登	981		12	112	0.01691%	581215	88.22%	53	14.60%
賣	1052		15	98	0.0148%	581313	89.35%	53	14.60%
殘	1064		12	94	0.01419%	581407	89.52%	53	14.60%
映	1092		9	90	0.01359%	581497	89.91%	53	14.60%
升	1107		4	88	0.01329%	581585	90.11%	53	14.60%
降	1137		8	86	0.01298%	581671	90.51%	53	14.60%
招	1201		8	78	0.01178%	581749	91.30%	53	14.60%
頓	1244		13	74	0.01117%	581823	91.79%	53	14.60%
觸	1260		20	72	0.01087%	581895	91.97%	53	14.60%
劇	469		15	312	0.0471%	582207	73.65%	52	14.33%
戲	721		17	179	0.02702%	582386	82.63%	52	14.33%
淺	852		11	140	0.02114%	582526	85.79%	52	14.33%
策	859		12	139	0.02099%	582665	85.94%	52	14.33%
藍	990		18	110	0.01661%	582775	88.38%	52	14.33%
衛	1008		15	107	0.01615%	582882	88.67%	52	14.33%
執	1070		11	93	0.01404%	582975	89.61%	52	14.33%
童	1088		12	91	0.01374%	583066	89.86%	52	14.33%
寬	1091		15	90	0.01359%	583156	89.90%	52	14.33%
骨	1097		10	90	0.01359%	583246	89.98%	52	14.33%
智	1110		12	88	0.01329%	583334	90.15%	52	14.33%
陰	1124		10	87	0.01313%	583421	90.34%	52	14.33%
唯	1209		11	77	0.01163%	583498	91.39%	52	14.33%
敗	1236		11	74	0.01117%	583572	91.70%	52	14.33%
植	711		12	181	0.02733%	583753	82.36%	51	14.05%
企	759		6	169	0.02551%	583922	83.63%	51	14.05%
康	866		11	136	0.02053%	584058	86.08%	51	14.05%
測	915		12	125	0.01887%	584183	87.05%	51	14.05%
帝	919		9	124	0.01872%	584307	87.13%	51	14.05%
飄	955		20	116	0.01751%	584423	87.78%	51	14.05%
飯	956		12	116	0.01751%	584539	87.80%	51	14.05%
博	986		12	110	0.01661%	584649	88.31%	51	14.05%
損	996		13	109	0.01646%	584758	88.47%	51	14.05%
訂	1021		9	105	0.01585%	584863	88.88%	51	14.05%
瞭	1095		17	90	0.01359%	584953	89.95%	51	14.05%
沿	1101		8	89	0.01344%	585042	90.03%	51	14.05%
洗	1111		9	88	0.01329%	585130	90.17%	51	14.05%
寄	1128		11	86	0.01298%	585216	90.39%	51	14.05%
浮	1144		10	85	0.01283%	585301	90.60%	51	14.05%
忍	1163		7	83	0.01253%	585384	90.84%	51	14.05%
謝	1177		17	81	0.01223%	585465	91.01%	51	14.05%
危	1180		6	80	0.01208%	585545	91.05%	51	14.05%
潔	1186		15	80	0.01208%	585625	91.12%	51	14.05%
巨	1191		5	79	0.01193%	585704	91.18%	51	14.05%
傾	1231		13	74	0.01117%	585778	91.65%	51	14.05%
介	1265		4	71	0.01072%	585849	92.02%	51	14.05%
股	1272		8	71	0.01072%	585920	92.09%	51	14.05%
跡	1359		13	63	0.009512%	585983	92.97%	51	14.05%
隊	717		11	180	0.02718%	586163	82.52%	50	13.77%
阿	804		7	155	0.0234%	586318	84.72%	50	13.77%
李	809		7	153	0.0231%	586471	84.84%	50	13.77%
核	846		10	141	0.02129%	586612	85.66%	50	13.77%
孔	912		4	126	0.01902%	586738	86.99%	50	13.77%
築	916		16	125	0.01887%	586863	87.07%	50	13.77%
漢	953		14	116	0.01751%	586979	87.74%	50	13.77%
促	963		9	114	0.01721%	587093	87.92%	50	13.77%
跳	1027		13	104	0.0157%	587197	88.97%	50	13.77%
潮	1036		15	102	0.0154%	587299	89.11%	50	13.77%
緩	1058		15	96	0.01449%	587395	89.44%	50	13.77%
掛	1140		11	85	0.01283%	587480	90.55%	50	13.77%
淚	1155		11	84	0.01268%	587564	90.74%	50	13.77%
仰	1173		6	81	0.01223%	587645	90.96%	50	13.77%
距	1212		12	77	0.01163%	587722	91.43%	50	13.77%
嘗	1214		14	76	0.01147%	587798	91.45%	50	13.77%
嘴	1225		15	75	0.01132%	587873	91.58%	50	13.77%
釋	1274		20	71	0.01072%	587944	92.12%	50	13.77%
漫	1282		14	70	0.01057%	588014	92.20%	50	13.77%
趨	1358		17	63	0.009512%	588077	92.96%	50	13.77%
尾	874		7	134	0.02023%	588211	86.25%	49	13.50%
鳥	1013		11	106	0.016%	588317	88.75%	49	13.50%
私	1033		7	103	0.01555%	588420	89.06%	49	13.50%
懂	1054		17	97	0.01464%	588517	89.38%	49	13.50%
玉	1087		5	91	0.01374%	588608	89.84%	49	13.50%
借	1099		10	89	0.01344%	588697	90.01%	49	13.50%
幽	1109		9	88	0.01329%	588785	90.14%	49	13.50%
縮	1148		17	85	0.01283%	588870	90.65%	49	13.50%
婦	1151		11	84	0.01268%	588954	90.69%	49	13.50%
掉	1164		11	83	0.01253%	589037	90.85%	49	13.50%
幫	1192		17	79	0.01193%	589116	91.19%	49	13.50%
番	1239		12	74	0.01117%	589190	91.73%	49	13.50%
珍	1251		9	73	0.01102%	589263	91.87%	49	13.50%
徑	1268		10	71	0.01072%	589334	92.05%	49	13.50%
醒	1273		16	71	0.01072%	589405	92.11%	49	13.50%
彼	1278		8	70	0.01057%	589475	92.16%	49	13.50%
伸	1306		7	67	0.01012%	589542	92.45%	49	13.50%
倫	718		10	179	0.02702%	589721	82.55%	48	13.22%
街	935		12	121	0.01827%	589842	87.42%	48	13.22%
店	969		8	113	0.01706%	589955	88.02%	48	13.22%
泥	1010		8	106	0.016%	590061	88.70%	48	13.22%
盤	1032		15	103	0.01555%	590164	89.05%	48	13.22%
武	1085		8	91	0.01374%	590255	89.82%	48	13.22%
朵	1170		6	82	0.01238%	590337	90.93%	48	13.22%
混	1194		11	79	0.01193%	590416	91.22%	48	13.22%
橫	1210		16	77	0.01163%	590493	91.41%	48	13.22%
孤	1226		8	75	0.01132%	590568	91.59%	48	13.22%
肯	1240		8	74	0.01117%	590642	91.75%	48	13.22%
翻	1327		18	66	0.009964%	590708	92.66%	48	13.22%
乘	1342		10	64	0.009662%	590772	92.81%	48	13.22%
江	835		6	144	0.02174%	590916	85.43%	47	12.95%
旅	1055		10	97	0.01464%	591013	89.39%	47	12.95%
析	1142		8	85	0.01283%	591098	90.57%	47	12.95%
染	1184		9	80	0.01208%	591178	91.10%	47	12.95%
賴	1188		16	80	0.01208%	591258	91.14%	47	12.95%
薄	1196		17	79	0.01193%	591337	91.24%	47	12.95%
爛	1332		21	65	0.009813%	591402	92.71%	47	12.95%
憑	1345		16	64	0.009662%	591466	92.84%	47	12.95%
宗	860		8	138	0.02083%	591604	85.96%	46	12.67%
控	1131		11	86	0.01298%	591690	90.43%	46	12.67%
粗	1146		11	85	0.01283%	591775	90.62%	46	12.67%
牆	1195		17	79	0.01193%	591854	91.23%	46	12.67%
君	1199		7	78	0.01178%	591932	91.28%	46	12.67%
吹	1233		7	74	0.01117%	592006	91.67%	46	12.67%
啟	1247		11	73	0.01102%	592079	91.82%	46	12.67%
閒	1252		12	73	0.01102%	592152	91.88%	46	12.67%
堆	1267		11	71	0.01072%	592223	92.04%	46	12.67%
穩	1271		19	71	0.01072%	592294	92.08%	46	12.67%
寞	1293		14	68	0.01027%	592362	92.32%	46	12.67%
塞	1350		13	63	0.009512%	592425	92.88%	46	12.67%
擬	1373		17	61	0.00921%	592486	93.10%	46	12.67%
輸	743		16	174	0.02627%	592660	83.21%	45	12.40%
仁	985		4	110	0.01661%	592770	88.29%	45	12.40%
操	1002		16	108	0.01631%	592878	88.57%	45	12.40%
州	1077		6	92	0.01389%	592970	89.71%	45	12.40%
桌	1115		10	87	0.01313%	593057	90.22%	45	12.40%
鳴	1125		14	87	0.01313%	593144	90.35%	45	12.40%
尖	1152		6	84	0.01268%	593228	90.70%	45	12.40%
顏	1208		18	78	0.01178%	593306	91.38%	45	12.40%
柔	1219		9	76	0.01147%	593382	91.51%	45	12.40%
窮	1221		15	76	0.01147%	593458	91.53%	45	12.40%
圈	1310		11	67	0.01012%	593525	92.49%	45	12.40%
握	1312		12	67	0.01012%	593592	92.51%	45	12.40%
舒	1347		12	64	0.009662%	593656	92.86%	45	12.40%
煩	1393		13	60	0.009059%	593716	93.28%	45	12.40%
序	1431		7	57	0.008606%	593773	93.62%	45	12.40%
豈	1436		10	57	0.008606%	593830	93.66%	45	12.40%
昏	1472		8	53	0.008002%	593883	93.96%	45	12.40%
款	742		12	174	0.02627%	594057	83.19%	44	12.12%
額	891		18	132	0.01993%	594189	86.59%	44	12.12%
購	972		17	113	0.01706%	594302	88.07%	44	12.12%
亡	1029		3	103	0.01555%	594405	89.00%	44	12.12%
誤	1074		14	93	0.01404%	594498	89.66%	44	12.12%
封	1129		9	86	0.01298%	594584	90.40%	44	12.12%
隱	1160		16	84	0.01268%	594668	90.80%	44	12.12%
閃	1168		10	83	0.01253%	594751	90.90%	44	12.12%
複	1241		14	74	0.01117%	594825	91.76%	44	12.12%
席	1254		10	72	0.01087%	594897	91.90%	44	12.12%
甘	1284		5	70	0.01057%	594967	92.22%	44	12.12%
返	1287		7	70	0.01057%	595037	92.25%	44	12.12%
幻	1290		4	69	0.01042%	595106	92.29%	44	12.12%
礎	1299		18	68	0.01027%	595174	92.38%	44	12.12%
禁	1300		13	68	0.01027%	595242	92.39%	44	12.12%
錄	1304		16	68	0.01027%	595310	92.43%	44	12.12%
牛	1317		4	67	0.01012%	595377	92.56%	44	12.12%
輝	1318		15	67	0.01012%	595444	92.57%	44	12.12%
硬	1334		12	65	0.009813%	595509	92.73%	44	12.12%
阻	1378		7	61	0.00921%	595570	93.15%	44	12.12%
駐	1380		15	61	0.00921%	595631	93.17%	44	12.12%
菜	840		12	143	0.02159%	595774	85.53%	43	11.85%
台	937		5	120	0.01812%	595894	87.46%	43	11.85%
廳	1100		25	89	0.01344%	595983	90.02%	43	11.85%
培	1114		11	87	0.01313%	596070	90.21%	43	11.85%
籍	1133		20	86	0.01298%	596156	90.46%	43	11.85%
訪	1136		11	86	0.01298%	596242	90.49%	43	11.85%
暖	1218		13	76	0.01147%	596318	91.50%	43	11.85%
晨	1237		11	74	0.01117%	596392	91.71%	43	11.85%
跑	1242		12	74	0.01117%	596466	91.77%	43	11.85%
鏡	1262		19	72	0.01087%	596538	91.99%	43	11.85%
昨	1280		9	70	0.01057%	596608	92.18%	43	11.85%
偉	1292		11	68	0.01027%	596676	92.31%	43	11.85%
抵	1296		8	68	0.01027%	596744	92.35%	43	11.85%
壯	1329		7	65	0.009813%	596809	92.68%	43	11.85%
績	1411		17	59	0.008908%	596868	93.44%	43	11.85%
迫	1424		8	58	0.008757%	596926	93.56%	43	11.85%
陷	1448		10	56	0.008455%	596982	93.76%	43	11.85%
奉	1460		8	54	0.008153%	597036	93.86%	43	11.85%
猶	1463		12	54	0.008153%	597090	93.89%	43	11.85%
厭	1488		14	52	0.007851%	597142	94.09%	43	11.85%
田	668		5	195	0.02944%	597337	81.14%	42	11.57%
黨	677		20	193	0.02914%	597530	81.40%	42	11.57%
紛	1066		10	94	0.01419%	597624	89.55%	42	11.57%
米	1229		6	75	0.01132%	597699	91.62%	42	11.57%
幼	1277		5	70	0.01057%	597769	92.15%	42	11.57%
悠	1279		11	70	0.01057%	597839	92.17%	42	11.57%
楚	1331		13	65	0.009813%	597904	92.70%	42	11.57%
荒	1337		10	65	0.009813%	597969	92.76%	42	11.57%
讚	1356		26	63	0.009512%	598032	92.94%	42	11.57%
魂	1369		14	62	0.009361%	598094	93.06%	42	11.57%
閉	1377		11	61	0.00921%	598155	93.14%	42	11.57%
伴	1381		7	60	0.009059%	598215	93.17%	42	11.57%
掌	1388		12	60	0.009059%	598275	93.24%	42	11.57%
珠	1394		10	60	0.009059%	598335	93.29%	42	11.57%
奔	1441		8	56	0.008455%	598391	93.71%	42	11.57%
秀	1465		7	54	0.008153%	598445	93.90%	42	11.57%
妨	1489		7	52	0.007851%	598497	94.10%	42	11.57%
碎	1496		13	52	0.007851%	598549	94.15%	42	11.57%
累	1498		11	52	0.007851%	598601	94.17%	42	11.57%
氏	722		4	179	0.02702%	598780	82.65%	41	11.29%
飾	827		13	148	0.02234%	598928	85.25%	41	11.29%
授	957		11	115	0.01736%	599043	87.81%	41	11.29%
俱	1035		10	102	0.0154%	599145	89.09%	41	11.29%
拍	1072		8	93	0.01404%	599238	89.64%	41	11.29%
哭	1139		10	85	0.01283%	599323	90.53%	41	11.29%
警	1172		20	82	0.01238%	599405	90.95%	41	11.29%
紹	1230		11	75	0.01132%	599480	91.63%	41	11.29%
拜	1324		9	66	0.009964%	599546	92.63%	41	11.29%
貢	1357		10	63	0.009512%	599609	92.95%	41	11.29%
徒	1386		10	60	0.009059%	599669	93.22%	41	11.29%
航	868		10	136	0.02053%	599805	86.12%	40	11.02%
蒼	1187		14	80	0.01208%	599885	91.13%	40	11.02%
戀	1216		23	76	0.01147%	599961	91.47%	40	11.02%
刊	1232		5	74	0.01117%	600035	91.66%	40	11.02%
判	1245		7	73	0.01102%	600108	91.80%	40	11.02%
醉	1288		15	70	0.01057%	600178	92.26%	40	11.02%
勵	1289		17	69	0.01042%	600247	92.27%	40	11.02%
廿	1294		4	68	0.01027%	600315	92.33%	40	11.02%
悉	1352		11	63	0.009512%	600378	92.90%	40	11.02%
辛	1367		7	62	0.009361%	600440	93.05%	40	11.02%
磨	1464		16	54	0.008153%	600494	93.90%	40	11.02%
逝	1482		10	53	0.008002%	600547	94.04%	40	11.02%
售	808		11	153	0.0231%	600700	84.82%	39	10.74%
射	1130		10	86	0.01298%	600786	90.42%	39	10.74%
斜	1217		11	76	0.01147%	600862	91.49%	39	10.74%
隆	1291		11	69	0.01042%	600931	92.30%	39	10.74%
緒	1335		14	65	0.009813%	600996	92.74%	39	10.74%
暴	1390		15	60	0.009059%	601056	93.26%	39	10.74%
擺	1405		18	59	0.008908%	601115	93.39%	39	10.74%
狂	1420		7	58	0.008757%	601173	93.52%	39	10.74%
繫	1455		19	55	0.008304%	601228	93.82%	39	10.74%
鼻	1458		14	55	0.008304%	601283	93.85%	39	10.74%
剩	1468		12	53	0.008002%	601336	93.93%	39	10.74%
哲	734		10	177	0.02672%	601513	82.98%	38	10.47%
池	934		6	121	0.01827%	601634	87.40%	38	10.47%
蒙	1038		14	101	0.01525%	601735	89.14%	38	10.47%
祖	1145		9	85	0.01283%	601820	90.61%	38	10.47%
壁	1169		16	82	0.01238%	601902	90.91%	38	10.47%
涼	1171		11	82	0.01238%	601984	90.94%	38	10.47%
冰	1266		6	71	0.01072%	602055	92.03%	38	10.47%
尊	1385		12	60	0.009059%	602115	93.21%	38	10.47%
哀	1404		9	59	0.008908%	602174	93.38%	38	10.47%
迴	1437		9	57	0.008606%	602231	93.67%	38	10.47%
唐	1440		10	56	0.008455%	602287	93.70%	38	10.47%
廢	1442		15	56	0.008455%	602343	93.71%	38	10.47%
叢	1459		18	54	0.008153%	602397	93.86%	38	10.47%
牽	1478		11	53	0.008002%	602450	94.01%	38	10.47%
胸	1499		10	52	0.007851%	602502	94.17%	38	10.47%
茲	1501		10	52	0.007851%	602554	94.19%	38	10.47%
耐	1515		9	51	0.0077%	602605	94.30%	38	10.47%
障	1522		13	51	0.0077%	602656	94.35%	38	10.47%
冒	1548		9	48	0.007247%	602704	94.55%	38	10.47%
滋	1586		12	46	0.006945%	602750	94.82%	38	10.47%
殺	1065		11	94	0.01419%	602844	89.54%	37	10.19%
旋	1078		11	92	0.01389%	602936	89.72%	37	10.19%
村	1176		7	81	0.01223%	603017	91.00%	37	10.19%
赤	1261		7	72	0.01087%	603089	91.98%	37	10.19%
燒	1283		16	70	0.01057%	603159	92.21%	37	10.19%
貧	1341		11	65	0.009813%	603224	92.80%	37	10.19%
顆	1361		17	63	0.009512%	603287	92.99%	37	10.19%
呀	1383		7	60	0.009059%	603347	93.19%	37	10.19%
針	1401		10	60	0.009059%	603407	93.36%	37	10.19%
淨	1407		11	59	0.008908%	603466	93.41%	37	10.19%
倍	1415		10	58	0.008757%	603524	93.48%	37	10.19%
勇	1416		9	58	0.008757%	603582	93.49%	37	10.19%
遲	1425		15	58	0.008757%	603640	93.57%	37	10.19%
綜	1454		14	55	0.008304%	603695	93.81%	37	10.19%
赴	1521		9	51	0.0077%	603746	94.34%	37	10.19%
疏	1569		11	47	0.007096%	603793	94.70%	37	10.19%
暫	1603		15	45	0.006794%	603838	94.93%	37	10.19%
夕	1646		3	42	0.006341%	603880	95.22%	37	10.19%
匪	772		10	164	0.02476%	604044	83.96%	36	9.92%
湖	853		12	140	0.02114%	604184	85.81%	36	9.92%
婚	1004		11	107	0.01615%	604291	88.60%	36	9.92%
縣	1067		16	94	0.01419%	604385	89.57%	36	9.92%
拖	1311		8	67	0.01012%	604452	92.50%	36	9.92%
彷	1322		7	66	0.009964%	604518	92.61%	36	9.92%
彿	1330		8	65	0.009813%	604583	92.69%	36	9.92%
塵	1351		14	63	0.009512%	604646	92.89%	36	9.92%
雅	1360		12	63	0.009512%	604709	92.98%	36	9.92%
袋	1366		11	62	0.009361%	604771	93.04%	36	9.92%
豪	1423		14	58	0.008757%	604829	93.55%	36	9.92%
憂	1443		15	56	0.008455%	604885	93.72%	36	9.92%
逃	1457		9	55	0.008304%	604940	93.84%	36	9.92%
慕	1493		15	52	0.007851%	604992	94.13%	36	9.92%
垂	1533		9	49	0.007398%	605041	94.44%	36	9.92%
闊	1558		17	48	0.007247%	605089	94.62%	36	9.92%
敬	1566		13	47	0.007096%	605136	94.67%	36	9.92%
擾	1583		18	46	0.006945%	605182	94.79%	36	9.92%
罷	1591		15	46	0.006945%	605228	94.85%	36	9.92%
堪	1617		12	44	0.006643%	605272	95.03%	36	9.92%
陶	973		10	113	0.01706%	605385	88.09%	35	9.64%
箱	1020		15	105	0.01585%	605490	88.86%	35	9.64%
鞋	1082		15	92	0.01389%	605582	89.78%	35	9.64%
競	1156		20	84	0.01268%	605666	90.75%	35	9.64%
鎮	1223		18	76	0.01147%	605742	91.55%	35	9.64%
彈	1227		15	75	0.01132%	605817	91.60%	35	9.64%
疾	1298		10	68	0.01027%	605885	92.37%	35	9.64%
餐	1305		16	68	0.01027%	605953	92.44%	35	9.64%
粉	1325		10	66	0.009964%	606019	92.64%	35	9.64%
描	1354		12	63	0.009512%	606082	92.92%	35	9.64%
攻	1362		7	62	0.009361%	606144	93.00%	35	9.64%
幕	1371		14	61	0.00921%	606205	93.08%	35	9.64%
陪	1379		10	61	0.00921%	606266	93.16%	35	9.64%
辭	1399		19	60	0.009059%	606326	93.34%	35	9.64%
凝	1402		16	59	0.008908%	606385	93.36%	35	9.64%
旦	1406		5	59	0.008908%	606444	93.40%	35	9.64%
墨	1430		15	57	0.008606%	606501	93.61%	35	9.64%
恨	1432		9	57	0.008606%	606558	93.63%	35	9.64%
倦	1438		10	56	0.008455%	606614	93.68%	35	9.64%
廉	1471		13	53	0.008002%	606667	93.95%	35	9.64%
洞	1474		9	53	0.008002%	606720	93.98%	35	9.64%
鬆	1504		18	52	0.007851%	606772	94.21%	35	9.64%
摸	1510		14	51	0.0077%	606823	94.26%	35	9.64%
慰	1563		15	47	0.007096%	606870	94.65%	35	9.64%
滑	1005		13	107	0.01615%	606977	88.62%	34	9.37%
松	1024		8	104	0.0157%	607081	88.92%	34	9.37%
梅	1050		11	98	0.0148%	607179	89.32%	34	9.37%
弟	1059		7	95	0.01434%	607274	89.45%	34	9.37%
奏	1083		9	91	0.01374%	607365	89.79%	34	9.37%
胡	1204		9	78	0.01178%	607443	91.33%	34	9.37%
濕	1228		17	75	0.01132%	607518	91.61%	34	9.37%
兵	1320		7	66	0.009964%	607584	92.59%	34	9.37%
忠	1323		8	66	0.009964%	607650	92.62%	34	9.37%
糊	1326		15	66	0.009964%	607716	92.65%	34	9.37%
振	1353		10	63	0.009512%	607779	92.91%	34	9.37%
牙	1355		4	63	0.009512%	607842	92.93%	34	9.37%
犯	1445		5	56	0.008455%	607898	93.74%	34	9.37%
鄰	1447		14	56	0.008455%	607954	93.76%	34	9.37%
蕩	1518		16	51	0.0077%	608005	94.32%	34	9.37%
襲	1520		22	51	0.0077%	608056	94.34%	34	9.37%
擠	1525		17	50	0.007549%	608106	94.37%	34	9.37%
桃	1538		10	49	0.007398%	608155	94.47%	34	9.37%
泛	1540		8	49	0.007398%	608204	94.49%	34	9.37%
謀	1545		16	49	0.007398%	608253	94.52%	34	9.37%
迅	1574		6	47	0.007096%	608300	94.73%	34	9.37%
埋	1578		10	46	0.006945%	608346	94.76%	34	9.37%
聊	1623		11	44	0.006643%	608390	95.07%	34	9.37%
哥	850		10	140	0.02114%	608530	85.75%	33	9.09%
佛	878		7	133	0.02008%	608663	86.33%	33	9.09%
網	917		14	125	0.01887%	608788	87.09%	33	9.09%
祝	1346		9	64	0.009662%	608852	92.85%	33	9.09%
爬	1363		8	62	0.009361%	608914	93.01%	33	9.09%
儀	1370		15	61	0.00921%	608975	93.07%	33	9.09%
貼	1397		12	60	0.009059%	609035	93.32%	33	9.09%
酸	1400		14	60	0.009059%	609095	93.35%	33	9.09%
飲	1426		12	58	0.008757%	609153	93.58%	33	9.09%
璃	1435		15	57	0.008606%	609210	93.65%	33	9.09%
懸	1462		20	54	0.008153%	609264	93.88%	33	9.09%
嫌	1491		13	52	0.007851%	609316	94.11%	33	9.09%
譽	1503		21	52	0.007851%	609368	94.21%	33	9.09%
愉	1506		12	51	0.0077%	609419	94.23%	33	9.09%
繞	1514		18	51	0.0077%	609470	94.29%	33	9.09%
緻	1529		15	50	0.007549%	609520	94.41%	33	9.09%
茫	1530		10	50	0.007549%	609570	94.41%	33	9.09%
莊	1572		11	47	0.007096%	609617	94.72%	33	9.09%
崇	1580		11	46	0.006945%	609663	94.77%	33	9.09%
托	1581		6	46	0.006945%	609709	94.78%	33	9.09%
符	1622		11	44	0.006643%	609753	95.06%	33	9.09%
估	1665		7	40	0.006039%	609793	95.33%	33	9.09%
枯	1670		9	40	0.006039%	609833	95.36%	33	9.09%
貌	1693		14	39	0.005888%	609872	95.50%	33	9.09%
漁	227		14	623	0.09406%	610495	57.59%	32	8.82%
刀	903		2	128	0.01932%	610623	86.82%	32	8.82%
貝	941		7	120	0.01812%	610743	87.53%	32	8.82%
黎	962		15	115	0.01736%	610858	87.90%	32	8.82%
鋼	1081		16	92	0.01389%	610950	89.76%	32	8.82%
汽	1116		7	87	0.01313%	611037	90.23%	32	8.82%
紫	1147		12	85	0.01283%	611122	90.64%	32	8.82%
妻	1162		8	83	0.01253%	611205	90.83%	32	8.82%
漂	1185		14	80	0.01208%	611285	91.11%	32	8.82%
喝	1309		12	67	0.01012%	611352	92.48%	32	8.82%
震	1319		15	67	0.01012%	611419	92.58%	32	8.82%
獎	1321		15	66	0.009964%	611485	92.60%	32	8.82%
軟	1348		11	64	0.009662%	611549	92.87%	32	8.82%
籌	1374		20	61	0.00921%	611610	93.11%	32	8.82%
罪	1396		13	60	0.009059%	611670	93.31%	32	8.82%
譬	1413		20	59	0.008908%	611729	93.46%	32	8.82%
幅	1419		12	58	0.008757%	611787	93.52%	32	8.82%
玻	1446		9	56	0.008455%	611843	93.75%	32	8.82%
屆	1450		8	55	0.008304%	611898	93.78%	32	8.82%
皇	1542		9	49	0.007398%	611947	94.50%	32	8.82%
縫	1571		17	47	0.007096%	611994	94.71%	32	8.82%
姿	1579		9	46	0.006945%	612040	94.77%	32	8.82%
准	1595		10	45	0.006794%	612085	94.88%	32	8.82%
邀	1615		16	45	0.006794%	612130	95.01%	32	8.82%
輩	1626		15	44	0.006643%	612174	95.09%	32	8.82%
雞	1644		18	43	0.006492%	612217	95.20%	32	8.82%
贊	1659		19	41	0.00619%	612258	95.30%	32	8.82%
踏	1660		15	41	0.00619%	612299	95.30%	32	8.82%
飽	1662		13	41	0.00619%	612340	95.32%	32	8.82%
稀	1672		12	40	0.006039%	612380	95.38%	32	8.82%
伏	1695		6	38	0.005737%	612418	95.51%	32	8.82%
貫	1757		11	36	0.005435%	612454	95.86%	32	8.82%
于	673		3	193	0.02914%	612647	81.28%	31	8.54%
橋	970		16	113	0.01706%	612760	88.04%	31	8.54%
捕	1084		10	91	0.01374%	612851	89.80%	31	8.54%
芳	1102		8	89	0.01344%	612940	90.05%	31	8.54%
輔	1158		14	84	0.01268%	613024	90.78%	31	8.54%
偷	1253		11	72	0.01087%	613096	91.89%	31	8.54%
措	1256		11	72	0.01087%	613168	91.92%	31	8.54%
茶	1259		10	72	0.01087%	613240	91.95%	31	8.54%
慶	1295		15	68	0.01027%	613308	92.34%	31	8.54%
腹	1364		13	62	0.009361%	613370	93.02%	31	8.54%
燃	1409		16	59	0.008908%	613429	93.43%	31	8.54%
牌	1444		12	56	0.008455%	613485	93.73%	31	8.54%
蓄	1466		14	54	0.008153%	613539	93.91%	31	8.54%
烏	1477		10	53	0.008002%	613592	94.00%	31	8.54%
宮	1492		10	52	0.007851%	613644	94.12%	31	8.54%
慈	1507		13	51	0.0077%	613695	94.24%	31	8.54%
愁	1508		13	51	0.0077%	613746	94.24%	31	8.54%
夾	1534		7	49	0.007398%	613795	94.44%	31	8.54%
宇	1549		6	48	0.007247%	613843	94.55%	31	8.54%
嘆	1561		14	47	0.007096%	613890	94.64%	31	8.54%
懼	1564		21	47	0.007096%	613937	94.66%	31	8.54%
敵	1585		15	46	0.006945%	613983	94.81%	31	8.54%
曉	1604		16	45	0.006794%	614028	94.94%	31	8.54%
潛	1608		15	45	0.006794%	614073	94.97%	31	8.54%
朗	1620		10	44	0.006643%	614117	95.05%	31	8.54%
剪	647		11	203	0.03065%	614320	80.51%	30	8.26%
稅	753		12	172	0.02597%	614492	83.48%	30	8.26%
川	791		3	158	0.02385%	614650	84.42%	30	8.26%
卡	904		5	128	0.01932%	614778	86.84%	30	8.26%
楊	948		13	117	0.01766%	614895	87.66%	30	8.26%
糖	1112		16	88	0.01329%	614983	90.18%	30	8.26%
膠	1167		15	83	0.01253%	615066	90.89%	30	8.26%
京	1190		8	79	0.01193%	615145	91.17%	30	8.26%
患	1248		11	73	0.01102%	615218	91.83%	30	8.26%
霧	1275		19	71	0.01072%	615289	92.13%	30	8.26%
蟲	1339		18	65	0.009813%	615354	92.78%	30	8.26%
側	1343		11	64	0.009662%	615418	92.82%	30	8.26%
祗	1395		9	60	0.009059%	615478	93.30%	30	8.26%
匯	1403		13	59	0.008908%	615537	93.37%	30	8.26%
潤	1408		15	59	0.008908%	615596	93.42%	30	8.26%
匆	1417		5	58	0.008757%	615654	93.50%	30	8.26%
援	1433		12	57	0.008606%	615711	93.64%	30	8.26%
沖	1451		7	55	0.008304%	615766	93.79%	30	8.26%
賓	1456		14	55	0.008304%	615821	93.83%	30	8.26%
仙	1467		5	53	0.008002%	615874	93.92%	30	8.26%
抑	1509		7	51	0.0077%	615925	94.25%	30	8.26%
塗	1523		13	50	0.007549%	615975	94.36%	30	8.26%
審	1524		15	50	0.007549%	616025	94.37%	30	8.26%
寸	1536		3	49	0.007398%	616074	94.46%	30	8.26%
召	1597		5	45	0.006794%	616119	94.89%	30	8.26%
涉	1607		10	45	0.006794%	616164	94.96%	30	8.26%
籠	1610		22	45	0.006794%	616209	94.98%	30	8.26%
疲	1621		10	44	0.006643%	616253	95.05%	30	8.26%
甲	1636		5	43	0.006492%	616296	95.15%	30	8.26%
碧	1638		14	43	0.006492%	616339	95.16%	30	8.26%
鬱	1645		29	43	0.006492%	616382	95.21%	30	8.26%
遷	1661		14	41	0.00619%	616423	95.31%	30	8.26%
坦	1667		8	40	0.006039%	616463	95.35%	30	8.26%
齡	1678		20	40	0.006039%	616503	95.41%	30	8.26%
柏	1704		9	38	0.005737%	616541	95.56%	30	8.26%
逢	1716		10	38	0.005737%	616579	95.63%	30	8.26%
脆	1775		10	35	0.005284%	616614	95.96%	30	8.26%
媽	596		13	231	0.03488%	616845	78.83%	29	7.99%
貿	716		12	180	0.02718%	617025	82.49%	29	7.99%
版	940		8	120	0.01812%	617145	87.51%	29	7.99%
塑	1276		13	70	0.01057%	617215	92.14%	29	7.99%
森	1281		12	70	0.01057%	617285	92.19%	29	7.99%
誕	1340		15	65	0.009813%	617350	92.79%	29	7.99%
丈	1349		3	63	0.009512%	617413	92.88%	29	7.99%
怨	1387		9	60	0.009059%	617473	93.23%	29	7.99%
哈	1429		9	57	0.008606%	617530	93.60%	29	7.99%
呈	1439		7	56	0.008455%	617586	93.69%	29	7.99%
聚	1516		14	51	0.0077%	617637	94.31%	29	7.99%
衰	1519		10	51	0.0077%	617688	94.33%	29	7.99%
慧	1537		15	49	0.007398%	617737	94.46%	29	7.99%
丁	1546		2	48	0.007247%	617785	94.53%	29	7.99%
兄	1559		5	47	0.007096%	617832	94.63%	29	7.99%
瓶	1568		11	47	0.007096%	617879	94.69%	29	7.99%
插	1582		12	46	0.006945%	617925	94.79%	29	7.99%
搬	1633		13	43	0.006492%	617968	95.13%	29	7.99%
悅	1648		10	42	0.006341%	618010	95.23%	29	7.99%
挑	1656		9	41	0.00619%	618051	95.28%	29	7.99%
械	1671		11	40	0.006039%	618091	95.37%	29	7.99%
拒	1703		8	38	0.005737%	618129	95.56%	29	7.99%
礙	1729		19	37	0.005586%	618166	95.71%	29	7.99%
恰	1744		9	36	0.005435%	618202	95.79%	29	7.99%
捨	1808		11	33	0.004982%	618235	96.12%	29	7.99%
毒	727		9	178	0.02687%	618413	82.79%	28	7.71%
谷	1089		7	91	0.01374%	618504	89.87%	28	7.71%
庫	1193		10	79	0.01193%	618583	91.20%	28	7.71%
舍	1205		8	78	0.01178%	618661	91.35%	28	7.71%
融	1206		16	78	0.01178%	618739	91.36%	28	7.71%
琴	1258		12	72	0.01087%	618811	91.94%	28	7.71%
泉	1297		9	68	0.01027%	618879	92.36%	28	7.71%
杯	1391		8	60	0.009059%	618939	93.27%	28	7.71%
賽	1398		17	60	0.009059%	618999	93.33%	28	7.71%
哪	1470		10	53	0.008002%	619052	93.94%	28	7.71%
泰	1475		10	53	0.008002%	619105	93.98%	28	7.71%
溝	1476		13	53	0.008002%	619158	93.99%	28	7.71%
娘	1490		10	52	0.007851%	619210	94.10%	28	7.71%
侵	1576		9	46	0.006945%	619256	94.75%	28	7.71%
奧	1600		13	45	0.006794%	619301	94.91%	28	7.71%
浸	1606		10	45	0.006794%	619346	94.95%	28	7.71%
悟	1618		10	44	0.006643%	619390	95.03%	28	7.71%
吐	1654		6	41	0.00619%	619431	95.27%	28	7.71%
暢	1685		14	39	0.005888%	619470	95.45%	28	7.71%
舖	1690		15	39	0.005888%	619509	95.48%	28	7.71%
慎	1768		13	35	0.005284%	619544	95.92%	28	7.71%
妥	1782		7	34	0.005133%	619578	95.99%	28	7.71%
狹	1813		10	33	0.004982%	619611	96.15%	28	7.71%
勉	1825		9	32	0.004831%	619643	96.21%	28	7.71%
掩	1832		11	32	0.004831%	619675	96.24%	28	7.71%
療	901		17	129	0.01948%	619804	86.78%	27	7.44%
雕	907		16	128	0.01932%	619932	86.90%	27	7.44%
紋	1079		10	92	0.01389%	620024	89.73%	27	7.44%
戴	1235		17	74	0.01117%	620098	91.69%	27	7.44%
旗	1249		14	73	0.01102%	620171	91.85%	27	7.44%
億	1308		15	67	0.01012%	620238	92.47%	27	7.44%
菲	1365		12	62	0.009361%	620300	93.03%	27	7.44%
游	1452		12	55	0.008304%	620355	93.80%	27	7.44%
倡	1486		10	52	0.007851%	620407	94.07%	27	7.44%
紐	1497		10	52	0.007851%	620459	94.16%	27	7.44%
敏	1511		11	51	0.0077%	620510	94.27%	27	7.44%
碼	1543		15	49	0.007398%	620559	94.51%	27	7.44%
彎	1550		22	48	0.007247%	620607	94.56%	27	7.44%
豆	1556		7	48	0.007247%	620655	94.60%	27	7.44%
摩	1602		15	45	0.006794%	620700	94.92%	27	7.44%
敲	1619		14	44	0.006643%	620744	95.04%	27	7.44%
倘	1628		10	43	0.006492%	620787	95.10%	27	7.44%
戶	1632		4	43	0.006492%	620830	95.13%	27	7.44%
渡	1634		12	43	0.006492%	620873	95.14%	27	7.44%
膽	1689		17	39	0.005888%	620912	95.48%	27	7.44%
瓦	1751		5	36	0.005435%	620948	95.83%	27	7.44%
恢	1767		9	35	0.005284%	620983	95.91%	27	7.44%
綴	1773		14	35	0.005284%	621018	95.95%	27	7.44%
頁	1778		9	35	0.005284%	621053	95.97%	27	7.44%
湧	1789		12	34	0.005133%	621087	96.03%	27	7.44%
肚	1794		7	34	0.005133%	621121	96.05%	27	7.44%
惑	1803		12	33	0.004982%	621154	96.10%	27	7.44%
馳	1823		13	33	0.004982%	621187	96.20%	27	7.44%
迄	1893		6	30	0.004529%	621217	96.53%	27	7.44%
杜	823		7	149	0.0225%	621366	85.16%	26	7.16%
荷	1103		11	89	0.01344%	621455	90.06%	26	7.16%
衡	1122		16	87	0.01313%	621542	90.31%	26	7.16%
坡	1200		8	78	0.01178%	621620	91.29%	26	7.16%
胞	1302		9	68	0.01027%	621688	92.41%	26	7.16%
裂	1303		12	68	0.01027%	621756	92.42%	26	7.16%
噴	1344		15	64	0.009662%	621820	92.83%	26	7.16%
悄	1372		10	61	0.00921%	621881	93.09%	26	7.16%
柳	1392		9	60	0.009059%	621941	93.27%	26	7.16%
覽	1422		21	58	0.008757%	621999	93.54%	26	7.16%
僑	1449		14	55	0.008304%	622054	93.77%	26	7.16%
丹	1485		4	52	0.007851%	622106	94.06%	26	7.16%
污	1513		6	51	0.0077%	622157	94.28%	26	7.16%
幣	1601		14	45	0.006794%	622202	94.92%	26	7.16%
甜	1635		11	43	0.006492%	622245	95.14%	26	7.16%
瘦	1637		14	43	0.006492%	622288	95.16%	26	7.16%
播	1649		15	42	0.006341%	622330	95.24%	26	7.16%
壽	1655		14	41	0.00619%	622371	95.27%	26	7.16%
宿	1668		11	40	0.006039%	622411	95.35%	26	7.16%
仔	1680		5	39	0.005888%	622450	95.42%	26	7.16%
廚	1683		15	39	0.005888%	622489	95.44%	26	7.16%
滾	1686		14	39	0.005888%	622528	95.46%	26	7.16%
譯	1714		20	38	0.005737%	622566	95.62%	26	7.16%
辨	1715		16	38	0.005737%	622604	95.63%	26	7.16%
腐	1733		14	37	0.005586%	622641	95.73%	26	7.16%
齒	1739		15	37	0.005586%	622678	95.76%	26	7.16%
澤	1749		16	36	0.005435%	622714	95.82%	26	7.16%
奈	1764		8	35	0.005284%	622749	95.90%	26	7.16%
驅	1779		21	35	0.005284%	622784	95.98%	26	7.16%
佩	1780		8	34	0.005133%	622818	95.98%	26	7.16%
虧	1796		17	34	0.005133%	622852	96.06%	26	7.16%
劣	1800		6	33	0.004982%	622885	96.08%	26	7.16%
摘	1809		14	33	0.004982%	622918	96.13%	26	7.16%
悶	1847		12	31	0.00468%	622949	96.31%	26	7.16%
循	1906		12	29	0.004378%	622978	96.58%	26	7.16%
潑	1924		15	29	0.004378%	623007	96.66%	26	7.16%
劑	1037		16	101	0.01525%	623108	89.13%	25	6.89%
塔	1062		13	94	0.01419%	623202	89.49%	25	6.89%
駛	1068		15	94	0.01419%	623296	89.58%	25	6.89%
劉	1106		15	88	0.01329%	623384	90.10%	25	6.89%
翅	1135		10	86	0.01298%	623470	90.48%	25	6.89%
凍	1150		10	84	0.01268%	623554	90.67%	25	6.89%
株	1269		10	71	0.01072%	623625	92.06%	25	6.89%
溶	1270		13	71	0.01072%	623696	92.07%	25	6.89%
椅	1314		12	67	0.01012%	623763	92.53%	25	6.89%
肥	1375		8	61	0.00921%	623824	93.12%	25	6.89%
暑	1473		12	53	0.008002%	623877	93.97%	25	6.89%
滴	1541		14	49	0.007398%	623926	94.49%	25	6.89%
儲	1547		17	48	0.007247%	623974	94.54%	25	6.89%
喊	1560		12	47	0.007096%	624021	94.63%	25	6.89%
攝	1584		21	46	0.006945%	624067	94.80%	25	6.89%
票	1588		11	46	0.006945%	624113	94.83%	25	6.89%
賢	1653		15	42	0.006341%	624155	95.26%	25	6.89%
羊	1658		6	41	0.00619%	624196	95.29%	25	6.89%
逸	1675		11	40	0.006039%	624236	95.39%	25	6.89%
云	1679		4	39	0.005888%	624275	95.42%	25	6.89%
冊	1681		5	39	0.005888%	624314	95.43%	25	6.89%
紗	1687		10	39	0.005888%	624353	95.47%	25	6.89%
銅	1694		14	39	0.005888%	624392	95.51%	25	6.89%
怒	1702		9	38	0.005737%	624430	95.55%	25	6.89%
遮	1717		14	38	0.005737%	624468	95.64%	25	6.89%
扣	1721		6	37	0.005586%	624505	95.66%	25	6.89%
虎	1736		8	37	0.005586%	624542	95.75%	25	6.89%
躍	1758		21	36	0.005435%	624578	95.87%	25	6.89%
稿	1772		15	35	0.005284%	624613	95.94%	25	6.89%
違	1777		12	35	0.005284%	624648	95.97%	25	6.89%
喪	1781		12	34	0.005133%	624682	95.99%	25	6.89%
憐	1785		15	34	0.005133%	624716	96.01%	25	6.89%
慘	1804		14	33	0.004982%	624749	96.10%	25	6.89%
懶	1806		19	33	0.004982%	624782	96.11%	25	6.89%
燦	1812		17	33	0.004982%	624815	96.14%	25	6.89%
肅	1816		12	33	0.004982%	624848	96.16%	25	6.89%
惱	1829		12	32	0.004831%	624880	96.23%	25	6.89%
愚	1830		13	32	0.004831%	624912	96.23%	25	6.89%
遙	1864		13	31	0.00468%	624943	96.39%	25	6.89%
傲	1866		13	30	0.004529%	624973	96.40%	25	6.89%
汗	1878		6	30	0.004529%	625003	96.46%	25	6.89%
俯	1937		10	28	0.004227%	625031	96.72%	25	6.89%
糾	1975		8	27	0.004076%	625058	96.88%	25	6.89%
狗	895		8	131	0.01978%	625189	86.67%	24	6.61%
溪	1031		13	103	0.01555%	625292	89.03%	24	6.61%
孟	1048		8	98	0.0148%	625390	89.29%	24	6.61%
噸	1075		16	92	0.01389%	625482	89.68%	24	6.61%
液	1203		11	78	0.01178%	625560	91.32%	24	6.61%
昂	1250		8	73	0.01102%	625633	91.86%	24	6.61%
井	1264		4	71	0.01072%	625704	92.01%	24	6.61%
鑽	1368		27	62	0.009361%	625766	93.05%	24	6.61%
	1461		12	54	0.008153%	625820	93.87%	24	6.61%
雷	1483		13	53	0.008002%	625873	94.05%	24	6.61%
絡	1590		12	46	0.006945%	625919	94.84%	24	6.61%
毀	1605		13	45	0.006794%	625964	94.95%	24	6.61%
哩	1616		10	44	0.006643%	626008	95.02%	24	6.61%
滲	1707		14	38	0.005737%	626046	95.58%	24	6.61%
喻	1742		12	36	0.005435%	626082	95.78%	24	6.61%
粒	1752		11	36	0.005435%	626118	95.83%	24	6.61%
騰	1762		20	36	0.005435%	626154	95.89%	24	6.61%
碰	1771		13	35	0.005284%	626189	95.93%	24	6.61%
翼	1774		17	35	0.005284%	626224	95.95%	24	6.61%
泣	1810		8	33	0.004982%	626257	96.13%	24	6.61%
躲	1821		13	33	0.004982%	626290	96.19%	24	6.61%
卅	1826		4	32	0.004831%	626322	96.21%	24	6.61%
抓	1831		7	32	0.004831%	626354	96.24%	24	6.61%
擦	1834		17	32	0.004831%	626386	96.25%	24	6.61%
拋	1874		8	30	0.004529%	626416	96.44%	24	6.61%
澈	1881		14	30	0.004529%	626446	96.47%	24	6.61%
謹	1892		18	30	0.004529%	626476	96.52%	24	6.61%
奪	1901		14	29	0.004378%	626505	96.56%	24	6.61%
掃	1908		11	29	0.004378%	626534	96.59%	24	6.61%
漠	1922		14	29	0.004378%	626563	96.65%	24	6.61%
併	1985		8	26	0.003925%	626589	96.92%	24	6.61%
盆	1060		9	95	0.01434%	626684	89.47%	23	6.34%
伯	1307		7	67	0.01012%	626751	92.46%	23	6.34%
殼	1315		12	67	0.01012%	626818	92.54%	23	6.34%
姑	1418		8	58	0.008757%	626876	93.51%	23	6.34%
眠	1528		10	50	0.007549%	626926	94.40%	23	6.34%
罵	1639		15	43	0.006492%	626969	95.17%	23	6.34%
伊	1664		6	40	0.006039%	627009	95.33%	23	6.34%
纖	1673		23	40	0.006039%	627049	95.38%	23	6.34%
孫	1682		10	39	0.005888%	627088	95.44%	23	6.34%
蜜	1692		14	39	0.005888%	627127	95.50%	23	6.34%
宋	1698		7	38	0.005737%	627165	95.53%	23	6.34%
冠	1763		9	35	0.005284%	627200	95.89%	23	6.34%
誌	1820		14	33	0.004982%	627233	96.18%	23	6.34%
喚	1827		12	32	0.004831%	627265	96.22%	23	6.34%
掙	1833		11	32	0.004831%	627297	96.25%	23	6.34%
勤	1842		13	31	0.00468%	627328	96.29%	23	6.34%
拓	1848		8	31	0.00468%	627359	96.32%	23	6.34%
眉	1858		9	31	0.00468%	627390	96.37%	23	6.34%
膚	1861		15	31	0.00468%	627421	96.38%	23	6.34%
臥	1885		8	30	0.004529%	627451	96.49%	23	6.34%
艱	1886		17	30	0.004529%	627481	96.49%	23	6.34%
暮	1916		15	29	0.004378%	627510	96.63%	23	6.34%
欠	1918		4	29	0.004378%	627539	96.64%	23	6.34%
肩	1926		8	29	0.004378%	627568	96.67%	23	6.34%
痕	1948		11	28	0.004227%	627596	96.76%	23	6.34%
盈	1949		9	28	0.004227%	627624	96.77%	23	6.34%
勁	1954		9	27	0.004076%	627651	96.79%	23	6.34%
鬼	1984		10	27	0.004076%	627678	96.91%	23	6.34%
拘	1992		8	26	0.003925%	627704	96.94%	23	6.34%
拾	1993		9	26	0.003925%	627730	96.95%	23	6.34%
遣	2015		13	26	0.003925%	627756	97.03%	23	6.34%
臭	2049		10	25	0.003774%	627781	97.16%	23	6.34%
吳	1246		7	73	0.01102%	627854	91.81%	22	6.06%
脈	1285		10	70	0.01057%	627924	92.23%	22	6.06%
瑞	1410		13	59	0.008908%	627983	93.44%	22	6.06%
刷	1427		8	57	0.008606%	628040	93.59%	22	6.06%
咬	1469		9	53	0.008002%	628093	93.94%	22	6.06%
魯	1484		15	53	0.008002%	628146	94.06%	22	6.06%
偽	1487		11	52	0.007851%	628198	94.08%	22	6.06%
吉	1505		6	51	0.0077%	628249	94.22%	22	6.06%
炎	1527		8	50	0.007549%	628299	94.39%	22	6.06%
臟	1555		22	48	0.007247%	628347	94.60%	22	6.06%
粹	1570		14	47	0.007096%	628394	94.70%	22	6.06%
呵	1598		8	45	0.006794%	628439	94.90%	22	6.06%
申	1609		5	45	0.006794%	628484	94.97%	22	6.06%
敘	1650		11	42	0.006341%	628526	95.24%	22	6.06%
撲	1669		15	40	0.006039%	628566	95.36%	22	6.06%
駕	1677		15	40	0.006039%	628606	95.41%	22	6.06%
宙	1699		8	38	0.005737%	628644	95.54%	22	6.06%
盪	1709		17	38	0.005737%	628682	95.59%	22	6.06%
泊	1723		8	37	0.005586%	628719	95.67%	22	6.06%
獸	1724		19	37	0.005586%	628756	95.68%	22	6.06%
祥	1731		10	37	0.005586%	628793	95.72%	22	6.06%
腿	1734		14	37	0.005586%	628830	95.73%	22	6.06%
捉	1746		10	36	0.005435%	628866	95.80%	22	6.06%
撥	1747		15	36	0.005435%	628902	95.81%	22	6.06%
姐	1783		8	34	0.005133%	628936	96.00%	22	6.06%
廊	1784		12	34	0.005133%	628970	96.00%	22	6.06%
串	1799		7	33	0.004982%	629003	96.08%	22	6.06%
憤	1805		15	33	0.004982%	629036	96.11%	22	6.06%
捧	1807		11	33	0.004982%	629069	96.12%	22	6.06%
醜	1822		17	33	0.004982%	629102	96.19%	22	6.06%
傑	1824		12	32	0.004831%	629134	96.20%	22	6.06%
罩	1837		13	32	0.004831%	629166	96.27%	22	6.06%
耀	1838		20	32	0.004831%	629198	96.27%	22	6.06%
挺	1849		10	31	0.00468%	629229	96.32%	22	6.06%
遂	1863		12	31	0.00468%	629260	96.39%	22	6.06%
逼	1894		12	30	0.004529%	629290	96.53%	22	6.06%
丟	1896		6	29	0.004378%	629319	96.54%	22	6.06%
撒	1911		15	29	0.004378%	629348	96.60%	22	6.06%
漏	1923		14	29	0.004378%	629377	96.66%	22	6.06%
蔭	1928		15	29	0.004378%	629406	96.68%	22	6.06%
誘	1952		14	28	0.004227%	629434	96.78%	22	6.06%
呆	1956		7	27	0.004076%	629461	96.80%	22	6.06%
吞	2023		7	25	0.003774%	629486	97.06%	22	6.06%
盼	2044		9	25	0.003774%	629511	97.14%	22	6.06%
俄	923		9	123	0.01857%	629634	87.20%	21	5.79%
殖	989		12	110	0.01661%	629744	88.36%	21	5.79%
傘	1127		12	86	0.01298%	629830	90.38%	21	5.79%
燥	1132		17	86	0.01298%	629916	90.44%	21	5.79%
泡	1257		8	72	0.01087%	629988	91.93%	21	5.79%
罐	1301		24	68	0.01027%	630056	92.40%	21	5.79%
郎	1531		8	50	0.007549%	630106	94.42%	21	5.79%
削	1532		9	49	0.007398%	630155	94.43%	21	5.79%
閱	1676		15	40	0.006039%	630195	95.40%	21	5.79%
監	1726		14	37	0.005586%	630232	95.69%	21	5.79%
碗	1728		13	37	0.005586%	630269	95.70%	21	5.79%
韻	1738		19	37	0.005586%	630306	95.76%	21	5.79%
訊	1755		10	36	0.005435%	630342	95.85%	21	5.79%
婆	1766		11	35	0.005284%	630377	95.91%	21	5.79%
扇	1769		10	35	0.005284%	630412	95.92%	21	5.79%
柴	1787		10	34	0.005133%	630446	96.02%	21	5.79%
炸	1791		9	34	0.005133%	630480	96.04%	21	5.79%
辯	1841		21	32	0.004831%	630512	96.29%	21	5.79%
悔	1846		10	31	0.00468%	630543	96.31%	21	5.79%
玄	1854		5	31	0.00468%	630574	96.35%	21	5.79%
鳳	1865		14	31	0.00468%	630605	96.40%	21	5.79%
恒	1871		9	30	0.004529%	630635	96.43%	21	5.79%
襯	1889		21	30	0.004529%	630665	96.51%	21	5.79%
扎	1907		4	29	0.004378%	630694	96.59%	21	5.79%
搭	1910		13	29	0.004378%	630723	96.60%	21	5.79%
諾	1929		16	29	0.004378%	630752	96.68%	21	5.79%
牢	1946		7	28	0.004227%	630780	96.76%	21	5.79%
勸	1955		20	27	0.004076%	630807	96.79%	21	5.79%
昔	1961		8	27	0.004076%	630834	96.82%	21	5.79%
截	2029		14	25	0.003774%	630859	97.09%	21	5.79%
添	2038		11	25	0.003774%	630884	97.12%	21	5.79%
傍	2057		12	24	0.003623%	630908	97.19%	21	5.79%
誇	2078		13	24	0.003623%	630932	97.27%	21	5.79%
稚	2101		13	23	0.003472%	630955	97.35%	21	5.79%
蔽	2105		15	23	0.003472%	630978	97.36%	21	5.79%
貪	2107		11	23	0.003472%	631001	97.37%	21	5.79%
吾	1428		7	57	0.008606%	631058	93.59%	20	5.51%
柱	1551		9	48	0.007247%	631106	94.57%	20	5.51%
濤	1587		17	46	0.006945%	631152	94.82%	20	5.51%
遜	1627		13	44	0.006643%	631196	95.09%	20	5.51%
姆	1630		8	43	0.006492%	631239	95.11%	20	5.51%
徐	1631		10	43	0.006492%	631282	95.12%	20	5.51%
勒	1666		11	40	0.006039%	631322	95.34%	20	5.51%
戒	1684		7	39	0.005888%	631361	95.45%	20	5.51%
胖	1688		9	39	0.005888%	631400	95.47%	20	5.51%
棉	1705		12	38	0.005737%	631438	95.57%	20	5.51%
臘	1713		19	38	0.005737%	631476	95.62%	20	5.51%
蕭	1735		16	37	0.005586%	631513	95.74%	20	5.51%
慾	1745		15	36	0.005435%	631549	95.79%	20	5.51%
舟	1753		6	36	0.005435%	631585	95.84%	20	5.51%
誼	1756		15	36	0.005435%	631621	95.85%	20	5.51%
奶	1765		5	35	0.005284%	631656	95.90%	20	5.51%
郊	1797		8	34	0.005133%	631690	96.07%	20	5.51%
涯	1811		11	33	0.004982%	631723	96.14%	20	5.51%
腰	1817		13	33	0.004982%	631756	96.17%	20	5.51%
氛	1852		8	31	0.00468%	631787	96.34%	20	5.51%
託	1890		10	30	0.004529%	631817	96.51%	20	5.51%
姓	1902		8	29	0.004378%	631846	96.56%	20	5.51%
斑	1912		12	29	0.004378%	631875	96.61%	20	5.51%
渺	1921		12	29	0.004378%	631904	96.65%	20	5.51%
綿	1950		14	28	0.004227%	631932	96.77%	20	5.51%
煌	1967		13	27	0.004076%	631959	96.84%	20	5.51%
逆	1979		9	27	0.004076%	631986	96.89%	20	5.51%
濫	2000		17	26	0.003925%	632012	96.97%	20	5.51%
脅	2008		10	26	0.003925%	632038	97.01%	20	5.51%
諒	2013		15	26	0.003925%	632064	97.03%	20	5.51%
躺	2014		15	26	0.003925%	632090	97.03%	20	5.51%
邦	2017		6	26	0.003925%	632116	97.04%	20	5.51%
鍵	2019		17	26	0.003925%	632142	97.05%	20	5.51%
俾	2021		10	25	0.003774%	632167	97.06%	20	5.51%
慨	2028		12	25	0.003774%	632192	97.08%	20	5.51%
捲	2030		11	25	0.003774%	632217	97.09%	20	5.51%
朱	2033		6	25	0.003774%	632242	97.10%	20	5.51%
瓜	2041		5	25	0.003774%	632267	97.13%	20	5.51%
盲	2043		8	25	0.003774%	632292	97.14%	20	5.51%
聰	2048		17	25	0.003774%	632317	97.16%	20	5.51%
卓	2060		8	24	0.003623%	632341	97.20%	20	5.51%
壇	2061		16	24	0.003623%	632365	97.21%	20	5.51%
裕	2077		12	24	0.003623%	632389	97.27%	20	5.51%
勾	2084		4	23	0.003472%	632412	97.29%	20	5.51%
臂	2103		17	23	0.003472%	632435	97.36%	20	5.51%
吻	2116		7	22	0.003321%	632457	97.40%	20	5.51%
邁	2217		16	20	0.00302%	632477	97.72%	20	5.51%
頃	1207		11	78	0.01178%	632555	91.37%	19	5.23%
玲	1421		9	58	0.008757%	632613	93.53%	19	5.23%
註	1481		12	53	0.008002%	632666	94.03%	19	5.23%
艇	1500		13	52	0.007851%	632718	94.18%	19	5.23%
繪	1553		19	48	0.007247%	632766	94.58%	19	5.23%
輛	1573		15	47	0.007096%	632813	94.72%	19	5.23%
剝	1596		10	45	0.006794%	632858	94.88%	19	5.23%
曰	1651		4	42	0.006341%	632900	95.25%	19	5.23%
廟	1701		15	38	0.005737%	632938	95.55%	19	5.23%
湯	1706		12	38	0.005737%	632976	95.58%	19	5.23%
爐	1708		20	38	0.005737%	633014	95.59%	19	5.23%
詢	1737		13	37	0.005586%	633051	95.75%	19	5.23%
宅	1743		6	36	0.005435%	633087	95.78%	19	5.23%
棵	1748		12	36	0.005435%	633123	95.81%	19	5.23%
撤	1786		14	34	0.005133%	633157	96.01%	19	5.23%
弊	1802		14	33	0.004982%	633190	96.09%	19	5.23%
翠	1815		14	33	0.004982%	633223	96.16%	19	5.23%
裁	1819		12	33	0.004982%	633256	96.18%	19	5.23%
爆	1836		19	32	0.004831%	633288	96.26%	19	5.23%
糧	1859		18	31	0.00468%	633319	96.37%	19	5.23%
唇	1869		10	30	0.004529%	633349	96.42%	19	5.23%
掘	1875		11	30	0.004529%	633379	96.44%	19	5.23%
淋	1879		11	30	0.004529%	633409	96.46%	19	5.23%
滯	1880		14	30	0.004529%	633439	96.47%	19	5.23%
搜	1909		12	29	0.004378%	633468	96.60%	19	5.23%
贈	1931		19	29	0.004378%	633497	96.69%	19	5.23%
役	1940		7	28	0.004227%	633525	96.73%	19	5.23%
欄	1945		21	28	0.004227%	633553	96.75%	19	5.23%
袖	1951		10	28	0.004227%	633581	96.78%	19	5.23%
腔	1977		12	27	0.004076%	633608	96.88%	19	5.23%
陋	1982		8	27	0.004076%	633635	96.90%	19	5.23%
嚮	1987		18	26	0.003925%	633661	96.92%	19	5.23%
拔	1991		8	26	0.003925%	633687	96.94%	19	5.23%
屈	2026		8	25	0.003774%	633712	97.08%	19	5.23%
晴	2031		12	25	0.003774%	633737	97.09%	19	5.23%
撫	2063		15	24	0.003623%	633761	97.21%	19	5.23%
攤	2065		22	24	0.003623%	633785	97.22%	19	5.23%
焉	2070		11	24	0.003623%	633809	97.24%	19	5.23%
巷	2089		9	23	0.003472%	633832	97.31%	19	5.23%
斗	2091		4	23	0.003472%	633855	97.31%	19	5.23%
纏	2102		21	23	0.003472%	633878	97.35%	19	5.23%
賦	2108		15	23	0.003472%	633901	97.37%	19	5.23%
跌	2109		12	23	0.003472%	633924	97.38%	19	5.23%
餓	2111		15	23	0.003472%	633947	97.38%	19	5.23%
倉	2115		10	22	0.003321%	633969	97.40%	19	5.23%
抹	2125		8	22	0.003321%	633991	97.43%	19	5.23%
衷	2144		10	22	0.003321%	634013	97.49%	19	5.23%
銳	2149		15	22	0.003321%	634035	97.51%	19	5.23%
庸	2162		11	21	0.003171%	634056	97.55%	19	5.23%
貸	967		12	114	0.01721%	634170	87.99%	18	4.96%
澳	1003		16	108	0.01631%	634278	88.59%	18	4.96%
妹	1234		8	74	0.01117%	634352	91.68%	18	4.96%
曼	1313		11	67	0.01012%	634419	92.52%	18	4.96%
嘉	1577		14	46	0.006945%	634465	94.75%	18	4.96%
蕉	1624		16	44	0.006643%	634509	95.07%	18	4.96%
腸	1640		13	43	0.006492%	634552	95.18%	18	4.96%
峰	1700		10	38	0.005737%	634590	95.54%	18	4.96%
祇	1710		8	38	0.005737%	634628	95.60%	18	4.96%
釘	1718		10	38	0.005737%	634666	95.64%	18	4.96%
盾	1727		9	37	0.005586%	634703	95.70%	18	4.96%
啦	1740		11	36	0.005435%	634739	95.77%	18	4.96%
輯	1760		16	36	0.005435%	634775	95.88%	18	4.96%
濱	1790		17	34	0.005133%	634809	96.03%	18	4.96%
龐	1798		19	34	0.005133%	634843	96.07%	18	4.96%
督	1814		13	33	0.004982%	634876	96.15%	18	4.96%
孝	1844		7	31	0.00468%	634907	96.30%	18	4.96%
瑰	1855		14	31	0.00468%	634938	96.35%	18	4.96%
吵	1868		7	30	0.004529%	634968	96.41%	18	4.96%
填	1870		13	30	0.004529%	634998	96.42%	18	4.96%
槍	1877		14	30	0.004529%	635028	96.45%	18	4.96%
勃	1899		9	29	0.004378%	635057	96.55%	18	4.96%
旺	1914		8	29	0.004378%	635086	96.62%	18	4.96%
騎	1936		18	29	0.004378%	635115	96.71%	18	4.96%
昇	1962		8	27	0.004076%	635142	96.82%	18	4.96%
牲	1970		9	27	0.004076%	635169	96.86%	18	4.96%
疊	1971		22	27	0.004076%	635196	96.86%	18	4.96%
	1976		13	27	0.004076%	635223	96.88%	18	4.96%
卑	1986		8	26	0.003925%	635249	96.92%	18	4.96%
晶	1996		12	26	0.003925%	635275	96.96%	18	4.96%
渴	1998		12	26	0.003925%	635301	96.97%	18	4.96%
窄	2005		10	26	0.003925%	635327	96.99%	18	4.96%
艷	2009		24	26	0.003925%	635353	97.01%	18	4.96%
嫩	2025		14	25	0.003774%	635378	97.07%	18	4.96%
弦	2027		8	25	0.003774%	635403	97.08%	18	4.96%
矣	2045		7	25	0.003774%	635428	97.15%	18	4.96%
芽	2050		8	25	0.003774%	635453	97.17%	18	4.96%
剎	2059		9	24	0.003623%	635477	97.20%	18	4.96%
脹	2075		12	24	0.003623%	635501	97.26%	18	4.96%
茂	2076		9	24	0.003623%	635525	97.26%	18	4.96%
鉅	2080		13	24	0.003623%	635549	97.28%	18	4.96%
萎	2104		12	23	0.003472%	635572	97.36%	18	4.96%
蜂	2106		13	23	0.003472%	635595	97.37%	18	4.96%
撰	2128		15	22	0.003321%	635617	97.44%	18	4.96%
樑	2131		15	22	0.003321%	635639	97.45%	18	4.96%
鋒	2150		15	22	0.003321%	635661	97.51%	18	4.96%
凌	2153		10	21	0.003171%	635682	97.52%	18	4.96%
斥	2165		5	21	0.003171%	635703	97.56%	18	4.96%
晰	2168		12	21	0.003171%	635724	97.57%	18	4.96%
浴	2172		10	21	0.003171%	635745	97.58%	18	4.96%
猛	2175		11	21	0.003171%	635766	97.59%	18	4.96%
酷	2186		14	21	0.003171%	635787	97.63%	18	4.96%
鑑	2187		22	21	0.003171%	635808	97.63%	18	4.96%
誦	2212		14	20	0.00302%	635828	97.71%	18	4.96%
抬	2240		8	19	0.002869%	635847	97.79%	18	4.96%
竭	2252		14	19	0.002869%	635866	97.82%	18	4.96%
驕	2308		22	18	0.002718%	635884	97.98%	18	4.96%
症	776		10	164	0.02476%	636048	84.05%	17	4.68%
岩	977		8	112	0.01691%	636160	88.16%	17	4.68%
貓	1123		16	87	0.01313%	636247	90.33%	17	4.68%
麥	1126		11	87	0.01313%	636334	90.36%	17	4.68%
塘	1384		13	60	0.009059%	636394	93.20%	17	4.68%
	1453		10	55	0.008304%	636449	93.81%	17	4.68%
砂	1479		9	53	0.008002%	636502	94.02%	17	4.68%
梯	1567		11	47	0.007096%	636549	94.68%	17	4.68%
艘	1593		15	46	0.006945%	636595	94.86%	17	4.68%
亭	1594		9	45	0.006794%	636640	94.87%	17	4.68%
蒸	1641		14	43	0.006492%	636683	95.18%	17	4.68%
洽	1652		9	42	0.006341%	636725	95.25%	17	4.68%
灘	1657		22	41	0.00619%	636766	95.29%	17	4.68%
披	1722		8	37	0.005586%	636803	95.67%	17	4.68%
啡	1741		11	36	0.005435%	636839	95.77%	17	4.68%
煮	1750		12	36	0.005435%	636875	95.82%	17	4.68%
衫	1754		8	36	0.005435%	636911	95.84%	17	4.68%
耶	1792		9	34	0.005133%	636945	96.04%	17	4.68%
艾	1818		6	33	0.004982%	636978	96.17%	17	4.68%
咖	1843		8	31	0.00468%	637009	96.30%	17	4.68%
寓	1903		12	29	0.004378%	637038	96.57%	17	4.68%
枚	1917		8	29	0.004378%	637067	96.63%	17	4.68%
遵	1932		15	29	0.004378%	637096	96.70%	17	4.68%
霞	1935		17	29	0.004378%	637125	96.71%	17	4.68%
瓣	1947		19	28	0.004227%	637153	96.76%	17	4.68%
惠	1958		12	27	0.004076%	637180	96.81%	17	4.68%
樸	1964		16	27	0.004076%	637207	96.83%	17	4.68%
薩	1978		18	27	0.004076%	637234	96.89%	17	4.68%
鎖	1981		18	27	0.004076%	637261	96.90%	17	4.68%
晒	1995		10	26	0.003925%	637287	96.96%	17	4.68%
犧	2003		21	26	0.003925%	637313	96.99%	17	4.68%
籃	2006		20	26	0.003925%	637339	97.00%	17	4.68%
漆	2040		14	25	0.003774%	637364	97.13%	17	4.68%
褲	2051		15	25	0.003774%	637389	97.17%	17	4.68%
宴	2062		10	24	0.003623%	637413	97.21%	17	4.68%
涵	2068		11	24	0.003623%	637437	97.23%	17	4.68%
溢	2069		13	24	0.003623%	637461	97.24%	17	4.68%
耗	2074		10	24	0.003623%	637485	97.25%	17	4.68%
賺	2079		17	24	0.003623%	637509	97.27%	17	4.68%
漲	2093		14	23	0.003472%	637532	97.32%	17	4.68%
畔	2096		10	23	0.003472%	637555	97.33%	17	4.68%
嬌	2120		15	22	0.003321%	637577	97.41%	17	4.68%
恕	2124		10	22	0.003321%	637599	97.43%	17	4.68%
搶	2126		13	22	0.003321%	637621	97.43%	17	4.68%
暇	2129		13	22	0.003321%	637643	97.44%	17	4.68%
窩	2140		14	22	0.003321%	637665	97.48%	17	4.68%
豎	2145		15	22	0.003321%	637687	97.50%	17	4.68%
卷	2157		8	21	0.003171%	637708	97.54%	17	4.68%
翁	2180		10	21	0.003171%	637729	97.61%	17	4.68%
芒	2182		7	21	0.003171%	637750	97.61%	17	4.68%
嚼	2194		20	20	0.00302%	637770	97.65%	17	4.68%
芬	2211		8	20	0.00302%	637790	97.70%	17	4.68%
趁	2215		12	20	0.00302%	637810	97.72%	17	4.68%
倚	2224		10	19	0.002869%	637829	97.74%	17	4.68%
攏	2280		19	18	0.002718%	637847	97.90%	17	4.68%
欺	2284		12	18	0.002718%	637865	97.91%	17	4.68%
蛇	731		11	178	0.02687%	638043	82.90%	16	4.41%
釣	1179		11	81	0.01223%	638124	91.04%	16	4.41%
災	1220		7	76	0.01147%	638200	91.52%	16	4.41%
繩	1480		19	53	0.008002%	638253	94.02%	16	4.41%
匹	1697		4	38	0.005737%	638291	95.52%	16	4.41%
筋	1711		12	38	0.005737%	638329	95.60%	16	4.41%
軌	1759		9	36	0.005435%	638365	95.87%	16	4.41%
謬	1776		18	35	0.005284%	638400	95.96%	16	4.41%
肝	1793		7	34	0.005133%	638434	96.05%	16	4.41%
紡	1860		10	31	0.00468%	638465	96.38%	16	4.41%
恥	1872		10	30	0.004529%	638495	96.43%	16	4.41%
簾	1884		19	30	0.004529%	638525	96.48%	16	4.41%
裙	1888		12	30	0.004529%	638555	96.50%	16	4.41%
羨	1925		13	29	0.004378%	638584	96.67%	16	4.41%
萊	1927		12	29	0.004378%	638613	96.67%	16	4.41%
屏	1939		9	28	0.004227%	638641	96.73%	16	4.41%
梢	1943		11	28	0.004227%	638669	96.74%	16	4.41%
桶	1944		11	28	0.004227%	638697	96.75%	16	4.41%
扭	1959		7	27	0.004076%	638724	96.81%	16	4.41%
旨	1960		6	27	0.004076%	638751	96.81%	16	4.41%
祈	1973		8	27	0.004076%	638778	96.87%	16	4.41%
頸	1983		16	27	0.004076%	638805	96.91%	16	4.41%
扶	1990		7	26	0.003925%	638831	96.94%	16	4.41%
焦	2002		12	26	0.003925%	638857	96.98%	16	4.41%
蓬	2010		15	26	0.003925%	638883	97.01%	16	4.41%
鈴	2018		13	26	0.003925%	638909	97.05%	16	4.41%
轟	2053		21	25	0.003774%	638934	97.18%	16	4.41%
函	2058		8	24	0.003623%	638958	97.20%	16	4.41%
擎	2064		17	24	0.003623%	638982	97.22%	16	4.41%
仇	2081		4	23	0.003472%	639005	97.28%	16	4.41%
匠	2085		6	23	0.003472%	639028	97.29%	16	4.41%
姻	2088		9	23	0.003472%	639051	97.30%	16	4.41%
洛	2092		9	23	0.003472%	639074	97.32%	16	4.41%
煤	2094		13	23	0.003472%	639097	97.32%	16	4.41%
吟	2117		7	22	0.003321%	639119	97.40%	16	4.41%
奠	2119		12	22	0.003321%	639141	97.41%	16	4.41%
磅	2137		15	22	0.003321%	639163	97.47%	16	4.41%
穫	2139		19	22	0.003321%	639185	97.48%	16	4.41%
吊	2159		6	21	0.003171%	639206	97.54%	16	4.41%
崗	2161		11	21	0.003171%	639227	97.55%	16	4.41%
朽	2169		6	21	0.003171%	639248	97.57%	16	4.41%
孕	2197		5	20	0.00302%	639268	97.66%	16	4.41%
寡	2199		14	20	0.00302%	639288	97.67%	16	4.41%
湊	2205		12	20	0.00302%	639308	97.69%	16	4.41%
仿	2222		6	19	0.002869%	639327	97.74%	16	4.41%
償	2226		17	19	0.002869%	639346	97.75%	16	4.41%
咀	2228		8	19	0.002869%	639365	97.75%	16	4.41%
忌	2236		7	19	0.002869%	639384	97.78%	16	4.41%
曳	2243		6	19	0.002869%	639403	97.80%	16	4.41%
酬	2258		13	19	0.002869%	639422	97.84%	16	4.41%
頑	2259		13	19	0.002869%	639441	97.84%	16	4.41%
鑒	2305		22	18	0.002718%	639459	97.97%	16	4.41%
閑	2306		12	18	0.002718%	639477	97.97%	16	4.41%
昧	2329		9	17	0.002567%	639494	98.03%	16	4.41%
淪	2332		11	17	0.002567%	639511	98.04%	16	4.41%
灑	2333		22	17	0.002567%	639528	98.04%	16	4.41%
爽	2336		11	17	0.002567%	639545	98.05%	16	4.41%
穎	2343		16	17	0.002567%	639562	98.07%	16	4.41%
洩	2392		9	16	0.002416%	639578	98.19%	16	4.41%
牠	610		7	224	0.03382%	639802	79.31%	15	4.13%
爸	843		8	142	0.02144%	639944	85.60%	15	4.13%
胃	1222		9	76	0.01147%	640020	91.54%	15	4.13%
您	1255		11	72	0.01087%	640092	91.91%	15	4.13%
蓮	1286		15	70	0.01057%	640162	92.24%	15	4.13%
耕	1554		10	48	0.007247%	640210	94.59%	15	4.13%
捐	1565		10	47	0.007096%	640257	94.67%	15	4.13%
署	1674		13	40	0.006039%	640297	95.39%	15	4.13%
罰	1712		14	38	0.005737%	640335	95.61%	15	4.13%
灌	1835		21	32	0.004831%	640367	96.26%	15	4.13%
蛋	1887		11	30	0.004529%	640397	96.50%	15	4.13%
剖	1898		10	29	0.004378%	640426	96.55%	15	4.13%
帽	1904		12	29	0.004378%	640455	96.57%	15	4.13%
栽	1963		10	27	0.004076%	640482	96.83%	15	4.13%
玫	2004		8	26	0.003925%	640508	96.99%	15	4.13%
夷	2024		6	25	0.003774%	640533	97.07%	15	4.13%
枕	2034		8	25	0.003774%	640558	97.11%	15	4.13%
矛	2072		5	24	0.003623%	640582	97.25%	15	4.13%
盟	2097		13	23	0.003472%	640605	97.33%	15	4.13%
禍	2098		13	23	0.003472%	640628	97.34%	15	4.13%
驟	2112		24	23	0.003472%	640651	97.39%	15	4.13%
伍	2113		6	22	0.003321%	640673	97.39%	15	4.13%
伐	2114		6	22	0.003321%	640695	97.39%	15	4.13%
巡	2122		7	22	0.003321%	640717	97.42%	15	4.13%
溜	2133		13	22	0.003321%	640739	97.46%	15	4.13%
肺	2141		8	22	0.003321%	640761	97.48%	15	4.13%
鍊	2151		17	22	0.003321%	640783	97.52%	15	4.13%
凋	2154		10	21	0.003171%	640804	97.53%	15	4.13%
割	2155		12	21	0.003171%	640825	97.53%	15	4.13%
晤	2167		11	21	0.003171%	640846	97.57%	15	4.13%
溺	2173		13	21	0.003171%	640867	97.59%	15	4.13%
瞧	2177		17	21	0.003171%	640888	97.60%	15	4.13%
簽	2178		19	21	0.003171%	640909	97.60%	15	4.13%
鹽	2193		24	21	0.003171%	640930	97.65%	15	4.13%
宏	2198		7	20	0.00302%	640950	97.66%	15	4.13%
挽	2201		10	20	0.00302%	640970	97.67%	15	4.13%
眷	2208		11	20	0.00302%	640990	97.70%	15	4.13%
唸	2229		11	19	0.002869%	641009	97.76%	15	4.13%
悵	2237		11	19	0.002869%	641028	97.78%	15	4.13%
扮	2239		7	19	0.002869%	641047	97.79%	15	4.13%
殷	2247		10	19	0.002869%	641066	97.81%	15	4.13%
淵	2248		11	19	0.002869%	641085	97.81%	15	4.13%
厲	2266		15	18	0.002718%	641103	97.86%	15	4.13%
奴	2272		5	18	0.002718%	641121	97.88%	15	4.13%
恩	2277		10	18	0.002718%	641139	97.89%	15	4.13%
膀	2292		14	18	0.002718%	641157	97.93%	15	4.13%
跨	2299		13	18	0.002718%	641175	97.95%	15	4.13%
叛	2315		9	17	0.002567%	641192	97.99%	15	4.13%
咒	2318		8	17	0.002567%	641209	98.00%	15	4.13%
猜	2337		11	17	0.002567%	641226	98.05%	15	4.13%
矮	2339		13	17	0.002567%	641243	98.06%	15	4.13%
稽	2342		15	17	0.002567%	641260	98.06%	15	4.13%
釀	2356		24	17	0.002567%	641277	98.10%	15	4.13%
騙	2359		19	17	0.002567%	641294	98.11%	15	4.13%
囊	2366		22	16	0.002416%	641310	98.12%	15	4.13%
瘋	2398		14	16	0.002416%	641326	98.20%	15	4.13%
碩	2400		14	16	0.002416%	641342	98.21%	15	4.13%
卵	1053		7	97	0.01464%	641439	89.36%	14	3.86%
傢	1213		12	76	0.01147%	641515	91.44%	14	3.86%
濛	1316		17	67	0.01012%	641582	92.55%	14	3.86%
胎	1336		9	65	0.009813%	641647	92.75%	14	3.86%
斤	1389		4	60	0.009059%	641707	93.25%	14	3.86%
踐	1557		15	48	0.007247%	641755	94.61%	14	3.86%
羽	1611		6	45	0.006794%	641800	94.99%	14	3.86%
柯	1770		9	35	0.005284%	641835	95.93%	14	3.86%
蝦	1840		15	32	0.004831%	641867	96.28%	14	3.86%
盒	1882		11	30	0.004529%	641897	96.48%	14	3.86%
傻	1897		13	29	0.004378%	641926	96.54%	14	3.86%
敦	1941		12	28	0.004227%	641954	96.73%	14	3.86%
撈	1994		15	26	0.003925%	641980	96.95%	14	3.86%
洪	1997		9	26	0.003925%	642006	96.96%	14	3.86%
蝕	2012		14	26	0.003925%	642032	97.02%	14	3.86%
畜	2042		10	25	0.003774%	642057	97.14%	14	3.86%
乳	2055		8	24	0.003623%	642081	97.19%	14	3.86%
昌	2066		8	24	0.003623%	642105	97.23%	14	3.86%
秦	2100		10	23	0.003472%	642128	97.35%	14	3.86%
撐	2127		15	22	0.003321%	642150	97.44%	14	3.86%
磚	2138		16	22	0.003321%	642172	97.47%	14	3.86%
販	2146		11	22	0.003321%	642194	97.50%	14	3.86%
娛	2160		10	21	0.003171%	642215	97.55%	14	3.86%
抖	2164		7	21	0.003171%	642236	97.56%	14	3.86%
畏	2176		9	21	0.003171%	642257	97.60%	14	3.86%
鑿	2188		28	21	0.003171%	642278	97.63%	14	3.86%
霍	2189		16	21	0.003171%	642299	97.64%	14	3.86%
柄	2204		9	20	0.00302%	642319	97.68%	14	3.86%
綱	2209		14	20	0.00302%	642339	97.70%	14	3.86%
賀	2213		12	20	0.00302%	642359	97.71%	14	3.86%
鍾	2218		17	20	0.00302%	642379	97.73%	14	3.86%
顛	2220		19	20	0.00302%	642399	97.73%	14	3.86%
叉	2227		3	19	0.002869%	642418	97.75%	14	3.86%
徊	2235		9	19	0.002869%	642437	97.77%	14	3.86%
掀	2242		11	19	0.002869%	642456	97.79%	14	3.86%
盜	2250		12	19	0.002869%	642475	97.82%	14	3.86%
糕	2253		16	19	0.002869%	642494	97.83%	14	3.86%
拙	2278		8	18	0.002718%	642512	97.89%	14	3.86%
晝	2281		11	18	0.002718%	642530	97.90%	14	3.86%
笨	2288		11	18	0.002718%	642548	97.92%	14	3.86%
膨	2293		16	18	0.002718%	642566	97.94%	14	3.86%
蹟	2301		18	18	0.002718%	642584	97.96%	14	3.86%
錦	2304		16	18	0.002718%	642602	97.97%	14	3.86%
鴨	2311		16	18	0.002718%	642620	97.98%	14	3.86%
屢	2323		14	17	0.002567%	642637	98.02%	14	3.86%
怯	2324		8	17	0.002567%	642654	98.02%	14	3.86%
拼	2325		9	17	0.002567%	642671	98.02%	14	3.86%
摧	2326		14	17	0.002567%	642688	98.02%	14	3.86%
矯	2340		17	17	0.002567%	642705	98.06%	14	3.86%
蔚	2350		15	17	0.002567%	642722	98.08%	14	3.86%
寵	2369		19	16	0.002416%	642738	98.13%	14	3.86%
愧	2377		13	16	0.002416%	642754	98.15%	14	3.86%
陌	2411		8	16	0.002416%	642770	98.23%	14	3.86%
雀	2446		11	15	0.002265%	642785	98.31%	14	3.86%
履	2457		15	14	0.002114%	642799	98.34%	14	3.86%
瞬	2483		17	14	0.002114%	642813	98.39%	14	3.86%
黯	2515		21	14	0.002114%	642827	98.46%	14	3.86%
蔬	1338		15	65	0.009813%	642892	92.77%	13	3.58%
汁	1434		5	57	0.008606%	642949	93.65%	13	3.58%
稻	1589		15	46	0.006945%	642995	94.84%	13	3.58%
埃	1599		10	45	0.006794%	643040	94.90%	13	3.58%
裸	1612		13	45	0.006794%	643085	94.99%	13	3.58%
棲	1788		12	34	0.005133%	643119	96.02%	13	3.58%
彙	1845		13	31	0.00468%	643150	96.30%	13	3.58%
桂	1850		10	31	0.00468%	643181	96.33%	13	3.58%
爺	1853		13	31	0.00468%	643212	96.34%	13	3.58%
箭	1883		15	30	0.004529%	643242	96.48%	13	3.58%
喧	1900		12	29	0.004378%	643271	96.56%	13	3.58%
沈	1919		7	29	0.004378%	643300	96.64%	13	3.58%
津	1965		9	27	0.004076%	643327	96.83%	13	3.58%
漿	1966		15	27	0.004076%	643354	96.84%	13	3.58%
燭	1968		17	27	0.004076%	643381	96.85%	13	3.58%
禱	1974		18	27	0.004076%	643408	96.87%	13	3.58%
憲	1988		16	26	0.003925%	643434	96.93%	13	3.58%
烘	2001		10	26	0.003925%	643460	96.98%	13	3.58%
纔	2007		23	26	0.003925%	643486	97.00%	13	3.58%
遞	2016		13	26	0.003925%	643512	97.04%	13	3.58%
殿	2036		13	25	0.003774%	643537	97.11%	13	3.58%
侯	2056		9	24	0.003623%	643561	97.19%	13	3.58%
	2073		13	24	0.003623%	643585	97.25%	13	3.58%
唉	2086		10	23	0.003472%	643608	97.30%	13	3.58%
珊	2095		9	23	0.003472%	643631	97.33%	13	3.58%
鍋	2110		17	23	0.003472%	643654	97.38%	13	3.58%
碌	2136		13	22	0.003321%	643676	97.47%	13	3.58%
蹤	2147		18	22	0.003321%	643698	97.50%	13	3.58%
伙	2152		6	21	0.003171%	643719	97.52%	13	3.58%
藤	2185		19	21	0.003171%	643740	97.62%	13	3.58%
赫	2214		14	20	0.00302%	643760	97.71%	13	3.58%
堡	2230		12	19	0.002869%	643779	97.76%	13	3.58%
挨	2241		10	19	0.002869%	643798	97.79%	13	3.58%
董	2257		13	19	0.002869%	643817	97.84%	13	3.58%
催	2262		13	18	0.002718%	643835	97.85%	13	3.58%
征	2276		8	18	0.002718%	643853	97.89%	13	3.58%
渾	2286		12	18	0.002718%	643871	97.92%	13	3.58%
縛	2290		16	18	0.002718%	643889	97.93%	13	3.58%
覓	2298		11	18	0.002718%	643907	97.95%	13	3.58%
饒	2307		20	18	0.002718%	643925	97.97%	13	3.58%
乍	2312		5	17	0.002567%	643942	97.99%	13	3.58%
后	2317		6	17	0.002567%	643959	98.00%	13	3.58%
妄	2322		6	17	0.002567%	643976	98.01%	13	3.58%
桑	2330		10	17	0.002567%	643993	98.03%	13	3.58%
繳	2348		19	17	0.002567%	644010	98.08%	13	3.58%
舌	2349		6	17	0.002567%	644027	98.08%	13	3.58%
隙	2358		13	17	0.002567%	644044	98.11%	13	3.58%
亟	2361		8	16	0.002416%	644060	98.11%	13	3.58%
徘	2374		11	16	0.002416%	644076	98.14%	13	3.58%
憾	2378		16	16	0.002416%	644092	98.15%	13	3.58%
揭	2381		12	16	0.002416%	644108	98.16%	13	3.58%
搞	2382		13	16	0.002416%	644124	98.16%	13	3.58%
攀	2384		19	16	0.002416%	644140	98.17%	13	3.58%
旬	2385		6	16	0.002416%	644156	98.17%	13	3.58%
濁	2394		16	16	0.002416%	644172	98.19%	13	3.58%
蒂	2404		13	16	0.002416%	644188	98.22%	13	3.58%
謙	2408		17	16	0.002416%	644204	98.23%	13	3.58%
采	2410		8	16	0.002416%	644220	98.23%	13	3.58%
恬	2423		9	15	0.002265%	644235	98.26%	13	3.58%
懇	2424		17	15	0.002265%	644250	98.26%	13	3.58%
爍	2431		19	15	0.002265%	644265	98.28%	13	3.58%
聘	2439		13	15	0.002265%	644280	98.30%	13	3.58%
聳	2440		17	15	0.002265%	644295	98.30%	13	3.58%
頌	2448		13	15	0.002265%	644310	98.32%	13	3.58%
拆	2466		8	14	0.002114%	644324	98.36%	13	3.58%
窺	2487		16	14	0.002114%	644338	98.40%	13	3.58%
豫	2500		16	14	0.002114%	644352	98.43%	13	3.58%
顫	2509		22	14	0.002114%	644366	98.45%	13	3.58%
魔	2511		21	14	0.002114%	644380	98.45%	13	3.58%
劫	2523		7	13	0.001963%	644393	98.48%	13	3.58%
彌	2530		17	13	0.001963%	644406	98.49%	13	3.58%
撞	2534		15	13	0.001963%	644419	98.50%	13	3.58%
滌	2545		14	13	0.001963%	644432	98.52%	13	3.58%
羡	2556		12	13	0.001963%	644445	98.54%	13	3.58%
瑪	1238		14	74	0.01117%	644519	91.72%	12	3.31%
韓	1263		17	72	0.01087%	644591	92.00%	12	3.31%
蟬	1412		18	59	0.008908%	644650	93.45%	12	3.31%
汪	1495		7	52	0.007851%	644702	94.14%	12	3.31%
桐	1512		10	51	0.0077%	644753	94.28%	12	3.31%
姊	1535		8	49	0.007398%	644802	94.45%	12	3.31%
氧	1539		10	49	0.007398%	644851	94.48%	12	3.31%
菊	1544		12	49	0.007398%	644900	94.52%	12	3.31%
褐	1625		14	44	0.006643%	644944	95.08%	12	3.31%
嶺	1647		17	42	0.006341%	644986	95.22%	12	3.31%
膜	1795		15	34	0.005133%	645020	96.06%	12	3.31%
閣	1934		14	29	0.004378%	645049	96.71%	12	3.31%
梁	1942		11	28	0.004227%	645077	96.74%	12	3.31%
牧	1969		8	27	0.004076%	645104	96.85%	12	3.31%
盞	1972		13	27	0.004076%	645131	96.86%	12	3.31%
淒	2039		11	25	0.003774%	645156	97.13%	12	3.31%
筒	2046		12	25	0.003774%	645181	97.15%	12	3.31%
僱	2083		14	23	0.003472%	645204	97.29%	12	3.31%
租	2099		10	23	0.003472%	645227	97.34%	12	3.31%
邏	2148		22	22	0.003321%	645249	97.51%	12	3.31%
煉	2174		13	21	0.003171%	645270	97.59%	12	3.31%
昭	2202		9	20	0.00302%	645290	97.68%	12	3.31%
遼	2216		15	20	0.00302%	645310	97.72%	12	3.31%
乙	2221		1	19	0.002869%	645329	97.73%	12	3.31%
佐	2223		7	19	0.002869%	645348	97.74%	12	3.31%
曹	2244		11	19	0.002869%	645367	97.80%	12	3.31%
樁	2246		15	19	0.002869%	645386	97.81%	12	3.31%
葛	2256		13	19	0.002869%	645405	97.83%	12	3.31%
嗚	2269		13	18	0.002718%	645423	97.87%	12	3.31%
紮	2289		11	18	0.002718%	645441	97.92%	12	3.31%
萄	2295		12	18	0.002718%	645459	97.94%	12	3.31%
跪	2300		13	18	0.002718%	645477	97.95%	12	3.31%
鄭	2303		14	18	0.002718%	645495	97.96%	12	3.31%
乖	2313		8	17	0.002567%	645512	97.99%	12	3.31%
啼	2319		12	17	0.002567%	645529	98.01%	12	3.31%
敷	2327		15	17	0.002567%	645546	98.03%	12	3.31%
煞	2334		13	17	0.002567%	645563	98.04%	12	3.31%
邪	2355		6	17	0.002567%	645580	98.10%	12	3.31%
闢	2357		21	17	0.002567%	645597	98.10%	12	3.31%
倆	2362		10	16	0.002416%	645613	98.12%	12	3.31%
惶	2376		12	16	0.002416%	645629	98.15%	12	3.31%
歇	2391		13	16	0.002416%	645645	98.19%	12	3.31%
淹	2393		11	16	0.002416%	645661	98.19%	12	3.31%
炭	2396		9	16	0.002416%	645677	98.20%	12	3.31%
忱	2422		7	15	0.002265%	645692	98.26%	12	3.31%
澄	2430		15	15	0.002265%	645707	98.28%	12	3.31%
甫	2432		7	15	0.002265%	645722	98.28%	12	3.31%
疼	2433		10	15	0.002265%	645737	98.28%	12	3.31%
膝	2442		15	15	0.002265%	645752	98.30%	12	3.31%
囂	2452		21	14	0.002114%	645766	98.33%	12	3.31%
屑	2456		10	14	0.002114%	645780	98.34%	12	3.31%
瑣	2480		14	14	0.002114%	645794	98.39%	12	3.31%
瓏	2481		20	14	0.002114%	645808	98.39%	12	3.31%
禽	2486		13	14	0.002114%	645822	98.40%	12	3.31%
籬	2490		25	14	0.002114%	645836	98.41%	12	3.31%
脾	2493		12	14	0.002114%	645850	98.41%	12	3.31%
蘊	2497		20	14	0.002114%	645864	98.42%	12	3.31%
辣	2503		14	14	0.002114%	645878	98.43%	12	3.31%
酣	2504		12	14	0.002114%	645892	98.44%	12	3.31%
錫	2506		16	14	0.002114%	645906	98.44%	12	3.31%
仲	2517		6	13	0.001963%	645919	98.46%	12	3.31%
捷	2533		11	13	0.001963%	645932	98.50%	12	3.31%
攜	2536		21	13	0.001963%	645945	98.50%	12	3.31%
苟	2558		9	13	0.001963%	645958	98.54%	12	3.31%
勿	2574		4	12	0.001812%	645970	98.58%	12	3.31%
徹	2591		14	12	0.001812%	645982	98.61%	12	3.31%
秩	2600		10	12	0.001812%	645994	98.62%	12	3.31%
諱	2616		16	12	0.001812%	646006	98.65%	12	3.31%
苗	620		9	219	0.03306%	646225	79.65%	11	3.03%
叔	1382		8	60	0.009059%	646285	93.18%	11	3.03%
診	1502		12	52	0.007851%	646337	94.20%	11	3.03%
寺	1562		6	47	0.007096%	646384	94.65%	11	3.03%
賊	1642		13	43	0.006492%	646427	95.19%	11	3.03%
鱗	1663		23	41	0.00619%	646468	95.32%	11	3.03%
旱	1913		7	29	0.004378%	646497	96.61%	11	3.03%
豬	1930		11	29	0.004378%	646526	96.69%	11	3.03%
堤	1938		12	28	0.004227%	646554	96.72%	11	3.03%
泳	2067		8	24	0.003623%	646578	97.23%	11	3.03%
燕	2134		16	22	0.003321%	646600	97.46%	11	3.03%
勻	2156		4	21	0.003171%	646621	97.53%	11	3.03%
騷	2191		20	21	0.003171%	646642	97.64%	11	3.03%
艙	2210		16	20	0.00302%	646662	97.70%	11	3.03%
儒	2225		16	19	0.002869%	646681	97.75%	11	3.03%
婉	2232		11	19	0.002869%	646700	97.77%	11	3.03%
卜	2265		2	18	0.002718%	646718	97.86%	11	3.03%
臣	2294		6	18	0.002718%	646736	97.94%	11	3.03%
蔣	2296		15	18	0.002718%	646754	97.94%	11	3.03%
辰	2302		7	18	0.002718%	646772	97.96%	11	3.03%
毋	2331		4	17	0.002567%	646789	98.04%	11	3.03%
薪	2351		17	17	0.002567%	646806	98.09%	11	3.03%
峽	2371		10	16	0.002416%	646822	98.14%	11	3.03%
嵌	2372		12	16	0.002416%	646838	98.14%	11	3.03%
恍	2375		9	16	0.002416%	646854	98.15%	11	3.03%
昆	2386		8	16	0.002416%	646870	98.17%	11	3.03%
葡	2405		13	16	0.002416%	646886	98.22%	11	3.03%
諧	2407		16	16	0.002416%	646902	98.22%	11	3.03%
喘	2418		12	15	0.002265%	646917	98.25%	11	3.03%
祭	2434		11	15	0.002265%	646932	98.29%	11	3.03%
禿	2436		7	15	0.002265%	646947	98.29%	11	3.03%
腕	2441		12	15	0.002265%	646962	98.30%	11	3.03%
軀	2444		18	15	0.002265%	646977	98.31%	11	3.03%
鑲	2445		25	15	0.002265%	646992	98.31%	11	3.03%
俟	2450		9	14	0.002114%	647006	98.32%	11	3.03%
戚	2463		11	14	0.002114%	647020	98.35%	11	3.03%
扁	2464		9	14	0.002114%	647034	98.35%	11	3.03%
揉	2468		12	14	0.002114%	647048	98.36%	11	3.03%
毅	2476		15	14	0.002114%	647062	98.38%	11	3.03%
沾	2477		8	14	0.002114%	647076	98.38%	11	3.03%
澀	2478		17	14	0.002114%	647090	98.38%	11	3.03%
馨	2510		20	14	0.002114%	647104	98.45%	11	3.03%
侶	2518		9	13	0.001963%	647117	98.47%	11	3.03%
允	2521		4	13	0.001963%	647130	98.47%	11	3.03%
橡	2542		16	13	0.001963%	647143	98.51%	11	3.03%
灶	2546		7	13	0.001963%	647156	98.52%	11	3.03%
蘋	2561		20	13	0.001963%	647169	98.55%	11	3.03%
踩	2566		15	13	0.001963%	647182	98.56%	11	3.03%
迪	2568		8	13	0.001963%	647195	98.56%	11	3.03%
俊	2572		9	12	0.001812%	647207	98.57%	11	3.03%
嘯	2579		15	12	0.001812%	647219	98.58%	11	3.03%
瀾	2596		20	12	0.001812%	647231	98.61%	11	3.03%
綢	2604		14	12	0.001812%	647243	98.63%	11	3.03%
芭	2609		8	12	0.001812%	647255	98.64%	11	3.03%
頻	2626		16	12	0.001812%	647267	98.67%	11	3.03%
啞	2638		11	11	0.001661%	647278	98.69%	11	3.03%
寢	2647		14	11	0.001661%	647289	98.70%	11	3.03%
惹	2651		13	11	0.001661%	647300	98.71%	11	3.03%
扯	2653		7	11	0.001661%	647311	98.71%	11	3.03%
朦	2657		18	11	0.001661%	647322	98.72%	11	3.03%
翌	2676		11	11	0.001661%	647333	98.75%	11	3.03%
脂	2678		10	11	0.001661%	647344	98.76%	11	3.03%
酌	2689		10	11	0.001661%	647355	98.77%	11	3.03%
軸	1414		12	59	0.008908%	647414	93.47%	10	2.76%
肌	1517		6	51	0.0077%	647465	94.31%	10	2.76%
礦	1730		20	37	0.005586%	647502	95.71%	10	2.76%
芝	1862		8	31	0.00468%	647533	96.38%	10	2.76%
	1867		6	30	0.004529%	647563	96.41%	10	2.76%
詹	1891		13	30	0.004529%	647593	96.52%	10	2.76%
鼠	1895		13	30	0.004529%	647623	96.53%	10	2.76%
巿	1957		4	27	0.004076%	647650	96.80%	10	2.76%
蘆	2011		20	26	0.003925%	647676	97.02%	10	2.76%
凱	2022		12	25	0.003774%	647701	97.06%	10	2.76%
恆	2090		9	23	0.003472%	647724	97.31%	10	2.76%
幢	2123		15	22	0.003321%	647746	97.42%	10	2.76%
螺	2143		17	22	0.003321%	647768	97.49%	10	2.76%
梳	2171		10	21	0.003171%	647789	97.58%	10	2.76%
薰	2184		18	21	0.003171%	647810	97.62%	10	2.76%
犬	2207		4	20	0.00302%	647830	97.69%	10	2.76%
嶼	2233		17	19	0.002869%	647849	97.77%	10	2.76%
帆	2234		6	19	0.002869%	647868	97.77%	10	2.76%
梨	2245		11	19	0.002869%	647887	97.80%	10	2.76%
莎	2254		11	19	0.002869%	647906	97.83%	10	2.76%
鶴	2260		21	19	0.002869%	647925	97.85%	10	2.76%
刑	2263		6	18	0.002718%	647943	97.85%	10	2.76%
劍	2264		15	18	0.002718%	647961	97.86%	10	2.76%
叭	2267		5	18	0.002718%	647979	97.87%	10	2.76%
喇	2268		12	18	0.002718%	647997	97.87%	10	2.76%
墊	2271		14	18	0.002718%	648015	97.88%	10	2.76%
嬰	2274		17	18	0.002718%	648033	97.88%	10	2.76%
廈	2275		13	18	0.002718%	648051	97.89%	10	2.76%
沸	2285		8	18	0.002718%	648069	97.91%	10	2.76%
斃	2328		17	17	0.002567%	648086	98.03%	10	2.76%
熊	2335		14	17	0.002567%	648103	98.05%	10	2.76%
簿	2344		19	17	0.002567%	648120	98.07%	10	2.76%
簷	2345		19	17	0.002567%	648137	98.07%	10	2.76%
蘿	2352		23	17	0.002567%	648154	98.09%	10	2.76%
僧	2363		14	16	0.002416%	648170	98.12%	10	2.76%
吼	2365		7	16	0.002416%	648186	98.12%	10	2.76%
壺	2367		12	16	0.002416%	648202	98.13%	10	2.76%
扔	2379		5	16	0.002416%	648218	98.16%	10	2.76%
頰	2413		16	16	0.002416%	648234	98.24%	10	2.76%
几	2417		2	15	0.002265%	648249	98.25%	10	2.76%
坑	2420		7	15	0.002265%	648264	98.25%	10	2.76%
竿	2437		9	15	0.002265%	648279	98.29%	10	2.76%
袍	2443		10	15	0.002265%	648294	98.31%	10	2.76%
坪	2453		8	14	0.002114%	648308	98.33%	10	2.76%
彰	2461		14	14	0.002114%	648322	98.35%	10	2.76%
挪	2467		10	14	0.002114%	648336	98.36%	10	2.76%
擲	2470		18	14	0.002114%	648350	98.36%	10	2.76%
茄	2494		9	14	0.002114%	648364	98.42%	10	2.76%
蠟	2499		21	14	0.002114%	648378	98.43%	10	2.76%
辜	2502		12	14	0.002114%	648392	98.43%	10	2.76%
鋸	2505		16	14	0.002114%	648406	98.44%	10	2.76%
麵	2514		20	14	0.002114%	648420	98.46%	10	2.76%
僵	2519		15	13	0.001963%	648433	98.47%	10	2.76%
奢	2527		11	13	0.001963%	648446	98.48%	10	2.76%
崩	2529		11	13	0.001963%	648459	98.49%	10	2.76%
癡	2550		19	13	0.001963%	648472	98.53%	10	2.76%
穆	2551		16	13	0.001963%	648485	98.53%	10	2.76%
縐	2555		16	13	0.001963%	648498	98.54%	10	2.76%
茅	2557		9	13	0.001963%	648511	98.54%	10	2.76%
謎	2563		17	13	0.001963%	648524	98.55%	10	2.76%
譜	2564		19	13	0.001963%	648537	98.56%	10	2.76%
賤	2565		15	13	0.001963%	648550	98.56%	10	2.76%
辱	2567		10	13	0.001963%	648563	98.56%	10	2.76%
墜	2580		15	12	0.001812%	648575	98.59%	10	2.76%
媚	2584		12	12	0.001812%	648587	98.59%	10	2.76%
廓	2590		14	12	0.001812%	648599	98.60%	10	2.76%
怖	2592		8	12	0.001812%	648611	98.61%	10	2.76%
浩	2594		10	12	0.001812%	648623	98.61%	10	2.76%
淘	2595		11	12	0.001812%	648635	98.61%	10	2.76%
糙	2603		17	12	0.001812%	648647	98.63%	10	2.76%
膩	2608		16	12	0.001812%	648659	98.64%	10	2.76%
苛	2611		9	12	0.001812%	648671	98.64%	10	2.76%
虐	2613		9	12	0.001812%	648683	98.65%	10	2.76%
諷	2617		16	12	0.001812%	648695	98.65%	10	2.76%
贏	2620		20	12	0.001812%	648707	98.66%	10	2.76%
逾	2622		12	12	0.001812%	648719	98.66%	10	2.76%
鉛	2624		13	12	0.001812%	648731	98.67%	10	2.76%
兜	2631		11	11	0.001661%	648742	98.68%	10	2.76%
卒	2635		8	11	0.001661%	648753	98.68%	10	2.76%
喉	2640		12	11	0.001661%	648764	98.69%	10	2.76%
嗜	2642		13	11	0.001661%	648775	98.70%	10	2.76%
恭	2650		10	11	0.001661%	648786	98.71%	10	2.76%
慌	2652		13	11	0.001661%	648797	98.71%	10	2.76%
拂	2654		8	11	0.001661%	648808	98.72%	10	2.76%
歉	2661		14	11	0.001661%	648819	98.73%	10	2.76%
籲	2674		32	11	0.001661%	648830	98.75%	10	2.76%
絨	2675		12	11	0.001661%	648841	98.75%	10	2.76%
虹	2682		9	11	0.001661%	648852	98.76%	10	2.76%
霄	2692		15	11	0.001661%	648863	98.78%	10	2.76%
悴	2713		11	10	0.00151%	648873	98.81%	10	2.76%
掠	2717		11	10	0.00151%	648883	98.82%	10	2.76%
朧	2720		20	10	0.00151%	648893	98.82%	10	2.76%
翹	2747		18	10	0.00151%	648903	98.86%	10	2.76%
駭	2765		16	10	0.00151%	648913	98.89%	10	2.76%
娃	1215		9	76	0.01147%	648989	91.46%	9	2.48%
艦	1691		20	39	0.005888%	649028	95.49%	9	2.48%
尿	1828		7	32	0.004831%	649060	96.22%	9	2.48%
晉	1915		10	29	0.004378%	649089	96.62%	9	2.48%
沼	1920		8	29	0.004378%	649118	96.64%	9	2.48%
仗	2082		5	23	0.003472%	649141	97.28%	9	2.48%
蛙	2142		12	22	0.003321%	649163	97.49%	9	2.48%
晃	2166		10	21	0.003171%	649184	97.56%	9	2.48%
腫	2181		13	21	0.003171%	649205	97.61%	9	2.48%
妓	2195		7	20	0.00302%	649225	97.66%	9	2.48%
漬	2249		14	19	0.002869%	649244	97.81%	9	2.48%
債	2261		13	18	0.002718%	649262	97.85%	9	2.48%
嫁	2273		13	18	0.002718%	649280	97.88%	9	2.48%
捏	2279		10	18	0.002718%	649298	97.90%	9	2.48%
蔡	2297		15	18	0.002718%	649316	97.95%	9	2.48%
	2316		13	17	0.002567%	649333	98.00%	9	2.48%
嚐	2320		17	17	0.002567%	649350	98.01%	9	2.48%
墓	2321		14	17	0.002567%	649367	98.01%	9	2.48%
鴻	2360		17	17	0.002567%	649384	98.11%	9	2.48%
卿	2364		10	16	0.002416%	649400	98.12%	9	2.48%
杏	2388		7	16	0.002416%	649416	98.18%	9	2.48%
羞	2403		11	16	0.002416%	649432	98.21%	9	2.48%
邱	2409		7	16	0.002416%	649448	98.23%	9	2.48%
榻	2427		14	15	0.002265%	649463	98.27%	9	2.48%
禪	2435		16	15	0.002265%	649478	98.29%	9	2.48%
鞭	2447		18	15	0.002265%	649493	98.32%	9	2.48%
墳	2455		15	14	0.002114%	649507	98.33%	9	2.48%
崖	2459		11	14	0.002114%	649521	98.34%	9	2.48%
悽	2462		11	14	0.002114%	649535	98.35%	9	2.48%
拌	2465		8	14	0.002114%	649549	98.35%	9	2.48%
撕	2469		15	14	0.002114%	649563	98.36%	9	2.48%
梧	2471		11	14	0.002114%	649577	98.37%	9	2.48%
棕	2472		12	14	0.002114%	649591	98.37%	9	2.48%
櫥	2475		19	14	0.002114%	649605	98.38%	9	2.48%
葬	2495		13	14	0.002114%	649619	98.42%	9	2.48%
虔	2498		10	14	0.002114%	649633	98.42%	9	2.48%
哉	2524		9	13	0.001963%	649646	98.48%	9	2.48%
嗣	2525		13	13	0.001963%	649659	98.48%	9	2.48%
峻	2528		10	13	0.001963%	649672	98.49%	9	2.48%
惘	2532		11	13	0.001963%	649685	98.49%	9	2.48%
擋	2535		16	13	0.001963%	649698	98.50%	9	2.48%
暈	2537		13	13	0.001963%	649711	98.50%	9	2.48%
暨	2538		14	13	0.001963%	649724	98.50%	9	2.48%
曆	2539		16	13	0.001963%	649737	98.51%	9	2.48%
醇	2569		15	13	0.001963%	649750	98.57%	9	2.48%
逗	2621		10	12	0.001812%	649762	98.66%	9	2.48%
闆	2625		17	12	0.001812%	649774	98.67%	9	2.48%
駁	2628		14	12	0.001812%	649786	98.67%	9	2.48%
幌	2649		13	11	0.001661%	649797	98.71%	9	2.48%
杖	2658		7	11	0.001661%	649808	98.72%	9	2.48%
歧	2662		8	11	0.001661%	649819	98.73%	9	2.48%
淫	2664		11	11	0.001661%	649830	98.73%	9	2.48%
焚	2666		12	11	0.001661%	649841	98.74%	9	2.48%
眸	2670		11	11	0.001661%	649852	98.74%	9	2.48%
砍	2671		9	11	0.001661%	649863	98.74%	9	2.48%
篤	2673		16	11	0.001661%	649874	98.75%	9	2.48%
虞	2680		13	11	0.001661%	649885	98.76%	9	2.48%
褪	2683		15	11	0.001661%	649896	98.76%	9	2.48%
鑼	2691		27	11	0.001661%	649907	98.78%	9	2.48%
鵝	2698		18	11	0.001661%	649918	98.79%	9	2.48%
鹹	2700		20	11	0.001661%	649929	98.79%	9	2.48%
惆	2714		11	10	0.00151%	649939	98.81%	9	2.48%
挾	2716		10	10	0.00151%	649949	98.82%	9	2.48%
棟	2725		12	10	0.00151%	649959	98.83%	9	2.48%
欽	2731		12	10	0.00151%	649969	98.84%	9	2.48%
沛	2733		7	10	0.00151%	649979	98.84%	9	2.48%
洶	2734		9	10	0.00151%	649989	98.84%	9	2.48%
爪	2736		4	10	0.00151%	649999	98.85%	9	2.48%
癮	2740		22	10	0.00151%	650009	98.85%	9	2.48%
蠶	2753		24	10	0.00151%	650019	98.87%	9	2.48%
衍	2754		9	10	0.00151%	650029	98.87%	9	2.48%
裳	2755		14	10	0.00151%	650039	98.88%	9	2.48%
銜	2760		14	10	0.00151%	650049	98.88%	9	2.48%
闖	2761		18	10	0.00151%	650059	98.88%	9	2.48%
倖	2770		10	9	0.001359%	650068	98.90%	9	2.48%
僻	2771		15	9	0.001359%	650077	98.90%	9	2.48%
咸	2773		9	9	0.001359%	650086	98.90%	9	2.48%
宵	2777		10	9	0.001359%	650095	98.91%	9	2.48%
嶄	2781		14	9	0.001359%	650104	98.91%	9	2.48%
摯	2789		15	9	0.001359%	650113	98.92%	9	2.48%
斬	2791		11	9	0.001359%	650122	98.93%	9	2.48%
旳	2792		7	9	0.001359%	650131	98.93%	9	2.48%
枉	2793		8	9	0.001359%	650140	98.93%	9	2.48%
繽	2821		20	9	0.001359%	650149	98.97%	9	2.48%
肖	2823		7	9	0.001359%	650158	98.97%	9	2.48%
臻	2825		16	9	0.001359%	650167	98.97%	9	2.48%
藩	2833		19	9	0.001359%	650176	98.98%	9	2.48%
迥	2841		8	9	0.001359%	650185	98.99%	9	2.48%
髒	2845		22	9	0.001359%	650194	99.00%	9	2.48%
郵	1243		11	74	0.01117%	650268	91.78%	8	2.20%
鮪	1328		17	66	0.009964%	650334	92.67%	8	2.20%
獅	1333		13	65	0.009813%	650399	92.72%	8	2.20%
淑	1526		11	50	0.007549%	650449	94.38%	8	2.20%
錨	1575		17	47	0.007096%	650496	94.74%	8	2.20%
醬	1643		18	43	0.006492%	650539	95.20%	8	2.20%
姨	2087		9	23	0.003472%	650562	97.30%	8	2.20%
岳	2121		8	22	0.003321%	650584	97.42%	8	2.20%
卸	2158		8	21	0.003171%	650605	97.54%	8	2.20%
餌	2190		14	21	0.003171%	650626	97.64%	8	2.20%
潭	2206		15	20	0.00302%	650646	97.69%	8	2.20%
奸	2231		6	19	0.002869%	650665	97.76%	8	2.20%
莖	2255		11	19	0.002869%	650684	97.83%	8	2.20%
炮	2287		9	18	0.002718%	650702	97.92%	8	2.20%
瞎	2338		15	17	0.002567%	650719	98.05%	8	2.20%
袛	2353		10	17	0.002567%	650736	98.09%	8	2.20%
趙	2354		14	17	0.002567%	650753	98.09%	8	2.20%
屜	2370		11	16	0.002416%	650769	98.13%	8	2.20%
曬	2387		23	16	0.002416%	650785	98.18%	8	2.20%
秒	2401		9	16	0.002416%	650801	98.21%	8	2.20%
蝶	2406		15	16	0.002416%	650817	98.22%	8	2.20%
兇	2416		6	15	0.002265%	650832	98.25%	8	2.20%
杉	2425		7	15	0.002265%	650847	98.27%	8	2.20%
刮	2451		8	14	0.002114%	650861	98.32%	8	2.20%
獄	2479		14	14	0.002114%	650875	98.38%	8	2.20%
貶	2501		12	14	0.002114%	650889	98.43%	8	2.20%
丫	2516		3	13	0.001963%	650902	98.46%	8	2.20%
凸	2522		5	13	0.001963%	650915	98.47%	8	2.20%
杆	2540		7	13	0.001963%	650928	98.51%	8	2.20%
洒	2544		9	13	0.001963%	650941	98.52%	8	2.20%
烤	2547		10	13	0.001963%	650954	98.52%	8	2.20%
癒	2549		18	13	0.001963%	650967	98.53%	8	2.20%
締	2554		15	13	0.001963%	650980	98.54%	8	2.20%
陡	2570		9	13	0.001963%	650993	98.57%	8	2.20%
喬	2577		12	12	0.001812%	651005	98.58%	8	2.20%
嗅	2578		13	12	0.001812%	651017	98.58%	8	2.20%
妒	2582		7	12	0.001812%	651029	98.59%	8	2.20%
寥	2586		14	12	0.001812%	651041	98.60%	8	2.20%
穴	2601		5	12	0.001812%	651053	98.62%	8	2.20%
糟	2602		17	12	0.001812%	651065	98.63%	8	2.20%
繡	2606		18	12	0.001812%	651077	98.63%	8	2.20%
脊	2607		10	12	0.001812%	651089	98.63%	8	2.20%
薇	2612		17	12	0.001812%	651101	98.64%	8	2.20%
譚	2618		19	12	0.001812%	651113	98.65%	8	2.20%
飢	2627		10	12	0.001812%	651125	98.67%	8	2.20%
剔	2634		10	11	0.001661%	651136	98.68%	8	2.20%
咽	2637		9	11	0.001661%	651147	98.69%	8	2.20%
契	2643		9	11	0.001661%	651158	98.70%	8	2.20%
嬉	2645		15	11	0.001661%	651169	98.70%	8	2.20%
拳	2655		10	11	0.001661%	651180	98.72%	8	2.20%
搗	2656		13	11	0.001661%	651191	98.72%	8	2.20%
碟	2672		14	11	0.001661%	651202	98.75%	8	2.20%
鏟	2690		19	11	0.001661%	651213	98.78%	8	2.20%
魄	2696		15	11	0.001661%	651224	98.79%	8	2.20%
刃	2702		3	10	0.00151%	651234	98.80%	8	2.20%
夥	2709		14	10	0.00151%	651244	98.81%	8	2.20%
廁	2711		12	10	0.00151%	651254	98.81%	8	2.20%
慚	2715		14	10	0.00151%	651264	98.82%	8	2.20%
掏	2718		11	10	0.00151%	651274	98.82%	8	2.20%
橢	2728		16	10	0.00151%	651284	98.84%	8	2.20%
歪	2732		9	10	0.00151%	651294	98.84%	8	2.20%
痊	2739		11	10	0.00151%	651304	98.85%	8	2.20%
眩	2741		10	10	0.00151%	651314	98.85%	8	2.20%
砌	2742		9	10	0.00151%	651324	98.86%	8	2.20%
祂	2743		7	10	0.00151%	651334	98.86%	8	2.20%
萌	2749		12	10	0.00151%	651344	98.87%	8	2.20%
襟	2756		18	10	0.00151%	651354	98.88%	8	2.20%
郁	2759		8	10	0.00151%	651364	98.88%	8	2.20%
霜	2762		17	10	0.00151%	651374	98.89%	8	2.20%
頒	2763		13	10	0.00151%	651384	98.89%	8	2.20%
頹	2764		16	10	0.00151%	651394	98.89%	8	2.20%
寐	2778		12	9	0.001359%	651403	98.91%	8	2.20%
憎	2786		15	9	0.001359%	651412	98.92%	8	2.20%
抒	2787		7	9	0.001359%	651421	98.92%	8	2.20%
拭	2788		9	9	0.001359%	651430	98.92%	8	2.20%
棘	2794		12	9	0.001359%	651439	98.93%	8	2.20%
漪	2799		14	9	0.001359%	651448	98.94%	8	2.20%
燄	2803		16	9	0.001359%	651457	98.94%	8	2.20%
獵	2804		18	9	0.001359%	651466	98.94%	8	2.20%
疇	2807		19	9	0.001359%	651475	98.95%	8	2.20%
眺	2811		11	9	0.001359%	651484	98.95%	8	2.20%
睜	2812		13	9	0.001359%	651493	98.96%	8	2.20%
肆	2822		13	9	0.001359%	651502	98.97%	8	2.20%
螢	2838		16	9	0.001359%	651511	98.99%	8	2.20%
貯	2840		12	9	0.001359%	651520	98.99%	8	2.20%
冶	2857		7	8	0.001208%	651528	99.02%	8	2.20%
嘲	2866		15	8	0.001208%	651536	99.03%	8	2.20%
囑	2869		24	8	0.001208%	651544	99.03%	8	2.20%
廷	2881		7	8	0.001208%	651552	99.04%	8	2.20%
惕	2884		11	8	0.001208%	651560	99.05%	8	2.20%
憔	2887		15	8	0.001208%	651568	99.05%	8	2.20%
撩	2894		15	8	0.001208%	651576	99.06%	8	2.20%
殆	2901		9	8	0.001208%	651584	99.07%	8	2.20%
渲	2903		12	8	0.001208%	651592	99.07%	8	2.20%
漾	2905		14	8	0.001208%	651600	99.07%	8	2.20%
炙	2911		8	8	0.001208%	651608	99.08%	8	2.20%
繹	2920		19	8	0.001208%	651616	99.09%	8	2.20%
翔	2921		12	8	0.001208%	651624	99.09%	8	2.20%
肢	2922		8	8	0.001208%	651632	99.09%	8	2.20%
轍	2936		18	8	0.001208%	651640	99.11%	8	2.20%
釐	2939		18	8	0.001208%	651648	99.11%	8	2.20%
癌	998		17	109	0.01646%	651757	88.51%	7	1.93%
槽	1494		15	52	0.007851%	651809	94.14%	7	1.93%
飼	1761		13	36	0.005435%	651845	95.88%	7	1.93%
瓊	1857		19	31	0.00468%	651876	96.36%	7	1.93%
郭	1933		10	29	0.004378%	651905	96.70%	7	1.93%
錶	1980		16	27	0.004076%	651932	96.90%	7	1.93%
札	2032		5	25	0.003774%	651957	97.10%	7	1.93%
榴	2035		14	25	0.003774%	651982	97.11%	7	1.93%
壤	2118		20	22	0.003321%	652004	97.41%	7	1.93%
溉	2132		12	22	0.003321%	652026	97.45%	7	1.93%
彝	2163		18	21	0.003171%	652047	97.55%	7	1.93%
抄	2238		7	19	0.002869%	652066	97.78%	7	1.93%
缸	2291		9	18	0.002718%	652084	97.93%	7	1.93%
偵	2314		11	17	0.002567%	652101	97.99%	7	1.93%
粘	2346		11	17	0.002567%	652118	98.07%	7	1.93%
婷	2368		12	16	0.002416%	652134	98.13%	7	1.93%
桿	2389		11	16	0.002416%	652150	98.18%	7	1.93%
瘡	2399		15	16	0.002416%	652166	98.20%	7	1.93%
穌	2402		16	16	0.002416%	652182	98.21%	7	1.93%
渠	2429		12	15	0.002265%	652197	98.27%	7	1.93%
巫	2460		7	14	0.002114%	652211	98.34%	7	1.93%
橘	2473		16	14	0.002114%	652225	98.37%	7	1.93%
檯	2474		18	14	0.002114%	652239	98.37%	7	1.93%
笛	2488		11	14	0.002114%	652253	98.40%	7	1.93%
縷	2492		17	14	0.002114%	652267	98.41%	7	1.93%
儉	2520		15	13	0.001963%	652280	98.47%	7	1.93%
榜	2541		14	13	0.001963%	652293	98.51%	7	1.93%
竊	2552		23	13	0.001963%	652306	98.53%	7	1.93%
簍	2553		17	13	0.001963%	652319	98.53%	7	1.93%
菱	2559		12	13	0.001963%	652332	98.55%	7	1.93%
裹	2562		14	13	0.001963%	652345	98.55%	7	1.93%
麓	2571		19	13	0.001963%	652358	98.57%	7	1.93%
叮	2576		5	12	0.001812%	652370	98.58%	7	1.93%
皺	2598		15	12	0.001812%	652382	98.62%	7	1.93%
褒	2615		15	12	0.001812%	652394	98.65%	7	1.93%
賜	2619		15	12	0.001812%	652406	98.66%	7	1.93%
鴉	2629		15	12	0.001812%	652418	98.67%	7	1.93%
巍	2648		21	11	0.001661%	652429	98.71%	7	1.93%
炒	2665		8	11	0.001661%	652440	98.73%	7	1.93%
舶	2679		11	11	0.001661%	652451	98.76%	7	1.93%
赦	2686		11	11	0.001661%	652462	98.77%	7	1.93%
軋	2687		8	11	0.001661%	652473	98.77%	7	1.93%
鬚	2695		22	11	0.001661%	652484	98.78%	7	1.93%
划	2703		6	10	0.00151%	652494	98.80%	7	1.93%
址	2708		7	10	0.00151%	652504	98.80%	7	1.93%
擱	2719		17	10	0.00151%	652514	98.82%	7	1.93%
柑	2721		9	10	0.00151%	652524	98.82%	7	1.93%
梗	2723		11	10	0.00151%	652534	98.83%	7	1.93%
瀟	2735		19	10	0.00151%	652544	98.85%	7	1.93%
絞	2745		12	10	0.00151%	652554	98.86%	7	1.93%
菩	2748		12	10	0.00151%	652564	98.87%	7	1.93%
薔	2750		17	10	0.00151%	652574	98.87%	7	1.93%
賠	2757		15	10	0.00151%	652584	98.88%	7	1.93%
逕	2758		10	10	0.00151%	652594	98.88%	7	1.93%
侍	2769		8	9	0.001359%	652603	98.90%	7	1.93%
冀	2772		16	9	0.001359%	652612	98.90%	7	1.93%
岡	2779		8	9	0.001359%	652621	98.91%	7	1.93%
巾	2783		3	9	0.001359%	652630	98.92%	7	1.93%
攪	2790		23	9	0.001359%	652639	98.93%	7	1.93%
渦	2798		12	9	0.001359%	652648	98.94%	7	1.93%
癢	2808		20	9	0.001359%	652657	98.95%	7	1.93%
皂	2809		7	9	0.001359%	652666	98.95%	7	1.93%
盯	2810		7	9	0.001359%	652675	98.95%	7	1.93%
鼎	2849		13	9	0.001359%	652684	99.01%	7	1.93%
佇	2852		7	8	0.001208%	652692	99.01%	7	1.93%
余	2853		7	8	0.001208%	652700	99.01%	7	1.93%
嚇	2868		17	8	0.001208%	652708	99.03%	7	1.93%
圭	2871		6	8	0.001208%	652716	99.03%	7	1.93%
嫉	2873		13	8	0.001208%	652724	99.03%	7	1.93%
帖	2876		8	8	0.001208%	652732	99.04%	7	1.93%
拈	2890		8	8	0.001208%	652740	99.05%	7	1.93%
挖	2892		9	8	0.001208%	652748	99.06%	7	1.93%
攔	2895		20	8	0.001208%	652756	99.06%	7	1.93%
曦	2897		20	8	0.001208%	652764	99.06%	7	1.93%
殉	2902		10	8	0.001208%	652772	99.07%	7	1.93%
澆	2906		15	8	0.001208%	652780	99.07%	7	1.93%
澎	2907		15	8	0.001208%	652788	99.08%	7	1.93%
潘	2908		15	8	0.001208%	652796	99.08%	7	1.93%
瀰	2910		20	8	0.001208%	652804	99.08%	7	1.93%
琢	2913		12	8	0.001208%	652812	99.08%	7	1.93%
瑚	2914		13	8	0.001208%	652820	99.08%	7	1.93%
矢	2918		5	8	0.001208%	652828	99.09%	7	1.93%
誓	2930		14	8	0.001208%	652836	99.10%	7	1.93%
賭	2933		15	8	0.001208%	652844	99.11%	7	1.93%
蹈	2934		17	8	0.001208%	652852	99.11%	7	1.93%
躬	2935		10	8	0.001208%	652860	99.11%	7	1.93%
鄙	2937		13	8	0.001208%	652868	99.11%	7	1.93%
鑄	2942		22	8	0.001208%	652876	99.12%	7	1.93%
闡	2943		20	8	0.001208%	652884	99.12%	7	1.93%
雛	2944		18	8	0.001208%	652892	99.12%	7	1.93%
靄	2946		24	8	0.001208%	652900	99.12%	7	1.93%
堵	2967		11	7	0.001057%	652907	99.15%	7	1.93%
壘	2969		18	7	0.001057%	652914	99.15%	7	1.93%
夭	2970		4	7	0.001057%	652921	99.15%	7	1.93%
娶	2972		11	7	0.001057%	652928	99.15%	7	1.93%
怡	2983		8	7	0.001057%	652935	99.16%	7	1.93%
摔	2991		14	7	0.001057%	652942	99.17%	7	1.93%
撼	2992		16	7	0.001057%	652949	99.17%	7	1.93%
澡	3000		16	7	0.001057%	652956	99.18%	7	1.93%
猖	3009		11	7	0.001057%	652963	99.19%	7	1.93%
盎	3016		10	7	0.001057%	652970	99.20%	7	1.93%
矜	3020		9	7	0.001057%	652977	99.20%	7	1.93%
罕	3033		7	7	0.001057%	652984	99.21%	7	1.93%
聆	3036		11	7	0.001057%	652991	99.22%	7	1.93%
腥	3038		13	7	0.001057%	652998	99.22%	7	1.93%
詐	3052		12	7	0.001057%	653005	99.24%	7	1.93%
詭	3053		13	7	0.001057%	653012	99.24%	7	1.93%
軒	3057		10	7	0.001057%	653019	99.24%	7	1.93%
醋	3061		15	7	0.001057%	653026	99.24%	7	1.93%
鋪	3063		15	7	0.001057%	653033	99.25%	7	1.93%
闕	3064		18	7	0.001057%	653040	99.25%	7	1.93%
騁	3067		17	7	0.001057%	653047	99.25%	7	1.93%
鬢	3070		24	7	0.001057%	653054	99.25%	7	1.93%
妳	796		8	157	0.0237%	653211	84.54%	6	1.65%
鰭	1056		21	97	0.01464%	653308	89.41%	6	1.65%
蔗	1376		15	61	0.00921%	653369	93.13%	6	1.65%
沫	1552		8	48	0.007247%	653417	94.57%	6	1.65%
伶	1696		7	38	0.005737%	653455	95.52%	6	1.65%
	1719		12	38	0.005737%	653493	95.65%	6	1.65%
腺	1839		13	32	0.004831%	653525	96.28%	6	1.65%
楓	1851		13	31	0.00468%	653556	96.33%	6	1.65%
棒	1876		12	30	0.004529%	653586	96.45%	6	1.65%
鴿	2020		17	26	0.003925%	653612	97.05%	6	1.65%
翰	2047		16	25	0.003774%	653637	97.16%	6	1.65%
狄	2135		7	22	0.003321%	653659	97.46%	6	1.65%
框	2170		10	21	0.003171%	653680	97.58%	6	1.65%
菌	2183		12	21	0.003171%	653701	97.62%	6	1.65%
杭	2203		8	20	0.00302%	653721	97.68%	6	1.65%
硫	2251		11	19	0.002869%	653740	97.82%	6	1.65%
礁	2341		17	17	0.002567%	653757	98.06%	6	1.65%
捆	2380		10	16	0.002416%	653773	98.16%	6	1.65%
摺	2383		14	16	0.002416%	653789	98.17%	6	1.65%
棚	2390		12	16	0.002416%	653805	98.18%	6	1.65%
韌	2412		12	16	0.002416%	653821	98.24%	6	1.65%
嘩	2419		15	15	0.002265%	653836	98.25%	6	1.65%
栗	2426		10	15	0.002265%	653851	98.27%	6	1.65%
埔	2454		10	14	0.002114%	653865	98.33%	6	1.65%
峨	2458		10	14	0.002114%	653879	98.34%	6	1.65%
綁	2491		13	14	0.002114%	653893	98.41%	6	1.65%
鵑	2512		18	14	0.002114%	653907	98.45%	6	1.65%
嘻	2526		15	13	0.001963%	653920	98.48%	6	1.65%
檻	2543		18	13	0.001963%	653933	98.51%	6	1.65%
占	2575		5	12	0.001812%	653945	98.58%	6	1.65%
孵	2585		14	12	0.001812%	653957	98.60%	6	1.65%
帳	2589		11	12	0.001812%	653969	98.60%	6	1.65%
燻	2597		18	12	0.001812%	653981	98.62%	6	1.65%
砲	2599		10	12	0.001812%	653993	98.62%	6	1.65%
蜀	2614		13	12	0.001812%	654005	98.65%	6	1.65%
倩	2630		10	11	0.001661%	654016	98.68%	6	1.65%
券	2633		8	11	0.001661%	654027	98.68%	6	1.65%
咳	2636		9	11	0.001661%	654038	98.69%	6	1.65%
喃	2639		12	11	0.001661%	654049	98.69%	6	1.65%
宰	2646		10	11	0.001661%	654060	98.70%	6	1.65%
檀	2660		17	11	0.001661%	654071	98.73%	6	1.65%
疫	2668		9	11	0.001661%	654082	98.74%	6	1.65%
翩	2677		15	11	0.001661%	654093	98.75%	6	1.65%
颱	2693		14	11	0.001661%	654104	98.78%	6	1.65%
鹿	2701		11	11	0.001661%	654115	98.79%	6	1.65%
棗	2724		12	10	0.00151%	654125	98.83%	6	1.65%
棍	2726		12	10	0.00151%	654135	98.83%	6	1.65%
檜	2730		17	10	0.00151%	654145	98.84%	6	1.65%
甸	2738		7	10	0.00151%	654155	98.85%	6	1.65%
纍	2746		21	10	0.00151%	654165	98.86%	6	1.65%
蚊	2751		10	10	0.00151%	654175	98.87%	6	1.65%
鯨	2767		19	10	0.00151%	654185	98.89%	6	1.65%
亨	2768		7	9	0.001359%	654194	98.90%	6	1.65%
喟	2774		12	9	0.001359%	654203	98.90%	6	1.65%
嘈	2775		14	9	0.001359%	654212	98.90%	6	1.65%
娜	2776		10	9	0.001359%	654221	98.91%	6	1.65%
巒	2782		22	9	0.001359%	654230	98.91%	6	1.65%
并	2784		6	9	0.001359%	654239	98.92%	6	1.65%
憫	2785		15	9	0.001359%	654248	98.92%	6	1.65%
琉	2805		10	9	0.001359%	654257	98.95%	6	1.65%
磁	2813		14	9	0.001359%	654266	98.96%	6	1.65%
絢	2819		12	9	0.001359%	654275	98.96%	6	1.65%
鋁	2842		15	9	0.001359%	654284	99.00%	6	1.65%
錐	2843		16	9	0.001359%	654293	99.00%	6	1.65%
顱	2844		25	9	0.001359%	654302	99.00%	6	1.65%
丸	2850		3	8	0.001208%	654310	99.01%	6	1.65%
冥	2856		10	8	0.001208%	654318	99.01%	6	1.65%
凄	2858		10	8	0.001208%	654326	99.02%	6	1.65%
吋	2861		6	8	0.001208%	654334	99.02%	6	1.65%
嘶	2867		15	8	0.001208%	654342	99.03%	6	1.65%
崎	2875		11	8	0.001208%	654350	99.04%	6	1.65%
庇	2878		7	8	0.001208%	654358	99.04%	6	1.65%
弧	2882		8	8	0.001208%	654366	99.05%	6	1.65%
挫	2893		10	8	0.001208%	654374	99.06%	6	1.65%
溯	2904		13	8	0.001208%	654382	99.07%	6	1.65%
濺	2909		18	8	0.001208%	654390	99.08%	6	1.65%
燙	2912		16	8	0.001208%	654398	99.08%	6	1.65%
眨	2916		10	8	0.001208%	654406	99.09%	6	1.65%
瞇	2917		15	8	0.001208%	654414	99.09%	6	1.65%
苔	2923		9	8	0.001208%	654422	99.09%	6	1.65%
蒲	2925		14	8	0.001208%	654430	99.10%	6	1.65%
蛻	2927		13	8	0.001208%	654438	99.10%	6	1.65%
譏	2931		19	8	0.001208%	654446	99.10%	6	1.65%
貞	2932		9	8	0.001208%	654454	99.11%	6	1.65%
錘	2941		17	8	0.001208%	654462	99.12%	6	1.65%
丙	2950		5	7	0.001057%	654469	99.13%	6	1.65%
侮	2951		9	7	0.001057%	654476	99.13%	6	1.65%
剌	2954		9	7	0.001057%	654483	99.13%	6	1.65%
哄	2958		9	7	0.001057%	654490	99.14%	6	1.65%
哼	2960		10	7	0.001057%	654497	99.14%	6	1.65%
嗓	2962		13	7	0.001057%	654504	99.14%	6	1.65%
囉	2965		22	7	0.001057%	654511	99.14%	6	1.65%
弓	2981		3	7	0.001057%	654518	99.16%	6	1.65%
弛	2982		6	7	0.001057%	654525	99.16%	6	1.65%
憧	2985		15	7	0.001057%	654532	99.16%	6	1.65%
憬	2986		15	7	0.001057%	654539	99.17%	6	1.65%
憩	2987		16	7	0.001057%	654546	99.17%	6	1.65%
拱	2988		9	7	0.001057%	654553	99.17%	6	1.65%
櫻	2994		21	7	0.001057%	654560	99.17%	6	1.65%
歎	2995		15	7	0.001057%	654567	99.17%	6	1.65%
淆	2997		11	7	0.001057%	654574	99.18%	6	1.65%
瀉	3001		18	7	0.001057%	654581	99.18%	6	1.65%
灼	3002		7	7	0.001057%	654588	99.18%	6	1.65%
烹	3003		11	7	0.001057%	654595	99.18%	6	1.65%
煥	3004		13	7	0.001057%	654602	99.18%	6	1.65%
熄	3005		14	7	0.001057%	654609	99.19%	6	1.65%
熬	3006		15	7	0.001057%	654616	99.19%	6	1.65%
爰	3007		9	7	0.001057%	654623	99.19%	6	1.65%
狠	3008		9	7	0.001057%	654630	99.19%	6	1.65%
盧	3017		16	7	0.001057%	654637	99.20%	6	1.65%
眶	3018		11	7	0.001057%	654644	99.20%	6	1.65%
睹	3019		13	7	0.001057%	654651	99.20%	6	1.65%
矩	3021		10	7	0.001057%	654658	99.20%	6	1.65%
緞	3031		15	7	0.001057%	654665	99.21%	6	1.65%
耍	3035		9	7	0.001057%	654672	99.22%	6	1.65%
肇	3037		14	7	0.001057%	654679	99.22%	6	1.65%
臆	3039		17	7	0.001057%	654686	99.22%	6	1.65%
蠢	3049		21	7	0.001057%	654693	99.23%	6	1.65%
蠻	3050		25	7	0.001057%	654700	99.23%	6	1.65%
衹	3051		9	7	0.001057%	654707	99.23%	6	1.65%
躁	3056		20	7	0.001057%	654714	99.24%	6	1.65%
鞠	3066		17	7	0.001057%	654721	99.25%	6	1.65%
髦	3069		14	7	0.001057%	654728	99.25%	6	1.65%
儼	3081		22	6	0.0009059%	654734	99.26%	6	1.65%
叩	3085		5	6	0.0009059%	654740	99.27%	6	1.65%
咎	3091		8	6	0.0009059%	654746	99.27%	6	1.65%
囀	3097		21	6	0.0009059%	654752	99.28%	6	1.65%
坎	3098		7	6	0.0009059%	654758	99.28%	6	1.65%
塢	3102		13	6	0.0009059%	654764	99.28%	6	1.65%
廝	3108		15	6	0.0009059%	654770	99.29%	6	1.65%
惋	3111		11	6	0.0009059%	654776	99.29%	6	1.65%
摒	3115		12	6	0.0009059%	654782	99.30%	6	1.65%
	3116		13	6	0.0009059%	654788	99.30%	6	1.65%
撓	3118		15	6	0.0009059%	654794	99.30%	6	1.65%
擅	3119		16	6	0.0009059%	654800	99.30%	6	1.65%
曠	3122		19	6	0.0009059%	654806	99.30%	6	1.65%
歹	3131		4	6	0.0009059%	654812	99.31%	6	1.65%
毯	3132		12	6	0.0009059%	654818	99.31%	6	1.65%
漣	3142		14	6	0.0009059%	654824	99.32%	6	1.65%
狼	3147		10	6	0.0009059%	654830	99.32%	6	1.65%
疵	3151		11	6	0.0009059%	654836	99.33%	6	1.65%
瞪	3154		17	6	0.0009059%	654842	99.33%	6	1.65%
瞻	3155		18	6	0.0009059%	654848	99.33%	6	1.65%
碑	3156		13	6	0.0009059%	654854	99.33%	6	1.65%
絀	3166		11	6	0.0009059%	654860	99.34%	6	1.65%
綻	3167		14	6	0.0009059%	654866	99.34%	6	1.65%
綺	3168		14	6	0.0009059%	654872	99.34%	6	1.65%
繆	3170		17	6	0.0009059%	654878	99.35%	6	1.65%
羈	3172		24	6	0.0009059%	654884	99.35%	6	1.65%
謠	3183		17	6	0.0009059%	654890	99.36%	6	1.65%
贅	3184		18	6	0.0009059%	654896	99.36%	6	1.65%
蹲	3187		19	6	0.0009059%	654902	99.36%	6	1.65%
輾	3191		17	6	0.0009059%	654908	99.36%	6	1.65%
醞	3193		17	6	0.0009059%	654914	99.37%	6	1.65%
銘	3194		14	6	0.0009059%	654920	99.37%	6	1.65%
閨	3195		14	6	0.0009059%	654926	99.37%	6	1.65%
霓	3198		16	6	0.0009059%	654932	99.37%	6	1.65%
丘	1189		5	79	0.01193%	655011	91.16%	5	1.38%
噪	1720		16	37	0.005586%	655048	95.66%	5	1.38%
賈	2052		13	25	0.003774%	655073	97.17%	5	1.38%
籐	2179		21	21	0.003171%	655094	97.61%	5	1.38%
陵	2219		10	20	0.00302%	655114	97.73%	5	1.38%
埠	2270		11	18	0.002718%	655132	97.87%	5	1.38%
樞	2283		15	18	0.002718%	655150	97.91%	5	1.38%
粵	2347		13	17	0.002567%	655167	98.08%	5	1.38%
鰱	2415		22	16	0.002416%	655183	98.24%	5	1.38%
瓷	2482		11	14	0.002114%	655197	98.39%	5	1.38%
閩	2508		14	14	0.002114%	655211	98.44%	5	1.38%
彭	2531		12	13	0.001963%	655224	98.49%	5	1.38%
疆	2548		19	13	0.001963%	655237	98.52%	5	1.38%
蕃	2560		16	13	0.001963%	655250	98.55%	5	1.38%
壩	2581		24	12	0.001812%	655262	98.59%	5	1.38%
屍	2588		9	12	0.001812%	655274	98.60%	5	1.38%
敝	2593		11	12	0.001812%	655286	98.61%	5	1.38%
范	2610		9	12	0.001812%	655298	98.64%	5	1.38%
凹	2632		5	11	0.001661%	655309	98.68%	5	1.38%
姚	2644		9	11	0.001661%	655320	98.70%	5	1.38%
牡	2667		7	11	0.001661%	655331	98.74%	5	1.38%
痰	2669		13	11	0.001661%	655342	98.74%	5	1.38%
馮	2694		12	11	0.001661%	655353	98.78%	5	1.38%
吱	2705		7	10	0.00151%	655363	98.80%	5	1.38%
楷	2727		13	10	0.00151%	655373	98.83%	5	1.38%
爵	2737		17	10	0.00151%	655383	98.85%	5	1.38%
浦	2797		10	9	0.001359%	655392	98.93%	5	1.38%
漉	2800		14	9	0.001359%	655401	98.94%	5	1.38%
潺	2801		15	9	0.001359%	655410	98.94%	5	1.38%
祠	2814		9	9	0.001359%	655419	98.96%	5	1.38%
簫	2817		18	9	0.001359%	655428	98.96%	5	1.38%
腎	2824		12	9	0.001359%	655437	98.97%	5	1.38%
茸	2827		10	9	0.001359%	655446	98.98%	5	1.38%
蔔	2832		15	9	0.001359%	655455	98.98%	5	1.38%
藻	2834		20	9	0.001359%	655464	98.98%	5	1.38%
蝴	2837		15	9	0.001359%	655473	98.99%	5	1.38%
袁	2839		10	9	0.001359%	655482	98.99%	5	1.38%
鰓	2848		20	9	0.001359%	655491	99.00%	5	1.38%
乞	2851		3	8	0.001208%	655499	99.01%	5	1.38%
匱	2860		14	8	0.001208%	655507	99.02%	5	1.38%
啃	2863		11	8	0.001208%	655515	99.02%	5	1.38%
喀	2864		12	8	0.001208%	655523	99.02%	5	1.38%
嗽	2865		14	8	0.001208%	655531	99.02%	5	1.38%
囚	2870		5	8	0.001208%	655539	99.03%	5	1.38%
墮	2872		15	8	0.001208%	655547	99.03%	5	1.38%
媳	2874		13	8	0.001208%	655555	99.04%	5	1.38%
庶	2879		11	8	0.001208%	655563	99.04%	5	1.38%
悸	2885		11	8	0.001208%	655571	99.05%	5	1.38%
愴	2886		13	8	0.001208%	655579	99.05%	5	1.38%
懊	2888		16	8	0.001208%	655587	99.05%	5	1.38%
懲	2889		19	8	0.001208%	655595	99.05%	5	1.38%
椒	2899		12	8	0.001208%	655603	99.07%	5	1.38%
癱	2915		24	8	0.001208%	655611	99.09%	5	1.38%
紊	2919		10	8	0.001208%	655619	99.09%	5	1.38%
蛤	2926		12	8	0.001208%	655627	99.10%	5	1.38%
訝	2929		11	8	0.001208%	655635	99.10%	5	1.38%
鈕	2940		12	8	0.001208%	655643	99.12%	5	1.38%
霉	2945		15	8	0.001208%	655651	99.12%	5	1.38%
咧	2959		9	7	0.001057%	655658	99.14%	5	1.38%
墅	2968		14	7	0.001057%	655665	99.15%	5	1.38%
媒	2973		12	7	0.001057%	655672	99.15%	5	1.38%
宛	2976		8	7	0.001057%	655679	99.15%	5	1.38%
帛	2979		8	7	0.001057%	655686	99.16%	5	1.38%
慵	2984		14	7	0.001057%	655693	99.16%	5	1.38%
揀	2989		12	7	0.001057%	655700	99.17%	5	1.38%
搏	2990		13	7	0.001057%	655707	99.17%	5	1.38%
漩	2998		14	7	0.001057%	655714	99.18%	5	1.38%
瑟	3012		13	7	0.001057%	655721	99.19%	5	1.38%
痴	3014		13	7	0.001057%	655728	99.19%	5	1.38%
稠	3024		13	7	0.001057%	655735	99.21%	5	1.38%
竣	3025		12	7	0.001057%	655742	99.21%	5	1.38%
罔	3034		8	7	0.001057%	655749	99.22%	5	1.38%
莉	3044		11	7	0.001057%	655756	99.23%	5	1.38%
蛛	3046		12	7	0.001057%	655763	99.23%	5	1.38%
蟻	3047		19	7	0.001057%	655770	99.23%	5	1.38%
蠅	3048		19	7	0.001057%	655777	99.23%	5	1.38%
賬	3054		15	7	0.001057%	655784	99.24%	5	1.38%
轎	3058		19	7	0.001057%	655791	99.24%	5	1.38%
逛	3059		10	7	0.001057%	655798	99.24%	5	1.38%
郤	3060		9	7	0.001057%	655805	99.24%	5	1.38%
雁	3065		12	7	0.001057%	655812	99.25%	5	1.38%
魅	3071		15	7	0.001057%	655819	99.26%	5	1.38%
龜	3073		16	7	0.001057%	655826	99.26%	5	1.38%
佑	3074		7	6	0.0009059%	655832	99.26%	5	1.38%
偕	3077		11	6	0.0009059%	655838	99.26%	5	1.38%
傅	3078		12	6	0.0009059%	655844	99.26%	5	1.38%
傭	3080		13	6	0.0009059%	655850	99.26%	5	1.38%
兔	3082		8	6	0.0009059%	655856	99.27%	5	1.38%
凳	3083		14	6	0.0009059%	655862	99.27%	5	1.38%
呂	3089		7	6	0.0009059%	655868	99.27%	5	1.38%
咐	3090		8	6	0.0009059%	655874	99.27%	5	1.38%
啜	3092		11	6	0.0009059%	655880	99.27%	5	1.38%
噎	3093		15	6	0.0009059%	655886	99.28%	5	1.38%
嚀	3095		17	6	0.0009059%	655892	99.28%	5	1.38%
圾	3099		7	6	0.0009059%	655898	99.28%	5	1.38%
垃	3100		8	6	0.0009059%	655904	99.28%	5	1.38%
壹	3103		12	6	0.0009059%	655910	99.28%	5	1.38%
奚	3104		10	6	0.0009059%	655916	99.29%	5	1.38%
屁	3106		7	6	0.0009059%	655922	99.29%	5	1.38%
恙	3110		10	6	0.0009059%	655928	99.29%	5	1.38%
懺	3113		20	6	0.0009059%	655934	99.29%	5	1.38%
拴	3114		9	6	0.0009059%	655940	99.29%	5	1.38%
搓	3117		13	6	0.0009059%	655946	99.30%	5	1.38%
斟	3121		13	6	0.0009059%	655952	99.30%	5	1.38%
棋	3123		12	6	0.0009059%	655958	99.30%	5	1.38%
涕	3138		10	6	0.0009059%	655964	99.32%	5	1.38%
滬	3143		14	6	0.0009059%	655970	99.32%	5	1.38%
潰	3144		15	6	0.0009059%	655976	99.32%	5	1.38%
濡	3145		17	6	0.0009059%	655982	99.32%	5	1.38%
煽	3146		14	6	0.0009059%	655988	99.32%	5	1.38%
璜	3148		16	6	0.0009059%	655994	99.33%	5	1.38%
甦	3149		12	6	0.0009059%	656000	99.33%	5	1.38%
畸	3150		13	6	0.0009059%	656006	99.33%	5	1.38%
皓	3152		12	6	0.0009059%	656012	99.33%	5	1.38%
窒	3161		11	6	0.0009059%	656018	99.34%	5	1.38%
筷	3162		13	6	0.0009059%	656024	99.34%	5	1.38%
籤	3163		23	6	0.0009059%	656030	99.34%	5	1.38%
聾	3173		22	6	0.0009059%	656036	99.35%	5	1.38%
舢	3175		9	6	0.0009059%	656042	99.35%	5	1.38%
茁	3177		9	6	0.0009059%	656048	99.35%	5	1.38%
裨	3182		13	6	0.0009059%	656054	99.36%	5	1.38%
	3185		14	6	0.0009059%	656060	99.36%	5	1.38%
踞	3186		15	6	0.0009059%	656066	99.36%	5	1.38%
躊	3188		21	6	0.0009059%	656072	99.36%	5	1.38%
	3189		11	6	0.0009059%	656078	99.36%	5	1.38%
轄	3190		17	6	0.0009059%	656084	99.36%	5	1.38%
鄧	3192		14	6	0.0009059%	656090	99.36%	5	1.38%
雋	3197		13	6	0.0009059%	656096	99.37%	5	1.38%
靖	3199		13	6	0.0009059%	656102	99.37%	5	1.38%
靡	3200		19	6	0.0009059%	656108	99.37%	5	1.38%
麟	3206		23	6	0.0009059%	656114	99.38%	5	1.38%
	3208		6	5	0.0007549%	656119	99.38%	5	1.38%
亢	3209		4	5	0.0007549%	656124	99.38%	5	1.38%
俘	3211		9	5	0.0007549%	656129	99.38%	5	1.38%
倣	3212		10	5	0.0007549%	656134	99.38%	5	1.38%
兆	3213		6	5	0.0007549%	656139	99.38%	5	1.38%
冕	3215		11	5	0.0007549%	656144	99.38%	5	1.38%
冤	3216		10	5	0.0007549%	656149	99.39%	5	1.38%
剋	3219		9	5	0.0007549%	656154	99.39%	5	1.38%
匿	3220		11	5	0.0007549%	656159	99.39%	5	1.38%
哇	3222		9	5	0.0007549%	656164	99.39%	5	1.38%
咱	3223		9	5	0.0007549%	656169	99.39%	5	1.38%
哨	3224		10	5	0.0007549%	656174	99.39%	5	1.38%
啣	3225		11	5	0.0007549%	656179	99.39%	5	1.38%
坊	3235		7	5	0.0007549%	656184	99.40%	5	1.38%
塌	3236		13	5	0.0007549%	656189	99.40%	5	1.38%
嫣	3242		14	5	0.0007549%	656194	99.41%	5	1.38%
巔	3244		22	5	0.0007549%	656199	99.41%	5	1.38%
幟	3246		15	5	0.0007549%	656204	99.41%	5	1.38%
廂	3248		12	5	0.0007549%	656209	99.41%	5	1.38%
弗	3250		5	5	0.0007549%	656214	99.41%	5	1.38%
徉	3252		9	5	0.0007549%	656219	99.41%	5	1.38%
怔	3254		8	5	0.0007549%	656224	99.41%	5	1.38%
恃	3255		9	5	0.0007549%	656229	99.41%	5	1.38%
慄	3257		13	5	0.0007549%	656234	99.42%	5	1.38%
慷	3259		14	5	0.0007549%	656239	99.42%	5	1.38%
懈	3260		16	5	0.0007549%	656244	99.42%	5	1.38%
戎	3261		6	5	0.0007549%	656249	99.42%	5	1.38%
扉	3264		12	5	0.0007549%	656254	99.42%	5	1.38%
	3267		12	5	0.0007549%	656259	99.42%	5	1.38%
撇	3268		14	5	0.0007549%	656264	99.42%	5	1.38%
撮	3269		15	5	0.0007549%	656269	99.43%	5	1.38%
擄	3270		16	5	0.0007549%	656274	99.43%	5	1.38%
敞	3272		12	5	0.0007549%	656279	99.43%	5	1.38%
桓	3276		10	5	0.0007549%	656284	99.43%	5	1.38%
氓	3287		8	5	0.0007549%	656289	99.44%	5	1.38%
汰	3288		7	5	0.0007549%	656294	99.44%	5	1.38%
浙	3291		10	5	0.0007549%	656299	99.44%	5	1.38%
滄	3296		13	5	0.0007549%	656304	99.45%	5	1.38%
瀚	3298		19	5	0.0007549%	656309	99.45%	5	1.38%
烙	3300		10	5	0.0007549%	656314	99.45%	5	1.38%
狐	3303		8	5	0.0007549%	656319	99.45%	5	1.38%
猴	3304		12	5	0.0007549%	656324	99.45%	5	1.38%
癥	3310		20	5	0.0007549%	656329	99.46%	5	1.38%
瞞	3312		16	5	0.0007549%	656334	99.46%	5	1.38%
瞟	3313		16	5	0.0007549%	656339	99.46%	5	1.38%
瞥	3314		16	5	0.0007549%	656344	99.46%	5	1.38%
瞰	3315		17	5	0.0007549%	656349	99.46%	5	1.38%
矗	3316		24	5	0.0007549%	656354	99.46%	5	1.38%
穢	3322		18	5	0.0007549%	656359	99.47%	5	1.38%
竄	3324		18	5	0.0007549%	656364	99.47%	5	1.38%
箕	3325		14	5	0.0007549%	656369	99.47%	5	1.38%
簇	3327		17	5	0.0007549%	656374	99.47%	5	1.38%
綽	3333		14	5	0.0007549%	656379	99.47%	5	1.38%
罄	3334		17	5	0.0007549%	656384	99.47%	5	1.38%
翡	3335		14	5	0.0007549%	656389	99.48%	5	1.38%
耘	3337		10	5	0.0007549%	656394	99.48%	5	1.38%
腮	3341		13	5	0.0007549%	656399	99.48%	5	1.38%
臀	3345		17	5	0.0007549%	656404	99.48%	5	1.38%
芻	3351		10	5	0.0007549%	656409	99.49%	5	1.38%
蔓	3356		15	5	0.0007549%	656414	99.49%	5	1.38%
謐	3370		17	5	0.0007549%	656419	99.50%	5	1.38%
豁	3371		17	5	0.0007549%	656424	99.50%	5	1.38%
輒	3374		14	5	0.0007549%	656429	99.50%	5	1.38%
迨	3375		8	5	0.0007549%	656434	99.51%	5	1.38%
逞	3376		10	5	0.0007549%	656439	99.51%	5	1.38%
遐	3378		12	5	0.0007549%	656444	99.51%	5	1.38%
遑	3379		12	5	0.0007549%	656449	99.51%	5	1.38%
鈍	3382		12	5	0.0007549%	656454	99.51%	5	1.38%
阱	3390		6	5	0.0007549%	656459	99.52%	5	1.38%
陀	3391		7	5	0.0007549%	656464	99.52%	5	1.38%
隸	3392		17	5	0.0007549%	656469	99.52%	5	1.38%
霸	3394		21	5	0.0007549%	656474	99.52%	5	1.38%
饑	3398		20	5	0.0007549%	656479	99.52%	5	1.38%
驀	3400		21	5	0.0007549%	656484	99.52%	5	1.38%
魁	3403		14	5	0.0007549%	656489	99.53%	5	1.38%
圃	993		10	109	0.01646%	656598	88.42%	4	1.10%
瑙	1725		13	37	0.005586%	656635	95.68%	4	1.10%
筍	1732		12	37	0.005586%	656672	95.72%	4	1.10%
邵	1953		7	28	0.004227%	656700	96.79%	4	1.10%
戈	1989		4	26	0.003925%	656726	96.93%	4	1.10%
澗	1999		15	26	0.003925%	656752	96.97%	4	1.10%
棠	2130		12	22	0.003321%	656774	97.45%	4	1.10%
巢	2200		11	20	0.00302%	656794	97.67%	4	1.10%
焰	2397		12	16	0.002416%	656810	98.20%	4	1.10%
岷	2421		8	15	0.002265%	656825	98.26%	4	1.10%
篩	2489		16	14	0.002114%	656839	98.40%	4	1.10%
藕	2496		19	14	0.002114%	656853	98.42%	4	1.10%
寮	2587		15	12	0.001812%	656865	98.60%	4	1.10%
鈞	2623		12	12	0.001812%	656877	98.66%	4	1.10%
喫	2641		12	11	0.001661%	656888	98.69%	4	1.10%
鵬	2699		19	11	0.001661%	656899	98.79%	4	1.10%
吏	2704		6	10	0.00151%	656909	98.80%	4	1.10%
嗡	2707		13	10	0.00151%	656919	98.80%	4	1.10%
娼	2710		11	10	0.00151%	656929	98.81%	4	1.10%
鬍	2766		19	10	0.00151%	656939	98.89%	4	1.10%
汕	2796		6	9	0.001359%	656948	98.93%	4	1.10%
灸	2802		7	9	0.001359%	656957	98.94%	4	1.10%
秧	2815		10	9	0.001359%	656966	98.96%	4	1.10%
蒜	2831		14	9	0.001359%	656975	98.98%	4	1.10%
魏	2846		18	9	0.001359%	656984	99.00%	4	1.10%
兮	2854		4	8	0.001208%	656992	99.01%	4	1.10%
冉	2855		5	8	0.001208%	657000	99.01%	4	1.10%
劈	2859		15	8	0.001208%	657008	99.02%	4	1.10%
唧	2862		10	8	0.001208%	657016	99.02%	4	1.10%
廖	2880		14	8	0.001208%	657024	99.04%	4	1.10%
惦	2883		11	8	0.001208%	657032	99.05%	4	1.10%
押	2891		8	8	0.001208%	657040	99.06%	4	1.10%
檳	2900		18	8	0.001208%	657048	99.07%	4	1.10%
萍	2924		12	8	0.001208%	657056	99.10%	4	1.10%
鰹	2947		22	8	0.001208%	657064	99.12%	4	1.10%
黍	2949		12	8	0.001208%	657072	99.13%	4	1.10%
偎	2953		11	7	0.001057%	657079	99.13%	4	1.10%
厘	2956		9	7	0.001057%	657086	99.13%	4	1.10%
咪	2957		9	7	0.001057%	657093	99.13%	4	1.10%
嘛	2963		14	7	0.001057%	657100	99.14%	4	1.10%
噩	2964		16	7	0.001057%	657107	99.14%	4	1.10%
垮	2966		9	7	0.001057%	657114	99.14%	4	1.10%
姬	2971		10	7	0.001057%	657121	99.15%	4	1.10%
屠	2978		11	7	0.001057%	657128	99.16%	4	1.10%
	2980		8	7	0.001057%	657135	99.16%	4	1.10%
楂	2993		13	7	0.001057%	657142	99.17%	4	1.10%
澱	2999		16	7	0.001057%	657149	99.18%	4	1.10%
瘓	3015		14	7	0.001057%	657156	99.20%	4	1.10%
磺	3022		17	7	0.001057%	657163	99.20%	4	1.10%
禦	3023		16	7	0.001057%	657170	99.20%	4	1.10%
箋	3026		14	7	0.001057%	657177	99.21%	4	1.10%
舵	3040		11	7	0.001057%	657184	99.22%	4	1.10%
舷	3041		11	7	0.001057%	657191	99.22%	4	1.10%
踱	3055		16	7	0.001057%	657198	99.24%	4	1.10%
釁	3062		25	7	0.001057%	657205	99.25%	4	1.10%
驢	3068		26	7	0.001057%	657212	99.25%	4	1.10%
黝	3072		17	7	0.001057%	657219	99.26%	4	1.10%
侈	3075		8	6	0.0009059%	657225	99.26%	4	1.10%
侖	3076		8	6	0.0009059%	657231	99.26%	4	1.10%
傖	3079		12	6	0.0009059%	657237	99.26%	4	1.10%
	3086		6	6	0.0009059%	657243	99.27%	4	1.10%
吆	3087		6	6	0.0009059%	657249	99.27%	4	1.10%
恤	3109		9	6	0.0009059%	657255	99.29%	4	1.10%
惚	3112		11	6	0.0009059%	657261	99.29%	4	1.10%
榔	3124		13	6	0.0009059%	657267	99.30%	4	1.10%
榖	3128		14	6	0.0009059%	657273	99.31%	4	1.10%
	3129		17	6	0.0009059%	657279	99.31%	4	1.10%
氤	3133		10	6	0.0009059%	657285	99.31%	4	1.10%
氯	3134		12	6	0.0009059%	657291	99.31%	4	1.10%
汀	3135		5	6	0.0009059%	657297	99.31%	4	1.10%
汲	3136		7	6	0.0009059%	657303	99.31%	4	1.10%
浣	3139		10	6	0.0009059%	657309	99.32%	4	1.10%
睦	3153		13	6	0.0009059%	657315	99.33%	4	1.10%
祕	3157		9	6	0.0009059%	657321	99.33%	4	1.10%
秉	3159		8	6	0.0009059%	657327	99.34%	4	1.10%
穀	3160		15	6	0.0009059%	657333	99.34%	4	1.10%
籽	3164		9	6	0.0009059%	657339	99.34%	4	1.10%
絃	3165		11	6	0.0009059%	657345	99.34%	4	1.10%
緬	3169		15	6	0.0009059%	657351	99.34%	4	1.10%
缽	3171		11	6	0.0009059%	657357	99.35%	4	1.10%
胰	3174		10	6	0.0009059%	657363	99.35%	4	1.10%
薑	3179		17	6	0.0009059%	657369	99.35%	4	1.10%
雇	3196		12	6	0.0009059%	657375	99.37%	4	1.10%
鷹	3205		24	6	0.0009059%	657381	99.38%	4	1.10%
俠	3210		9	5	0.0007549%	657386	99.38%	4	1.10%
咆	3221		8	5	0.0007549%	657391	99.39%	4	1.10%
喂	3226		12	5	0.0007549%	657396	99.39%	4	1.10%
嗒	3231		13	5	0.0007549%	657401	99.40%	4	1.10%
噤	3232		16	5	0.0007549%	657406	99.40%	4	1.10%
嚕	3233		18	5	0.0007549%	657411	99.40%	4	1.10%
囿	3234		9	5	0.0007549%	657416	99.40%	4	1.10%
墟	3237		15	5	0.0007549%	657421	99.40%	4	1.10%
壟	3240		19	5	0.0007549%	657426	99.40%	4	1.10%
徙	3253		11	5	0.0007549%	657431	99.41%	4	1.10%
愫	3258		13	5	0.0007549%	657436	99.42%	4	1.10%
戕	3262		8	5	0.0007549%	657441	99.42%	4	1.10%
戳	3263		18	5	0.0007549%	657446	99.42%	4	1.10%
敊	3271		10	5	0.0007549%	657451	99.43%	4	1.10%
晦	3274		11	5	0.0007549%	657456	99.43%	4	1.10%
枷	3275		9	5	0.0007549%	657461	99.43%	4	1.10%
梭	3277		11	5	0.0007549%	657466	99.43%	4	1.10%
椏	3279		12	5	0.0007549%	657471	99.43%	4	1.10%
樊	3284		15	5	0.0007549%	657476	99.44%	4	1.10%
涅	3293		10	5	0.0007549%	657481	99.44%	4	1.10%
炊	3299		8	5	0.0007549%	657486	99.45%	4	1.10%
煎	3301		13	5	0.0007549%	657491	99.45%	4	1.10%
熙	3302		14	5	0.0007549%	657496	99.45%	4	1.10%
玆	3305		10	5	0.0007549%	657501	99.45%	4	1.10%
瑯	3306		13	5	0.0007549%	657506	99.45%	4	1.10%
痺	3308		13	5	0.0007549%	657511	99.45%	4	1.10%
瘤	3309		15	5	0.0007549%	657516	99.46%	4	1.10%
篷	3329		17	5	0.0007549%	657521	99.47%	4	1.10%
紳	3331		11	5	0.0007549%	657526	99.47%	4	1.10%
絮	3332		12	5	0.0007549%	657531	99.47%	4	1.10%
胚	3339		9	5	0.0007549%	657536	99.48%	4	1.10%
膏	3342		14	5	0.0007549%	657541	99.48%	4	1.10%
膺	3344		17	5	0.0007549%	657546	99.48%	4	1.10%
苑	3350		9	5	0.0007549%	657551	99.49%	4	1.10%
萣	3354		12	5	0.0007549%	657556	99.49%	4	1.10%
薯	3357		17	5	0.0007549%	657561	99.49%	4	1.10%
蜘	3360		14	5	0.0007549%	657566	99.49%	4	1.10%
褔	3364		14	5	0.0007549%	657571	99.50%	4	1.10%
諦	3367		16	5	0.0007549%	657576	99.50%	4	1.10%
諺	3368		16	5	0.0007549%	657581	99.50%	4	1.10%
謊	3369		17	5	0.0007549%	657586	99.50%	4	1.10%
躇	3373		19	5	0.0007549%	657591	99.50%	4	1.10%
酵	3380		14	5	0.0007549%	657596	99.51%	4	1.10%
鈔	3381		12	5	0.0007549%	657601	99.51%	4	1.10%
鍛	3384		17	5	0.0007549%	657606	99.51%	4	1.10%
鏈	3385		19	5	0.0007549%	657611	99.51%	4	1.10%
閭	3388		15	5	0.0007549%	657616	99.52%	4	1.10%
闌	3389		17	5	0.0007549%	657621	99.52%	4	1.10%
韶	3396		14	5	0.0007549%	657626	99.52%	4	1.10%
髯	3402		15	5	0.0007549%	657631	99.53%	4	1.10%
鶯	3405		21	5	0.0007549%	657636	99.53%	4	1.10%
黏	3407		17	5	0.0007549%	657641	99.53%	4	1.10%
佣	3409		7	4	0.0006039%	657645	99.53%	4	1.10%
凜	3417		15	4	0.0006039%	657649	99.54%	4	1.10%
凰	3418		11	4	0.0006039%	657653	99.54%	4	1.10%
厄	3421		4	4	0.0006039%	657657	99.54%	4	1.10%
吶	3422		7	4	0.0006039%	657661	99.54%	4	1.10%
哦	3426		10	4	0.0006039%	657665	99.54%	4	1.10%
囌	3435		23	4	0.0006039%	657669	99.55%	4	1.10%
垣	3437		9	4	0.0006039%	657673	99.55%	4	1.10%
妝	3442		7	4	0.0006039%	657677	99.55%	4	1.10%
孽	3443		20	4	0.0006039%	657681	99.55%	4	1.10%
峙	3448		9	4	0.0006039%	657685	99.55%	4	1.10%
崑	3449		11	4	0.0006039%	657689	99.55%	4	1.10%
嶇	3450		14	4	0.0006039%	657693	99.56%	4	1.10%
帘	3451		8	4	0.0006039%	657697	99.56%	4	1.10%
徜	3453		11	4	0.0006039%	657701	99.56%	4	1.10%
忖	3456		6	4	0.0006039%	657705	99.56%	4	1.10%
怵	3458		8	4	0.0006039%	657709	99.56%	4	1.10%
怠	3459		9	4	0.0006039%	657713	99.56%	4	1.10%
悼	3461		11	4	0.0006039%	657717	99.56%	4	1.10%
慇	3462		14	4	0.0006039%	657721	99.56%	4	1.10%
憊	3463		16	4	0.0006039%	657725	99.56%	4	1.10%
懦	3464		17	4	0.0006039%	657729	99.56%	4	1.10%
懿	3465		22	4	0.0006039%	657733	99.56%	4	1.10%
扼	3467		7	4	0.0006039%	657737	99.57%	4	1.10%
拐	3468		8	4	0.0006039%	657741	99.57%	4	1.10%
揣	3471		12	4	0.0006039%	657745	99.57%	4	1.10%
攬	3473		24	4	0.0006039%	657749	99.57%	4	1.10%
曙	3477		17	4	0.0006039%	657753	99.57%	4	1.10%
柬	3478		9	4	0.0006039%	657757	99.57%	4	1.10%
榷	3483		14	4	0.0006039%	657761	99.58%	4	1.10%
毆	3488		15	4	0.0006039%	657765	99.58%	4	1.10%
	3491		7	4	0.0006039%	657769	99.58%	4	1.10%
沽	3492		8	4	0.0006039%	657773	99.58%	4	1.10%
淌	3497		11	4	0.0006039%	657777	99.58%	4	1.10%
淮	3499		11	4	0.0006039%	657781	99.59%	4	1.10%
湃	3501		12	4	0.0006039%	657785	99.59%	4	1.10%
漳	3503		14	4	0.0006039%	657789	99.59%	4	1.10%
漓	3504		14	4	0.0006039%	657793	99.59%	4	1.10%
瀕	3507		19	4	0.0006039%	657797	99.59%	4	1.10%
炫	3508		9	4	0.0006039%	657801	99.59%	4	1.10%
熾	3512		16	4	0.0006039%	657805	99.59%	4	1.10%
犀	3513		12	4	0.0006039%	657809	99.59%	4	1.10%
獗	3514		15	4	0.0006039%	657813	99.59%	4	1.10%
瑩	3517		15	4	0.0006039%	657817	99.60%	4	1.10%
瘠	3524		15	4	0.0006039%	657821	99.60%	4	1.10%
瘴	3525		16	4	0.0006039%	657825	99.60%	4	1.10%
瞄	3530		14	4	0.0006039%	657829	99.60%	4	1.10%
矇	3533		19	4	0.0006039%	657833	99.61%	4	1.10%
砥	3535		10	4	0.0006039%	657837	99.61%	4	1.10%
磋	3536		15	4	0.0006039%	657841	99.61%	4	1.10%
祀	3537		7	4	0.0006039%	657845	99.61%	4	1.10%
穹	3538		8	4	0.0006039%	657849	99.61%	4	1.10%
竅	3539		18	4	0.0006039%	657853	99.61%	4	1.10%
竇	3540		20	4	0.0006039%	657857	99.61%	4	1.10%
緘	3544		15	4	0.0006039%	657861	99.61%	4	1.10%
緝	3545		15	4	0.0006039%	657865	99.61%	4	1.10%
繃	3547		17	4	0.0006039%	657869	99.61%	4	1.10%
縹	3548		17	4	0.0006039%	657873	99.61%	4	1.10%
腑	3553		12	4	0.0006039%	657877	99.62%	4	1.10%
臼	3555		6	4	0.0006039%	657881	99.62%	4	1.10%
芍	3556		7	4	0.0006039%	657885	99.62%	4	1.10%
芙	3557		8	4	0.0006039%	657889	99.62%	4	1.10%
荊	3558		10	4	0.0006039%	657893	99.62%	4	1.10%
蓊	3561		14	4	0.0006039%	657897	99.62%	4	1.10%
蔑	3562		15	4	0.0006039%	657901	99.62%	4	1.10%
蕾	3563		17	4	0.0006039%	657905	99.62%	4	1.10%
薦	3564		18	4	0.0006039%	657909	99.62%	4	1.10%
藹	3565		20	4	0.0006039%	657913	99.62%	4	1.10%
蜷	3566		14	4	0.0006039%	657917	99.63%	4	1.10%
蟹	3568		19	4	0.0006039%	657921	99.63%	4	1.10%
蠱	3569		23	4	0.0006039%	657925	99.63%	4	1.10%
褓	3572		14	4	0.0006039%	657929	99.63%	4	1.10%
訐	3573		10	4	0.0006039%	657933	99.63%	4	1.10%
訣	3574		11	4	0.0006039%	657937	99.63%	4	1.10%
謳	3577		18	4	0.0006039%	657941	99.63%	4	1.10%
貽	3581		12	4	0.0006039%	657945	99.63%	4	1.10%
跚	3583		12	4	0.0006039%	657949	99.64%	4	1.10%
踢	3584		15	4	0.0006039%	657953	99.64%	4	1.10%
蹄	3585		16	4	0.0006039%	657957	99.64%	4	1.10%
蹣	3587		18	4	0.0006039%	657961	99.64%	4	1.10%
蹬	3588		19	4	0.0006039%	657965	99.64%	4	1.10%
迂	3589		6	4	0.0006039%	657969	99.64%	4	1.10%
迺	3590		9	4	0.0006039%	657973	99.64%	4	1.10%
迸	3592		9	4	0.0006039%	657977	99.64%	4	1.10%
逍	3593		10	4	0.0006039%	657981	99.64%	4	1.10%
遨	3594		14	4	0.0006039%	657985	99.64%	4	1.10%
鏢	3601		19	4	0.0006039%	657989	99.65%	4	1.10%
闔	3602		18	4	0.0006039%	657993	99.65%	4	1.10%
骸	3609		16	4	0.0006039%	657997	99.65%	4	1.10%
骼	3610		16	4	0.0006039%	658001	99.65%	4	1.10%
髓	3611		23	4	0.0006039%	658005	99.65%	4	1.10%
髻	3612		16	4	0.0006039%	658009	99.65%	4	1.10%
鷗	3613		22	4	0.0006039%	658013	99.65%	4	1.10%
舅	1592		13	46	0.006945%	658059	94.86%	3	0.83%
璐	1856		17	31	0.00468%	658090	96.36%	3	0.83%
懋	1873		17	30	0.004529%	658120	96.43%	3	0.83%
彬	1905		11	29	0.004378%	658149	96.58%	3	0.83%
泌	2037		8	25	0.003774%	658174	97.12%	3	0.83%
楨	2282		13	18	0.002718%	658192	97.91%	3	0.83%
鮑	2309		16	18	0.002718%	658210	97.98%	3	0.83%
鮫	2414		17	16	0.002416%	658226	98.24%	3	0.83%
櫃	2428		18	15	0.002265%	658241	98.27%	3	0.83%
碳	2484		14	14	0.002114%	658255	98.39%	3	0.83%
妮	2583		8	12	0.001812%	658267	98.59%	3	0.83%
緯	2605		15	12	0.001812%	658279	98.63%	3	0.83%
榆	2659		13	11	0.001661%	658290	98.72%	3	0.83%
虱	2681		8	11	0.001661%	658301	98.76%	3	0.83%
褶	2684		16	11	0.001661%	658312	98.77%	3	0.83%
諜	2685		16	11	0.001661%	658323	98.77%	3	0.83%
輿	2688		17	11	0.001661%	658334	98.77%	3	0.83%
徽	2712		17	10	0.00151%	658344	98.81%	3	0.83%
柚	2722		9	10	0.00151%	658354	98.83%	3	0.83%
樵	2729		16	10	0.00151%	658364	98.84%	3	0.83%
籟	2744		22	10	0.00151%	658374	98.86%	3	0.83%
崔	2780		11	9	0.001359%	658383	98.91%	3	0.83%
氫	2795		11	9	0.001359%	658392	98.93%	3	0.83%
稜	2816		13	9	0.001359%	658401	98.96%	3	0.83%
簧	2818		18	9	0.001359%	658410	98.96%	3	0.83%
絹	2820		13	9	0.001359%	658419	98.97%	3	0.83%
茵	2828		10	9	0.001359%	658428	98.98%	3	0.83%
莓	2829		11	9	0.001359%	658437	98.98%	3	0.83%
斌	2896		12	8	0.001208%	658445	99.06%	3	0.83%
匙	2955		11	7	0.001057%	658452	99.13%	3	0.83%
哺	2961		10	7	0.001057%	658459	99.14%	3	0.83%
嫂	2974		12	7	0.001057%	658466	99.15%	3	0.83%
孱	2975		12	7	0.001057%	658473	99.15%	3	0.83%
尉	2977		11	7	0.001057%	658480	99.16%	3	0.83%
浬	2996		10	7	0.001057%	658487	99.18%	3	0.83%
粧	3029		12	7	0.001057%	658494	99.21%	3	0.83%
莘	3042		11	7	0.001057%	658501	99.22%	3	0.83%
莽	3043		11	7	0.001057%	658508	99.23%	3	0.83%
蒔	3045		14	7	0.001057%	658515	99.23%	3	0.83%
卉	3084		5	6	0.0009059%	658521	99.27%	3	0.83%
呎	3088		7	6	0.0009059%	658527	99.27%	3	0.83%
嚶	3096		20	6	0.0009059%	658533	99.28%	3	0.83%
塭	3101		13	6	0.0009059%	658539	99.28%	3	0.83%
孜	3105		7	6	0.0009059%	658545	99.29%	3	0.83%
	3107		10	6	0.0009059%	658551	99.29%	3	0.83%
斛	3120		11	6	0.0009059%	658557	99.30%	3	0.83%
楠	3125		13	6	0.0009059%	658563	99.30%	3	0.83%
楞	3126		13	6	0.0009059%	658569	99.31%	3	0.83%
槓	3127		14	6	0.0009059%	658575	99.31%	3	0.83%
涸	3141		11	6	0.0009059%	658581	99.32%	3	0.83%
芥	3176		8	6	0.0009059%	658587	99.35%	3	0.83%
荃	3178		10	6	0.0009059%	658593	99.35%	3	0.83%
裊	3181		13	6	0.0009059%	658599	99.36%	3	0.83%
靨	3201		23	6	0.0009059%	658605	99.37%	3	0.83%
靴	3202		13	6	0.0009059%	658611	99.37%	3	0.83%
餵	3203		17	6	0.0009059%	658617	99.37%	3	0.83%
鯖	3204		19	6	0.0009059%	658623	99.38%	3	0.83%
黴	3207		23	6	0.0009059%	658629	99.38%	3	0.83%
兌	3214		7	5	0.0007549%	658634	99.38%	3	0.83%
凈	3217		10	5	0.0007549%	658639	99.39%	3	0.83%
刁	3218		2	5	0.0007549%	658644	99.39%	3	0.83%
喲	3227		12	5	0.0007549%	658649	99.39%	3	0.83%
嗯	3229		13	5	0.0007549%	658654	99.40%	3	0.83%
墾	3238		16	5	0.0007549%	658659	99.40%	3	0.83%
墻	3239		16	5	0.0007549%	658664	99.40%	3	0.83%
彥	3251		9	5	0.0007549%	658669	99.41%	3	0.83%
悖	3256		10	5	0.0007549%	658674	99.42%	3	0.83%
拚	3265		8	5	0.0007549%	658679	99.42%	3	0.83%
拮	3266		9	5	0.0007549%	658684	99.42%	3	0.83%
斧	3273		8	5	0.0007549%	658689	99.43%	3	0.83%
椎	3278		12	5	0.0007549%	658694	99.43%	3	0.83%
椰	3280		13	5	0.0007549%	658699	99.43%	3	0.83%
榕	3282		14	5	0.0007549%	658704	99.44%	3	0.83%
欖	3285		25	5	0.0007549%	658709	99.44%	3	0.83%
毗	3286		9	5	0.0007549%	658714	99.44%	3	0.83%
沃	3289		7	5	0.0007549%	658719	99.44%	3	0.83%
涓	3292		10	5	0.0007549%	658724	99.44%	3	0.83%
砒	3317		9	5	0.0007549%	658729	99.46%	3	0.83%
硯	3318		12	5	0.0007549%	658734	99.46%	3	0.83%
篾	3328		17	5	0.0007549%	658739	99.47%	3	0.83%
翽	3336		19	5	0.0007549%	658744	99.48%	3	0.83%
膊	3343		14	5	0.0007549%	658749	99.48%	3	0.83%
臍	3346		18	5	0.0007549%	658754	99.48%	3	0.83%
芋	3348		7	5	0.0007549%	658759	99.49%	3	0.83%
芹	3349		8	5	0.0007549%	658764	99.49%	3	0.83%
葦	3355		13	5	0.0007549%	658769	99.49%	3	0.83%
蘸	3358		23	5	0.0007549%	658774	99.49%	3	0.83%
蛾	3359		13	5	0.0007549%	658779	99.49%	3	0.83%
蟆	3361		17	5	0.0007549%	658784	99.49%	3	0.83%
蠕	3362		20	5	0.0007549%	658789	99.50%	3	0.83%
褚	3363		13	5	0.0007549%	658794	99.50%	3	0.83%
詠	3365		12	5	0.0007549%	658799	99.50%	3	0.83%
詫	3366		13	5	0.0007549%	658804	99.50%	3	0.83%
逮	3377		11	5	0.0007549%	658809	99.51%	3	0.83%
	3387		23	5	0.0007549%	658814	99.51%	3	0.83%
雌	3393		14	5	0.0007549%	658819	99.52%	3	0.83%
韙	3395		18	5	0.0007549%	658824	99.52%	3	0.83%
飭	3397		12	5	0.0007549%	658829	99.52%	3	0.83%
駿	3399		17	5	0.0007549%	658834	99.52%	3	0.83%
丑	3408		4	4	0.0006039%	658838	99.53%	3	0.83%
佬	3410		8	4	0.0006039%	658842	99.53%	3	0.83%
侃	3411		8	4	0.0006039%	658846	99.53%	3	0.83%
	3416		6	4	0.0006039%	658850	99.53%	3	0.83%
哮	3425		10	4	0.0006039%	658854	99.54%	3	0.83%
哽	3427		10	4	0.0006039%	658858	99.54%	3	0.83%
嘔	3430		14	4	0.0006039%	658862	99.54%	3	0.83%
嘹	3431		15	4	0.0006039%	658866	99.54%	3	0.83%
噯	3433		16	4	0.0006039%	658870	99.55%	3	0.83%
噢	3434		16	4	0.0006039%	658874	99.55%	3	0.83%
垠	3436		9	4	0.0006039%	658878	99.55%	3	0.83%
壬	3440		4	4	0.0006039%	658882	99.55%	3	0.83%
尬	3445		7	4	0.0006039%	658886	99.55%	3	0.83%
尷	3446		17	4	0.0006039%	658890	99.55%	3	0.83%
徨	3454		12	4	0.0006039%	658894	99.56%	3	0.83%
徬	3455		13	4	0.0006039%	658898	99.56%	3	0.83%
	3469		8	4	0.0006039%	658902	99.57%	3	0.83%
攣	3472		23	4	0.0006039%	658906	99.57%	3	0.83%
旭	3474		6	4	0.0006039%	658910	99.57%	3	0.83%
晌	3475		10	4	0.0006039%	658914	99.57%	3	0.83%
梵	3481		11	4	0.0006039%	658918	99.57%	3	0.83%
榭	3484		14	4	0.0006039%	658922	99.58%	3	0.83%
櫚	3487		19	4	0.0006039%	658926	99.58%	3	0.83%
氳	3490		14	4	0.0006039%	658930	99.58%	3	0.83%
沮	3494		8	4	0.0006039%	658934	99.58%	3	0.83%
沬	3495		8	4	0.0006039%	658938	99.58%	3	0.83%
泯	3496		8	4	0.0006039%	658942	99.58%	3	0.83%
渥	3500		12	4	0.0006039%	658946	99.59%	3	0.83%
渝	3502		12	4	0.0006039%	658950	99.59%	3	0.83%
澹	3505		16	4	0.0006039%	658954	99.59%	3	0.83%
瀑	3506		18	4	0.0006039%	658958	99.59%	3	0.83%
烽	3509		11	4	0.0006039%	658962	99.59%	3	0.83%
熔	3511		14	4	0.0006039%	658966	99.59%	3	0.83%
瑤	3516		14	4	0.0006039%	658970	99.60%	3	0.83%
瑾	3518		15	4	0.0006039%	658974	99.60%	3	0.83%
疚	3519		8	4	0.0006039%	658978	99.60%	3	0.83%
疹	3520		10	4	0.0006039%	658982	99.60%	3	0.83%
痙	3521		12	4	0.0006039%	658986	99.60%	3	0.83%
瘧	3522		14	4	0.0006039%	658990	99.60%	3	0.83%
癆	3526		17	4	0.0006039%	658994	99.60%	3	0.83%
癖	3527		18	4	0.0006039%	658998	99.60%	3	0.83%
盂	3528		8	4	0.0006039%	659002	99.60%	3	0.83%
睫	3529		13	4	0.0006039%	659006	99.60%	3	0.83%
瞅	3531		14	4	0.0006039%	659010	99.60%	3	0.83%
瞌	3532		15	4	0.0006039%	659014	99.61%	3	0.83%
砰	3534		10	4	0.0006039%	659018	99.61%	3	0.83%
篡	3541		16	4	0.0006039%	659022	99.61%	3	0.83%
紉	3543		9	4	0.0006039%	659026	99.61%	3	0.83%
縈	3546		16	4	0.0006039%	659030	99.61%	3	0.83%
翳	3550		17	4	0.0006039%	659034	99.62%	3	0.83%
肘	3551		7	4	0.0006039%	659038	99.62%	3	0.83%
胳	3552		10	4	0.0006039%	659042	99.62%	3	0.83%
袱	3570		11	4	0.0006039%	659046	99.63%	3	0.83%
裘	3571		13	4	0.0006039%	659050	99.63%	3	0.83%
譴	3578		21	4	0.0006039%	659054	99.63%	3	0.83%
豌	3579		15	4	0.0006039%	659058	99.63%	3	0.83%
豹	3580		10	4	0.0006039%	659062	99.63%	3	0.83%
趟	3582		15	4	0.0006039%	659066	99.64%	3	0.83%
逅	3591		9	4	0.0006039%	659070	99.64%	3	0.83%
邂	3595		16	4	0.0006039%	659074	99.64%	3	0.83%
鄒	3596		12	4	0.0006039%	659078	99.64%	3	0.83%
銹	3599		15	4	0.0006039%	659082	99.65%	3	0.83%
隋	3603		11	4	0.0006039%	659086	99.65%	3	0.83%
雍	3604		13	4	0.0006039%	659090	99.65%	3	0.83%
霽	3605		22	4	0.0006039%	659094	99.65%	3	0.83%
齋	3615		17	4	0.0006039%	659098	99.66%	3	0.83%
齣	3616		20	4	0.0006039%	659102	99.66%	3	0.83%
亙	3617		6	3	0.0004529%	659105	99.66%	3	0.83%
亥	3618		6	3	0.0004529%	659108	99.66%	3	0.83%
伺	3621		7	3	0.0004529%	659111	99.66%	3	0.83%
侏	3622		8	3	0.0004529%	659114	99.66%	3	0.83%
俏	3623		9	3	0.0004529%	659117	99.66%	3	0.83%
侷	3624		9	3	0.0004529%	659120	99.66%	3	0.83%
倏	3626		11	3	0.0004529%	659123	99.66%	3	0.83%
傀	3627		12	3	0.0004529%	659126	99.66%	3	0.83%
僥	3629		14	3	0.0004529%	659129	99.66%	3	0.83%
儡	3631		17	3	0.0004529%	659132	99.66%	3	0.83%
兀	3632		3	3	0.0004529%	659135	99.66%	3	0.83%
勳	3635		16	3	0.0004529%	659138	99.66%	3	0.83%
匣	3638		7	3	0.0004529%	659141	99.67%	3	0.83%
厥	3639		12	3	0.0004529%	659144	99.67%	3	0.83%
吝	3640		7	3	0.0004529%	659147	99.67%	3	0.83%
唾	3644		12	3	0.0004529%	659150	99.67%	3	0.83%
喙	3645		12	3	0.0004529%	659153	99.67%	3	0.83%
噁	3648		15	3	0.0004529%	659156	99.67%	3	0.83%
噬	3650		16	3	0.0004529%	659159	99.67%	3	0.83%
嚥	3652		19	3	0.0004529%	659162	99.67%	3	0.83%
嚷	3653		20	3	0.0004529%	659165	99.67%	3	0.83%
囈	3654		22	3	0.0004529%	659168	99.67%	3	0.83%
坷	3656		8	3	0.0004529%	659171	99.67%	3	0.83%
坤	3657		8	3	0.0004529%	659174	99.67%	3	0.83%
垢	3659		9	3	0.0004529%	659177	99.68%	3	0.83%
埂	3660		10	3	0.0004529%	659180	99.68%	3	0.83%
奎	3661		9	3	0.0004529%	659183	99.68%	3	0.83%
妃	3662		6	3	0.0004529%	659186	99.68%	3	0.83%
妊	3663		7	3	0.0004529%	659189	99.68%	3	0.83%
姪	3664		9	3	0.0004529%	659192	99.68%	3	0.83%
孃	3669		20	3	0.0004529%	659195	99.68%	3	0.83%
孳	3670		12	3	0.0004529%	659198	99.68%	3	0.83%
孺	3671		17	3	0.0004529%	659201	99.68%	3	0.83%
寇	3672		11	3	0.0004529%	659204	99.68%	3	0.83%
屹	3673		6	3	0.0004529%	659207	99.68%	3	0.83%
巖	3677		23	3	0.0004529%	659210	99.68%	3	0.83%
幀	3679		12	3	0.0004529%	659213	99.68%	3	0.83%
弔	3681		4	3	0.0004529%	659216	99.69%	3	0.83%
彆	3682		14	3	0.0004529%	659219	99.69%	3	0.83%
御	3684		11	3	0.0004529%	659222	99.69%	3	0.83%
悚	3685		10	3	0.0004529%	659225	99.69%	3	0.83%
惰	3686		12	3	0.0004529%	659228	99.69%	3	0.83%
慬	3687		14	3	0.0004529%	659231	99.69%	3	0.83%
憚	3688		15	3	0.0004529%	659234	99.69%	3	0.83%
懃	3689		17	3	0.0004529%	659237	99.69%	3	0.83%
懣	3690		18	3	0.0004529%	659240	99.69%	3	0.83%
掄	3693		11	3	0.0004529%	659243	99.69%	3	0.83%
捩	3694		11	3	0.0004529%	659246	99.69%	3	0.83%
摟	3697		14	3	0.0004529%	659249	99.69%	3	0.83%
摻	3698		14	3	0.0004529%	659252	99.69%	3	0.83%
摹	3699		15	3	0.0004529%	659255	99.69%	3	0.83%
攘	3701		20	3	0.0004529%	659258	99.69%	3	0.83%
攫	3702		23	3	0.0004529%	659261	99.69%	3	0.83%
暉	3705		13	3	0.0004529%	659264	99.70%	3	0.83%
	3707		9	3	0.0004529%	659267	99.70%	3	0.83%
杞	3708		7	3	0.0004529%	659270	99.70%	3	0.83%
杳	3709		8	3	0.0004529%	659273	99.70%	3	0.83%
栓	3710		10	3	0.0004529%	659276	99.70%	3	0.83%
桎	3711		10	3	0.0004529%	659279	99.70%	3	0.83%
梏	3712		11	3	0.0004529%	659282	99.70%	3	0.83%
櫸	3718		21	3	0.0004529%	659285	99.70%	3	0.83%
沐	3720		7	3	0.0004529%	659288	99.70%	3	0.83%
涎	3722		11	3	0.0004529%	659291	99.70%	3	0.83%
湛	3723		12	3	0.0004529%	659294	99.70%	3	0.83%
湍	3725		12	3	0.0004529%	659297	99.71%	3	0.83%
湄	3726		12	3	0.0004529%	659300	99.71%	3	0.83%
溼	3727		13	3	0.0004529%	659303	99.71%	3	0.83%
滔	3728		13	3	0.0004529%	659306	99.71%	3	0.83%
潦	3729		15	3	0.0004529%	659309	99.71%	3	0.83%
瀝	3732		19	3	0.0004529%	659312	99.71%	3	0.83%
炳	3734		9	3	0.0004529%	659315	99.71%	3	0.83%
煦	3736		13	3	0.0004529%	659318	99.71%	3	0.83%
燉	3737		16	3	0.0004529%	659321	99.71%	3	0.83%
燼	3738		18	3	0.0004529%	659324	99.71%	3	0.83%
牟	3739		6	3	0.0004529%	659327	99.71%	3	0.83%
獷	3742		18	3	0.0004529%	659330	99.71%	3	0.83%
琳	3745		12	3	0.0004529%	659333	99.71%	3	0.83%
璧	3746		18	3	0.0004529%	659336	99.71%	3	0.83%
甩	3748		5	3	0.0004529%	659339	99.72%	3	0.83%
疋	3749		5	3	0.0004529%	659342	99.72%	3	0.83%
疤	3750		9	3	0.0004529%	659345	99.72%	3	0.83%
疸	3752		10	3	0.0004529%	659348	99.72%	3	0.83%
痢	3753		12	3	0.0004529%	659351	99.72%	3	0.83%
瞿	3758		18	3	0.0004529%	659354	99.72%	3	0.83%
矚	3759		26	3	0.0004529%	659357	99.72%	3	0.83%
砸	3761		10	3	0.0004529%	659360	99.72%	3	0.83%
磯	3764		17	3	0.0004529%	659363	99.72%	3	0.83%
礪	3765		20	3	0.0004529%	659366	99.72%	3	0.83%
祉	3766		8	3	0.0004529%	659369	99.72%	3	0.83%
秤	3768		10	3	0.0004529%	659372	99.72%	3	0.83%
窟	3770		13	3	0.0004529%	659375	99.73%	3	0.83%
窪	3771		14	3	0.0004529%	659378	99.73%	3	0.83%
筏	3774		12	3	0.0004529%	659381	99.73%	3	0.83%
篋	3777		15	3	0.0004529%	659384	99.73%	3	0.83%
粥	3779		12	3	0.0004529%	659387	99.73%	3	0.83%
糞	3782		17	3	0.0004529%	659390	99.73%	3	0.83%
糢	3783		17	3	0.0004529%	659393	99.73%	3	0.83%
緲	3784		15	3	0.0004529%	659396	99.73%	3	0.83%
繚	3785		18	3	0.0004529%	659399	99.73%	3	0.83%
辮	3786		20	3	0.0004529%	659402	99.73%	3	0.83%
纂	3787		20	3	0.0004529%	659405	99.73%	3	0.83%
羔	3789		10	3	0.0004529%	659408	99.73%	3	0.83%
翱	3790		16	3	0.0004529%	659411	99.73%	3	0.83%
肴	3792		8	3	0.0004529%	659414	99.74%	3	0.83%
胥	3793		9	3	0.0004529%	659417	99.74%	3	0.83%
胭	3794		10	3	0.0004529%	659420	99.74%	3	0.83%
脯	3795		11	3	0.0004529%	659423	99.74%	3	0.83%
脛	3796		11	3	0.0004529%	659426	99.74%	3	0.83%
腋	3797		12	3	0.0004529%	659429	99.74%	3	0.83%
臬	3799		10	3	0.0004529%	659432	99.74%	3	0.83%
菇	3805		12	3	0.0004529%	659435	99.74%	3	0.83%
蕊	3810		16	3	0.0004529%	659438	99.74%	3	0.83%
蕪	3811		16	3	0.0004529%	659441	99.74%	3	0.83%
藷	3813		19	3	0.0004529%	659444	99.75%	3	0.83%
蜒	3817		14	3	0.0004529%	659447	99.75%	3	0.83%
褥	3819		15	3	0.0004529%	659450	99.75%	3	0.83%
襪	3820		20	3	0.0004529%	659453	99.75%	3	0.83%
誡	3822		14	3	0.0004529%	659456	99.75%	3	0.83%
謁	3824		16	3	0.0004529%	659459	99.75%	3	0.83%
諳	3825		16	3	0.0004529%	659462	99.75%	3	0.83%
譎	3827		19	3	0.0004529%	659465	99.75%	3	0.83%
豢	3828		13	3	0.0004529%	659468	99.75%	3	0.83%
赭	3829		15	3	0.0004529%	659471	99.75%	3	0.83%
蹂	3830		16	3	0.0004529%	659474	99.75%	3	0.83%
踵	3831		16	3	0.0004529%	659477	99.75%	3	0.83%
蹶	3833		19	3	0.0004529%	659480	99.75%	3	0.83%
輊	3834		13	3	0.0004529%	659483	99.75%	3	0.83%
轅	3835		17	3	0.0004529%	659486	99.75%	3	0.83%
迤	3838		8	3	0.0004529%	659489	99.76%	3	0.83%
逡	3839		10	3	0.0004529%	659492	99.76%	3	0.83%
遽	3841		16	3	0.0004529%	659495	99.76%	3	0.83%
邃	3842		17	3	0.0004529%	659498	99.76%	3	0.83%
釧	3846		11	3	0.0004529%	659501	99.76%	3	0.83%
鈣	3847		12	3	0.0004529%	659504	99.76%	3	0.83%
鈿	3848		13	3	0.0004529%	659507	99.76%	3	0.83%
	3849		15	3	0.0004529%	659510	99.76%	3	0.83%
鑾	3853		27	3	0.0004529%	659513	99.76%	3	0.83%
閥	3854		14	3	0.0004529%	659516	99.76%	3	0.83%
隅	3857		11	3	0.0004529%	659519	99.76%	3	0.83%
隘	3858		12	3	0.0004529%	659522	99.77%	3	0.83%
霎	3859		16	3	0.0004529%	659525	99.77%	3	0.83%
霖	3860		16	3	0.0004529%	659528	99.77%	3	0.83%
颶	3862		17	3	0.0004529%	659531	99.77%	3	0.83%
餅	3863		14	3	0.0004529%	659534	99.77%	3	0.83%
駝	3865		15	3	0.0004529%	659537	99.77%	3	0.83%
鴛	3868		16	3	0.0004529%	659540	99.77%	3	0.83%
轆	1613		18	45	0.006794%	659585	95.00%	2	0.55%
轤	1614		23	45	0.006794%	659630	95.01%	2	0.55%
勘	1629		11	43	0.006492%	659673	95.11%	2	0.55%
鯉	2054		18	25	0.003774%	659698	97.18%	2	0.55%
皿	2071		5	24	0.003623%	659722	97.24%	2	0.55%
鱒	2192		23	21	0.003171%	659743	97.65%	2	0.55%
娣	2196		10	20	0.00302%	659763	97.66%	2	0.55%
濾	2395		18	16	0.002416%	659779	98.19%	2	0.55%
縵	2438		17	15	0.002265%	659794	98.30%	2	0.55%
鰻	2449		22	15	0.002265%	659809	98.32%	2	0.55%
祺	2485		12	14	0.002114%	659823	98.40%	2	0.55%
劾	2573		8	12	0.001812%	659835	98.57%	2	0.55%
淞	2663		11	11	0.001661%	659846	98.73%	2	0.55%
鱷	2697		27	11	0.001661%	659857	98.79%	2	0.55%
咚	2706		8	10	0.00151%	659867	98.80%	2	0.55%
蜻	2752		14	10	0.00151%	659877	98.87%	2	0.55%
芸	2826		8	9	0.001359%	659886	98.97%	2	0.55%
蛀	2835		11	9	0.001359%	659895	98.99%	2	0.55%
帥	2877		9	8	0.001208%	659903	99.04%	2	0.55%
桁	2898		10	8	0.001208%	659911	99.06%	2	0.55%
蠣	2928		21	8	0.001208%	659919	99.10%	2	0.55%
酋	2938		9	8	0.001208%	659927	99.11%	2	0.55%
倪	2952		10	7	0.001057%	659934	99.13%	2	0.55%
猝	3010		11	7	0.001057%	659941	99.19%	2	0.55%
琶	3011		12	7	0.001057%	659948	99.19%	2	0.55%
甄	3013		14	7	0.001057%	659955	99.19%	2	0.55%
簀	3027		17	7	0.001057%	659962	99.21%	2	0.55%
簪	3028		18	7	0.001057%	659969	99.21%	2	0.55%
	3030		14	7	0.001057%	659976	99.21%	2	0.55%
縴	3032		17	7	0.001057%	659983	99.21%	2	0.55%
噹	3094		16	6	0.0009059%	659989	99.28%	2	0.55%
檔	3130		17	6	0.0009059%	659995	99.31%	2	0.55%
淤	3140		11	6	0.0009059%	660001	99.32%	2	0.55%
禧	3158		16	6	0.0009059%	660007	99.33%	2	0.55%
裔	3180		13	6	0.0009059%	660013	99.35%	2	0.55%
啾	3228		12	5	0.0007549%	660018	99.39%	2	0.55%
嘟	3230		13	5	0.0007549%	660023	99.40%	2	0.55%
姘	3241		9	5	0.0007549%	660028	99.40%	2	0.55%
巳	3245		3	5	0.0007549%	660033	99.41%	2	0.55%
庵	3247		11	5	0.0007549%	660038	99.41%	2	0.55%
	3249		9	5	0.0007549%	660043	99.41%	2	0.55%
楯	3281		13	5	0.0007549%	660048	99.43%	2	0.55%
樟	3283		15	5	0.0007549%	660053	99.44%	2	0.55%
泅	3290		8	5	0.0007549%	660058	99.44%	2	0.55%
淇	3294		11	5	0.0007549%	660063	99.44%	2	0.55%
滷	3297		14	5	0.0007549%	660068	99.45%	2	0.55%
瑜	3307		13	5	0.0007549%	660073	99.45%	2	0.55%
礫	3320		20	5	0.0007549%	660078	99.46%	2	0.55%
禎	3321		13	5	0.0007549%	660083	99.46%	2	0.55%
窖	3323		12	5	0.0007549%	660088	99.47%	2	0.55%
箇	3326		14	5	0.0007549%	660093	99.47%	2	0.55%
肛	3338		7	5	0.0007549%	660098	99.48%	2	0.55%
胱	3340		10	5	0.0007549%	660103	99.48%	2	0.55%
臧	3347		14	5	0.0007549%	660108	99.48%	2	0.55%
茗	3352		10	5	0.0007549%	660113	99.49%	2	0.55%
贓	3372		21	5	0.0007549%	660118	99.50%	2	0.55%
鐲	3386		21	5	0.0007549%	660123	99.51%	2	0.55%
驛	3401		23	5	0.0007549%	660128	99.53%	2	0.55%
麴	3406		19	5	0.0007549%	660133	99.53%	2	0.55%
佼	3412		8	4	0.0006039%	660137	99.53%	2	0.55%
倔	3413		10	4	0.0006039%	660141	99.53%	2	0.55%
兢	3414		14	4	0.0006039%	660145	99.53%	2	0.55%
冗	3415		4	4	0.0006039%	660149	99.53%	2	0.55%
	3420		8	4	0.0006039%	660153	99.54%	2	0.55%
吠	3423		7	4	0.0006039%	660157	99.54%	2	0.55%
唏	3428		10	4	0.0006039%	660161	99.54%	2	0.55%
嗇	3429		13	4	0.0006039%	660165	99.54%	2	0.55%
壑	3439		17	4	0.0006039%	660169	99.55%	2	0.55%
壼	3441		13	4	0.0006039%	660173	99.55%	2	0.55%
	3444		15	4	0.0006039%	660177	99.55%	2	0.55%
屎	3447		9	4	0.0006039%	660181	99.55%	2	0.55%
廛	3452		15	4	0.0006039%	660185	99.56%	2	0.55%
怏	3457		8	4	0.0006039%	660189	99.56%	2	0.55%
恂	3460		9	4	0.0006039%	660193	99.56%	2	0.55%
戍	3466		6	4	0.0006039%	660197	99.57%	2	0.55%
揍	3470		12	4	0.0006039%	660201	99.57%	2	0.55%
栩	3479		10	4	0.0006039%	660205	99.57%	2	0.55%
栖	3480		10	4	0.0006039%	660209	99.57%	2	0.55%
橄	3485		16	4	0.0006039%	660213	99.58%	2	0.55%
泓	3493		8	4	0.0006039%	660217	99.58%	2	0.55%
淅	3498		11	4	0.0006039%	660221	99.58%	2	0.55%
	3510		13	4	0.0006039%	660225	99.59%	2	0.55%
琤	3515		12	4	0.0006039%	660229	99.59%	2	0.55%
簌	3542		17	4	0.0006039%	660233	99.61%	2	0.55%
羹	3549		19	4	0.0006039%	660237	99.62%	2	0.55%
菸	3559		12	4	0.0006039%	660241	99.62%	2	0.55%
蓆	3560		14	4	0.0006039%	660245	99.62%	2	0.55%
螞	3567		16	4	0.0006039%	660249	99.63%	2	0.55%
訥	3575		11	4	0.0006039%	660253	99.63%	2	0.55%
諄	3576		15	4	0.0006039%	660257	99.63%	2	0.55%
踽	3586		16	4	0.0006039%	660261	99.64%	2	0.55%
酗	3597		11	4	0.0006039%	660265	99.64%	2	0.55%
鉋	3598		13	4	0.0006039%	660269	99.64%	2	0.55%
錡	3600		16	4	0.0006039%	660273	99.65%	2	0.55%
颯	3606		14	4	0.0006039%	660277	99.65%	2	0.55%
饅	3607		19	4	0.0006039%	660281	99.65%	2	0.55%
馭	3608		12	4	0.0006039%	660285	99.65%	2	0.55%
黛	3614		17	4	0.0006039%	660289	99.65%	2	0.55%
偌	3625		11	3	0.0004529%	660292	99.66%	2	0.55%
僂	3628		13	3	0.0004529%	660295	99.66%	2	0.55%
儈	3630		15	3	0.0004529%	660298	99.66%	2	0.55%
冽	3633		8	3	0.0004529%	660301	99.66%	2	0.55%
剃	3634		9	3	0.0004529%	660304	99.66%	2	0.55%
勺	3636		3	3	0.0004529%	660307	99.66%	2	0.55%
匈	3637		6	3	0.0004529%	660310	99.67%	2	0.55%
吩	3641		7	3	0.0004529%	660313	99.67%	2	0.55%
唔	3642		10	3	0.0004529%	660316	99.67%	2	0.55%
喋	3643		12	3	0.0004529%	660319	99.67%	2	0.55%
嗟	3646		13	3	0.0004529%	660322	99.67%	2	0.55%
嗔	3647		13	3	0.0004529%	660325	99.67%	2	0.55%
嚏	3651		17	3	0.0004529%	660328	99.67%	2	0.55%
	3655		7	3	0.0004529%	660331	99.67%	2	0.55%
婿	3665		12	3	0.0004529%	660334	99.68%	2	0.55%
嫦	3666		14	3	0.0004529%	660337	99.68%	2	0.55%
嫻	3667		15	3	0.0004529%	660340	99.68%	2	0.55%
嬝	3668		16	3	0.0004529%	660343	99.68%	2	0.55%
峭	3674		10	3	0.0004529%	660346	99.68%	2	0.55%
嵐	3675		12	3	0.0004529%	660349	99.68%	2	0.55%
嵋	3676		12	3	0.0004529%	660352	99.68%	2	0.55%
帕	3678		8	3	0.0004529%	660355	99.68%	2	0.55%
异	3680		6	3	0.0004529%	660358	99.68%	2	0.55%
彪	3683		11	3	0.0004529%	660361	99.69%	2	0.55%
扳	3691		7	3	0.0004529%	660364	99.69%	2	0.55%
拇	3692		8	3	0.0004529%	660367	99.69%	2	0.55%
捶	3695		12	3	0.0004529%	660370	99.69%	2	0.55%
搾	3696		13	3	0.0004529%	660373	99.69%	2	0.55%
晏	3703		10	3	0.0004529%	660376	99.70%	2	0.55%
晢	3704		11	3	0.0004529%	660379	99.70%	2	0.55%
楫	3714		13	3	0.0004529%	660382	99.70%	2	0.55%
楹	3715		13	3	0.0004529%	660385	99.70%	2	0.55%
橙	3717		16	3	0.0004529%	660388	99.70%	2	0.55%
沁	3719		7	3	0.0004529%	660391	99.70%	2	0.55%
湘	3724		12	3	0.0004529%	660394	99.70%	2	0.55%
灩	3733		31	3	0.0004529%	660397	99.71%	2	0.55%
炬	3735		9	3	0.0004529%	660400	99.71%	2	0.55%
獃	3741		14	3	0.0004529%	660403	99.71%	2	0.55%
琅	3744		11	3	0.0004529%	660406	99.71%	2	0.55%
疥	3751		9	3	0.0004529%	660409	99.72%	2	0.55%
瘀	3755		13	3	0.0004529%	660412	99.72%	2	0.55%
癩	3756		21	3	0.0004529%	660415	99.72%	2	0.55%
皈	3757		9	3	0.0004529%	660418	99.72%	2	0.55%
禾	3767		5	3	0.0004529%	660421	99.72%	2	0.55%
穗	3769		17	3	0.0004529%	660424	99.73%	2	0.55%
笆	3772		10	3	0.0004529%	660427	99.73%	2	0.55%
笠	3773		11	3	0.0004529%	660430	99.73%	2	0.55%
筵	3775		14	3	0.0004529%	660433	99.73%	2	0.55%
箍	3776		14	3	0.0004529%	660436	99.73%	2	0.55%
粟	3778		12	3	0.0004529%	660439	99.73%	2	0.55%
粽	3780		14	3	0.0004529%	660442	99.73%	2	0.55%
糜	3781		17	3	0.0004529%	660445	99.73%	2	0.55%
纜	3788		27	3	0.0004529%	660448	99.73%	2	0.55%
耽	3791		10	3	0.0004529%	660451	99.74%	2	0.55%
苓	3802		9	3	0.0004529%	660454	99.74%	2	0.55%
苡	3803		9	3	0.0004529%	660457	99.74%	2	0.55%
萼	3806		13	3	0.0004529%	660460	99.74%	2	0.55%
葺	3808		13	3	0.0004529%	660463	99.74%	2	0.55%
蓉	3809		14	3	0.0004529%	660466	99.74%	2	0.55%
薏	3812		17	3	0.0004529%	660469	99.74%	2	0.55%
蚌	3814		10	3	0.0004529%	660472	99.75%	2	0.55%
蚕	3815		10	3	0.0004529%	660475	99.75%	2	0.55%
訛	3821		11	3	0.0004529%	660478	99.75%	2	0.55%
誨	3823		14	3	0.0004529%	660481	99.75%	2	0.55%
諤	3826		16	3	0.0004529%	660484	99.75%	2	0.55%
蹦	3832		18	3	0.0004529%	660487	99.75%	2	0.55%
辟	3836		13	3	0.0004529%	660490	99.76%	2	0.55%
迢	3837		8	3	0.0004529%	660493	99.76%	2	0.55%
遏	3840		12	3	0.0004529%	660496	99.76%	2	0.55%
邈	3843		17	3	0.0004529%	660499	99.76%	2	0.55%
醺	3845		21	3	0.0004529%	660502	99.76%	2	0.55%
鏘	3851		19	3	0.0004529%	660505	99.76%	2	0.55%
鏽	3852		20	3	0.0004529%	660508	99.76%	2	0.55%
閤	3855		14	3	0.0004529%	660511	99.76%	2	0.55%
阮	3856		6	3	0.0004529%	660514	99.76%	2	0.55%
靉	3861		25	3	0.0004529%	660517	99.77%	2	0.55%
黔	3870		16	3	0.0004529%	660520	99.77%	2	0.55%
鼾	3872		17	3	0.0004529%	660523	99.77%	2	0.55%
丐	3873		4	2	0.000302%	660525	99.77%	2	0.55%
丕	3874		5	2	0.000302%	660527	99.77%	2	0.55%
丞	3875		6	2	0.000302%	660529	99.77%	2	0.55%
丰	3876		4	2	0.000302%	660531	99.77%	2	0.55%
仕	3877		5	2	0.000302%	660533	99.77%	2	0.55%
伽	3878		7	2	0.000302%	660535	99.77%	2	0.55%
佃	3879		7	2	0.000302%	660537	99.77%	2	0.55%
俑	3881		9	2	0.000302%	660539	99.77%	2	0.55%
俐	3882		9	2	0.000302%	660541	99.77%	2	0.55%
俚	3883		9	2	0.000302%	660543	99.78%	2	0.55%
俳	3884		10	2	0.000302%	660545	99.78%	2	0.55%
僮	3886		14	2	0.000302%	660547	99.78%	2	0.55%
僚	3887		14	2	0.000302%	660549	99.78%	2	0.55%
僕	3888		14	2	0.000302%	660551	99.78%	2	0.55%
儷	3889		21	2	0.000302%	660553	99.78%	2	0.55%
凶	3890		4	2	0.000302%	660555	99.78%	2	0.55%
刪	3891		7	2	0.000302%	660557	99.78%	2	0.55%
刨	3892		7	2	0.000302%	660559	99.78%	2	0.55%
剡	3893		10	2	0.000302%	660561	99.78%	2	0.55%
劭	3894		7	2	0.000302%	660563	99.78%	2	0.55%
匝	3895		5	2	0.000302%	660565	99.78%	2	0.55%
叨	3896		5	2	0.000302%	660567	99.78%	2	0.55%
吭	3897		7	2	0.000302%	660569	99.78%	2	0.55%
哎	3902		9	2	0.000302%	660571	99.78%	2	0.55%
啄	3907		11	2	0.000302%	660573	99.78%	2	0.55%
唬	3908		11	2	0.000302%	660575	99.78%	2	0.55%
唳	3909		11	2	0.000302%	660577	99.78%	2	0.55%
啻	3910		12	2	0.000302%	660579	99.78%	2	0.55%
喔	3911		12	2	0.000302%	660581	99.78%	2	0.55%
嗨	3913		13	2	0.000302%	660583	99.78%	2	0.55%
嗦	3914		13	2	0.000302%	660585	99.78%	2	0.55%
嗄	3915		13	2	0.000302%	660587	99.78%	2	0.55%
噓	3917		15	2	0.000302%	660589	99.79%	2	0.55%
嚎	3918		17	2	0.000302%	660591	99.79%	2	0.55%
嚙	3920		18	2	0.000302%	660593	99.79%	2	0.55%
嚨	3921		20	2	0.000302%	660595	99.79%	2	0.55%
囫	3922		7	2	0.000302%	660597	99.79%	2	0.55%
圇	3923		11	2	0.000302%	660599	99.79%	2	0.55%
圮	3924		6	2	0.000302%	660601	99.79%	2	0.55%
	3925		7	2	0.000302%	660603	99.79%	2	0.55%
堿	3927		12	2	0.000302%	660605	99.79%	2	0.55%
壕	3929		17	2	0.000302%	660607	99.79%	2	0.55%
妾	3932		8	2	0.000302%	660609	99.79%	2	0.55%
姦	3936		9	2	0.000302%	660611	99.79%	2	0.55%
娑	3937		10	2	0.000302%	660613	99.79%	2	0.55%
娠	3939		10	2	0.000302%	660615	99.79%	2	0.55%
娉	3940		10	2	0.000302%	660617	99.79%	2	0.55%
婪	3941		11	2	0.000302%	660619	99.79%	2	0.55%
媲	3942		13	2	0.000302%	660621	99.79%	2	0.55%
嫵	3944		15	2	0.000302%	660623	99.79%	2	0.55%
嬴	3945		16	2	0.000302%	660625	99.79%	2	0.55%
孛	3947		7	2	0.000302%	660627	99.79%	2	0.55%
孰	3948		11	2	0.000302%	660629	99.79%	2	0.55%
宦	3950		9	2	0.000302%	660631	99.80%	2	0.55%
寨	3951		14	2	0.000302%	660633	99.80%	2	0.55%
寰	3952		16	2	0.000302%	660635	99.80%	2	0.55%
屐	3954		10	2	0.000302%	660637	99.80%	2	0.55%
屯	3955		4	2	0.000302%	660639	99.80%	2	0.55%
岑	3956		7	2	0.000302%	660641	99.80%	2	0.55%
岫	3957		8	2	0.000302%	660643	99.80%	2	0.55%
峋	3958		9	2	0.000302%	660645	99.80%	2	0.55%
崛	3959		11	2	0.000302%	660647	99.80%	2	0.55%
嶙	3960		15	2	0.000302%	660649	99.80%	2	0.55%
帷	3963		11	2	0.000302%	660651	99.80%	2	0.55%
幛	3964		14	2	0.000302%	660653	99.80%	2	0.55%
幔	3965		14	2	0.000302%	660655	99.80%	2	0.55%
廬	3967		19	2	0.000302%	660657	99.80%	2	0.55%
弁	3968		5	2	0.000302%	660659	99.80%	2	0.55%
弒	3970		13	2	0.000302%	660661	99.80%	2	0.55%
弩	3971		8	2	0.000302%	660663	99.80%	2	0.55%
弭	3972		9	2	0.000302%	660665	99.80%	2	0.55%
彗	3973		11	2	0.000302%	660667	99.80%	2	0.55%
徠	3974		11	2	0.000302%	660669	99.80%	2	0.55%
徼	3975		16	2	0.000302%	660671	99.80%	2	0.55%
忪	3976		7	2	0.000302%	660673	99.80%	2	0.55%
恪	3979		9	2	0.000302%	660675	99.80%	2	0.55%
恣	3980		10	2	0.000302%	660677	99.80%	2	0.55%
惺	3982		12	2	0.000302%	660679	99.80%	2	0.55%
懾	3986		21	2	0.000302%	660681	99.81%	2	0.55%
戡	3987		13	2	0.000302%	660683	99.81%	2	0.55%
戢	3988		13	2	0.000302%	660685	99.81%	2	0.55%
戾	3989		8	2	0.000302%	660687	99.81%	2	0.55%
抉	3990		7	2	0.000302%	660689	99.81%	2	0.55%
拯	3991		9	2	0.000302%	660691	99.81%	2	0.55%
挐	3993		10	2	0.000302%	660693	99.81%	2	0.55%
掬	3994		11	2	0.000302%	660695	99.81%	2	0.55%
据	3995		11	2	0.000302%	660697	99.81%	2	0.55%
揆	3996		12	2	0.000302%	660699	99.81%	2	0.55%
揖	3997		12	2	0.000302%	660701	99.81%	2	0.55%
摭	3998		14	2	0.000302%	660703	99.81%	2	0.55%
	4000		16	2	0.000302%	660705	99.81%	2	0.55%
擘	4001		17	2	0.000302%	660707	99.81%	2	0.55%
擢	4002		17	2	0.000302%	660709	99.81%	2	0.55%
擯	4003		17	2	0.000302%	660711	99.81%	2	0.55%
擻	4004		18	2	0.000302%	660713	99.81%	2	0.55%
斂	4005		17	2	0.000302%	660715	99.81%	2	0.55%
昊	4006		8	2	0.000302%	660717	99.81%	2	0.55%
曇	4007		16	2	0.000302%	660719	99.81%	2	0.55%
曝	4008		19	2	0.000302%	660721	99.81%	2	0.55%
杓	4009		7	2	0.000302%	660723	99.81%	2	0.55%
杷	4010		8	2	0.000302%	660725	99.81%	2	0.55%
杵	4011		8	2	0.000302%	660727	99.81%	2	0.55%
枒	4012		8	2	0.000302%	660729	99.81%	2	0.55%
楝	4014		13	2	0.000302%	660731	99.81%	2	0.55%
楸	4015		13	2	0.000302%	660733	99.81%	2	0.55%
榨	4016		14	2	0.000302%	660735	99.82%	2	0.55%
槁	4017		14	2	0.000302%	660737	99.82%	2	0.55%
槐	4018		14	2	0.000302%	660739	99.82%	2	0.55%
榦	4019		14	2	0.000302%	660741	99.82%	2	0.55%
槎	4020		14	2	0.000302%	660743	99.82%	2	0.55%
槳	4022		15	2	0.000302%	660745	99.82%	2	0.55%
樽	4023		16	2	0.000302%	660747	99.82%	2	0.55%
檬	4024		18	2	0.000302%	660749	99.82%	2	0.55%
檸	4025		18	2	0.000302%	660751	99.82%	2	0.55%
歛	4028		17	2	0.000302%	660753	99.82%	2	0.55%
殮	4029		17	2	0.000302%	660755	99.82%	2	0.55%
殲	4030		21	2	0.000302%	660757	99.82%	2	0.55%
毓	4031		13	2	0.000302%	660759	99.82%	2	0.55%
氮	4032		12	2	0.000302%	660761	99.82%	2	0.55%
氾	4033		5	2	0.000302%	660763	99.82%	2	0.55%
沌	4034		7	2	0.000302%	660765	99.82%	2	0.55%
汶	4035		7	2	0.000302%	660767	99.82%	2	0.55%
沏	4036		7	2	0.000302%	660769	99.82%	2	0.55%
泗	4037		8	2	0.000302%	660771	99.82%	2	0.55%
淳	4038		11	2	0.000302%	660773	99.82%	2	0.55%
淩	4040		11	2	0.000302%	660775	99.82%	2	0.55%
淍	4041		11	2	0.000302%	660777	99.82%	2	0.55%
湎	4042		12	2	0.000302%	660779	99.82%	2	0.55%
滸	4044		14	2	0.000302%	660781	99.82%	2	0.55%
濘	4046		17	2	0.000302%	660783	99.82%	2	0.55%
濯	4047		17	2	0.000302%	660785	99.82%	2	0.55%
瀋	4048		18	2	0.000302%	660787	99.82%	2	0.55%
瀲	4051		20	2	0.000302%	660789	99.83%	2	0.55%
煜	4054		13	2	0.000302%	660791	99.83%	2	0.55%
熨	4055		15	2	0.000302%	660793	99.83%	2	0.55%
燬	4056		17	2	0.000302%	660795	99.83%	2	0.55%
燠	4057		17	2	0.000302%	660797	99.83%	2	0.55%
爹	4058		10	2	0.000302%	660799	99.83%	2	0.55%
狡	4061		9	2	0.000302%	660801	99.83%	2	0.55%
狽	4062		10	2	0.000302%	660803	99.83%	2	0.55%
狸	4063		10	2	0.000302%	660805	99.83%	2	0.55%
猥	4064		12	2	0.000302%	660807	99.83%	2	0.55%
猷	4065		13	2	0.000302%	660809	99.83%	2	0.55%
獰	4066		17	2	0.000302%	660811	99.83%	2	0.55%
玳	4067		9	2	0.000302%	660813	99.83%	2	0.55%
珮	4068		10	2	0.000302%	660815	99.83%	2	0.55%
瑕	4069		13	2	0.000302%	660817	99.83%	2	0.55%
瑁	4070		13	2	0.000302%	660819	99.83%	2	0.55%
璞	4071		16	2	0.000302%	660821	99.83%	2	0.55%
甑	4073		17	2	0.000302%	660823	99.83%	2	0.55%
畝	4074		10	2	0.000302%	660825	99.83%	2	0.55%
畦	4075		11	2	0.000302%	660827	99.83%	2	0.55%
疙	4076		8	2	0.000302%	660829	99.83%	2	0.55%
瘁	4079		13	2	0.000302%	660831	99.83%	2	0.55%
瘖	4080		14	2	0.000302%	660833	99.83%	2	0.55%
瘟	4081		15	2	0.000302%	660835	99.83%	2	0.55%
癤	4082		18	2	0.000302%	660837	99.84%	2	0.55%
盍	4085		10	2	0.000302%	660839	99.84%	2	0.55%
盹	4086		9	2	0.000302%	660841	99.84%	2	0.55%
睨	4089		13	2	0.000302%	660843	99.84%	2	0.55%
睿	4090		14	2	0.000302%	660845	99.84%	2	0.55%
矓	4091		21	2	0.000302%	660847	99.84%	2	0.55%
矽	4092		8	2	0.000302%	660849	99.84%	2	0.55%
硝	4094		12	2	0.000302%	660851	99.84%	2	0.55%
碘	4096		13	2	0.000302%	660853	99.84%	2	0.55%
碓	4097		13	2	0.000302%	660855	99.84%	2	0.55%
磕	4099		15	2	0.000302%	660857	99.84%	2	0.55%
磷	4100		17	2	0.000302%	660859	99.84%	2	0.55%
禺	4103		9	2	0.000302%	660861	99.84%	2	0.55%
稔	4104		13	2	0.000302%	660863	99.84%	2	0.55%
窘	4106		12	2	0.000302%	660865	99.84%	2	0.55%
笈	4107		10	2	0.000302%	660867	99.84%	2	0.55%
筲	4108		13	2	0.000302%	660869	99.84%	2	0.55%
箴	4109		15	2	0.000302%	660871	99.84%	2	0.55%
篆	4110		15	2	0.000302%	660873	99.84%	2	0.55%
簋	4111		17	2	0.000302%	660875	99.84%	2	0.55%
粲	4113		13	2	0.000302%	660877	99.84%	2	0.55%
紆	4114		9	2	0.000302%	660879	99.84%	2	0.55%
絆	4115		11	2	0.000302%	660881	99.85%	2	0.55%
絳	4116		12	2	0.000302%	660883	99.85%	2	0.55%
緋	4117		14	2	0.000302%	660885	99.85%	2	0.55%
縝	4118		16	2	0.000302%	660887	99.85%	2	0.55%
罟	4119		10	2	0.000302%	660889	99.85%	2	0.55%
羸	4121		19	2	0.000302%	660891	99.85%	2	0.55%
翎	4122		11	2	0.000302%	660893	99.85%	2	0.55%
聒	4125		12	2	0.000302%	660895	99.85%	2	0.55%
肫	4126		8	2	0.000302%	660897	99.85%	2	0.55%
肪	4127		8	2	0.000302%	660899	99.85%	2	0.55%
胺	4128		10	2	0.000302%	660901	99.85%	2	0.55%
膛	4129		15	2	0.000302%	660903	99.85%	2	0.55%
膾	4131		17	2	0.000302%	660905	99.85%	2	0.55%
舜	4134		12	2	0.000302%	660907	99.85%	2	0.55%
舫	4135		10	2	0.000302%	660909	99.85%	2	0.55%
舨	4136		10	2	0.000302%	660911	99.85%	2	0.55%
苜	4138		9	2	0.000302%	660913	99.85%	2	0.55%
荔	4140		10	2	0.000302%	660915	99.85%	2	0.55%
茹	4141		10	2	0.000302%	660917	99.85%	2	0.55%
莞	4143		11	2	0.000302%	660919	99.85%	2	0.55%
荼	4144		11	2	0.000302%	660921	99.85%	2	0.55%
菁	4147		12	2	0.000302%	660923	99.85%	2	0.55%
葷	4148		13	2	0.000302%	660925	99.86%	2	0.55%
葵	4149		13	2	0.000302%	660927	99.86%	2	0.55%
蒐	4150		14	2	0.000302%	660929	99.86%	2	0.55%
蔥	4151		15	2	0.000302%	660931	99.86%	2	0.55%
蕙	4153		16	2	0.000302%	660933	99.86%	2	0.55%
薈	4154		17	2	0.000302%	660935	99.86%	2	0.55%
虜	4155		13	2	0.000302%	660937	99.86%	2	0.55%
	4156		7	2	0.000302%	660939	99.86%	2	0.55%
蛆	4158		11	2	0.000302%	660941	99.86%	2	0.55%
蜿	4160		14	2	0.000302%	660943	99.86%	2	0.55%
蜚	4161		14	2	0.000302%	660945	99.86%	2	0.55%
蝟	4164		15	2	0.000302%	660947	99.86%	2	0.55%
螃	4166		16	2	0.000302%	660949	99.86%	2	0.55%
袪	4167		10	2	0.000302%	660951	99.86%	2	0.55%
裴	4168		13	2	0.000302%	660953	99.86%	2	0.55%
裾	4169		13	2	0.000302%	660955	99.86%	2	0.55%
褸	4170		16	2	0.000302%	660957	99.86%	2	0.55%
褵	4171		16	2	0.000302%	660959	99.86%	2	0.55%
襁	4172		16	2	0.000302%	660961	99.86%	2	0.55%
褻	4173		17	2	0.000302%	660963	99.86%	2	0.55%
觴	4174		18	2	0.000302%	660965	99.86%	2	0.55%
訟	4175		11	2	0.000302%	660967	99.86%	2	0.55%
詛	4177		12	2	0.000302%	660969	99.86%	2	0.55%
詰	4178		13	2	0.000302%	660971	99.86%	2	0.55%
誣	4179		14	2	0.000302%	660973	99.86%	2	0.55%
誚	4180		14	2	0.000302%	660975	99.86%	2	0.55%
誹	4181		15	2	0.000302%	660977	99.87%	2	0.55%
諮	4183		16	2	0.000302%	660979	99.87%	2	0.55%
諢	4184		16	2	0.000302%	660981	99.87%	2	0.55%
謗	4185		17	2	0.000302%	660983	99.87%	2	0.55%
貳	4188		12	2	0.000302%	660985	99.87%	2	0.55%
賸	4190		17	2	0.000302%	660987	99.87%	2	0.55%
跋	4191		12	2	0.000302%	660989	99.87%	2	0.55%
踝	4194		15	2	0.000302%	660991	99.87%	2	0.55%
踴	4195		16	2	0.000302%	660993	99.87%	2	0.55%
踰	4196		16	2	0.000302%	660995	99.87%	2	0.55%
蹊	4197		17	2	0.000302%	660997	99.87%	2	0.55%
蹕	4199		18	2	0.000302%	660999	99.87%	2	0.55%
蹴	4200		19	2	0.000302%	661001	99.87%	2	0.55%
蹻	4201		19	2	0.000302%	661003	99.87%	2	0.55%
躝	4204		24	2	0.000302%	661005	99.87%	2	0.55%
軾	4205		13	2	0.000302%	661007	99.87%	2	0.55%
輓	4206		14	2	0.000302%	661009	99.87%	2	0.55%
迭	4210		8	2	0.000302%	661011	99.87%	2	0.55%
遴	4211		15	2	0.000302%	661013	99.87%	2	0.55%
邇	4212		17	2	0.000302%	661015	99.87%	2	0.55%
邐	4213		22	2	0.000302%	661017	99.87%	2	0.55%
郡	4214		9	2	0.000302%	661019	99.87%	2	0.55%
酉	4215		7	2	0.000302%	661021	99.88%	2	0.55%
酊	4216		9	2	0.000302%	661023	99.88%	2	0.55%
酩	4217		13	2	0.000302%	661025	99.88%	2	0.55%
釆	4218		7	2	0.000302%	661027	99.88%	2	0.55%
鉗	4219		13	2	0.000302%	661029	99.88%	2	0.55%
銓	4221		14	2	0.000302%	661031	99.88%	2	0.55%
錮	4222		16	2	0.000302%	661033	99.88%	2	0.55%
鍥	4223		17	2	0.000302%	661035	99.88%	2	0.55%
鎚	4225		18	2	0.000302%	661037	99.88%	2	0.55%
鎗	4226		18	2	0.000302%	661039	99.88%	2	0.55%
鏤	4227		19	2	0.000302%	661041	99.88%	2	0.55%
鑰	4228		25	2	0.000302%	661043	99.88%	2	0.55%
陝	4231		9	2	0.000302%	661045	99.88%	2	0.55%
隴	4232		18	2	0.000302%	661047	99.88%	2	0.55%
霆	4233		15	2	0.000302%	661049	99.88%	2	0.55%
頦	4235		15	2	0.000302%	661051	99.88%	2	0.55%
頤	4236		16	2	0.000302%	661053	99.88%	2	0.55%
顥	4237		21	2	0.000302%	661055	99.88%	2	0.55%
颳	4239		15	2	0.000302%	661057	99.88%	2	0.55%
飪	4240		12	2	0.000302%	661059	99.88%	2	0.55%
餃	4241		14	2	0.000302%	661061	99.88%	2	0.55%
餒	4242		15	2	0.000302%	661063	99.88%	2	0.55%
餚	4243		16	2	0.000302%	661065	99.88%	2	0.55%
餽	4244		18	2	0.000302%	661067	99.88%	2	0.55%
駢	4247		16	2	0.000302%	661069	99.88%	2	0.55%
骷	4248		15	2	0.000302%	661071	99.89%	2	0.55%
髏	4249		21	2	0.000302%	661073	99.89%	2	0.55%
髣	4250		14	2	0.000302%	661075	99.89%	2	0.55%
鬣	4251		25	2	0.000302%	661077	99.89%	2	0.55%
鯊	4253		18	2	0.000302%	661079	99.89%	2	0.55%
鯽	4254		18	2	0.000302%	661081	99.89%	2	0.55%
鰤	4255		21	2	0.000302%	661083	99.89%	2	0.55%
鴦	4259		16	2	0.000302%	661085	99.89%	2	0.55%
鵠	4260		18	2	0.000302%	661087	99.89%	2	0.55%
鶉	4261		19	2	0.000302%	661089	99.89%	2	0.55%
麇	4262		16	2	0.000302%	661091	99.89%	2	0.55%
黠	4263		18	2	0.000302%	661093	99.89%	2	0.55%
齪	4264		22	2	0.000302%	661095	99.89%	2	0.55%
齷	4265		24	2	0.000302%	661097	99.89%	2	0.55%
坯	1801		8	33	0.004982%	661130	96.09%	1	0.28%
鮭	2310		17	18	0.002718%	661148	97.98%	1	0.28%
嵇	2373		12	16	0.002416%	661164	98.14%	1	0.28%
鏍	2507		19	14	0.002114%	661178	98.44%	1	0.28%
鸞	2513		30	14	0.002114%	661192	98.46%	1	0.28%
瑋	2806		13	9	0.001359%	661201	98.95%	1	0.28%
	2830		13	9	0.001359%	661210	98.98%	1	0.28%
蜓	2836		13	9	0.001359%	661219	98.99%	1	0.28%
鯰	2847		19	9	0.001359%	661228	99.00%	1	0.28%
鱸	2948		27	8	0.001208%	661236	99.12%	1	0.28%
沱	3137		8	6	0.0009059%	661242	99.32%	1	0.28%
嬤	3243		17	5	0.0007549%	661247	99.41%	1	0.28%
涪	3295		11	5	0.0007549%	661252	99.45%	1	0.28%
盔	3311		11	5	0.0007549%	661257	99.46%	1	0.28%
碚	3319		13	5	0.0007549%	661262	99.46%	1	0.28%
粱	3330		13	5	0.0007549%	661267	99.47%	1	0.28%
莧	3353		11	5	0.0007549%	661272	99.49%	1	0.28%
錚	3383		16	5	0.0007549%	661277	99.51%	1	0.28%
鯛	3404		19	5	0.0007549%	661282	99.53%	1	0.28%
剷	3419		13	4	0.0006039%	661286	99.54%	1	0.28%
咦	3424		9	4	0.0006039%	661290	99.54%	1	0.28%
嘿	3432		15	4	0.0006039%	661294	99.54%	1	0.28%
埕	3438		10	4	0.0006039%	661298	99.55%	1	0.28%
暪	3476		15	4	0.0006039%	661302	99.57%	1	0.28%
楣	3482		13	4	0.0006039%	661306	99.57%	1	0.28%
檐	3486		17	4	0.0006039%	661310	99.58%	1	0.28%
氈	3489		17	4	0.0006039%	661314	99.58%	1	0.28%
瘌	3523		14	4	0.0006039%	661318	99.60%	1	0.28%
	3554		13	4	0.0006039%	661322	99.62%	1	0.28%
仄	3619		4	3	0.0004529%	661325	99.66%	1	0.28%
佗	3620		7	3	0.0004529%	661328	99.66%	1	0.28%
噀	3649		15	3	0.0004529%	661331	99.67%	1	0.28%
坵	3658		8	3	0.0004529%	661334	99.67%	1	0.28%
撚	3700		15	3	0.0004529%	661337	99.69%	1	0.28%
曄	3706		16	3	0.0004529%	661340	99.70%	1	0.28%
棻	3713		12	3	0.0004529%	661343	99.70%	1	0.28%
樅	3716		15	3	0.0004529%	661346	99.70%	1	0.28%
泵	3721		9	3	0.0004529%	661349	99.70%	1	0.28%
濮	3730		17	3	0.0004529%	661352	99.71%	1	0.28%
瀨	3731		19	3	0.0004529%	661355	99.71%	1	0.28%
猩	3740		12	3	0.0004529%	661358	99.71%	1	0.28%
珞	3743		10	3	0.0004529%	661361	99.71%	1	0.28%
瓬	3747		9	3	0.0004529%	661364	99.72%	1	0.28%
痞	3754		12	3	0.0004529%	661367	99.72%	1	0.28%
矼	3760		8	3	0.0004529%	661370	99.72%	1	0.28%
砵	3762		10	3	0.0004529%	661373	99.72%	1	0.28%
碉	3763		13	3	0.0004529%	661376	99.72%	1	0.28%
膳	3798		16	3	0.0004529%	661379	99.74%	1	0.28%
艉	3800		13	3	0.0004529%	661382	99.74%	1	0.28%
苣	3801		9	3	0.0004529%	661385	99.74%	1	0.28%
茯	3804		10	3	0.0004529%	661388	99.74%	1	0.28%
萵	3807		13	3	0.0004529%	661391	99.74%	1	0.28%
蜊	3816		13	3	0.0004529%	661394	99.75%	1	0.28%
裒	3818		12	3	0.0004529%	661397	99.75%	1	0.28%
	3844		14	3	0.0004529%	661400	99.76%	1	0.28%
鏃	3850		19	3	0.0004529%	661403	99.76%	1	0.28%
馱	3864		13	3	0.0004529%	661406	99.77%	1	0.28%
鰒	3866		20	3	0.0004529%	661409	99.77%	1	0.28%
鱧	3867		24	3	0.0004529%	661412	99.77%	1	0.28%
鶻	3869		21	3	0.0004529%	661415	99.77%	1	0.28%
黽	3871		13	3	0.0004529%	661418	99.77%	1	0.28%
佝	3880		7	2	0.000302%	661420	99.77%	1	0.28%
偑	3885		11	2	0.000302%	661422	99.78%	1	0.28%
咕	3898		8	2	0.000302%	661424	99.78%	1	0.28%
呷	3899		8	2	0.000302%	661426	99.78%	1	0.28%
呱	3900		8	2	0.000302%	661428	99.78%	1	0.28%
呣	3901		8	2	0.000302%	661430	99.78%	1	0.28%
咯	3903		9	2	0.000302%	661432	99.78%	1	0.28%
咻	3904		9	2	0.000302%	661434	99.78%	1	0.28%
咿	3905		9	2	0.000302%	661436	99.78%	1	0.28%
唷	3906		10	2	0.000302%	661438	99.78%	1	0.28%
喳	3912		12	2	0.000302%	661440	99.78%	1	0.28%
嗷	3916		14	2	0.000302%	661442	99.79%	1	0.28%
嚅	3919		17	2	0.000302%	661444	99.79%	1	0.28%
坍	3926		7	2	0.000302%	661446	99.79%	1	0.28%
塍	3928		13	2	0.000302%	661448	99.79%	1	0.28%
奄	3930		8	2	0.000302%	661450	99.79%	1	0.28%
奕	3931		9	2	0.000302%	661452	99.79%	1	0.28%
姍	3933		8	2	0.000302%	661454	99.79%	1	0.28%
妲	3934		8	2	0.000302%	661456	99.79%	1	0.28%
姥	3935		9	2	0.000302%	661458	99.79%	1	0.28%
娓	3938		10	2	0.000302%	661460	99.79%	1	0.28%
嫋	3943		13	2	0.000302%	661462	99.79%	1	0.28%
嬸	3946		18	2	0.000302%	661464	99.79%	1	0.28%
宓	3949		8	2	0.000302%	661466	99.79%	1	0.28%
尹	3953		4	2	0.000302%	661468	99.80%	1	0.28%
巽	3961		12	2	0.000302%	661470	99.80%	1	0.28%
帑	3962		8	2	0.000302%	661472	99.80%	1	0.28%
庄	3966		6	2	0.000302%	661474	99.80%	1	0.28%
弋	3969		3	2	0.000302%	661476	99.80%	1	0.28%
忿	3977		8	2	0.000302%	661478	99.80%	1	0.28%
	3978		9	2	0.000302%	661480	99.80%	1	0.28%
悻	3981		11	2	0.000302%	661482	99.80%	1	0.28%
惴	3983		12	2	0.000302%	661484	99.81%	1	0.28%
愨	3984		14	2	0.000302%	661486	99.81%	1	0.28%
懨	3985		17	2	0.000302%	661488	99.81%	1	0.28%
挈	3992		10	2	0.000302%	661490	99.81%	1	0.28%
摰	3999		15	2	0.000302%	661492	99.81%	1	0.28%
棱	4013		12	2	0.000302%	661494	99.81%	1	0.28%
榑	4021		14	2	0.000302%	661496	99.82%	1	0.28%
櫓	4026		19	2	0.000302%	661498	99.82%	1	0.28%
欸	4027		11	2	0.000302%	661500	99.82%	1	0.28%
淙	4039		11	2	0.000302%	661502	99.82%	1	0.28%
溲	4043		12	2	0.000302%	661504	99.82%	1	0.28%
潸	4045		15	2	0.000302%	661506	99.82%	1	0.28%
瀛	4049		19	2	0.000302%	661508	99.83%	1	0.28%
瀘	4050		19	2	0.000302%	661510	99.83%	1	0.28%
灕	4052		22	2	0.000302%	661512	99.83%	1	0.28%
烯	4053		11	2	0.000302%	661514	99.83%	1	0.28%
犄	4059		12	2	0.000302%	661516	99.83%	1	0.28%
犖	4060		14	2	0.000302%	661518	99.83%	1	0.28%
璫	4072		17	2	0.000302%	661520	99.83%	1	0.28%
痘	4077		12	2	0.000302%	661522	99.83%	1	0.28%
痧	4078		12	2	0.000302%	661524	99.83%	1	0.28%
癹	4083		9	2	0.000302%	661526	99.84%	1	0.28%
皎	4084		11	2	0.000302%	661528	99.84%	1	0.28%
眥	4087		11	2	0.000302%	661530	99.84%	1	0.28%
睏	4088		12	2	0.000302%	661532	99.84%	1	0.28%
矻	4093		8	2	0.000302%	661534	99.84%	1	0.28%
硜	4095		12	2	0.000302%	661536	99.84%	1	0.28%
磊	4098		15	2	0.000302%	661538	99.84%	1	0.28%
礬	4101		20	2	0.000302%	661540	99.84%	1	0.28%
禹	4102		9	2	0.000302%	661542	99.84%	1	0.28%
稼	4105		15	2	0.000302%	661544	99.84%	1	0.28%
籀	4112		19	2	0.000302%	661546	99.84%	1	0.28%
罹	4120		16	2	0.000302%	661548	99.85%	1	0.28%
耙	4123		10	2	0.000302%	661550	99.85%	1	0.28%
耿	4124		10	2	0.000302%	661552	99.85%	1	0.28%
膿	4130		17	2	0.000302%	661554	99.85%	1	0.28%
舐	4132		10	2	0.000302%	661556	99.85%	1	0.28%
舔	4133		14	2	0.000302%	661558	99.85%	1	0.28%
茉	4137		9	2	0.000302%	661560	99.85%	1	0.28%
苪	4139		9	2	0.000302%	661562	99.85%	1	0.28%
茜	4142		10	2	0.000302%	661564	99.85%	1	0.28%
菠	4145		12	2	0.000302%	661566	99.85%	1	0.28%
萋	4146		12	2	0.000302%	661568	99.85%	1	0.28%
蔦	4152		15	2	0.000302%	661570	99.86%	1	0.28%
蚩	4157		10	2	0.000302%	661572	99.86%	1	0.28%
蛟	4159		12	2	0.000302%	661574	99.86%	1	0.28%
蝠	4162		15	2	0.000302%	661576	99.86%	1	0.28%
蝙	4163		15	2	0.000302%	661578	99.86%	1	0.28%
蝮	4165		15	2	0.000302%	661580	99.86%	1	0.28%
証	4176		12	2	0.000302%	661582	99.86%	1	0.28%
諛	4182		15	2	0.000302%	661584	99.87%	1	0.28%
謅	4186		17	2	0.000302%	661586	99.87%	1	0.28%
謫	4187		18	2	0.000302%	661588	99.87%	1	0.28%
賒	4189		14	2	0.000302%	661590	99.87%	1	0.28%
跣	4192		13	2	0.000302%	661592	99.87%	1	0.28%
踉	4193		14	2	0.000302%	661594	99.87%	1	0.28%
蹌	4198		17	2	0.000302%	661596	99.87%	1	0.28%
躅	4202		20	2	0.000302%	661598	99.87%	1	0.28%
躑	4203		22	2	0.000302%	661600	99.87%	1	0.28%
輞	4207		15	2	0.000302%	661602	99.87%	1	0.28%
轔	4208		19	2	0.000302%	661604	99.87%	1	0.28%
迦	4209		8	2	0.000302%	661606	99.87%	1	0.28%
鉚	4220		13	2	0.000302%	661608	99.88%	1	0.28%
鎏	4224		17	2	0.000302%	661610	99.88%	1	0.28%
阡	4229		5	2	0.000302%	661612	99.88%	1	0.28%
陂	4230		7	2	0.000302%	661614	99.88%	1	0.28%
霏	4234		16	2	0.000302%	661616	99.88%	1	0.28%
顳	4238		26	2	0.000302%	661618	99.88%	1	0.28%
饌	4245		20	2	0.000302%	661620	99.88%	1	0.28%
饞	4246		25	2	0.000302%	661622	99.88%	1	0.28%
鮒	4252		16	2	0.000302%	661624	99.89%	1	0.28%
鱈	4256		22	2	0.000302%	661626	99.89%	1	0.28%
鱠	4257		24	2	0.000302%	661628	99.89%	1	0.28%
鳩	4258		13	2	0.000302%	661630	99.89%	1	0.28%
么	4266		3	1	0.000151%	661631	99.89%	1	0.28%
	4267		3	1	0.000151%	661632	99.89%	1	0.28%
仆	4268		4	1	0.000151%	661633	99.89%	1	0.28%
仞	4269		5	1	0.000151%	661634	99.89%	1	0.28%
仟	4270		5	1	0.000151%	661635	99.89%	1	0.28%
伉	4271		6	1	0.000151%	661636	99.89%	1	0.28%
伎	4272		6	1	0.000151%	661637	99.89%	1	0.28%
佞	4273		7	1	0.000151%	661638	99.89%	1	0.28%
佟	4274		7	1	0.000151%	661639	99.89%	1	0.28%
佘	4275		7	1	0.000151%	661640	99.89%	1	0.28%
佰	4276		8	1	0.000151%	661641	99.89%	1	0.28%
俎	4277		9	1	0.000151%	661642	99.89%	1	0.28%
俞	4278		9	1	0.000151%	661643	99.89%	1	0.28%
	4279		10	1	0.000151%	661644	99.89%	1	0.28%
俸	4280		10	1	0.000151%	661645	99.89%	1	0.28%
俺	4281		10	1	0.000151%	661646	99.89%	1	0.28%
倨	4282		10	1	0.000151%	661647	99.89%	1	0.28%
倜	4283		10	1	0.000151%	661648	99.89%	1	0.28%
偃	4284		11	1	0.000151%	661649	99.89%	1	0.28%
傴	4285		13	1	0.000151%	661650	99.89%	1	0.28%
僈	4286		13	1	0.000151%	661651	99.89%	1	0.28%
儆	4287		15	1	0.000151%	661652	99.89%	1	0.28%
儕	4288		16	1	0.000151%	661653	99.89%	1	0.28%
儗	4289		16	1	0.000151%	661654	99.89%	1	0.28%
儻	4290		22	1	0.000151%	661655	99.89%	1	0.28%
冢	4291		10	1	0.000151%	661656	99.89%	1	0.28%
刳	4292		8	1	0.000151%	661657	99.89%	1	0.28%
劊	4293		15	1	0.000151%	661658	99.89%	1	0.28%
劬	4294		7	1	0.000151%	661659	99.89%	1	0.28%
募	4295		13	1	0.000151%	661660	99.89%	1	0.28%
匍	4296		9	1	0.000151%	661661	99.90%	1	0.28%
匐	4297		11	1	0.000151%	661662	99.90%	1	0.28%
匕	4298		2	1	0.000151%	661663	99.90%	1	0.28%
匜	4299		5	1	0.000151%	661664	99.90%	1	0.28%
匾	4300		11	1	0.000151%	661665	99.90%	1	0.28%
卍	4301		6	1	0.000151%	661666	99.90%	1	0.28%
卯	4302		5	1	0.000151%	661667	99.90%	1	0.28%
卮	4303		5	1	0.000151%	661668	99.90%	1	0.28%
卹	4304		8	1	0.000151%	661669	99.90%	1	0.28%
厝	4305		10	1	0.000151%	661670	99.90%	1	0.28%
	4306		8	1	0.000151%	661671	99.90%	1	0.28%
吮	4307		7	1	0.000151%	661672	99.90%	1	0.28%
呸	4308		8	1	0.000151%	661673	99.90%	1	0.28%
呶	4309		8	1	0.000151%	661674	99.90%	1	0.28%
咨	4310		9	1	0.000151%	661675	99.90%	1	0.28%
咫	4311		9	1	0.000151%	661676	99.90%	1	0.28%
唆	4312		10	1	0.000151%	661677	99.90%	1	0.28%
啖	4313		11	1	0.000151%	661678	99.90%	1	0.28%
啤	4314		11	1	0.000151%	661679	99.90%	1	0.28%
啁	4315		11	1	0.000151%	661680	99.90%	1	0.28%
唪	4316		11	1	0.000151%	661681	99.90%	1	0.28%
啥	4317		11	1	0.000151%	661682	99.90%	1	0.28%
喱	4318		12	1	0.000151%	661683	99.90%	1	0.28%
喏	4319		12	1	0.000151%	661684	99.90%	1	0.28%
嗑	4320		13	1	0.000151%	661685	99.90%	1	0.28%
嗤	4321		13	1	0.000151%	661686	99.90%	1	0.28%
嗲	4322		13	1	0.000151%	661687	99.90%	1	0.28%
嘖	4323		14	1	0.000151%	661688	99.90%	1	0.28%
噘	4324		15	1	0.000151%	661689	99.90%	1	0.28%
嚆	4325		17	1	0.000151%	661690	99.90%	1	0.28%
嚜	4326		18	1	0.000151%	661691	99.90%	1	0.28%
囓	4327		24	1	0.000151%	661692	99.90%	1	0.28%
圜	4328		16	1	0.000151%	661693	99.90%	1	0.28%
圪	4329		6	1	0.000151%	661694	99.90%	1	0.28%
	4330		7	1	0.000151%	661695	99.90%	1	0.28%
坳	4331		8	1	0.000151%	661696	99.90%	1	0.28%
垓	4332		9	1	0.000151%	661697	99.90%	1	0.28%
埒	4333		10	1	0.000151%	661698	99.90%	1	0.28%
埤	4334		11	1	0.000151%	661699	99.90%	1	0.28%
埸	4335		11	1	0.000151%	661700	99.90%	1	0.28%
埏	4336		11	1	0.000151%	661701	99.90%	1	0.28%
堯	4337		12	1	0.000151%	661702	99.90%	1	0.28%
墁	4338		14	1	0.000151%	661703	99.90%	1	0.28%
墩	4339		15	1	0.000151%	661704	99.90%	1	0.28%
墺	4340		16	1	0.000151%	661705	99.90%	1	0.28%
壢	4341		19	1	0.000151%	661706	99.90%	1	0.28%
壚	4342		19	1	0.000151%	661707	99.90%	1	0.28%
奐	4343		9	1	0.000151%	661708	99.90%	1	0.28%
奩	4344		14	1	0.000151%	661709	99.90%	1	0.28%
妁	4345		6	1	0.000151%	661710	99.90%	1	0.28%
妞	4346		7	1	0.000151%	661711	99.90%	1	0.28%
妣	4347		7	1	0.000151%	661712	99.90%	1	0.28%
妖	4348		7	1	0.000151%	661713	99.90%	1	0.28%
妍	4349		7	1	0.000151%	661714	99.90%	1	0.28%
妯	4350		8	1	0.000151%	661715	99.90%	1	0.28%
姒	4351		8	1	0.000151%	661716	99.90%	1	0.28%
	4352		9	1	0.000151%	661717	99.90%	1	0.28%
姜	4353		9	1	0.000151%	661718	99.90%	1	0.28%
娩	4354		10	1	0.000151%	661719	99.90%	1	0.28%
娥	4355		10	1	0.000151%	661720	99.90%	1	0.28%
娌	4356		10	1	0.000151%	661721	99.90%	1	0.28%
婢	4357		11	1	0.000151%	661722	99.90%	1	0.28%
媼	4358		13	1	0.000151%	661723	99.90%	1	0.28%
媵	4359		13	1	0.000151%	661724	99.90%	1	0.28%
嫗	4360		14	1	0.000151%	661725	99.90%	1	0.28%
嫖	4361		14	1	0.000151%	661726	99.90%	1	0.28%
嫺	4362		15	1	0.000151%	661727	99.91%	1	0.28%
嬪	4363		17	1	0.000151%	661728	99.91%	1	0.28%
孚	4364		7	1	0.000151%	661729	99.91%	1	0.28%
孿	4365		22	1	0.000151%	661730	99.91%	1	0.28%
宕	4366		8	1	0.000151%	661731	99.91%	1	0.28%
宥	4367		9	1	0.000151%	661732	99.91%	1	0.28%
寅	4368		11	1	0.000151%	661733	99.91%	1	0.28%
寖	4369		13	1	0.000151%	661734	99.91%	1	0.28%
尢	4370		3	1	0.000151%	661735	99.91%	1	0.28%
岔	4371		7	1	0.000151%	661736	99.91%	1	0.28%
崙	4372		11	1	0.000151%	661737	99.91%	1	0.28%
崚	4373		11	1	0.000151%	661738	99.91%	1	0.28%
嵩	4374		13	1	0.000151%	661739	99.91%	1	0.28%
嶒	4375		15	1	0.000151%	661740	99.91%	1	0.28%
巉	4376		20	1	0.000151%	661741	99.91%	1	0.28%
	4377		9	1	0.000151%	661742	99.91%	1	0.28%
幃	4378		12	1	0.000151%	661743	99.91%	1	0.28%
幄	4379		12	1	0.000151%	661744	99.91%	1	0.28%
庚	4380		8	1	0.000151%	661745	99.91%	1	0.28%
庖	4381		8	1	0.000151%	661746	99.91%	1	0.28%
廩	4382		16	1	0.000151%	661747	99.91%	1	0.28%
廨	4383		16	1	0.000151%	661748	99.91%	1	0.28%
弘	4384		5	1	0.000151%	661749	99.91%	1	0.28%
弼	4385		12	1	0.000151%	661750	99.91%	1	0.28%
彀	4386		13	1	0.000151%	661751	99.91%	1	0.28%
彫	4387		11	1	0.000151%	661752	99.91%	1	0.28%
徇	4388		9	1	0.000151%	661753	99.91%	1	0.28%
忸	4389		7	1	0.000151%	661754	99.91%	1	0.28%
忑	4390		7	1	0.000151%	661755	99.91%	1	0.28%
忐	4391		7	1	0.000151%	661756	99.91%	1	0.28%
忡	4392		7	1	0.000151%	661757	99.91%	1	0.28%
忝	4393		8	1	0.000151%	661758	99.91%	1	0.28%
怩	4394		8	1	0.000151%	661759	99.91%	1	0.28%
怍	4395		8	1	0.000151%	661760	99.91%	1	0.28%
恫	4396		9	1	0.000151%	661761	99.91%	1	0.28%
悍	4397		10	1	0.000151%	661762	99.91%	1	0.28%
悌	4398		10	1	0.000151%	661763	99.91%	1	0.28%
恁	4399		10	1	0.000151%	661764	99.91%	1	0.28%
恿	4400		11	1	0.000151%	661765	99.91%	1	0.28%
悱	4401		11	1	0.000151%	661766	99.91%	1	0.28%
愜	4402		12	1	0.000151%	661767	99.91%	1	0.28%
惲	4403		12	1	0.000151%	661768	99.91%	1	0.28%
慍	4404		13	1	0.000151%	661769	99.91%	1	0.28%
愾	4405		13	1	0.000151%	661770	99.91%	1	0.28%
愍	4406		13	1	0.000151%	661771	99.91%	1	0.28%
慟	4407		14	1	0.000151%	661772	99.91%	1	0.28%
慓	4408		14	1	0.000151%	661773	99.91%	1	0.28%
慫	4409		15	1	0.000151%	661774	99.91%	1	0.28%
憟	4410		15	1	0.000151%	661775	99.91%	1	0.28%
懍	4411		16	1	0.000151%	661776	99.91%	1	0.28%
憨	4412		16	1	0.000151%	661777	99.91%	1	0.28%
懵	4413		19	1	0.000151%	661778	99.91%	1	0.28%
戊	4414		5	1	0.000151%	661779	99.91%	1	0.28%
戌	4415		6	1	0.000151%	661780	99.91%	1	0.28%
戛	4416		11	1	0.000151%	661781	99.91%	1	0.28%
戮	4417		15	1	0.000151%	661782	99.91%	1	0.28%
扒	4418		5	1	0.000151%	661783	99.91%	1	0.28%
扦	4419		6	1	0.000151%	661784	99.91%	1	0.28%
扺	4420		7	1	0.000151%	661785	99.91%	1	0.28%
拗	4421		8	1	0.000151%	661786	99.91%	1	0.28%
拽	4422		9	1	0.000151%	661787	99.91%	1	0.28%
拷	4423		9	1	0.000151%	661788	99.91%	1	0.28%
捂	4424		10	1	0.000151%	661789	99.91%	1	0.28%
捍	4425		10	1	0.000151%	661790	99.91%	1	0.28%
捋	4426		10	1	0.000151%	661791	99.91%	1	0.28%
挴	4427		10	1	0.000151%	661792	99.91%	1	0.28%
掖	4428		11	1	0.000151%	661793	99.92%	1	0.28%
捻	4429		11	1	0.000151%	661794	99.92%	1	0.28%
掎	4430		11	1	0.000151%	661795	99.92%	1	0.28%
掇	4431		11	1	0.000151%	661796	99.92%	1	0.28%
挻	4432		11	1	0.000151%	661797	99.92%	1	0.28%
掁	4433		11	1	0.000151%	661798	99.92%	1	0.28%
掣	4434		12	1	0.000151%	661799	99.92%	1	0.28%
揹	4435		12	1	0.000151%	661800	99.92%	1	0.28%
揄	4436		12	1	0.000151%	661801	99.92%	1	0.28%
搪	4437		13	1	0.000151%	661802	99.92%	1	0.28%
搆	4438		13	1	0.000151%	661803	99.92%	1	0.28%
摑	4439		14	1	0.000151%	661804	99.92%	1	0.28%
摶	4440		14	1	0.000151%	661805	99.92%	1	0.28%
摽	4441		14	1	0.000151%	661806	99.92%	1	0.28%
撢	4442		15	1	0.000151%	661807	99.92%	1	0.28%
撳	4443		15	1	0.000151%	661808	99.92%	1	0.28%
撻	4444		16	1	0.000151%	661809	99.92%	1	0.28%
擂	4445		16	1	0.000151%	661810	99.92%	1	0.28%
擷	4446		18	1	0.000151%	661811	99.92%	1	0.28%
攄	4447		18	1	0.000151%	661812	99.92%	1	0.28%
攙	4448		20	1	0.000151%	661813	99.92%	1	0.28%
攛	4449		21	1	0.000151%	661814	99.92%	1	0.28%
攢	4450		22	1	0.000151%	661815	99.92%	1	0.28%
攸	4451		7	1	0.000151%	661816	99.92%	1	0.28%
攷	4452		7	1	0.000151%	661817	99.92%	1	0.28%
敕	4453		11	1	0.000151%	661818	99.92%	1	0.28%
旃	4454		10	1	0.000151%	661819	99.92%	1	0.28%
旎	4455		11	1	0.000151%	661820	99.92%	1	0.28%
旖	4456		14	1	0.000151%	661821	99.92%	1	0.28%
昃	4457		8	1	0.000151%	661822	99.92%	1	0.28%
昶	4458		9	1	0.000151%	661823	99.92%	1	0.28%
晷	4459		12	1	0.000151%	661824	99.92%	1	0.28%
晹	4460		12	1	0.000151%	661825	99.92%	1	0.28%
暄	4461		13	1	0.000151%	661826	99.92%	1	0.28%
暾	4462		16	1	0.000151%	661827	99.92%	1	0.28%
曖	4463		17	1	0.000151%	661828	99.92%	1	0.28%
曷	4464		9	1	0.000151%	661829	99.92%	1	0.28%
朕	4465		10	1	0.000151%	661830	99.92%	1	0.28%
朮	4466		5	1	0.000151%	661831	99.92%	1	0.28%
朴	4467		6	1	0.000151%	661832	99.92%	1	0.28%
杈	4468		7	1	0.000151%	661833	99.92%	1	0.28%
枋	4469		8	1	0.000151%	661834	99.92%	1	0.28%
杪	4470		8	1	0.000151%	661835	99.92%	1	0.28%
枆	4471		8	1	0.000151%	661836	99.92%	1	0.28%
柵	4472		9	1	0.000151%	661837	99.92%	1	0.28%
柝	4473		9	1	0.000151%	661838	99.92%	1	0.28%
枳	4474		9	1	0.000151%	661839	99.92%	1	0.28%
枹	4475		9	1	0.000151%	661840	99.92%	1	0.28%
桀	4476		10	1	0.000151%	661841	99.92%	1	0.28%
桅	4477		10	1	0.000151%	661842	99.92%	1	0.28%
梃	4478		11	1	0.000151%	661843	99.92%	1	0.28%
梟	4479		11	1	0.000151%	661844	99.92%	1	0.28%
桮	4480		11	1	0.000151%	661845	99.92%	1	0.28%
桷	4481		11	1	0.000151%	661846	99.92%	1	0.28%
梠	4482		11	1	0.000151%	661847	99.92%	1	0.28%
棺	4483		12	1	0.000151%	661848	99.92%	1	0.28%
棧	4484		12	1	0.000151%	661849	99.92%	1	0.28%
棹	4485		12	1	0.000151%	661850	99.92%	1	0.28%
棣	4486		12	1	0.000151%	661851	99.92%	1	0.28%
楮	4487		12	1	0.000151%	661852	99.92%	1	0.28%
椪	4488		12	1	0.000151%	661853	99.92%	1	0.28%
棬	4489		12	1	0.000151%	661854	99.92%	1	0.28%
椑	4490		12	1	0.000151%	661855	99.92%	1	0.28%
楢	4491		13	1	0.000151%	661856	99.92%	1	0.28%
椿	4492		13	1	0.000151%	661857	99.92%	1	0.28%
椹	4493		13	1	0.000151%	661858	99.92%	1	0.28%
椵	4494		13	1	0.000151%	661859	99.92%	1	0.28%
榫	4495		14	1	0.000151%	661860	99.93%	1	0.28%
槌	4496		14	1	0.000151%	661861	99.93%	1	0.28%
槃	4497		14	1	0.000151%	661862	99.93%	1	0.28%
樺	4498		16	1	0.000151%	661863	99.93%	1	0.28%
樾	4499		16	1	0.000151%	661864	99.93%	1	0.28%
樨	4500		16	1	0.000151%	661865	99.93%	1	0.28%
櫛	4501		17	1	0.000151%	661866	99.93%	1	0.28%
檎	4502		17	1	0.000151%	661867	99.93%	1	0.28%
檽	4503		18	1	0.000151%	661868	99.93%	1	0.28%
櫪	4504		20	1	0.000151%	661869	99.93%	1	0.28%
櫺	4505		21	1	0.000151%	661870	99.93%	1	0.28%
歟	4506		18	1	0.000151%	661871	99.93%	1	0.28%
歿	4507		8	1	0.000151%	661872	99.93%	1	0.28%
殃	4508		9	1	0.000151%	661873	99.93%	1	0.28%
殞	4509		14	1	0.000151%	661874	99.93%	1	0.28%
殯	4510		18	1	0.000151%	661875	99.93%	1	0.28%
毌	4511		4	1	0.000151%	661876	99.93%	1	0.28%
毽	4512		13	1	0.000151%	661877	99.93%	1	0.28%
氨	4513		10	1	0.000151%	661878	99.93%	1	0.28%
汐	4514		6	1	0.000151%	661879	99.93%	1	0.28%
汛	4515		6	1	0.000151%	661880	99.93%	1	0.28%
汔	4516		6	1	0.000151%	661881	99.93%	1	0.28%
汞	4517		7	1	0.000151%	661882	99.93%	1	0.28%
汨	4518		7	1	0.000151%	661883	99.93%	1	0.28%
汴	4519		7	1	0.000151%	661884	99.93%	1	0.28%
沔	4520		7	1	0.000151%	661885	99.93%	1	0.28%
泄	4521		8	1	0.000151%	661886	99.93%	1	0.28%
泱	4522		8	1	0.000151%	661887	99.93%	1	0.28%
沓	4523		8	1	0.000151%	661888	99.93%	1	0.28%
泫	4524		8	1	0.000151%	661889	99.93%	1	0.28%
洫	4525		9	1	0.000151%	661890	99.93%	1	0.28%
	4526		10	1	0.000151%	661891	99.93%	1	0.28%
涇	4527		10	1	0.000151%	661892	99.93%	1	0.28%
浹	4528		10	1	0.000151%	661893	99.93%	1	0.28%
浥	4529		10	1	0.000151%	661894	99.93%	1	0.28%
涂	4530		10	1	0.000151%	661895	99.93%	1	0.28%
淬	4531		11	1	0.000151%	661896	99.93%	1	0.28%
淖	4532		11	1	0.000151%	661897	99.93%	1	0.28%
淝	4533		11	1	0.000151%	661898	99.93%	1	0.28%
淭	4534		11	1	0.000151%	661899	99.93%	1	0.28%
湔	4535		12	1	0.000151%	661900	99.93%	1	0.28%
渣	4536		12	1	0.000151%	661901	99.93%	1	0.28%
湮	4537		12	1	0.000151%	661902	99.93%	1	0.28%
渭	4538		12	1	0.000151%	661903	99.93%	1	0.28%
渙	4539		12	1	0.000151%	661904	99.93%	1	0.28%
湲	4540		12	1	0.000151%	661905	99.93%	1	0.28%
滓	4541		13	1	0.000151%	661906	99.93%	1	0.28%
滇	4542		13	1	0.000151%	661907	99.93%	1	0.28%
溥	4543		13	1	0.000151%	661908	99.93%	1	0.28%
滃	4544		13	1	0.000151%	661909	99.93%	1	0.28%
漱	4545		14	1	0.000151%	661910	99.93%	1	0.28%
滕	4546		15	1	0.000151%	661911	99.93%	1	0.28%
濂	4547		16	1	0.000151%	661912	99.93%	1	0.28%
澠	4548		16	1	0.000151%	661913	99.93%	1	0.28%
澣	4549		16	1	0.000151%	661914	99.93%	1	0.28%
濇	4550		16	1	0.000151%	661915	99.93%	1	0.28%
濬	4551		17	1	0.000151%	661916	99.93%	1	0.28%
瀆	4552		18	1	0.000151%	661917	99.93%	1	0.28%
瀏	4553		18	1	0.000151%	661918	99.93%	1	0.28%
	4554		6	1	0.000151%	661919	99.93%	1	0.28%
烊	4555		10	1	0.000151%	661920	99.93%	1	0.28%
烶	4556		11	1	0.000151%	661921	99.93%	1	0.28%
焙	4557		12	1	0.000151%	661922	99.93%	1	0.28%
煨	4558		13	1	0.000151%	661923	99.93%	1	0.28%
熲	4559		15	1	0.000151%	661924	99.93%	1	0.28%
熠	4560		15	1	0.000151%	661925	99.93%	1	0.28%
燐	4561		16	1	0.000151%	661926	99.94%	1	0.28%
熹	4562		16	1	0.000151%	661927	99.94%	1	0.28%
燾	4563		18	1	0.000151%	661928	99.94%	1	0.28%
爻	4564		4	1	0.000151%	661929	99.94%	1	0.28%
牋	4565		12	1	0.000151%	661930	99.94%	1	0.28%
牘	4566		19	1	0.000151%	661931	99.94%	1	0.28%
牴	4567		9	1	0.000151%	661932	99.94%	1	0.28%
犁	4568		11	1	0.000151%	661933	99.94%	1	0.28%
犍	4569		13	1	0.000151%	661934	99.94%	1	0.28%
狃	4570		7	1	0.000151%	661935	99.94%	1	0.28%
狷	4571		10	1	0.000151%	661936	99.94%	1	0.28%
猙	4572		11	1	0.000151%	661937	99.94%	1	0.28%
猢	4573		12	1	0.000151%	661938	99.94%	1	0.28%
猿	4574		13	1	0.000151%	661939	99.94%	1	0.28%
猻	4575		13	1	0.000151%	661940	99.94%	1	0.28%
玀	4576		22	1	0.000151%	661941	99.94%	1	0.28%
玢	4577		8	1	0.000151%	661942	99.94%	1	0.28%
玷	4578		9	1	0.000151%	661943	99.94%	1	0.28%
珂	4579		9	1	0.000151%	661944	99.94%	1	0.28%
琪	4580		12	1	0.000151%	661945	99.94%	1	0.28%
琥	4581		12	1	0.000151%	661946	99.94%	1	0.28%
琵	4582		12	1	0.000151%	661947	99.94%	1	0.28%
琛	4583		12	1	0.000151%	661948	99.94%	1	0.28%
璀	4584		15	1	0.000151%	661949	99.94%	1	0.28%
璇	4585		15	1	0.000151%	661950	99.94%	1	0.28%
璽	4586		19	1	0.000151%	661951	99.94%	1	0.28%
瓢	4587		16	1	0.000151%	661952	99.94%	1	0.28%
瓤	4588		22	1	0.000151%	661953	99.94%	1	0.28%
甌	4589		16	1	0.000151%	661954	99.94%	1	0.28%
甗	4590		21	1	0.000151%	661955	99.94%	1	0.28%
甬	4591		7	1	0.000151%	661956	99.94%	1	0.28%
甯	4592		12	1	0.000151%	661957	99.94%	1	0.28%
畛	4593		10	1	0.000151%	661958	99.94%	1	0.28%
疔	4594		7	1	0.000151%	661959	99.94%	1	0.28%
	4595		10	1	0.000151%	661960	99.94%	1	0.28%
	4596		10	1	0.000151%	661961	99.94%	1	0.28%
疽	4597		10	1	0.000151%	661962	99.94%	1	0.28%
痔	4598		11	1	0.000151%	661963	99.94%	1	0.28%
痍	4599		11	1	0.000151%	661964	99.94%	1	0.28%
痣	4600		12	1	0.000151%	661965	99.94%	1	0.28%
痲	4601		13	1	0.000151%	661966	99.94%	1	0.28%
痿	4602		13	1	0.000151%	661967	99.94%	1	0.28%
痳	4603		13	1	0.000151%	661968	99.94%	1	0.28%
痼	4604		13	1	0.000151%	661969	99.94%	1	0.28%
瘩	4605		15	1	0.000151%	661970	99.94%	1	0.28%
瘼	4606		16	1	0.000151%	661971	99.94%	1	0.28%
瘰	4607		16	1	0.000151%	661972	99.94%	1	0.28%
癘	4608		18	1	0.000151%	661973	99.94%	1	0.28%
癭	4609		22	1	0.000151%	661974	99.94%	1	0.28%
癲	4610		24	1	0.000151%	661975	99.94%	1	0.28%
癸	4611		9	1	0.000151%	661976	99.94%	1	0.28%
皋	4612		10	1	0.000151%	661977	99.94%	1	0.28%
盥	4613		16	1	0.000151%	661978	99.94%	1	0.28%
睬	4614		13	1	0.000151%	661979	99.94%	1	0.28%
睥	4615		13	1	0.000151%	661980	99.94%	1	0.28%
睢	4616		13	1	0.000151%	661981	99.94%	1	0.28%
瞠	4617		16	1	0.000151%	661982	99.94%	1	0.28%
瞳	4618		17	1	0.000151%	661983	99.94%	1	0.28%
瞶	4619		17	1	0.000151%	661984	99.94%	1	0.28%
瞼	4620		18	1	0.000151%	661985	99.94%	1	0.28%
矧	4621		9	1	0.000151%	661986	99.94%	1	0.28%
砉	4622		9	1	0.000151%	661987	99.94%	1	0.28%
砧	4623		10	1	0.000151%	661988	99.94%	1	0.28%
砝	4624		10	1	0.000151%	661989	99.94%	1	0.28%
砷	4625		10	1	0.000151%	661990	99.94%	1	0.28%
砭	4626		10	1	0.000151%	661991	99.94%	1	0.28%
砫	4627		10	1	0.000151%	661992	99.95%	1	0.28%
硃	4628		11	1	0.000151%	661993	99.95%	1	0.28%
砦	4629		11	1	0.000151%	661994	99.95%	1	0.28%
碇	4630		13	1	0.000151%	661995	99.95%	1	0.28%
碞	4631		14	1	0.000151%	661996	99.95%	1	0.28%
礡	4632		19	1	0.000151%	661997	99.95%	1	0.28%
礱	4633		21	1	0.000151%	661998	99.95%	1	0.28%
祁	4634		7	1	0.000151%	661999	99.95%	1	0.28%
祐	4635		9	1	0.000151%	662000	99.95%	1	0.28%
祚	4636		9	1	0.000151%	662001	99.95%	1	0.28%
祟	4637		10	1	0.000151%	662002	99.95%	1	0.28%
祿	4638		12	1	0.000151%	662003	99.95%	1	0.28%
祼	4639		12	1	0.000151%	662004	99.95%	1	0.28%
禳	4640		21	1	0.000151%	662005	99.95%	1	0.28%
种	4641		9	1	0.000151%	662006	99.95%	1	0.28%
稷	4642		15	1	0.000151%	662007	99.95%	1	0.28%
窠	4643		13	1	0.000151%	662008	99.95%	1	0.28%
窳	4644		15	1	0.000151%	662009	99.95%	1	0.28%
窿	4645		17	1	0.000151%	662010	99.95%	1	0.28%
竺	4646		8	1	0.000151%	662011	99.95%	1	0.28%
竽	4647		9	1	0.000151%	662012	99.95%	1	0.28%
	4648		10	1	0.000151%	662013	99.95%	1	0.28%
笄	4649		10	1	0.000151%	662014	99.95%	1	0.28%
笙	4650		11	1	0.000151%	662015	99.95%	1	0.28%
筐	4651		12	1	0.000151%	662016	99.95%	1	0.28%
笻	4652		12	1	0.000151%	662017	99.95%	1	0.28%
筠	4653		13	1	0.000151%	662018	99.95%	1	0.28%
簑	4654		16	1	0.000151%	662019	99.95%	1	0.28%
篝	4655		16	1	0.000151%	662020	99.95%	1	0.28%
篔	4656		16	1	0.000151%	662021	99.95%	1	0.28%
簣	4657		18	1	0.000151%	662022	99.95%	1	0.28%
簠	4658		18	1	0.000151%	662023	99.95%	1	0.28%
簸	4659		19	1	0.000151%	662024	99.95%	1	0.28%
簹	4660		19	1	0.000151%	662025	99.95%	1	0.28%
籮	4661		25	1	0.000151%	662026	99.95%	1	0.28%
粼	4662		14	1	0.000151%	662027	99.95%	1	0.28%
糰	4663		20	1	0.000151%	662028	99.95%	1	0.28%
紜	4664		10	1	0.000151%	662029	99.95%	1	0.28%
紏	4665		10	1	0.000151%	662030	99.95%	1	0.28%
紬	4666		11	1	0.000151%	662031	99.95%	1	0.28%
紿	4667		11	1	0.000151%	662032	99.95%	1	0.28%
絜	4668		12	1	0.000151%	662033	99.95%	1	0.28%
	4669		13	1	0.000151%	662034	99.95%	1	0.28%
綑	4670		13	1	0.000151%	662035	99.95%	1	0.28%
綏	4671		13	1	0.000151%	662036	99.95%	1	0.28%
綃	4672		13	1	0.000151%	662037	99.95%	1	0.28%
綰	4673		14	1	0.000151%	662038	99.95%	1	0.28%
綵	4674		14	1	0.000151%	662039	99.95%	1	0.28%
綟	4675		14	1	0.000151%	662040	99.95%	1	0.28%
綦	4676		14	1	0.000151%	662041	99.95%	1	0.28%
縊	4677		16	1	0.000151%	662042	99.95%	1	0.28%
縉	4678		16	1	0.000151%	662043	99.95%	1	0.28%
縟	4679		16	1	0.000151%	662044	99.95%	1	0.28%
顈	4680		17	1	0.000151%	662045	99.95%	1	0.28%
繕	4681		18	1	0.000151%	662046	99.95%	1	0.28%
繭	4682		19	1	0.000151%	662047	99.95%	1	0.28%
纙	4683		25	1	0.000151%	662048	99.95%	1	0.28%
罈	4684		18	1	0.000151%	662049	99.95%	1	0.28%
罌	4685		20	1	0.000151%	662050	99.95%	1	0.28%
罣	4686		11	1	0.000151%	662051	99.95%	1	0.28%
羌	4687		8	1	0.000151%	662052	99.95%	1	0.28%
翕	4688		12	1	0.000151%	662053	99.95%	1	0.28%
耒	4689		6	1	0.000151%	662054	99.95%	1	0.28%
耨	4690		16	1	0.000151%	662055	99.95%	1	0.28%
聃	4691		11	1	0.000151%	662056	99.95%	1	0.28%
聿	4692		6	1	0.000151%	662057	99.95%	1	0.28%
肄	4693		13	1	0.000151%	662058	99.96%	1	0.28%
胤	4694		9	1	0.000151%	662059	99.96%	1	0.28%
胝	4695		9	1	0.000151%	662060	99.96%	1	0.28%
胠	4696		9	1	0.000151%	662061	99.96%	1	0.28%
胼	4697		10	1	0.000151%	662062	99.96%	1	0.28%
脖	4698		11	1	0.000151%	662063	99.96%	1	0.28%
腆	4699		12	1	0.000151%	662064	99.96%	1	0.28%
腓	4700		12	1	0.000151%	662065	99.96%	1	0.28%
腱	4701		13	1	0.000151%	662066	99.96%	1	0.28%
臃	4702		17	1	0.000151%	662067	99.96%	1	0.28%
臊	4703		17	1	0.000151%	662068	99.96%	1	0.28%
臚	4704		20	1	0.000151%	662069	99.96%	1	0.28%
臾	4705		8	1	0.000151%	662070	99.96%	1	0.28%
芷	4706		8	1	0.000151%	662071	99.96%	1	0.28%
芮	4707		8	1	0.000151%	662072	99.96%	1	0.28%
苞	4708		9	1	0.000151%	662073	99.96%	1	0.28%
苕	4709		9	1	0.000151%	662074	99.96%	1	0.28%
荐	4710		10	1	0.000151%	662075	99.96%	1	0.28%
荀	4711		10	1	0.000151%	662076	99.96%	1	0.28%
茨	4712		10	1	0.000151%	662077	99.96%	1	0.28%
荸	4713		11	1	0.000151%	662078	99.96%	1	0.28%
萃	4714		12	1	0.000151%	662079	99.96%	1	0.28%
菅	4715		12	1	0.000151%	662080	99.96%	1	0.28%
菖	4716		12	1	0.000151%	662081	99.96%	1	0.28%
	4717		13	1	0.000151%	662082	99.96%	1	0.28%
葫	4718		13	1	0.000151%	662083	99.96%	1	0.28%
葆	4719		13	1	0.000151%	662084	99.96%	1	0.28%
蒞	4720		14	1	0.000151%	662085	99.96%	1	0.28%
蓀	4721		14	1	0.000151%	662086	99.96%	1	0.28%
蒺	4722		14	1	0.000151%	662087	99.96%	1	0.28%
蔻	4723		15	1	0.000151%	662088	99.96%	1	0.28%
蓼	4724		15	1	0.000151%	662089	99.96%	1	0.28%
蕖	4725		16	1	0.000151%	662090	99.96%	1	0.28%
薤	4726		17	1	0.000151%	662091	99.96%	1	0.28%
藐	4727		18	1	0.000151%	662092	99.96%	1	0.28%
薺	4728		18	1	0.000151%	662093	99.96%	1	0.28%
藪	4729		19	1	0.000151%	662094	99.96%	1	0.28%
藜	4730		19	1	0.000151%	662095	99.96%	1	0.28%
蘚	4731		21	1	0.000151%	662096	99.96%	1	0.28%
蘘	4732		21	1	0.000151%	662097	99.96%	1	0.28%
蘧	4733		21	1	0.000151%	662098	99.96%	1	0.28%
蘼	4734		23	1	0.000151%	662099	99.96%	1	0.28%
虌	4735		29	1	0.000151%	662100	99.96%	1	0.28%
虫	4736		6	1	0.000151%	662101	99.96%	1	0.28%
蚪	4737		10	1	0.000151%	662102	99.96%	1	0.28%
蚓	4738		10	1	0.000151%	662103	99.96%	1	0.28%
蚣	4739		10	1	0.000151%	662104	99.96%	1	0.28%
蚋	4740		10	1	0.000151%	662105	99.96%	1	0.28%
蚶	4741		11	1	0.000151%	662106	99.96%	1	0.28%
蚯	4742		11	1	0.000151%	662107	99.96%	1	0.28%
蛹	4743		13	1	0.000151%	662108	99.96%	1	0.28%
蜈	4744		13	1	0.000151%	662109	99.96%	1	0.28%
蜉	4745		13	1	0.000151%	662110	99.96%	1	0.28%
蜩	4746		14	1	0.000151%	662111	99.96%	1	0.28%
蜮	4747		14	1	0.000151%	662112	99.96%	1	0.28%
螂	4748		15	1	0.000151%	662113	99.96%	1	0.28%
蝸	4749		15	1	0.000151%	662114	99.96%	1	0.28%
蝗	4750		15	1	0.000151%	662115	99.96%	1	0.28%
蝌	4751		15	1	0.000151%	662116	99.96%	1	0.28%
蝣	4752		15	1	0.000151%	662117	99.96%	1	0.28%
蝎	4753		15	1	0.000151%	662118	99.96%	1	0.28%
螗	4754		16	1	0.000151%	662119	99.96%	1	0.28%
螳	4755		17	1	0.000151%	662120	99.96%	1	0.28%
蟒	4756		17	1	0.000151%	662121	99.96%	1	0.28%
螫	4757		17	1	0.000151%	662122	99.96%	1	0.28%
螻	4758		17	1	0.000151%	662123	99.96%	1	0.28%
蟠	4759		18	1	0.000151%	662124	99.96%	1	0.28%
蠹	4760		24	1	0.000151%	662125	99.97%	1	0.28%
衙	4761		13	1	0.000151%	662126	99.97%	1	0.28%
衢	4762		24	1	0.000151%	662127	99.97%	1	0.28%
袂	4763		9	1	0.000151%	662128	99.97%	1	0.28%
衲	4764		9	1	0.000151%	662129	99.97%	1	0.28%
袒	4765		10	1	0.000151%	662130	99.97%	1	0.28%
衾	4766		10	1	0.000151%	662131	99.97%	1	0.28%
袞	4767		11	1	0.000151%	662132	99.97%	1	0.28%
褂	4768		13	1	0.000151%	662133	99.97%	1	0.28%
裱	4769		13	1	0.000151%	662134	99.97%	1	0.28%
襌	4770		17	1	0.000151%	662135	99.97%	1	0.28%
襖	4771		18	1	0.000151%	662136	99.97%	1	0.28%
襤	4772		19	1	0.000151%	662137	99.97%	1	0.28%
覈	4773		19	1	0.000151%	662138	99.97%	1	0.28%
覡	4774		14	1	0.000151%	662139	99.97%	1	0.28%
覲	4775		18	1	0.000151%	662140	99.97%	1	0.28%
覷	4776		19	1	0.000151%	662141	99.97%	1	0.28%
覿	4777		22	1	0.000151%	662142	99.97%	1	0.28%
觫	4778		14	1	0.000151%	662143	99.97%	1	0.28%
觳	4779		17	1	0.000151%	662144	99.97%	1	0.28%
訏	4780		10	1	0.000151%	662145	99.97%	1	0.28%
訢	4781		11	1	0.000151%	662146	99.97%	1	0.28%
詎	4782		12	1	0.000151%	662147	99.97%	1	0.28%
詑	4783		12	1	0.000151%	662148	99.97%	1	0.28%
詣	4784		13	1	0.000151%	662149	99.97%	1	0.28%
詮	4785		13	1	0.000151%	662150	99.97%	1	0.28%
詬	4786		13	1	0.000151%	662151	99.97%	1	0.28%
詵	4787		13	1	0.000151%	662152	99.97%	1	0.28%
諉	4788		15	1	0.000151%	662153	99.97%	1	0.28%
諫	4789		16	1	0.000151%	662154	99.97%	1	0.28%
諼	4790		16	1	0.000151%	662155	99.97%	1	0.28%
謔	4791		16	1	0.000151%	662156	99.97%	1	0.28%
謄	4792		17	1	0.000151%	662157	99.97%	1	0.28%
謤	4793		18	1	0.000151%	662158	99.97%	1	0.28%
譪	4794		20	1	0.000151%	662159	99.97%	1	0.28%
讞	4795		26	1	0.000151%	662160	99.97%	1	0.28%
谿	4796		17	1	0.000151%	662161	99.97%	1	0.28%
豉	4797		11	1	0.000151%	662162	99.97%	1	0.28%
豔	4798		28	1	0.000151%	662163	99.97%	1	0.28%
豸	4799		7	1	0.000151%	662164	99.97%	1	0.28%
賄	4800		13	1	0.000151%	662165	99.97%	1	0.28%
貲	4801		13	1	0.000151%	662166	99.97%	1	0.28%
賻	4802		17	1	0.000151%	662167	99.97%	1	0.28%
贖	4803		22	1	0.000151%	662168	99.97%	1	0.28%
趄	4804		12	1	0.000151%	662169	99.97%	1	0.28%
趑	4805		13	1	0.000151%	662170	99.97%	1	0.28%
趾	4806		11	1	0.000151%	662171	99.97%	1	0.28%
跛	4807		12	1	0.000151%	662172	99.97%	1	0.28%
跺	4808		13	1	0.000151%	662173	99.97%	1	0.28%
跫	4809		13	1	0.000151%	662174	99.97%	1	0.28%
踟	4810		15	1	0.000151%	662175	99.97%	1	0.28%
踮	4811		15	1	0.000151%	662176	99.97%	1	0.28%
踜	4812		15	1	0.000151%	662177	99.97%	1	0.28%
蹉	4813		17	1	0.000151%	662178	99.97%	1	0.28%
蹋	4814		17	1	0.000151%	662179	99.97%	1	0.28%
蹓	4815		17	1	0.000151%	662180	99.97%	1	0.28%
蹧	4816		18	1	0.000151%	662181	99.97%	1	0.28%
蹩	4817		18	1	0.000151%	662182	99.97%	1	0.28%
蹺	4818		19	1	0.000151%	662183	99.97%	1	0.28%
躓	4819		22	1	0.000151%	662184	99.97%	1	0.28%
躕	4820		22	1	0.000151%	662185	99.97%	1	0.28%
躚	4821		22	1	0.000151%	662186	99.97%	1	0.28%
躣	4822		25	1	0.000151%	662187	99.97%	1	0.28%
躦	4823		26	1	0.000151%	662188	99.97%	1	0.28%
躪	4824		27	1	0.000151%	662189	99.97%	1	0.28%
軻	4825		12	1	0.000151%	662190	99.97%	1	0.28%
軼	4826		12	1	0.000151%	662191	99.98%	1	0.28%
輻	4827		16	1	0.000151%	662192	99.98%	1	0.28%
輳	4828		16	1	0.000151%	662193	99.98%	1	0.28%
轢	4829		22	1	0.000151%	662194	99.98%	1	0.28%
逶	4830		11	1	0.000151%	662195	99.98%	1	0.28%
遁	4831		12	1	0.000151%	662196	99.98%	1	0.28%
邑	4832		7	1	0.000151%	662197	99.98%	1	0.28%
郝	4833		9	1	0.000151%	662198	99.98%	1	0.28%
酆	4834		20	1	0.000151%	662199	99.98%	1	0.28%
酢	4835		12	1	0.000151%	662200	99.98%	1	0.28%
酪	4836		13	1	0.000151%	662201	99.98%	1	0.28%
醐	4837		16	1	0.000151%	662202	99.98%	1	0.28%
醍	4838		16	1	0.000151%	662203	99.98%	1	0.28%
醪	4839		18	1	0.000151%	662204	99.98%	1	0.28%
醱	4840		19	1	0.000151%	662205	99.98%	1	0.28%
醵	4841		20	1	0.000151%	662206	99.98%	1	0.28%
釉	4842		13	1	0.000151%	662207	99.98%	1	0.28%
釵	4843		11	1	0.000151%	662208	99.98%	1	0.28%
鈉	4844		12	1	0.000151%	662209	99.98%	1	0.28%
鈐	4845		12	1	0.000151%	662210	99.98%	1	0.28%
鈄	4846		12	1	0.000151%	662211	99.98%	1	0.28%
鉤	4847		13	1	0.000151%	662212	99.98%	1	0.28%
鉸	4848		14	1	0.000151%	662213	99.98%	1	0.28%
鋅	4849		15	1	0.000151%	662214	99.98%	1	0.28%
鋓	4850		15	1	0.000151%	662215	99.98%	1	0.28%
鍍	4851		17	1	0.000151%	662216	99.98%	1	0.28%
鍔	4852		17	1	0.000151%	662217	99.98%	1	0.28%
鍼	4853		17	1	0.000151%	662218	99.98%	1	0.28%
鎔	4854		18	1	0.000151%	662219	99.98%	1	0.28%
鎊	4855		18	1	0.000151%	662220	99.98%	1	0.28%
鎳	4856		18	1	0.000151%	662221	99.98%	1	0.28%
鏑	4857		19	1	0.000151%	662222	99.98%	1	0.28%
鏗	4858		19	1	0.000151%	662223	99.98%	1	0.28%
鏇	4859		19	1	0.000151%	662224	99.98%	1	0.28%
鏐	4860		19	1	0.000151%	662225	99.98%	1	0.28%
鐺	4861		21	1	0.000151%	662226	99.98%	1	0.28%
鐫	4862		21	1	0.000151%	662227	99.98%	1	0.28%
鑣	4863		23	1	0.000151%	662228	99.98%	1	0.28%
鑠	4864		23	1	0.000151%	662229	99.98%	1	0.28%
閘	4865		13	1	0.000151%	662230	99.98%	1	0.28%
閞	4866		13	1	0.000151%	662231	99.98%	1	0.28%
閡	4867		14	1	0.000151%	662232	99.98%	1	0.28%
閬	4868		15	1	0.000151%	662233	99.98%	1	0.28%
闋	4869		17	1	0.000151%	662234	99.98%	1	0.28%
闇	4870		17	1	0.000151%	662235	99.98%	1	0.28%
闓	4871		18	1	0.000151%	662236	99.98%	1	0.28%
阜	4872		8	1	0.000151%	662237	99.98%	1	0.28%
陔	4873		8	1	0.000151%	662238	99.98%	1	0.28%
陟	4874		9	1	0.000151%	662239	99.98%	1	0.28%
隈	4875		11	1	0.000151%	662240	99.98%	1	0.28%
隕	4876		12	1	0.000151%	662241	99.98%	1	0.28%
雉	4877		13	1	0.000151%	662242	99.98%	1	0.28%
雒	4878		14	1	0.000151%	662243	99.98%	1	0.28%
霾	4879		22	1	0.000151%	662244	99.98%	1	0.28%
靆	4880		24	1	0.000151%	662245	99.98%	1	0.28%
靛	4881		16	1	0.000151%	662246	99.98%	1	0.28%
靦	4882		16	1	0.000151%	662247	99.98%	1	0.28%
	4883		12	1	0.000151%	662248	99.98%	1	0.28%
靼	4884		14	1	0.000151%	662249	99.98%	1	0.28%
鞍	4885		15	1	0.000151%	662250	99.98%	1	0.28%
鞏	4886		15	1	0.000151%	662251	99.98%	1	0.28%
鞘	4887		16	1	0.000151%	662252	99.98%	1	0.28%
鞣	4888		18	1	0.000151%	662253	99.98%	1	0.28%
鞦	4889		18	1	0.000151%	662254	99.98%	1	0.28%
韃	4890		22	1	0.000151%	662255	99.98%	1	0.28%
韆	4891		24	1	0.000151%	662256	99.98%	1	0.28%
韋	4892		9	1	0.000151%	662257	99.99%	1	0.28%
頜	4893		15	1	0.000151%	662258	99.99%	1	0.28%
頷	4894		16	1	0.000151%	662259	99.99%	1	0.28%
飴	4895		13	1	0.000151%	662260	99.99%	1	0.28%
餉	4896		14	1	0.000151%	662261	99.99%	1	0.28%
餡	4897		16	1	0.000151%	662262	99.99%	1	0.28%
饈	4898		19	1	0.000151%	662263	99.99%	1	0.28%
饗	4899		21	1	0.000151%	662264	99.99%	1	0.28%
饕	4900		22	1	0.000151%	662265	99.99%	1	0.28%
駒	4901		15	1	0.000151%	662266	99.99%	1	0.28%
駖	4902		15	1	0.000151%	662267	99.99%	1	0.28%
駰	4903		16	1	0.000151%	662268	99.99%	1	0.28%
騫	4904		20	1	0.000151%	662269	99.99%	1	0.28%
驥	4905		26	1	0.000151%	662270	99.99%	1	0.28%
骯	4906		14	1	0.000151%	662271	99.99%	1	0.28%
髲	4907		15	1	0.000151%	662272	99.99%	1	0.28%
鬨	4908		16	1	0.000151%	662273	99.99%	1	0.28%
鬮	4909		26	1	0.000151%	662274	99.99%	1	0.28%
鬲	4910		10	1	0.000151%	662275	99.99%	1	0.28%
魽	4911		15	1	0.000151%	662276	99.99%	1	0.28%
鮐	4912		16	1	0.000151%	662277	99.99%	1	0.28%
鯇	4913		18	1	0.000151%	662278	99.99%	1	0.28%
鯧	4914		19	1	0.000151%	662279	99.99%	1	0.28%
鯕	4915		19	1	0.000151%	662280	99.99%	1	0.28%
鰍	4916		20	1	0.000151%	662281	99.99%	1	0.28%
鰥	4917		21	1	0.000151%	662282	99.99%	1	0.28%
鱉	4918		22	1	0.000151%	662283	99.99%	1	0.28%
鰲	4919		22	1	0.000151%	662284	99.99%	1	0.28%
鱔	4920		23	1	0.000151%	662285	99.99%	1	0.28%
鱟	4921		24	1	0.000151%	662286	99.99%	1	0.28%
鳶	4922		14	1	0.000151%	662287	99.99%	1	0.28%
鴕	4923		16	1	0.000151%	662288	99.99%	1	0.28%
鴣	4924		16	1	0.000151%	662289	99.99%	1	0.28%
鵲	4925		19	1	0.000151%	662290	99.99%	1	0.28%
鵪	4926		19	1	0.000151%	662291	99.99%	1	0.28%
鶩	4927		20	1	0.000151%	662292	99.99%	1	0.28%
鷓	4928		22	1	0.000151%	662293	99.99%	1	0.28%
鷺	4929		24	1	0.000151%	662294	99.99%	1	0.28%
鸁	4930		24	1	0.000151%	662295	99.99%	1	0.28%
鹵	4931		11	1	0.000151%	662296	99.99%	1	0.28%
鹼	4932		24	1	0.000151%	662297	99.99%	1	0.28%
麃	4933		15	1	0.000151%	662298	99.99%	1	0.28%
麜	4934		21	1	0.000151%	662299	99.99%	1	0.28%
齧	4935		21	1	0.000151%	662300	99.99%	1	0.28%
龔	4936		22	1	0.000151%	662301	99.99%	1	0.28%
龕	4937		22	1	0.000151%	662302	99.99%	1	0.28%
