單字	序號	部首	筆劃	頻次	頻率	累積頻次	累積頻率	見檔次	見檔率
的	1		8	29327	4.425%	29327	4.425%	247	99.99%
一	2		1	10466	1.579%	39793	6.005%	247	99.99%
是	3		9	8724	1.316%	48517	7.321%	247	99.99%
了	4		2	7621	1.150%	56138	8.471%	247	99.99%
不	5		4	7074	1.067%	63212	9.539%	247	99.99%
在	6		6	6654	1.004%	69866	10.54%	247	99.99%
有	7		6	5945	0.8971%	75811	11.44%	247	99.99%
和	12		8	4101	0.6188%	79912	15.24%	247	99.99%
上	13		3	3971	0.5992%	83883	15.84%	247	99.99%
大	14		3	3754	0.5665%	87637	16.41%	247	99.99%
個	15		10	3734	0.5635%	91371	16.97%	247	99.99%
來	18		8	3425	0.5168%	94796	18.60%	247	99.99%
以	30		5	2548	0.3845%	97344	23.76%	247	99.99%
過	48		12	1955	0.295%	99299	29.66%	247	99.99%
人	8		2	5912	0.8921%	105211	12.33%	246	99.60%
這	11		10	4613	0.6961%	109824	14.62%	246	99.60%
地	17		6	3697	0.5579%	113521	18.09%	246	99.60%
為	19		9	3335	0.5032%	116856	19.11%	246	99.60%
到	23		8	2886	0.4355%	119742	20.92%	246	99.60%
要	27		9	2687	0.4055%	122429	22.58%	246	99.60%
出	28		5	2645	0.3991%	125074	22.98%	246	99.60%
得	44		11	2014	0.3039%	127088	28.46%	246	99.60%
下	49		3	1930	0.2912%	129018	29.95%	246	99.60%
時	26		10	2690	0.4059%	131708	22.17%	245	99.19%
對	37		14	2248	0.3392%	133956	26.22%	245	99.19%
多	51		6	1855	0.2799%	135811	30.52%	245	99.19%
中	16		4	3704	0.5589%	139515	17.53%	244	98.79%
生	24		5	2861	0.4317%	142376	21.35%	244	98.79%
自	40		6	2170	0.3274%	144546	27.21%	244	98.79%
會	29		13	2614	0.3944%	147160	23.37%	243	98.38%
也	32		3	2379	0.359%	149539	24.49%	243	98.38%
可	54		5	1800	0.2716%	151339	31.34%	243	98.38%
從	81		11	1412	0.2131%	152751	37.66%	243	98.38%
們	21		10	3083	0.4652%	155834	20.04%	242	97.98%
現	52		11	1854	0.2798%	157688	30.79%	242	97.98%
後	57		9	1709	0.2579%	159397	32.13%	242	97.98%
著	22		12	2931	0.4423%	162328	20.48%	241	97.57%
發	34		12	2308	0.3483%	164636	25.19%	241	97.57%
就	36		12	2259	0.3409%	166895	25.88%	241	97.57%
之	56		4	1713	0.2585%	168608	31.87%	241	97.57%
還	72		16	1502	0.2266%	170110	35.68%	241	97.57%
我	9		7	5855	0.8835%	175965	13.22%	240	97.17%
而	45		6	2014	0.3039%	177979	28.76%	240	97.17%
能	46		10	1994	0.3009%	179973	29.07%	240	97.17%
都	69		9	1531	0.231%	181504	34.99%	240	97.17%
面	83		9	1389	0.2096%	182893	38.09%	240	97.17%
成	50		6	1879	0.2835%	184772	30.24%	239	96.76%
起	64		10	1561	0.2356%	186333	33.82%	239	96.76%
前	102		9	1202	0.1814%	187535	41.71%	239	96.76%
年	25		6	2783	0.4199%	190318	21.77%	238	96.36%
種	61		14	1590	0.2399%	191908	33.11%	238	96.36%
又	89		2	1280	0.1931%	193188	39.30%	238	96.36%
家	39		10	2178	0.3287%	195366	26.89%	237	95.95%
於	47		8	1988	0.300%	197354	29.37%	237	95.95%
然	66		12	1549	0.2337%	198903	34.29%	237	95.95%
經	43		13	2054	0.3099%	200957	28.16%	236	95.55%
動	65		11	1560	0.2354%	202517	34.06%	235	95.14%
開	75		12	1486	0.2242%	204003	36.35%	235	95.14%
進	78		11	1476	0.2227%	205479	37.02%	235	95.14%
些	105		8	1196	0.1805%	206675	42.25%	235	95.14%
點	131		17	1009	0.1523%	207684	46.54%	235	95.14%
說	31		14	2479	0.3741%	210163	24.13%	234	94.74%
行	53		6	1812	0.2734%	211975	31.07%	234	94.74%
用	63		5	1574	0.2375%	213549	33.59%	234	94.74%
當	94		13	1231	0.1858%	214780	40.24%	234	94.74%
作	33		7	2347	0.3542%	217127	24.85%	233	94.33%
同	70		6	1528	0.2306%	218655	35.22%	233	94.33%
分	73		4	1501	0.2265%	220156	35.90%	232	93.93%
正	145		5	930	0.1403%	221086	48.58%	232	93.93%
方	59		4	1677	0.2531%	222763	32.63%	231	93.52%
好	87		6	1344	0.2028%	224107	38.90%	231	93.52%
樣	107		15	1183	0.1785%	225290	42.61%	230	93.12%
如	110		6	1165	0.1758%	226455	43.14%	230	93.12%
他	10		5	4718	0.7119%	231173	13.93%	229	92.71%
心	71		4	1518	0.2291%	232691	35.45%	229	92.71%
高	96		10	1225	0.1848%	233916	40.61%	229	92.71%
所	99		8	1216	0.1835%	235132	41.16%	228	92.31%
無	130		12	1012	0.1527%	236144	46.38%	228	92.31%
明	141		8	951	0.1435%	237095	48.01%	228	92.31%
實	68		14	1540	0.2324%	238635	34.76%	227	91.90%
三	128		3	1018	0.1536%	239653	46.08%	226	91.50%
把	92		7	1236	0.1865%	240889	39.87%	225	91.09%
長	95		8	1230	0.1856%	242119	40.42%	225	91.09%
外	101		5	1206	0.182%	243325	41.52%	225	91.09%
間	147		12	922	0.1391%	244247	48.86%	225	91.09%
重	112		9	1150	0.1735%	245397	43.48%	224	90.69%
兩	132		8	1002	0.1512%	246399	46.69%	224	90.69%
子	38		3	2225	0.3357%	248624	26.56%	223	90.28%
去	62		5	1578	0.2381%	250202	33.35%	223	90.28%
小	55		3	1783	0.2691%	251985	31.61%	222	89.88%
定	106		8	1188	0.1793%	253173	42.43%	222	89.88%
使	135		8	992	0.1497%	254165	47.14%	222	89.88%
最	168		12	805	0.1215%	254970	51.54%	222	89.88%
但	138		7	965	0.1456%	255935	47.58%	221	89.47%
只	140		5	951	0.1435%	256886	47.87%	221	89.47%
情	91		11	1256	0.1895%	258142	39.68%	220	89.07%
十	97		2	1221	0.1842%	259363	40.79%	220	89.07%
意	116		13	1111	0.1676%	260474	44.17%	220	89.07%
因	144		6	934	0.1409%	261408	48.44%	220	89.07%
沒	88		7	1335	0.2014%	262743	39.10%	219	88.66%
等	109		12	1170	0.1766%	263913	42.96%	219	88.66%
事	117		8	1109	0.1673%	265022	44.33%	219	88.66%
道	134		12	996	0.1503%	266018	46.99%	219	88.66%
已	158		3	845	0.1275%	266863	50.31%	219	88.66%
其	115		8	1120	0.169%	267983	44.00%	218	88.26%
相	166		9	808	0.1219%	268791	51.29%	218	88.26%
本	129		5	1017	0.1535%	269808	46.23%	217	87.85%
新	143		13	943	0.1423%	270751	48.30%	217	87.85%
向	152		6	890	0.1343%	271641	49.53%	217	87.85%
全	124		6	1042	0.1572%	272683	45.46%	216	87.45%
天	67		4	1540	0.2324%	274223	34.53%	215	87.04%
看	82		9	1403	0.2117%	275626	37.88%	215	87.04%
體	104		23	1199	0.1809%	276825	42.07%	215	87.04%
身	154		7	867	0.1308%	277692	49.79%	215	87.04%
幾	179		12	764	0.1153%	278456	52.83%	214	86.64%
國	20		11	3088	0.466%	281544	19.57%	213	86.23%
那	42		6	2065	0.3116%	283609	27.85%	213	86.23%
者	120		8	1069	0.1613%	284678	44.82%	213	86.23%
很	161		9	815	0.123%	285493	50.68%	213	86.23%
理	60		11	1599	0.2413%	287092	32.87%	212	85.83%
學	35		16	2302	0.3474%	289394	25.54%	211	85.43%
關	119		19	1081	0.1631%	290475	44.66%	211	85.43%
此	187		6	730	0.1102%	291205	53.73%	211	85.43%
活	123		9	1048	0.1581%	292253	45.30%	210	85.02%
二	159		2	844	0.1274%	293097	50.43%	210	85.02%
別	241		7	624	0.09416%	293721	59.26%	210	85.02%
想	93		13	1235	0.1864%	294956	40.05%	209	84.62%
並	189		8	728	0.1099%	295684	53.95%	208	84.21%
見	155		7	862	0.1301%	296546	49.92%	207	83.81%
次	160		6	844	0.1274%	297390	50.56%	207	83.81%
更	211		7	687	0.1037%	298077	56.30%	207	83.81%
法	80		8	1419	0.2141%	299496	37.45%	206	83.40%
與	84		14	1360	0.2052%	300856	38.29%	206	83.40%
由	175		5	777	0.1172%	301633	52.37%	205	83.00%
主	77		5	1477	0.2229%	303110	36.80%	204	82.59%
力	125		2	1040	0.1569%	304150	45.61%	204	82.59%
問	156		11	850	0.1283%	305000	50.05%	204	82.59%
己	149		3	893	0.1348%	305893	49.13%	203	82.19%
位	192		7	722	0.1089%	306615	54.27%	203	82.19%
原	206		10	697	0.1052%	307312	55.77%	203	82.19%
麼	76		14	1481	0.2235%	308793	36.58%	202	81.78%
水	111		4	1159	0.1749%	309952	43.31%	201	81.38%
手	126		4	1029	0.1553%	310981	45.77%	201	81.38%
結	183		12	741	0.1118%	311722	53.28%	201	81.38%
日	184		4	736	0.1111%	312458	53.39%	200	80.97%
少	228		4	654	0.09869%	313112	58.02%	200	80.97%
加	142		5	945	0.1426%	314057	48.15%	199	80.57%
應	172		17	790	0.1192%	314847	52.02%	199	80.57%
提	167		12	805	0.1215%	315652	51.42%	198	80.16%
處	244		11	614	0.09265%	316266	59.54%	198	80.16%
化	98		4	1219	0.1839%	317485	40.98%	197	79.76%
部	122		10	1050	0.1584%	318535	45.14%	197	79.76%
比	224		4	661	0.09974%	319196	57.62%	197	79.76%
入	199		2	711	0.1073%	319907	55.03%	196	79.35%
四	230		5	649	0.09793%	320556	58.21%	196	79.35%
平	182		5	742	0.112%	321298	53.17%	195	78.95%
知	185		8	733	0.1106%	322031	53.51%	195	78.95%
被	203		10	701	0.1058%	322732	55.46%	195	78.95%
工	85		3	1358	0.2049%	324090	38.50%	194	78.54%
真	209		10	692	0.1044%	324782	56.09%	194	78.54%
頭	139		16	958	0.1446%	325740	47.72%	193	78.14%
給	220		12	669	0.101%	326409	57.22%	193	78.14%
先	243		6	617	0.0931%	327026	59.45%	193	78.14%
文	58		4	1680	0.2535%	328706	32.38%	192	77.73%
性	113		8	1144	0.1726%	329850	43.66%	192	77.73%
代	118		5	1090	0.1645%	330940	44.50%	192	77.73%
條	266		11	571	0.08616%	331511	61.50%	192	77.73%
許	299		11	496	0.07485%	332007	64.14%	192	77.73%
特	180		10	750	0.1132%	332757	52.95%	191	77.33%
總	249		17	603	0.09099%	333360	60.00%	190	76.92%
果	254		8	590	0.08903%	333950	60.45%	190	76.92%
受	264		8	572	0.08631%	334522	61.32%	190	76.92%
內	197		4	715	0.1079%	335237	54.82%	189	76.52%
目	202		5	708	0.1068%	335945	55.35%	189	76.52%
回	214		6	684	0.1032%	336629	56.61%	189	76.52%
難	292		19	520	0.07847%	337149	63.61%	188	76.11%
完	323		7	464	0.07002%	337613	65.88%	188	76.11%
變	225		23	658	0.09929%	338271	57.72%	187	75.71%
直	312		8	482	0.07273%	338753	65.10%	187	75.71%
表	193		8	722	0.1089%	339475	54.38%	186	75.30%
通	242		10	621	0.09371%	340096	59.36%	186	75.30%
至	315		6	478	0.07213%	340574	65.31%	186	75.30%
民	86		5	1347	0.2033%	341921	38.70%	185	74.90%
氣	150		10	893	0.1348%	342814	49.26%	185	74.90%
認	245		14	611	0.0922%	343425	59.64%	185	74.90%
放	257		8	586	0.08843%	344011	60.72%	185	74.90%
立	148		5	899	0.1357%	344910	48.99%	184	74.49%
物	165		8	808	0.1219%	345718	51.17%	184	74.49%
走	169		7	795	0.120%	346513	51.66%	183	74.09%
常	239		11	627	0.09461%	347140	59.08%	183	74.09%
再	286		6	523	0.07892%	347663	63.14%	183	74.09%
接	311		11	482	0.07273%	348145	65.03%	183	74.09%
門	186		8	733	0.1106%	348878	53.62%	182	73.68%
解	255		13	588	0.08873%	349466	60.54%	182	73.68%
才	290		3	521	0.07862%	349987	63.45%	182	73.68%
感	181		13	746	0.1126%	350733	53.06%	181	73.28%
流	208		9	694	0.1047%	351427	55.98%	181	73.28%
深	217		11	680	0.1026%	352107	56.91%	181	73.28%
今	329		4	452	0.06821%	352559	66.30%	181	73.28%
老	90		6	1279	0.193%	353838	39.49%	180	72.87%
它	136		5	989	0.1492%	354827	47.29%	180	72.87%
合	170		6	791	0.1194%	355618	51.78%	180	72.87%
風	210		9	689	0.104%	356307	56.19%	180	72.87%
五	271		4	562	0.0848%	356869	61.92%	180	72.87%
步	275		7	547	0.08254%	357416	62.26%	180	72.87%
度	212		9	686	0.1035%	358102	56.40%	179	72.47%
色	223		6	662	0.09989%	358764	57.52%	179	72.47%
帶	331		11	451	0.06805%	359215	66.43%	179	72.47%
形	191		7	725	0.1094%	359940	54.16%	178	72.06%
世	204		5	699	0.1055%	360639	55.56%	178	72.06%
機	205		16	698	0.1053%	361337	55.67%	178	72.06%
切	349		4	429	0.06474%	361766	67.62%	178	72.06%
第	219		11	671	0.1013%	362437	57.12%	177	71.66%
滿	280		14	533	0.08043%	362970	62.66%	177	71.66%
論	178		15	765	0.1154%	363735	52.72%	176	71.26%
近	396		7	379	0.05719%	364114	70.49%	176	71.26%
光	251		6	596	0.08994%	364710	60.18%	175	70.85%
或	256		8	587	0.08858%	365297	60.63%	175	70.85%
界	278		9	539	0.08133%	365836	62.50%	175	70.85%
路	294		13	510	0.07696%	366346	63.77%	175	70.85%
思	221		9	668	0.1008%	367014	57.32%	174	70.45%
話	234		13	640	0.09657%	367654	58.60%	174	70.45%
指	295		9	507	0.07651%	368161	63.84%	174	70.45%
做	313		11	480	0.07243%	368641	65.17%	174	70.45%
像	153		14	867	0.1308%	369508	49.66%	173	70.04%
口	200		3	711	0.1073%	370219	55.14%	173	70.04%
各	190		6	728	0.1099%	370947	54.06%	172	69.64%
神	218		9	674	0.1017%	371621	57.02%	172	69.64%
管	222		14	665	0.1003%	372286	57.42%	172	69.64%
月	232		4	644	0.09718%	372930	58.41%	172	69.64%
名	259		6	579	0.08737%	373509	60.89%	172	69.64%
公	216		4	683	0.1031%	374192	56.81%	171	69.23%
期	240		12	625	0.09431%	374817	59.17%	171	69.23%
將	298		11	498	0.07515%	375315	64.07%	171	69.23%
根	346		10	433	0.06534%	375748	67.43%	171	69.23%
強	201		11	709	0.107%	376457	55.25%	170	68.83%
清	307		11	485	0.07319%	376942	64.73%	170	68.83%
件	355		6	422	0.06368%	377364	68.01%	170	68.83%
觀	248		25	605	0.09129%	377969	59.91%	169	68.42%
反	284		4	525	0.07922%	378494	62.98%	169	68.42%
題	215		18	684	0.1032%	379178	56.71%	168	68.02%
西	272		6	561	0.08465%	379739	62.01%	168	68.02%
打	277		5	539	0.08133%	380278	62.42%	168	68.02%
便	308		9	484	0.07303%	380762	64.81%	168	68.02%
產	74		11	1501	0.2265%	382263	36.13%	167	67.61%
求	300		7	495	0.07469%	382758	64.22%	167	67.61%
且	402		5	374	0.05644%	383132	70.83%	166	67.21%
轉	297		18	501	0.0756%	383633	63.99%	165	66.80%
什	163		4	808	0.1219%	384441	50.93%	163	65.99%
任	282		6	530	0.07998%	384971	62.82%	163	65.99%
始	401		8	375	0.05659%	385346	70.77%	163	65.99%
品	151		9	892	0.1346%	386238	49.40%	162	65.59%
信	260		9	578	0.08722%	386816	60.98%	162	65.59%
精	303		14	489	0.07379%	387305	64.44%	162	65.59%
影	306		15	485	0.07319%	387790	64.66%	162	65.59%
卻	309		9	484	0.07303%	388274	64.88%	162	65.59%
何	357		7	421	0.06353%	388695	68.14%	162	65.59%
隨	470		15	306	0.04617%	389001	74.34%	162	65.59%
眼	213		11	686	0.1035%	389687	56.50%	161	65.18%
調	238		15	628	0.09476%	390315	58.98%	161	65.18%
及	265		4	571	0.08616%	390886	61.41%	161	65.18%
數	321		15	466	0.07032%	391352	65.74%	161	65.18%
業	41		13	2135	0.3222%	393487	27.54%	160	64.78%
美	173		9	790	0.1192%	394277	52.13%	160	64.78%
質	276		15	545	0.08224%	394822	62.34%	160	64.78%
每	359		7	415	0.06262%	395237	68.26%	160	64.78%
視	407		12	370	0.05583%	395607	71.11%	160	64.78%
東	250		8	600	0.09054%	396207	60.09%	158	63.97%
取	353		8	426	0.06428%	396633	67.88%	158	63.97%
極	375		13	403	0.06081%	397036	69.25%	158	63.97%
快	393		7	383	0.05779%	397419	70.32%	158	63.97%
制	137		8	980	0.1479%	398399	47.43%	157	63.56%
量	235		12	633	0.09552%	399032	58.70%	157	63.56%
整	333		16	446	0.0673%	399478	66.57%	157	63.56%
安	341		6	439	0.06624%	399917	67.10%	157	63.56%
展	114		10	1138	0.1717%	401055	43.83%	156	63.16%
白	285		5	524	0.07907%	401579	63.06%	156	63.16%
必	364		5	411	0.06202%	401990	68.57%	156	63.16%
落	385		13	391	0.059%	402381	69.85%	156	63.16%
包	415		5	366	0.05523%	402747	71.55%	156	63.16%
失	416		5	366	0.05523%	403113	71.61%	156	63.16%
聲	227		17	656	0.09899%	403769	57.92%	155	62.75%
住	320		7	469	0.07077%	404238	65.67%	155	62.75%
識	258		19	585	0.08828%	404823	60.80%	154	62.35%
建	121		9	1065	0.1607%	405888	44.98%	153	61.94%
熱	421		15	361	0.05447%	406249	71.88%	153	61.94%
即	424		7	357	0.05387%	406606	72.04%	153	61.94%
山	103		3	1199	0.1809%	407805	41.89%	152	61.54%
員	269		10	565	0.08526%	408370	61.75%	152	61.54%
造	289		10	523	0.07892%	408893	63.38%	152	61.54%
格	339		10	441	0.06655%	409334	66.97%	152	61.54%
據	348		16	430	0.06489%	409764	67.56%	152	61.54%
張	287		11	523	0.07892%	410287	63.22%	151	61.13%
往	351		8	428	0.06458%	410715	67.75%	151	61.13%
顯	506		23	280	0.04225%	410995	75.92%	151	61.13%
利	194		7	721	0.1088%	411716	54.49%	150	60.73%
望	361		11	413	0.06232%	412129	68.39%	150	60.73%
遠	413		13	367	0.05538%	412496	71.44%	150	60.73%
交	456		6	321	0.04844%	412817	73.68%	150	60.73%
連	460		10	317	0.04783%	413134	73.87%	150	60.73%
義	177		13	771	0.1163%	413905	52.60%	149	60.32%
單	398		12	377	0.05689%	414282	70.60%	149	60.32%
場	207		12	696	0.105%	414978	55.88%	148	59.92%
愛	261		13	574	0.08662%	415552	61.06%	148	59.92%
式	305		6	485	0.07319%	416037	64.59%	148	59.92%
引	427		4	353	0.05327%	416390	72.20%	148	59.92%
該	448		13	330	0.0498%	416720	73.29%	148	59.92%
斷	480		18	297	0.04482%	417017	74.79%	148	59.92%
術	188		11	729	0.110%	417746	53.84%	147	59.51%
改	252		7	593	0.08948%	418339	60.27%	147	59.51%
花	281		8	531	0.08013%	418870	62.74%	147	59.51%
收	337		6	442	0.0667%	419312	66.84%	147	59.51%
讓	373		24	406	0.06126%	419718	69.13%	147	59.51%
輕	420		14	362	0.05463%	420080	71.83%	147	59.51%
社	127		7	1029	0.1553%	421109	45.92%	146	59.11%
服	304		8	486	0.07334%	421595	64.51%	146	59.11%
傳	338		13	441	0.06655%	422036	66.90%	146	59.11%
非	440		8	341	0.05146%	422377	72.88%	146	59.11%
照	487		13	292	0.04406%	422669	75.10%	146	59.11%
容	466		10	310	0.04678%	422979	74.15%	145	58.70%
則	325		9	458	0.06911%	423437	66.02%	144	58.30%
具	367		8	410	0.06187%	423847	68.76%	144	58.30%
離	439		18	341	0.05146%	424188	72.83%	144	58.30%
首	513		9	274	0.04135%	424462	76.22%	144	58.30%
決	314		7	480	0.07243%	424942	65.24%	143	57.89%
命	343		8	437	0.06594%	425379	67.23%	143	57.89%
兒	164		8	808	0.1219%	426187	51.05%	142	57.49%
邊	317		18	473	0.07137%	426660	65.46%	142	57.49%
領	371		14	408	0.06157%	427068	69.01%	142	57.49%
記	336		10	443	0.06685%	427511	66.77%	140	56.68%
導	347		16	431	0.06504%	427942	67.49%	140	56.68%
覺	366		20	411	0.06202%	428353	68.70%	140	56.68%
集	386		12	391	0.059%	428744	69.91%	140	56.68%
青	395		8	380	0.05734%	429124	70.43%	140	56.68%
興	435		16	343	0.05176%	429467	72.62%	140	56.68%
爭	340		8	440	0.0664%	429907	67.03%	139	56.28%
初	504		7	280	0.04225%	430187	75.84%	139	56.28%
金	171		8	791	0.1194%	430978	51.90%	138	55.87%
候	414		10	366	0.05523%	431344	71.50%	138	55.87%
空	463		8	314	0.04738%	431658	74.01%	138	55.87%
教	198		11	714	0.1077%	432372	54.92%	137	55.47%
類	236		19	633	0.09552%	433005	58.79%	137	55.47%
寫	273		15	551	0.08314%	433556	62.09%	137	55.47%
歷	330		16	452	0.06821%	434008	66.36%	137	55.47%
百	332		6	451	0.06805%	434459	66.50%	137	55.47%
確	412		15	367	0.05538%	434826	71.39%	137	55.47%
節	476		13	304	0.04587%	435130	74.61%	137	55.47%
早	498		6	287	0.04331%	435417	75.58%	137	55.47%
未	502		5	283	0.0427%	435700	75.76%	137	55.47%
程	370		12	409	0.06172%	436109	68.94%	136	55.06%
達	381		12	396	0.05976%	436505	69.61%	136	55.06%
言	432		7	348	0.05251%	436853	72.47%	136	55.06%
足	536		7	259	0.03908%	437112	77.14%	136	55.06%
你	100		7	1213	0.183%	438325	41.34%	135	54.66%
基	176		11	772	0.1165%	439097	52.49%	135	54.66%
海	233		10	644	0.09718%	439741	58.50%	135	54.66%
萬	326		13	457	0.06896%	440198	66.09%	135	54.66%
太	372		4	407	0.06142%	440605	69.07%	135	54.66%
廣	404		15	372	0.05613%	440977	70.94%	135	54.66%
況	468		8	308	0.04648%	441285	74.25%	135	54.66%
乎	539		5	257	0.03878%	441542	77.25%	135	54.66%
苦	451		9	325	0.04904%	441867	73.43%	134	54.25%
僅	479		13	297	0.04482%	442164	74.75%	134	54.25%
留	532		10	261	0.03938%	442425	76.98%	134	54.25%
仍	596		4	224	0.0338%	442649	79.31%	134	54.25%
怎	467		9	310	0.04678%	442959	74.20%	133	53.85%
似	483		7	293	0.04421%	443252	74.93%	133	53.85%
半	494		5	288	0.04346%	443540	75.41%	133	53.85%
聽	301		22	491	0.07409%	444031	64.29%	132	53.44%
親	316		16	477	0.07198%	444508	65.39%	132	53.44%
運	356		12	422	0.06368%	444930	68.07%	132	53.44%
片	397		4	378	0.05704%	445308	70.54%	132	53.44%
千	492		3	289	0.04361%	445597	75.32%	132	53.44%
女	196		3	716	0.108%	446313	54.71%	131	53.04%
北	267		5	568	0.08571%	446881	61.58%	131	53.04%
保	246		9	608	0.09175%	447489	59.73%	130	52.63%
統	262		11	573	0.08646%	448062	61.15%	130	52.63%
八	408		2	369	0.05568%	448431	71.16%	130	52.63%
共	410		6	367	0.05538%	448798	71.27%	130	52.63%
嚴	490		20	290	0.04376%	449088	75.24%	130	52.63%
圍	623		12	211	0.03184%	449299	80.19%	130	52.63%
政	174		9	787	0.1188%	450086	52.25%	129	52.23%
究	283		7	529	0.07982%	450615	62.90%	129	52.23%
存	417		6	366	0.05523%	450981	71.66%	129	52.23%
談	527		15	266	0.04014%	451247	76.78%	129	52.23%
推	562		11	241	0.03637%	451488	78.12%	129	52.23%
市	157		5	847	0.1278%	452335	50.18%	128	51.82%
區	226		11	656	0.09899%	452991	57.82%	128	51.82%
報	229		12	651	0.09823%	453642	58.11%	128	51.82%
創	324		12	463	0.06987%	454105	65.95%	128	51.82%
象	358		12	416	0.06277%	454521	68.20%	128	51.82%
七	473		2	304	0.04587%	454825	74.48%	128	51.82%
充	543		5	255	0.03848%	455080	77.41%	128	51.82%
雖	620		17	214	0.03229%	455294	80.10%	128	51.82%
務	231		11	645	0.09733%	455939	58.31%	127	51.42%
專	368		11	410	0.06187%	456349	68.82%	127	51.42%
電	382		13	396	0.05976%	456745	69.67%	127	51.42%
層	453		15	323	0.04874%	457068	73.53%	127	51.42%
曾	523		12	267	0.04029%	457335	76.62%	127	51.42%
需	405		14	371	0.05598%	457706	71.00%	126	51.01%
字	441		6	339	0.05115%	458045	72.93%	126	51.01%
呢	445		8	334	0.0504%	458379	73.14%	126	51.01%
找	477		7	300	0.04527%	458679	74.66%	126	51.01%
突	578		9	234	0.03531%	458913	78.69%	126	51.01%
資	133		13	998	0.1506%	459911	46.84%	125	50.61%
書	274		10	548	0.08269%	460459	62.17%	125	50.61%
息	428		10	353	0.05327%	460812	72.26%	125	50.61%
另	644		5	202	0.03048%	461014	80.85%	125	50.61%
科	270		9	563	0.08496%	461577	61.84%	124	50.20%
際	378		13	399	0.06021%	461976	69.43%	124	50.20%
越	387		12	390	0.05885%	462366	69.97%	124	50.20%
倒	537		10	258	0.03893%	462624	77.18%	124	50.20%
致	566		9	239	0.03606%	462863	78.26%	124	50.20%
馬	279		10	537	0.08103%	463400	62.58%	123	49.80%
計	296		9	505	0.0762%	463905	63.92%	123	49.80%
標	369		15	409	0.06172%	464314	68.88%	123	49.80%
告	488		7	291	0.04391%	464605	75.15%	123	49.80%
養	512		15	274	0.04135%	464879	76.17%	123	49.80%
參	521		11	268	0.04044%	465147	76.54%	123	49.80%
甚	607		9	218	0.0329%	465365	79.67%	123	49.80%
除	635		9	208	0.03139%	465573	80.57%	123	49.80%
價	268		15	565	0.08526%	466138	61.67%	122	49.39%
較	455		13	322	0.04859%	466460	73.63%	122	49.39%
富	491		12	290	0.04376%	466750	75.28%	122	49.39%
考	496		6	288	0.04346%	467038	75.50%	122	49.39%
消	550		10	247	0.03727%	467285	77.67%	122	49.39%
盡	631		14	209	0.03154%	467494	80.45%	122	49.39%
群	328		13	454	0.06851%	467948	66.23%	121	48.99%
支	418		4	363	0.05478%	468311	71.72%	121	48.99%
持	444		9	335	0.05055%	468646	73.08%	121	48.99%
緊	554		14	246	0.03712%	468892	77.82%	121	48.99%
喜	576		12	234	0.03531%	469126	78.62%	121	48.99%
示	604		5	220	0.0332%	469346	79.58%	121	48.99%
般	612		10	217	0.03274%	469563	79.84%	121	48.99%
裏	108		13	1177	0.1776%	470740	42.78%	120	48.58%
語	376		14	401	0.06051%	471141	69.31%	120	48.58%
底	650		8	200	0.03018%	471341	81.03%	120	48.58%
辦	388		16	389	0.0587%	471730	70.02%	119	48.18%
境	392		14	383	0.05779%	472113	70.26%	119	48.18%
組	431		11	348	0.05251%	472461	72.41%	119	48.18%
聯	481		17	297	0.04482%	472758	74.84%	119	48.18%
約	524		9	267	0.04029%	473025	76.66%	119	48.18%
注	618		8	215	0.03244%	473240	80.03%	119	48.18%
終	624		11	211	0.03184%	473451	80.23%	119	48.18%
台	377		5	399	0.06021%	473850	69.37%	118	47.77%
獨	484		16	293	0.04421%	474143	74.97%	118	47.77%
火	495		4	288	0.04346%	474431	75.45%	118	47.77%
六	501		4	283	0.0427%	474714	75.71%	118	47.77%
刻	556		8	244	0.03682%	474958	77.90%	118	47.77%
待	658		9	198	0.02988%	475156	81.27%	118	47.77%
土	195		3	719	0.1085%	475875	54.60%	117	47.37%
史	302		5	489	0.07379%	476364	64.37%	117	47.37%
規	291		11	521	0.07862%	476885	63.53%	116	46.96%
治	293		8	516	0.07786%	477401	63.69%	116	46.96%
戰	384		16	391	0.059%	477792	69.79%	116	46.96%
晚	514		11	272	0.04104%	478064	76.26%	116	46.96%
她	79		6	1426	0.2152%	479490	37.24%	115	46.56%
料	419		10	363	0.05478%	479853	71.77%	115	46.56%
黑	436		12	343	0.05176%	480196	72.68%	115	46.56%
叫	450		5	326	0.04919%	480522	73.38%	115	46.56%
段	509		9	276	0.04165%	480798	76.05%	115	46.56%
林	247		8	606	0.09144%	481404	59.82%	114	46.15%
笑	394		10	382	0.05764%	481786	70.37%	114	46.15%
樂	429		15	351	0.05297%	482137	72.31%	114	46.15%
份	508		6	276	0.04165%	482413	76.01%	114	46.15%
低	564		7	239	0.03606%	482652	78.19%	114	46.15%
絕	652		12	200	0.03018%	482852	81.09%	114	46.15%
設	253		11	591	0.08918%	483443	60.36%	113	45.75%
眾	383		11	393	0.0593%	483836	69.73%	113	45.75%
南	447		9	331	0.04995%	484167	73.24%	113	45.75%
準	499		13	287	0.04331%	484454	75.63%	113	45.75%
革	318		9	473	0.07137%	484927	65.53%	112	45.34%
車	327		7	457	0.06896%	485384	66.16%	112	45.34%
九	344		2	436	0.06579%	485820	67.30%	112	45.34%
吃	406		6	370	0.05583%	486190	71.05%	112	45.34%
議	464		20	314	0.04738%	486504	74.06%	112	45.34%
功	471		5	305	0.04602%	486809	74.38%	112	45.34%
態	478		14	299	0.04512%	487108	74.70%	112	45.34%
勢	587		13	228	0.0344%	487336	79.00%	112	45.34%
既	686		9	188	0.02837%	487524	82.08%	112	45.34%
濟	146		17	928	0.140%	488452	48.72%	111	44.94%
增	350		15	428	0.06458%	488880	67.69%	111	44.94%
益	442		10	339	0.05115%	489219	72.98%	111	44.94%
模	568		15	237	0.03576%	489456	78.33%	111	44.94%
例	579		8	232	0.03501%	489688	78.72%	111	44.94%
破	627		10	210	0.03169%	489898	80.32%	111	44.94%
農	162		13	810	0.1222%	490708	50.81%	110	44.53%
系	319		7	472	0.07122%	491180	65.60%	110	44.53%
城	399		9	376	0.05674%	491556	70.66%	110	44.53%
效	409		10	368	0.05553%	491924	71.22%	110	44.53%
紅	443		9	336	0.0507%	492260	73.03%	110	44.53%
華	500		12	286	0.04316%	492546	75.67%	110	44.53%
積	522		16	268	0.04044%	492814	76.58%	110	44.53%
響	551		21	247	0.03727%	493061	77.71%	110	44.53%
細	561		11	242	0.03652%	493303	78.08%	110	44.53%
筆	601		12	222	0.0335%	493525	79.48%	110	44.53%
商	352		11	427	0.06443%	493952	67.82%	109	44.13%
值	434		10	344	0.05191%	494296	72.57%	109	44.13%
念	474		8	304	0.04587%	494600	74.52%	109	44.13%
客	516		9	270	0.04074%	494870	76.34%	109	44.13%
易	563		8	240	0.03622%	495110	78.15%	109	44.13%
密	585		11	229	0.03456%	495339	78.93%	109	44.13%
稱	628		14	210	0.03169%	495549	80.35%	109	44.13%
局	493		7	289	0.04361%	495838	75.37%	108	43.72%
願	629		19	210	0.03169%	496048	80.38%	108	43.72%
舉	636		17	206	0.03108%	496254	80.60%	108	43.72%
級	310		10	483	0.07288%	496737	64.95%	107	43.32%
構	430		14	350	0.05281%	497087	72.36%	107	43.32%
素	517		10	270	0.04074%	497357	76.38%	107	43.32%
友	533		4	260	0.03923%	497617	77.02%	106	42.91%
剛	593		10	226	0.0341%	497843	79.20%	106	42.91%
習	603		11	221	0.03335%	498064	79.54%	106	42.91%
列	621		6	213	0.03214%	498277	80.13%	106	42.91%
型	389		9	387	0.0584%	498664	70.08%	105	42.51%
古	457		5	321	0.04844%	498985	73.72%	105	42.51%
鄉	458		11	318	0.04799%	499303	73.77%	105	42.51%
算	459		14	317	0.04783%	499620	73.82%	105	42.51%
屬	614		21	216	0.03259%	499836	79.90%	105	42.51%
角	643		7	203	0.03063%	500039	80.82%	105	42.51%
備	655		12	198	0.02988%	500237	81.18%	105	42.51%
激	661		16	195	0.02943%	500432	81.36%	105	42.51%
歡	672		22	193	0.02912%	500625	81.68%	105	42.51%
院	482		9	294	0.04436%	500919	74.88%	104	42.11%
站	526		10	266	0.04014%	501185	76.74%	104	42.11%
竟	637		11	206	0.03108%	501391	80.64%	104	42.11%
周	656		8	198	0.02988%	501589	81.21%	104	42.11%
靠	719		15	176	0.02656%	501765	82.99%	104	42.11%
黃	335		12	444	0.067%	502209	66.70%	103	41.70%
供	540		8	257	0.03878%	502466	77.29%	103	41.70%
靈	569		24	237	0.03576%	502703	78.37%	103	41.70%
味	570		8	236	0.03561%	502939	78.40%	103	41.70%
陽	591		11	227	0.03425%	503166	79.14%	103	41.70%
久	674		3	192	0.02897%	503358	81.74%	103	41.70%
助	745		7	168	0.02535%	503526	83.66%	103	41.70%
亂	791		13	156	0.02354%	503682	84.78%	103	41.70%
係	503		9	281	0.0424%	503963	75.80%	102	41.30%
血	538		6	258	0.03893%	504221	77.22%	102	41.30%
嗎	545		13	252	0.03803%	504473	77.49%	102	41.30%
批	546		7	252	0.03803%	504725	77.52%	102	41.30%
塊	605		13	218	0.0329%	504943	79.61%	102	41.30%
續	726		21	174	0.02626%	505117	83.17%	102	41.30%
雜	775		18	161	0.02429%	505278	84.40%	102	41.30%
石	360		5	415	0.06262%	505693	68.33%	101	40.89%
死	433		6	347	0.05236%	506040	72.52%	101	40.89%
環	437		17	342	0.05161%	506382	72.73%	101	40.89%
故	541		9	257	0.03878%	506639	77.33%	101	40.89%
依	586		8	228	0.0344%	506867	78.96%	101	40.89%
景	598		12	224	0.0338%	507091	79.37%	101	40.89%
異	750		11	167	0.0252%	507258	83.79%	101	40.89%
勞	363		12	411	0.06202%	507669	68.51%	100	40.49%
幹	510		13	275	0.0415%	507944	76.09%	100	40.49%
雙	544		18	255	0.03848%	508199	77.45%	100	40.49%
飛	589		9	228	0.0344%	508427	79.07%	100	40.49%
負	633		9	209	0.03154%	508636	80.51%	100	40.49%
研	288		9	523	0.07892%	509159	63.30%	99	40.08%
王	374		4	404	0.06096%	509563	69.19%	99	40.08%
靜	575		16	235	0.03546%	509798	78.58%	99	40.08%
誰	595		15	225	0.03395%	510023	79.27%	99	40.08%
須	616		12	216	0.03259%	510239	79.97%	99	40.08%
亮	639		9	204	0.03078%	510443	80.70%	99	40.08%
採	645		11	202	0.03048%	510645	80.88%	99	40.08%
善	654		12	199	0.03003%	510844	81.15%	99	40.08%
志	422		7	360	0.05432%	511204	71.93%	98	39.68%
差	727		10	172	0.02595%	511376	83.20%	98	39.68%
良	729		7	172	0.02595%	511548	83.25%	98	39.68%
止	742		4	169	0.0255%	511717	83.58%	98	39.68%
音	403		9	373	0.05628%	512090	70.88%	97	39.27%
夜	489		8	291	0.04391%	512381	75.19%	97	39.27%
律	525		9	266	0.04014%	512647	76.70%	97	39.27%
呼	695		8	184	0.02777%	512831	82.34%	97	39.27%
驗	572		23	236	0.03561%	513067	78.47%	96	38.87%
裝	582		13	232	0.03501%	513299	78.83%	96	38.87%
限	684		8	189	0.02852%	513488	82.03%	96	38.87%
烈	794		10	156	0.02354%	513644	84.85%	96	38.87%
簡	831		18	143	0.02158%	513787	85.69%	96	38.87%
驚	838		23	142	0.02143%	513929	85.84%	96	38.87%
技	354		7	423	0.06383%	514352	67.95%	95	38.46%
香	425		9	356	0.05372%	514708	72.10%	95	38.46%
露	739		21	170	0.02565%	514878	83.51%	95	38.46%
訴	773		12	161	0.02429%	515039	84.35%	95	38.46%
藝	342		19	438	0.06609%	515477	67.17%	94	38.06%
隊	438		11	341	0.05146%	515818	72.78%	94	38.06%
草	574		10	235	0.03546%	516053	78.54%	94	38.06%
坐	588		7	228	0.0344%	516281	79.03%	94	38.06%
選	600		15	223	0.03365%	516504	79.44%	94	38.06%
吧	640		7	203	0.03063%	516707	80.73%	94	38.06%
講	663		17	195	0.02943%	516902	81.42%	94	38.06%
團	670		14	193	0.02912%	517095	81.62%	94	38.06%
背	682		9	189	0.02852%	517284	81.97%	94	38.06%
探	749		11	167	0.0252%	517451	83.76%	94	38.06%
脫	769		11	162	0.02445%	517613	84.26%	94	38.06%
樹	334		16	445	0.06715%	518058	66.63%	93	37.65%
派	462		9	314	0.04738%	518372	73.96%	93	37.65%
評	472		12	305	0.04602%	518677	74.43%	93	37.65%
劃	520		14	268	0.04044%	518945	76.50%	93	37.65%
居	530		8	263	0.03969%	519208	76.90%	93	37.65%
織	547		18	250	0.03772%	519458	77.56%	93	37.65%
委	552		8	246	0.03712%	519704	77.75%	93	37.65%
哪	597		10	224	0.0338%	519928	79.34%	93	37.65%
優	626		17	210	0.03169%	520138	80.29%	93	37.65%
排	641		11	203	0.03063%	520341	80.76%	93	37.65%
歲	642		13	203	0.03063%	520544	80.79%	93	37.65%
否	680		7	189	0.02852%	520733	81.91%	93	37.65%
獲	696		17	184	0.02777%	520917	82.36%	93	37.65%
懷	787		19	157	0.02369%	521074	84.69%	93	37.65%
擔	792		16	156	0.02354%	521230	84.81%	93	37.65%
投	454		7	323	0.04874%	521553	73.58%	92	37.25%
房	531		8	262	0.03954%	521815	76.94%	92	37.25%
副	617		11	215	0.03244%	522030	80.00%	92	37.25%
某	659		9	197	0.02973%	522227	81.30%	92	37.25%
怕	716		8	176	0.02656%	522403	82.91%	92	37.25%
吸	741		7	169	0.0255%	522572	83.56%	92	37.25%
繼	763		20	164	0.02475%	522736	84.11%	92	37.25%
歌	379		14	398	0.06006%	523134	69.49%	91	36.84%
河	380		8	396	0.05976%	523530	69.55%	91	36.84%
章	693		11	185	0.02792%	523715	82.28%	91	36.84%
缺	756		10	165	0.0249%	523880	83.94%	91	36.84%
速	774		10	161	0.02429%	524041	84.38%	91	36.84%
索	810		10	152	0.02294%	524193	85.23%	91	36.84%
村	362		7	412	0.06217%	524605	68.45%	90	36.44%
春	549		9	248	0.03742%	524853	77.64%	90	36.44%
佔	648		7	201	0.03033%	525054	80.97%	90	36.44%
微	660		13	195	0.02943%	525249	81.33%	90	36.44%
腳	662		13	195	0.02943%	525444	81.39%	90	36.44%
適	706		14	181	0.02731%	525625	82.64%	90	36.44%
顧	709		21	180	0.02716%	525805	82.72%	90	36.44%
請	711		15	178	0.02686%	525983	82.77%	90	36.44%
豐	738		18	170	0.02565%	526153	83.48%	90	36.44%
鮮	811		17	152	0.02294%	526305	85.25%	90	36.44%
項	511		12	274	0.04135%	526579	76.13%	89	36.03%
拉	571		8	236	0.03561%	526815	78.44%	89	36.03%
承	581		8	232	0.03501%	527047	78.79%	89	36.03%
述	694		8	185	0.02792%	527232	82.31%	89	36.03%
線	700		15	182	0.02746%	527414	82.47%	89	36.03%
散	715		12	177	0.02671%	527591	82.88%	89	36.03%
復	731		12	171	0.0258%	527762	83.30%	89	36.03%
冷	767		7	162	0.02445%	527924	84.21%	89	36.03%
夠	822		11	147	0.02218%	528071	85.50%	89	36.03%
查	507		9	277	0.0418%	528348	75.97%	88	35.63%
元	519		4	268	0.04044%	528616	76.46%	88	35.63%
夫	548		4	248	0.03742%	528864	77.60%	88	35.63%
護	555		21	245	0.03697%	529109	77.86%	88	35.63%
讀	613		22	217	0.03274%	529326	79.87%	88	35.63%
概	651		13	200	0.03018%	529526	81.06%	88	35.63%
衣	653		6	200	0.03018%	529726	81.12%	88	35.63%
令	765		5	163	0.0246%	529889	84.16%	88	35.63%
階	391		11	387	0.0584%	530276	70.20%	87	35.22%
育	423		7	359	0.05417%	530635	71.99%	87	35.22%
臉	558		17	243	0.03667%	530878	77.97%	87	35.22%
責	559		11	243	0.03667%	531121	78.01%	87	35.22%
狀	630		8	209	0.03154%	531330	80.42%	87	35.22%
拿	685		10	188	0.02837%	531518	82.06%	87	35.22%
送	734		9	171	0.0258%	531689	83.38%	87	35.22%
堅	797		11	155	0.02339%	531844	84.93%	87	35.22%
沉	798		7	155	0.02339%	531999	84.95%	87	35.22%
停	812		11	151	0.02279%	532150	85.27%	87	35.22%
權	322		22	466	0.07032%	532616	65.81%	86	34.82%
座	665		10	194	0.02927%	532810	81.48%	86	34.82%
跟	673		13	193	0.02912%	533003	81.71%	86	34.82%
紀	681		9	189	0.02852%	533192	81.94%	86	34.82%
奇	702		8	181	0.02731%	533373	82.53%	86	34.82%
痛	743		12	169	0.0255%	533542	83.61%	86	34.82%
臨	766		17	163	0.0246%	533705	84.18%	86	34.82%
揮	788		12	157	0.02369%	533862	84.71%	86	34.82%
族	390		11	387	0.0584%	534249	70.14%	85	34.41%
木	475		4	304	0.04587%	534553	74.57%	85	34.41%
溫	704		13	181	0.02731%	534734	82.58%	85	34.41%
彩	801		11	154	0.02324%	534888	85.02%	85	34.41%
雨	592		8	227	0.03425%	535115	79.17%	84	34.01%
曲	609		6	217	0.03274%	535332	79.74%	84	34.01%
順	837		12	142	0.02143%	535474	85.82%	84	34.01%
錯	857		16	135	0.02037%	535609	86.24%	84	34.01%
尋	889		12	126	0.01901%	535735	86.87%	84	34.01%
省	345		9	435	0.06564%	536170	67.36%	83	33.60%
孩	486		9	292	0.04406%	536462	75.06%	83	33.60%
圖	565		14	239	0.03606%	536701	78.22%	83	33.60%
礎	679		18	191	0.02882%	536892	81.89%	83	33.60%
室	713		9	177	0.02671%	537069	82.83%	83	33.60%
句	722		5	174	0.02626%	537243	83.07%	83	33.60%
餘	740		15	170	0.02565%	537413	83.53%	83	33.60%
追	757		9	165	0.0249%	537578	83.96%	83	33.60%
困	796		7	155	0.02339%	537733	84.90%	83	33.60%
討	800		10	155	0.02339%	537888	85.00%	83	33.60%
互	824		4	146	0.02203%	538034	85.54%	83	33.60%
括	852		9	136	0.02052%	538170	86.14%	83	33.60%
固	871		8	131	0.01977%	538301	86.52%	83	33.60%
源	446		13	333	0.05025%	538634	73.19%	82	33.20%
星	606		9	218	0.0329%	538852	79.64%	82	33.20%
德	608		15	217	0.03274%	539069	79.71%	82	33.20%
施	638		9	205	0.03093%	539274	80.67%	82	33.20%
按	746		9	168	0.02535%	539442	83.68%	82	33.20%
壓	779		17	159	0.02399%	539601	84.50%	82	33.20%
材	808		7	152	0.02294%	539753	85.18%	82	33.20%
號	845		13	139	0.02097%	539892	85.99%	82	33.20%
熟	847		15	137	0.02067%	540029	86.03%	82	33.20%
端	856		14	135	0.02037%	540164	86.22%	82	33.20%
母	557		5	244	0.03682%	540408	77.93%	81	32.79%
里	664		7	195	0.02943%	540603	81.45%	81	32.79%
穿	733		9	171	0.0258%	540774	83.35%	81	32.79%
短	809		12	152	0.02294%	540926	85.20%	81	32.79%
含	839		7	141	0.02128%	541067	85.87%	81	32.79%
克	567		7	237	0.03576%	541304	78.30%	80	32.39%
錢	619		16	215	0.03244%	541519	80.07%	80	32.39%
朋	649		8	201	0.03033%	541720	81.00%	80	32.39%
映	728		9	172	0.02595%	541892	83.22%	80	32.39%
逐	783		10	159	0.02399%	542051	84.59%	80	32.39%
裡	263		12	573	0.08646%	542624	61.24%	79	31.98%
維	632		14	209	0.03154%	542833	80.48%	79	31.98%
害	723		10	174	0.02626%	543007	83.09%	79	31.98%
急	826		9	146	0.02203%	543153	85.58%	79	31.98%
透	868		10	132	0.01992%	543285	86.46%	79	31.98%
歸	877		18	130	0.01962%	543415	86.64%	79	31.98%
病	400		10	376	0.05674%	543791	70.72%	78	31.58%
英	515		9	272	0.04104%	544063	76.30%	78	31.58%
率	610		11	217	0.03274%	544280	79.77%	78	31.58%
費	689		12	186	0.02807%	544466	82.17%	78	31.58%
普	708		12	180	0.02716%	544646	82.69%	78	31.58%
飯	764		12	164	0.02475%	544810	84.13%	78	31.58%
腦	781		13	159	0.02399%	544969	84.55%	78	31.58%
希	844		7	139	0.02097%	545108	85.97%	78	31.58%
幫	880		17	129	0.01947%	545237	86.70%	78	31.58%
翻	923		18	117	0.01766%	545354	87.49%	78	31.58%
遇	944		12	114	0.0172%	545468	87.86%	78	31.58%
營	411		17	367	0.05538%	545835	71.33%	77	31.17%
食	469		9	308	0.04648%	546143	74.29%	77	31.17%
毛	542		4	257	0.03878%	546400	77.37%	77	31.17%
補	647		12	202	0.03048%	546602	80.94%	77	31.17%
士	657		3	198	0.02988%	546800	81.24%	77	31.17%
配	683		10	189	0.02852%	546989	82.00%	77	31.17%
巴	736		4	170	0.02565%	547159	83.43%	77	31.17%
印	758		6	164	0.02475%	547323	83.98%	77	31.17%
超	818		12	149	0.02248%	547472	85.41%	77	31.17%
置	932		13	115	0.01735%	547587	87.65%	77	31.17%
策	449		12	329	0.04965%	547916	73.33%	76	30.77%
師	465		10	313	0.04723%	548229	74.11%	76	30.77%
雲	678		12	192	0.02897%	548421	81.86%	76	30.77%
睛	699		13	182	0.02746%	548603	82.45%	76	30.77%
擊	977		17	108	0.0163%	548711	88.41%	76	30.77%
遍	982		12	108	0.0163%	548819	88.49%	76	30.77%
折	1049		7	99	0.01494%	548918	89.53%	76	30.77%
綠	667		14	194	0.02927%	549112	81.54%	75	30.36%
協	675		8	192	0.02897%	549304	81.77%	75	30.36%
嘴	712		15	177	0.02671%	549481	82.80%	75	30.36%
鬥	721		10	175	0.02641%	549656	83.04%	75	30.36%
察	735		14	170	0.02565%	549826	83.40%	75	30.36%
煙	755		13	165	0.0249%	549991	83.91%	75	30.36%
野	828		11	146	0.02203%	550137	85.63%	75	30.36%
買	836		12	142	0.02143%	550279	85.80%	75	30.36%
忽	947		8	113	0.01705%	550392	87.91%	75	30.36%
若	972		9	109	0.01645%	550501	88.33%	75	30.36%
父	518		4	269	0.04059%	550770	76.42%	74	29.96%
斯	535		12	259	0.03908%	551029	77.10%	74	29.96%
米	666		6	194	0.02927%	551223	81.51%	74	29.96%
予	707		4	180	0.02716%	551403	82.67%	74	29.96%
紙	747		10	168	0.02535%	551571	83.71%	74	29.96%
器	851		16	136	0.02052%	551707	86.12%	74	29.96%
借	886		10	127	0.01916%	551834	86.81%	74	29.96%
夏	887		10	127	0.01916%	551961	86.83%	74	29.96%
幸	911		8	120	0.01811%	552081	87.28%	74	29.96%
掉	927		11	115	0.01735%	552196	87.56%	74	29.96%
換	990		12	107	0.01615%	552303	88.62%	74	29.96%
健	744		11	168	0.02535%	552471	83.63%	73	29.55%
修	754		10	165	0.0249%	552636	83.89%	73	29.55%
布	807		5	152	0.02294%	552788	85.16%	73	29.55%
田	848		5	137	0.02067%	552925	86.05%	73	29.55%
跳	883		13	129	0.01947%	553054	86.75%	73	29.55%
怪	916		8	118	0.01781%	553172	87.37%	73	29.55%
頓	919		13	118	0.01781%	553290	87.42%	73	29.55%
職	461		18	316	0.04768%	553606	73.92%	72	29.15%
江	594		6	225	0.03395%	553831	79.24%	72	29.15%
舞	611		14	217	0.03274%	554048	79.80%	72	29.15%
窗	725		12	174	0.02626%	554222	83.14%	72	29.15%
促	820		9	147	0.02218%	554369	85.45%	72	29.15%
錄	858		16	135	0.02037%	554504	86.26%	72	29.15%
詞	902		12	124	0.01871%	554628	87.11%	72	29.15%
左	939		5	114	0.0172%	554742	87.77%	72	29.15%
忘	946		7	113	0.01705%	554855	87.89%	72	29.15%
敢	951		12	112	0.0169%	554967	87.98%	72	29.15%
疑	1055		14	98	0.01479%	555065	89.62%	72	29.15%
演	646		14	202	0.03048%	555267	80.91%	71	28.74%
傾	874		13	130	0.01962%	555397	86.58%	71	28.74%
巨	910		5	120	0.01811%	555517	87.26%	71	28.74%
尚	938		8	114	0.0172%	555631	87.75%	71	28.74%
答	942		12	114	0.0172%	555745	87.82%	71	28.74%
爾	534		14	260	0.03923%	556005	77.06%	70	28.34%
京	622		8	211	0.03184%	556216	80.16%	70	28.34%
班	697		10	184	0.02777%	556400	82.39%	70	28.34%
跑	849		12	137	0.02067%	556537	86.08%	70	28.34%
麗	869		19	132	0.01992%	556669	86.48%	70	28.34%
暗	905		13	123	0.01856%	556792	87.17%	70	28.34%
握	925		12	116	0.0175%	556908	87.53%	70	28.34%
免	986		7	107	0.01615%	557015	88.55%	70	28.34%
擺	1004		18	105	0.01584%	557120	88.84%	70	28.34%
畫	365		12	411	0.06202%	557531	68.64%	69	27.94%
葉	584		13	230	0.03471%	557761	78.90%	69	27.94%
證	730		19	172	0.02595%	557933	83.27%	69	27.94%
抓	771		7	161	0.02429%	558094	84.30%	69	27.94%
壯	968		7	109	0.01645%	558203	88.26%	69	27.94%
掛	1025		11	101	0.01524%	558304	89.17%	69	27.94%
廠	505		15	280	0.04225%	558584	75.88%	68	27.53%
範	583		15	231	0.03486%	558815	78.86%	68	27.53%
劇	669		15	193	0.02912%	559008	81.60%	68	27.53%
隻	690		10	186	0.02807%	559194	82.20%	68	27.53%
朝	710		12	178	0.02686%	559372	82.75%	68	27.53%
府	714		8	177	0.02671%	559549	82.85%	68	27.53%
皮	720		5	175	0.02641%	559724	83.01%	68	27.53%
福	803		13	154	0.02324%	559878	85.06%	68	27.53%
略	914		11	119	0.01796%	559997	87.33%	68	27.53%
尤	976		4	108	0.0163%	560105	88.39%	68	27.53%
肯	1000		8	106	0.016%	560211	88.78%	68	27.53%
介	1033		4	100	0.01509%	560311	89.29%	68	27.53%
套	1059		10	97	0.01464%	560408	89.68%	68	27.53%
黨	452		20	324	0.04889%	560732	73.48%	67	27.13%
夢	691		14	185	0.02792%	560917	82.23%	67	27.13%
祖	802		9	154	0.02324%	561071	85.04%	67	27.13%
升	821		4	147	0.02218%	561218	85.47%	67	27.13%
掌	829		12	145	0.02188%	561363	85.65%	67	27.13%
試	832		13	143	0.02158%	561506	85.72%	67	27.13%
漸	881		14	129	0.01947%	561635	86.72%	67	27.13%
謂	882		16	129	0.01947%	561764	86.74%	67	27.13%
陣	884		9	128	0.01931%	561892	86.77%	67	27.13%
洋	890		9	126	0.01901%	562018	86.89%	67	27.13%
傷	926		13	115	0.01735%	562133	87.55%	67	27.13%
累	931		11	115	0.01735%	562248	87.63%	67	27.13%
寶	970		20	109	0.01645%	562357	88.29%	67	27.13%
混	1053		11	98	0.01479%	562455	89.59%	67	27.13%
弱	1066		10	96	0.01449%	562551	89.78%	67	27.13%
園	813		13	151	0.02279%	562702	85.29%	66	26.72%
鐵	855		21	136	0.02052%	562838	86.20%	66	26.72%
頂	861		11	134	0.02022%	562972	86.32%	66	26.72%
骨	862		10	134	0.02022%	563106	86.34%	66	26.72%
默	885		16	128	0.01931%	563234	86.79%	66	26.72%
耳	891		6	126	0.01901%	563360	86.91%	66	26.72%
肉	892		6	126	0.01901%	563486	86.93%	66	26.72%
永	908		5	122	0.01841%	563608	87.23%	66	26.72%
退	981		9	108	0.0163%	563716	88.47%	66	26.72%
旁	1017		10	103	0.01554%	563819	89.05%	66	26.72%
右	1084		5	93	0.01403%	563912	90.04%	66	26.72%
篇	599		15	224	0.0338%	564136	79.41%	65	26.32%
秋	615		9	216	0.03259%	564352	79.94%	65	26.32%
男	634		7	208	0.03139%	564560	80.54%	65	26.32%
藏	835		18	142	0.02143%	564702	85.78%	65	26.32%
聞	860		14	134	0.02022%	564836	86.30%	65	26.32%
波	962		8	110	0.0166%	564946	88.16%	65	26.32%
潮	1007		15	105	0.01584%	565051	88.89%	65	26.32%
弄	1011		7	104	0.01569%	565155	88.95%	65	26.32%
途	1031		10	101	0.01524%	565256	89.26%	65	26.32%
宣	1168		9	81	0.01222%	565337	91.14%	65	26.32%
樓	577		15	234	0.03531%	565571	78.65%	64	25.91%
李	688		7	186	0.02807%	565757	82.14%	64	25.91%
証	782		12	159	0.02399%	565916	84.57%	64	25.91%
鎮	806		18	153	0.02309%	566069	85.13%	64	25.91%
燈	815		16	151	0.02279%	566220	85.34%	64	25.91%
遺	898		15	125	0.01886%	566345	87.04%	64	25.91%
揚	912		12	120	0.01811%	566465	87.30%	64	25.91%
忙	920		6	117	0.01766%	566582	87.44%	64	25.91%
穩	922		19	117	0.01766%	566699	87.48%	64	25.91%
培	937		11	114	0.0172%	566813	87.74%	64	25.91%
序	940		7	114	0.0172%	566927	87.79%	64	25.91%
跡	980		13	108	0.0163%	567035	88.46%	64	25.91%
乾	984		11	107	0.01615%	567142	88.52%	64	25.91%
擇	997		16	106	0.016%	567248	88.73%	64	25.91%
淚	1006		11	105	0.01584%	567353	88.87%	64	25.91%
童	1056		12	98	0.01479%	567451	89.64%	64	25.91%
觸	1071		20	96	0.01449%	567547	89.85%	64	25.91%
厚	1073		9	95	0.01434%	567642	89.88%	64	25.91%
司	573		5	235	0.03546%	567877	78.51%	63	25.51%
財	718		10	176	0.02656%	568053	82.96%	63	25.51%
域	825		11	146	0.02203%	568199	85.56%	63	25.51%
執	840		11	141	0.02128%	568340	85.89%	63	25.51%
慢	859		14	134	0.02022%	568474	86.28%	63	25.51%
壞	989		19	107	0.01615%	568581	88.60%	63	25.51%
醒	994		16	107	0.01615%	568688	88.68%	63	25.51%
搖	1026		13	101	0.01524%	568789	89.18%	63	25.51%
奮	1035		16	100	0.01509%	568889	89.32%	63	25.51%
涼	1038		11	100	0.01509%	568989	89.37%	63	25.51%
勝	1058		12	97	0.01464%	569086	89.67%	63	25.51%
蓋	1098		14	92	0.01388%	569178	90.23%	63	25.51%
詩	426		13	354	0.05342%	569532	72.15%	62	25.10%
陳	668		10	194	0.02927%	569726	81.57%	62	25.10%
編	823		15	147	0.02218%	569873	85.52%	62	25.10%
假	878		11	129	0.01947%	570002	86.66%	62	25.10%
嚮	894		18	125	0.01886%	570127	86.96%	62	25.10%
踐	897		15	125	0.01886%	570252	87.02%	62	25.10%
降	933		8	115	0.01735%	570367	87.67%	62	25.10%
鼓	983		13	108	0.0163%	570475	88.51%	62	25.10%
圓	996		13	106	0.016%	570581	88.71%	62	25.10%
貴	1013		12	104	0.01569%	570685	88.98%	62	25.10%
楚	1020		13	102	0.01539%	570787	89.09%	62	25.10%
登	1029		12	101	0.01524%	570888	89.23%	62	25.10%
慮	1037		15	100	0.01509%	570988	89.35%	62	25.10%
繁	1042		17	100	0.01509%	571088	89.43%	62	25.10%
針	1046		10	100	0.01509%	571188	89.49%	62	25.10%
慣	1119		14	88	0.01328%	571276	90.52%	62	25.10%
企	237		6	631	0.09522%	571907	58.89%	61	24.70%
酒	560		10	243	0.03667%	572150	78.04%	61	24.70%
牛	692		4	185	0.02792%	572335	82.25%	61	24.70%
床	760		7	164	0.02475%	572499	84.03%	61	24.70%
武	777		8	160	0.02414%	572659	84.45%	61	24.70%
封	785		9	158	0.02384%	572817	84.64%	61	24.70%
啊	870		11	131	0.01977%	572948	86.50%	61	24.70%
擴	904		18	123	0.01856%	573071	87.15%	61	24.70%
減	921		12	117	0.01766%	573188	87.46%	61	24.70%
趕	1045		14	100	0.01509%	573288	89.47%	61	24.70%
盛	1061		11	97	0.01464%	573385	89.71%	61	24.70%
惡	1080		12	94	0.01418%	573479	89.98%	61	24.70%
凡	1133		3	85	0.01283%	573564	90.70%	61	24.70%
泛	1137		8	85	0.01283%	573649	90.75%	61	24.70%
磨	1230		16	75	0.01132%	573724	91.87%	61	24.70%
醫	485		18	293	0.04421%	574017	75.02%	60	24.29%
戶	761		4	164	0.02475%	574181	84.06%	60	24.29%
險	789		15	157	0.02369%	574338	84.74%	60	24.29%
軍	805		9	153	0.02309%	574491	85.11%	60	24.29%
獻	843		20	140	0.02113%	574631	85.95%	60	24.29%
架	865		9	132	0.01992%	574763	86.40%	60	24.29%
睡	866		14	132	0.01992%	574895	86.42%	60	24.29%
典	879		8	129	0.01947%	575024	86.68%	60	24.29%
荒	948		10	113	0.01705%	575137	87.93%	60	24.29%
釋	1062		20	97	0.01464%	575234	89.72%	60	24.29%
淡	1104		11	91	0.01373%	575325	90.32%	60	24.29%
擁	1142		16	84	0.01268%	575409	90.82%	60	24.29%
純	1156		10	82	0.01237%	575491	90.99%	60	24.29%
漫	705		14	181	0.02731%	575672	82.61%	59	23.89%
屋	780		9	159	0.02399%	575831	84.52%	59	23.89%
洗	834		9	142	0.02143%	575973	85.76%	59	23.89%
舊	854		18	136	0.02052%	576109	86.18%	59	23.89%
搞	903		13	123	0.01856%	576232	87.13%	59	23.89%
濃	991		16	107	0.01615%	576339	88.63%	59	23.89%
迷	993		9	107	0.01615%	576446	88.67%	59	23.89%
誤	1008		14	105	0.01584%	576551	88.91%	59	23.89%
乏	1083		5	93	0.01403%	576644	90.03%	59	23.89%
伸	1120		7	87	0.01313%	576731	90.53%	59	23.89%
招	1150		8	83	0.01252%	576814	90.92%	59	23.89%
官	748		8	167	0.0252%	576981	83.73%	58	23.48%
游	793		12	156	0.02354%	577137	84.83%	58	23.48%
控	833		11	142	0.02143%	577279	85.74%	58	23.48%
案	863		10	133	0.02007%	577412	86.36%	58	23.48%
雄	899		12	125	0.01886%	577537	87.06%	58	23.48%
析	913		8	120	0.01811%	577657	87.32%	58	23.48%
龍	934		16	115	0.01735%	577772	87.69%	58	23.48%
拍	950		8	112	0.0169%	577884	87.96%	58	23.48%
趣	958		15	111	0.01675%	577995	88.09%	58	23.48%
禁	971		13	109	0.01645%	578104	88.31%	58	23.48%
迎	1106		7	91	0.01373%	578195	90.34%	58	23.48%
載	1127		13	87	0.01313%	578282	90.62%	58	23.48%
延	1148		8	83	0.01252%	578365	90.89%	58	23.48%
聚	1158		14	82	0.01237%	578447	91.02%	58	23.48%
吹	1164		7	81	0.01222%	578528	91.09%	58	23.48%
雪	790		11	157	0.02369%	578685	84.76%	57	23.08%
堂	936		11	114	0.0172%	578799	87.72%	57	23.08%
判	945		7	113	0.01705%	578912	87.87%	57	23.08%
沖	978		7	108	0.0163%	579020	88.42%	57	23.08%
均	1015		7	103	0.01554%	579123	89.02%	57	23.08%
閃	1018		10	103	0.01554%	579226	89.06%	57	23.08%
盤	1109		15	90	0.01358%	579316	90.39%	57	23.08%
奔	1124		8	87	0.01313%	579403	90.59%	57	23.08%
浪	1194		10	79	0.01192%	579482	91.45%	57	23.08%
粗	1218		11	76	0.01147%	579558	91.74%	57	23.08%
股	602		8	222	0.0335%	579780	79.51%	56	22.67%
縣	625		16	211	0.03184%	579991	80.26%	56	22.67%
匯	701		13	181	0.02731%	580172	82.50%	56	22.67%
沙	703		7	181	0.02731%	580353	82.56%	56	22.67%
蘇	867		20	132	0.01992%	580485	86.44%	56	22.67%
植	876		12	130	0.01962%	580615	86.62%	56	22.67%
油	906		8	123	0.01856%	580738	87.19%	56	22.67%
板	917		8	118	0.01781%	580856	87.39%	56	22.67%
悲	924		12	116	0.0175%	580972	87.51%	56	22.67%
零	1057		13	98	0.01479%	581070	89.65%	56	22.67%
偏	1099		11	91	0.01373%	581161	90.25%	56	22.67%
幅	1103		12	91	0.01373%	581252	90.30%	56	22.67%
抱	1245		8	73	0.01102%	581325	92.04%	56	22.67%
硬	1277		12	70	0.01056%	581395	92.38%	56	22.67%
唱	580		11	232	0.03501%	581627	78.76%	55	22.27%
漢	732		14	171	0.0258%	581798	83.33%	55	22.27%
店	804		8	153	0.02309%	581951	85.09%	55	22.27%
庭	817		10	149	0.02248%	582100	85.39%	55	22.27%
喝	893		12	125	0.01886%	582225	86.95%	55	22.27%
泥	901		8	124	0.01871%	582349	87.10%	55	22.27%
審	1010		15	104	0.01569%	582453	88.94%	55	22.27%
秘	1095		10	92	0.01388%	582545	90.19%	55	22.27%
糊	1110		15	90	0.01358%	582635	90.40%	55	22.27%
隱	1139		16	85	0.01283%	582720	90.78%	55	22.27%
唯	1141		11	84	0.01268%	582804	90.81%	55	22.27%
午	1147		4	83	0.01252%	582887	90.88%	55	22.27%
偶	1177		11	80	0.01207%	582967	91.25%	55	22.27%
薄	1203		17	78	0.01177%	583045	91.56%	55	22.27%
避	1232		16	75	0.01132%	583120	91.89%	55	22.27%
娘	830		10	143	0.02158%	583263	85.67%	54	21.86%
齊	873		14	131	0.01977%	583394	86.56%	54	21.86%
挑	1067		9	96	0.01449%	583490	89.80%	54	21.86%
婦	1079		11	94	0.01418%	583584	89.97%	54	21.86%
努	1116		7	88	0.01328%	583672	90.48%	54	21.86%
輩	1186		15	80	0.01207%	583752	91.36%	54	21.86%
沿	1229		8	75	0.01132%	583827	91.86%	54	21.86%
畢	1257		11	72	0.01086%	583899	92.17%	54	21.86%
束	1265		7	71	0.01071%	583970	92.26%	54	21.86%
訪	992		11	107	0.01615%	584077	88.65%	53	21.46%
措	1024		11	101	0.01524%	584178	89.15%	53	21.46%
綜	1041		14	100	0.01509%	584278	89.41%	53	21.46%
測	1087		12	93	0.01403%	584371	90.08%	53	21.46%
寧	1092		14	92	0.01388%	584463	90.15%	53	21.46%
智	1170		12	81	0.01222%	584544	91.16%	53	21.46%
艱	1172		17	81	0.01222%	584625	91.19%	53	21.46%
複	1174		14	81	0.01222%	584706	91.21%	53	21.46%
擠	1181		17	80	0.01207%	584786	91.30%	53	21.46%
鬧	1215		15	77	0.01162%	584863	91.70%	53	21.46%
績	1219		17	76	0.01147%	584939	91.75%	53	21.46%
遭	1315		14	67	0.01011%	585006	92.78%	53	21.46%
銀	497		14	288	0.04346%	585294	75.54%	52	21.05%
館	590		16	228	0.0344%	585522	79.10%	52	21.05%
校	698		10	182	0.02746%	585704	82.42%	52	21.05%
融	717		16	176	0.02656%	585880	82.93%	52	21.05%
損	841		13	141	0.02128%	586021	85.91%	52	21.05%
紛	888		10	127	0.01916%	586148	86.85%	52	21.05%
禮	964		17	110	0.0166%	586258	88.19%	52	21.05%
哭	988		10	107	0.01615%	586365	88.59%	52	21.05%
賣	1044		15	100	0.01509%	586465	89.46%	52	21.05%
俗	1063		9	96	0.01449%	586561	89.74%	52	21.05%
冬	1121		5	87	0.01313%	586648	90.55%	52	21.05%
托	1130		6	86	0.01298%	586734	90.66%	52	21.05%
威	1244		9	73	0.01102%	586807	92.03%	52	21.05%
菜	737		12	170	0.02565%	586977	83.45%	51	20.65%
防	846		6	139	0.02097%	587116	86.01%	51	20.65%
殘	895		12	125	0.01886%	587241	86.98%	51	20.65%
抗	900		7	124	0.01871%	587365	87.08%	51	20.65%
街	973		12	109	0.01645%	587474	88.34%	51	20.65%
偉	985		11	107	0.01615%	587581	88.54%	51	20.65%
檢	1005		17	105	0.01584%	587686	88.86%	51	20.65%
季	1019		8	102	0.01539%	587788	89.08%	51	20.65%
懂	1048		17	99	0.01494%	587887	89.52%	51	20.65%
納	1052		10	99	0.01494%	587986	89.58%	51	20.65%
麻	1077		11	95	0.01434%	588081	89.94%	51	20.65%
休	1078		6	94	0.01418%	588175	89.95%	51	20.65%
刺	1100		8	91	0.01373%	588266	90.26%	51	20.65%
危	1101		6	91	0.01373%	588357	90.28%	51	20.65%
誠	1126		13	87	0.01313%	588444	90.61%	51	20.65%
莫	1146		11	84	0.01268%	588528	90.87%	51	20.65%
恨	1149		9	83	0.01252%	588611	90.91%	51	20.65%
私	1155		7	82	0.01237%	588693	90.98%	51	20.65%
陰	1175		10	81	0.01222%	588774	91.23%	51	20.65%
紹	1202		11	78	0.01177%	588852	91.55%	51	20.65%
躍	1258		21	72	0.01086%	588924	92.18%	51	20.65%
橫	1275		16	70	0.01056%	588994	92.36%	51	20.65%
移	786		11	158	0.02384%	589152	84.67%	50	20.24%
貼	872		12	131	0.01977%	589283	86.54%	50	20.24%
汽	999		7	106	0.016%	589389	88.76%	50	20.24%
玩	1060		8	97	0.01464%	589486	89.69%	50	20.24%
榮	1086		14	93	0.01403%	589579	90.07%	50	20.24%
課	1090		15	93	0.01403%	589672	90.12%	50	20.24%
勁	1140		9	84	0.01268%	589756	90.79%	50	20.24%
絲	1151		12	83	0.01252%	589839	90.93%	50	20.24%
干	1154		3	82	0.01237%	589921	90.97%	50	20.24%
縮	1157		17	82	0.01237%	590003	91.01%	50	20.24%
寬	1178		15	80	0.01207%	590083	91.26%	50	20.24%
巧	1189		5	79	0.01192%	590162	91.39%	50	20.24%
徹	1191		14	79	0.01192%	590241	91.42%	50	20.24%
喊	1217		12	76	0.01147%	590317	91.72%	50	20.24%
秀	1278		7	70	0.01056%	590387	92.39%	50	20.24%
迅	1281		6	70	0.01056%	590457	92.43%	50	20.24%
州	676		6	192	0.02897%	590649	81.80%	49	19.84%
羅	752		19	166	0.02505%	590815	83.84%	49	19.84%
崇	1036		11	100	0.01509%	590915	89.34%	49	19.84%
版	1039		8	100	0.01509%	591015	89.38%	49	19.84%
燒	1054		16	98	0.01479%	591113	89.61%	49	19.84%
享	1107		8	90	0.01358%	591203	90.36%	49	19.84%
肩	1242		8	74	0.01117%	591277	92.01%	49	19.84%
港	553		12	246	0.03712%	591523	77.78%	48	19.43%
球	724		11	174	0.02626%	591697	83.12%	48	19.43%
亡	751		3	166	0.02505%	591863	83.81%	48	19.43%
陸	784		10	159	0.02399%	592022	84.62%	48	19.43%
宗	961		8	110	0.0166%	592132	88.14%	48	19.43%
冰	995		6	106	0.016%	592238	88.70%	48	19.43%
桌	998		10	106	0.016%	592344	88.75%	48	19.43%
蒙	1138		14	85	0.01283%	592429	90.77%	48	19.43%
佈	1176		7	80	0.01207%	592509	91.24%	48	19.43%
窮	1196		15	79	0.01192%	592588	91.48%	48	19.43%
啟	1199		11	78	0.01177%	592666	91.51%	48	19.43%
預	1213		13	77	0.01162%	592743	91.68%	48	19.43%
守	1226		6	75	0.01132%	592818	91.83%	48	19.43%
蕩	1243		16	74	0.01117%	592892	92.02%	48	19.43%
敬	1246		13	73	0.01102%	592965	92.05%	48	19.43%
迫	1282		8	70	0.01056%	593035	92.44%	48	19.43%
抽	1293		8	69	0.01041%	593104	92.55%	48	19.43%
甘	1336		5	65	0.009808%	593169	92.98%	48	19.43%
儘	1341		16	64	0.009657%	593233	93.03%	48	19.43%
末	1355		5	63	0.009507%	593296	93.17%	48	19.43%
染	827		9	146	0.02203%	593442	85.61%	47	19.03%
松	928		8	115	0.01735%	593557	87.58%	47	19.03%
谷	1001		7	106	0.016%	593663	88.79%	47	19.03%
蛋	1043		11	100	0.01509%	593763	89.44%	47	19.03%
尖	1074		6	95	0.01434%	593858	89.90%	47	19.03%
席	1118		10	88	0.01328%	593946	90.51%	47	19.03%
鐘	1128		20	87	0.01313%	594033	90.64%	47	19.03%
柔	1143		9	84	0.01268%	594117	90.83%	47	19.03%
康	1179		11	80	0.01207%	594197	91.27%	47	19.03%
賞	1185		15	80	0.01207%	594277	91.35%	47	19.03%
踏	1250		15	73	0.01102%	594350	92.09%	47	19.03%
博	1254		12	72	0.01086%	594422	92.14%	47	19.03%
腿	1302		14	68	0.01026%	594490	92.64%	47	19.03%
孤	1343		8	64	0.009657%	594554	93.05%	47	19.03%
虛	1346		12	64	0.009657%	594618	93.08%	47	19.03%
款	528		12	265	0.03999%	594883	76.82%	46	18.62%
洲	956		9	111	0.01675%	594994	88.06%	46	18.62%
孫	969		10	109	0.01645%	595103	88.28%	46	18.62%
鳥	1047		11	100	0.01509%	595203	89.50%	46	18.62%
坡	1064		8	96	0.01449%	595299	89.75%	46	18.62%
描	1081		12	94	0.01418%	595393	90.00%	46	18.62%
藍	1152		18	83	0.01252%	595476	90.94%	46	18.62%
粉	1248		10	73	0.01102%	595549	92.07%	46	18.62%
闊	1251		17	73	0.01102%	595622	92.11%	46	18.62%
殊	1307		10	67	0.01011%	595689	92.69%	46	18.62%
忍	1344		7	64	0.009657%	595753	93.06%	46	18.62%
徑	1352		10	63	0.009507%	595816	93.14%	46	18.62%
惜	1353		11	63	0.009507%	595879	93.15%	46	18.62%
附	1382		7	61	0.009205%	595940	93.42%	46	18.62%
妙	1385		7	60	0.009054%	596000	93.45%	46	18.62%
欲	1389		11	60	0.009054%	596060	93.48%	46	18.62%
怨	1429		9	56	0.00845%	596116	93.83%	46	18.62%
練	768		15	162	0.02445%	596278	84.23%	45	18.22%
碎	941		13	114	0.0172%	596392	87.81%	45	18.22%
歐	1027		15	101	0.01524%	596493	89.20%	45	18.22%
央	1085		5	93	0.01403%	596586	90.05%	45	18.22%
旅	1136		10	85	0.01283%	596671	90.74%	45	18.22%
幽	1190		9	79	0.01192%	596750	91.41%	45	18.22%
珠	1195		10	79	0.01192%	596829	91.47%	45	18.22%
胡	1197		9	79	0.01192%	596908	91.49%	45	18.22%
憶	1209		16	77	0.01162%	596985	91.63%	45	18.22%
閉	1211		11	77	0.01162%	597062	91.65%	45	18.22%
壁	1225		16	75	0.01132%	597137	91.81%	45	18.22%
抬	1264		8	71	0.01071%	597208	92.25%	45	18.22%
側	1270		11	70	0.01056%	597278	92.31%	45	18.22%
欣	1299		8	68	0.01026%	597346	92.61%	45	18.22%
趨	1304		17	68	0.01026%	597414	92.66%	45	18.22%
魚	1319		11	67	0.01011%	597481	92.82%	45	18.22%
胸	1345		10	64	0.009657%	597545	93.07%	45	18.22%
輪	1380		15	61	0.009205%	597606	93.40%	45	18.22%
繞	1451		18	54	0.008148%	597660	94.02%	45	18.22%
替	1461		12	53	0.007998%	597713	94.10%	45	18.22%
玉	1040		5	100	0.01509%	597813	89.40%	44	17.81%
盾	1070		9	96	0.01449%	597909	89.84%	44	17.81%
魂	1076		14	95	0.01434%	598004	89.93%	44	17.81%
緣	1171		15	81	0.01222%	598085	91.18%	44	17.81%
徵	1180		15	80	0.01207%	598165	91.29%	44	17.81%
堆	1223		11	75	0.01132%	598240	91.79%	44	17.81%
鏡	1233		19	75	0.01132%	598315	91.91%	44	17.81%
牙	1247		4	73	0.01102%	598388	92.06%	44	17.81%
髮	1259		15	72	0.01086%	598460	92.19%	44	17.81%
凝	1272		16	70	0.01056%	598530	92.33%	44	17.81%
付	1286		5	69	0.01041%	598599	92.48%	44	17.81%
勵	1321		17	66	0.009959%	598665	92.84%	44	17.81%
符	1359		11	63	0.009507%	598728	93.20%	44	17.81%
鬆	1361		18	63	0.009507%	598791	93.22%	44	17.81%
尊	1364		12	62	0.009356%	598853	93.25%	44	17.81%
衡	1370		16	62	0.009356%	598915	93.31%	44	17.81%
毫	1399		11	59	0.008903%	598974	93.57%	44	17.81%
操	1431		16	56	0.00845%	599030	93.85%	44	17.81%
購	966		17	110	0.0166%	599140	88.23%	43	17.41%
額	1002		18	106	0.016%	599246	88.81%	43	17.41%
矛	1082		5	94	0.01418%	599340	90.01%	43	17.41%
醉	1115		15	89	0.01343%	599429	90.47%	43	17.41%
牆	1125		17	87	0.01313%	599516	90.60%	43	17.41%
卷	1134		8	85	0.01283%	599601	90.72%	43	17.41%
衝	1173		15	81	0.01222%	599682	91.20%	43	17.41%
灰	1183		6	80	0.01207%	599762	91.32%	43	17.41%
舒	1184		12	80	0.01207%	599842	91.33%	43	17.41%
騰	1214		20	77	0.01162%	599919	91.69%	43	17.41%
朵	1228		6	75	0.01132%	599994	91.85%	43	17.41%
緩	1300		15	68	0.01026%	600062	92.62%	43	17.41%
暴	1324		15	66	0.009959%	600128	92.87%	43	17.41%
伙	1340		6	64	0.009657%	600192	93.02%	43	17.41%
宜	1363		8	62	0.009356%	600254	93.24%	43	17.41%
涉	1377		10	61	0.009205%	600315	93.37%	43	17.41%
滅	1400		13	59	0.008903%	600374	93.58%	43	17.41%
恐	1415		10	57	0.008601%	600431	93.71%	43	17.41%
鋪	1424		15	57	0.008601%	600488	93.79%	43	17.41%
鼻	1438		14	56	0.00845%	600544	93.91%	43	17.41%
伏	1456		6	53	0.007998%	600597	94.06%	43	17.41%
幻	1457		4	53	0.007998%	600650	94.06%	43	17.41%
亞	935		8	114	0.0172%	600764	87.70%	42	17.00%
億	959		15	110	0.0166%	600874	88.11%	42	17.00%
獎	1102		15	91	0.01373%	600965	90.29%	42	17.00%
戴	1129		17	86	0.01298%	601051	90.65%	42	17.00%
授	1131		11	86	0.01298%	601137	90.68%	42	17.00%
峰	1236		10	74	0.01117%	601211	91.94%	42	17.00%
殺	1266		11	71	0.01071%	601282	92.27%	42	17.00%
罪	1267		13	71	0.01071%	601353	92.28%	42	17.00%
顏	1284		18	70	0.01056%	601423	92.46%	42	17.00%
怒	1291		9	69	0.01041%	601492	92.53%	42	17.00%
拓	1292		8	69	0.01041%	601561	92.54%	42	17.00%
震	1316		15	67	0.01011%	601628	92.79%	42	17.00%
淨	1335		11	65	0.009808%	601693	92.97%	42	17.00%
恰	1373		9	61	0.009205%	601754	93.34%	42	17.00%
緒	1392		14	60	0.009054%	601814	93.51%	42	17.00%
輝	1394		15	60	0.009054%	601874	93.53%	42	17.00%
狂	1411		7	58	0.008752%	601932	93.68%	42	17.00%
憑	1416		16	57	0.008601%	601989	93.72%	42	17.00%
塞	1428		13	56	0.00845%	602045	93.82%	42	17.00%
銷	778		15	160	0.02414%	602205	84.47%	41	16.60%
核	929		10	115	0.01735%	602320	87.60%	41	16.60%
弟	1200		7	78	0.01177%	602398	91.53%	41	16.60%
雞	1205		18	78	0.01177%	602476	91.58%	41	16.60%
貫	1280		11	70	0.01056%	602546	92.42%	41	16.60%
彿	1298		8	68	0.01026%	602614	92.60%	41	16.60%
爬	1309		8	67	0.01011%	602681	92.72%	41	16.60%
衛	1313		15	67	0.01011%	602748	92.76%	41	16.60%
摸	1333		14	65	0.009808%	602813	92.95%	41	16.60%
吐	1342		6	64	0.009657%	602877	93.04%	41	16.60%
敗	1354		11	63	0.009507%	602940	93.16%	41	16.60%
諸	1360		15	63	0.009507%	603003	93.21%	41	16.60%
珍	1368		9	62	0.009356%	603065	93.29%	41	16.60%
倍	1384		10	60	0.009054%	603125	93.44%	41	16.60%
伴	1403		7	58	0.008752%	603183	93.61%	41	16.60%
誌	1423		14	57	0.008601%	603240	93.78%	41	16.60%
埋	1427		10	56	0.00845%	603296	93.82%	41	16.60%
膽	1481		17	52	0.007847%	603348	94.25%	41	16.60%
頗	1485		14	52	0.007847%	603400	94.29%	41	16.60%
悉	1487		11	51	0.007696%	603451	94.30%	41	16.60%
婚	687		11	187	0.02822%	603638	82.11%	40	16.19%
妻	819		8	148	0.02233%	603786	85.43%	40	16.19%
澤	1094		16	92	0.01388%	603878	90.18%	40	16.19%
警	1113		20	90	0.01358%	603968	90.44%	40	16.19%
呀	1122		7	87	0.01313%	604055	90.56%	40	16.19%
岸	1235		8	74	0.01117%	604129	91.93%	40	16.19%
呆	1260		7	71	0.01071%	604200	92.20%	40	16.19%
廳	1262		25	71	0.01071%	604271	92.22%	40	16.19%
鬼	1296		10	69	0.01041%	604340	92.58%	40	16.19%
扎	1306		4	67	0.01011%	604407	92.68%	40	16.19%
齡	1320		20	67	0.01011%	604474	92.83%	40	16.19%
繫	1465		19	53	0.007998%	604527	94.13%	40	16.19%
斜	1472		11	52	0.007847%	604579	94.18%	40	16.19%
豪	1534		14	48	0.007243%	604627	94.65%	40	16.19%
貨	915		11	119	0.01796%	604746	87.35%	39	15.79%
楊	952		13	112	0.0169%	604858	87.99%	39	15.79%
塑	1034		13	100	0.01509%	604958	89.31%	39	15.79%
訓	1072		10	96	0.01449%	605054	89.87%	39	15.79%
晨	1182		11	80	0.01207%	605134	91.31%	39	15.79%
飄	1188		20	80	0.01207%	605214	91.38%	39	15.79%
競	1201		20	78	0.01177%	605292	91.54%	39	15.79%
軟	1204		11	78	0.01177%	605370	91.57%	39	15.79%
宏	1255		7	72	0.01086%	605442	92.15%	39	15.79%
滾	1327		14	66	0.009959%	605508	92.90%	39	15.79%
慶	1387		15	60	0.009054%	605568	93.46%	39	15.79%
覆	1412		18	58	0.008752%	605626	93.69%	39	15.79%
勇	1470		9	52	0.007847%	605678	94.17%	39	15.79%
伐	1022		6	101	0.01524%	605779	89.12%	38	15.38%
網	1145		14	84	0.01268%	605863	90.86%	38	15.38%
刀	1207		2	77	0.01162%	605940	91.61%	38	15.38%
汗	1237		6	74	0.01117%	606014	91.95%	38	15.38%
兵	1271		7	70	0.01056%	606084	92.32%	38	15.38%
遊	1314		12	67	0.01011%	606151	92.77%	38	15.38%
彈	1330		15	65	0.009808%	606216	92.93%	38	15.38%
輸	1347		16	64	0.009657%	606280	93.09%	38	15.38%
仿	1349		6	63	0.009507%	606343	93.11%	38	15.38%
偷	1351		11	63	0.009507%	606406	93.13%	38	15.38%
撞	1417		15	57	0.008601%	606463	93.73%	38	15.38%
渾	1432		12	56	0.00845%	606519	93.86%	38	15.38%
播	1448		15	54	0.008148%	606573	93.99%	38	15.38%
辛	1491		7	51	0.007696%	606624	94.33%	38	15.38%
抑	1510		7	49	0.007394%	606673	94.47%	38	15.38%
懸	1550		20	46	0.006941%	606719	94.76%	38	15.38%
監	799		14	155	0.02339%	606874	84.97%	37	14.98%
竹	816		6	151	0.02279%	607025	85.36%	37	14.98%
票	909		11	121	0.01826%	607146	87.24%	37	14.98%
船	957		11	111	0.01675%	607257	88.08%	37	14.98%
哈	960		9	110	0.0166%	607367	88.13%	37	14.98%
哥	987		10	107	0.01615%	607474	88.57%	37	14.98%
姑	1091		8	92	0.01388%	607566	90.14%	37	14.98%
戲	1093		17	92	0.01388%	607658	90.17%	37	14.98%
奏	1166		9	81	0.01222%	607739	91.12%	37	14.98%
乃	1285		2	69	0.01041%	607808	92.47%	37	14.98%
牌	1310		12	67	0.01011%	607875	92.73%	37	14.98%
尾	1404		7	58	0.008752%	607933	93.62%	37	14.98%
籠	1433		22	56	0.00845%	607989	93.87%	37	14.98%
旋	1441		11	55	0.008299%	608044	93.93%	37	14.98%
哀	1471		9	52	0.007847%	608096	94.18%	37	14.98%
勤	1519		13	48	0.007243%	608144	94.54%	37	14.98%
暖	1525		13	48	0.007243%	608192	94.58%	37	14.98%
潔	1529		15	48	0.007243%	608240	94.61%	37	14.98%
番	1554		12	46	0.006941%	608286	94.79%	37	14.98%
森	671		12	193	0.02912%	608479	81.65%	36	14.57%
媽	814		13	151	0.02279%	608630	85.32%	36	14.57%
糧	943		18	114	0.0172%	608744	87.84%	36	14.57%
爺	1021		13	102	0.01539%	608846	89.11%	36	14.57%
卡	1163		5	81	0.01222%	608927	91.08%	36	14.57%
射	1227		10	75	0.01132%	609002	91.84%	36	14.57%
雅	1252		12	73	0.01102%	609075	92.12%	36	14.57%
孔	1290		4	69	0.01041%	609144	92.52%	36	14.57%
揭	1374		12	61	0.009205%	609205	93.35%	36	14.57%
洞	1376		9	61	0.009205%	609266	93.36%	36	14.57%
顆	1383		17	61	0.009205%	609327	93.43%	36	14.57%
跨	1393		13	60	0.009054%	609387	93.52%	36	14.57%
蒼	1401		14	59	0.008903%	609446	93.59%	36	14.57%
赤	1455		7	54	0.008148%	609500	94.05%	36	14.57%
鑒	1469		22	53	0.007998%	609553	94.16%	36	14.57%
喚	1486		12	51	0.007696%	609604	94.29%	36	14.57%
隔	1492		12	51	0.007696%	609655	94.34%	36	14.57%
碰	1499		13	50	0.007545%	609705	94.39%	36	14.57%
仰	1505		6	49	0.007394%	609754	94.44%	36	14.57%
圈	1507		11	49	0.007394%	609803	94.45%	36	14.57%
寒	1540		12	47	0.007092%	609850	94.69%	36	14.57%
鍵	1566		17	45	0.00679%	609895	94.87%	36	14.57%
滋	1599		12	43	0.006489%	609938	95.09%	36	14.57%
眉	1603		9	43	0.006489%	609981	95.11%	36	14.57%
飲	753		12	166	0.02505%	610147	83.86%	35	14.17%
劉	770		15	161	0.02429%	610308	84.28%	35	14.17%
刊	954		5	111	0.01675%	610419	88.03%	35	14.17%
疾	1051		10	99	0.01494%	610518	89.56%	35	14.17%
救	1210		11	77	0.01162%	610595	91.64%	35	14.17%
稿	1241		15	74	0.01117%	610669	91.99%	35	14.17%
貧	1268		11	71	0.01071%	610740	92.29%	35	14.17%
召	1322		5	66	0.009959%	610806	92.85%	35	14.17%
搬	1332		13	65	0.009808%	610871	92.95%	35	14.17%
姓	1386		8	60	0.009054%	610931	93.46%	35	14.17%
屆	1439		8	55	0.008299%	610986	93.92%	35	14.17%
湧	1462		12	53	0.007998%	611039	94.10%	35	14.17%
准	1518		10	48	0.007243%	611087	94.53%	35	14.17%
嘆	1521		14	48	0.007243%	611135	94.55%	35	14.17%
寂	1539		11	47	0.007092%	611182	94.68%	35	14.17%
屈	1541		8	47	0.007092%	611229	94.70%	35	14.17%
奪	1548		14	46	0.006941%	611275	94.75%	35	14.17%
廢	1549		15	46	0.006941%	611321	94.76%	35	14.17%
讚	1581		26	44	0.00664%	611365	94.97%	35	14.17%
閑	1583		12	44	0.00664%	611409	94.98%	35	14.17%
猶	1625		12	42	0.006338%	611451	95.26%	35	14.17%
飽	1629		13	42	0.006338%	611493	95.28%	35	14.17%
飾	1630		13	42	0.006338%	611535	95.29%	35	14.17%
冒	1667		9	39	0.005885%	611574	95.51%	35	14.17%
酸	1009		14	105	0.01584%	611679	88.92%	34	13.77%
障	1032		13	101	0.01524%	611780	89.28%	34	13.77%
漠	1050		14	99	0.01494%	611879	89.55%	34	13.77%
庫	1065		10	96	0.01449%	611975	89.77%	34	13.77%
舍	1096		8	92	0.01388%	612067	90.21%	34	13.77%
剩	1162		12	81	0.01222%	612148	91.07%	34	13.77%
丈	1253		3	72	0.01086%	612220	92.13%	34	13.77%
陪	1413		10	58	0.008752%	612278	93.70%	34	13.77%
佳	1414		8	57	0.008601%	612335	93.70%	34	13.77%
悠	1524		11	48	0.007243%	612383	94.58%	34	13.77%
棄	1526		11	48	0.007243%	612431	94.59%	34	13.77%
貌	1535		14	48	0.007243%	612479	94.66%	34	13.77%
猛	1553		11	46	0.006941%	612525	94.78%	34	13.77%
肚	1564		7	45	0.00679%	612570	94.86%	34	13.77%
惑	1591		12	43	0.006489%	612613	95.04%	34	13.77%
喪	1618		12	42	0.006338%	612655	95.21%	34	13.77%
循	1620		12	42	0.006338%	612697	95.22%	34	13.77%
距	1680		12	39	0.005885%	612736	95.59%	34	13.77%
逢	1681		10	39	0.005885%	612775	95.59%	34	13.77%
朱	772		6	161	0.02429%	612936	84.33%	33	13.36%
築	795		16	156	0.02354%	613092	84.88%	33	13.36%
倫	949		10	112	0.0169%	613204	87.94%	33	13.36%
茶	1030		10	101	0.01524%	613305	89.25%	33	13.36%
瓶	1088		11	93	0.01403%	613398	90.10%	33	13.36%
墨	1123		15	87	0.01313%	613485	90.57%	33	13.36%
輯	1161		16	82	0.01237%	613567	91.05%	33	13.36%
爛	1240		21	74	0.01117%	613641	91.98%	33	13.36%
愈	1263		13	71	0.01071%	613712	92.23%	33	13.36%
啦	1273		11	70	0.01056%	613782	92.34%	33	13.36%
霧	1317		19	67	0.01011%	613849	92.80%	33	13.36%
耕	1337		10	65	0.009808%	613914	92.99%	33	13.36%
袋	1338		11	65	0.009808%	613979	93.00%	33	13.36%
伍	1350		6	63	0.009507%	614042	93.12%	33	13.36%
違	1371		12	62	0.009356%	614104	93.32%	33	13.36%
軌	1483		9	52	0.007847%	614156	94.27%	33	13.36%
腰	1490		13	51	0.007696%	614207	94.32%	33	13.36%
亦	1493		6	50	0.007545%	614257	94.35%	33	13.36%
憤	1509		15	49	0.007394%	614306	94.47%	33	13.36%
塗	1547		13	46	0.006941%	614352	94.74%	33	13.36%
昏	1551		8	46	0.006941%	614398	94.77%	33	13.36%
鄰	1556		14	46	0.006941%	614444	94.80%	33	13.36%
陷	1557		10	46	0.006941%	614490	94.81%	33	13.36%
撲	1560		15	45	0.00679%	614535	94.83%	33	13.36%
漂	1574		14	44	0.00664%	614579	94.93%	33	13.36%
稀	1576		12	44	0.00664%	614623	94.94%	33	13.36%
罩	1577		13	44	0.00664%	614667	94.94%	33	13.36%
煩	1624		13	42	0.006338%	614709	95.25%	33	13.36%
敲	1654		14	40	0.006036%	614749	95.43%	33	13.36%
暫	1692		15	38	0.005734%	614787	95.66%	33	13.36%
污	864		6	133	0.02007%	614920	86.38%	32	12.96%
災	1028		7	101	0.01524%	615021	89.22%	32	12.96%
毀	1068		13	96	0.01449%	615117	89.81%	32	12.96%
訂	1160		9	82	0.01237%	615199	91.04%	32	12.96%
售	1208		11	77	0.01162%	615276	91.62%	32	12.96%
帝	1261		9	71	0.01071%	615347	92.21%	32	12.96%
浮	1308		10	67	0.01011%	615414	92.70%	32	12.96%
甜	1358		11	63	0.009507%	615477	93.20%	32	12.96%
渡	1390		12	60	0.009054%	615537	93.49%	32	12.96%
焦	1391		12	60	0.009054%	615597	93.50%	32	12.96%
勃	1426		9	56	0.00845%	615653	93.81%	32	12.96%
戀	1440		23	55	0.008299%	615708	93.93%	32	12.96%
枝	1442		8	55	0.008299%	615763	93.94%	32	12.96%
抵	1459		8	53	0.007998%	615816	94.08%	32	12.96%
溝	1528		13	48	0.007243%	615864	94.61%	32	12.96%
拾	1542		9	47	0.007092%	615911	94.71%	32	12.96%
逃	1543		9	47	0.007092%	615958	94.71%	32	12.96%
潛	1552		15	46	0.006941%	616004	94.78%	32	12.96%
兼	1558		10	45	0.00679%	616049	94.82%	32	12.96%
叢	1559		18	45	0.00679%	616094	94.82%	32	12.96%
濕	1562		17	45	0.00679%	616139	94.84%	32	12.96%
攻	1595		7	43	0.006489%	616182	95.06%	32	12.96%
掩	1634		11	41	0.006187%	616223	95.31%	32	12.96%
串	1646		7	40	0.006036%	616263	95.39%	32	12.96%
脆	1701		10	38	0.005734%	616301	95.71%	32	12.96%
蟲	1112		18	90	0.01358%	616391	90.43%	31	12.55%
婆	1167		11	81	0.01222%	616472	91.13%	31	12.55%
兄	1206		5	77	0.01162%	616549	91.60%	31	12.55%
湖	1239		12	74	0.01117%	616623	91.97%	31	12.55%
鞋	1318		15	67	0.01011%	616690	92.81%	31	12.55%
悄	1331		10	65	0.009808%	616755	92.94%	31	12.55%
鳴	1402		14	59	0.008903%	616814	93.60%	31	12.55%
煉	1409		13	58	0.008752%	616872	93.66%	31	12.55%
睜	1477		13	52	0.007847%	616924	94.22%	31	12.55%
撥	1489		15	51	0.007696%	616975	94.32%	31	12.55%
呈	1495		7	50	0.007545%	617025	94.36%	31	12.55%
扭	1497		7	50	0.007545%	617075	94.38%	31	12.55%
遞	1502		13	50	0.007545%	617125	94.41%	31	12.55%
挺	1594		10	43	0.006489%	617168	95.06%	31	12.55%
潤	1600		15	43	0.006489%	617211	95.10%	31	12.55%
肅	1605		12	43	0.006489%	617254	95.13%	31	12.55%
彎	1619		22	42	0.006338%	617296	95.22%	31	12.55%
滴	1657		14	40	0.006036%	617336	95.45%	31	12.55%
氛	1671		8	39	0.005885%	617375	95.54%	31	12.55%
姿	1713		9	37	0.005583%	617412	95.78%	31	12.55%
稍	1738		12	36	0.005432%	617448	95.92%	31	12.55%
脈	1740		10	36	0.005432%	617484	95.93%	31	12.55%
臥	1741		8	36	0.005432%	617520	95.93%	31	12.55%
耐	1760		9	35	0.005281%	617555	96.03%	31	12.55%
您	1016		11	103	0.01554%	617658	89.03%	30	12.15%
雕	1187		16	80	0.01207%	617738	91.37%	30	12.15%
泉	1193		9	79	0.01192%	617817	91.44%	30	12.15%
佛	1198		7	78	0.01177%	617895	91.50%	30	12.15%
謝	1221		17	76	0.01147%	617971	91.77%	30	12.15%
哲	1297		10	68	0.01026%	618039	92.59%	30	12.15%
犯	1356		5	63	0.009507%	618102	93.18%	30	12.15%
辭	1395		19	60	0.009054%	618162	93.54%	30	12.15%
患	1406		11	58	0.008752%	618220	93.63%	30	12.15%
籌	1450		20	54	0.008148%	618274	94.01%	30	12.15%
肥	1452		8	54	0.008148%	618328	94.02%	30	12.15%
疲	1476		10	52	0.007847%	618380	94.21%	30	12.15%
遙	1517		13	49	0.007394%	618429	94.53%	30	12.15%
脖	1578		11	44	0.00664%	618473	94.95%	30	12.15%
縱	1641		17	41	0.006187%	618514	95.36%	30	12.15%
掃	1688		11	38	0.005734%	618552	95.64%	30	12.15%
割	1708		12	37	0.005583%	618589	95.75%	30	12.15%
厭	1709		14	37	0.005583%	618626	95.76%	30	12.15%
渴	1719		12	37	0.005583%	618663	95.81%	30	12.15%
暢	1802		14	33	0.00498%	618696	96.25%	30	12.15%
灣	762		25	164	0.02475%	618860	84.08%	29	11.74%
橋	1012		16	104	0.01569%	618964	88.97%	29	11.74%
葯	1097		13	92	0.01388%	619056	90.22%	29	11.74%
牧	1105		8	91	0.01373%	619147	90.33%	29	11.74%
岩	1365		8	62	0.009356%	619209	93.26%	29	11.74%
洪	1367		9	62	0.009356%	619271	93.28%	29	11.74%
杯	1375		8	61	0.009205%	619332	93.35%	29	11.74%
鋼	1436		16	56	0.00845%	619388	93.89%	29	11.74%
陶	1437		10	56	0.00845%	619444	93.90%	29	11.74%
稅	1478		12	52	0.007847%	619496	94.23%	29	11.74%
郁	1503		8	50	0.007545%	619546	94.42%	29	11.74%
罵	1515		15	49	0.007394%	619595	94.51%	29	11.74%
樸	1561		16	45	0.00679%	619640	94.84%	29	11.74%
乘	1585		10	43	0.006489%	619683	95.00%	29	11.74%
譽	1607		21	43	0.006489%	619726	95.14%	29	11.74%
躺	1609		15	43	0.006489%	619769	95.15%	29	11.74%
阻	1612		7	43	0.006489%	619812	95.17%	29	11.74%
咬	1617		9	42	0.006338%	619854	95.20%	29	11.74%
茫	1627		10	42	0.006338%	619896	95.27%	29	11.74%
虎	1628		8	42	0.006338%	619938	95.27%	29	11.74%
摩	1635		15	41	0.006187%	619979	95.32%	29	11.74%
滑	1672		13	39	0.005885%	620018	95.54%	29	11.74%
燃	1695		16	38	0.005734%	620056	95.68%	29	11.74%
誘	1704		14	38	0.005734%	620094	95.73%	29	11.74%
忠	1753		8	35	0.005281%	620129	96.00%	29	11.74%
牲	1757		9	35	0.005281%	620164	96.02%	29	11.74%
詳	1835		13	32	0.004829%	620196	96.41%	29	11.74%
宋	955		7	111	0.01675%	620307	88.04%	28	11.34%
雷	1212		13	77	0.01162%	620384	91.67%	28	11.34%
池	1238		6	74	0.01117%	620458	91.96%	28	11.34%
拜	1323		9	66	0.009959%	620524	92.86%	28	11.34%
仙	1348		5	63	0.009507%	620587	93.10%	28	11.34%
塵	1362		14	62	0.009356%	620649	93.23%	28	11.34%
棵	1407		12	58	0.008752%	620707	93.64%	28	11.34%
皇	1444		9	55	0.008299%	620762	93.96%	28	11.34%
妹	1447		8	54	0.008148%	620816	93.98%	28	11.34%
搶	1460		13	53	0.007998%	620869	94.09%	28	11.34%
唐	1520		10	48	0.007243%	620917	94.55%	28	11.34%
壇	1522		16	48	0.007243%	620965	94.56%	28	11.34%
恢	1523		9	48	0.007243%	621013	94.57%	28	11.34%
礙	1563		19	45	0.00679%	621058	94.85%	28	11.34%
瓜	1575		5	44	0.00664%	621102	94.93%	28	11.34%
朗	1596		10	43	0.006489%	621145	95.07%	28	11.34%
悅	1621		10	42	0.006338%	621187	95.23%	28	11.34%
拖	1623		8	42	0.006338%	621229	95.24%	28	11.34%
潑	1658		15	40	0.006036%	621269	95.46%	28	11.34%
裂	1664		12	40	0.006036%	621309	95.49%	28	11.34%
垂	1668		9	39	0.005885%	621348	95.52%	28	11.34%
撒	1690		15	38	0.005734%	621386	95.65%	28	11.34%
摘	1716		14	37	0.005583%	621423	95.79%	28	11.34%
幼	1750		5	35	0.005281%	621458	95.98%	28	11.34%
披	1770		8	34	0.005131%	621492	96.08%	28	11.34%
耀	1779		20	34	0.005131%	621526	96.13%	28	11.34%
返	1784		7	34	0.005131%	621560	96.16%	28	11.34%
振	1822		10	32	0.004829%	621592	96.34%	28	11.34%
牽	1828		11	32	0.004829%	621624	96.37%	28	11.34%
拼	1851		9	31	0.004678%	621655	96.48%	28	11.34%
督	853		13	136	0.02052%	621791	86.16%	27	10.93%
賽	974		17	109	0.01645%	621900	88.36%	27	10.93%
島	1169		10	81	0.01222%	621981	91.15%	27	10.93%
徒	1274		10	70	0.01056%	622051	92.35%	27	10.93%
胞	1301		9	68	0.01026%	622119	92.63%	27	10.93%
賓	1434		14	56	0.00845%	622175	93.87%	27	10.93%
蘭	1482		21	52	0.007847%	622227	94.26%	27	10.93%
敏	1511		11	49	0.007394%	622276	94.48%	27	10.93%
毒	1527		9	48	0.007243%	622324	94.60%	27	10.93%
詢	1533		13	48	0.007243%	622372	94.64%	27	10.93%
倆	1567		10	44	0.00664%	622416	94.88%	27	10.93%
涵	1573		11	44	0.00664%	622460	94.92%	27	10.93%
扶	1593		7	43	0.006489%	622503	95.05%	27	10.93%
玻	1601		9	43	0.006489%	622546	95.10%	27	10.93%
絡	1604		12	43	0.006489%	622589	95.12%	27	10.93%
寄	1652		11	40	0.006036%	622629	95.42%	27	10.93%
瘦	1676		14	39	0.005885%	622668	95.57%	27	10.93%
盆	1677		9	39	0.005885%	622707	95.57%	27	10.93%
頻	1682		16	39	0.005885%	622746	95.60%	27	10.93%
插	1689		12	38	0.005734%	622784	95.64%	27	10.93%
躲	1743		13	36	0.005432%	622820	95.94%	27	10.93%
碼	1758		15	35	0.005281%	622855	96.02%	27	10.93%
縫	1759		17	35	0.005281%	622890	96.03%	27	10.93%
擾	1771		18	34	0.005131%	622924	96.09%	27	10.93%
艷	1781		24	34	0.005131%	622958	96.14%	27	10.93%
逝	1785		10	34	0.005131%	622992	96.16%	27	10.93%
夕	1792		3	33	0.00498%	623025	96.20%	27	10.93%
夾	1793		7	33	0.00498%	623058	96.20%	27	10.93%
捧	1798		11	33	0.00498%	623091	96.23%	27	10.93%
遵	1815		15	33	0.00498%	623124	96.31%	27	10.93%
滲	1857		14	31	0.004678%	623155	96.51%	27	10.93%
衷	1866		10	31	0.004678%	623186	96.55%	27	10.93%
碑	963		13	110	0.0166%	623296	88.18%	26	10.53%
奶	975		5	108	0.0163%	623404	88.37%	26	10.53%
阿	1075		7	95	0.01434%	623499	89.91%	26	10.53%
晶	1192		12	79	0.01192%	623578	91.43%	26	10.53%
尼	1256		5	72	0.01086%	623650	92.16%	26	10.53%
槍	1325		14	66	0.009959%	623716	92.88%	26	10.53%
吳	1329		7	65	0.009808%	623781	92.92%	26	10.53%
狗	1357		8	63	0.009507%	623844	93.19%	26	10.53%
鋒	1381		15	61	0.009205%	623905	93.41%	26	10.53%
豆	1454		7	54	0.008148%	623959	94.04%	26	10.53%
邁	1468		16	53	0.007998%	624012	94.15%	26	10.53%
簽	1514		19	49	0.007394%	624061	94.50%	26	10.53%
腐	1579		14	44	0.00664%	624105	94.96%	26	10.53%
冠	1587		9	43	0.006489%	624148	95.01%	26	10.53%
璃	1602		15	43	0.006489%	624191	95.11%	26	10.53%
償	1614		17	42	0.006338%	624233	95.19%	26	10.53%
奉	1631		8	41	0.006187%	624274	95.29%	26	10.53%
蓄	1642		14	41	0.006187%	624315	95.36%	26	10.53%
聖	1663		13	40	0.006036%	624355	95.49%	26	10.53%
拔	1669		8	39	0.005885%	624394	95.52%	26	10.53%
甲	1674		5	39	0.005885%	624433	95.55%	26	10.53%
瘋	1675		14	39	0.005885%	624472	95.56%	26	10.53%
枯	1693		9	38	0.005734%	624510	95.66%	26	10.53%
綿	1700		14	38	0.005734%	624548	95.70%	26	10.53%
騎	1705		18	38	0.005734%	624586	95.73%	26	10.53%
憂	1714		15	37	0.005583%	624623	95.78%	26	10.53%
扣	1715		6	37	0.005583%	624660	95.79%	26	10.53%
顫	1724		22	37	0.005583%	624697	95.84%	26	10.53%
慰	1729		15	36	0.005432%	624733	95.87%	26	10.53%
撫	1730		15	36	0.005432%	624769	95.87%	26	10.53%
估	1745		7	35	0.005281%	624804	95.95%	26	10.53%
宿	1749		11	35	0.005281%	624839	95.97%	26	10.53%
申	1775		5	34	0.005131%	624873	96.11%	26	10.53%
窩	1778		14	34	0.005131%	624907	96.12%	26	10.53%
刷	1790		8	33	0.00498%	624940	96.19%	26	10.53%
賴	1814		16	33	0.00498%	624973	96.31%	26	10.53%
貢	1838		10	32	0.004829%	625005	96.42%	26	10.53%
悟	1848		10	31	0.004678%	625036	96.47%	26	10.53%
搏	1854		13	31	0.004678%	625067	96.50%	26	10.53%
旦	1893		5	29	0.004376%	625096	96.67%	26	10.53%
逼	1904		12	29	0.004376%	625125	96.72%	26	10.53%
貸	677		12	192	0.02897%	625317	81.83%	25	10.12%
黎	776		15	161	0.02429%	625478	84.43%	25	10.12%
攝	875		21	130	0.01962%	625608	86.60%	25	10.12%
烏	1069		10	96	0.01449%	625704	89.83%	25	10.12%
慎	1108		13	90	0.01358%	625794	90.37%	25	10.12%
魯	1396		15	60	0.009054%	625854	93.55%	25	10.12%
殖	1418		12	57	0.008601%	625911	93.74%	25	10.12%
瓦	1512		5	49	0.007394%	625960	94.49%	25	10.12%
抒	1570		7	44	0.00664%	626004	94.90%	25	10.12%
勒	1588		11	43	0.006489%	626047	95.02%	25	10.12%
掙	1653		11	40	0.006036%	626087	95.43%	25	10.12%
幕	1685		14	38	0.005734%	626125	95.62%	25	10.12%
抖	1687		7	38	0.005734%	626163	95.63%	25	10.12%
歪	1736		9	36	0.005432%	626199	95.90%	25	10.12%
籍	1739		20	36	0.005432%	626235	95.92%	25	10.12%
削	1747		9	35	0.005281%	626270	95.96%	25	10.12%
惱	1767		12	34	0.005131%	626304	96.07%	25	10.12%
慘	1768		14	34	0.005131%	626338	96.07%	25	10.12%
扔	1769		5	34	0.005131%	626372	96.08%	25	10.12%
辯	1783		21	34	0.005131%	626406	96.15%	25	10.12%
抹	1797		8	33	0.00498%	626439	96.22%	25	10.12%
淺	1806		11	33	0.00498%	626472	96.27%	25	10.12%
衰	1812		10	33	0.00498%	626505	96.30%	25	10.12%
賦	1839		15	32	0.004829%	626537	96.43%	25	10.12%
截	1849		14	31	0.004678%	626568	96.47%	25	10.12%
謀	1883		16	30	0.004527%	626598	96.63%	25	10.12%
傲	1887		13	29	0.004376%	626627	96.65%	25	10.12%
贊	1903		19	29	0.004376%	626656	96.72%	25	10.12%
劣	1910		6	28	0.004225%	626684	96.75%	25	10.12%
裹	1926		14	28	0.004225%	626712	96.82%	25	10.12%
鎖	1930		18	28	0.004225%	626740	96.83%	25	10.12%
堪	1970		12	26	0.003923%	626766	97.00%	25	10.12%
砍	907		9	123	0.01856%	626889	87.21%	24	9.72%
呵	1153		8	82	0.01237%	626971	90.96%	24	9.72%
侵	1222		9	75	0.01132%	627046	91.78%	24	9.72%
錦	1283		16	70	0.01056%	627116	92.45%	24	9.72%
蕭	1369		16	62	0.009356%	627178	93.30%	24	9.72%
麥	1372		11	62	0.009356%	627240	93.33%	24	9.72%
糖	1421		16	57	0.008601%	627297	93.76%	24	9.72%
惠	1430		12	56	0.00845%	627353	93.84%	24	9.72%
伊	1446		6	54	0.008148%	627407	93.97%	24	9.72%
糾	1479		8	52	0.007847%	627459	94.24%	24	9.72%
臂	1480		17	52	0.007847%	627511	94.25%	24	9.72%
嘛	1496		14	50	0.007545%	627561	94.37%	24	9.72%
繪	1531		19	48	0.007243%	627609	94.63%	24	9.72%
頁	1536		9	48	0.007243%	627657	94.66%	24	9.72%
君	1616		7	42	0.006338%	627699	95.20%	24	9.72%
恩	1633		10	41	0.006187%	627740	95.31%	24	9.72%
慌	1686		13	38	0.005734%	627778	95.62%	24	9.72%
擦	1691		17	38	0.005734%	627816	95.65%	24	9.72%
秩	1698		10	38	0.005734%	627854	95.69%	24	9.72%
嘗	1711		14	37	0.005583%	627891	95.77%	24	9.72%
敵	1731		15	36	0.005432%	627927	95.88%	24	9.72%
征	1751		8	35	0.005281%	627962	95.98%	24	9.72%
斤	1754		4	35	0.005281%	627997	96.00%	24	9.72%
斗	1773		4	34	0.005131%	628031	96.10%	24	9.72%
祝	1777		9	34	0.005131%	628065	96.12%	24	9.72%
聳	1780		17	34	0.005131%	628099	96.14%	24	9.72%
灌	1808		21	33	0.00498%	628132	96.28%	24	9.72%
箱	1809		15	33	0.00498%	628165	96.28%	24	9.72%
盼	1831		9	32	0.004829%	628197	96.39%	24	9.72%
纏	1862		21	31	0.004678%	628228	96.53%	24	9.72%
斥	1873		5	30	0.004527%	628258	96.59%	24	9.72%
窄	1897		10	29	0.004376%	628287	96.69%	24	9.72%
頑	1962		13	27	0.004074%	628314	96.96%	24	9.72%
彼	1976		8	26	0.003923%	628340	97.02%	24	9.72%
禍	2015		13	25	0.003772%	628365	97.17%	24	9.72%
浴	896		10	125	0.01886%	628490	87.00%	23	9.31%
貿	918		12	118	0.01781%	628608	87.41%	23	9.31%
荷	1231		11	75	0.01132%	628683	91.88%	23	9.31%
余	1269		7	70	0.01056%	628753	92.30%	23	9.31%
姐	1289		8	69	0.01041%	628822	92.51%	23	9.31%
羊	1312		6	67	0.01011%	628889	92.75%	23	9.31%
掘	1488		11	51	0.007696%	628940	94.31%	23	9.31%
迪	1516		8	49	0.007394%	628989	94.52%	23	9.31%
鍋	1544		17	47	0.007092%	629036	94.72%	23	9.31%
厲	1568		15	44	0.00664%	629080	94.89%	23	9.31%
虧	1580		17	44	0.00664%	629124	94.96%	23	9.31%
扇	1592		10	43	0.006489%	629167	95.04%	23	9.31%
添	1598		11	43	0.006489%	629210	95.08%	23	9.31%
剝	1615		10	42	0.006338%	629252	95.19%	23	9.31%
宮	1632		10	41	0.006187%	629293	95.30%	23	9.31%
碗	1639		13	41	0.006187%	629334	95.34%	23	9.31%
吉	1647		6	40	0.006036%	629374	95.39%	23	9.31%
製	1679		14	39	0.005885%	629413	95.58%	23	9.31%
紫	1699		12	38	0.005734%	629451	95.70%	23	9.31%
裁	1703		12	38	0.005734%	629489	95.72%	23	9.31%
昨	1732		9	36	0.005432%	629525	95.88%	23	9.31%
采	1744		8	36	0.005432%	629561	95.95%	23	9.31%
徐	1752		10	35	0.005281%	629596	95.99%	23	9.31%
噴	1764		15	34	0.005131%	629630	96.05%	23	9.31%
痕	1776		11	34	0.005131%	629664	96.11%	23	9.31%
斑	1799		12	33	0.00498%	629697	96.23%	23	9.31%
渠	1807		12	33	0.00498%	629730	96.27%	23	9.31%
譯	1813		20	33	0.00498%	629763	96.30%	23	9.31%
頌	1818		13	33	0.00498%	629796	96.33%	23	9.31%
盲	1830		8	32	0.004829%	629828	96.38%	23	9.31%
妥	1844		7	31	0.004678%	629859	96.45%	23	9.31%
宇	1846		6	31	0.004678%	629890	96.46%	23	9.31%
皆	1877		9	30	0.004527%	629920	96.60%	23	9.31%
辨	1884		16	30	0.004527%	629950	96.64%	23	9.31%
悶	1892		12	29	0.004376%	629979	96.67%	23	9.31%
狹	1896		10	29	0.004376%	630008	96.69%	23	9.31%
脊	1923		10	28	0.004225%	630036	96.80%	23	9.31%
慨	1944		12	27	0.004074%	630063	96.89%	23	9.31%
拋	1946		8	27	0.004074%	630090	96.90%	23	9.31%
誕	1995		15	26	0.003923%	630116	97.09%	23	9.31%
齒	1999		15	26	0.003923%	630142	97.11%	23	9.31%
腔	2056		12	24	0.003622%	630166	97.32%	23	9.31%
琴	1132		12	86	0.01298%	630252	90.69%	22	8.91%
蹈	1295		17	69	0.01041%	630321	92.57%	22	8.91%
溪	1326		13	66	0.009959%	630387	92.89%	22	8.91%
丁	1425		2	56	0.00845%	630443	93.80%	22	8.91%
儀	1506		15	49	0.007394%	630492	94.44%	22	8.91%
仁	1538		4	47	0.007092%	630539	94.68%	22	8.91%
餐	1545		16	47	0.007092%	630586	94.73%	22	8.91%
銅	1582		14	44	0.00664%	630630	94.98%	22	8.91%
豬	1608		11	43	0.006489%	630673	95.15%	22	8.91%
覽	1643		21	41	0.006187%	630714	95.37%	22	8.91%
喘	1648		12	40	0.006036%	630754	95.40%	22	8.91%
仔	1683		5	38	0.005734%	630792	95.61%	22	8.91%
坦	1712		8	37	0.005583%	630829	95.77%	22	8.91%
沈	1718		7	37	0.005583%	630866	95.81%	22	8.91%
欠	1734		4	36	0.005432%	630902	95.89%	22	8.91%
允	1746		4	35	0.005281%	630937	95.96%	22	8.91%
攤	1772		22	34	0.005131%	630971	96.09%	22	8.91%
孕	1795		5	33	0.00498%	631004	96.21%	22	8.91%
膀	1811		14	33	0.00498%	631037	96.29%	22	8.91%
吞	1820		7	32	0.004829%	631069	96.34%	22	8.91%
扯	1850		7	31	0.004678%	631100	96.48%	22	8.91%
掏	1852		11	31	0.004678%	631131	96.49%	22	8.91%
邀	1868		16	31	0.004678%	631162	96.56%	22	8.91%
彷	1871		7	30	0.004527%	631192	96.58%	22	8.91%
裙	1882		12	30	0.004527%	631222	96.63%	22	8.91%
駛	1886		15	30	0.004527%	631252	96.64%	22	8.91%
勸	1888		20	29	0.004376%	631281	96.65%	22	8.91%
顛	1909		19	29	0.004376%	631310	96.74%	22	8.91%
酷	1929		14	28	0.004225%	631338	96.83%	22	8.91%
憐	1945		15	27	0.004074%	631365	96.90%	22	8.91%
倘	1965		10	26	0.003923%	631391	96.98%	22	8.91%
愚	2009		13	25	0.003772%	631416	97.15%	22	8.91%
攀	2011		19	25	0.003772%	631441	97.16%	22	8.91%
昂	2040		8	24	0.003622%	631465	97.26%	22	8.91%
驅	2066		21	24	0.003622%	631489	97.36%	22	8.91%
匆	1397		5	59	0.008903%	631548	93.55%	21	8.50%
丹	1445		4	54	0.008148%	631602	93.97%	21	8.50%
湯	1498		12	50	0.007545%	631652	94.38%	21	8.50%
壽	1508		14	49	0.007394%	631701	94.46%	21	8.50%
症	1530		10	48	0.007243%	631749	94.62%	21	8.50%
井	1546		4	46	0.006941%	631795	94.73%	21	8.50%
挖	1571		9	44	0.00664%	631839	94.91%	21	8.50%
膚	1626		15	42	0.006338%	631881	95.26%	21	8.50%
狠	1637		9	41	0.006187%	631922	95.33%	21	8.50%
皺	1638		15	41	0.006187%	631963	95.34%	21	8.50%
爆	1696		19	38	0.005734%	632001	95.68%	21	8.50%
鹽	1706		24	38	0.005734%	632039	95.74%	21	8.50%
剪	1707		11	37	0.005583%	632076	95.74%	21	8.50%
屁	1728		7	36	0.005432%	632112	95.86%	21	8.50%
奧	1794		13	33	0.00498%	632145	96.21%	21	8.50%
川	1796		3	33	0.00498%	632178	96.22%	21	8.50%
旗	1800		14	33	0.00498%	632211	96.24%	21	8.50%
紋	1810		10	33	0.00498%	632244	96.29%	21	8.50%
罰	1833		14	32	0.004829%	632276	96.40%	21	8.50%
倡	1841		10	31	0.004678%	632307	96.44%	21	8.50%
莊	1865		11	31	0.004678%	632338	96.55%	21	8.50%
慕	1872		15	30	0.004527%	632368	96.58%	21	8.50%
浩	1875		10	30	0.004527%	632398	96.59%	21	8.50%
粒	1878		11	30	0.004527%	632428	96.61%	21	8.50%
罷	1879		15	30	0.004527%	632458	96.61%	21	8.50%
耗	1880		10	30	0.004527%	632488	96.62%	21	8.50%
嚇	1890		17	29	0.004376%	632517	96.66%	21	8.50%
扮	1916		7	28	0.004225%	632545	96.77%	21	8.50%
盈	1919		9	28	0.004225%	632573	96.79%	21	8.50%
聊	1922		11	28	0.004225%	632601	96.80%	21	8.50%
魔	1933		21	28	0.004225%	632629	96.85%	21	8.50%
叉	1938		3	27	0.004074%	632656	96.87%	21	8.50%
泡	1985		8	26	0.003923%	632682	97.05%	21	8.50%
熬	1988		15	26	0.003923%	632708	97.07%	21	8.50%
訊	1993		10	26	0.003923%	632734	97.09%	21	8.50%
舌	2020		6	25	0.003772%	632759	97.19%	21	8.50%
喧	2033		12	24	0.003622%	632783	97.24%	21	8.50%
柱	2041		9	24	0.003622%	632807	97.27%	21	8.50%
犧	2045		21	24	0.003622%	632831	97.28%	21	8.50%
械	2076		11	23	0.003471%	632854	97.39%	21	8.50%
湊	2078		12	23	0.003471%	632877	97.40%	21	8.50%
銳	2119		15	22	0.00332%	632899	97.54%	21	8.50%
疏	2136		11	21	0.003169%	632920	97.59%	21	8.50%
爸	953		8	112	0.0169%	633032	88.01%	20	8.10%
援	1003		12	105	0.01584%	633137	88.83%	20	8.10%
薩	1159		18	82	0.01237%	633219	91.03%	20	8.10%
航	1279		10	70	0.01056%	633289	92.40%	20	8.10%
債	1287		13	69	0.01041%	633358	92.49%	20	8.10%
劑	1288		16	69	0.01041%	633427	92.50%	20	8.10%
療	1378		17	61	0.009205%	633488	93.38%	20	8.10%
氏	1473		4	52	0.007847%	633540	94.19%	20	8.10%
濱	1474		17	52	0.007847%	633592	94.20%	20	8.10%
霞	1484		17	52	0.007847%	633644	94.28%	20	8.10%
伯	1586		7	43	0.006489%	633687	95.00%	20	8.10%
昌	1636		8	41	0.006187%	633728	95.32%	20	8.10%
礦	1660		20	40	0.006036%	633768	95.47%	20	8.10%
祥	1678		10	39	0.005885%	633807	95.58%	20	8.10%
椅	1717		12	37	0.005583%	633844	95.80%	20	8.10%
腸	1720		13	37	0.005583%	633881	95.82%	20	8.10%
膠	1761		15	35	0.005281%	633916	96.04%	20	8.10%
帽	1766		12	34	0.005131%	633950	96.06%	20	8.10%
嗓	1791		13	33	0.00498%	633983	96.19%	20	8.10%
梁	1825		11	32	0.004829%	634015	96.36%	20	8.10%
盯	1829		7	32	0.004829%	634047	96.38%	20	8.10%
貝	1837		7	32	0.004829%	634079	96.42%	20	8.10%
弓	1847		3	31	0.004678%	634110	96.46%	20	8.10%
梅	1855		11	31	0.004678%	634141	96.50%	20	8.10%
租	1860		10	31	0.004678%	634172	96.53%	20	8.10%
遲	1905		15	29	0.004376%	634201	96.73%	20	8.10%
填	1912		13	28	0.004225%	634229	96.76%	20	8.10%
嫩	1913		14	28	0.004225%	634257	96.76%	20	8.10%
矮	1920		13	28	0.004225%	634285	96.79%	20	8.10%
邏	1928		22	28	0.004225%	634313	96.83%	20	8.10%
丟	1934		6	27	0.004074%	634340	96.85%	20	8.10%
俱	1936		10	27	0.004074%	634367	96.86%	20	8.10%
吊	1939		6	27	0.004074%	634394	96.87%	20	8.10%
哄	1941		9	27	0.004074%	634421	96.88%	20	8.10%
濫	1949		17	27	0.004074%	634448	96.91%	20	8.10%
瀉	1950		18	27	0.004074%	634475	96.92%	20	8.10%
聰	1956		17	27	0.004074%	634502	96.94%	20	8.10%
誦	1958		14	27	0.004074%	634529	96.95%	20	8.10%
辱	1960		10	27	0.004074%	634556	96.96%	20	8.10%
愁	1977		13	26	0.003923%	634582	97.02%	20	8.10%
捉	1979		10	26	0.003923%	634608	97.03%	20	8.10%
旨	1980		6	26	0.003923%	634634	97.04%	20	8.10%
柴	1981		10	26	0.003923%	634660	97.04%	20	8.10%
刮	2002		8	25	0.003772%	634685	97.12%	20	8.10%
唇	2004		10	25	0.003772%	634710	97.13%	20	8.10%
腹	2019		13	25	0.003772%	634735	97.19%	20	8.10%
蔭	2022		15	25	0.003772%	634760	97.20%	20	8.10%
闡	2026		20	25	0.003772%	634785	97.21%	20	8.10%
彌	2037		17	24	0.003622%	634809	97.25%	20	8.10%
袖	2059		10	24	0.003622%	634833	97.33%	20	8.10%
遮	2063		14	24	0.003622%	634857	97.35%	20	8.10%
喉	2069		12	23	0.003471%	634880	97.37%	20	8.10%
擋	2075		16	23	0.003471%	634903	97.39%	20	8.10%
漲	2079		14	23	0.003471%	634926	97.40%	20	8.10%
糟	2081		17	23	0.003471%	634949	97.41%	20	8.10%
浸	2104		10	22	0.00332%	634971	97.49%	20	8.10%
赴	2117		9	22	0.00332%	634993	97.53%	20	8.10%
畏	2171		9	20	0.003018%	635013	97.70%	20	8.10%
羽	965		6	110	0.0166%	635123	88.21%	19	7.69%
塔	1165		13	81	0.01222%	635204	91.10%	19	7.69%
煤	1276		13	70	0.01056%	635274	92.37%	19	7.69%
幣	1366		14	62	0.009356%	635336	93.27%	19	7.69%
泰	1572		10	44	0.00664%	635380	94.91%	19	7.69%
洛	1655		9	40	0.006036%	635420	95.44%	19	7.69%
吵	1710		7	37	0.005583%	635457	95.76%	19	7.69%
濤	1826		17	32	0.004829%	635489	96.36%	19	7.69%
碧	1832		14	32	0.004829%	635521	96.39%	19	7.69%
搭	1853		13	31	0.004678%	635552	96.49%	19	7.69%
刑	1869		6	30	0.004527%	635582	96.57%	19	7.69%
臭	1901		10	29	0.004376%	635611	96.71%	19	7.69%
慧	1915		15	28	0.004225%	635639	96.77%	19	7.69%
炎	1917		8	28	0.004225%	635667	96.78%	19	7.69%
遼	1927		15	28	0.004225%	635695	96.82%	19	7.69%
隆	1931		11	28	0.004225%	635723	96.84%	19	7.69%
剖	1937		10	27	0.004074%	635750	96.86%	19	7.69%
輛	1959		15	27	0.004074%	635777	96.95%	19	7.69%
勾	1967		4	26	0.003923%	635803	96.98%	19	7.69%
坎	1969		7	26	0.003923%	635829	96.99%	19	7.69%
欄	1984		21	26	0.003923%	635855	97.05%	19	7.69%
疼	1989		10	26	0.003923%	635881	97.07%	19	7.69%
轟	1996		21	26	0.003923%	635907	97.10%	19	7.69%
弦	2008		8	25	0.003772%	635932	97.14%	19	7.69%
曉	2012		16	25	0.003772%	635957	97.16%	19	7.69%
攏	2039		19	24	0.003622%	635981	97.26%	19	7.69%
諧	2060		16	24	0.003622%	636005	97.33%	19	7.69%
捕	2074		10	23	0.003471%	636028	97.38%	19	7.69%
晰	2098		12	22	0.00332%	636050	97.47%	19	7.69%
疊	2108		22	22	0.00332%	636072	97.50%	19	7.69%
傻	2123		13	21	0.003169%	636093	97.55%	19	7.69%
嘲	2154		15	20	0.003018%	636113	97.65%	19	7.69%
漏	2165		14	20	0.003018%	636133	97.68%	19	7.69%
框	1388		10	60	0.009054%	636193	93.47%	18	7.29%
汁	1419		5	57	0.008601%	636250	93.75%	18	7.29%
畝	1449		10	54	0.008148%	636304	94.00%	18	7.29%
匹	1494		4	50	0.007545%	636354	94.35%	18	7.29%
津	1597		9	43	0.006489%	636397	95.08%	18	7.29%
噸	1649		16	40	0.006036%	636437	95.40%	18	7.29%
翼	1662		17	40	0.006036%	636477	95.48%	18	7.29%
吾	1684		7	38	0.005734%	636515	95.61%	18	7.29%
云	1725		4	36	0.005432%	636551	95.84%	18	7.29%
歧	1735		8	36	0.005432%	636587	95.90%	18	7.29%
咱	1748		9	35	0.005281%	636622	95.97%	18	7.29%
譜	1762		19	35	0.005281%	636657	96.04%	18	7.29%
葬	1782		13	34	0.005131%	636691	96.15%	18	7.29%
鞭	1817		18	33	0.00498%	636724	96.32%	18	7.29%
遷	1867		14	31	0.004678%	636755	96.56%	18	7.29%
繩	1898		19	29	0.004376%	636784	96.70%	18	7.29%
裕	1902		12	29	0.004376%	636813	96.71%	18	7.29%
匠	1911		6	28	0.004225%	636841	96.75%	18	7.29%
惶	1914		12	28	0.004225%	636869	96.77%	18	7.29%
裸	1925		13	28	0.004225%	636897	96.81%	18	7.29%
仇	1935		4	27	0.004074%	636924	96.85%	18	7.29%
炸	1951		9	27	0.004074%	636951	96.92%	18	7.29%
馳	1963		13	27	0.004074%	636978	96.97%	18	7.29%
尺	1973		4	26	0.003923%	637004	97.01%	18	7.29%
漁	1987		14	26	0.003923%	637030	97.06%	18	7.29%
磚	1991		16	26	0.003923%	637056	97.08%	18	7.29%
寞	2006		14	25	0.003772%	637081	97.14%	18	7.29%
挪	2010		10	25	0.003772%	637106	97.15%	18	7.29%
爽	2014		11	25	0.003772%	637131	97.17%	18	7.29%
褲	2023		15	25	0.003772%	637156	97.20%	18	7.29%
叮	2031		5	24	0.003622%	637180	97.23%	18	7.29%
廊	2036		12	24	0.003622%	637204	97.25%	18	7.29%
淋	2042		11	24	0.003622%	637228	97.27%	18	7.29%
燦	2044		17	24	0.003622%	637252	97.28%	18	7.29%
鉆	2086		13	23	0.003471%	637275	97.43%	18	7.29%
摔	2095		14	22	0.00332%	637297	97.46%	18	7.29%
閱	2120		15	22	0.00332%	637319	97.54%	18	7.29%
輔	2144		14	21	0.003169%	637340	97.62%	18	7.29%
溢	2164		13	20	0.003018%	637360	97.68%	18	7.29%
郊	2181		8	20	0.003018%	637380	97.73%	18	7.29%
魄	2184		15	20	0.003018%	637400	97.74%	18	7.29%
趙	842		14	141	0.02128%	637541	85.93%	17	6.88%
瓷	1311		11	67	0.01011%	637608	92.74%	17	6.88%
萌	1422		12	57	0.008601%	637665	93.77%	17	6.88%
辣	1435		14	56	0.00845%	637721	93.88%	17	6.88%
纖	1500		23	50	0.007545%	637771	94.40%	17	6.88%
藥	1501		19	50	0.007545%	637821	94.41%	17	6.88%
鄭	1611		14	43	0.006489%	637864	95.17%	17	6.88%
戚	1622		11	42	0.006338%	637906	95.24%	17	6.88%
液	1656		11	40	0.006036%	637946	95.45%	17	6.88%
瞬	1697		17	38	0.005734%	637984	95.69%	17	6.88%
臟	1722		22	37	0.005583%	638021	95.83%	17	6.88%
畜	1737		10	36	0.005432%	638057	95.91%	17	6.88%
炮	1756		9	35	0.005281%	638092	96.01%	17	6.88%
灘	1827		22	32	0.004829%	638124	96.37%	17	6.88%
嫁	1845		13	31	0.004678%	638155	96.46%	17	6.88%
紡	1861		10	31	0.004678%	638186	96.53%	17	6.88%
脾	1864		12	31	0.004678%	638217	96.54%	17	6.88%
姆	1870		8	30	0.004527%	638247	96.57%	17	6.88%
桑	1874		10	30	0.004527%	638277	96.59%	17	6.88%
胃	1899		9	29	0.004376%	638306	96.70%	17	6.88%
雀	1906		11	29	0.004376%	638335	96.73%	17	6.88%
爐	1918		20	28	0.004225%	638363	96.78%	17	6.88%
髒	1932		22	28	0.004225%	638391	96.84%	17	6.88%
悔	1943		10	27	0.004074%	638418	96.89%	17	6.88%
坑	2005		7	25	0.003772%	638443	97.13%	17	6.88%
櫃	2013		18	25	0.003772%	638468	97.16%	17	6.88%
傢	2027		12	24	0.003622%	638492	97.22%	17	6.88%
哦	2032		10	24	0.003622%	638516	97.23%	17	6.88%
峽	2035		10	24	0.003622%	638540	97.24%	17	6.88%
紗	2051		10	24	0.003622%	638564	97.30%	17	6.88%
韻	2065		19	24	0.003622%	638588	97.35%	17	6.88%
愉	2072		12	23	0.003471%	638611	97.38%	17	6.88%
脹	2083		12	23	0.003471%	638634	97.42%	17	6.88%
寡	2090		14	22	0.00332%	638656	97.44%	17	6.88%
庸	2092		11	22	0.00332%	638678	97.45%	17	6.88%
旺	2097		8	22	0.00332%	638700	97.46%	17	6.88%
沾	2103		8	22	0.00332%	638722	97.48%	17	6.88%
廉	2127		13	21	0.003169%	638743	97.56%	17	6.88%
嘯	2156		15	20	0.003018%	638763	97.65%	17	6.88%
漆	2208		14	19	0.002867%	638782	97.81%	17	6.88%
遂	2226		12	19	0.002867%	638801	97.86%	17	6.88%
泊	2249		8	18	0.002716%	638819	97.92%	17	6.88%
煌	2254		13	18	0.002716%	638837	97.93%	17	6.88%
芒	2258		7	18	0.002716%	638855	97.94%	17	6.88%
僑	1216		14	76	0.01147%	638931	91.71%	16	6.48%
葡	1294		13	69	0.01041%	639000	92.56%	16	6.48%
萄	1303		12	68	0.01026%	639068	92.65%	16	6.48%
昆	1398		8	59	0.008903%	639127	93.56%	16	6.48%
棉	1408		12	58	0.008752%	639185	93.65%	16	6.48%
郎	1610		8	43	0.006489%	639228	95.16%	16	6.48%
晃	1670		10	39	0.005885%	639267	95.53%	16	6.48%
鑽	1816		27	33	0.00498%	639300	96.32%	16	6.48%
契	1891		9	29	0.004376%	639329	96.67%	16	6.48%
杜	1894		7	29	0.004376%	639358	96.68%	16	6.48%
殼	1948		12	27	0.004074%	639385	96.91%	16	6.48%
甩	1952		5	27	0.004074%	639412	96.92%	16	6.48%
籃	1954		20	27	0.004074%	639439	96.93%	16	6.48%
僵	1966		15	26	0.003923%	639465	96.98%	16	6.48%
巾	1975		3	26	0.003923%	639491	97.02%	16	6.48%
拆	1978		8	26	0.003923%	639517	97.03%	16	6.48%
醜	1997		17	26	0.003923%	639543	97.10%	16	6.48%
乳	2000		8	25	0.003772%	639568	97.11%	16	6.48%
哼	2003		10	25	0.003772%	639593	97.12%	16	6.48%
筒	2016		12	25	0.003772%	639618	97.17%	16	6.48%
縷	2017		17	25	0.003772%	639643	97.18%	16	6.48%
盒	2048		11	24	0.003622%	639667	97.29%	16	6.48%
笨	2050		11	24	0.003622%	639691	97.30%	16	6.48%
賢	2061		15	24	0.003622%	639715	97.34%	16	6.48%
闖	2064		18	24	0.003622%	639739	97.35%	16	6.48%
丘	2067		5	23	0.003471%	639762	97.36%	16	6.48%
茂	2084		9	23	0.003471%	639785	97.42%	16	6.48%
蹤	2085		18	23	0.003471%	639808	97.42%	16	6.48%
憾	2094		16	22	0.00332%	639830	97.45%	16	6.48%
翅	2113		10	22	0.00332%	639852	97.52%	16	6.48%
蓬	2115		15	22	0.00332%	639874	97.52%	16	6.48%
喻	2124		12	21	0.003169%	639895	97.55%	16	6.48%
役	2130		7	21	0.003169%	639916	97.57%	16	6.48%
洒	2134		9	21	0.003169%	639937	97.58%	16	6.48%
膝	2139		15	21	0.003169%	639958	97.60%	16	6.48%
蘊	2142		20	21	0.003169%	639979	97.61%	16	6.48%
魅	2148		15	21	0.003169%	640000	97.63%	16	6.48%
棚	2162		12	20	0.003018%	640020	97.67%	16	6.48%
豈	2177		10	20	0.003018%	640040	97.72%	16	6.48%
寸	2194		3	19	0.002867%	640059	97.77%	16	6.48%
峻	2196		10	19	0.002867%	640078	97.77%	16	6.48%
敘	2201		11	19	0.002867%	640097	97.79%	16	6.48%
朽	2203		6	19	0.002867%	640116	97.79%	16	6.48%
瞪	2212		17	19	0.002867%	640135	97.82%	16	6.48%
饑	2228		20	19	0.002867%	640154	97.86%	16	6.48%
嫌	2236		13	18	0.002716%	640172	97.88%	16	6.48%
暈	2245		13	18	0.002716%	640190	97.91%	16	6.48%
柏	2247		9	18	0.002716%	640208	97.91%	16	6.48%
跌	2265		12	18	0.002716%	640226	97.96%	16	6.48%
淹	2298		11	17	0.002565%	640243	98.05%	16	6.48%
謙	2312		17	17	0.002565%	640260	98.08%	16	6.48%
躁	2314		20	17	0.002565%	640277	98.09%	16	6.48%
驟	2366		24	16	0.002414%	640293	98.22%	16	6.48%
儒	967		16	109	0.01645%	640402	88.24%	15	6.07%
墓	1224		14	75	0.01132%	640477	91.80%	15	6.07%
亭	1339		9	64	0.009657%	640541	93.01%	15	6.07%
帳	1405		11	58	0.008752%	640599	93.63%	15	6.07%
澡	1420		16	57	0.008601%	640656	93.76%	15	6.07%
范	1555		9	46	0.006941%	640702	94.80%	15	6.07%
韓	1645		17	41	0.006187%	640743	95.38%	15	6.07%
偽	1666		11	39	0.005885%	640782	95.51%	15	6.07%
僚	1788		14	33	0.00498%	640815	96.18%	15	6.07%
儲	1789		17	33	0.00498%	640848	96.18%	15	6.07%
柳	1803		9	33	0.00498%	640881	96.25%	15	6.07%
桂	1823		10	32	0.004829%	640913	96.35%	15	6.07%
澳	1858		16	31	0.004678%	640944	96.52%	15	6.07%
桃	1895		10	29	0.004376%	640973	96.68%	15	6.07%
鞏	1908		15	29	0.004376%	641002	96.74%	15	6.07%
咕	1940		8	27	0.004074%	641029	96.87%	15	6.07%
衫	1957		8	27	0.004074%	641056	96.94%	15	6.07%
瞧	1990		17	26	0.003923%	641082	97.07%	15	6.07%
冊	2028		5	24	0.003622%	641106	97.22%	15	6.07%
挽	2038		10	24	0.003622%	641130	97.26%	15	6.07%
猜	2046		11	24	0.003622%	641154	97.28%	15	6.07%
蹄	2062		16	24	0.003622%	641178	97.34%	15	6.07%
帆	2091		6	22	0.00332%	641200	97.44%	15	6.07%
杆	2099		7	22	0.00332%	641222	97.47%	15	6.07%
毅	2102		15	22	0.00332%	641244	97.48%	15	6.07%
眠	2109		10	22	0.00332%	641266	97.50%	15	6.07%
膩	2114		16	22	0.00332%	641288	97.52%	15	6.07%
鵝	2121		18	22	0.00332%	641310	97.54%	15	6.07%
廟	2128		15	21	0.003169%	641331	97.56%	15	6.07%
懮	2131		18	21	0.003169%	641352	97.57%	15	6.07%
芳	2140		8	21	0.003169%	641373	97.60%	15	6.07%
鈴	2146		13	21	0.003169%	641394	97.62%	15	6.07%
淒	2163		11	20	0.003018%	641414	97.67%	15	6.07%
燕	2168		16	20	0.003018%	641434	97.69%	15	6.07%
翠	2174		14	20	0.003018%	641454	97.71%	15	6.07%
膨	2175		16	20	0.003018%	641474	97.71%	15	6.07%
催	2187		13	19	0.002867%	641493	97.75%	15	6.07%
撰	2243		15	18	0.002716%	641511	97.90%	15	6.07%
糕	2256		16	18	0.002716%	641529	97.94%	15	6.07%
豎	2263		15	18	0.002716%	641547	97.96%	15	6.07%
贈	2264		19	18	0.002716%	641565	97.96%	15	6.07%
挨	2283		10	17	0.002565%	641582	98.01%	15	6.07%
掀	2284		11	17	0.002565%	641599	98.01%	15	6.07%
搜	2285		12	17	0.002565%	641616	98.02%	15	6.07%
暑	2290		12	17	0.002565%	641633	98.03%	15	6.07%
蠻	2310		25	17	0.002565%	641650	98.08%	15	6.07%
覓	2311		11	17	0.002565%	641667	98.08%	15	6.07%
饒	2316		20	17	0.002565%	641684	98.10%	15	6.07%
僻	2320		15	16	0.002414%	641700	98.11%	15	6.07%
挫	2341		10	16	0.002414%	641716	98.16%	15	6.07%
棍	2343		12	16	0.002414%	641732	98.16%	15	6.07%
歇	2344		13	16	0.002414%	641748	98.16%	15	6.07%
囑	2376		24	15	0.002263%	641763	98.24%	15	6.07%
栽	2396		10	15	0.002263%	641778	98.28%	15	6.07%
壤	759		20	164	0.02475%	641942	84.01%	14	5.67%
叔	850		8	136	0.02052%	642078	86.10%	14	5.67%
肺	1114		8	89	0.01343%	642167	90.45%	14	5.67%
徽	1458		17	53	0.007998%	642220	94.07%	14	5.67%
鍛	1504		17	50	0.007545%	642270	94.43%	14	5.67%
鳳	1584		14	44	0.00664%	642314	94.99%	14	5.67%
肌	1606		6	43	0.006489%	642357	95.13%	14	5.67%
瑞	1673		13	39	0.005885%	642396	95.55%	14	5.67%
杰	1755		8	35	0.005281%	642431	96.01%	14	5.67%
檔	1804		17	33	0.00498%	642464	96.26%	14	5.67%
脂	1900		10	29	0.004376%	642493	96.71%	14	5.67%
笛	1953		11	27	0.004074%	642520	96.93%	14	5.67%
郵	1961		11	27	0.004074%	642547	96.96%	14	5.67%
溶	1986		13	26	0.003923%	642573	97.06%	14	5.67%
聘	2054		13	24	0.003622%	642597	97.31%	14	5.67%
押	2073		8	23	0.003471%	642620	97.38%	14	5.67%
敦	2096		12	22	0.00332%	642642	97.46%	14	5.67%
濁	2105		16	22	0.00332%	642664	97.49%	14	5.67%
罕	2111		7	22	0.00332%	642686	97.51%	14	5.67%
崗	2159		11	20	0.003018%	642706	97.66%	14	5.67%
株	2161		10	20	0.003018%	642726	97.67%	14	5.67%
狼	2169		10	20	0.003018%	642746	97.69%	14	5.67%
賀	2178		12	20	0.003018%	642766	97.72%	14	5.67%
頸	2183		16	20	0.003018%	642786	97.73%	14	5.67%
嶄	2197		14	19	0.002867%	642805	97.77%	14	5.67%
竊	2214		23	19	0.002867%	642824	97.82%	14	5.67%
咽	2232		9	18	0.002716%	642842	97.87%	14	5.67%
宙	2237		8	18	0.002716%	642860	97.89%	14	5.67%
愧	2239		13	18	0.002716%	642878	97.89%	14	5.67%
拒	2241		8	18	0.002716%	642896	97.90%	14	5.67%
瀟	2252		19	18	0.002716%	642914	97.93%	14	5.67%
矚	2255		26	18	0.002716%	642932	97.94%	14	5.67%
蜜	2260		14	18	0.002716%	642950	97.95%	14	5.67%
邪	2266		6	18	0.002716%	642968	97.97%	14	5.67%
陌	2268		8	18	0.002716%	642986	97.97%	14	5.67%
鷹	2270		24	18	0.002716%	643004	97.98%	14	5.67%
麵	2271		20	18	0.002716%	643022	97.98%	14	5.67%
奠	2275		12	17	0.002565%	643039	97.99%	14	5.67%
屏	2279		9	17	0.002565%	643056	98.00%	14	5.67%
晴	2289		12	17	0.002565%	643073	98.03%	14	5.67%
曼	2291		11	17	0.002565%	643090	98.03%	14	5.67%
竭	2305		14	17	0.002565%	643107	98.07%	14	5.67%
絮	2307		12	17	0.002565%	643124	98.07%	14	5.67%
騙	2317		19	17	0.002565%	643141	98.10%	14	5.67%
傑	2319		12	16	0.002414%	643157	98.10%	14	5.67%
卓	2323		8	16	0.002414%	643173	98.11%	14	5.67%
坷	2328		8	16	0.002414%	643189	98.12%	14	5.67%
崖	2336		11	16	0.002414%	643205	98.14%	14	5.67%
懼	2339		21	16	0.002414%	643221	98.15%	14	5.67%
澆	2346		15	16	0.002414%	643237	98.17%	14	5.67%
睹	2349		13	16	0.002414%	643253	98.18%	14	5.67%
茅	2353		9	16	0.002414%	643269	98.18%	14	5.67%
餓	2363		15	16	0.002414%	643285	98.21%	14	5.67%
驕	2365		22	16	0.002414%	643301	98.21%	14	5.67%
咒	2372		8	15	0.002263%	643316	98.23%	14	5.67%
妨	2382		7	15	0.002263%	643331	98.25%	14	5.67%
巡	2386		7	15	0.002263%	643346	98.26%	14	5.67%
懶	2388		19	15	0.002263%	643361	98.27%	14	5.67%
撕	2392		15	15	0.002263%	643376	98.28%	14	5.67%
胎	2412		9	15	0.002263%	643391	98.32%	14	5.67%
豫	2417		16	15	0.002263%	643406	98.33%	14	5.67%
貪	2418		11	15	0.002263%	643421	98.33%	14	5.67%
于	1014		3	103	0.01554%	643524	89.00%	13	5.26%
券	1234		8	74	0.01117%	643598	91.92%	13	5.26%
秦	1513		10	49	0.007394%	643647	94.50%	13	5.26%
膜	1721		15	37	0.005583%	643684	95.82%	13	5.26%
淮	1774		11	34	0.005131%	643718	96.10%	13	5.26%
晉	1801		10	33	0.00498%	643751	96.24%	13	5.26%
苗	1881		9	30	0.004527%	643781	96.62%	13	5.26%
綱	1955		14	27	0.004074%	643808	96.94%	13	5.26%
寓	1972		12	26	0.003923%	643834	97.00%	13	5.26%
樑	2101		15	22	0.00332%	643856	97.48%	13	5.26%
疆	2107		19	22	0.00332%	643878	97.50%	13	5.26%
禿	2110		7	22	0.00332%	643900	97.51%	13	5.26%
署	2112		13	22	0.00332%	643922	97.51%	13	5.26%
拳	2132		10	21	0.003169%	643943	97.58%	13	5.26%
梯	2133		11	21	0.003169%	643964	97.58%	13	5.26%
獸	2135		19	21	0.003169%	643985	97.59%	13	5.26%
逆	2145		9	21	0.003169%	644006	97.62%	13	5.26%
灑	2167		22	20	0.003018%	644026	97.69%	13	5.26%
玫	2170		8	20	0.003018%	644046	97.69%	13	5.26%
赫	2179		14	20	0.003018%	644066	97.72%	13	5.26%
屍	2195		9	19	0.002867%	644085	97.77%	13	5.26%
拐	2199		8	19	0.002867%	644104	97.78%	13	5.26%
櫥	2206		19	19	0.002867%	644123	97.80%	13	5.26%
獄	2210		14	19	0.002867%	644142	97.81%	13	5.26%
痴	2211		13	19	0.002867%	644161	97.81%	13	5.26%
藤	2220		19	19	0.002867%	644180	97.84%	13	5.26%
貓	2225		16	19	0.002867%	644199	97.85%	13	5.26%
陡	2227		9	19	0.002867%	644218	97.86%	13	5.26%
凍	2230		10	18	0.002716%	644236	97.87%	13	5.26%
啞	2233		11	18	0.002716%	644254	97.88%	13	5.26%
攔	2244		20	18	0.002716%	644272	97.91%	13	5.26%
朦	2246		18	18	0.002716%	644290	97.91%	13	5.26%
奸	2276		6	17	0.002565%	644307	97.99%	13	5.26%
嬰	2278		17	17	0.002565%	644324	98.00%	13	5.26%
欺	2295		12	17	0.002565%	644341	98.04%	13	5.26%
芽	2308		8	17	0.002565%	644358	98.07%	13	5.26%
賺	2313		17	17	0.002565%	644375	98.09%	13	5.26%
閨	2315		14	17	0.002565%	644392	98.09%	13	5.26%
劫	2322		7	16	0.002414%	644408	98.11%	13	5.26%
宅	2332		6	16	0.002414%	644424	98.13%	13	5.26%
弊	2338		14	16	0.002414%	644440	98.15%	13	5.26%
燥	2347		17	16	0.002414%	644456	98.17%	13	5.26%
鬍	2367		19	16	0.002414%	644472	98.22%	13	5.26%
婉	2383		11	15	0.002263%	644487	98.25%	13	5.26%
崩	2385		11	15	0.002263%	644502	98.26%	13	5.26%
拘	2389		8	15	0.002263%	644517	98.27%	13	5.26%
捨	2391		11	15	0.002263%	644532	98.27%	13	5.26%
涯	2399		11	15	0.002263%	644547	98.29%	13	5.26%
滯	2401		14	15	0.002263%	644562	98.30%	13	5.26%
漿	2402		15	15	0.002263%	644577	98.30%	13	5.26%
澀	2404		17	15	0.002263%	644592	98.30%	13	5.26%
絨	2409		12	15	0.002263%	644607	98.31%	13	5.26%
踩	2419		15	15	0.002263%	644622	98.34%	13	5.26%
逗	2422		10	15	0.002263%	644637	98.34%	13	5.26%
倦	2430		10	14	0.002113%	644651	98.36%	13	5.26%
倚	2431		10	14	0.002113%	644665	98.36%	13	5.26%
勉	2432		9	14	0.002113%	644679	98.36%	13	5.26%
奈	2437		8	14	0.002113%	644693	98.38%	13	5.26%
惹	2446		13	14	0.002113%	644707	98.39%	13	5.26%
昧	2450		9	14	0.002113%	644721	98.40%	13	5.26%
瞎	2463		15	14	0.002113%	644735	98.43%	13	5.26%
砸	2464		10	14	0.002113%	644749	98.43%	13	5.26%
筋	2466		12	14	0.002113%	644763	98.44%	13	5.26%
妄	2499		6	13	0.001962%	644776	98.50%	13	5.26%
襲	2531		22	13	0.001962%	644789	98.57%	13	5.26%
陋	2538		8	13	0.001962%	644802	98.58%	13	5.26%
蓮	1111		15	90	0.01358%	644892	90.41%	12	4.86%
	1220		11	76	0.01147%	644968	91.76%	12	4.86%
萊	1249		12	73	0.01102%	645041	92.08%	12	4.86%
圳	1305		6	67	0.01011%	645108	92.67%	12	4.86%
穆	1464		16	53	0.007998%	645161	94.12%	12	4.86%
辟	1467		13	53	0.007998%	645214	94.14%	12	4.86%
姻	1569		9	44	0.00664%	645258	94.89%	12	4.86%
鴨	1763		16	35	0.005281%	645293	96.05%	12	4.86%
侯	1819		9	32	0.004829%	645325	96.33%	12	4.86%
栗	1824		10	32	0.004829%	645357	96.35%	12	4.86%
蒂	1834		13	32	0.004829%	645389	96.40%	12	4.86%
癌	1859		17	31	0.004678%	645420	96.52%	12	4.86%
炭	1876		9	30	0.004527%	645450	96.60%	12	4.86%
稻	1921		15	28	0.004225%	645478	96.80%	12	4.86%
凋	2029		10	24	0.003622%	645502	97.22%	12	4.86%
熊	2043		14	24	0.003622%	645526	97.27%	12	4.86%
盜	2049		12	24	0.003622%	645550	97.30%	12	4.86%
廈	2093		13	22	0.00332%	645572	97.45%	12	4.86%
郤	2118		9	22	0.00332%	645594	97.53%	12	4.86%
腫	2138		13	21	0.003169%	645615	97.60%	12	4.86%
啥	2153		11	20	0.003018%	645635	97.64%	12	4.86%
嚷	2191		20	19	0.002867%	645654	97.76%	12	4.86%
肢	2217		8	19	0.002867%	645673	97.83%	12	4.86%
諒	2223		15	19	0.002867%	645692	97.85%	12	4.86%
騷	2229		20	19	0.002867%	645711	97.87%	12	4.86%
垮	2234		9	18	0.002716%	645729	97.88%	12	4.86%
抄	2240		7	18	0.002716%	645747	97.90%	12	4.86%
捏	2242		10	18	0.002716%	645765	97.90%	12	4.86%
嚼	2274		20	17	0.002565%	645782	97.99%	12	4.86%
嬌	2277		15	17	0.002565%	645799	98.00%	12	4.86%
攪	2286		23	17	0.002565%	645816	98.02%	12	4.86%
灶	2300		7	17	0.002565%	645833	98.05%	12	4.86%
劍	2321		15	16	0.002414%	645849	98.11%	12	4.86%
堵	2329		11	16	0.002414%	645865	98.13%	12	4.86%
尿	2333		7	16	0.002414%	645881	98.14%	12	4.86%
屑	2334		10	16	0.002414%	645897	98.14%	12	4.86%
扛	2340		6	16	0.002414%	645913	98.15%	12	4.86%
砂	2351		9	16	0.002414%	645929	98.18%	12	4.86%
逾	2360		12	16	0.002414%	645945	98.20%	12	4.86%
駝	2364		15	16	0.002414%	645961	98.21%	12	4.86%
俯	2368		10	15	0.002263%	645976	98.22%	12	4.86%
塘	2380		13	15	0.002263%	645991	98.25%	12	4.86%
擱	2393		17	15	0.002263%	646006	98.28%	12	4.86%
曠	2394		19	15	0.002263%	646021	98.28%	12	4.86%
淪	2400		11	15	0.002263%	646036	98.29%	12	4.86%
澄	2403		15	15	0.002263%	646051	98.30%	12	4.86%
畔	2407		10	15	0.002263%	646066	98.31%	12	4.86%
稚	2408		13	15	0.002263%	646081	98.31%	12	4.86%
膊	2413		14	15	0.002263%	646096	98.32%	12	4.86%
銜	2425		14	15	0.002263%	646111	98.35%	12	4.86%
佩	2428		8	14	0.002113%	646125	98.36%	12	4.86%
俊	2429		9	14	0.002113%	646139	98.36%	12	4.86%
囂	2435		21	14	0.002113%	646153	98.37%	12	4.86%
墊	2436		14	14	0.002113%	646167	98.37%	12	4.86%
拂	2448		8	14	0.002113%	646181	98.40%	12	4.86%
朧	2451		20	14	0.002113%	646195	98.41%	12	4.86%
沸	2455		8	14	0.002113%	646209	98.41%	12	4.86%
滄	2457		13	14	0.002113%	646223	98.42%	12	4.86%
煞	2458		13	14	0.002113%	646237	98.42%	12	4.86%
琢	2459		12	14	0.002113%	646251	98.42%	12	4.86%
瑰	2460		14	14	0.002113%	646265	98.42%	12	4.86%
迴	2478		9	14	0.002113%	646279	98.46%	12	4.86%
邦	2480		6	14	0.002113%	646293	98.47%	12	4.86%
鑄	2481		22	14	0.002113%	646307	98.47%	12	4.86%
韌	2483		12	14	0.002113%	646321	98.47%	12	4.86%
傍	2487		12	13	0.001962%	646334	98.48%	12	4.86%
卑	2489		8	13	0.001962%	646347	98.48%	12	4.86%
叨	2491		5	13	0.001962%	646360	98.49%	12	4.86%
擬	2509		17	13	0.001962%	646373	98.52%	12	4.86%
濺	2517		18	13	0.001962%	646386	98.54%	12	4.86%
粹	2524		14	13	0.001962%	646399	98.55%	12	4.86%
軀	2535		18	13	0.001962%	646412	98.57%	12	4.86%
頒	2540		13	13	0.001962%	646425	98.58%	12	4.86%
掠	2573		11	12	0.001811%	646437	98.65%	12	4.86%
捷	2574		11	12	0.001811%	646449	98.65%	12	4.86%
撓	2576		15	12	0.001811%	646461	98.65%	12	4.86%
瑣	2586		14	12	0.001811%	646473	98.67%	12	4.86%
瓣	2587		19	12	0.001811%	646485	98.67%	12	4.86%
逸	2604		11	12	0.001811%	646497	98.70%	12	4.86%
沐	1334		7	65	0.009808%	646562	92.96%	11	4.45%
菌	1453		12	54	0.008148%	646616	94.03%	11	4.45%
轄	1466		17	53	0.007998%	646669	94.14%	11	4.45%
遜	1565		13	45	0.00679%	646714	94.87%	11	4.45%
奴	1590		5	43	0.006489%	646757	95.03%	11	4.45%
寺	1765		6	34	0.005131%	646791	96.06%	11	4.45%
妝	1843		7	31	0.004678%	646822	96.45%	11	4.45%
嘻	1942		15	27	0.004074%	646849	96.88%	11	4.45%
巷	1974		9	26	0.003923%	646875	97.01%	11	4.45%
嶺	2007		17	25	0.003772%	646900	97.14%	11	4.45%
芝	2021		8	25	0.003772%	646925	97.19%	11	4.45%
嗒	2125		13	21	0.003169%	646946	97.56%	11	4.45%
販	2143		11	21	0.003169%	646967	97.61%	11	4.45%
傅	2150		12	20	0.003018%	646987	97.63%	11	4.45%
嘩	2155		15	20	0.003018%	647007	97.65%	11	4.45%
倉	2186		10	19	0.002867%	647026	97.74%	11	4.45%
咖	2188		8	19	0.002867%	647045	97.75%	11	4.45%
啡	2189		11	19	0.002867%	647064	97.75%	11	4.45%
蔓	2219		15	19	0.002867%	647083	97.84%	11	4.45%
幢	2238		15	18	0.002716%	647101	97.89%	11	4.45%
汪	2248		7	18	0.002716%	647119	97.92%	11	4.45%
駱	2269		16	18	0.002716%	647137	97.97%	11	4.45%
帘	2280		8	17	0.002565%	647154	98.00%	11	4.45%
桶	2293		11	17	0.002565%	647171	98.04%	11	4.45%
泣	2297		8	17	0.002565%	647188	98.05%	11	4.45%
穎	2304		16	17	0.002565%	647205	98.06%	11	4.45%
蒸	2309		14	17	0.002565%	647222	98.08%	11	4.45%
咧	2325		9	16	0.002414%	647238	98.12%	11	4.45%
嬴	2331		16	16	0.002414%	647254	98.13%	11	4.45%
劈	2369		15	15	0.002263%	647269	98.22%	11	4.45%
吁	2371		6	15	0.002263%	647284	98.23%	11	4.45%
坊	2377		7	15	0.002263%	647299	98.24%	11	4.45%
憎	2387		15	15	0.002263%	647314	98.26%	11	4.45%
蹲	2421		19	15	0.002263%	647329	98.34%	11	4.45%
哉	2433		9	14	0.002113%	647343	98.37%	11	4.45%
忌	2442		7	14	0.002113%	647357	98.39%	11	4.45%
恍	2443		9	14	0.002113%	647371	98.39%	11	4.45%
恭	2444		10	14	0.002113%	647385	98.39%	11	4.45%
捲	2449		11	14	0.002113%	647399	98.40%	11	4.45%
枚	2452		8	14	0.002113%	647413	98.41%	11	4.45%
盞	2462		13	14	0.002113%	647427	98.43%	11	4.45%
綴	2468		14	14	0.002113%	647441	98.44%	11	4.45%
綢	2469		14	14	0.002113%	647455	98.44%	11	4.45%
蜂	2474		13	14	0.002113%	647469	98.45%	11	4.45%
吟	2493		7	13	0.001962%	647482	98.49%	11	4.45%
啼	2495		12	13	0.001962%	647495	98.50%	11	4.45%
寨	2500		14	13	0.001962%	647508	98.51%	11	4.45%
廚	2503		15	13	0.001962%	647521	98.51%	11	4.45%
悵	2505		11	13	0.001962%	647534	98.52%	11	4.45%
揉	2507		12	13	0.001962%	647547	98.52%	11	4.45%
撐	2508		15	13	0.001962%	647560	98.52%	11	4.45%
訝	2532		11	13	0.001962%	647573	98.57%	11	4.45%
謹	2533		18	13	0.001962%	647586	98.57%	11	4.45%
闢	2537		21	13	0.001962%	647599	98.58%	11	4.45%
駁	2542		14	13	0.001962%	647612	98.59%	11	4.45%
鬱	2543		29	13	0.001962%	647625	98.59%	11	4.45%
龐	2545		19	13	0.001962%	647638	98.59%	11	4.45%
仗	2546		5	12	0.001811%	647650	98.60%	11	4.45%
凌	2548		10	12	0.001811%	647662	98.60%	11	4.45%
匙	2552		11	12	0.001811%	647674	98.61%	11	4.45%
嚨	2559		20	12	0.001811%	647686	98.62%	11	4.45%
宵	2563		10	12	0.001811%	647698	98.63%	11	4.45%
懲	2569		19	12	0.001811%	647710	98.64%	11	4.45%
捂	2572		10	12	0.001811%	647722	98.64%	11	4.45%
揣	2575		12	12	0.001811%	647734	98.65%	11	4.45%
殿	2580		13	12	0.001811%	647746	98.66%	11	4.45%
煮	2585		12	12	0.001811%	647758	98.67%	11	4.45%
碩	2591		14	12	0.001811%	647770	98.68%	11	4.45%
裳	2599		14	12	0.001811%	647782	98.69%	11	4.45%
趁	2601		12	12	0.001811%	647794	98.70%	11	4.45%
跪	2602		13	12	0.001811%	647806	98.70%	11	4.45%
駕	2607		15	12	0.001811%	647818	98.71%	11	4.45%
尬	2624		7	11	0.00166%	647829	98.74%	11	4.45%
尷	2625		17	11	0.00166%	647840	98.74%	11	4.45%
昔	2636		8	11	0.00166%	647851	98.75%	11	4.45%
迄	2677		6	11	0.00166%	647862	98.82%	11	4.45%
疇	979		19	108	0.0163%	647970	88.44%	10	4.05%
夷	1117		6	88	0.01328%	648058	90.49%	10	4.05%
嘉	1135		14	85	0.01283%	648143	90.73%	10	4.05%
梨	1144		11	84	0.01268%	648227	90.84%	10	4.05%
仲	1328		6	65	0.009808%	648292	92.91%	10	4.05%
祭	1463		11	53	0.007998%	648345	94.11%	10	4.05%
喬	1589		12	43	0.006489%	648388	95.02%	10	4.05%
賠	1665		15	40	0.006036%	648428	95.50%	10	4.05%
曹	1733		11	36	0.005432%	648464	95.89%	10	4.05%
諷	1742		16	36	0.005432%	648500	95.94%	10	4.05%
驢	1964		26	27	0.004074%	648527	96.97%	10	4.05%
凹	2001		5	25	0.003772%	648552	97.12%	10	4.05%
肖	2055		7	24	0.003622%	648576	97.32%	10	4.05%
蔥	2058		15	24	0.003622%	648600	97.33%	10	4.05%
后	2068		6	23	0.003471%	648623	97.36%	10	4.05%
廂	2070		12	23	0.003471%	648646	97.37%	10	4.05%
咳	2151		9	20	0.003018%	648666	97.64%	10	4.05%
塌	2157		13	20	0.003018%	648686	97.66%	10	4.05%
憲	2160		16	20	0.003018%	648706	97.66%	10	4.05%
濛	2166		17	20	0.003018%	648726	97.68%	10	4.05%
宴	2193		10	19	0.002867%	648745	97.76%	10	4.05%
杉	2204		7	19	0.002867%	648764	97.79%	10	4.05%
哇	2231		9	18	0.002716%	648782	97.87%	10	4.05%
炒	2253		8	18	0.002716%	648800	97.93%	10	4.05%
諾	2262		16	18	0.002716%	648818	97.96%	10	4.05%
嗚	2273		13	17	0.002565%	648835	97.98%	10	4.05%
毯	2296		12	17	0.002565%	648852	98.04%	10	4.05%
紐	2306		10	17	0.002565%	648869	98.07%	10	4.05%
墾	2330		16	16	0.002414%	648885	98.13%	10	4.05%
芬	2352		8	16	0.002414%	648901	98.18%	10	4.05%
蹦	2358		18	16	0.002414%	648917	98.20%	10	4.05%
釀	2361		24	16	0.002414%	648933	98.20%	10	4.05%
堡	2379		12	15	0.002263%	648948	98.25%	10	4.05%
拎	2390		8	15	0.002263%	648963	98.27%	10	4.05%
杏	2395		7	15	0.002263%	648978	98.28%	10	4.05%
烘	2406		10	15	0.002263%	648993	98.31%	10	4.05%
羞	2410		11	15	0.002263%	649008	98.32%	10	4.05%
哩	2434		10	14	0.002113%	649022	98.37%	10	4.05%
胖	2471		9	14	0.002113%	649036	98.45%	10	4.05%
凸	2488		5	13	0.001962%	649049	98.48%	10	4.05%
徊	2504		9	13	0.001962%	649062	98.51%	10	4.05%
揀	2506		12	13	0.001962%	649075	98.52%	10	4.05%
曰	2511		4	13	0.001962%	649088	98.53%	10	4.05%
沼	2514		8	13	0.001962%	649101	98.53%	10	4.05%
洶	2515		9	13	0.001962%	649114	98.54%	10	4.05%
胳	2526		10	13	0.001962%	649127	98.56%	10	4.05%
臘	2528		19	13	0.001962%	649140	98.56%	10	4.05%
趴	2534		9	13	0.001962%	649153	98.57%	10	4.05%
輿	2536		17	13	0.001962%	649166	98.58%	10	4.05%
頃	2539		11	13	0.001962%	649179	98.58%	10	4.05%
凶	2550		4	12	0.001811%	649191	98.60%	10	4.05%
吶	2553		7	12	0.001811%	649203	98.61%	10	4.05%
垃	2560		8	12	0.001811%	649215	98.62%	10	4.05%
履	2564		15	12	0.001811%	649227	98.63%	10	4.05%
戈	2570		4	12	0.001811%	649239	98.64%	10	4.05%
扒	2571		5	12	0.001811%	649251	98.64%	10	4.05%
禽	2592		13	12	0.001811%	649263	98.68%	10	4.05%
賭	2600		15	12	0.001811%	649275	98.69%	10	4.05%
乞	2608		3	11	0.00166%	649286	98.71%	10	4.05%
剔	2613		10	11	0.00166%	649297	98.72%	10	4.05%
吼	2614		7	11	0.00166%	649308	98.72%	10	4.05%
囊	2617		22	11	0.00166%	649319	98.72%	10	4.05%
捆	2631		10	11	0.00166%	649330	98.75%	10	4.05%
敝	2635		11	11	0.00166%	649341	98.75%	10	4.05%
淌	2646		11	11	0.00166%	649352	98.77%	10	4.05%
燙	2653		16	11	0.00166%	649363	98.78%	10	4.05%
竄	2662		18	11	0.00166%	649374	98.80%	10	4.05%
萎	2665		12	11	0.00166%	649385	98.80%	10	4.05%
蔽	2666		15	11	0.00166%	649396	98.80%	10	4.05%
藉	2668		18	11	0.00166%	649407	98.81%	10	4.05%
誓	2671		14	11	0.00166%	649418	98.81%	10	4.05%
贏	2675		20	11	0.00166%	649429	98.82%	10	4.05%
酬	2680		13	11	0.00166%	649440	98.83%	10	4.05%
驀	2683		21	11	0.00166%	649451	98.83%	10	4.05%
崛	2699		11	10	0.001509%	649461	98.86%	10	4.05%
攜	2709		21	10	0.001509%	649471	98.87%	10	4.05%
旳	2711		7	10	0.001509%	649481	98.88%	10	4.05%
檐	2715		17	10	0.001509%	649491	98.88%	10	4.05%
淵	2716		11	10	0.001509%	649501	98.88%	10	4.05%
渺	2717		12	10	0.001509%	649511	98.88%	10	4.05%
眶	2723		11	10	0.001509%	649521	98.89%	10	4.05%
絢	2730		12	10	0.001509%	649531	98.90%	10	4.05%
郭	2747		10	10	0.001509%	649541	98.93%	10	4.05%
陵	2751		10	10	0.001509%	649551	98.94%	10	4.05%
蝕	1379		14	61	0.009205%	649612	93.39%	9	3.64%
爹	1410		10	58	0.008752%	649670	93.67%	9	3.64%
泳	1443		8	55	0.008299%	649725	93.95%	9	3.64%
娃	1650		9	40	0.006036%	649765	95.41%	9	3.64%
址	1727		7	36	0.005432%	649801	95.86%	9	3.64%
氧	1805		10	33	0.00498%	649834	96.26%	9	3.64%
墳	1842		15	31	0.004678%	649865	96.44%	9	3.64%
霜	1885		17	30	0.004527%	649895	96.64%	9	3.64%
霉	1907		15	29	0.004376%	649924	96.74%	9	3.64%
萍	1924		12	28	0.004225%	649952	96.81%	9	3.64%
搓	1947		13	27	0.004074%	649979	96.90%	9	3.64%
椒	1983		12	26	0.003923%	650005	97.05%	9	3.64%
誇	2025		13	25	0.003772%	650030	97.21%	9	3.64%
鏈	2087		19	23	0.003471%	650053	97.43%	9	3.64%
僧	2088		14	22	0.00332%	650075	97.43%	9	3.64%
蘿	2116		23	22	0.00332%	650097	97.53%	9	3.64%
缸	2137		9	21	0.003169%	650118	97.59%	9	3.64%
啪	2152		11	20	0.003018%	650138	97.64%	9	3.64%
拴	2200		9	19	0.002867%	650157	97.78%	9	3.64%
腑	2218		12	19	0.002867%	650176	97.83%	9	3.64%
滔	2251		13	18	0.002716%	650194	97.93%	9	3.64%
螞	2261		16	18	0.002716%	650212	97.95%	9	3.64%
晒	2288		10	17	0.002565%	650229	98.02%	9	3.64%
溜	2299		13	17	0.002565%	650246	98.05%	9	3.64%
盧	2302		16	17	0.002565%	650263	98.06%	9	3.64%
吻	2324		7	16	0.002414%	650279	98.11%	9	3.64%
帕	2337		8	16	0.002414%	650295	98.15%	9	3.64%
蝶	2356		15	16	0.002414%	650311	98.19%	9	3.64%
卵	2370		7	15	0.002263%	650326	98.23%	9	3.64%
噹	2374		16	15	0.002263%	650341	98.23%	9	3.64%
堤	2378		12	15	0.002263%	650356	98.24%	9	3.64%
墩	2381		15	15	0.002263%	650371	98.25%	9	3.64%
棋	2397		12	15	0.002263%	650386	98.29%	9	3.64%
襯	2416		21	15	0.002263%	650401	98.33%	9	3.64%
餅	2426		14	15	0.002263%	650416	98.35%	9	3.64%
悼	2445		11	14	0.002113%	650430	98.39%	9	3.64%
戒	2447		7	14	0.002113%	650444	98.40%	9	3.64%
沌	2454		7	14	0.002113%	650458	98.41%	9	3.64%
閣	2482		14	14	0.002113%	650472	98.47%	9	3.64%
占	2490		5	13	0.001962%	650485	98.49%	9	3.64%
吭	2492		7	13	0.001962%	650498	98.49%	9	3.64%
暮	2510		15	13	0.001962%	650511	98.53%	9	3.64%
炊	2518		8	13	0.001962%	650524	98.54%	9	3.64%
饋	2541		20	13	0.001962%	650537	98.59%	9	3.64%
凜	2549		15	12	0.001811%	650549	98.60%	9	3.64%
剎	2551		9	12	0.001811%	650561	98.61%	9	3.64%
啤	2554		11	12	0.001811%	650573	98.61%	9	3.64%
媒	2562		12	12	0.001811%	650585	98.63%	9	3.64%
怖	2567		8	12	0.001811%	650597	98.63%	9	3.64%
澱	2584		16	12	0.001811%	650609	98.67%	9	3.64%
盟	2589		13	12	0.001811%	650621	98.67%	9	3.64%
矩	2590		10	12	0.001811%	650633	98.68%	9	3.64%
糞	2593		17	12	0.001811%	650645	98.68%	9	3.64%
翩	2595		15	12	0.001811%	650657	98.69%	9	3.64%
舅	2597		13	12	0.001811%	650669	98.69%	9	3.64%
踢	2603		15	12	0.001811%	650681	98.70%	9	3.64%
銘	2606		14	12	0.001811%	650693	98.70%	9	3.64%
兌	2610		7	11	0.00166%	650704	98.71%	9	3.64%
哨	2616		10	11	0.00166%	650715	98.72%	9	3.64%
圾	2618		7	11	0.00166%	650726	98.73%	9	3.64%
媚	2621		12	11	0.00166%	650737	98.73%	9	3.64%
媳	2622		13	11	0.00166%	650748	98.73%	9	3.64%
宛	2623		8	11	0.00166%	650759	98.73%	9	3.64%
屠	2626		11	11	0.00166%	650770	98.74%	9	3.64%
摟	2633		14	11	0.00166%	650781	98.75%	9	3.64%
摯	2634		15	11	0.00166%	650792	98.75%	9	3.64%
晝	2637		11	11	0.00166%	650803	98.76%	9	3.64%
枕	2638		8	11	0.00166%	650814	98.76%	9	3.64%
桔	2640		10	11	0.00166%	650825	98.76%	9	3.64%
棒	2641		12	11	0.00166%	650836	98.76%	9	3.64%
榨	2642		14	11	0.00166%	650847	98.76%	9	3.64%
沫	2644		8	11	0.00166%	650858	98.77%	9	3.64%
泄	2645		8	11	0.00166%	650869	98.77%	9	3.64%
漓	2648		14	11	0.00166%	650880	98.77%	9	3.64%
眺	2657		11	11	0.00166%	650891	98.79%	9	3.64%
苟	2664		9	11	0.00166%	650902	98.80%	9	3.64%
貶	2673		12	11	0.00166%	650913	98.82%	9	3.64%
軒	2676		10	11	0.00166%	650924	98.82%	9	3.64%
逛	2678		10	11	0.00166%	650935	98.82%	9	3.64%
墮	2695		15	10	0.001509%	650945	98.85%	9	3.64%
壘	2696		18	10	0.001509%	650955	98.85%	9	3.64%
幟	2701		15	10	0.001509%	650965	98.86%	9	3.64%
旬	2710		6	10	0.001509%	650975	98.87%	9	3.64%
獵	2720		18	10	0.001509%	650985	98.89%	9	3.64%
翔	2732		12	10	0.001509%	650995	98.91%	9	3.64%
耍	2733		9	10	0.001509%	651005	98.91%	9	3.64%
虔	2736		10	10	0.001509%	651015	98.91%	9	3.64%
趟	2745		15	10	0.001509%	651025	98.93%	9	3.64%
鄙	2748		13	10	0.001509%	651035	98.93%	9	3.64%
酣	2749		12	10	0.001509%	651045	98.93%	9	3.64%
隙	2752		13	10	0.001509%	651055	98.94%	9	3.64%
駐	2755		15	10	0.001509%	651065	98.94%	9	3.64%
咐	2765		8	9	0.001358%	651074	98.96%	9	3.64%
喲	2770		12	9	0.001358%	651083	98.96%	9	3.64%
寵	2776		19	9	0.001358%	651092	98.97%	9	3.64%
巢	2777		11	9	0.001358%	651101	98.97%	9	3.64%
廓	2779		14	9	0.001358%	651110	98.97%	9	3.64%
拙	2785		8	9	0.001358%	651119	98.98%	9	3.64%
挾	2786		10	9	0.001358%	651128	98.98%	9	3.64%
摧	2787		14	9	0.001358%	651137	98.99%	9	3.64%
撿	2788		16	9	0.001358%	651146	98.99%	9	3.64%
翹	2816		18	9	0.001358%	651155	99.02%	9	3.64%
荐	2818		10	9	0.001358%	651164	99.03%	9	3.64%
謬	2828		18	9	0.001358%	651173	99.04%	9	3.64%
鑰	2833		25	9	0.001358%	651182	99.05%	9	3.64%
陝	2834		9	9	0.001358%	651191	99.05%	9	3.64%
鶴	1537		21	48	0.007243%	651239	94.67%	8	3.24%
孟	1651		8	40	0.006036%	651279	95.42%	8	3.24%
蔣	1702		15	38	0.005734%	651317	95.72%	8	3.24%
蔬	1723		15	37	0.005583%	651354	95.83%	8	3.24%
緯	2052		15	24	0.003622%	651378	97.31%	8	3.24%
彭	2071		12	23	0.003471%	651401	97.37%	8	3.24%
淫	2077		11	23	0.003471%	651424	97.39%	8	3.24%
瑪	2106		14	22	0.00332%	651446	97.49%	8	3.24%
壺	2126		12	21	0.003169%	651467	97.56%	8	3.24%
磁	2172		14	20	0.003018%	651487	97.70%	8	3.24%
淘	2207		11	19	0.002867%	651506	97.80%	8	3.24%
爪	2209		4	19	0.002867%	651525	97.81%	8	3.24%
筷	2216		13	19	0.002867%	651544	97.83%	8	3.24%
艾	2257		6	18	0.002716%	651562	97.94%	8	3.24%
鄧	2267		14	18	0.002716%	651580	97.97%	8	3.24%
廷	2281		7	17	0.002565%	651597	98.01%	8	3.24%
斧	2287		8	17	0.002565%	651614	98.02%	8	3.24%
柯	2292		9	17	0.002565%	651631	98.03%	8	3.24%
鵬	2318		19	17	0.002565%	651648	98.10%	8	3.24%
梢	2342		11	16	0.002414%	651664	98.16%	8	3.24%
甸	2348		7	16	0.002414%	651680	98.17%	8	3.24%
虹	2355		9	16	0.002414%	651696	98.19%	8	3.24%
嘰	2373		15	15	0.002263%	651711	98.23%	8	3.24%
岭	2440		8	14	0.002113%	651725	98.38%	8	3.24%
綽	2467		14	14	0.002113%	651739	98.44%	8	3.24%
舟	2472		6	14	0.002113%	651753	98.45%	8	3.24%
葛	2473		13	14	0.002113%	651767	98.45%	8	3.24%
鼠	2485		13	14	0.002113%	651781	98.48%	8	3.24%
浙	2516		10	13	0.001962%	651794	98.54%	8	3.24%
聾	2525		22	13	0.001962%	651807	98.56%	8	3.24%
鼎	2544		13	13	0.001962%	651820	98.59%	8	3.24%
嗦	2556		13	12	0.001811%	651832	98.61%	8	3.24%
峭	2565		10	12	0.001811%	651844	98.63%	8	3.24%
恥	2568		10	12	0.001811%	651856	98.64%	8	3.24%
樞	2579		15	12	0.001811%	651868	98.66%	8	3.24%
洼	2581		9	12	0.001811%	651880	98.66%	8	3.24%
淑	2582		11	12	0.001811%	651892	98.66%	8	3.24%
癱	2588		24	12	0.001811%	651904	98.67%	8	3.24%
罐	2594		24	12	0.001811%	651916	98.68%	8	3.24%
兇	2609		6	11	0.00166%	651927	98.71%	8	3.24%
兔	2611		8	11	0.00166%	651938	98.71%	8	3.24%
兮	2612		4	11	0.00166%	651949	98.72%	8	3.24%
彰	2628		14	11	0.00166%	651960	98.74%	8	3.24%
徘	2629		11	11	0.00166%	651971	98.74%	8	3.24%
揪	2632		12	11	0.00166%	651982	98.75%	8	3.24%
柿	2639		9	11	0.00166%	651993	98.76%	8	3.24%
爍	2654		19	11	0.00166%	652004	98.78%	8	3.24%
瞥	2658		16	11	0.00166%	652015	98.79%	8	3.24%
矗	2659		24	11	0.00166%	652026	98.79%	8	3.24%
薦	2669		18	11	0.00166%	652037	98.81%	8	3.24%
蘆	2670		20	11	0.00166%	652048	98.81%	8	3.24%
謊	2672		17	11	0.00166%	652059	98.81%	8	3.24%
賊	2674		13	11	0.00166%	652070	98.82%	8	3.24%
霸	2681		21	11	0.00166%	652081	98.83%	8	3.24%
丫	2684		3	10	0.001509%	652091	98.83%	8	3.24%
傘	2685		12	10	0.001509%	652101	98.84%	8	3.24%
儉	2687		15	10	0.001509%	652111	98.84%	8	3.24%
唉	2693		10	10	0.001509%	652121	98.85%	8	3.24%
嫉	2697		13	10	0.001509%	652131	98.85%	8	3.24%
屢	2698		14	10	0.001509%	652141	98.86%	8	3.24%
梭	2713		11	10	0.001509%	652151	98.88%	8	3.24%
榜	2714		14	10	0.001509%	652161	98.88%	8	3.24%
熄	2719		14	10	0.001509%	652171	98.89%	8	3.24%
瑩	2721		15	10	0.001509%	652181	98.89%	8	3.24%
碌	2724		13	10	0.001509%	652191	98.89%	8	3.24%
窟	2727		13	10	0.001509%	652201	98.90%	8	3.24%
糙	2729		17	10	0.001509%	652211	98.90%	8	3.24%
繡	2731		18	10	0.001509%	652221	98.91%	8	3.24%
訣	2741		11	10	0.001509%	652231	98.92%	8	3.24%
謠	2743		17	10	0.001509%	652241	98.92%	8	3.24%
跋	2746		12	10	0.001509%	652251	98.93%	8	3.24%
兆	2760		6	9	0.001358%	652260	98.95%	8	3.24%
叩	2762		5	9	0.001358%	652269	98.95%	8	3.24%
嗯	2771		13	9	0.001358%	652278	98.96%	8	3.24%
恆	2781		9	9	0.001358%	652287	98.98%	8	3.24%
恬	2782		9	9	0.001358%	652296	98.98%	8	3.24%
憋	2783		15	9	0.001358%	652305	98.98%	8	3.24%
梳	2790		10	9	0.001358%	652314	98.99%	8	3.24%
癮	2804		22	9	0.001358%	652323	99.01%	8	3.24%
矣	2806		7	9	0.001358%	652332	99.01%	8	3.24%
稼	2808		15	9	0.001358%	652341	99.01%	8	3.24%
穗	2809		17	9	0.001358%	652350	99.02%	8	3.24%
緲	2813		15	9	0.001358%	652359	99.02%	8	3.24%
縹	2814		17	9	0.001358%	652368	99.02%	8	3.24%
菊	2819		12	9	0.001358%	652377	99.03%	8	3.24%
遏	2830		12	9	0.001358%	652386	99.04%	8	3.24%
骯	2838		14	9	0.001358%	652395	99.05%	8	3.24%
亢	2842		4	8	0.001207%	652403	99.06%	8	3.24%
扼	2862		7	8	0.001207%	652411	99.08%	8	3.24%
旱	2869		7	8	0.001207%	652419	99.09%	8	3.24%
牢	2882		7	8	0.001207%	652427	99.11%	8	3.24%
睬	2887		13	8	0.001207%	652435	99.11%	8	3.24%
縛	2902		16	8	0.001207%	652443	99.13%	8	3.24%
耘	2904		10	8	0.001207%	652451	99.13%	8	3.24%
詐	2916		12	8	0.001207%	652459	99.15%	8	3.24%
謐	2920		17	8	0.001207%	652467	99.15%	8	3.24%
逮	2924		11	8	0.001207%	652475	99.16%	8	3.24%
獅	1475		13	52	0.007847%	652527	94.21%	7	2.83%
賈	1644		13	41	0.006187%	652568	95.37%	7	2.83%
隸	1840		17	32	0.004829%	652600	96.43%	7	2.83%
娜	1971		10	26	0.003923%	652626	97.00%	7	2.83%
桿	1982		11	26	0.003923%	652652	97.04%	7	2.83%
診	1994		12	26	0.003923%	652678	97.09%	7	2.83%
耶	2018		9	25	0.003772%	652703	97.18%	7	2.83%
卜	2030		2	24	0.003622%	652727	97.23%	7	2.83%
翁	2053		10	24	0.003622%	652751	97.31%	7	2.83%
姨	2089		9	22	0.00332%	652773	97.44%	7	2.83%
岳	2158		8	20	0.003018%	652793	97.66%	7	2.83%
蔔	2176		15	20	0.003018%	652813	97.71%	7	2.83%
輻	2180		16	20	0.003018%	652833	97.72%	7	2.83%
嘟	2190		13	19	0.002867%	652852	97.75%	7	2.83%
虞	2221		13	19	0.002867%	652871	97.84%	7	2.83%
蚊	2259		10	18	0.002716%	652889	97.95%	7	2.83%
彪	2282		11	17	0.002565%	652906	98.01%	7	2.83%
瓊	2301		19	17	0.002565%	652923	98.06%	7	2.83%
週	2359		11	16	0.002414%	652939	98.20%	7	2.83%
嚓	2375		17	15	0.002263%	652954	98.24%	7	2.83%
孝	2384		7	15	0.002263%	652969	98.26%	7	2.83%
廁	2441		12	14	0.002113%	652983	98.38%	7	2.83%
氓	2453		8	14	0.002113%	652997	98.41%	7	2.83%
湛	2456		12	14	0.002113%	653011	98.42%	7	2.83%
竿	2465		9	14	0.002113%	653025	98.43%	7	2.83%
遣	2479		13	14	0.002113%	653039	98.46%	7	2.83%
鴿	2484		17	14	0.002113%	653053	98.47%	7	2.83%
咯	2494		9	13	0.001962%	653066	98.49%	7	2.83%
喃	2496		12	13	0.001962%	653079	98.50%	7	2.83%
埃	2498		10	13	0.001962%	653092	98.50%	7	2.83%
巒	2502		22	13	0.001962%	653105	98.51%	7	2.83%
炯	2519		9	13	0.001962%	653118	98.54%	7	2.83%
粘	2523		11	13	0.001962%	653131	98.55%	7	2.83%
腥	2527		13	13	0.001962%	653144	98.56%	7	2.83%
兜	2547		11	12	0.001811%	653156	98.60%	7	2.83%
嘶	2558		15	12	0.001811%	653168	98.62%	7	2.83%
御	2566		11	12	0.001811%	653180	98.63%	7	2.83%
腕	2596		12	12	0.001811%	653192	98.69%	7	2.83%
蛇	2598		11	12	0.001811%	653204	98.69%	7	2.83%
夥	2619		14	11	0.00166%	653215	98.73%	7	2.83%
姜	2620		9	11	0.00166%	653226	98.73%	7	2.83%
憊	2630		16	11	0.00166%	653237	98.74%	7	2.83%
烤	2650		10	11	0.00166%	653248	98.78%	7	2.83%
熙	2651		14	11	0.00166%	653259	98.78%	7	2.83%
熏	2652		14	11	0.00166%	653270	98.78%	7	2.83%
碟	2660		14	11	0.00166%	653281	98.79%	7	2.83%
秒	2661		9	11	0.00166%	653292	98.80%	7	2.83%
筍	2663		12	11	0.00166%	653303	98.80%	7	2.83%
酥	2679		12	11	0.00166%	653314	98.83%	7	2.83%
僱	2686		14	10	0.001509%	653324	98.84%	7	2.83%
哆	2692		9	10	0.001509%	653334	98.85%	7	2.83%
惟	2704		11	10	0.001509%	653344	98.86%	7	2.83%
扁	2705		9	10	0.001509%	653354	98.87%	7	2.83%
撤	2707		14	10	0.001509%	653364	98.87%	7	2.83%
杭	2712		8	10	0.001509%	653374	98.88%	7	2.83%
瀰	2718		20	10	0.001509%	653384	98.89%	7	2.83%
眨	2722		10	10	0.001509%	653394	98.89%	7	2.83%
肘	2734		7	10	0.001509%	653404	98.91%	7	2.83%
閩	2750		14	10	0.001509%	653414	98.93%	7	2.83%
吏	2763		6	9	0.001358%	653423	98.95%	7	2.83%
哺	2766		10	9	0.001358%	653432	98.96%	7	2.83%
喂	2768		12	9	0.001358%	653441	98.96%	7	2.83%
喇	2769		12	9	0.001358%	653450	98.96%	7	2.83%
姊	2774		8	9	0.001358%	653459	98.97%	7	2.83%
溯	2795		13	9	0.001358%	653468	99.00%	7	2.83%
漾	2796		14	9	0.001358%	653477	99.00%	7	2.83%
畸	2802		13	9	0.001358%	653486	99.01%	7	2.83%
祈	2807		8	9	0.001358%	653495	99.01%	7	2.83%
苔	2817		9	9	0.001358%	653504	99.03%	7	2.83%
蔚	2820		15	9	0.001358%	653513	99.03%	7	2.83%
蔑	2821		15	9	0.001358%	653522	99.03%	7	2.83%
隘	2835		12	9	0.001358%	653531	99.05%	7	2.83%
雛	2837		18	9	0.001358%	653540	99.05%	7	2.83%
侍	2843		8	8	0.001207%	653548	99.06%	7	2.83%
冤	2844		10	8	0.001207%	653556	99.06%	7	2.83%
匪	2847		10	8	0.001207%	653564	99.07%	7	2.83%
卸	2848		8	8	0.001207%	653572	99.07%	7	2.83%
卿	2849		10	8	0.001207%	653580	99.07%	7	2.83%
埸	2853		11	8	0.001207%	653588	99.07%	7	2.83%
愣	2859		12	8	0.001207%	653596	99.08%	7	2.83%
憨	2861		16	8	0.001207%	653604	99.08%	7	2.83%
撮	2866		15	8	0.001207%	653612	99.09%	7	2.83%
昭	2870		9	8	0.001207%	653620	99.09%	7	2.83%
晦	2871		11	8	0.001207%	653628	99.09%	7	2.83%
曳	2872		6	8	0.001207%	653636	99.10%	7	2.83%
棘	2874		12	8	0.001207%	653644	99.10%	7	2.83%
洽	2877		9	8	0.001207%	653652	99.10%	7	2.83%
淀	2878		11	8	0.001207%	653660	99.10%	7	2.83%
澈	2879		14	8	0.001207%	653668	99.10%	7	2.83%
瞭	2888		17	8	0.001207%	653676	99.12%	7	2.83%
稽	2891		15	8	0.001207%	653684	99.12%	7	2.83%
篩	2894		16	8	0.001207%	653692	99.12%	7	2.83%
緻	2900		15	8	0.001207%	653700	99.13%	7	2.83%
繃	2903		17	8	0.001207%	653708	99.13%	7	2.83%
腮	2906		13	8	0.001207%	653716	99.14%	7	2.83%
荊	2908		10	8	0.001207%	653724	99.14%	7	2.83%
襟	2915		18	8	0.001207%	653732	99.15%	7	2.83%
詫	2917		13	8	0.001207%	653740	99.15%	7	2.83%
諱	2918		16	8	0.001207%	653748	99.15%	7	2.83%
賜	2923		15	8	0.001207%	653756	99.16%	7	2.83%
鏟	2925		19	8	0.001207%	653764	99.16%	7	2.83%
閒	2926		12	8	0.001207%	653772	99.16%	7	2.83%
鴉	2931		15	8	0.001207%	653780	99.17%	7	2.83%
凳	2938		14	7	0.001056%	653787	99.17%	7	2.83%
卉	2939		5	7	0.001056%	653794	99.18%	7	2.83%
呻	2940		8	7	0.001056%	653801	99.18%	7	2.83%
妓	2954		7	7	0.001056%	653808	99.19%	7	2.83%
娛	2955		10	7	0.001056%	653815	99.19%	7	2.83%
峙	2957		9	7	0.001056%	653822	99.19%	7	2.83%
惆	2959		11	7	0.001056%	653829	99.20%	7	2.83%
慈	2960		13	7	0.001056%	653836	99.20%	7	2.83%
拽	2964		9	7	0.001056%	653843	99.20%	7	2.83%
撈	2969		15	7	0.001056%	653850	99.21%	7	2.83%
撅	2970		15	7	0.001056%	653857	99.21%	7	2.83%
擅	2971		16	7	0.001056%	653864	99.21%	7	2.83%
撼	2972		16	7	0.001056%	653871	99.21%	7	2.83%
擰	2973		17	7	0.001056%	653878	99.21%	7	2.83%
攬	2974		24	7	0.001056%	653885	99.21%	7	2.83%
斬	2977		11	7	0.001056%	653892	99.22%	7	2.83%
桐	2980		10	7	0.001056%	653899	99.22%	7	2.83%
欽	2985		12	7	0.001056%	653906	99.22%	7	2.83%
歉	2986		14	7	0.001056%	653913	99.23%	7	2.83%
殷	2987		10	7	0.001056%	653920	99.23%	7	2.83%
涕	2990		10	7	0.001056%	653927	99.23%	7	2.83%
砌	3005		9	7	0.001056%	653934	99.25%	7	2.83%
菩	3021		12	7	0.001056%	653941	99.26%	7	2.83%
遁	3034		12	7	0.001056%	653948	99.28%	7	2.83%
鑼	3039		27	7	0.001056%	653955	99.28%	7	2.83%
霾	3042		22	7	0.001056%	653962	99.28%	7	2.83%
靄	3043		24	7	0.001056%	653969	99.29%	7	2.83%
馨	3045		20	7	0.001056%	653976	99.29%	7	2.83%
穀	1089		15	93	0.01403%	654069	90.11%	6	2.43%
翰	1661		16	40	0.006036%	654109	95.48%	6	2.43%
咸	1889		9	29	0.004376%	654138	96.66%	6	2.43%
呂	1968		7	26	0.003923%	654164	96.99%	6	2.43%
騾	1998		21	26	0.003923%	654190	97.11%	6	2.43%
襖	2024		18	25	0.003772%	654215	97.20%	6	2.43%
嫂	2034		12	24	0.003622%	654239	97.24%	6	2.43%
煥	2080		13	23	0.003471%	654262	97.41%	6	2.43%
肝	2082		7	23	0.003471%	654285	97.41%	6	2.43%
樁	2100		15	22	0.00332%	654307	97.47%	6	2.43%
馮	2147		12	21	0.003169%	654328	97.62%	6	2.43%
么	2149		3	20	0.003018%	654348	97.63%	6	2.43%
俄	2185		9	19	0.002867%	654367	97.74%	6	2.43%
唸	2272		11	17	0.002565%	654384	97.98%	6	2.43%
眷	2303		11	17	0.002565%	654401	98.06%	6	2.43%
哮	2326		10	16	0.002414%	654417	98.12%	6	2.43%
董	2354		13	16	0.002414%	654433	98.19%	6	2.43%
袁	2357		10	16	0.002414%	654449	98.19%	6	2.43%
餃	2362		14	16	0.002414%	654465	98.21%	6	2.43%
瀑	2405		18	15	0.002263%	654480	98.30%	6	2.43%
蹟	2420		18	15	0.002263%	654495	98.34%	6	2.43%
鴻	2427		17	15	0.002263%	654510	98.35%	6	2.43%
乙	2486		1	13	0.001962%	654523	98.48%	6	2.43%
囚	2497		5	13	0.001962%	654536	98.50%	6	2.43%
犁	2521		11	13	0.001962%	654549	98.55%	6	2.43%
臺	2529		14	13	0.001962%	654562	98.56%	6	2.43%
嗽	2557		14	12	0.001811%	654574	98.62%	6	2.43%
棺	2578		12	12	0.001811%	654586	98.65%	6	2.43%
咨	2615		9	11	0.00166%	654597	98.72%	6	2.43%
榥	2643		14	11	0.00166%	654608	98.77%	6	2.43%
淤	2647		11	11	0.00166%	654619	98.77%	6	2.43%
澇	2649		15	11	0.00166%	654630	98.78%	6	2.43%
飼	2682		13	11	0.00166%	654641	98.83%	6	2.43%
厘	2689		9	10	0.001509%	654651	98.84%	6	2.43%
嚕	2694		18	10	0.001509%	654661	98.85%	6	2.43%
幔	2700		14	10	0.001509%	654671	98.86%	6	2.43%
恒	2703		9	10	0.001509%	654681	98.86%	6	2.43%
撇	2706		14	10	0.001509%	654691	98.87%	6	2.43%
攘	2708		20	10	0.001509%	654701	98.87%	6	2.43%
禾	2726		5	10	0.001509%	654711	98.90%	6	2.43%
菲	2735		12	10	0.001509%	654721	98.91%	6	2.43%
蝦	2739		15	10	0.001509%	654731	98.92%	6	2.43%
譏	2744		19	10	0.001509%	654741	98.93%	6	2.43%
馱	2754		13	10	0.001509%	654751	98.94%	6	2.43%
魏	2756		18	10	0.001509%	654761	98.94%	6	2.43%
黏	2757		17	10	0.001509%	654771	98.94%	6	2.43%
侃	2759		8	9	0.001358%	654780	98.95%	6	2.43%
勺	2761		3	9	0.001358%	654789	98.95%	6	2.43%
噩	2773		16	9	0.001358%	654798	98.97%	6	2.43%
懺	2784		20	9	0.001358%	654807	98.98%	6	2.43%
昇	2789		8	9	0.001358%	654816	98.99%	6	2.43%
棲	2791		12	9	0.001358%	654825	98.99%	6	2.43%
焉	2798		11	9	0.001358%	654834	99.00%	6	2.43%
玲	2800		9	9	0.001358%	654843	99.00%	6	2.43%
瑟	2801		13	9	0.001358%	654852	99.00%	6	2.43%
眯	2805		11	9	0.001358%	654861	99.01%	6	2.43%
箭	2810		15	9	0.001358%	654870	99.02%	6	2.43%
簇	2811		17	9	0.001358%	654879	99.02%	6	2.43%
蝴	2823		15	9	0.001358%	654888	99.03%	6	2.43%
賬	2829		15	9	0.001358%	654897	99.04%	6	2.43%
雇	2836		12	9	0.001358%	654906	99.05%	6	2.43%
刃	2845		3	8	0.001207%	654914	99.06%	6	2.43%
划	2846		6	8	0.001207%	654922	99.06%	6	2.43%
拯	2863		9	8	0.001207%	654930	99.09%	6	2.43%
斟	2868		13	8	0.001207%	654938	99.09%	6	2.43%
瀾	2881		20	8	0.001207%	654946	99.11%	6	2.43%
犬	2883		4	8	0.001207%	654954	99.11%	6	2.43%
猴	2884		12	8	0.001207%	654962	99.11%	6	2.43%
疙	2886		8	8	0.001207%	654970	99.11%	6	2.43%
箋	2893		14	8	0.001207%	654978	99.12%	6	2.43%
簾	2896		19	8	0.001207%	654986	99.13%	6	2.43%
粥	2897		12	8	0.001207%	654994	99.13%	6	2.43%
糜	2898		17	8	0.001207%	655002	99.13%	6	2.43%
莽	2909		11	8	0.001207%	655010	99.14%	6	2.43%
薪	2910		17	8	0.001207%	655018	99.14%	6	2.43%
薰	2911		18	8	0.001207%	655026	99.14%	6	2.43%
賃	2921		13	8	0.001207%	655034	99.16%	6	2.43%
雁	2928		12	8	0.001207%	655042	99.16%	6	2.43%
餵	2929		17	8	0.001207%	655050	99.16%	6	2.43%
佐	2933		7	7	0.001056%	655057	99.17%	6	2.43%
冀	2934		16	7	0.001056%	655064	99.17%	6	2.43%
凱	2937		12	7	0.001056%	655071	99.17%	6	2.43%
垢	2947		9	7	0.001056%	655078	99.18%	6	2.43%
墅	2948		14	7	0.001056%	655085	99.19%	6	2.43%
巔	2958		22	7	0.001056%	655092	99.20%	6	2.43%
戳	2962		18	7	0.001056%	655099	99.20%	6	2.43%
拱	2965		9	7	0.001056%	655106	99.20%	6	2.43%
摹	2968		15	7	0.001056%	655113	99.21%	6	2.43%
斂	2976		17	7	0.001056%	655120	99.22%	6	2.43%
柵	2978		9	7	0.001056%	655127	99.22%	6	2.43%
棗	2981		12	7	0.001056%	655134	99.22%	6	2.43%
椰	2983		13	7	0.001056%	655141	99.22%	6	2.43%
榻	2984		14	7	0.001056%	655148	99.22%	6	2.43%
濾	2993		18	7	0.001056%	655155	99.23%	6	2.43%
瀚	2994		19	7	0.001056%	655162	99.23%	6	2.43%
煦	2996		13	7	0.001056%	655169	99.24%	6	2.43%
狡	2998		9	7	0.001056%	655176	99.24%	6	2.43%
癢	3000		20	7	0.001056%	655183	99.24%	6	2.43%
瞄	3002		14	7	0.001056%	655190	99.24%	6	2.43%
瞻	3004		18	7	0.001056%	655197	99.24%	6	2.43%
磕	3006		15	7	0.001056%	655204	99.25%	6	2.43%
礫	3008		20	7	0.001056%	655211	99.25%	6	2.43%
縈	3012		16	7	0.001056%	655218	99.25%	6	2.43%
繚	3013		18	7	0.001056%	655225	99.25%	6	2.43%
肆	3015		13	7	0.001056%	655232	99.26%	6	2.43%
脯	3018		11	7	0.001056%	655239	99.26%	6	2.43%
蠕	3025		20	7	0.001056%	655246	99.27%	6	2.43%
袍	3026		10	7	0.001056%	655253	99.27%	6	2.43%
襪	3027		20	7	0.001056%	655260	99.27%	6	2.43%
諦	3028		16	7	0.001056%	655267	99.27%	6	2.43%
邃	3035		17	7	0.001056%	655274	99.28%	6	2.43%
醇	3036		15	7	0.001056%	655281	99.28%	6	2.43%
鍾	3038		17	7	0.001056%	655288	99.28%	6	2.43%
霍	3040		16	7	0.001056%	655295	99.28%	6	2.43%
餡	3044		16	7	0.001056%	655302	99.29%	6	2.43%
鬃	3047		18	7	0.001056%	655309	99.29%	6	2.43%
剃	3057		9	6	0.0009054%	655315	99.30%	6	2.43%
匿	3059		11	6	0.0009054%	655321	99.30%	6	2.43%
吆	3060		6	6	0.0009054%	655327	99.30%	6	2.43%
墜	3065		15	6	0.0009054%	655333	99.31%	6	2.43%
壑	3066		17	6	0.0009054%	655339	99.31%	6	2.43%
宰	3070		10	6	0.0009054%	655345	99.31%	6	2.43%
嵌	3073		12	6	0.0009054%	655351	99.31%	6	2.43%
徉	3076		9	6	0.0009054%	655357	99.32%	6	2.43%
徜	3077		11	6	0.0009054%	655363	99.32%	6	2.43%
忱	3078		7	6	0.0009054%	655369	99.32%	6	2.43%
怹	3080		9	6	0.0009054%	655375	99.32%	6	2.43%
惘	3081		11	6	0.0009054%	655381	99.32%	6	2.43%
惰	3082		12	6	0.0009054%	655387	99.32%	6	2.43%
懈	3084		16	6	0.0009054%	655393	99.32%	6	2.43%
拚	3086		8	6	0.0009054%	655399	99.33%	6	2.43%
搗	3087		13	6	0.0009054%	655405	99.33%	6	2.43%
擎	3089		17	6	0.0009054%	655411	99.33%	6	2.43%
敞	3090		12	6	0.0009054%	655417	99.33%	6	2.43%
曆	3091		16	6	0.0009054%	655423	99.33%	6	2.43%
梧	3095		11	6	0.0009054%	655429	99.33%	6	2.43%
濘	3105		17	6	0.0009054%	655435	99.34%	6	2.43%
炙	3106		8	6	0.0009054%	655441	99.34%	6	2.43%
炫	3107		9	6	0.0009054%	655447	99.34%	6	2.43%
燭	3108		17	6	0.0009054%	655453	99.35%	6	2.43%
玄	3109		5	6	0.0009054%	655459	99.35%	6	2.43%
琳	3111		12	6	0.0009054%	655465	99.35%	6	2.43%
瑜	3112		13	6	0.0009054%	655471	99.35%	6	2.43%
疫	3114		9	6	0.0009054%	655477	99.35%	6	2.43%
硝	3117		12	6	0.0009054%	655483	99.35%	6	2.43%
羡	3125		12	6	0.0009054%	655489	99.36%	6	2.43%
羨	3126		13	6	0.0009054%	655495	99.36%	6	2.43%
脅	3128		10	6	0.0009054%	655501	99.36%	6	2.43%
腺	3130		13	6	0.0009054%	655507	99.37%	6	2.43%
虐	3140		9	6	0.0009054%	655513	99.37%	6	2.43%
蜿	3143		14	6	0.0009054%	655519	99.38%	6	2.43%
蜒	3145		14	6	0.0009054%	655525	99.38%	6	2.43%
袱	3147		11	6	0.0009054%	655531	99.38%	6	2.43%
裔	3148		13	6	0.0009054%	655537	99.38%	6	2.43%
褪	3149		15	6	0.0009054%	655543	99.38%	6	2.43%
豁	3151		17	6	0.0009054%	655549	99.38%	6	2.43%
跤	3154		13	6	0.0009054%	655555	99.39%	6	2.43%
輾	3156		17	6	0.0009054%	655561	99.39%	6	2.43%
辰	3158		7	6	0.0009054%	655567	99.39%	6	2.43%
遐	3161		12	6	0.0009054%	655573	99.39%	6	2.43%
釣	3164		11	6	0.0009054%	655579	99.40%	6	2.43%
錘	3167		17	6	0.0009054%	655585	99.40%	6	2.43%
顱	3169		25	6	0.0009054%	655591	99.40%	6	2.43%
魁	3174		14	6	0.0009054%	655597	99.41%	6	2.43%
鱗	3175		23	6	0.0009054%	655603	99.41%	6	2.43%
龜	3178		16	6	0.0009054%	655609	99.41%	6	2.43%
嫻	1023		15	101	0.01524%	655710	89.14%	5	2.02%
茲	1532		10	48	0.007243%	655758	94.63%	5	2.02%
霖	1613		16	43	0.006489%	655801	95.18%	5	2.02%
燧	1659		17	40	0.006036%	655841	95.46%	5	2.02%
巍	1821		21	32	0.004829%	655873	96.34%	5	2.02%
蔗	2057		15	24	0.003622%	655897	97.32%	5	2.02%
弗	2129		5	21	0.003169%	655918	97.57%	5	2.02%
筐	2215		12	19	0.002867%	655937	97.83%	5	2.02%
諮	2224		16	19	0.002867%	655956	97.85%	5	2.02%
娟	2235		10	18	0.002716%	655974	97.88%	5	2.02%
湳	2250		12	18	0.002716%	655992	97.92%	5	2.02%
岡	2335		8	16	0.002414%	656008	98.14%	5	2.02%
耿	2411		10	15	0.002263%	656023	98.32%	5	2.02%
鄂	2423		11	15	0.002263%	656038	98.35%	5	2.02%
醋	2424		15	15	0.002263%	656053	98.35%	5	2.02%
蟬	2477		18	14	0.002113%	656067	98.46%	5	2.02%
烽	2520		11	13	0.001962%	656080	98.55%	5	2.02%
祀	2522		7	13	0.001962%	656093	98.55%	5	2.02%
蔡	2530		15	13	0.001962%	656106	98.57%	5	2.02%
杖	2577		7	12	0.001811%	656118	98.65%	5	2.02%
潘	2583		15	12	0.001811%	656130	98.66%	5	2.02%
醬	2605		18	12	0.001811%	656142	98.70%	5	2.02%
琅	2655		11	11	0.00166%	656153	98.79%	5	2.02%
叛	2690		9	10	0.001509%	656163	98.84%	5	2.02%
叭	2691		5	10	0.001509%	656173	98.85%	5	2.02%
彬	2702		11	10	0.001509%	656183	98.86%	5	2.02%
簌	2728		17	10	0.001509%	656193	98.90%	5	2.02%
雍	2753		13	10	0.001509%	656203	98.94%	5	2.02%
吱	2764		7	9	0.001358%	656212	98.95%	5	2.02%
哧	2767		10	9	0.001358%	656221	98.96%	5	2.02%
寥	2775		14	9	0.001358%	656230	98.97%	5	2.02%
怯	2780		8	9	0.001358%	656239	98.98%	5	2.02%
炕	2797		8	9	0.001358%	656248	99.00%	5	2.02%
瘓	2803		14	9	0.001358%	656257	99.01%	5	2.02%
蚌	2822		10	9	0.001358%	656266	99.03%	5	2.02%
託	2826		10	9	0.001358%	656275	99.04%	5	2.02%
誼	2827		15	9	0.001358%	656284	99.04%	5	2.02%
鈔	2831		12	9	0.001358%	656293	99.05%	5	2.02%
鹼	2839		24	9	0.001358%	656302	99.06%	5	2.02%
黝	2841		17	9	0.001358%	656311	99.06%	5	2.02%
嘹	2850		15	8	0.001207%	656319	99.07%	5	2.02%
孜	2855		7	8	0.001207%	656327	99.08%	5	2.02%
揍	2865		12	8	0.001207%	656335	99.09%	5	2.02%
擭	2867		17	8	0.001207%	656343	99.09%	5	2.02%
簍	2895		17	8	0.001207%	656351	99.12%	5	2.02%
綁	2899		13	8	0.001207%	656359	99.13%	5	2.02%
舔	2907		14	8	0.001207%	656367	99.14%	5	2.02%
藻	2912		20	8	0.001207%	656375	99.14%	5	2.02%
蛙	2913		12	8	0.001207%	656383	99.15%	5	2.02%
謎	2919		17	8	0.001207%	656391	99.15%	5	2.02%
賤	2922		15	8	0.001207%	656399	99.16%	5	2.02%
髓	2930		23	8	0.001207%	656407	99.17%	5	2.02%
黛	2932		17	8	0.001207%	656415	99.17%	5	2.02%
咚	2942		8	7	0.001056%	656422	99.18%	5	2.02%
啄	2943		11	7	0.001056%	656429	99.18%	5	2.02%
啃	2944		11	7	0.001056%	656436	99.18%	5	2.02%
嘿	2945		15	7	0.001056%	656443	99.18%	5	2.02%
壟	2950		19	7	0.001056%	656450	99.19%	5	2.02%
奕	2951		9	7	0.001056%	656457	99.19%	5	2.02%
妒	2953		7	7	0.001056%	656464	99.19%	5	2.02%
拌	2963		8	7	0.001056%	656471	99.20%	5	2.02%
敊	2975		10	7	0.001056%	656478	99.21%	5	2.02%
柄	2979		9	7	0.001056%	656485	99.22%	5	2.02%
楠	2982		13	7	0.001056%	656492	99.22%	5	2.02%
潰	2992		15	7	0.001056%	656499	99.23%	5	2.02%
瘩	2999		15	7	0.001056%	656506	99.24%	5	2.02%
睦	3001		13	7	0.001056%	656513	99.24%	5	2.02%
秉	3009		8	7	0.001056%	656520	99.25%	5	2.02%
籽	3010		9	7	0.001056%	656527	99.25%	5	2.02%
紮	3011		11	7	0.001056%	656534	99.25%	5	2.02%
肴	3016		8	7	0.001056%	656541	99.26%	5	2.02%
膳	3019		16	7	0.001056%	656548	99.26%	5	2.02%
趾	3031		11	7	0.001056%	656555	99.27%	5	2.02%
軋	3032		8	7	0.001056%	656562	99.27%	5	2.02%
軼	3033		12	7	0.001056%	656569	99.28%	5	2.02%
鋁	3037		15	7	0.001056%	656576	99.28%	5	2.02%
霽	3041		22	7	0.001056%	656583	99.28%	5	2.02%
髦	3046		14	7	0.001056%	656590	99.29%	5	2.02%
丑	3049		4	6	0.0009054%	656596	99.29%	5	2.02%
佑	3050		7	6	0.0009054%	656602	99.29%	5	2.02%
奢	3067		11	6	0.0009054%	656608	99.31%	5	2.02%
寢	3071		14	6	0.0009054%	656614	99.31%	5	2.02%
廬	3075		19	6	0.0009054%	656620	99.32%	5	2.02%
慷	3083		14	6	0.0009054%	656626	99.32%	5	2.02%
抿	3085		8	6	0.0009054%	656632	99.32%	5	2.02%
朴	3092		6	6	0.0009054%	656638	99.33%	5	2.02%
杠	3093		7	6	0.0009054%	656644	99.33%	5	2.02%
槐	3098		14	6	0.0009054%	656650	99.34%	5	2.02%
洩	3100		9	6	0.0009054%	656656	99.34%	5	2.02%
淳	3102		11	6	0.0009054%	656662	99.34%	5	2.02%
渦	3103		12	6	0.0009054%	656668	99.34%	5	2.02%
疚	3113		8	6	0.0009054%	656674	99.35%	5	2.02%
瞅	3116		14	6	0.0009054%	656680	99.35%	5	2.02%
絹	3122		13	6	0.0009054%	656686	99.36%	5	2.02%
繆	3123		17	6	0.0009054%	656692	99.36%	5	2.02%
繳	3124		19	6	0.0009054%	656698	99.36%	5	2.02%
翳	3127		17	6	0.0009054%	656704	99.36%	5	2.02%
胯	3129		10	6	0.0009054%	656710	99.36%	5	2.02%
臣	3132		6	6	0.0009054%	656716	99.37%	5	2.02%
蠟	3146		21	6	0.0009054%	656722	99.38%	5	2.02%
蹭	3155		19	6	0.0009054%	656728	99.39%	5	2.02%
迭	3159		8	6	0.0009054%	656734	99.39%	5	2.02%
迸	3160		9	6	0.0009054%	656740	99.39%	5	2.02%
釘	3163		10	6	0.0009054%	656746	99.40%	5	2.02%
霎	3168		16	6	0.0009054%	656752	99.40%	5	2.02%
馭	3170		12	6	0.0009054%	656758	99.40%	5	2.02%
乍	3180		5	5	0.0007545%	656763	99.41%	5	2.02%
亟	3181		8	5	0.0007545%	656768	99.41%	5	2.02%
俠	3183		9	5	0.0007545%	656773	99.41%	5	2.02%
侶	3184		9	5	0.0007545%	656778	99.41%	5	2.02%
侮	3185		9	5	0.0007545%	656783	99.41%	5	2.02%
兀	3187		3	5	0.0007545%	656788	99.42%	5	2.02%
冕	3188		11	5	0.0007545%	656793	99.42%	5	2.02%
冶	3189		7	5	0.0007545%	656798	99.42%	5	2.02%
凄	3190		10	5	0.0007545%	656803	99.42%	5	2.02%
勻	3192		4	5	0.0007545%	656808	99.42%	5	2.02%
厄	3193		4	5	0.0007545%	656813	99.42%	5	2.02%
咆	3195		8	5	0.0007545%	656818	99.42%	5	2.02%
嘔	3202		14	5	0.0007545%	656823	99.43%	5	2.02%
嘮	3204		15	5	0.0007545%	656828	99.43%	5	2.02%
噪	3205		16	5	0.0007545%	656833	99.43%	5	2.02%
夭	3209		4	5	0.0007545%	656838	99.43%	5	2.02%
妖	3210		7	5	0.0007545%	656843	99.43%	5	2.02%
娶	3212		11	5	0.0007545%	656848	99.43%	5	2.02%
婪	3213		11	5	0.0007545%	656853	99.44%	5	2.02%
宕	3215		8	5	0.0007545%	656858	99.44%	5	2.02%
屎	3216		9	5	0.0007545%	656863	99.44%	5	2.02%
帚	3221		8	5	0.0007545%	656868	99.44%	5	2.02%
帥	3222		9	5	0.0007545%	656873	99.44%	5	2.02%
弘	3224		5	5	0.0007545%	656878	99.44%	5	2.02%
惕	3227		11	5	0.0007545%	656883	99.45%	5	2.02%
慚	3230		14	5	0.0007545%	656888	99.45%	5	2.02%
懊	3231		16	5	0.0007545%	656893	99.45%	5	2.02%
挎	3235		9	5	0.0007545%	656898	99.45%	5	2.02%
摻	3237		14	5	0.0007545%	656903	99.45%	5	2.02%
暉	3238		13	5	0.0007545%	656908	99.45%	5	2.02%
暇	3239		13	5	0.0007545%	656913	99.45%	5	2.02%
桎	3242		10	5	0.0007545%	656918	99.46%	5	2.02%
梏	3243		11	5	0.0007545%	656923	99.46%	5	2.02%
殆	3249		9	5	0.0007545%	656928	99.46%	5	2.02%
沃	3253		7	5	0.0007545%	656933	99.47%	5	2.02%
涎	3256		11	5	0.0007545%	656938	99.47%	5	2.02%
渲	3259		12	5	0.0007545%	656943	99.47%	5	2.02%
湍	3261		12	5	0.0007545%	656948	99.47%	5	2.02%
潭	3264		15	5	0.0007545%	656953	99.47%	5	2.02%
瀕	3266		19	5	0.0007545%	656958	99.48%	5	2.02%
灼	3267		7	5	0.0007545%	656963	99.48%	5	2.02%
焰	3269		12	5	0.0007545%	656968	99.48%	5	2.02%
瘡	3274		15	5	0.0007545%	656973	99.48%	5	2.02%
眸	3277		11	5	0.0007545%	656978	99.48%	5	2.02%
秧	3284		10	5	0.0007545%	656983	99.49%	5	2.02%
穴	3287		5	5	0.0007545%	656988	99.49%	5	2.02%
穹	3288		8	5	0.0007545%	656993	99.49%	5	2.02%
箕	3296		14	5	0.0007545%	656998	99.50%	5	2.02%
篡	3297		16	5	0.0007545%	657003	99.50%	5	2.02%
簸	3300		19	5	0.0007545%	657008	99.50%	5	2.02%
籟	3301		22	5	0.0007545%	657013	99.50%	5	2.02%
籲	3303		32	5	0.0007545%	657018	99.50%	5	2.02%
綻	3304		14	5	0.0007545%	657023	99.50%	5	2.02%
繽	3305		20	5	0.0007545%	657028	99.50%	5	2.02%
羔	3306		10	5	0.0007545%	657033	99.51%	5	2.02%
耽	3308		10	5	0.0007545%	657038	99.51%	5	2.02%
舖	3312		15	5	0.0007545%	657043	99.51%	5	2.02%
苛	3314		9	5	0.0007545%	657048	99.51%	5	2.02%
蜷	3320		14	5	0.0007545%	657053	99.52%	5	2.02%
褐	3324		14	5	0.0007545%	657058	99.52%	5	2.02%
褒	3325		15	5	0.0007545%	657063	99.52%	5	2.02%
詭	3327		13	5	0.0007545%	657068	99.52%	5	2.02%
跚	3331		12	5	0.0007545%	657073	99.52%	5	2.02%
踵	3333		16	5	0.0007545%	657078	99.53%	5	2.02%
蹊	3334		17	5	0.0007545%	657083	99.53%	5	2.02%
蹣	3335		18	5	0.0007545%	657088	99.53%	5	2.02%
轍	3338		18	5	0.0007545%	657093	99.53%	5	2.02%
	3341		12	5	0.0007545%	657098	99.53%	5	2.02%
錶	3343		16	5	0.0007545%	657103	99.53%	5	2.02%
鋸	3344		16	5	0.0007545%	657108	99.53%	5	2.02%
錫	3345		16	5	0.0007545%	657113	99.53%	5	2.02%
闌	3347		17	5	0.0007545%	657118	99.54%	5	2.02%
霄	3348		15	5	0.0007545%	657123	99.54%	5	2.02%
霆	3349		15	5	0.0007545%	657128	99.54%	5	2.02%
瑾	930		15	115	0.01735%	657243	87.62%	4	1.62%
歹	1856		4	31	0.004678%	657274	96.51%	4	1.62%
碳	2173		14	20	0.003018%	657294	97.70%	4	1.62%
堯	2192		12	19	0.002867%	657313	97.76%	4	1.62%
斌	2202		12	19	0.002867%	657332	97.79%	4	1.62%
蟹	2222		19	19	0.002867%	657351	97.85%	4	1.62%
噬	2327		16	16	0.002414%	657367	98.12%	4	1.62%
渣	2345		12	16	0.002414%	657383	98.17%	4	1.62%
楓	2398		13	15	0.002263%	657398	98.29%	4	1.62%
汕	2512		6	13	0.001962%	657411	98.53%	4	1.62%
喳	2555		12	12	0.001811%	657423	98.61%	4	1.62%
娥	2561		10	12	0.001811%	657435	98.62%	4	1.62%
薛	2667		17	11	0.00166%	657446	98.81%	4	1.62%
冉	2688		5	10	0.001509%	657456	98.84%	4	1.62%
祇	2725		8	10	0.001509%	657466	98.90%	4	1.62%
巿	2778		4	9	0.001358%	657475	98.97%	4	1.62%
篷	2812		17	9	0.001358%	657484	99.02%	4	1.62%
蟻	2824		19	9	0.001358%	657493	99.04%	4	1.62%
埠	2852		11	8	0.001207%	657501	99.07%	4	1.62%
寇	2856		11	8	0.001207%	657509	99.08%	4	1.62%
崽	2857		12	8	0.001207%	657517	99.08%	4	1.62%
忡	2858		7	8	0.001207%	657525	99.08%	4	1.62%
慾	2860		15	8	0.001207%	657533	99.08%	4	1.62%
捎	2864		10	8	0.001207%	657541	99.09%	4	1.62%
汨	2876		7	8	0.001207%	657549	99.10%	4	1.62%
漉	2880		14	8	0.001207%	657557	99.11%	4	1.62%
笙	2892		11	8	0.001207%	657565	99.12%	4	1.62%
肇	2905		14	8	0.001207%	657573	99.14%	4	1.62%
裊	2914		13	8	0.001207%	657581	99.15%	4	1.62%
陀	2927		7	8	0.001207%	657589	99.16%	4	1.62%
冥	2935		10	7	0.001056%	657596	99.17%	4	1.62%
冽	2936		8	7	0.001056%	657603	99.17%	4	1.62%
坪	2946		8	7	0.001056%	657610	99.18%	4	1.62%
墻	2949		16	7	0.001056%	657617	99.19%	4	1.62%
掂	2966		11	7	0.001056%	657624	99.20%	4	1.62%
掐	2967		11	7	0.001056%	657631	99.21%	4	1.62%
湘	2991		12	7	0.001056%	657638	99.23%	4	1.62%
狐	2997		8	7	0.001056%	657645	99.24%	4	1.62%
磷	3007		17	7	0.001056%	657652	99.25%	4	1.62%
蕉	3022		16	7	0.001056%	657659	99.26%	4	1.62%
賄	3030		13	7	0.001056%	657666	99.27%	4	1.62%
偵	3053		11	6	0.0009054%	657672	99.30%	4	1.62%
僕	3055		14	6	0.0009054%	657678	99.30%	4	1.62%
勘	3058		11	6	0.0009054%	657684	99.30%	4	1.62%
嘀	3062		14	6	0.0009054%	657690	99.30%	4	1.62%
囉	3063		22	6	0.0009054%	657696	99.30%	4	1.62%
垠	3064		9	6	0.0009054%	657702	99.31%	4	1.62%
屜	3072		11	6	0.0009054%	657708	99.31%	4	1.62%
摺	3088		14	6	0.0009054%	657714	99.33%	4	1.62%
棱	3097		12	6	0.0009054%	657720	99.34%	4	1.62%
沱	3099		8	6	0.0009054%	657726	99.34%	4	1.62%
涌	3101		10	6	0.0009054%	657732	99.34%	4	1.62%
滬	3104		14	6	0.0009054%	657738	99.34%	4	1.62%
篤	3120		16	6	0.0009054%	657744	99.36%	4	1.62%
臀	3131		17	6	0.0009054%	657750	99.37%	4	1.62%
莎	3135		11	6	0.0009054%	657756	99.37%	4	1.62%
莉	3136		11	6	0.0009054%	657762	99.37%	4	1.62%
萃	3137		12	6	0.0009054%	657768	99.37%	4	1.62%
蘋	3138		20	6	0.0009054%	657774	99.37%	4	1.62%
蘢	3139		20	6	0.0009054%	657780	99.37%	4	1.62%
蛀	3141		11	6	0.0009054%	657786	99.38%	4	1.62%
蛛	3142		12	6	0.0009054%	657792	99.38%	4	1.62%
蜘	3144		14	6	0.0009054%	657798	99.38%	4	1.62%
貞	3152		9	6	0.0009054%	657804	99.39%	4	1.62%
賂	3153		13	6	0.0009054%	657810	99.39%	4	1.62%
轎	3157		19	6	0.0009054%	657816	99.39%	4	1.62%
釆	3162		7	6	0.0009054%	657822	99.39%	4	1.62%
鉛	3165		13	6	0.0009054%	657828	99.40%	4	1.62%
骼	3171		16	6	0.0009054%	657834	99.40%	4	1.62%
鬚	3172		22	6	0.0009054%	657840	99.40%	4	1.62%
鵑	3176		18	6	0.0009054%	657846	99.41%	4	1.62%
黯	3177		21	6	0.0009054%	657852	99.41%	4	1.62%
丸	3179		3	5	0.0007545%	657857	99.41%	4	1.62%
佗	3182		7	5	0.0007545%	657862	99.41%	4	1.62%
咋	3196		8	5	0.0007545%	657867	99.42%	4	1.62%
啜	3199		11	5	0.0007545%	657872	99.42%	4	1.62%
嗜	3201		13	5	0.0007545%	657877	99.43%	4	1.62%
嘈	3203		14	5	0.0007545%	657882	99.43%	4	1.62%
垣	3208		9	5	0.0007545%	657887	99.43%	4	1.62%
妾	3211		8	5	0.0007545%	657892	99.43%	4	1.62%
峋	3217		9	5	0.0007545%	657897	99.44%	4	1.62%
嶙	3218		15	5	0.0007545%	657902	99.44%	4	1.62%
并	3223		6	5	0.0007545%	657907	99.44%	4	1.62%
惋	3226		11	5	0.0007545%	657912	99.44%	4	1.62%
惚	3228		11	5	0.0007545%	657917	99.45%	4	1.62%
愫	3229		13	5	0.0007545%	657922	99.45%	4	1.62%
懇	3232		17	5	0.0007545%	657927	99.45%	4	1.62%
抨	3234		8	5	0.0007545%	657932	99.45%	4	1.62%
揹	3236		12	5	0.0007545%	657937	99.45%	4	1.62%
札	3240		5	5	0.0007545%	657942	99.46%	4	1.62%
棧	3246		12	5	0.0007545%	657947	99.46%	4	1.62%
橡	3248		16	5	0.0007545%	657952	99.46%	4	1.62%
沛	3252		7	5	0.0007545%	657957	99.46%	4	1.62%
沏	3254		7	5	0.0007545%	657962	99.47%	4	1.62%
沮	3255		8	5	0.0007545%	657967	99.47%	4	1.62%
湮	3260		12	5	0.0007545%	657972	99.47%	4	1.62%
溺	3262		13	5	0.0007545%	657977	99.47%	4	1.62%
漚	3263		14	5	0.0007545%	657982	99.47%	4	1.62%
狄	3271		7	5	0.0007545%	657987	99.48%	4	1.62%
皂	3276		7	5	0.0007545%	657992	99.48%	4	1.62%
瞞	3278		16	5	0.0007545%	657997	99.48%	4	1.62%
祠	3281		9	5	0.0007545%	658002	99.49%	4	1.62%
禱	3283		18	5	0.0007545%	658007	99.49%	4	1.62%
穫	3286		19	5	0.0007545%	658012	99.49%	4	1.62%
窪	3290		14	5	0.0007545%	658017	99.49%	4	1.62%
竅	3293		18	5	0.0007545%	658022	99.50%	4	1.62%
篝	3298		16	5	0.0007545%	658027	99.50%	4	1.62%
籮	3302		25	5	0.0007545%	658032	99.50%	4	1.62%
聆	3309		11	5	0.0007545%	658037	99.51%	4	1.62%
臻	3311		16	5	0.0007545%	658042	99.51%	4	1.62%
苞	3315		9	5	0.0007545%	658047	99.51%	4	1.62%
蓑	3316		14	5	0.0007545%	658052	99.51%	4	1.62%
蠢	3323		21	5	0.0007545%	658057	99.52%	4	1.62%
誡	3328		14	5	0.0007545%	658062	99.52%	4	1.62%
譚	3330		19	5	0.0007545%	658067	99.52%	4	1.62%
跛	3332		12	5	0.0007545%	658072	99.52%	4	1.62%
蹬	3336		19	5	0.0007545%	658077	99.53%	4	1.62%
軸	3337		12	5	0.0007545%	658082	99.53%	4	1.62%
閥	3346		14	5	0.0007545%	658087	99.54%	4	1.62%
霓	3350		16	5	0.0007545%	658092	99.54%	4	1.62%
頹	3353		16	5	0.0007545%	658097	99.54%	4	1.62%
頤	3354		16	5	0.0007545%	658102	99.54%	4	1.62%
丐	3359		4	4	0.0006036%	658106	99.55%	4	1.62%
佇	3363		7	4	0.0006036%	658110	99.55%	4	1.62%
併	3365		8	4	0.0006036%	658114	99.55%	4	1.62%
倔	3367		10	4	0.0006036%	658118	99.55%	4	1.62%
勿	3371		4	4	0.0006036%	658122	99.55%	4	1.62%
匱	3374		14	4	0.0006036%	658126	99.55%	4	1.62%
叼	3376		5	4	0.0006036%	658130	99.56%	4	1.62%
叱	3377		5	4	0.0006036%	658134	99.56%	4	1.62%
哎	3378		9	4	0.0006036%	658138	99.56%	4	1.62%
哽	3379		10	4	0.0006036%	658142	99.56%	4	1.62%
唾	3380		12	4	0.0006036%	658146	99.56%	4	1.62%
噙	3382		16	4	0.0006036%	658150	99.56%	4	1.62%
嚎	3385		17	4	0.0006036%	658154	99.56%	4	1.62%
夸	3390		6	4	0.0006036%	658158	99.56%	4	1.62%
嬉	3394		15	4	0.0006036%	658162	99.57%	4	1.62%
孽	3397		20	4	0.0006036%	658166	99.57%	4	1.62%
屹	3400		6	4	0.0006036%	658170	99.57%	4	1.62%
崎	3402		11	4	0.0006036%	658174	99.57%	4	1.62%
巫	3405		7	4	0.0006036%	658178	99.57%	4	1.62%
幀	3406		12	4	0.0006036%	658182	99.57%	4	1.62%
庄	3407		6	4	0.0006036%	658186	99.57%	4	1.62%
廝	3409		15	4	0.0006036%	658190	99.58%	4	1.62%
弛	3410		6	4	0.0006036%	658194	99.58%	4	1.62%
怔	3414		8	4	0.0006036%	658198	99.58%	4	1.62%
怜	3415		8	4	0.0006036%	658202	99.58%	4	1.62%
悍	3416		10	4	0.0006036%	658206	99.58%	4	1.62%
悖	3417		10	4	0.0006036%	658210	99.58%	4	1.62%
悴	3419		11	4	0.0006036%	658214	99.58%	4	1.62%
愕	3421		12	4	0.0006036%	658218	99.58%	4	1.62%
憔	3424		15	4	0.0006036%	658222	99.58%	4	1.62%
懣	3426		18	4	0.0006036%	658226	99.59%	4	1.62%
拇	3428		8	4	0.0006036%	658230	99.59%	4	1.62%
捐	3429		10	4	0.0006036%	658234	99.59%	4	1.62%
掬	3430		11	4	0.0006036%	658238	99.59%	4	1.62%
掰	3431		12	4	0.0006036%	658242	99.59%	4	1.62%
搐	3432		13	4	0.0006036%	658246	99.59%	4	1.62%
擷	3435		18	4	0.0006036%	658250	99.59%	4	1.62%
攫	3436		23	4	0.0006036%	658254	99.59%	4	1.62%
晌	3439		10	4	0.0006036%	658258	99.59%	4	1.62%
晾	3440		12	4	0.0006036%	658262	99.59%	4	1.62%
棟	3444		12	4	0.0006036%	658266	99.60%	4	1.62%
橙	3450		16	4	0.0006036%	658270	99.60%	4	1.62%
氯	3453		12	4	0.0006036%	658274	99.60%	4	1.62%
涸	3458		11	4	0.0006036%	658278	99.60%	4	1.62%
淩	3460		11	4	0.0006036%	658282	99.61%	4	1.62%
涷	3461		11	4	0.0006036%	658286	99.61%	4	1.62%
湃	3462		12	4	0.0006036%	658290	99.61%	4	1.62%
澎	3464		15	4	0.0006036%	658294	99.61%	4	1.62%
煎	3466		13	4	0.0006036%	658298	99.61%	4	1.62%
熨	3467		15	4	0.0006036%	658302	99.61%	4	1.62%
獷	3470		18	4	0.0006036%	658306	99.61%	4	1.62%
璀	3472		15	4	0.0006036%	658310	99.61%	4	1.62%
璧	3473		18	4	0.0006036%	658314	99.61%	4	1.62%
痙	3475		12	4	0.0006036%	658318	99.62%	4	1.62%
瘠	3478		15	4	0.0006036%	658322	99.62%	4	1.62%
癟	3480		19	4	0.0006036%	658326	99.62%	4	1.62%
矯	3481		17	4	0.0006036%	658330	99.62%	4	1.62%
硫	3482		11	4	0.0006036%	658334	99.62%	4	1.62%
磅	3483		15	4	0.0006036%	658338	99.62%	4	1.62%
稈	3487		12	4	0.0006036%	658342	99.62%	4	1.62%
窒	3488		11	4	0.0006036%	658346	99.62%	4	1.62%
窺	3489		16	4	0.0006036%	658350	99.62%	4	1.62%
篆	3491		15	4	0.0006036%	658354	99.62%	4	1.62%
籬	3494		25	4	0.0006036%	658358	99.63%	4	1.62%
紊	3495		10	4	0.0006036%	658362	99.63%	4	1.62%
紜	3496		10	4	0.0006036%	658366	99.63%	4	1.62%
紳	3497		11	4	0.0006036%	658370	99.63%	4	1.62%
翌	3499		11	4	0.0006036%	658374	99.63%	4	1.62%
膏	3501		14	4	0.0006036%	658378	99.63%	4	1.62%
膛	3502		15	4	0.0006036%	658382	99.63%	4	1.62%
苑	3509		9	4	0.0006036%	658386	99.64%	4	1.62%
茖	3510		10	4	0.0006036%	658390	99.64%	4	1.62%
葦	3512		13	4	0.0006036%	658394	99.64%	4	1.62%
蕊	3514		16	4	0.0006036%	658398	99.64%	4	1.62%
藩	3517		19	4	0.0006036%	658402	99.64%	4	1.62%
蘸	3518		23	4	0.0006036%	658406	99.64%	4	1.62%
褂	3522		13	4	0.0006036%	658410	99.64%	4	1.62%
褓	3523		14	4	0.0006036%	658414	99.64%	4	1.62%
褸	3525		16	4	0.0006036%	658418	99.65%	4	1.62%
襄	3526		17	4	0.0006036%	658422	99.65%	4	1.62%
襤	3527		19	4	0.0006036%	658426	99.65%	4	1.62%
訧	3529		11	4	0.0006036%	658430	99.65%	4	1.62%
詛	3530		12	4	0.0006036%	658434	99.65%	4	1.62%
誨	3531		14	4	0.0006036%	658438	99.65%	4	1.62%
謗	3532		17	4	0.0006036%	658442	99.65%	4	1.62%
謾	3534		18	4	0.0006036%	658446	99.65%	4	1.62%
譬	3535		20	4	0.0006036%	658450	99.65%	4	1.62%
貯	3536		12	4	0.0006036%	658454	99.65%	4	1.62%
贅	3537		18	4	0.0006036%	658458	99.65%	4	1.62%
跺	3538		13	4	0.0006036%	658462	99.65%	4	1.62%
迂	3542		6	4	0.0006036%	658466	99.66%	4	1.62%
鈍	3545		12	4	0.0006036%	658470	99.66%	4	1.62%
阜	3552		8	4	0.0006036%	658474	99.66%	4	1.62%
雌	3555		14	4	0.0006036%	658478	99.66%	4	1.62%
頰	3557		16	4	0.0006036%	658482	99.66%	4	1.62%
顥	3558		21	4	0.0006036%	658486	99.67%	4	1.62%
鹿	3569		11	4	0.0006036%	658490	99.67%	4	1.62%
齜	3573		21	4	0.0006036%	658494	99.67%	4	1.62%
萱	529		13	265	0.03999%	658759	76.86%	3	1.22%
瀅	1694		18	38	0.005734%	658797	95.67%	3	1.22%
咪	1726		9	36	0.005432%	658833	95.85%	3	1.22%
豹	1836		10	32	0.004829%	658865	96.41%	3	1.22%
腎	1863		12	31	0.004678%	658896	96.54%	3	1.22%
禪	1992		16	26	0.003923%	658922	97.08%	3	1.22%
傣	2122		12	21	0.003169%	658943	97.55%	3	1.22%
芹	2141		8	21	0.003169%	658964	97.61%	3	1.22%
酵	2182		14	20	0.003018%	658984	97.73%	3	1.22%
彤	2198		7	19	0.002867%	659003	97.78%	3	1.22%
欒	2294		23	17	0.002565%	659020	98.04%	3	1.22%
芙	2414		8	15	0.002263%	659035	98.32%	3	1.22%
蓉	2415		14	15	0.002263%	659050	98.33%	3	1.22%
妮	2438		8	14	0.002113%	659064	98.38%	3	1.22%
瘤	2461		15	14	0.002113%	659078	98.43%	3	1.22%
汰	2513		7	13	0.001962%	659091	98.53%	3	1.22%
盔	2656		11	11	0.00166%	659102	98.79%	3	1.22%
蟥	2740		18	10	0.001509%	659112	98.92%	3	1.22%
仕	2758		5	9	0.001358%	659121	98.95%	3	1.22%
嘎	2772		14	9	0.001358%	659130	98.96%	3	1.22%
檬	2792		18	9	0.001358%	659139	98.99%	3	1.22%
檸	2793		18	9	0.001358%	659148	98.99%	3	1.22%
熔	2799		14	9	0.001358%	659157	99.00%	3	1.22%
衍	2825		9	9	0.001358%	659166	99.04%	3	1.22%
麓	2840		19	9	0.001358%	659175	99.06%	3	1.22%
妃	2854		6	8	0.001207%	659183	99.07%	3	1.22%
柜	2873		9	8	0.001207%	659191	99.10%	3	1.22%
确	2890		12	8	0.001207%	659199	99.12%	3	1.22%
緬	2901		15	8	0.001207%	659207	99.13%	3	1.22%
呱	2941		8	7	0.001056%	659214	99.18%	3	1.22%
奎	2952		9	7	0.001056%	659221	99.19%	3	1.22%
氨	2988		10	7	0.001056%	659228	99.23%	3	1.22%
聶	3014		18	7	0.001056%	659235	99.26%	3	1.22%
肪	3017		8	7	0.001056%	659242	99.26%	3	1.22%
茵	3020		10	7	0.001056%	659249	99.26%	3	1.22%
謫	3029		18	7	0.001056%	659256	99.27%	3	1.22%
佼	3051		8	6	0.0009054%	659262	99.29%	3	1.22%
侄	3052		8	6	0.0009054%	659268	99.29%	3	1.22%
傭	3054		13	6	0.0009054%	659274	99.30%	3	1.22%
剁	3056		8	6	0.0009054%	659280	99.30%	3	1.22%
唧	3061		10	6	0.0009054%	659286	99.30%	3	1.22%
娓	3068		10	6	0.0009054%	659292	99.31%	3	1.22%
嫦	3069		14	6	0.0009054%	659298	99.31%	3	1.22%
庶	3074		11	6	0.0009054%	659304	99.31%	3	1.22%
怦	3079		8	6	0.0009054%	659310	99.32%	3	1.22%
栩	3094		10	6	0.0009054%	659316	99.33%	3	1.22%
珊	3110		9	6	0.0009054%	659322	99.35%	3	1.22%
糶	3121		25	6	0.0009054%	659328	99.36%	3	1.22%
苯	3133		9	6	0.0009054%	659334	99.37%	3	1.22%
茸	3134		10	6	0.0009054%	659340	99.37%	3	1.22%
訶	3150		12	6	0.0009054%	659346	99.38%	3	1.22%
咄	3194		8	5	0.0007545%	659351	99.42%	3	1.22%
咦	3197		9	5	0.0007545%	659356	99.42%	3	1.22%
唔	3198		10	5	0.0007545%	659361	99.42%	3	1.22%
喀	3200		12	5	0.0007545%	659366	99.43%	3	1.22%
噢	3206		16	5	0.0007545%	659371	99.43%	3	1.22%
坳	3207		8	5	0.0007545%	659376	99.43%	3	1.22%
孰	3214		11	5	0.0007545%	659381	99.44%	3	1.22%
嶼	3219		17	5	0.0007545%	659386	99.44%	3	1.22%
扉	3233		12	5	0.0007545%	659391	99.45%	3	1.22%
棕	3244		12	5	0.0007545%	659396	99.46%	3	1.22%
楞	3247		13	5	0.0007545%	659401	99.46%	3	1.22%
氈	3250		17	5	0.0007545%	659406	99.46%	3	1.22%
淆	3257		11	5	0.0007545%	659411	99.47%	3	1.22%
潺	3265		15	5	0.0007545%	659416	99.47%	3	1.22%
焊	3268		11	5	0.0007545%	659421	99.48%	3	1.22%
燼	3270		18	5	0.0007545%	659426	99.48%	3	1.22%
猩	3272		12	5	0.0007545%	659431	99.48%	3	1.22%
瘀	3273		13	5	0.0007545%	659436	99.48%	3	1.22%
癖	3275		18	5	0.0007545%	659441	99.48%	3	1.22%
碓	3279		13	5	0.0007545%	659446	99.48%	3	1.22%
磋	3280		15	5	0.0007545%	659451	99.49%	3	1.22%
祿	3282		12	5	0.0007545%	659456	99.49%	3	1.22%
稠	3285		13	5	0.0007545%	659461	99.49%	3	1.22%
窣	3289		13	5	0.0007545%	659466	99.49%	3	1.22%
窸	3292		16	5	0.0007545%	659471	99.49%	3	1.22%
竣	3295		12	5	0.0007545%	659476	99.50%	3	1.22%
簪	3299		18	5	0.0007545%	659481	99.50%	3	1.22%
舜	3313		12	5	0.0007545%	659486	99.51%	3	1.22%
薯	3317		17	5	0.0007545%	659491	99.51%	3	1.22%
蕻	3318		17	5	0.0007545%	659496	99.51%	3	1.22%
蜀	3319		13	5	0.0007545%	659501	99.52%	3	1.22%
蠅	3322		19	5	0.0007545%	659506	99.52%	3	1.22%
訟	3326		11	5	0.0007545%	659511	99.52%	3	1.22%
謢	3329		17	5	0.0007545%	659516	99.52%	3	1.22%
銼	3342		15	5	0.0007545%	659521	99.53%	3	1.22%
韭	3352		9	5	0.0007545%	659526	99.54%	3	1.22%
颯	3355		14	5	0.0007545%	659531	99.54%	3	1.22%
颳	3356		15	5	0.0007545%	659536	99.54%	3	1.22%
馴	3357		13	5	0.0007545%	659541	99.54%	3	1.22%
丙	3360		5	4	0.0006036%	659545	99.55%	3	1.22%
乖	3361		8	4	0.0006036%	659549	99.55%	3	1.22%
亙	3362		6	4	0.0006036%	659553	99.55%	3	1.22%
伽	3364		7	4	0.0006036%	659557	99.55%	3	1.22%
俘	3366		9	4	0.0006036%	659561	99.55%	3	1.22%
匾	3375		11	4	0.0006036%	659565	99.55%	3	1.22%
噥	3383		16	4	0.0006036%	659569	99.56%	3	1.22%
坱	3387		8	4	0.0006036%	659573	99.56%	3	1.22%
墟	3388		15	4	0.0006036%	659577	99.56%	3	1.22%
峨	3401		10	4	0.0006036%	659581	99.57%	3	1.22%
彙	3411		13	4	0.0006036%	659585	99.58%	3	1.22%
徙	3412		11	4	0.0006036%	659589	99.58%	3	1.22%
悒	3418		10	4	0.0006036%	659593	99.58%	3	1.22%
憫	3423		15	4	0.0006036%	659597	99.58%	3	1.22%
憩	3425		16	4	0.0006036%	659601	99.59%	3	1.22%
擲	3434		18	4	0.0006036%	659605	99.59%	3	1.22%
斕	3437		21	4	0.0006036%	659609	99.59%	3	1.22%
曙	3441		17	4	0.0006036%	659613	99.59%	3	1.22%
柚	3443		9	4	0.0006036%	659617	99.60%	3	1.22%
楹	3445		13	4	0.0006036%	659621	99.60%	3	1.22%
櫻	3451		21	4	0.0006036%	659625	99.60%	3	1.22%
毋	3452		4	4	0.0006036%	659629	99.60%	3	1.22%
汝	3454		6	4	0.0006036%	659633	99.60%	3	1.22%
泌	3455		8	4	0.0006036%	659637	99.60%	3	1.22%
泯	3456		8	4	0.0006036%	659641	99.60%	3	1.22%
淅	3459		11	4	0.0006036%	659645	99.61%	3	1.22%
漩	3463		14	4	0.0006036%	659649	99.61%	3	1.22%
炳	3465		9	4	0.0006036%	659653	99.61%	3	1.22%
猾	3469		13	4	0.0006036%	659657	99.61%	3	1.22%
玨	3471		8	4	0.0006036%	659661	99.61%	3	1.22%
痰	3477		13	4	0.0006036%	659665	99.62%	3	1.22%
瘸	3479		16	4	0.0006036%	659669	99.62%	3	1.22%
磯	3484		17	4	0.0006036%	659673	99.62%	3	1.22%
祟	3485		10	4	0.0006036%	659677	99.62%	3	1.22%
簧	3492		18	4	0.0006036%	659681	99.63%	3	1.22%
簿	3493		19	4	0.0006036%	659685	99.63%	3	1.22%
艘	3503		15	4	0.0006036%	659689	99.63%	3	1.22%
芭	3505		8	4	0.0006036%	659693	99.63%	3	1.22%
芥	3506		8	4	0.0006036%	659697	99.63%	3	1.22%
茬	3511		10	4	0.0006036%	659701	99.64%	3	1.22%
蕪	3516		16	4	0.0006036%	659705	99.64%	3	1.22%
蟄	3521		17	4	0.0006036%	659709	99.64%	3	1.22%
褥	3524		15	4	0.0006036%	659713	99.64%	3	1.22%
訥	3528		11	4	0.0006036%	659717	99.65%	3	1.22%
蹌	3539		17	4	0.0006036%	659721	99.65%	3	1.22%
轆	3541		18	4	0.0006036%	659725	99.66%	3	1.22%
釅	3544		27	4	0.0006036%	659729	99.66%	3	1.22%
鋤	3548		15	4	0.0006036%	659733	99.66%	3	1.22%
錳	3549		16	4	0.0006036%	659737	99.66%	3	1.22%
鎬	3550		18	4	0.0006036%	659741	99.66%	3	1.22%
鑿	3551		28	4	0.0006036%	659745	99.66%	3	1.22%
隧	3554		15	4	0.0006036%	659749	99.66%	3	1.22%
駭	3560		16	4	0.0006036%	659753	99.67%	3	1.22%
騁	3561		17	4	0.0006036%	659757	99.67%	3	1.22%
驥	3562		26	4	0.0006036%	659761	99.67%	3	1.22%
鯊	3565		18	4	0.0006036%	659765	99.67%	3	1.22%
鶢	3567		20	4	0.0006036%	659769	99.67%	3	1.22%
鹹	3568		20	4	0.0006036%	659773	99.67%	3	1.22%
黔	3570		16	4	0.0006036%	659777	99.67%	3	1.22%
齋	3571		17	4	0.0006036%	659781	99.67%	3	1.22%
齣	3572		20	4	0.0006036%	659785	99.67%	3	1.22%
佃	3574		7	3	0.0004527%	659788	99.67%	3	1.22%
体	3575		7	3	0.0004527%	659791	99.68%	3	1.22%
俏	3577		9	3	0.0004527%	659794	99.68%	3	1.22%
偌	3578		11	3	0.0004527%	659797	99.68%	3	1.22%
偎	3579		11	3	0.0004527%	659800	99.68%	3	1.22%
偕	3580		11	3	0.0004527%	659803	99.68%	3	1.22%
倏	3581		11	3	0.0004527%	659806	99.68%	3	1.22%
儼	3582		22	3	0.0004527%	659809	99.68%	3	1.22%
冗	3583		4	3	0.0004527%	659812	99.68%	3	1.22%
函	3585		8	3	0.0004527%	659815	99.68%	3	1.22%
剿	3587		13	3	0.0004527%	659818	99.68%	3	1.22%
勛	3588		12	3	0.0004527%	659821	99.68%	3	1.22%
吝	3590		7	3	0.0004527%	659824	99.68%	3	1.22%
咀	3591		8	3	0.0004527%	659827	99.68%	3	1.22%
咎	3593		8	3	0.0004527%	659830	99.68%	3	1.22%
咫	3595		9	3	0.0004527%	659833	99.68%	3	1.22%
嗇	3599		13	3	0.0004527%	659836	99.69%	3	1.22%
嗅	3601		13	3	0.0004527%	659839	99.69%	3	1.22%
嗆	3602		13	3	0.0004527%	659842	99.69%	3	1.22%
嘍	3603		14	3	0.0004527%	659845	99.69%	3	1.22%
噓	3605		15	3	0.0004527%	659848	99.69%	3	1.22%
圃	3608		10	3	0.0004527%	659851	99.69%	3	1.22%
复	3613		9	3	0.0004527%	659854	99.69%	3	1.22%
奚	3614		10	3	0.0004527%	659857	99.69%	3	1.22%
妊	3615		7	3	0.0004527%	659860	99.69%	3	1.22%
姚	3616		9	3	0.0004527%	659863	99.69%	3	1.22%
娑	3617		10	3	0.0004527%	659866	99.69%	3	1.22%
娠	3618		10	3	0.0004527%	659869	99.69%	3	1.22%
婿	3620		12	3	0.0004527%	659872	99.70%	3	1.22%
嫣	3621		14	3	0.0004527%	659875	99.70%	3	1.22%
崢	3626		11	3	0.0004527%	659878	99.70%	3	1.22%
嶇	3627		14	3	0.0004527%	659881	99.70%	3	1.22%
嶸	3628		17	3	0.0004527%	659884	99.70%	3	1.22%
彊	3630		16	3	0.0004527%	659887	99.70%	3	1.22%
徨	3632		12	3	0.0004527%	659890	99.70%	3	1.22%
怵	3633		8	3	0.0004527%	659893	99.70%	3	1.22%
怠	3634		9	3	0.0004527%	659896	99.70%	3	1.22%
恙	3635		10	3	0.0004527%	659899	99.70%	3	1.22%
恕	3636		10	3	0.0004527%	659902	99.70%	3	1.22%
恿	3637		11	3	0.0004527%	659905	99.70%	3	1.22%
惦	3638		11	3	0.0004527%	659908	99.70%	3	1.22%
慄	3639		13	3	0.0004527%	659911	99.70%	3	1.22%
慫	3640		15	3	0.0004527%	659914	99.70%	3	1.22%
憬	3641		15	3	0.0004527%	659917	99.71%	3	1.22%
懦	3642		17	3	0.0004527%	659920	99.71%	3	1.22%
抉	3644		7	3	0.0004527%	659923	99.71%	3	1.22%
扳	3645		7	3	0.0004527%	659926	99.71%	3	1.22%
拗	3647		8	3	0.0004527%	659929	99.71%	3	1.22%
捻	3652		11	3	0.0004527%	659932	99.71%	3	1.22%
捺	3653		11	3	0.0004527%	659935	99.71%	3	1.22%
捶	3654		12	3	0.0004527%	659938	99.71%	3	1.22%
搪	3655		13	3	0.0004527%	659941	99.71%	3	1.22%
摁	3656		13	3	0.0004527%	659944	99.71%	3	1.22%
撩	3658		15	3	0.0004527%	659947	99.71%	3	1.22%
攣	3660		23	3	0.0004527%	659950	99.71%	3	1.22%
敷	3662		15	3	0.0004527%	659953	99.71%	3	1.22%
暄	3663		13	3	0.0004527%	659956	99.72%	3	1.22%
曇	3664		16	3	0.0004527%	659959	99.72%	3	1.22%
梓	3669		11	3	0.0004527%	659962	99.72%	3	1.22%
楣	3672		13	3	0.0004527%	659965	99.72%	3	1.22%
槓	3674		14	3	0.0004527%	659968	99.72%	3	1.22%
榷	3675		14	3	0.0004527%	659971	99.72%	3	1.22%
橘	3679		16	3	0.0004527%	659974	99.72%	3	1.22%
檯	3681		18	3	0.0004527%	659977	99.72%	3	1.22%
殃	3682		9	3	0.0004527%	659980	99.72%	3	1.22%
殉	3683		10	3	0.0004527%	659983	99.72%	3	1.22%
泓	3686		8	3	0.0004527%	659986	99.73%	3	1.22%
沓	3687		8	3	0.0004527%	659989	99.73%	3	1.22%
洌	3689		9	3	0.0004527%	659992	99.73%	3	1.22%
浦	3690		10	3	0.0004527%	659995	99.73%	3	1.22%
浹	3692		10	3	0.0004527%	659998	99.73%	3	1.22%
渝	3694		12	3	0.0004527%	660001	99.73%	3	1.22%
溉	3695		12	3	0.0004527%	660004	99.73%	3	1.22%
漬	3698		14	3	0.0004527%	660007	99.73%	3	1.22%
漣	3699		14	3	0.0004527%	660010	99.73%	3	1.22%
漪	3700		14	3	0.0004527%	660013	99.73%	3	1.22%
滌	3701		14	3	0.0004527%	660016	99.73%	3	1.22%
濡	3703		17	3	0.0004527%	660019	99.73%	3	1.22%
瀏	3704		18	3	0.0004527%	660022	99.73%	3	1.22%
焚	3707		12	3	0.0004527%	660025	99.74%	3	1.22%
煽	3708		14	3	0.0004527%	660028	99.74%	3	1.22%
熾	3709		16	3	0.0004527%	660031	99.74%	3	1.22%
燎	3710		16	3	0.0004527%	660034	99.74%	3	1.22%
爵	3711		17	3	0.0004527%	660037	99.74%	3	1.22%
犢	3712		19	3	0.0004527%	660040	99.74%	3	1.22%
猖	3713		11	3	0.0004527%	660043	99.74%	3	1.22%
瑯	3714		13	3	0.0004527%	660046	99.74%	3	1.22%
瑕	3715		13	3	0.0004527%	660049	99.74%	3	1.22%
瓢	3717		16	3	0.0004527%	660052	99.74%	3	1.22%
甭	3718		9	3	0.0004527%	660055	99.74%	3	1.22%
痢	3719		12	3	0.0004527%	660058	99.74%	3	1.22%
瘟	3721		15	3	0.0004527%	660061	99.74%	3	1.22%
皖	3723		12	3	0.0004527%	660064	99.74%	3	1.22%
盎	3724		10	3	0.0004527%	660067	99.74%	3	1.22%
眩	3725		10	3	0.0004527%	660070	99.74%	3	1.22%
睫	3726		13	3	0.0004527%	660073	99.74%	3	1.22%
睞	3727		13	3	0.0004527%	660076	99.74%	3	1.22%
睿	3728		14	3	0.0004527%	660079	99.74%	3	1.22%
瞑	3730		15	3	0.0004527%	660082	99.75%	3	1.22%
瞟	3731		16	3	0.0004527%	660085	99.75%	3	1.22%
瞼	3733		18	3	0.0004527%	660088	99.75%	3	1.22%
矢	3734		5	3	0.0004527%	660091	99.75%	3	1.22%
砰	3735		10	3	0.0004527%	660094	99.75%	3	1.22%
礪	3738		20	3	0.0004527%	660097	99.75%	3	1.22%
穢	3741		18	3	0.0004527%	660100	99.75%	3	1.22%
窈	3742		10	3	0.0004527%	660103	99.75%	3	1.22%
窕	3743		11	3	0.0004527%	660106	99.75%	3	1.22%
窠	3744		13	3	0.0004527%	660109	99.75%	3	1.22%
窿	3745		17	3	0.0004527%	660112	99.75%	3	1.22%
絆	3751		11	3	0.0004527%	660115	99.75%	3	1.22%
絞	3752		12	3	0.0004527%	660118	99.76%	3	1.22%
綸	3753		14	3	0.0004527%	660121	99.76%	3	1.22%
綹	3754		14	3	0.0004527%	660124	99.76%	3	1.22%
繹	3755		19	3	0.0004527%	660127	99.76%	3	1.22%
纂	3756		20	3	0.0004527%	660130	99.76%	3	1.22%
羈	3759		24	3	0.0004527%	660133	99.76%	3	1.22%
翎	3761		11	3	0.0004527%	660136	99.76%	3	1.22%
肋	3762		6	3	0.0004527%	660139	99.76%	3	1.22%
舷	3764		11	3	0.0004527%	660142	99.76%	3	1.22%
舶	3765		11	3	0.0004527%	660145	99.76%	3	1.22%
芯	3766		8	3	0.0004527%	660148	99.76%	3	1.22%
莖	3768		11	3	0.0004527%	660151	99.76%	3	1.22%
蒲	3772		14	3	0.0004527%	660154	99.76%	3	1.22%
蕾	3773		17	3	0.0004527%	660157	99.76%	3	1.22%
蘚	3776		21	3	0.0004527%	660160	99.77%	3	1.22%
蚕	3778		10	3	0.0004527%	660163	99.77%	3	1.22%
蛻	3781		13	3	0.0004527%	660166	99.77%	3	1.22%
襁	3785		16	3	0.0004527%	660169	99.77%	3	1.22%
訛	3786		11	3	0.0004527%	660172	99.77%	3	1.22%
詮	3788		13	3	0.0004527%	660175	99.77%	3	1.22%
誣	3789		14	3	0.0004527%	660178	99.77%	3	1.22%
誹	3790		15	3	0.0004527%	660181	99.77%	3	1.22%
諺	3791		16	3	0.0004527%	660184	99.77%	3	1.22%
踞	3794		15	3	0.0004527%	660187	99.77%	3	1.22%
踱	3795		16	3	0.0004527%	660190	99.77%	3	1.22%
蹩	3797		18	3	0.0004527%	660193	99.78%	3	1.22%
躇	3798		19	3	0.0004527%	660196	99.78%	3	1.22%
躊	3799		21	3	0.0004527%	660199	99.78%	3	1.22%
轅	3801		17	3	0.0004527%	660202	99.78%	3	1.22%
迆	3802		6	3	0.0004527%	660205	99.78%	3	1.22%
遛	3803		13	3	0.0004527%	660208	99.78%	3	1.22%
鉀	3806		13	3	0.0004527%	660211	99.78%	3	1.22%
銹	3808		15	3	0.0004527%	660214	99.78%	3	1.22%
錐	3809		16	3	0.0004527%	660217	99.78%	3	1.22%
鑲	3812		25	3	0.0004527%	660220	99.78%	3	1.22%
閂	3813		9	3	0.0004527%	660223	99.78%	3	1.22%
阱	3815		6	3	0.0004527%	660226	99.78%	3	1.22%
隅	3817		11	3	0.0004527%	660229	99.78%	3	1.22%
陲	3818		11	3	0.0004527%	660232	99.79%	3	1.22%
鞍	3820		15	3	0.0004527%	660235	99.79%	3	1.22%
頷	3821		16	3	0.0004527%	660238	99.79%	3	1.22%
飢	3823		10	3	0.0004527%	660241	99.79%	3	1.22%
饅	3824		19	3	0.0004527%	660244	99.79%	3	1.22%
鱔	3826		23	3	0.0004527%	660247	99.79%	3	1.22%
鷺	3830		24	3	0.0004527%	660250	99.79%	3	1.22%
鼾	3831		17	3	0.0004527%	660253	99.79%	3	1.22%
粱	1640		13	41	0.006187%	660294	95.35%	2	0.81%
闆	1786		17	34	0.005131%	660328	96.17%	2	0.81%
鸝	1787		30	34	0.005131%	660362	96.17%	2	0.81%
桓	2205		10	19	0.002867%	660381	97.80%	2	0.81%
締	2470		15	14	0.002113%	660395	98.45%	2	0.81%
螂	2475		15	14	0.002113%	660409	98.46%	2	0.81%
螃	2476		16	14	0.002113%	660423	98.46%	2	0.81%
崔	2501		11	13	0.001962%	660436	98.51%	2	0.81%
諭	2742		16	10	0.001509%	660446	98.92%	2	0.81%
沅	2794		7	9	0.001358%	660455	98.99%	2	0.81%
纜	2815		27	9	0.001358%	660464	99.02%	2	0.81%
錮	2832		16	9	0.001358%	660473	99.05%	2	0.81%
埔	2851		10	8	0.001207%	660481	99.07%	2	0.81%
玡	2885		8	8	0.001207%	660489	99.11%	2	0.81%
硯	2889		12	8	0.001207%	660497	99.12%	2	0.81%
愷	2961		13	7	0.001056%	660504	99.20%	2	0.81%
瞌	3003		15	7	0.001056%	660511	99.24%	2	0.81%
椎	3096		12	6	0.0009054%	660517	99.33%	2	0.81%
皓	3115		12	6	0.0009054%	660523	99.35%	2	0.81%
秤	3118		10	6	0.0009054%	660529	99.35%	2	0.81%
竺	3119		8	6	0.0009054%	660535	99.36%	2	0.81%
錚	3166		16	6	0.0009054%	660541	99.40%	2	0.81%
鬲	3173		10	6	0.0009054%	660547	99.40%	2	0.81%
俞	3186		9	5	0.0007545%	660552	99.41%	2	0.81%
剜	3191		10	5	0.0007545%	660557	99.42%	2	0.81%
巳	3220		3	5	0.0007545%	660562	99.44%	2	0.81%
栓	3241		10	5	0.0007545%	660567	99.46%	2	0.81%
棠	3245		12	5	0.0007545%	660572	99.46%	2	0.81%
氫	3251		11	5	0.0007545%	660577	99.46%	2	0.81%
淄	3258		11	5	0.0007545%	660582	99.47%	2	0.81%
竇	3294		20	5	0.0007545%	660587	99.50%	2	0.81%
胺	3310		10	5	0.0007545%	660592	99.51%	2	0.81%
釉	3340		13	5	0.0007545%	660597	99.53%	2	0.81%
韋	3351		9	5	0.0007545%	660602	99.54%	2	0.81%
駿	3358		17	5	0.0007545%	660607	99.54%	2	0.81%
兢	3370		14	4	0.0006036%	660611	99.55%	2	0.81%
匝	3372		5	4	0.0006036%	660615	99.55%	2	0.81%
匣	3373		7	4	0.0006036%	660619	99.55%	2	0.81%
嗷	3381		14	4	0.0006036%	660623	99.56%	2	0.81%
噠	3384		16	4	0.0006036%	660627	99.56%	2	0.81%
壩	3389		24	4	0.0006036%	660631	99.56%	2	0.81%
姍	3391		8	4	0.0006036%	660635	99.56%	2	0.81%
妲	3392		8	4	0.0006036%	660639	99.57%	2	0.81%
姬	3393		10	4	0.0006036%	660643	99.57%	2	0.81%
嫵	3395		15	4	0.0006036%	660647	99.57%	2	0.81%
嬸	3396		18	4	0.0006036%	660651	99.57%	2	0.81%
尉	3399		11	4	0.0006036%	660655	99.57%	2	0.81%
嶗	3403		15	4	0.0006036%	660659	99.57%	2	0.81%
巉	3404		20	4	0.0006036%	660663	99.57%	2	0.81%
廖	3408		14	4	0.0006036%	660667	99.57%	2	0.81%
怏	3413		8	4	0.0006036%	660671	99.58%	2	0.81%
悻	3420		11	4	0.0006036%	660675	99.58%	2	0.81%
惴	3422		12	4	0.0006036%	660679	99.58%	2	0.81%
戎	3427		6	4	0.0006036%	660683	99.59%	2	0.81%
斡	3438		14	4	0.0006036%	660687	99.59%	2	0.81%
朔	3442		10	4	0.0006036%	660691	99.60%	2	0.81%
楝	3446		13	4	0.0006036%	660695	99.60%	2	0.81%
槽	3447		15	4	0.0006036%	660699	99.60%	2	0.81%
槳	3448		15	4	0.0006036%	660703	99.60%	2	0.81%
樺	3449		16	4	0.0006036%	660707	99.60%	2	0.81%
涔	3457		10	4	0.0006036%	660711	99.60%	2	0.81%
熠	3468		15	4	0.0006036%	660715	99.61%	2	0.81%
疤	3474		9	4	0.0006036%	660719	99.61%	2	0.81%
禹	3486		9	4	0.0006036%	660723	99.62%	2	0.81%
腆	3500		12	4	0.0006036%	660727	99.63%	2	0.81%
茄	3508		9	4	0.0006036%	660731	99.64%	2	0.81%
葫	3513		13	4	0.0006036%	660735	99.64%	2	0.81%
謨	3533		18	4	0.0006036%	660739	99.65%	2	0.81%
迢	3543		8	4	0.0006036%	660743	99.66%	2	0.81%
鈦	3546		12	4	0.0006036%	660747	99.66%	2	0.81%
鉤	3547		13	4	0.0006036%	660751	99.66%	2	0.81%
隕	3553		12	4	0.0006036%	660755	99.66%	2	0.81%
霏	3556		16	4	0.0006036%	660759	99.66%	2	0.81%
骸	3563		16	4	0.0006036%	660763	99.67%	2	0.81%
鮑	3564		16	4	0.0006036%	660767	99.67%	2	0.81%
几	3584		2	3	0.0004527%	660770	99.68%	2	0.81%
剌	3586		9	3	0.0004527%	660773	99.68%	2	0.81%
匡	3589		6	3	0.0004527%	660776	99.68%	2	0.81%
呷	3592		8	3	0.0004527%	660779	99.68%	2	0.81%
啶	3597		11	3	0.0004527%	660782	99.69%	2	0.81%
嗨	3598		13	3	0.0004527%	660785	99.69%	2	0.81%
嗤	3600		13	3	0.0004527%	660788	99.69%	2	0.81%
嗶	3604		14	3	0.0004527%	660791	99.69%	2	0.81%
嚀	3606		17	3	0.0004527%	660794	99.69%	2	0.81%
囀	3607		21	3	0.0004527%	660797	99.69%	2	0.81%
圪	3609		6	3	0.0004527%	660800	99.69%	2	0.81%
坯	3610		8	3	0.0004527%	660803	99.69%	2	0.81%
尹	3622		4	3	0.0004527%	660806	99.70%	2	0.81%
屐	3623		10	3	0.0004527%	660809	99.70%	2	0.81%
幛	3629		14	3	0.0004527%	660812	99.70%	2	0.81%
拄	3646		8	3	0.0004527%	660815	99.71%	2	0.81%
拭	3648		9	3	0.0004527%	660818	99.71%	2	0.81%
拷	3649		9	3	0.0004527%	660821	99.71%	2	0.81%
挈	3650		10	3	0.0004527%	660824	99.71%	2	0.81%
掖	3651		11	3	0.0004527%	660827	99.71%	2	0.81%
搧	3657		13	3	0.0004527%	660830	99.71%	2	0.81%
攢	3659		22	3	0.0004527%	660833	99.71%	2	0.81%
攥	3661		23	3	0.0004527%	660836	99.71%	2	0.81%
杞	3665		7	3	0.0004527%	660839	99.72%	2	0.81%
枸	3667		9	3	0.0004527%	660842	99.72%	2	0.81%
梱	3670		11	3	0.0004527%	660845	99.72%	2	0.81%
梆	3671		11	3	0.0004527%	660848	99.72%	2	0.81%
槁	3673		14	3	0.0004527%	660851	99.72%	2	0.81%
榴	3676		14	3	0.0004527%	660854	99.72%	2	0.81%
樟	3677		15	3	0.0004527%	660857	99.72%	2	0.81%
樊	3678		15	3	0.0004527%	660860	99.72%	2	0.81%
檀	3680		17	3	0.0004527%	660863	99.72%	2	0.81%
汔	3684		6	3	0.0004527%	660866	99.72%	2	0.81%
沆	3685		7	3	0.0004527%	660869	99.73%	2	0.81%
泒	3688		8	3	0.0004527%	660872	99.73%	2	0.81%
涓	3691		10	3	0.0004527%	660875	99.73%	2	0.81%
渤	3693		12	3	0.0004527%	660878	99.73%	2	0.81%
濯	3702		17	3	0.0004527%	660881	99.73%	2	0.81%
瀝	3705		19	3	0.0004527%	660884	99.73%	2	0.81%
烹	3706		11	3	0.0004527%	660887	99.73%	2	0.81%
瑤	3716		14	3	0.0004527%	660890	99.74%	2	0.81%
瘍	3720		14	3	0.0004527%	660893	99.74%	2	0.81%
癆	3722		17	3	0.0004527%	660896	99.74%	2	0.81%
瞇	3729		15	3	0.0004527%	660899	99.74%	2	0.81%
碾	3736		15	3	0.0004527%	660902	99.75%	2	0.81%
磺	3737		17	3	0.0004527%	660905	99.75%	2	0.81%
祁	3739		7	3	0.0004527%	660908	99.75%	2	0.81%
笠	3746		11	3	0.0004527%	660911	99.75%	2	0.81%
籤	3747		23	3	0.0004527%	660914	99.75%	2	0.81%
糯	3750		20	3	0.0004527%	660917	99.75%	2	0.81%
纔	3757		23	3	0.0004527%	660920	99.76%	2	0.81%
罹	3758		16	3	0.0004527%	660923	99.76%	2	0.81%
羥	3760		13	3	0.0004527%	660926	99.76%	2	0.81%
莧	3770		11	3	0.0004527%	660929	99.76%	2	0.81%
薇	3774		17	3	0.0004527%	660932	99.77%	2	0.81%
藐	3775		18	3	0.0004527%	660935	99.77%	2	0.81%
蛹	3780		13	3	0.0004527%	660938	99.77%	2	0.81%
蝠	3782		15	3	0.0004527%	660941	99.77%	2	0.81%
蝙	3783		15	3	0.0004527%	660944	99.77%	2	0.81%
蠋	3784		19	3	0.0004527%	660947	99.77%	2	0.81%
詠	3787		12	3	0.0004527%	660950	99.77%	2	0.81%
赭	3793		15	3	0.0004527%	660953	99.77%	2	0.81%
蹋	3796		17	3	0.0004527%	660956	99.78%	2	0.81%
輒	3800		14	3	0.0004527%	660959	99.78%	2	0.81%
鈕	3804		12	3	0.0004527%	660962	99.78%	2	0.81%
鈉	3805		12	3	0.0004527%	660965	99.78%	2	0.81%
閡	3814		14	3	0.0004527%	660968	99.78%	2	0.81%
阪	3816		6	3	0.0004527%	660971	99.78%	2	0.81%
雹	3819		13	3	0.0004527%	660974	99.79%	2	0.81%
顒	3822		18	3	0.0004527%	660977	99.79%	2	0.81%
驃	3825		21	3	0.0004527%	660980	99.79%	2	0.81%
鴦	3827		16	3	0.0004527%	660983	99.79%	2	0.81%
鴛	3828		16	3	0.0004527%	660986	99.79%	2	0.81%
鶯	3829		21	3	0.0004527%	660989	99.79%	2	0.81%
乇	3833		3	2	0.0003018%	660991	99.79%	2	0.81%
亥	3834		6	2	0.0003018%	660993	99.79%	2	0.81%
仨	3835		5	2	0.0003018%	660995	99.79%	2	0.81%
伢	3836		6	2	0.0003018%	660997	99.79%	2	0.81%
佣	3837		7	2	0.0003018%	660999	99.79%	2	0.81%
侈	3838		8	2	0.0003018%	661001	99.79%	2	0.81%
侖	3839		8	2	0.0003018%	661003	99.79%	2	0.81%
俑	3840		9	2	0.0003018%	661005	99.79%	2	0.81%
俐	3841		9	2	0.0003018%	661007	99.79%	2	0.81%
倩	3842		10	2	0.0003018%	661009	99.79%	2	0.81%
倖	3843		10	2	0.0003018%	661011	99.79%	2	0.81%
偑	3844		11	2	0.0003018%	661013	99.80%	2	0.81%
儷	3847		21	2	0.0003018%	661015	99.80%	2	0.81%
凰	3848		11	2	0.0003018%	661017	99.80%	2	0.81%
刁	3849		2	2	0.0003018%	661019	99.80%	2	0.81%
刪	3850		7	2	0.0003018%	661021	99.80%	2	0.81%
刨	3851		7	2	0.0003018%	661023	99.80%	2	0.81%
募	3853		13	2	0.0003018%	661025	99.80%	2	0.81%
匈	3854		6	2	0.0003018%	661027	99.80%	2	0.81%
吩	3855		7	2	0.0003018%	661029	99.80%	2	0.81%
唆	3856		10	2	0.0003018%	661031	99.80%	2	0.81%
唏	3857		10	2	0.0003018%	661033	99.80%	2	0.81%
唄	3858		10	2	0.0003018%	661035	99.80%	2	0.81%
啣	3860		11	2	0.0003018%	661037	99.80%	2	0.81%
啁	3861		11	2	0.0003018%	661039	99.80%	2	0.81%
啐	3862		11	2	0.0003018%	661041	99.80%	2	0.81%
啻	3864		12	2	0.0003018%	661043	99.80%	2	0.81%
喔	3865		12	2	0.0003018%	661045	99.80%	2	0.81%
啾	3867		12	2	0.0003018%	661047	99.80%	2	0.81%
喑	3868		12	2	0.0003018%	661049	99.80%	2	0.81%
嗡	3869		13	2	0.0003018%	661051	99.80%	2	0.81%
嗩	3870		13	2	0.0003018%	661053	99.80%	2	0.81%
噘	3872		15	2	0.0003018%	661055	99.80%	2	0.81%
坤	3879		8	2	0.0003018%	661057	99.81%	2	0.81%
塢	3882		13	2	0.0003018%	661059	99.81%	2	0.81%
塾	3883		14	2	0.0003018%	661061	99.81%	2	0.81%
墥	3884		15	2	0.0003018%	661063	99.81%	2	0.81%
夙	3885		6	2	0.0003018%	661065	99.81%	2	0.81%
妍	3887		7	2	0.0003018%	661067	99.81%	2	0.81%
娩	3889		10	2	0.0003018%	661069	99.81%	2	0.81%
娼	3890		11	2	0.0003018%	661071	99.81%	2	0.81%
媧	3891		12	2	0.0003018%	661073	99.81%	2	0.81%
孀	3893		20	2	0.0003018%	661075	99.81%	2	0.81%
孬	3894		10	2	0.0003018%	661077	99.81%	2	0.81%
宦	3895		9	2	0.0003018%	661079	99.81%	2	0.81%
尸	3896		3	2	0.0003018%	661081	99.81%	2	0.81%
岐	3898		7	2	0.0003018%	661083	99.81%	2	0.81%
帖	3903		8	2	0.0003018%	661085	99.81%	2	0.81%
帙	3905		8	2	0.0003018%	661087	99.81%	2	0.81%
帷	3906		11	2	0.0003018%	661089	99.81%	2	0.81%
幄	3907		12	2	0.0003018%	661091	99.81%	2	0.81%
幡	3908		15	2	0.0003018%	661093	99.81%	2	0.81%
庇	3909		7	2	0.0003018%	661095	99.81%	2	0.81%
庚	3910		8	2	0.0003018%	661097	99.81%	2	0.81%
廾	3911		3	2	0.0003018%	661099	99.82%	2	0.81%
弔	3912		4	2	0.0003018%	661101	99.82%	2	0.81%
弩	3913		8	2	0.0003018%	661103	99.82%	2	0.81%
徇	3914		9	2	0.0003018%	661105	99.82%	2	0.81%
徬	3915		13	2	0.0003018%	661107	99.82%	2	0.81%
忿	3917		8	2	0.0003018%	661109	99.82%	2	0.81%
怡	3918		8	2	0.0003018%	661111	99.82%	2	0.81%
恃	3919		9	2	0.0003018%	661113	99.82%	2	0.81%
恪	3920		9	2	0.0003018%	661115	99.82%	2	0.81%
恣	3921		10	2	0.0003018%	661117	99.82%	2	0.81%
恁	3922		10	2	0.0003018%	661119	99.82%	2	0.81%
惊	3923		11	2	0.0003018%	661121	99.82%	2	0.81%
愎	3925		12	2	0.0003018%	661123	99.82%	2	0.81%
愾	3926		13	2	0.0003018%	661125	99.82%	2	0.81%
憧	3927		15	2	0.0003018%	661127	99.82%	2	0.81%
懅	3928		16	2	0.0003018%	661129	99.82%	2	0.81%
懵	3929		19	2	0.0003018%	661131	99.82%	2	0.81%
懾	3930		21	2	0.0003018%	661133	99.82%	2	0.81%
戕	3931		8	2	0.0003018%	661135	99.82%	2	0.81%
抔	3932		7	2	0.0003018%	661137	99.82%	2	0.81%
捅	3933		10	2	0.0003018%	661139	99.82%	2	0.81%
掣	3935		12	2	0.0003018%	661141	99.82%	2	0.81%
揖	3936		12	2	0.0003018%	661143	99.82%	2	0.81%
摒	3937		12	2	0.0003018%	661145	99.82%	2	0.81%
揶	3938		12	2	0.0003018%	661147	99.82%	2	0.81%
揄	3939		12	2	0.0003018%	661149	99.82%	2	0.81%
撂	3940		14	2	0.0003018%	661151	99.82%	2	0.81%
敖	3942		11	2	0.0003018%	661153	99.82%	2	0.81%
斃	3943		17	2	0.0003018%	661155	99.82%	2	0.81%
旭	3944		6	2	0.0003018%	661157	99.83%	2	0.81%
晏	3945		10	2	0.0003018%	661159	99.83%	2	0.81%
曖	3946		17	2	0.0003018%	661161	99.83%	2	0.81%
胦	3948		9	2	0.0003018%	661163	99.83%	2	0.81%
杅	3950		7	2	0.0003018%	661165	99.83%	2	0.81%
枉	3951		8	2	0.0003018%	661167	99.83%	2	0.81%
柬	3952		9	2	0.0003018%	661169	99.83%	2	0.81%
桀	3954		10	2	0.0003018%	661171	99.83%	2	0.81%
榆	3957		13	2	0.0003018%	661173	99.83%	2	0.81%
楂	3959		13	2	0.0003018%	661175	99.83%	2	0.81%
棰	3960		13	2	0.0003018%	661177	99.83%	2	0.81%
榛	3961		14	2	0.0003018%	661179	99.83%	2	0.81%
榭	3962		14	2	0.0003018%	661181	99.83%	2	0.81%
樵	3963		16	2	0.0003018%	661183	99.83%	2	0.81%
櫛	3964		17	2	0.0003018%	661185	99.83%	2	0.81%
檻	3965		18	2	0.0003018%	661187	99.83%	2	0.81%
欞	3966		28	2	0.0003018%	661189	99.83%	2	0.81%
氤	3969		10	2	0.0003018%	661191	99.83%	2	0.81%
氮	3970		12	2	0.0003018%	661193	99.83%	2	0.81%
氳	3971		14	2	0.0003018%	661195	99.83%	2	0.81%
汐	3972		6	2	0.0003018%	661197	99.83%	2	0.81%
沁	3973		7	2	0.0003018%	661199	99.83%	2	0.81%
沂	3974		7	2	0.0003018%	661201	99.83%	2	0.81%
泠	3976		8	2	0.0003018%	661203	99.83%	2	0.81%
洁	3977		9	2	0.0003018%	661205	99.84%	2	0.81%
涮	3979		11	2	0.0003018%	661207	99.84%	2	0.81%
湎	3980		12	2	0.0003018%	661209	99.84%	2	0.81%
澗	3981		15	2	0.0003018%	661211	99.84%	2	0.81%
濮	3983		17	2	0.0003018%	661213	99.84%	2	0.81%
瀘	3985		19	2	0.0003018%	661215	99.84%	2	0.81%
炖	3986		8	2	0.0003018%	661217	99.84%	2	0.81%
烙	3988		10	2	0.0003018%	661219	99.84%	2	0.81%
牟	3992		6	2	0.0003018%	661221	99.84%	2	0.81%
牡	3993		7	2	0.0003018%	661223	99.84%	2	0.81%
犀	3994		12	2	0.0003018%	661225	99.84%	2	0.81%
狽	3995		10	2	0.0003018%	661227	99.84%	2	0.81%
狸	3996		10	2	0.0003018%	661229	99.84%	2	0.81%
猙	3997		11	2	0.0003018%	661231	99.84%	2	0.81%
猝	3998		11	2	0.0003018%	661233	99.84%	2	0.81%
猿	3999		13	2	0.0003018%	661235	99.84%	2	0.81%
獗	4000		15	2	0.0003018%	661237	99.84%	2	0.81%
獰	4001		17	2	0.0003018%	661239	99.84%	2	0.81%
珀	4004		9	2	0.0003018%	661241	99.84%	2	0.81%
琉	4005		10	2	0.0003018%	661243	99.84%	2	0.81%
琥	4007		12	2	0.0003018%	661245	99.84%	2	0.81%
琵	4008		12	2	0.0003018%	661247	99.84%	2	0.81%
琶	4009		12	2	0.0003018%	661249	99.84%	2	0.81%
璜	4010		16	2	0.0003018%	661251	99.85%	2	0.81%
璨	4011		17	2	0.0003018%	661253	99.85%	2	0.81%
瓏	4013		20	2	0.0003018%	661255	99.85%	2	0.81%
甄	4014		14	2	0.0003018%	661257	99.85%	2	0.81%
甥	4015		12	2	0.0003018%	661259	99.85%	2	0.81%
甫	4016		7	2	0.0003018%	661261	99.85%	2	0.81%
痍	4017		11	2	0.0003018%	661263	99.85%	2	0.81%
痒	4018		11	2	0.0003018%	661265	99.85%	2	0.81%
瘁	4019		13	2	0.0003018%	661267	99.85%	2	0.81%
瘢	4021		15	2	0.0003018%	661269	99.85%	2	0.81%
癜	4022		18	2	0.0003018%	661271	99.85%	2	0.81%
癩	4023		21	2	0.0003018%	661273	99.85%	2	0.81%
癹	4025		9	2	0.0003018%	661275	99.85%	2	0.81%
盅	4028		9	2	0.0003018%	661277	99.85%	2	0.81%
盬	4030		18	2	0.0003018%	661279	99.85%	2	0.81%
矜	4031		9	2	0.0003018%	661281	99.85%	2	0.81%
砝	4032		10	2	0.0003018%	661283	99.85%	2	0.81%
砭	4033		10	2	0.0003018%	661285	99.85%	2	0.81%
碉	4036		13	2	0.0003018%	661287	99.85%	2	0.81%
碣	4037		14	2	0.0003018%	661289	99.85%	2	0.81%
碴	4038		14	2	0.0003018%	661291	99.85%	2	0.81%
磐	4039		15	2	0.0003018%	661293	99.85%	2	0.81%
禎	4042		13	2	0.0003018%	661295	99.85%	2	0.81%
禦	4043		16	2	0.0003018%	661297	99.86%	2	0.81%
窘	4044		12	2	0.0003018%	661299	99.86%	2	0.81%
窖	4045		12	2	0.0003018%	661301	99.86%	2	0.81%
笆	4046		10	2	0.0003018%	661303	99.86%	2	0.81%
箏	4047		14	2	0.0003018%	661305	99.86%	2	0.81%
箍	4048		14	2	0.0003018%	661307	99.86%	2	0.81%
簫	4050		18	2	0.0003018%	661309	99.86%	2	0.81%
絀	4054		11	2	0.0003018%	661311	99.86%	2	0.81%
絻	4055		13	2	0.0003018%	661313	99.86%	2	0.81%
綣	4056		14	2	0.0003018%	661315	99.86%	2	0.81%
緘	4057		15	2	0.0003018%	661317	99.86%	2	0.81%
緝	4058		15	2	0.0003018%	661319	99.86%	2	0.81%
緞	4059		15	2	0.0003018%	661321	99.86%	2	0.81%
繭	4060		19	2	0.0003018%	661323	99.86%	2	0.81%
辮	4061		20	2	0.0003018%	661325	99.86%	2	0.81%
繾	4062		20	2	0.0003018%	661327	99.86%	2	0.81%
羲	4065		16	2	0.0003018%	661329	99.86%	2	0.81%
羶	4066		19	2	0.0003018%	661331	99.86%	2	0.81%
羹	4067		19	2	0.0003018%	661333	99.86%	2	0.81%
翕	4068		12	2	0.0003018%	661335	99.86%	2	0.81%
翟	4069		14	2	0.0003018%	661337	99.86%	2	0.81%
翱	4070		16	2	0.0003018%	661339	99.86%	2	0.81%
耙	4071		10	2	0.0003018%	661341	99.86%	2	0.81%
聇	4072		11	2	0.0003018%	661343	99.86%	2	0.81%
胛	4073		9	2	0.0003018%	661345	99.86%	2	0.81%
脛	4074		11	2	0.0003018%	661347	99.86%	2	0.81%
腱	4075		13	2	0.0003018%	661349	99.86%	2	0.81%
臆	4076		17	2	0.0003018%	661351	99.87%	2	0.81%
膺	4077		17	2	0.0003018%	661353	99.87%	2	0.81%
膾	4078		17	2	0.0003018%	661355	99.87%	2	0.81%
臧	4080		14	2	0.0003018%	661357	99.87%	2	0.81%
舫	4082		10	2	0.0003018%	661359	99.87%	2	0.81%
艇	4083		13	2	0.0003018%	661361	99.87%	2	0.81%
艙	4084		16	2	0.0003018%	661363	99.87%	2	0.81%
芍	4085		7	2	0.0003018%	661365	99.87%	2	0.81%
苓	4086		9	2	0.0003018%	661367	99.87%	2	0.81%
菁	4091		12	2	0.0003018%	661369	99.87%	2	0.81%
菇	4092		12	2	0.0003018%	661371	99.87%	2	0.81%
蒜	4094		14	2	0.0003018%	661373	99.87%	2	0.81%
蒔	4095		14	2	0.0003018%	661375	99.87%	2	0.81%
蕤	4096		16	2	0.0003018%	661377	99.87%	2	0.81%
藹	4098		20	2	0.0003018%	661379	99.87%	2	0.81%
虜	4099		13	2	0.0003018%	661381	99.87%	2	0.81%
虫	4100		6	2	0.0003018%	661383	99.87%	2	0.81%
蚱	4102		11	2	0.0003018%	661385	99.87%	2	0.81%
蜃	4103		13	2	0.0003018%	661387	99.87%	2	0.81%
螢	4105		16	2	0.0003018%	661389	99.87%	2	0.81%
螺	4106		17	2	0.0003018%	661391	99.87%	2	0.81%
蠶	4109		24	2	0.0003018%	661393	99.88%	2	0.81%
衙	4110		13	2	0.0003018%	661395	99.88%	2	0.81%
袒	4111		10	2	0.0003018%	661397	99.88%	2	0.81%
裾	4113		13	2	0.0003018%	661399	99.88%	2	0.81%
訐	4114		10	2	0.0003018%	661401	99.88%	2	0.81%
訕	4115		10	2	0.0003018%	661403	99.88%	2	0.81%
諉	4116		15	2	0.0003018%	661405	99.88%	2	0.81%
諳	4118		16	2	0.0003018%	661407	99.88%	2	0.81%
謔	4119		16	2	0.0003018%	661409	99.88%	2	0.81%
謳	4120		18	2	0.0003018%	661411	99.88%	2	0.81%
讖	4122		24	2	0.0003018%	661413	99.88%	2	0.81%
豌	4123		15	2	0.0003018%	661415	99.88%	2	0.81%
貽	4124		12	2	0.0003018%	661417	99.88%	2	0.81%
賑	4125		14	2	0.0003018%	661419	99.88%	2	0.81%
贛	4126		24	2	0.0003018%	661421	99.88%	2	0.81%
赦	4127		11	2	0.0003018%	661423	99.88%	2	0.81%
趺	4130		11	2	0.0003018%	661425	99.88%	2	0.81%
跎	4131		12	2	0.0003018%	661427	99.88%	2	0.81%
蹂	4134		16	2	0.0003018%	661429	99.88%	2	0.81%
蹉	4136		17	2	0.0003018%	661431	99.88%	2	0.81%
蹙	4137		18	2	0.0003018%	661433	99.88%	2	0.81%
蹶	4138		19	2	0.0003018%	661435	99.88%	2	0.81%
躪	4140		27	2	0.0003018%	661437	99.88%	2	0.81%
躬	4141		10	2	0.0003018%	661439	99.88%	2	0.81%
辜	4142		12	2	0.0003018%	661441	99.89%	2	0.81%
迥	4144		8	2	0.0003018%	661443	99.89%	2	0.81%
逅	4145		9	2	0.0003018%	661445	99.89%	2	0.81%
逍	4146		10	2	0.0003018%	661447	99.89%	2	0.81%
遒	4147		12	2	0.0003018%	661449	99.89%	2	0.81%
遨	4148		14	2	0.0003018%	661451	99.89%	2	0.81%
邂	4149		16	2	0.0003018%	661453	99.89%	2	0.81%
邈	4150		17	2	0.0003018%	661455	99.89%	2	0.81%
郅	4152		8	2	0.0003018%	661457	99.89%	2	0.81%
釁	4155		25	2	0.0003018%	661459	99.89%	2	0.81%
釜	4156		10	2	0.0003018%	661461	99.89%	2	0.81%
鈣	4157		12	2	0.0003018%	661463	99.89%	2	0.81%
鈞	4158		12	2	0.0003018%	661465	99.89%	2	0.81%
鈐	4159		12	2	0.0003018%	661467	99.89%	2	0.81%
鉸	4161		14	2	0.0003018%	661469	99.89%	2	0.81%
錠	4162		16	2	0.0003018%	661471	99.89%	2	0.81%
鍍	4163		17	2	0.0003018%	661473	99.89%	2	0.81%
錨	4164		17	2	0.0003018%	661475	99.89%	2	0.81%
鍘	4165		17	2	0.0003018%	661477	99.89%	2	0.81%
鎔	4166		18	2	0.0003018%	661479	99.89%	2	0.81%
鏘	4167		19	2	0.0003018%	661481	99.89%	2	0.81%
鏗	4168		19	2	0.0003018%	661483	99.89%	2	0.81%
鐀	4169		20	2	0.0003018%	661485	99.89%	2	0.81%
閔	4171		12	2	0.0003018%	661487	99.89%	2	0.81%
閹	4173		16	2	0.0003018%	661489	99.89%	2	0.81%
靨	4178		23	2	0.0003018%	661491	99.90%	2	0.81%
靶	4179		13	2	0.0003018%	661493	99.90%	2	0.81%
鞅	4180		14	2	0.0003018%	661495	99.90%	2	0.81%
顴	4181		26	2	0.0003018%	661497	99.90%	2	0.81%
颶	4182		17	2	0.0003018%	661499	99.90%	2	0.81%
餒	4184		15	2	0.0003018%	661501	99.90%	2	0.81%
馥	4185		18	2	0.0003018%	661503	99.90%	2	0.81%
驛	4187		23	2	0.0003018%	661505	99.90%	2	0.81%
鬢	4188		24	2	0.0003018%	661507	99.90%	2	0.81%
魘	4190		24	2	0.0003018%	661509	99.90%	2	0.81%
魷	4191		15	2	0.0003018%	661511	99.90%	2	0.81%
鰥	4193		21	2	0.0003018%	661513	99.90%	2	0.81%
鳩	4194		13	2	0.0003018%	661515	99.90%	2	0.81%
鵲	4197		19	2	0.0003018%	661517	99.90%	2	0.81%
鸚	4198		28	2	0.0003018%	661519	99.90%	2	0.81%
鹵	4199		11	2	0.0003018%	661521	99.90%	2	0.81%
齪	4201		22	2	0.0003018%	661523	99.90%	2	0.81%
齷	4202		24	2	0.0003018%	661525	99.90%	2	0.81%
琦	2047		12	24	0.003622%	661549	97.29%	1	0.40%
穌	2213		16	19	0.002867%	661568	97.82%	1	0.40%
矽	2350		8	16	0.002414%	661584	98.18%	1	0.40%
婛	2439		11	14	0.002113%	661598	98.38%	1	0.40%
幌	2627		13	11	0.00166%	661609	98.74%	1	0.40%
蜓	2737		13	10	0.001509%	661619	98.91%	1	0.40%
蜻	2738		14	10	0.001509%	661629	98.92%	1	0.40%
槿	2875		15	8	0.001207%	661637	99.10%	1	0.40%
嫡	2956		14	7	0.001056%	661644	99.19%	1	0.40%
汛	2989		6	7	0.001056%	661651	99.23%	1	0.40%
烯	2995		11	7	0.001056%	661658	99.24%	1	0.40%
蚰	3023		11	7	0.001056%	661665	99.26%	1	0.40%
蟑	3024		17	7	0.001056%	661672	99.27%	1	0.40%
鶚	3048		20	7	0.001056%	661679	99.29%	1	0.40%
悌	3225		10	5	0.0007545%	661684	99.44%	1	0.40%
窯	3291		15	5	0.0007545%	661689	99.49%	1	0.40%
羿	3307		9	5	0.0007545%	661694	99.51%	1	0.40%
螳	3321		17	5	0.0007545%	661699	99.52%	1	0.40%
鄒	3339		12	5	0.0007545%	661704	99.53%	1	0.40%
僳	3368		14	4	0.0006036%	661708	99.55%	1	0.40%
儂	3369		15	4	0.0006036%	661712	99.55%	1	0.40%
嚐	3386		17	4	0.0006036%	661716	99.56%	1	0.40%
寅	3398		11	4	0.0006036%	661720	99.57%	1	0.40%
擒	3433		16	4	0.0006036%	661724	99.59%	1	0.40%
痘	3476		12	4	0.0006036%	661728	99.62%	1	0.40%
笈	3490		10	4	0.0006036%	661732	99.62%	1	0.40%
縶	3498		17	4	0.0006036%	661736	99.63%	1	0.40%
艦	3504		20	4	0.0006036%	661740	99.63%	1	0.40%
芸	3507		8	4	0.0006036%	661744	99.63%	1	0.40%
蕃	3515		16	4	0.0006036%	661748	99.64%	1	0.40%
蚜	3519		10	4	0.0006036%	661752	99.64%	1	0.40%
蟈	3520		17	4	0.0006036%	661756	99.64%	1	0.40%
蹇	3540		17	4	0.0006036%	661760	99.65%	1	0.40%
颱	3559		14	4	0.0006036%	661764	99.67%	1	0.40%
鱖	3566		23	4	0.0006036%	661768	99.67%	1	0.40%
侉	3576		8	3	0.0004527%	661771	99.68%	1	0.40%
呴	3594		8	3	0.0004527%	661774	99.68%	1	0.40%
哏	3596		9	3	0.0004527%	661777	99.68%	1	0.40%
坭	3611		8	3	0.0004527%	661780	99.69%	1	0.40%
壼	3612		13	3	0.0004527%	661783	99.69%	1	0.40%
婭	3619		11	3	0.0004527%	661786	99.70%	1	0.40%
岑	3624		7	3	0.0004527%	661789	99.70%	1	0.40%
岬	3625		8	3	0.0004527%	661792	99.70%	1	0.40%
彗	3631		11	3	0.0004527%	661795	99.70%	1	0.40%
扦	3643		6	3	0.0004527%	661798	99.71%	1	0.40%
柑	3666		9	3	0.0004527%	661801	99.72%	1	0.40%
桅	3668		10	3	0.0004527%	661804	99.72%	1	0.40%
滓	3696		13	3	0.0004527%	661807	99.73%	1	0.40%
滁	3697		13	3	0.0004527%	661810	99.73%	1	0.40%
瞰	3732		17	3	0.0004527%	661813	99.75%	1	0.40%
祕	3740		9	3	0.0004527%	661816	99.75%	1	0.40%
粑	3748		10	3	0.0004527%	661819	99.75%	1	0.40%
糌	3749		15	3	0.0004527%	661822	99.75%	1	0.40%
膿	3763		17	3	0.0004527%	661825	99.76%	1	0.40%
茗	3767		10	3	0.0004527%	661828	99.76%	1	0.40%
莆	3769		11	3	0.0004527%	661831	99.76%	1	0.40%
萵	3771		13	3	0.0004527%	661834	99.76%	1	0.40%
蚓	3777		10	3	0.0004527%	661837	99.77%	1	0.40%
蚯	3779		11	3	0.0004527%	661840	99.77%	1	0.40%
諜	3792		16	3	0.0004527%	661843	99.77%	1	0.40%
鉺	3807		14	3	0.0004527%	661846	99.78%	1	0.40%
鎳	3810		18	3	0.0004527%	661849	99.78%	1	0.40%
鐫	3811		21	3	0.0004527%	661852	99.78%	1	0.40%
丞	3832		6	2	0.0003018%	661854	99.79%	1	0.40%
傀	3845		12	2	0.0003018%	661856	99.80%	1	0.40%
儡	3846		17	2	0.0003018%	661858	99.80%	1	0.40%
劬	3852		7	2	0.0003018%	661860	99.80%	1	0.40%
唬	3859		11	2	0.0003018%	661862	99.80%	1	0.40%
唰	3863		11	2	0.0003018%	661864	99.80%	1	0.40%
喋	3866		12	2	0.0003018%	661866	99.80%	1	0.40%
嘧	3871		14	2	0.0003018%	661868	99.80%	1	0.40%
嚅	3873		17	2	0.0003018%	661870	99.80%	1	0.40%
囁	3874		21	2	0.0003018%	661872	99.80%	1	0.40%
囔	3875		25	2	0.0003018%	661874	99.80%	1	0.40%
囹	3876		8	2	0.0003018%	661876	99.80%	1	0.40%
圄	3877		10	2	0.0003018%	661878	99.81%	1	0.40%
圭	3878		6	2	0.0003018%	661880	99.81%	1	0.40%
垛	3880		9	2	0.0003018%	661882	99.81%	1	0.40%
塈	3881		12	2	0.0003018%	661884	99.81%	1	0.40%
奄	3886		8	2	0.0003018%	661886	99.81%	1	0.40%
姥	3888		9	2	0.0003018%	661888	99.81%	1	0.40%
嬃	3892		15	2	0.0003018%	661890	99.81%	1	0.40%
屯	3897		4	2	0.0003018%	661892	99.81%	1	0.40%
峪	3899		10	2	0.0003018%	661894	99.81%	1	0.40%
崑	3900		11	2	0.0003018%	661896	99.81%	1	0.40%
崚	3901		11	2	0.0003018%	661898	99.81%	1	0.40%
嶒	3902		15	2	0.0003018%	661900	99.81%	1	0.40%
帛	3904		8	2	0.0003018%	661902	99.81%	1	0.40%
徭	3916		13	2	0.0003018%	661904	99.82%	1	0.40%
愜	3924		12	2	0.0003018%	661906	99.82%	1	0.40%
掇	3934		11	2	0.0003018%	661908	99.82%	1	0.40%
攙	3941		20	2	0.0003018%	661910	99.82%	1	0.40%
曬	3947		23	2	0.0003018%	661912	99.83%	1	0.40%
机	3949		6	2	0.0003018%	661914	99.83%	1	0.40%
柮	3953		9	2	0.0003018%	661916	99.83%	1	0.40%
梵	3955		11	2	0.0003018%	661918	99.83%	1	0.40%
楨	3956		13	2	0.0003018%	661920	99.83%	1	0.40%
椹	3958		13	2	0.0003018%	661922	99.83%	1	0.40%
氆	3967		16	2	0.0003018%	661924	99.83%	1	0.40%
氌	3968		19	2	0.0003018%	661926	99.83%	1	0.40%
泱	3975		8	2	0.0003018%	661928	99.83%	1	0.40%
洇	3978		9	2	0.0003018%	661930	99.84%	1	0.40%
澹	3982		16	2	0.0003018%	661932	99.84%	1	0.40%
濼	3984		18	2	0.0003018%	661934	99.84%	1	0.40%
炷	3987		9	2	0.0003018%	661936	99.84%	1	0.40%
烷	3989		11	2	0.0003018%	661938	99.84%	1	0.40%
焙	3990		12	2	0.0003018%	661940	99.84%	1	0.40%
煒	3991		13	2	0.0003018%	661942	99.84%	1	0.40%
獺	4002		19	2	0.0003018%	661944	99.84%	1	0.40%
玦	4003		8	2	0.0003018%	661946	99.84%	1	0.40%
珗	4006		10	2	0.0003018%	661948	99.84%	1	0.40%
璫	4012		17	2	0.0003018%	661950	99.85%	1	0.40%
痹	4020		13	2	0.0003018%	661952	99.85%	1	0.40%
癲	4024		24	2	0.0003018%	661954	99.85%	1	0.40%
皎	4026		11	2	0.0003018%	661956	99.85%	1	0.40%
皚	4027		15	2	0.0003018%	661958	99.85%	1	0.40%
盪	4029		17	2	0.0003018%	661960	99.85%	1	0.40%
硅	4034		11	2	0.0003018%	661962	99.85%	1	0.40%
碘	4035		13	2	0.0003018%	661964	99.85%	1	0.40%
礁	4040		17	2	0.0003018%	661966	99.85%	1	0.40%
祼	4041		12	2	0.0003018%	661968	99.85%	1	0.40%
篙	4049		16	2	0.0003018%	661970	99.86%	1	0.40%
粟	4051		12	2	0.0003018%	661972	99.86%	1	0.40%
粼	4052		14	2	0.0003018%	661974	99.86%	1	0.40%
糢	4053		17	2	0.0003018%	661976	99.86%	1	0.40%
纍	4063		21	2	0.0003018%	661978	99.86%	1	0.40%
罌	4064		20	2	0.0003018%	661980	99.86%	1	0.40%
臏	4079		18	2	0.0003018%	661982	99.87%	1	0.40%
臼	4081		6	2	0.0003018%	661984	99.87%	1	0.40%
荔	4087		10	2	0.0003018%	661986	99.87%	1	0.40%
莘	4088		11	2	0.0003018%	661988	99.87%	1	0.40%
堇	4089		11	2	0.0003018%	661990	99.87%	1	0.40%
萋	4090		12	2	0.0003018%	661992	99.87%	1	0.40%
萛	4093		12	2	0.0003018%	661994	99.87%	1	0.40%
薑	4097		17	2	0.0003018%	661996	99.87%	1	0.40%
蛆	4101		11	2	0.0003018%	661998	99.87%	1	0.40%
蜡	4104		14	2	0.0003018%	662000	99.87%	1	0.40%
螬	4107		17	2	0.0003018%	662002	99.87%	1	0.40%
蠐	4108		20	2	0.0003018%	662004	99.87%	1	0.40%
袛	4112		10	2	0.0003018%	662006	99.88%	1	0.40%
諫	4117		16	2	0.0003018%	662008	99.88%	1	0.40%
謮	4121		18	2	0.0003018%	662010	99.88%	1	0.40%
趄	4128		12	2	0.0003018%	662012	99.88%	1	0.40%
趑	4129		13	2	0.0003018%	662014	99.88%	1	0.40%
跩	4132		13	2	0.0003018%	662016	99.88%	1	0.40%
踉	4133		14	2	0.0003018%	662018	99.88%	1	0.40%
踽	4135		16	2	0.0003018%	662020	99.88%	1	0.40%
躡	4139		25	2	0.0003018%	662022	99.88%	1	0.40%
迦	4143		8	2	0.0003018%	662024	99.89%	1	0.40%
邑	4151		7	2	0.0003018%	662026	99.89%	1	0.40%
郡	4153		9	2	0.0003018%	662028	99.89%	1	0.40%
酯	4154		13	2	0.0003018%	662030	99.89%	1	0.40%
鉗	4160		13	2	0.0003018%	662032	99.89%	1	0.40%
鐮	4170		21	2	0.0003018%	662034	99.89%	1	0.40%
閻	4172		16	2	0.0003018%	662036	99.89%	1	0.40%
阮	4174		6	2	0.0003018%	662038	99.89%	1	0.40%
陃	4175		8	2	0.0003018%	662040	99.89%	1	0.40%
隄	4176		11	2	0.0003018%	662042	99.90%	1	0.40%
靡	4177		19	2	0.0003018%	662044	99.90%	1	0.40%
飪	4183		12	2	0.0003018%	662046	99.90%	1	0.40%
驄	4186		21	2	0.0003018%	662048	99.90%	1	0.40%
魆	4189		15	2	0.0003018%	662050	99.90%	1	0.40%
鯛	4192		19	2	0.0003018%	662052	99.90%	1	0.40%
鴯	4195		17	2	0.0003018%	662054	99.90%	1	0.40%
鵠	4196		18	2	0.0003018%	662056	99.90%	1	0.40%
齌	4200		18	2	0.0003018%	662058	99.90%	1	0.40%
万	4203		3	1	0.0001509%	662059	99.90%	1	0.40%
乒	4204		6	1	0.0001509%	662060	99.90%	1	0.40%
乓	4205		6	1	0.0001509%	662061	99.90%	1	0.40%
仃	4206		4	1	0.0001509%	662062	99.90%	1	0.40%
仄	4207		4	1	0.0001509%	662063	99.90%	1	0.40%
伉	4208		6	1	0.0001509%	662064	99.90%	1	0.40%
伓	4209		6	1	0.0001509%	662065	99.90%	1	0.40%
佞	4210		7	1	0.0001509%	662066	99.90%	1	0.40%
伺	4211		7	1	0.0001509%	662067	99.90%	1	0.40%
伶	4212		7	1	0.0001509%	662068	99.90%	1	0.40%
佝	4213		7	1	0.0001509%	662069	99.90%	1	0.40%
佤	4214		7	1	0.0001509%	662070	99.90%	1	0.40%
佬	4215		8	1	0.0001509%	662071	99.91%	1	0.40%
佻	4216		8	1	0.0001509%	662072	99.91%	1	0.40%
侚	4217		8	1	0.0001509%	662073	99.91%	1	0.40%
俟	4218		9	1	0.0001509%	662074	99.91%	1	0.40%
俚	4219		9	1	0.0001509%	662075	99.91%	1	0.40%
俓	4220		9	1	0.0001509%	662076	99.91%	1	0.40%
倣	4221		10	1	0.0001509%	662077	99.91%	1	0.40%
倥	4222		10	1	0.0001509%	662078	99.91%	1	0.40%
倬	4223		10	1	0.0001509%	662079	99.91%	1	0.40%
偭	4224		11	1	0.0001509%	662080	99.91%	1	0.40%
傯	4225		13	1	0.0001509%	662081	99.91%	1	0.40%
僂	4226		13	1	0.0001509%	662082	99.91%	1	0.40%
僥	4227		14	1	0.0001509%	662083	99.91%	1	0.40%
僭	4228		14	1	0.0001509%	662084	99.91%	1	0.40%
儈	4229		15	1	0.0001509%	662085	99.91%	1	0.40%
冼	4230		8	1	0.0001509%	662086	99.91%	1	0.40%
凈	4231		10	1	0.0001509%	662087	99.91%	1	0.40%
刖	4232		6	1	0.0001509%	662088	99.91%	1	0.40%
剷	4233		13	1	0.0001509%	662089	99.91%	1	0.40%
劭	4234		7	1	0.0001509%	662090	99.91%	1	0.40%
劾	4235		8	1	0.0001509%	662091	99.91%	1	0.40%
勰	4236		15	1	0.0001509%	662092	99.91%	1	0.40%
勳	4237		16	1	0.0001509%	662093	99.91%	1	0.40%
匕	4238		2	1	0.0001509%	662094	99.91%	1	0.40%
匼	4239		8	1	0.0001509%	662095	99.91%	1	0.40%
卒	4240		8	1	0.0001509%	662096	99.91%	1	0.40%
卦	4241		8	1	0.0001509%	662097	99.91%	1	0.40%
厥	4242		12	1	0.0001509%	662098	99.91%	1	0.40%
叵	4243		5	1	0.0001509%	662099	99.91%	1	0.40%
吋	4244		6	1	0.0001509%	662100	99.91%	1	0.40%
呎	4245		7	1	0.0001509%	662101	99.91%	1	0.40%
吮	4246		7	1	0.0001509%	662102	99.91%	1	0.40%
吜	4247		7	1	0.0001509%	662103	99.91%	1	0.40%
	4248		8	1	0.0001509%	662104	99.91%	1	0.40%
咿	4249		9	1	0.0001509%	662105	99.91%	1	0.40%
哞	4250		9	1	0.0001509%	662106	99.91%	1	0.40%
唁	4251		10	1	0.0001509%	662107	99.91%	1	0.40%
唑	4252		10	1	0.0001509%	662108	99.91%	1	0.40%
啷	4253		12	1	0.0001509%	662109	99.91%	1	0.40%
喏	4254		12	1	0.0001509%	662110	99.91%	1	0.40%
嗑	4255		13	1	0.0001509%	662111	99.91%	1	0.40%
嗣	4256		13	1	0.0001509%	662112	99.91%	1	0.40%
嗐	4257		13	1	0.0001509%	662113	99.91%	1	0.40%
嗝	4258		13	1	0.0001509%	662114	99.91%	1	0.40%
嗔	4259		13	1	0.0001509%	662115	99.91%	1	0.40%
嗲	4260		13	1	0.0001509%	662116	99.91%	1	0.40%
噎	4261		15	1	0.0001509%	662117	99.91%	1	0.40%
噗	4262		15	1	0.0001509%	662118	99.91%	1	0.40%
噌	4263		15	1	0.0001509%	662119	99.91%	1	0.40%
噁	4264		15	1	0.0001509%	662120	99.91%	1	0.40%
嘬	4265		15	1	0.0001509%	662121	99.91%	1	0.40%
噯	4266		16	1	0.0001509%	662122	99.91%	1	0.40%
噲	4267		16	1	0.0001509%	662123	99.91%	1	0.40%
嚥	4268		19	1	0.0001509%	662124	99.91%	1	0.40%
囈	4269		22	1	0.0001509%	662125	99.91%	1	0.40%
	4270		7	1	0.0001509%	662126	99.91%	1	0.40%
坍	4271		7	1	0.0001509%	662127	99.91%	1	0.40%
埌	4272		10	1	0.0001509%	662128	99.91%	1	0.40%
堲	4273		10	1	0.0001509%	662129	99.91%	1	0.40%
堰	4274		12	1	0.0001509%	662130	99.91%	1	0.40%
	4275		12	1	0.0001509%	662131	99.91%	1	0.40%
堞	4276		12	1	0.0001509%	662132	99.91%	1	0.40%
壅	4277		16	1	0.0001509%	662133	99.91%	1	0.40%
壕	4278		17	1	0.0001509%	662134	99.91%	1	0.40%
壬	4279		4	1	0.0001509%	662135	99.91%	1	0.40%
壹	4280		12	1	0.0001509%	662136	99.91%	1	0.40%
囍	4281		24	1	0.0001509%	662137	99.92%	1	0.40%
奐	4282		9	1	0.0001509%	662138	99.92%	1	0.40%
奓	4283		9	1	0.0001509%	662139	99.92%	1	0.40%
妞	4284		7	1	0.0001509%	662140	99.92%	1	0.40%
姒	4285		8	1	0.0001509%	662141	99.92%	1	0.40%
姣	4286		9	1	0.0001509%	662142	99.92%	1	0.40%
姦	4287		9	1	0.0001509%	662143	99.92%	1	0.40%
娭	4288		10	1	0.0001509%	662144	99.92%	1	0.40%
婀	4289		11	1	0.0001509%	662145	99.92%	1	0.40%
婊	4290		11	1	0.0001509%	662146	99.92%	1	0.40%
媛	4291		12	1	0.0001509%	662147	99.92%	1	0.40%
媿	4292		13	1	0.0001509%	662148	99.92%	1	0.40%
嫗	4293		14	1	0.0001509%	662149	99.92%	1	0.40%
嫖	4294		14	1	0.0001509%	662150	99.92%	1	0.40%
孵	4295		14	1	0.0001509%	662151	99.92%	1	0.40%
孿	4296		22	1	0.0001509%	662152	99.92%	1	0.40%
寐	4297		12	1	0.0001509%	662153	99.92%	1	0.40%
寮	4298		15	1	0.0001509%	662154	99.92%	1	0.40%
尃	4299		10	1	0.0001509%	662155	99.92%	1	0.40%
尥	4300		6	1	0.0001509%	662156	99.92%	1	0.40%
屌	4301		9	1	0.0001509%	662157	99.92%	1	0.40%
岔	4302		7	1	0.0001509%	662158	99.92%	1	0.40%
岫	4303		8	1	0.0001509%	662159	99.92%	1	0.40%
峱	4304		10	1	0.0001509%	662160	99.92%	1	0.40%
崦	4305		11	1	0.0001509%	662161	99.92%	1	0.40%
嵫	4306		12	1	0.0001509%	662162	99.92%	1	0.40%
嵂	4307		12	1	0.0001509%	662163	99.92%	1	0.40%
嵯	4308		13	1	0.0001509%	662164	99.92%	1	0.40%
嵬	4309		13	1	0.0001509%	662165	99.92%	1	0.40%
嵺	4310		14	1	0.0001509%	662166	99.92%	1	0.40%
嶵	4311		16	1	0.0001509%	662167	99.92%	1	0.40%
幵	4312		6	1	0.0001509%	662168	99.92%	1	0.40%
庖	4313		8	1	0.0001509%	662169	99.92%	1	0.40%
廩	4314		16	1	0.0001509%	662170	99.92%	1	0.40%
廿	4315		4	1	0.0001509%	662171	99.92%	1	0.40%
异	4316		6	1	0.0001509%	662172	99.92%	1	0.40%
彔	4317		8	1	0.0001509%	662173	99.92%	1	0.40%
忪	4318		7	1	0.0001509%	662174	99.92%	1	0.40%
怀	4319		7	1	0.0001509%	662175	99.92%	1	0.40%
怙	4320		8	1	0.0001509%	662176	99.92%	1	0.40%
悚	4321		10	1	0.0001509%	662177	99.92%	1	0.40%
悽	4322		11	1	0.0001509%	662178	99.92%	1	0.40%
悸	4323		11	1	0.0001509%	662179	99.92%	1	0.40%
惺	4324		12	1	0.0001509%	662180	99.92%	1	0.40%
愴	4325		13	1	0.0001509%	662181	99.92%	1	0.40%
愿	4326		14	1	0.0001509%	662182	99.92%	1	0.40%
慟	4327		14	1	0.0001509%	662183	99.92%	1	0.40%
慒	4328		14	1	0.0001509%	662184	99.92%	1	0.40%
慓	4329		14	1	0.0001509%	662185	99.92%	1	0.40%
慼	4330		15	1	0.0001509%	662186	99.92%	1	0.40%
憚	4331		15	1	0.0001509%	662187	99.92%	1	0.40%
懋	4332		17	1	0.0001509%	662188	99.92%	1	0.40%
戛	4333		11	1	0.0001509%	662189	99.92%	1	0.40%
戡	4334		13	1	0.0001509%	662190	99.92%	1	0.40%
戢	4335		13	1	0.0001509%	662191	99.92%	1	0.40%
戾	4336		8	1	0.0001509%	662192	99.92%	1	0.40%
扑	4337		5	1	0.0001509%	662193	99.92%	1	0.40%
抃	4338		7	1	0.0001509%	662194	99.92%	1	0.40%
抇	4339		7	1	0.0001509%	662195	99.92%	1	0.40%
拈	4340		8	1	0.0001509%	662196	99.92%	1	0.40%
抻	4341		8	1	0.0001509%	662197	99.92%	1	0.40%
拫	4342		9	1	0.0001509%	662198	99.92%	1	0.40%
捍	4343		10	1	0.0001509%	662199	99.92%	1	0.40%
捋	4344		10	1	0.0001509%	662200	99.92%	1	0.40%
挭	4345		10	1	0.0001509%	662201	99.92%	1	0.40%
捱	4346		11	1	0.0001509%	662202	99.92%	1	0.40%
捫	4347		11	1	0.0001509%	662203	99.93%	1	0.40%
掄	4348		11	1	0.0001509%	662204	99.93%	1	0.40%
捽	4349		11	1	0.0001509%	662205	99.93%	1	0.40%
掽	4350		11	1	0.0001509%	662206	99.93%	1	0.40%
揩	4351		12	1	0.0001509%	662207	99.93%	1	0.40%
揘	4352		12	1	0.0001509%	662208	99.93%	1	0.40%
搨	4353		13	1	0.0001509%	662209	99.93%	1	0.40%
搡	4354		13	1	0.0001509%	662210	99.93%	1	0.40%
摳	4355		14	1	0.0001509%	662211	99.93%	1	0.40%
摽	4356		14	1	0.0001509%	662212	99.93%	1	0.40%
摞	4357		14	1	0.0001509%	662213	99.93%	1	0.40%
摜	4358		14	1	0.0001509%	662214	99.93%	1	0.40%
擼	4359		14	1	0.0001509%	662215	99.93%	1	0.40%
撬	4360		15	1	0.0001509%	662216	99.93%	1	0.40%
撳	4361		15	1	0.0001509%	662217	99.93%	1	0.40%
摰	4362		15	1	0.0001509%	662218	99.93%	1	0.40%
撻	4363		16	1	0.0001509%	662219	99.93%	1	0.40%
撾	4364		16	1	0.0001509%	662220	99.93%	1	0.40%
擗	4365		16	1	0.0001509%	662221	99.93%	1	0.40%
擯	4366		17	1	0.0001509%	662222	99.93%	1	0.40%
攛	4367		21	1	0.0001509%	662223	99.93%	1	0.40%
攸	4368		7	1	0.0001509%	662224	99.93%	1	0.40%
敕	4369		11	1	0.0001509%	662225	99.93%	1	0.40%
敨	4370		12	1	0.0001509%	662226	99.93%	1	0.40%
斛	4371		11	1	0.0001509%	662227	99.93%	1	0.40%
旃	4372		10	1	0.0001509%	662228	99.93%	1	0.40%
旎	4373		11	1	0.0001509%	662229	99.93%	1	0.40%
旖	4374		14	1	0.0001509%	662230	99.93%	1	0.40%
旯	4375		6	1	0.0001509%	662231	99.93%	1	0.40%
旮	4376		6	1	0.0001509%	662232	99.93%	1	0.40%
昤	4377		9	1	0.0001509%	662233	99.93%	1	0.40%
昵	4378		9	1	0.0001509%	662234	99.93%	1	0.40%
昫	4379		9	1	0.0001509%	662235	99.93%	1	0.40%
晤	4380		11	1	0.0001509%	662236	99.93%	1	0.40%
暱	4381		15	1	0.0001509%	662237	99.93%	1	0.40%
暹	4382		16	1	0.0001509%	662238	99.93%	1	0.40%
曄	4383		16	1	0.0001509%	662239	99.93%	1	0.40%
曝	4384		19	1	0.0001509%	662240	99.93%	1	0.40%
曦	4385		20	1	0.0001509%	662241	99.93%	1	0.40%
曩	4386		21	1	0.0001509%	662242	99.93%	1	0.40%
朮	4387		5	1	0.0001509%	662243	99.93%	1	0.40%
杵	4388		8	1	0.0001509%	662244	99.93%	1	0.40%
杲	4389		8	1	0.0001509%	662245	99.93%	1	0.40%
柩	4390		9	1	0.0001509%	662246	99.93%	1	0.40%
柢	4391		9	1	0.0001509%	662247	99.93%	1	0.40%
枷	4392		9	1	0.0001509%	662248	99.93%	1	0.40%
柭	4393		9	1	0.0001509%	662249	99.93%	1	0.40%
栝	4394		10	1	0.0001509%	662250	99.93%	1	0.40%
梗	4395		11	1	0.0001509%	662251	99.93%	1	0.40%
梟	4396		11	1	0.0001509%	662252	99.93%	1	0.40%
梜	4397		11	1	0.0001509%	662253	99.93%	1	0.40%
桷	4398		11	1	0.0001509%	662254	99.93%	1	0.40%
棣	4399		12	1	0.0001509%	662255	99.93%	1	0.40%
椏	4400		12	1	0.0001509%	662256	99.93%	1	0.40%
棖	4401		12	1	0.0001509%	662257	99.93%	1	0.40%
楫	4402		13	1	0.0001509%	662258	99.93%	1	0.40%
楸	4403		13	1	0.0001509%	662259	99.93%	1	0.40%
榫	4404		14	1	0.0001509%	662260	99.93%	1	0.40%
槌	4405		14	1	0.0001509%	662261	99.93%	1	0.40%
榖	4406		14	1	0.0001509%	662262	99.93%	1	0.40%
榧	4407		14	1	0.0001509%	662263	99.93%	1	0.40%
橄	4408		16	1	0.0001509%	662264	99.93%	1	0.40%
檁	4409		17	1	0.0001509%	662265	99.93%	1	0.40%
檥	4410		17	1	0.0001509%	662266	99.93%	1	0.40%
檳	4411		18	1	0.0001509%	662267	99.93%	1	0.40%
櫚	4412		19	1	0.0001509%	662268	99.93%	1	0.40%
櫨	4413		20	1	0.0001509%	662269	99.93%	1	0.40%
欖	4414		25	1	0.0001509%	662270	99.94%	1	0.40%
歅	4415		13	1	0.0001509%	662271	99.94%	1	0.40%
歎	4416		15	1	0.0001509%	662272	99.94%	1	0.40%
歙	4417		16	1	0.0001509%	662273	99.94%	1	0.40%
殞	4418		14	1	0.0001509%	662274	99.94%	1	0.40%
殫	4419		16	1	0.0001509%	662275	99.94%	1	0.40%
殮	4420		17	1	0.0001509%	662276	99.94%	1	0.40%
殯	4421		18	1	0.0001509%	662277	99.94%	1	0.40%
殲	4422		21	1	0.0001509%	662278	99.94%	1	0.40%
殳	4423		4	1	0.0001509%	662279	99.94%	1	0.40%
毆	4424		15	1	0.0001509%	662280	99.94%	1	0.40%
毈	4425		16	1	0.0001509%	662281	99.94%	1	0.40%
毗	4426		9	1	0.0001509%	662282	99.94%	1	0.40%
毽	4427		13	1	0.0001509%	662283	99.94%	1	0.40%
氅	4428		16	1	0.0001509%	662284	99.94%	1	0.40%
氐	4429		5	1	0.0001509%	662285	99.94%	1	0.40%
氟	4430		9	1	0.0001509%	662286	99.94%	1	0.40%
氰	4431		12	1	0.0001509%	662287	99.94%	1	0.40%
汙	4432		6	1	0.0001509%	662288	99.94%	1	0.40%
汲	4433		7	1	0.0001509%	662289	99.94%	1	0.40%
汾	4434		7	1	0.0001509%	662290	99.94%	1	0.40%
汸	4435		7	1	0.0001509%	662291	99.94%	1	0.40%
汩	4436		7	1	0.0001509%	662292	99.94%	1	0.40%
沬	4437		8	1	0.0001509%	662293	99.94%	1	0.40%
泔	4438		8	1	0.0001509%	662294	99.94%	1	0.40%
泞	4439		8	1	0.0001509%	662295	99.94%	1	0.40%
洸	4440		9	1	0.0001509%	662296	99.94%	1	0.40%
洮	4441		9	1	0.0001509%	662297	99.94%	1	0.40%
洵	4442		9	1	0.0001509%	662298	99.94%	1	0.40%
浚	4443		10	1	0.0001509%	662299	99.94%	1	0.40%
涅	4444		10	1	0.0001509%	662300	99.94%	1	0.40%
浠	4445		10	1	0.0001509%	662301	99.94%	1	0.40%
涂	4446		10	1	0.0001509%	662302	99.94%	1	0.40%
淇	4447		11	1	0.0001509%	662303	99.94%	1	0.40%
渚	4448		11	1	0.0001509%	662304	99.94%	1	0.40%
淖	4449		11	1	0.0001509%	662305	99.94%	1	0.40%
渥	4450		12	1	0.0001509%	662306	99.94%	1	0.40%
湄	4451		12	1	0.0001509%	662307	99.94%	1	0.40%
湲	4452		12	1	0.0001509%	662308	99.94%	1	0.40%
溤	4453		12	1	0.0001509%	662309	99.94%	1	0.40%
滂	4454		13	1	0.0001509%	662310	99.94%	1	0.40%
滇	4455		13	1	0.0001509%	662311	99.94%	1	0.40%
溥	4456		13	1	0.0001509%	662312	99.94%	1	0.40%
溽	4457		13	1	0.0001509%	662313	99.94%	1	0.40%
滘	4458		13	1	0.0001509%	662314	99.94%	1	0.40%
漱	4459		14	1	0.0001509%	662315	99.94%	1	0.40%
滻	4460		14	1	0.0001509%	662316	99.94%	1	0.40%
潎	4461		14	1	0.0001509%	662317	99.94%	1	0.40%
滹	4462		14	1	0.0001509%	662318	99.94%	1	0.40%
潦	4463		15	1	0.0001509%	662319	99.94%	1	0.40%
潸	4464		15	1	0.0001509%	662320	99.94%	1	0.40%
滕	4465		15	1	0.0001509%	662321	99.94%	1	0.40%
瀆	4466		18	1	0.0001509%	662322	99.94%	1	0.40%
灝	4467		24	1	0.0001509%	662323	99.94%	1	0.40%
灠	4468		24	1	0.0001509%	662324	99.94%	1	0.40%
炬	4469		9	1	0.0001509%	662325	99.94%	1	0.40%
烴	4470		11	1	0.0001509%	662326	99.94%	1	0.40%
煇	4471		13	1	0.0001509%	662327	99.94%	1	0.40%
熒	4472		14	1	0.0001509%	662328	99.94%	1	0.40%
熹	4473		16	1	0.0001509%	662329	99.94%	1	0.40%
燠	4474		17	1	0.0001509%	662330	99.94%	1	0.40%
爻	4475		4	1	0.0001509%	662331	99.94%	1	0.40%
爿	4476		4	1	0.0001509%	662332	99.94%	1	0.40%
牒	4477		13	1	0.0001509%	662333	99.94%	1	0.40%
牝	4478		6	1	0.0001509%	662334	99.94%	1	0.40%
牠	4479		7	1	0.0001509%	662335	99.94%	1	0.40%
牾	4480		11	1	0.0001509%	662336	99.95%	1	0.40%
犍	4481		13	1	0.0001509%	662337	99.95%	1	0.40%
獪	4482		16	1	0.0001509%	662338	99.95%	1	0.40%
玖	4483		7	1	0.0001509%	662339	99.95%	1	0.40%
玵	4484		8	1	0.0001509%	662340	99.95%	1	0.40%
玷	4485		9	1	0.0001509%	662341	99.95%	1	0.40%
珂	4486		9	1	0.0001509%	662342	99.95%	1	0.40%
珈	4487		9	1	0.0001509%	662343	99.95%	1	0.40%
珮	4488		10	1	0.0001509%	662344	99.95%	1	0.40%
琇	4489		11	1	0.0001509%	662345	99.95%	1	0.40%
琪	4490		12	1	0.0001509%	662346	99.95%	1	0.40%
琛	4491		12	1	0.0001509%	662347	99.95%	1	0.40%
瑙	4492		13	1	0.0001509%	662348	99.95%	1	0.40%
瑛	4493		13	1	0.0001509%	662349	99.95%	1	0.40%
瑋	4494		13	1	0.0001509%	662350	99.95%	1	0.40%
瑢	4495		14	1	0.0001509%	662351	99.95%	1	0.40%
璽	4496		19	1	0.0001509%	662352	99.95%	1	0.40%
瓘	4497		22	1	0.0001509%	662353	99.95%	1	0.40%
甑	4498		17	1	0.0001509%	662354	99.95%	1	0.40%
甬	4499		7	1	0.0001509%	662355	99.95%	1	0.40%
畎	4500		9	1	0.0001509%	662356	99.95%	1	0.40%
畚	4501		10	1	0.0001509%	662357	99.95%	1	0.40%
畦	4502		11	1	0.0001509%	662358	99.95%	1	0.40%
畿	4503		15	1	0.0001509%	662359	99.95%	1	0.40%
疹	4504		10	1	0.0001509%	662360	99.95%	1	0.40%
疸	4505		10	1	0.0001509%	662361	99.95%	1	0.40%
痌	4506		11	1	0.0001509%	662362	99.95%	1	0.40%
	4507		13	1	0.0001509%	662363	99.95%	1	0.40%
痲	4508		13	1	0.0001509%	662364	99.95%	1	0.40%
痱	4509		13	1	0.0001509%	662365	99.95%	1	0.40%
痳	4510		13	1	0.0001509%	662366	99.95%	1	0.40%
痼	4511		13	1	0.0001509%	662367	99.95%	1	0.40%
瘐	4512		13	1	0.0001509%	662368	99.95%	1	0.40%
痽	4513		13	1	0.0001509%	662369	99.95%	1	0.40%
瘧	4514		14	1	0.0001509%	662370	99.95%	1	0.40%
瘖	4515		14	1	0.0001509%	662371	99.95%	1	0.40%
癥	4516		20	1	0.0001509%	662372	99.95%	1	0.40%
癸	4517		9	1	0.0001509%	662373	99.95%	1	0.40%
皈	4518		9	1	0.0001509%	662374	99.95%	1	0.40%
皙	4519		13	1	0.0001509%	662375	99.95%	1	0.40%
皿	4520		5	1	0.0001509%	662376	99.95%	1	0.40%
盂	4521		8	1	0.0001509%	662377	99.95%	1	0.40%
盍	4522		10	1	0.0001509%	662378	99.95%	1	0.40%
盹	4523		9	1	0.0001509%	662379	99.95%	1	0.40%
眛	4524		10	1	0.0001509%	662380	99.95%	1	0.40%
眥	4525		11	1	0.0001509%	662381	99.95%	1	0.40%
睨	4526		13	1	0.0001509%	662382	99.95%	1	0.40%
睚	4527		13	1	0.0001509%	662383	99.95%	1	0.40%
睽	4528		14	1	0.0001509%	662384	99.95%	1	0.40%
瞳	4529		17	1	0.0001509%	662385	99.95%	1	0.40%
瞵	4530		17	1	0.0001509%	662386	99.95%	1	0.40%
瞿	4531		18	1	0.0001509%	662387	99.95%	1	0.40%
矍	4532		20	1	0.0001509%	662388	99.95%	1	0.40%
砣	4533		10	1	0.0001509%	662389	99.95%	1	0.40%
硒	4534		11	1	0.0001509%	662390	99.95%	1	0.40%
硤	4535		12	1	0.0001509%	662391	99.95%	1	0.40%
磊	4536		15	1	0.0001509%	662392	99.95%	1	0.40%
磈	4537		15	1	0.0001509%	662393	99.95%	1	0.40%
磣	4538		16	1	0.0001509%	662394	99.95%	1	0.40%
磴	4539		17	1	0.0001509%	662395	99.95%	1	0.40%
磳	4540		17	1	0.0001509%	662396	99.95%	1	0.40%
礔	4541		18	1	0.0001509%	662397	99.95%	1	0.40%
礡	4542		19	1	0.0001509%	662398	99.95%	1	0.40%
祗	4543		9	1	0.0001509%	662399	99.95%	1	0.40%
祺	4544		12	1	0.0001509%	662400	99.95%	1	0.40%
禕	4545		13	1	0.0001509%	662401	99.95%	1	0.40%
禒	4546		13	1	0.0001509%	662402	99.96%	1	0.40%
禧	4547		16	1	0.0001509%	662403	99.96%	1	0.40%
禺	4548		9	1	0.0001509%	662404	99.96%	1	0.40%
种	4549		9	1	0.0001509%	662405	99.96%	1	0.40%
秣	4550		10	1	0.0001509%	662406	99.96%	1	0.40%
秸	4551		11	1	0.0001509%	662407	99.96%	1	0.40%
稜	4552		13	1	0.0001509%	662408	99.96%	1	0.40%
稔	4553		13	1	0.0001509%	662409	99.96%	1	0.40%
稞	4554		13	1	0.0001509%	662410	99.96%	1	0.40%
稷	4555		15	1	0.0001509%	662411	99.96%	1	0.40%
竽	4556		9	1	0.0001509%	662412	99.96%	1	0.40%
笊	4557		10	1	0.0001509%	662413	99.96%	1	0.40%
笴	4558		11	1	0.0001509%	662414	99.96%	1	0.40%
笸	4559		11	1	0.0001509%	662415	99.96%	1	0.40%
筠	4560		13	1	0.0001509%	662416	99.96%	1	0.40%
筱	4561		13	1	0.0001509%	662417	99.96%	1	0.40%
筵	4562		14	1	0.0001509%	662418	99.96%	1	0.40%
箘	4563		14	1	0.0001509%	662419	99.96%	1	0.40%
箴	4564		15	1	0.0001509%	662420	99.96%	1	0.40%
篋	4565		15	1	0.0001509%	662421	99.96%	1	0.40%
篦	4566		16	1	0.0001509%	662422	99.96%	1	0.40%
篱	4567		17	1	0.0001509%	662423	99.96%	1	0.40%
簟	4568		18	1	0.0001509%	662424	99.96%	1	0.40%
籈	4569		19	1	0.0001509%	662425	99.96%	1	0.40%
籐	4570		21	1	0.0001509%	662426	99.96%	1	0.40%
籣	4571		23	1	0.0001509%	662427	99.96%	1	0.40%
粕	4572		11	1	0.0001509%	662428	99.96%	1	0.40%
粵	4573		13	1	0.0001509%	662429	99.96%	1	0.40%
糅	4574		15	1	0.0001509%	662430	99.96%	1	0.40%
紂	4575		9	1	0.0001509%	662431	99.96%	1	0.40%
紉	4576		9	1	0.0001509%	662432	99.96%	1	0.40%
絳	4577		12	1	0.0001509%	662433	99.96%	1	0.40%
絜	4578		12	1	0.0001509%	662434	99.96%	1	0.40%
綑	4579		13	1	0.0001509%	662435	99.96%	1	0.40%
綏	4580		13	1	0.0001509%	662436	99.96%	1	0.40%
綰	4581		14	1	0.0001509%	662437	99.96%	1	0.40%
綺	4582		14	1	0.0001509%	662438	99.96%	1	0.40%
綪	4583		14	1	0.0001509%	662439	99.96%	1	0.40%
縝	4584		16	1	0.0001509%	662440	99.96%	1	0.40%
縉	4585		16	1	0.0001509%	662441	99.96%	1	0.40%
縋	4586		16	1	0.0001509%	662442	99.96%	1	0.40%
繅	4587		17	1	0.0001509%	662443	99.96%	1	0.40%
縳	4588		17	1	0.0001509%	662444	99.96%	1	0.40%
繵	4589		19	1	0.0001509%	662445	99.96%	1	0.40%
缽	4590		11	1	0.0001509%	662446	99.96%	1	0.40%
罔	4591		8	1	0.0001509%	662447	99.96%	1	0.40%
羌	4592		8	1	0.0001509%	662448	99.96%	1	0.40%
翡	4593		14	1	0.0001509%	662449	99.96%	1	0.40%
翬	4594		15	1	0.0001509%	662450	99.96%	1	0.40%
翦	4595		15	1	0.0001509%	662451	99.96%	1	0.40%
耆	4596		10	1	0.0001509%	662452	99.96%	1	0.40%
耹	4597		10	1	0.0001509%	662453	99.96%	1	0.40%
聵	4598		18	1	0.0001509%	662454	99.96%	1	0.40%
聿	4599		6	1	0.0001509%	662455	99.96%	1	0.40%
肓	4600		7	1	0.0001509%	662456	99.96%	1	0.40%
胝	4601		9	1	0.0001509%	662457	99.96%	1	0.40%
胍	4602		9	1	0.0001509%	662458	99.96%	1	0.40%
胰	4603		10	1	0.0001509%	662459	99.96%	1	0.40%
胭	4604		10	1	0.0001509%	662460	99.96%	1	0.40%
胼	4605		10	1	0.0001509%	662461	99.96%	1	0.40%
脤	4606		11	1	0.0001509%	662462	99.96%	1	0.40%
腋	4607		12	1	0.0001509%	662463	99.96%	1	0.40%
膈	4608		14	1	0.0001509%	662464	99.96%	1	0.40%
膲	4609		16	1	0.0001509%	662465	99.96%	1	0.40%
臃	4610		17	1	0.0001509%	662466	99.96%	1	0.40%
舄	4611		12	1	0.0001509%	662467	99.96%	1	0.40%
舐	4612		10	1	0.0001509%	662468	99.96%	1	0.40%
舢	4613		9	1	0.0001509%	662469	99.97%	1	0.40%
舨	4614		10	1	0.0001509%	662470	99.97%	1	0.40%
芋	4615		7	1	0.0001509%	662471	99.97%	1	0.40%
芟	4616		8	1	0.0001509%	662472	99.97%	1	0.40%
芾	4617		8	1	0.0001509%	662473	99.97%	1	0.40%
芮	4618		8	1	0.0001509%	662474	99.97%	1	0.40%
茉	4619		9	1	0.0001509%	662475	99.97%	1	0.40%
苜	4620		9	1	0.0001509%	662476	99.97%	1	0.40%
茴	4621		10	1	0.0001509%	662477	99.97%	1	0.40%
荏	4622		10	1	0.0001509%	662478	99.97%	1	0.40%
茹	4623		10	1	0.0001509%	662479	99.97%	1	0.40%
茨	4624		10	1	0.0001509%	662480	99.97%	1	0.40%
茜	4625		10	1	0.0001509%	662481	99.97%	1	0.40%
茯	4626		10	1	0.0001509%	662482	99.97%	1	0.40%
茧	4627		10	1	0.0001509%	662483	99.97%	1	0.40%
荿	4628		10	1	0.0001509%	662484	99.97%	1	0.40%
莞	4629		11	1	0.0001509%	662485	99.97%	1	0.40%
莒	4630		11	1	0.0001509%	662486	99.97%	1	0.40%
莓	4631		11	1	0.0001509%	662487	99.97%	1	0.40%
莠	4632		11	1	0.0001509%	662488	99.97%	1	0.40%
荼	4633		11	1	0.0001509%	662489	99.97%	1	0.40%
荳	4634		11	1	0.0001509%	662490	99.97%	1	0.40%
荵	4635		11	1	0.0001509%	662491	99.97%	1	0.40%
菠	4636		12	1	0.0001509%	662492	99.97%	1	0.40%
菱	4637		12	1	0.0001509%	662493	99.97%	1	0.40%
葩	4638		13	1	0.0001509%	662494	99.97%	1	0.40%
葆	4639		13	1	0.0001509%	662495	99.97%	1	0.40%
葳	4640		13	1	0.0001509%	662496	99.97%	1	0.40%
蒿	4641		14	1	0.0001509%	662497	99.97%	1	0.40%
蒞	4642		14	1	0.0001509%	662498	99.97%	1	0.40%
蓓	4643		14	1	0.0001509%	662499	99.97%	1	0.40%
蒐	4644		14	1	0.0001509%	662500	99.97%	1	0.40%
蒫	4645		14	1	0.0001509%	662501	99.97%	1	0.40%
蓿	4646		15	1	0.0001509%	662502	99.97%	1	0.40%
蔫	4647		15	1	0.0001509%	662503	99.97%	1	0.40%
蓼	4648		15	1	0.0001509%	662504	99.97%	1	0.40%
蕺	4649		17	1	0.0001509%	662505	99.97%	1	0.40%
薈	4650		17	1	0.0001509%	662506	99.97%	1	0.40%
薸	4651		18	1	0.0001509%	662507	99.97%	1	0.40%
藪	4652		19	1	0.0001509%	662508	99.97%	1	0.40%
蘑	4653		20	1	0.0001509%	662509	99.97%	1	0.40%
虱	4654		8	1	0.0001509%	662510	99.97%	1	0.40%
蚪	4655		10	1	0.0001509%	662511	99.97%	1	0.40%
蚣	4656		10	1	0.0001509%	662512	99.97%	1	0.40%
蚶	4657		11	1	0.0001509%	662513	99.97%	1	0.40%
蜈	4658		13	1	0.0001509%	662514	99.97%	1	0.40%
蜩	4659		14	1	0.0001509%	662515	99.97%	1	0.40%
蜚	4660		14	1	0.0001509%	662516	99.97%	1	0.40%
蝸	4661		15	1	0.0001509%	662517	99.97%	1	0.40%
蝌	4662		15	1	0.0001509%	662518	99.97%	1	0.40%
蝺	4663		15	1	0.0001509%	662519	99.97%	1	0.40%
螯	4664		17	1	0.0001509%	662520	99.97%	1	0.40%
蠣	4665		21	1	0.0001509%	662521	99.97%	1	0.40%
蠹	4666		24	1	0.0001509%	662522	99.97%	1	0.40%
衩	4667		8	1	0.0001509%	662523	99.97%	1	0.40%
袂	4668		9	1	0.0001509%	662524	99.97%	1	0.40%
袪	4669		10	1	0.0001509%	662525	99.97%	1	0.40%
袓	4670		10	1	0.0001509%	662526	99.97%	1	0.40%
袤	4671		11	1	0.0001509%	662527	99.97%	1	0.40%
裱	4672		13	1	0.0001509%	662528	99.97%	1	0.40%
褶	4673		16	1	0.0001509%	662529	99.97%	1	0.40%
褻	4674		17	1	0.0001509%	662530	99.97%	1	0.40%
襌	4675		17	1	0.0001509%	662531	99.97%	1	0.40%
襠	4676		18	1	0.0001509%	662532	99.97%	1	0.40%
覃	4677		12	1	0.0001509%	662533	99.97%	1	0.40%
覷	4678		19	1	0.0001509%	662534	99.97%	1	0.40%
訇	4679		9	1	0.0001509%	662535	99.98%	1	0.40%
訢	4680		11	1	0.0001509%	662536	99.98%	1	0.40%
註	4681		12	1	0.0001509%	662537	99.98%	1	0.40%
詔	4682		12	1	0.0001509%	662538	99.98%	1	0.40%
詆	4683		12	1	0.0001509%	662539	99.98%	1	0.40%
詼	4684		13	1	0.0001509%	662540	99.98%	1	0.40%
詣	4685		13	1	0.0001509%	662541	99.98%	1	0.40%
詹	4686		13	1	0.0001509%	662542	99.98%	1	0.40%
誆	4687		13	1	0.0001509%	662543	99.98%	1	0.40%
諂	4688		15	1	0.0001509%	662544	99.98%	1	0.40%
諍	4689		15	1	0.0001509%	662545	99.98%	1	0.40%
謁	4690		16	1	0.0001509%	662546	99.98%	1	0.40%
諯	4691		16	1	0.0001509%	662547	99.98%	1	0.40%
謅	4692		17	1	0.0001509%	662548	99.98%	1	0.40%
謚	4693		17	1	0.0001509%	662549	99.98%	1	0.40%
譎	4694		19	1	0.0001509%	662550	99.98%	1	0.40%
譪	4695		20	1	0.0001509%	662551	99.98%	1	0.40%
譴	4696		21	1	0.0001509%	662552	99.98%	1	0.40%
豚	4697		11	1	0.0001509%	662553	99.98%	1	0.40%
貂	4698		12	1	0.0001509%	662554	99.98%	1	0.40%
賡	4699		15	1	0.0001509%	662555	99.98%	1	0.40%
贓	4700		21	1	0.0001509%	662556	99.98%	1	0.40%
贖	4701		22	1	0.0001509%	662557	99.98%	1	0.40%
贙	4702		23	1	0.0001509%	662558	99.98%	1	0.40%
趵	4703		10	1	0.0001509%	662559	99.98%	1	0.40%
趿	4704		11	1	0.0001509%	662560	99.98%	1	0.40%
跐	4705		13	1	0.0001509%	662561	99.98%	1	0.40%
踅	4706		14	1	0.0001509%	662562	99.98%	1	0.40%
踝	4707		15	1	0.0001509%	662563	99.98%	1	0.40%
踟	4708		15	1	0.0001509%	662564	99.98%	1	0.40%
踡	4709		15	1	0.0001509%	662565	99.98%	1	0.40%
踮	4710		15	1	0.0001509%	662566	99.98%	1	0.40%
踴	4711		16	1	0.0001509%	662567	99.98%	1	0.40%
踼	4712		16	1	0.0001509%	662568	99.98%	1	0.40%
蹚	4713		18	1	0.0001509%	662569	99.98%	1	0.40%
蹴	4714		19	1	0.0001509%	662570	99.98%	1	0.40%
躆	4715		20	1	0.0001509%	662571	99.98%	1	0.40%
躕	4716		22	1	0.0001509%	662572	99.98%	1	0.40%
躦	4717		26	1	0.0001509%	662573	99.98%	1	0.40%
軔	4718		10	1	0.0001509%	662574	99.98%	1	0.40%
軾	4719		13	1	0.0001509%	662575	99.98%	1	0.40%
輓	4720		14	1	0.0001509%	662576	99.98%	1	0.40%
輟	4721		15	1	0.0001509%	662577	99.98%	1	0.40%
輥	4722		15	1	0.0001509%	662578	99.98%	1	0.40%
轤	4723		23	1	0.0001509%	662579	99.98%	1	0.40%
迍	4724		7	1	0.0001509%	662580	99.98%	1	0.40%
迕	4725		7	1	0.0001509%	662581	99.98%	1	0.40%
迤	4726		8	1	0.0001509%	662582	99.98%	1	0.40%
迨	4727		8	1	0.0001509%	662583	99.98%	1	0.40%
迠	4728		9	1	0.0001509%	662584	99.98%	1	0.40%
适	4729		9	1	0.0001509%	662585	99.98%	1	0.40%
逕	4730		10	1	0.0001509%	662586	99.98%	1	0.40%
逞	4731		10	1	0.0001509%	662587	99.98%	1	0.40%
迼	4732		10	1	0.0001509%	662588	99.98%	1	0.40%
逡	4733		10	1	0.0001509%	662589	99.98%	1	0.40%
遑	4734		12	1	0.0001509%	662590	99.98%	1	0.40%
遢	4735		13	1	0.0001509%	662591	99.98%	1	0.40%
遴	4736		15	1	0.0001509%	662592	99.98%	1	0.40%
邇	4737		17	1	0.0001509%	662593	99.98%	1	0.40%
邋	4738		18	1	0.0001509%	662594	99.98%	1	0.40%
邐	4739		22	1	0.0001509%	662595	99.98%	1	0.40%
邢	4740		6	1	0.0001509%	662596	99.98%	1	0.40%
邵	4741		7	1	0.0001509%	662597	99.98%	1	0.40%
邱	4742		7	1	0.0001509%	662598	99.98%	1	0.40%
酊	4743		9	1	0.0001509%	662599	99.98%	1	0.40%
酐	4744		10	1	0.0001509%	662600	99.98%	1	0.40%
酢	4745		12	1	0.0001509%	662601	99.99%	1	0.40%
酩	4746		13	1	0.0001509%	662602	99.99%	1	0.40%
醃	4747		15	1	0.0001509%	662603	99.99%	1	0.40%
醞	4748		17	1	0.0001509%	662604	99.99%	1	0.40%
醚	4749		17	1	0.0001509%	662605	99.99%	1	0.40%
醛	4750		17	1	0.0001509%	662606	99.99%	1	0.40%
釔	4751		9	1	0.0001509%	662607	99.99%	1	0.40%
釗	4752		10	1	0.0001509%	662608	99.99%	1	0.40%
釽	4753		12	1	0.0001509%	662609	99.99%	1	0.40%
鈾	4754		13	1	0.0001509%	662610	99.99%	1	0.40%
鉑	4755		13	1	0.0001509%	662611	99.99%	1	0.40%
鈿	4756		13	1	0.0001509%	662612	99.99%	1	0.40%
銓	4757		14	1	0.0001509%	662613	99.99%	1	0.40%
銨	4758		14	1	0.0001509%	662614	99.99%	1	0.40%
	4759		15	1	0.0001509%	662615	99.99%	1	0.40%
鋃	4760		15	1	0.0001509%	662616	99.99%	1	0.40%
錛	4761		16	1	0.0001509%	662617	99.99%	1	0.40%
鎂	4762		17	1	0.0001509%	662618	99.99%	1	0.40%
鍊	4763		17	1	0.0001509%	662619	99.99%	1	0.40%
鍥	4764		17	1	0.0001509%	662620	99.99%	1	0.40%
鍚	4765		17	1	0.0001509%	662621	99.99%	1	0.40%
鍜	4766		17	1	0.0001509%	662622	99.99%	1	0.40%
鎊	4767		18	1	0.0001509%	662623	99.99%	1	0.40%
鏃	4768		19	1	0.0001509%	662624	99.99%	1	0.40%
鏖	4769		19	1	0.0001509%	662625	99.99%	1	0.40%
鏤	4770		19	1	0.0001509%	662626	99.99%	1	0.40%
鏹	4771		19	1	0.0001509%	662627	99.99%	1	0.40%
鏽	4772		20	1	0.0001509%	662628	99.99%	1	0.40%
鐉	4773		20	1	0.0001509%	662629	99.99%	1	0.40%
鐳	4774		21	1	0.0001509%	662630	99.99%	1	0.40%
鐺	4775		21	1	0.0001509%	662631	99.99%	1	0.40%
鐸	4776		21	1	0.0001509%	662632	99.99%	1	0.40%
鑊	4777		22	1	0.0001509%	662633	99.99%	1	0.40%
鑣	4778		23	1	0.0001509%	662634	99.99%	1	0.40%
鑫	4779		24	1	0.0001509%	662635	99.99%	1	0.40%
鑾	4780		27	1	0.0001509%	662636	99.99%	1	0.40%
閎	4781		12	1	0.0001509%	662637	99.99%	1	0.40%
閘	4782		13	1	0.0001509%	662638	99.99%	1	0.40%
閞	4783		13	1	0.0001509%	662639	99.99%	1	0.40%
闇	4784		17	1	0.0001509%	662640	99.99%	1	0.40%
陛	4785		9	1	0.0001509%	662641	99.99%	1	0.40%
陜	4786		9	1	0.0001509%	662642	99.99%	1	0.40%
陬	4787		10	1	0.0001509%	662643	99.99%	1	0.40%
隴	4788		18	1	0.0001509%	662644	99.99%	1	0.40%
隼	4789		10	1	0.0001509%	662645	99.99%	1	0.40%
雋	4790		13	1	0.0001509%	662646	99.99%	1	0.40%
巂	4791		18	1	0.0001509%	662647	99.99%	1	0.40%
霪	4792		19	1	0.0001509%	662648	99.99%	1	0.40%
霰	4793		20	1	0.0001509%	662649	99.99%	1	0.40%
靚	4794		15	1	0.0001509%	662650	99.99%	1	0.40%
靴	4795		13	1	0.0001509%	662651	99.99%	1	0.40%
鞘	4796		16	1	0.0001509%	662652	99.99%	1	0.40%
鞠	4797		17	1	0.0001509%	662653	99.99%	1	0.40%
韁	4798		22	1	0.0001509%	662654	99.99%	1	0.40%
頎	4799		13	1	0.0001509%	662655	99.99%	1	0.40%
頧	4800		15	1	0.0001509%	662656	99.99%	1	0.40%
顟	4801		20	1	0.0001509%	662657	99.99%	1	0.40%
顰	4802		24	1	0.0001509%	662658	99.99%	1	0.40%
颺	4803		18	1	0.0001509%	662659	99.99%	1	0.40%
飆	4804		21	1	0.0001509%	662660	99.99%	1	0.40%
飩	4805		12	1	0.0001509%	662661	99.99%	1	0.40%
餛	4806		16	1	0.0001509%	662662	99.99%	1	0.40%
餚	4807		16	1	0.0001509%	662663	99.99%	1	0.40%
餮	4808		18	1	0.0001509%	662664	99.99%	1	0.40%
饈	4809		19	1	0.0001509%	662665	99.99%	1	0.40%
饕	4810		22	1	0.0001509%	662666	99.99%	1	0.40%
饞	4811		25	1	0.0001509%	662667	99.9999999999%	1	0.40%
駒	4812		15	1	0.0001509%	662668	99.9999999999%	1	0.40%
騏	4813		18	1	0.0001509%	662669	99.9999999999%	1	0.40%
騫	4814		20	1	0.0001509%	662670	99.9999999999%	1	0.40%
驍	4815		22	1	0.0001509%	662671	99.9999999999%	1	0.40%
驪	4816		29	1	0.0001509%	662672	99.9999999999%	1	0.40%
骰	4817		14	1	0.0001509%	662673	99.9999999999%	1	0.40%
骷	4818		15	1	0.0001509%	662674	99.9999999999%	1	0.40%
骿	4819		16	1	0.0001509%	662675	99.9999999999%	1	0.40%
髏	4820		21	1	0.0001509%	662676	99.9999999999%	1	0.40%
髯	4821		15	1	0.0001509%	662677	99.9999999999%	1	0.40%
髻	4822		16	1	0.0001509%	662678	99.9999999999%	1	0.40%
魈	4823		17	1	0.0001509%	662679	99.9999999999%	1	0.40%
魑	4824		21	1	0.0001509%	662680	99.9999999999%	1	0.40%
鯉	4825		18	1	0.0001509%	662681	99.9999999999%	1	0.40%
鯁	4826		18	1	0.0001509%	662682	99.9999999999%	1	0.40%
鯨	4827		19	1	0.0001509%	662683	99.9999999999%	1	0.40%
鯧	4828		19	1	0.0001509%	662684	99.9999999999%	1	0.40%
鰍	4829		20	1	0.0001509%	662685	99.9999999999%	1	0.40%
鰻	4830		22	1	0.0001509%	662686	99.9999999999%	1	0.40%
鰲	4831		22	1	0.0001509%	662687	99.9999999999%	1	0.40%
鳶	4832		14	1	0.0001509%	662688	99.9999999999%	1	0.40%
鵖	4833		18	1	0.0001509%	662689	99.9999999999%	1	0.40%
鵡	4834		19	1	0.0001509%	662690	99.9999999999%	1	0.40%
鶩	4835		20	1	0.0001509%	662691	99.9999999999%	1	0.40%
鷗	4836		22	1	0.0001509%	662692	99.9999999999%	1	0.40%
鷸	4837		23	1	0.0001509%	662693	99.9999999999%	1	0.40%
麋	4838		17	1	0.0001509%	662694	99.9999999999%	1	0.40%
麟	4839		23	1	0.0001509%	662695	99.9999999999%	1	0.40%
齟	4840		20	1	0.0001509%	662696	99.9999999999%	1	0.40%
齦	4841		21	1	0.0001509%	662697	99.9999999999%	1	0.40%
齬	4842		22	1	0.0001509%	662698	99.9999999999%	1	0.40%
齲	4843		24	1	0.0001509%	662699	99.9999999999%	1	0.40%
鸗	4844		28	1	0.0001509%	662700	99.9999999999%	1	0.40%
