單字	序號	部首	筆劃	頻次	頻率	累積頻次	累積頻率	見檔次	見檔率
的	1		8	29327	4.425%	29327	4.425%	247	99.99%
一	2		1	10466	1.579%	39793	6.005%	247	99.99%
是	3		9	8724	1.316%	48517	7.321%	247	99.99%
了	4		2	7621	1.150%	56138	8.471%	247	99.99%
不	5		4	7074	1.067%	63212	9.539%	247	99.99%
在	6		6	6654	1.004%	69866	10.54%	247	99.99%
有	7		6	5945	0.8971%	75811	11.44%	247	99.99%
人	8		2	5912	0.8921%	81723	12.33%	246	99.60%
我	9		7	5855	0.8835%	87578	13.22%	240	97.17%
他	10		5	4718	0.7119%	92296	13.93%	229	92.71%
這	11		10	4613	0.6961%	96909	14.62%	246	99.60%
和	12		8	4101	0.6188%	101010	15.24%	247	99.99%
上	13		3	3971	0.5992%	104981	15.84%	247	99.99%
大	14		3	3754	0.5665%	108735	16.41%	247	99.99%
個	15		10	3734	0.5635%	112469	16.97%	247	99.99%
中	16		4	3704	0.5589%	116173	17.53%	244	98.79%
地	17		6	3697	0.5579%	119870	18.09%	246	99.60%
來	18		8	3425	0.5168%	123295	18.60%	247	99.99%
為	19		9	3335	0.5032%	126630	19.11%	246	99.60%
國	20		11	3088	0.466%	129718	19.57%	213	86.23%
們	21		10	3083	0.4652%	132801	20.04%	242	97.98%
著	22		12	2931	0.4423%	135732	20.48%	241	97.57%
到	23		8	2886	0.4355%	138618	20.92%	246	99.60%
生	24		5	2861	0.4317%	141479	21.35%	244	98.79%
年	25		6	2783	0.4199%	144262	21.77%	238	96.36%
時	26		10	2690	0.4059%	146952	22.17%	245	99.19%
要	27		9	2687	0.4055%	149639	22.58%	246	99.60%
出	28		5	2645	0.3991%	152284	22.98%	246	99.60%
會	29		13	2614	0.3944%	154898	23.37%	243	98.38%
以	30		5	2548	0.3845%	157446	23.76%	247	99.99%
說	31		14	2479	0.3741%	159925	24.13%	234	94.74%
也	32		3	2379	0.359%	162304	24.49%	243	98.38%
作	33		7	2347	0.3542%	164651	24.85%	233	94.33%
發	34		12	2308	0.3483%	166959	25.19%	241	97.57%
學	35		16	2302	0.3474%	169261	25.54%	211	85.43%
就	36		12	2259	0.3409%	171520	25.88%	241	97.57%
對	37		14	2248	0.3392%	173768	26.22%	245	99.19%
子	38		3	2225	0.3357%	175993	26.56%	223	90.28%
家	39		10	2178	0.3287%	178171	26.89%	237	95.95%
自	40		6	2170	0.3274%	180341	27.21%	244	98.79%
業	41		13	2135	0.3222%	182476	27.54%	160	64.78%
那	42		6	2065	0.3116%	184541	27.85%	213	86.23%
經	43		13	2054	0.3099%	186595	28.16%	236	95.55%
得	44		11	2014	0.3039%	188609	28.46%	246	99.60%
而	45		6	2014	0.3039%	190623	28.76%	240	97.17%
能	46		10	1994	0.3009%	192617	29.07%	240	97.17%
於	47		8	1988	0.300%	194605	29.37%	237	95.95%
過	48		12	1955	0.295%	196560	29.66%	247	99.99%
下	49		3	1930	0.2912%	198490	29.95%	246	99.60%
成	50		6	1879	0.2835%	200369	30.24%	239	96.76%
多	51		6	1855	0.2799%	202224	30.52%	245	99.19%
現	52		11	1854	0.2798%	204078	30.79%	242	97.98%
行	53		6	1812	0.2734%	205890	31.07%	234	94.74%
可	54		5	1800	0.2716%	207690	31.34%	243	98.38%
小	55		3	1783	0.2691%	209473	31.61%	222	89.88%
之	56		4	1713	0.2585%	211186	31.87%	241	97.57%
後	57		9	1709	0.2579%	212895	32.13%	242	97.98%
文	58		4	1680	0.2535%	214575	32.38%	192	77.73%
方	59		4	1677	0.2531%	216252	32.63%	231	93.52%
理	60		11	1599	0.2413%	217851	32.87%	212	85.83%
種	61		14	1590	0.2399%	219441	33.11%	238	96.36%
去	62		5	1578	0.2381%	221019	33.35%	223	90.28%
用	63		5	1574	0.2375%	222593	33.59%	234	94.74%
起	64		10	1561	0.2356%	224154	33.82%	239	96.76%
動	65		11	1560	0.2354%	225714	34.06%	235	95.14%
然	66		12	1549	0.2337%	227263	34.29%	237	95.95%
天	67		4	1540	0.2324%	228803	34.53%	215	87.04%
實	68		14	1540	0.2324%	230343	34.76%	227	91.90%
都	69		9	1531	0.231%	231874	34.99%	240	97.17%
同	70		6	1528	0.2306%	233402	35.22%	233	94.33%
心	71		4	1518	0.2291%	234920	35.45%	229	92.71%
還	72		16	1502	0.2266%	236422	35.68%	241	97.57%
分	73		4	1501	0.2265%	237923	35.90%	232	93.93%
產	74		11	1501	0.2265%	239424	36.13%	167	67.61%
開	75		12	1486	0.2242%	240910	36.35%	235	95.14%
麼	76		14	1481	0.2235%	242391	36.58%	202	81.78%
主	77		5	1477	0.2229%	243868	36.80%	204	82.59%
進	78		11	1476	0.2227%	245344	37.02%	235	95.14%
她	79		6	1426	0.2152%	246770	37.24%	115	46.56%
法	80		8	1419	0.2141%	248189	37.45%	206	83.40%
從	81		11	1412	0.2131%	249601	37.66%	243	98.38%
看	82		9	1403	0.2117%	251004	37.88%	215	87.04%
面	83		9	1389	0.2096%	252393	38.09%	240	97.17%
與	84		14	1360	0.2052%	253753	38.29%	206	83.40%
工	85		3	1358	0.2049%	255111	38.50%	194	78.54%
民	86		5	1347	0.2033%	256458	38.70%	185	74.90%
好	87		6	1344	0.2028%	257802	38.90%	231	93.52%
沒	88		7	1335	0.2014%	259137	39.10%	219	88.66%
又	89		2	1280	0.1931%	260417	39.30%	238	96.36%
老	90		6	1279	0.193%	261696	39.49%	180	72.87%
情	91		11	1256	0.1895%	262952	39.68%	220	89.07%
把	92		7	1236	0.1865%	264188	39.87%	225	91.09%
想	93		13	1235	0.1864%	265423	40.05%	209	84.62%
當	94		13	1231	0.1858%	266654	40.24%	234	94.74%
長	95		8	1230	0.1856%	267884	40.42%	225	91.09%
高	96		10	1225	0.1848%	269109	40.61%	229	92.71%
十	97		2	1221	0.1842%	270330	40.79%	220	89.07%
化	98		4	1219	0.1839%	271549	40.98%	197	79.76%
所	99		8	1216	0.1835%	272765	41.16%	228	92.31%
你	100		7	1213	0.183%	273978	41.34%	135	54.66%
外	101		5	1206	0.182%	275184	41.52%	225	91.09%
前	102		9	1202	0.1814%	276386	41.71%	239	96.76%
山	103		3	1199	0.1809%	277585	41.89%	152	61.54%
體	104		23	1199	0.1809%	278784	42.07%	215	87.04%
些	105		8	1196	0.1805%	279980	42.25%	235	95.14%
定	106		8	1188	0.1793%	281168	42.43%	222	89.88%
樣	107		15	1183	0.1785%	282351	42.61%	230	93.12%
裏	108		13	1177	0.1776%	283528	42.78%	120	48.58%
等	109		12	1170	0.1766%	284698	42.96%	219	88.66%
如	110		6	1165	0.1758%	285863	43.14%	230	93.12%
水	111		4	1159	0.1749%	287022	43.31%	201	81.38%
重	112		9	1150	0.1735%	288172	43.48%	224	90.69%
性	113		8	1144	0.1726%	289316	43.66%	192	77.73%
展	114		10	1138	0.1717%	290454	43.83%	156	63.16%
其	115		8	1120	0.169%	291574	44.00%	218	88.26%
意	116		13	1111	0.1676%	292685	44.17%	220	89.07%
事	117		8	1109	0.1673%	293794	44.33%	219	88.66%
代	118		5	1090	0.1645%	294884	44.50%	192	77.73%
關	119		19	1081	0.1631%	295965	44.66%	211	85.43%
者	120		8	1069	0.1613%	297034	44.82%	213	86.23%
建	121		9	1065	0.1607%	298099	44.98%	153	61.94%
部	122		10	1050	0.1584%	299149	45.14%	197	79.76%
活	123		9	1048	0.1581%	300197	45.30%	210	85.02%
全	124		6	1042	0.1572%	301239	45.46%	216	87.45%
力	125		2	1040	0.1569%	302279	45.61%	204	82.59%
手	126		4	1029	0.1553%	303308	45.77%	201	81.38%
社	127		7	1029	0.1553%	304337	45.92%	146	59.11%
三	128		3	1018	0.1536%	305355	46.08%	226	91.50%
本	129		5	1017	0.1535%	306372	46.23%	217	87.85%
無	130		12	1012	0.1527%	307384	46.38%	228	92.31%
點	131		17	1009	0.1523%	308393	46.54%	235	95.14%
兩	132		8	1002	0.1512%	309395	46.69%	224	90.69%
資	133		13	998	0.1506%	310393	46.84%	125	50.61%
道	134		12	996	0.1503%	311389	46.99%	219	88.66%
使	135		8	992	0.1497%	312381	47.14%	222	89.88%
它	136		5	989	0.1492%	313370	47.29%	180	72.87%
制	137		8	980	0.1479%	314350	47.43%	157	63.56%
但	138		7	965	0.1456%	315315	47.58%	221	89.47%
頭	139		16	958	0.1446%	316273	47.72%	193	78.14%
只	140		5	951	0.1435%	317224	47.87%	221	89.47%
明	141		8	951	0.1435%	318175	48.01%	228	92.31%
加	142		5	945	0.1426%	319120	48.15%	199	80.57%
新	143		13	943	0.1423%	320063	48.30%	217	87.85%
因	144		6	934	0.1409%	320997	48.44%	220	89.07%
正	145		5	930	0.1403%	321927	48.58%	232	93.93%
濟	146		17	928	0.140%	322855	48.72%	111	44.94%
間	147		12	922	0.1391%	323777	48.86%	225	91.09%
立	148		5	899	0.1357%	324676	48.99%	184	74.49%
己	149		3	893	0.1348%	325569	49.13%	203	82.19%
氣	150		10	893	0.1348%	326462	49.26%	185	74.90%
品	151		9	892	0.1346%	327354	49.40%	162	65.59%
向	152		6	890	0.1343%	328244	49.53%	217	87.85%
像	153		14	867	0.1308%	329111	49.66%	173	70.04%
身	154		7	867	0.1308%	329978	49.79%	215	87.04%
見	155		7	862	0.1301%	330840	49.92%	207	83.81%
問	156		11	850	0.1283%	331690	50.05%	204	82.59%
市	157		5	847	0.1278%	332537	50.18%	128	51.82%
已	158		3	845	0.1275%	333382	50.31%	219	88.66%
二	159		2	844	0.1274%	334226	50.43%	210	85.02%
次	160		6	844	0.1274%	335070	50.56%	207	83.81%
很	161		9	815	0.123%	335885	50.68%	213	86.23%
農	162		13	810	0.1222%	336695	50.81%	110	44.53%
什	163		4	808	0.1219%	337503	50.93%	163	65.99%
兒	164		8	808	0.1219%	338311	51.05%	142	57.49%
物	165		8	808	0.1219%	339119	51.17%	184	74.49%
相	166		9	808	0.1219%	339927	51.29%	218	88.26%
提	167		12	805	0.1215%	340732	51.42%	198	80.16%
最	168		12	805	0.1215%	341537	51.54%	222	89.88%
走	169		7	795	0.120%	342332	51.66%	183	74.09%
合	170		6	791	0.1194%	343123	51.78%	180	72.87%
金	171		8	791	0.1194%	343914	51.90%	138	55.87%
應	172		17	790	0.1192%	344704	52.02%	199	80.57%
美	173		9	790	0.1192%	345494	52.13%	160	64.78%
政	174		9	787	0.1188%	346281	52.25%	129	52.23%
由	175		5	777	0.1172%	347058	52.37%	205	83.00%
基	176		11	772	0.1165%	347830	52.49%	135	54.66%
義	177		13	771	0.1163%	348601	52.60%	149	60.32%
論	178		15	765	0.1154%	349366	52.72%	176	71.26%
幾	179		12	764	0.1153%	350130	52.83%	214	86.64%
特	180		10	750	0.1132%	350880	52.95%	191	77.33%
感	181		13	746	0.1126%	351626	53.06%	181	73.28%
平	182		5	742	0.112%	352368	53.17%	195	78.95%
結	183		12	741	0.1118%	353109	53.28%	201	81.38%
日	184		4	736	0.1111%	353845	53.39%	200	80.97%
知	185		8	733	0.1106%	354578	53.51%	195	78.95%
門	186		8	733	0.1106%	355311	53.62%	182	73.68%
此	187		6	730	0.1102%	356041	53.73%	211	85.43%
術	188		11	729	0.110%	356770	53.84%	147	59.51%
並	189		8	728	0.1099%	357498	53.95%	208	84.21%
各	190		6	728	0.1099%	358226	54.06%	172	69.64%
形	191		7	725	0.1094%	358951	54.16%	178	72.06%
位	192		7	722	0.1089%	359673	54.27%	203	82.19%
表	193		8	722	0.1089%	360395	54.38%	186	75.30%
利	194		7	721	0.1088%	361116	54.49%	150	60.73%
土	195		3	719	0.1085%	361835	54.60%	117	47.37%
女	196		3	716	0.108%	362551	54.71%	131	53.04%
內	197		4	715	0.1079%	363266	54.82%	189	76.52%
教	198		11	714	0.1077%	363980	54.92%	137	55.47%
入	199		2	711	0.1073%	364691	55.03%	196	79.35%
口	200		3	711	0.1073%	365402	55.14%	173	70.04%
強	201		11	709	0.107%	366111	55.25%	170	68.83%
目	202		5	708	0.1068%	366819	55.35%	189	76.52%
被	203		10	701	0.1058%	367520	55.46%	195	78.95%
世	204		5	699	0.1055%	368219	55.56%	178	72.06%
機	205		16	698	0.1053%	368917	55.67%	178	72.06%
原	206		10	697	0.1052%	369614	55.77%	203	82.19%
場	207		12	696	0.105%	370310	55.88%	148	59.92%
流	208		9	694	0.1047%	371004	55.98%	181	73.28%
真	209		10	692	0.1044%	371696	56.09%	194	78.54%
風	210		9	689	0.104%	372385	56.19%	180	72.87%
更	211		7	687	0.1037%	373072	56.30%	207	83.81%
度	212		9	686	0.1035%	373758	56.40%	179	72.47%
眼	213		11	686	0.1035%	374444	56.50%	161	65.18%
回	214		6	684	0.1032%	375128	56.61%	189	76.52%
題	215		18	684	0.1032%	375812	56.71%	168	68.02%
公	216		4	683	0.1031%	376495	56.81%	171	69.23%
深	217		11	680	0.1026%	377175	56.91%	181	73.28%
神	218		9	674	0.1017%	377849	57.02%	172	69.64%
第	219		11	671	0.1013%	378520	57.12%	177	71.66%
給	220		12	669	0.101%	379189	57.22%	193	78.14%
思	221		9	668	0.1008%	379857	57.32%	174	70.45%
管	222		14	665	0.1003%	380522	57.42%	172	69.64%
色	223		6	662	0.09989%	381184	57.52%	179	72.47%
比	224		4	661	0.09974%	381845	57.62%	197	79.76%
變	225		23	658	0.09929%	382503	57.72%	187	75.71%
區	226		11	656	0.09899%	383159	57.82%	128	51.82%
聲	227		17	656	0.09899%	383815	57.92%	155	62.75%
少	228		4	654	0.09869%	384469	58.02%	200	80.97%
報	229		12	651	0.09823%	385120	58.11%	128	51.82%
四	230		5	649	0.09793%	385769	58.21%	196	79.35%
務	231		11	645	0.09733%	386414	58.31%	127	51.42%
月	232		4	644	0.09718%	387058	58.41%	172	69.64%
海	233		10	644	0.09718%	387702	58.50%	135	54.66%
話	234		13	640	0.09657%	388342	58.60%	174	70.45%
量	235		12	633	0.09552%	388975	58.70%	157	63.56%
類	236		19	633	0.09552%	389608	58.79%	137	55.47%
企	237		6	631	0.09522%	390239	58.89%	61	24.70%
調	238		15	628	0.09476%	390867	58.98%	161	65.18%
常	239		11	627	0.09461%	391494	59.08%	183	74.09%
期	240		12	625	0.09431%	392119	59.17%	171	69.23%
別	241		7	624	0.09416%	392743	59.26%	210	85.02%
通	242		10	621	0.09371%	393364	59.36%	186	75.30%
先	243		6	617	0.0931%	393981	59.45%	193	78.14%
處	244		11	614	0.09265%	394595	59.54%	198	80.16%
認	245		14	611	0.0922%	395206	59.64%	185	74.90%
保	246		9	608	0.09175%	395814	59.73%	130	52.63%
林	247		8	606	0.09144%	396420	59.82%	114	46.15%
觀	248		25	605	0.09129%	397025	59.91%	169	68.42%
總	249		17	603	0.09099%	397628	60.00%	190	76.92%
東	250		8	600	0.09054%	398228	60.09%	158	63.97%
光	251		6	596	0.08994%	398824	60.18%	175	70.85%
改	252		7	593	0.08948%	399417	60.27%	147	59.51%
設	253		11	591	0.08918%	400008	60.36%	113	45.75%
果	254		8	590	0.08903%	400598	60.45%	190	76.92%
解	255		13	588	0.08873%	401186	60.54%	182	73.68%
或	256		8	587	0.08858%	401773	60.63%	175	70.85%
放	257		8	586	0.08843%	402359	60.72%	185	74.90%
識	258		19	585	0.08828%	402944	60.80%	154	62.35%
名	259		6	579	0.08737%	403523	60.89%	172	69.64%
信	260		9	578	0.08722%	404101	60.98%	162	65.59%
愛	261		13	574	0.08662%	404675	61.06%	148	59.92%
統	262		11	573	0.08646%	405248	61.15%	130	52.63%
裡	263		12	573	0.08646%	405821	61.24%	79	31.98%
受	264		8	572	0.08631%	406393	61.32%	190	76.92%
及	265		4	571	0.08616%	406964	61.41%	161	65.18%
條	266		11	571	0.08616%	407535	61.50%	192	77.73%
北	267		5	568	0.08571%	408103	61.58%	131	53.04%
價	268		15	565	0.08526%	408668	61.67%	122	49.39%
員	269		10	565	0.08526%	409233	61.75%	152	61.54%
科	270		9	563	0.08496%	409796	61.84%	124	50.20%
五	271		4	562	0.0848%	410358	61.92%	180	72.87%
西	272		6	561	0.08465%	410919	62.01%	168	68.02%
寫	273		15	551	0.08314%	411470	62.09%	137	55.47%
書	274		10	548	0.08269%	412018	62.17%	125	50.61%
步	275		7	547	0.08254%	412565	62.26%	180	72.87%
質	276		15	545	0.08224%	413110	62.34%	160	64.78%
打	277		5	539	0.08133%	413649	62.42%	168	68.02%
界	278		9	539	0.08133%	414188	62.50%	175	70.85%
馬	279		10	537	0.08103%	414725	62.58%	123	49.80%
滿	280		14	533	0.08043%	415258	62.66%	177	71.66%
花	281		8	531	0.08013%	415789	62.74%	147	59.51%
任	282		6	530	0.07998%	416319	62.82%	163	65.99%
究	283		7	529	0.07982%	416848	62.90%	129	52.23%
反	284		4	525	0.07922%	417373	62.98%	169	68.42%
白	285		5	524	0.07907%	417897	63.06%	156	63.16%
再	286		6	523	0.07892%	418420	63.14%	183	74.09%
張	287		11	523	0.07892%	418943	63.22%	151	61.13%
研	288		9	523	0.07892%	419466	63.30%	99	40.08%
造	289		10	523	0.07892%	419989	63.38%	152	61.54%
才	290		3	521	0.07862%	420510	63.45%	182	73.68%
規	291		11	521	0.07862%	421031	63.53%	116	46.96%
難	292		19	520	0.07847%	421551	63.61%	188	76.11%
治	293		8	516	0.07786%	422067	63.69%	116	46.96%
路	294		13	510	0.07696%	422577	63.77%	175	70.85%
指	295		9	507	0.07651%	423084	63.84%	174	70.45%
計	296		9	505	0.0762%	423589	63.92%	123	49.80%
轉	297		18	501	0.0756%	424090	63.99%	165	66.80%
將	298		11	498	0.07515%	424588	64.07%	171	69.23%
許	299		11	496	0.07485%	425084	64.14%	192	77.73%
求	300		7	495	0.07469%	425579	64.22%	167	67.61%
聽	301		22	491	0.07409%	426070	64.29%	132	53.44%
史	302		5	489	0.07379%	426559	64.37%	117	47.37%
精	303		14	489	0.07379%	427048	64.44%	162	65.59%
服	304		8	486	0.07334%	427534	64.51%	146	59.11%
式	305		6	485	0.07319%	428019	64.59%	148	59.92%
影	306		15	485	0.07319%	428504	64.66%	162	65.59%
清	307		11	485	0.07319%	428989	64.73%	170	68.83%
便	308		9	484	0.07303%	429473	64.81%	168	68.02%
卻	309		9	484	0.07303%	429957	64.88%	162	65.59%
級	310		10	483	0.07288%	430440	64.95%	107	43.32%
接	311		11	482	0.07273%	430922	65.03%	183	74.09%
直	312		8	482	0.07273%	431404	65.10%	187	75.71%
做	313		11	480	0.07243%	431884	65.17%	174	70.45%
決	314		7	480	0.07243%	432364	65.24%	143	57.89%
至	315		6	478	0.07213%	432842	65.31%	186	75.30%
親	316		16	477	0.07198%	433319	65.39%	132	53.44%
邊	317		18	473	0.07137%	433792	65.46%	142	57.49%
革	318		9	473	0.07137%	434265	65.53%	112	45.34%
系	319		7	472	0.07122%	434737	65.60%	110	44.53%
住	320		7	469	0.07077%	435206	65.67%	155	62.75%
數	321		15	466	0.07032%	435672	65.74%	161	65.18%
權	322		22	466	0.07032%	436138	65.81%	86	34.82%
完	323		7	464	0.07002%	436602	65.88%	188	76.11%
創	324		12	463	0.06987%	437065	65.95%	128	51.82%
則	325		9	458	0.06911%	437523	66.02%	144	58.30%
萬	326		13	457	0.06896%	437980	66.09%	135	54.66%
車	327		7	457	0.06896%	438437	66.16%	112	45.34%
群	328		13	454	0.06851%	438891	66.23%	121	48.99%
今	329		4	452	0.06821%	439343	66.30%	181	73.28%
歷	330		16	452	0.06821%	439795	66.36%	137	55.47%
帶	331		11	451	0.06805%	440246	66.43%	179	72.47%
百	332		6	451	0.06805%	440697	66.50%	137	55.47%
整	333		16	446	0.0673%	441143	66.57%	157	63.56%
樹	334		16	445	0.06715%	441588	66.63%	93	37.65%
黃	335		12	444	0.067%	442032	66.70%	103	41.70%
記	336		10	443	0.06685%	442475	66.77%	140	56.68%
收	337		6	442	0.0667%	442917	66.84%	147	59.51%
傳	338		13	441	0.06655%	443358	66.90%	146	59.11%
格	339		10	441	0.06655%	443799	66.97%	152	61.54%
爭	340		8	440	0.0664%	444239	67.03%	139	56.28%
安	341		6	439	0.06624%	444678	67.10%	157	63.56%
藝	342		19	438	0.06609%	445116	67.17%	94	38.06%
命	343		8	437	0.06594%	445553	67.23%	143	57.89%
九	344		2	436	0.06579%	445989	67.30%	112	45.34%
省	345		9	435	0.06564%	446424	67.36%	83	33.60%
根	346		10	433	0.06534%	446857	67.43%	171	69.23%
導	347		16	431	0.06504%	447288	67.49%	140	56.68%
據	348		16	430	0.06489%	447718	67.56%	152	61.54%
切	349		4	429	0.06474%	448147	67.62%	178	72.06%
增	350		15	428	0.06458%	448575	67.69%	111	44.94%
往	351		8	428	0.06458%	449003	67.75%	151	61.13%
商	352		11	427	0.06443%	449430	67.82%	109	44.13%
取	353		8	426	0.06428%	449856	67.88%	158	63.97%
技	354		7	423	0.06383%	450279	67.95%	95	38.46%
件	355		6	422	0.06368%	450701	68.01%	170	68.83%
運	356		12	422	0.06368%	451123	68.07%	132	53.44%
何	357		7	421	0.06353%	451544	68.14%	162	65.59%
象	358		12	416	0.06277%	451960	68.20%	128	51.82%
每	359		7	415	0.06262%	452375	68.26%	160	64.78%
石	360		5	415	0.06262%	452790	68.33%	101	40.89%
望	361		11	413	0.06232%	453203	68.39%	150	60.73%
村	362		7	412	0.06217%	453615	68.45%	90	36.44%
勞	363		12	411	0.06202%	454026	68.51%	100	40.49%
必	364		5	411	0.06202%	454437	68.57%	156	63.16%
畫	365		12	411	0.06202%	454848	68.64%	69	27.94%
覺	366		20	411	0.06202%	455259	68.70%	140	56.68%
具	367		8	410	0.06187%	455669	68.76%	144	58.30%
專	368		11	410	0.06187%	456079	68.82%	127	51.42%
標	369		15	409	0.06172%	456488	68.88%	123	49.80%
程	370		12	409	0.06172%	456897	68.94%	136	55.06%
領	371		14	408	0.06157%	457305	69.01%	142	57.49%
太	372		4	407	0.06142%	457712	69.07%	135	54.66%
讓	373		24	406	0.06126%	458118	69.13%	147	59.51%
王	374		4	404	0.06096%	458522	69.19%	99	40.08%
極	375		13	403	0.06081%	458925	69.25%	158	63.97%
語	376		14	401	0.06051%	459326	69.31%	120	48.58%
台	377		5	399	0.06021%	459725	69.37%	118	47.77%
際	378		13	399	0.06021%	460124	69.43%	124	50.20%
歌	379		14	398	0.06006%	460522	69.49%	91	36.84%
河	380		8	396	0.05976%	460918	69.55%	91	36.84%
達	381		12	396	0.05976%	461314	69.61%	136	55.06%
電	382		13	396	0.05976%	461710	69.67%	127	51.42%
眾	383		11	393	0.0593%	462103	69.73%	113	45.75%
戰	384		16	391	0.059%	462494	69.79%	116	46.96%
落	385		13	391	0.059%	462885	69.85%	156	63.16%
集	386		12	391	0.059%	463276	69.91%	140	56.68%
越	387		12	390	0.05885%	463666	69.97%	124	50.20%
辦	388		16	389	0.0587%	464055	70.02%	119	48.18%
型	389		9	387	0.0584%	464442	70.08%	105	42.51%
族	390		11	387	0.0584%	464829	70.14%	85	34.41%
階	391		11	387	0.0584%	465216	70.20%	87	35.22%
境	392		14	383	0.05779%	465599	70.26%	119	48.18%
快	393		7	383	0.05779%	465982	70.32%	158	63.97%
笑	394		10	382	0.05764%	466364	70.37%	114	46.15%
青	395		8	380	0.05734%	466744	70.43%	140	56.68%
近	396		7	379	0.05719%	467123	70.49%	176	71.26%
片	397		4	378	0.05704%	467501	70.54%	132	53.44%
單	398		12	377	0.05689%	467878	70.60%	149	60.32%
城	399		9	376	0.05674%	468254	70.66%	110	44.53%
病	400		10	376	0.05674%	468630	70.72%	78	31.58%
始	401		8	375	0.05659%	469005	70.77%	163	65.99%
且	402		5	374	0.05644%	469379	70.83%	166	67.21%
音	403		9	373	0.05628%	469752	70.88%	97	39.27%
廣	404		15	372	0.05613%	470124	70.94%	135	54.66%
需	405		14	371	0.05598%	470495	71.00%	126	51.01%
吃	406		6	370	0.05583%	470865	71.05%	112	45.34%
視	407		12	370	0.05583%	471235	71.11%	160	64.78%
八	408		2	369	0.05568%	471604	71.16%	130	52.63%
效	409		10	368	0.05553%	471972	71.22%	110	44.53%
共	410		6	367	0.05538%	472339	71.27%	130	52.63%
營	411		17	367	0.05538%	472706	71.33%	77	31.17%
確	412		15	367	0.05538%	473073	71.39%	137	55.47%
遠	413		13	367	0.05538%	473440	71.44%	150	60.73%
候	414		10	366	0.05523%	473806	71.50%	138	55.87%
包	415		5	366	0.05523%	474172	71.55%	156	63.16%
失	416		5	366	0.05523%	474538	71.61%	156	63.16%
存	417		6	366	0.05523%	474904	71.66%	129	52.23%
支	418		4	363	0.05478%	475267	71.72%	121	48.99%
料	419		10	363	0.05478%	475630	71.77%	115	46.56%
輕	420		14	362	0.05463%	475992	71.83%	147	59.51%
熱	421		15	361	0.05447%	476353	71.88%	153	61.94%
志	422		7	360	0.05432%	476713	71.93%	98	39.68%
育	423		7	359	0.05417%	477072	71.99%	87	35.22%
即	424		7	357	0.05387%	477429	72.04%	153	61.94%
香	425		9	356	0.05372%	477785	72.10%	95	38.46%
詩	426		13	354	0.05342%	478139	72.15%	62	25.10%
引	427		4	353	0.05327%	478492	72.20%	148	59.92%
息	428		10	353	0.05327%	478845	72.26%	125	50.61%
樂	429		15	351	0.05297%	479196	72.31%	114	46.15%
構	430		14	350	0.05281%	479546	72.36%	107	43.32%
組	431		11	348	0.05251%	479894	72.41%	119	48.18%
言	432		7	348	0.05251%	480242	72.47%	136	55.06%
死	433		6	347	0.05236%	480589	72.52%	101	40.89%
值	434		10	344	0.05191%	480933	72.57%	109	44.13%
興	435		16	343	0.05176%	481276	72.62%	140	56.68%
黑	436		12	343	0.05176%	481619	72.68%	115	46.56%
環	437		17	342	0.05161%	481961	72.73%	101	40.89%
隊	438		11	341	0.05146%	482302	72.78%	94	38.06%
離	439		18	341	0.05146%	482643	72.83%	144	58.30%
非	440		8	341	0.05146%	482984	72.88%	146	59.11%
字	441		6	339	0.05115%	483323	72.93%	126	51.01%
益	442		10	339	0.05115%	483662	72.98%	111	44.94%
紅	443		9	336	0.0507%	483998	73.03%	110	44.53%
持	444		9	335	0.05055%	484333	73.08%	121	48.99%
呢	445		8	334	0.0504%	484667	73.14%	126	51.01%
源	446		13	333	0.05025%	485000	73.19%	82	33.20%
南	447		9	331	0.04995%	485331	73.24%	113	45.75%
該	448		13	330	0.0498%	485661	73.29%	148	59.92%
策	449		12	329	0.04965%	485990	73.33%	76	30.77%
叫	450		5	326	0.04919%	486316	73.38%	115	46.56%
苦	451		9	325	0.04904%	486641	73.43%	134	54.25%
黨	452		20	324	0.04889%	486965	73.48%	67	27.13%
層	453		15	323	0.04874%	487288	73.53%	127	51.42%
投	454		7	323	0.04874%	487611	73.58%	92	37.25%
較	455		13	322	0.04859%	487933	73.63%	122	49.39%
交	456		6	321	0.04844%	488254	73.68%	150	60.73%
古	457		5	321	0.04844%	488575	73.72%	105	42.51%
鄉	458		11	318	0.04799%	488893	73.77%	105	42.51%
算	459		14	317	0.04783%	489210	73.82%	105	42.51%
連	460		10	317	0.04783%	489527	73.87%	150	60.73%
職	461		18	316	0.04768%	489843	73.92%	72	29.15%
派	462		9	314	0.04738%	490157	73.96%	93	37.65%
空	463		8	314	0.04738%	490471	74.01%	138	55.87%
議	464		20	314	0.04738%	490785	74.06%	112	45.34%
師	465		10	313	0.04723%	491098	74.11%	76	30.77%
容	466		10	310	0.04678%	491408	74.15%	145	58.70%
怎	467		9	310	0.04678%	491718	74.20%	133	53.85%
況	468		8	308	0.04648%	492026	74.25%	135	54.66%
食	469		9	308	0.04648%	492334	74.29%	77	31.17%
隨	470		15	306	0.04617%	492640	74.34%	162	65.59%
功	471		5	305	0.04602%	492945	74.38%	112	45.34%
評	472		12	305	0.04602%	493250	74.43%	93	37.65%
七	473		2	304	0.04587%	493554	74.48%	128	51.82%
念	474		8	304	0.04587%	493858	74.52%	109	44.13%
木	475		4	304	0.04587%	494162	74.57%	85	34.41%
節	476		13	304	0.04587%	494466	74.61%	137	55.47%
找	477		7	300	0.04527%	494766	74.66%	126	51.01%
態	478		14	299	0.04512%	495065	74.70%	112	45.34%
僅	479		13	297	0.04482%	495362	74.75%	134	54.25%
斷	480		18	297	0.04482%	495659	74.79%	148	59.92%
聯	481		17	297	0.04482%	495956	74.84%	119	48.18%
院	482		9	294	0.04436%	496250	74.88%	104	42.11%
似	483		7	293	0.04421%	496543	74.93%	133	53.85%
獨	484		16	293	0.04421%	496836	74.97%	118	47.77%
醫	485		18	293	0.04421%	497129	75.02%	60	24.29%
孩	486		9	292	0.04406%	497421	75.06%	83	33.60%
照	487		13	292	0.04406%	497713	75.10%	146	59.11%
告	488		7	291	0.04391%	498004	75.15%	123	49.80%
夜	489		8	291	0.04391%	498295	75.19%	97	39.27%
嚴	490		20	290	0.04376%	498585	75.24%	130	52.63%
富	491		12	290	0.04376%	498875	75.28%	122	49.39%
千	492		3	289	0.04361%	499164	75.32%	132	53.44%
局	493		7	289	0.04361%	499453	75.37%	108	43.72%
半	494		5	288	0.04346%	499741	75.41%	133	53.85%
火	495		4	288	0.04346%	500029	75.45%	118	47.77%
考	496		6	288	0.04346%	500317	75.50%	122	49.39%
銀	497		14	288	0.04346%	500605	75.54%	52	21.05%
早	498		6	287	0.04331%	500892	75.58%	137	55.47%
準	499		13	287	0.04331%	501179	75.63%	113	45.75%
華	500		12	286	0.04316%	501465	75.67%	110	44.53%
六	501		4	283	0.0427%	501748	75.71%	118	47.77%
未	502		5	283	0.0427%	502031	75.76%	137	55.47%
係	503		9	281	0.0424%	502312	75.80%	102	41.30%
初	504		7	280	0.04225%	502592	75.84%	139	56.28%
廠	505		15	280	0.04225%	502872	75.88%	68	27.53%
顯	506		23	280	0.04225%	503152	75.92%	151	61.13%
查	507		9	277	0.0418%	503429	75.97%	88	35.63%
份	508		6	276	0.04165%	503705	76.01%	114	46.15%
段	509		9	276	0.04165%	503981	76.05%	115	46.56%
幹	510		13	275	0.0415%	504256	76.09%	100	40.49%
項	511		12	274	0.04135%	504530	76.13%	89	36.03%
養	512		15	274	0.04135%	504804	76.17%	123	49.80%
首	513		9	274	0.04135%	505078	76.22%	144	58.30%
晚	514		11	272	0.04104%	505350	76.26%	116	46.96%
英	515		9	272	0.04104%	505622	76.30%	78	31.58%
客	516		9	270	0.04074%	505892	76.34%	109	44.13%
素	517		10	270	0.04074%	506162	76.38%	107	43.32%
父	518		4	269	0.04059%	506431	76.42%	74	29.96%
元	519		4	268	0.04044%	506699	76.46%	88	35.63%
劃	520		14	268	0.04044%	506967	76.50%	93	37.65%
參	521		11	268	0.04044%	507235	76.54%	123	49.80%
積	522		16	268	0.04044%	507503	76.58%	110	44.53%
曾	523		12	267	0.04029%	507770	76.62%	127	51.42%
約	524		9	267	0.04029%	508037	76.66%	119	48.18%
律	525		9	266	0.04014%	508303	76.70%	97	39.27%
站	526		10	266	0.04014%	508569	76.74%	104	42.11%
談	527		15	266	0.04014%	508835	76.78%	129	52.23%
款	528		12	265	0.03999%	509100	76.82%	46	18.62%
萱	529		13	265	0.03999%	509365	76.86%	3	1.22%
居	530		8	263	0.03969%	509628	76.90%	93	37.65%
房	531		8	262	0.03954%	509890	76.94%	92	37.25%
留	532		10	261	0.03938%	510151	76.98%	134	54.25%
友	533		4	260	0.03923%	510411	77.02%	106	42.91%
爾	534		14	260	0.03923%	510671	77.06%	70	28.34%
斯	535		12	259	0.03908%	510930	77.10%	74	29.96%
足	536		7	259	0.03908%	511189	77.14%	136	55.06%
倒	537		10	258	0.03893%	511447	77.18%	124	50.20%
血	538		6	258	0.03893%	511705	77.22%	102	41.30%
乎	539		5	257	0.03878%	511962	77.25%	135	54.66%
供	540		8	257	0.03878%	512219	77.29%	103	41.70%
故	541		9	257	0.03878%	512476	77.33%	101	40.89%
毛	542		4	257	0.03878%	512733	77.37%	77	31.17%
充	543		5	255	0.03848%	512988	77.41%	128	51.82%
雙	544		18	255	0.03848%	513243	77.45%	100	40.49%
嗎	545		13	252	0.03803%	513495	77.49%	102	41.30%
批	546		7	252	0.03803%	513747	77.52%	102	41.30%
織	547		18	250	0.03772%	513997	77.56%	93	37.65%
夫	548		4	248	0.03742%	514245	77.60%	88	35.63%
春	549		9	248	0.03742%	514493	77.64%	90	36.44%
消	550		10	247	0.03727%	514740	77.67%	122	49.39%
響	551		21	247	0.03727%	514987	77.71%	110	44.53%
委	552		8	246	0.03712%	515233	77.75%	93	37.65%
港	553		12	246	0.03712%	515479	77.78%	48	19.43%
緊	554		14	246	0.03712%	515725	77.82%	121	48.99%
護	555		21	245	0.03697%	515970	77.86%	88	35.63%
刻	556		8	244	0.03682%	516214	77.90%	118	47.77%
母	557		5	244	0.03682%	516458	77.93%	81	32.79%
臉	558		17	243	0.03667%	516701	77.97%	87	35.22%
責	559		11	243	0.03667%	516944	78.01%	87	35.22%
酒	560		10	243	0.03667%	517187	78.04%	61	24.70%
細	561		11	242	0.03652%	517429	78.08%	110	44.53%
推	562		11	241	0.03637%	517670	78.12%	129	52.23%
易	563		8	240	0.03622%	517910	78.15%	109	44.13%
低	564		7	239	0.03606%	518149	78.19%	114	46.15%
圖	565		14	239	0.03606%	518388	78.22%	83	33.60%
致	566		9	239	0.03606%	518627	78.26%	124	50.20%
克	567		7	237	0.03576%	518864	78.30%	80	32.39%
模	568		15	237	0.03576%	519101	78.33%	111	44.94%
靈	569		24	237	0.03576%	519338	78.37%	103	41.70%
味	570		8	236	0.03561%	519574	78.40%	103	41.70%
拉	571		8	236	0.03561%	519810	78.44%	89	36.03%
驗	572		23	236	0.03561%	520046	78.47%	96	38.87%
司	573		5	235	0.03546%	520281	78.51%	63	25.51%
草	574		10	235	0.03546%	520516	78.54%	94	38.06%
靜	575		16	235	0.03546%	520751	78.58%	99	40.08%
喜	576		12	234	0.03531%	520985	78.62%	121	48.99%
樓	577		15	234	0.03531%	521219	78.65%	64	25.91%
突	578		9	234	0.03531%	521453	78.69%	126	51.01%
例	579		8	232	0.03501%	521685	78.72%	111	44.94%
唱	580		11	232	0.03501%	521917	78.76%	55	22.27%
承	581		8	232	0.03501%	522149	78.79%	89	36.03%
裝	582		13	232	0.03501%	522381	78.83%	96	38.87%
範	583		15	231	0.03486%	522612	78.86%	68	27.53%
葉	584		13	230	0.03471%	522842	78.90%	69	27.94%
密	585		11	229	0.03456%	523071	78.93%	109	44.13%
依	586		8	228	0.0344%	523299	78.96%	101	40.89%
勢	587		13	228	0.0344%	523527	79.00%	112	45.34%
坐	588		7	228	0.0344%	523755	79.03%	94	38.06%
飛	589		9	228	0.0344%	523983	79.07%	100	40.49%
館	590		16	228	0.0344%	524211	79.10%	52	21.05%
陽	591		11	227	0.03425%	524438	79.14%	103	41.70%
雨	592		8	227	0.03425%	524665	79.17%	84	34.01%
剛	593		10	226	0.0341%	524891	79.20%	106	42.91%
江	594		6	225	0.03395%	525116	79.24%	72	29.15%
誰	595		15	225	0.03395%	525341	79.27%	99	40.08%
仍	596		4	224	0.0338%	525565	79.31%	134	54.25%
哪	597		10	224	0.0338%	525789	79.34%	93	37.65%
景	598		12	224	0.0338%	526013	79.37%	101	40.89%
篇	599		15	224	0.0338%	526237	79.41%	65	26.32%
選	600		15	223	0.03365%	526460	79.44%	94	38.06%
筆	601		12	222	0.0335%	526682	79.48%	110	44.53%
股	602		8	222	0.0335%	526904	79.51%	56	22.67%
習	603		11	221	0.03335%	527125	79.54%	106	42.91%
示	604		5	220	0.0332%	527345	79.58%	121	48.99%
塊	605		13	218	0.0329%	527563	79.61%	102	41.30%
星	606		9	218	0.0329%	527781	79.64%	82	33.20%
甚	607		9	218	0.0329%	527999	79.67%	123	49.80%
德	608		15	217	0.03274%	528216	79.71%	82	33.20%
曲	609		6	217	0.03274%	528433	79.74%	84	34.01%
率	610		11	217	0.03274%	528650	79.77%	78	31.58%
舞	611		14	217	0.03274%	528867	79.80%	72	29.15%
般	612		10	217	0.03274%	529084	79.84%	121	48.99%
讀	613		22	217	0.03274%	529301	79.87%	88	35.63%
屬	614		21	216	0.03259%	529517	79.90%	105	42.51%
秋	615		9	216	0.03259%	529733	79.94%	65	26.32%
須	616		12	216	0.03259%	529949	79.97%	99	40.08%
副	617		11	215	0.03244%	530164	80.00%	92	37.25%
注	618		8	215	0.03244%	530379	80.03%	119	48.18%
錢	619		16	215	0.03244%	530594	80.07%	80	32.39%
雖	620		17	214	0.03229%	530808	80.10%	128	51.82%
列	621		6	213	0.03214%	531021	80.13%	106	42.91%
京	622		8	211	0.03184%	531232	80.16%	70	28.34%
圍	623		12	211	0.03184%	531443	80.19%	130	52.63%
終	624		11	211	0.03184%	531654	80.23%	119	48.18%
縣	625		16	211	0.03184%	531865	80.26%	56	22.67%
優	626		17	210	0.03169%	532075	80.29%	93	37.65%
破	627		10	210	0.03169%	532285	80.32%	111	44.94%
稱	628		14	210	0.03169%	532495	80.35%	109	44.13%
願	629		19	210	0.03169%	532705	80.38%	108	43.72%
狀	630		8	209	0.03154%	532914	80.42%	87	35.22%
盡	631		14	209	0.03154%	533123	80.45%	122	49.39%
維	632		14	209	0.03154%	533332	80.48%	79	31.98%
負	633		9	209	0.03154%	533541	80.51%	100	40.49%
男	634		7	208	0.03139%	533749	80.54%	65	26.32%
除	635		9	208	0.03139%	533957	80.57%	123	49.80%
舉	636		17	206	0.03108%	534163	80.60%	108	43.72%
竟	637		11	206	0.03108%	534369	80.64%	104	42.11%
施	638		9	205	0.03093%	534574	80.67%	82	33.20%
亮	639		9	204	0.03078%	534778	80.70%	99	40.08%
吧	640		7	203	0.03063%	534981	80.73%	94	38.06%
排	641		11	203	0.03063%	535184	80.76%	93	37.65%
歲	642		13	203	0.03063%	535387	80.79%	93	37.65%
角	643		7	203	0.03063%	535590	80.82%	105	42.51%
另	644		5	202	0.03048%	535792	80.85%	125	50.61%
採	645		11	202	0.03048%	535994	80.88%	99	40.08%
演	646		14	202	0.03048%	536196	80.91%	71	28.74%
補	647		12	202	0.03048%	536398	80.94%	77	31.17%
佔	648		7	201	0.03033%	536599	80.97%	90	36.44%
朋	649		8	201	0.03033%	536800	81.00%	80	32.39%
底	650		8	200	0.03018%	537000	81.03%	120	48.58%
概	651		13	200	0.03018%	537200	81.06%	88	35.63%
絕	652		12	200	0.03018%	537400	81.09%	114	46.15%
衣	653		6	200	0.03018%	537600	81.12%	88	35.63%
善	654		12	199	0.03003%	537799	81.15%	99	40.08%
備	655		12	198	0.02988%	537997	81.18%	105	42.51%
周	656		8	198	0.02988%	538195	81.21%	104	42.11%
士	657		3	198	0.02988%	538393	81.24%	77	31.17%
待	658		9	198	0.02988%	538591	81.27%	118	47.77%
某	659		9	197	0.02973%	538788	81.30%	92	37.25%
微	660		13	195	0.02943%	538983	81.33%	90	36.44%
激	661		16	195	0.02943%	539178	81.36%	105	42.51%
腳	662		13	195	0.02943%	539373	81.39%	90	36.44%
講	663		17	195	0.02943%	539568	81.42%	94	38.06%
里	664		7	195	0.02943%	539763	81.45%	81	32.79%
座	665		10	194	0.02927%	539957	81.48%	86	34.82%
米	666		6	194	0.02927%	540151	81.51%	74	29.96%
綠	667		14	194	0.02927%	540345	81.54%	75	30.36%
陳	668		10	194	0.02927%	540539	81.57%	62	25.10%
劇	669		15	193	0.02912%	540732	81.60%	68	27.53%
團	670		14	193	0.02912%	540925	81.62%	94	38.06%
森	671		12	193	0.02912%	541118	81.65%	36	14.57%
歡	672		22	193	0.02912%	541311	81.68%	105	42.51%
跟	673		13	193	0.02912%	541504	81.71%	86	34.82%
久	674		3	192	0.02897%	541696	81.74%	103	41.70%
協	675		8	192	0.02897%	541888	81.77%	75	30.36%
州	676		6	192	0.02897%	542080	81.80%	49	19.84%
貸	677		12	192	0.02897%	542272	81.83%	25	10.12%
雲	678		12	192	0.02897%	542464	81.86%	76	30.77%
礎	679		18	191	0.02882%	542655	81.89%	83	33.60%
否	680		7	189	0.02852%	542844	81.91%	93	37.65%
紀	681		9	189	0.02852%	543033	81.94%	86	34.82%
背	682		9	189	0.02852%	543222	81.97%	94	38.06%
配	683		10	189	0.02852%	543411	82.00%	77	31.17%
限	684		8	189	0.02852%	543600	82.03%	96	38.87%
拿	685		10	188	0.02837%	543788	82.06%	87	35.22%
既	686		9	188	0.02837%	543976	82.08%	112	45.34%
婚	687		11	187	0.02822%	544163	82.11%	40	16.19%
李	688		7	186	0.02807%	544349	82.14%	64	25.91%
費	689		12	186	0.02807%	544535	82.17%	78	31.58%
隻	690		10	186	0.02807%	544721	82.20%	68	27.53%
夢	691		14	185	0.02792%	544906	82.23%	67	27.13%
牛	692		4	185	0.02792%	545091	82.25%	61	24.70%
章	693		11	185	0.02792%	545276	82.28%	91	36.84%
述	694		8	185	0.02792%	545461	82.31%	89	36.03%
呼	695		8	184	0.02777%	545645	82.34%	97	39.27%
獲	696		17	184	0.02777%	545829	82.36%	93	37.65%
班	697		10	184	0.02777%	546013	82.39%	70	28.34%
校	698		10	182	0.02746%	546195	82.42%	52	21.05%
睛	699		13	182	0.02746%	546377	82.45%	76	30.77%
線	700		15	182	0.02746%	546559	82.47%	89	36.03%
匯	701		13	181	0.02731%	546740	82.50%	56	22.67%
奇	702		8	181	0.02731%	546921	82.53%	86	34.82%
沙	703		7	181	0.02731%	547102	82.56%	56	22.67%
溫	704		13	181	0.02731%	547283	82.58%	85	34.41%
漫	705		14	181	0.02731%	547464	82.61%	59	23.89%
適	706		14	181	0.02731%	547645	82.64%	90	36.44%
予	707		4	180	0.02716%	547825	82.67%	74	29.96%
普	708		12	180	0.02716%	548005	82.69%	78	31.58%
顧	709		21	180	0.02716%	548185	82.72%	90	36.44%
朝	710		12	178	0.02686%	548363	82.75%	68	27.53%
請	711		15	178	0.02686%	548541	82.77%	90	36.44%
嘴	712		15	177	0.02671%	548718	82.80%	75	30.36%
室	713		9	177	0.02671%	548895	82.83%	83	33.60%
府	714		8	177	0.02671%	549072	82.85%	68	27.53%
散	715		12	177	0.02671%	549249	82.88%	89	36.03%
怕	716		8	176	0.02656%	549425	82.91%	92	37.25%
融	717		16	176	0.02656%	549601	82.93%	52	21.05%
財	718		10	176	0.02656%	549777	82.96%	63	25.51%
靠	719		15	176	0.02656%	549953	82.99%	104	42.11%
皮	720		5	175	0.02641%	550128	83.01%	68	27.53%
鬥	721		10	175	0.02641%	550303	83.04%	75	30.36%
句	722		5	174	0.02626%	550477	83.07%	83	33.60%
害	723		10	174	0.02626%	550651	83.09%	79	31.98%
球	724		11	174	0.02626%	550825	83.12%	48	19.43%
窗	725		12	174	0.02626%	550999	83.14%	72	29.15%
續	726		21	174	0.02626%	551173	83.17%	102	41.30%
差	727		10	172	0.02595%	551345	83.20%	98	39.68%
映	728		9	172	0.02595%	551517	83.22%	80	32.39%
良	729		7	172	0.02595%	551689	83.25%	98	39.68%
證	730		19	172	0.02595%	551861	83.27%	69	27.94%
復	731		12	171	0.0258%	552032	83.30%	89	36.03%
漢	732		14	171	0.0258%	552203	83.33%	55	22.27%
穿	733		9	171	0.0258%	552374	83.35%	81	32.79%
送	734		9	171	0.0258%	552545	83.38%	87	35.22%
察	735		14	170	0.02565%	552715	83.40%	75	30.36%
巴	736		4	170	0.02565%	552885	83.43%	77	31.17%
菜	737		12	170	0.02565%	553055	83.45%	51	20.65%
豐	738		18	170	0.02565%	553225	83.48%	90	36.44%
露	739		21	170	0.02565%	553395	83.51%	95	38.46%
餘	740		15	170	0.02565%	553565	83.53%	83	33.60%
吸	741		7	169	0.0255%	553734	83.56%	92	37.25%
止	742		4	169	0.0255%	553903	83.58%	98	39.68%
痛	743		12	169	0.0255%	554072	83.61%	86	34.82%
健	744		11	168	0.02535%	554240	83.63%	73	29.55%
助	745		7	168	0.02535%	554408	83.66%	103	41.70%
按	746		9	168	0.02535%	554576	83.68%	82	33.20%
紙	747		10	168	0.02535%	554744	83.71%	74	29.96%
官	748		8	167	0.0252%	554911	83.73%	58	23.48%
探	749		11	167	0.0252%	555078	83.76%	94	38.06%
異	750		11	167	0.0252%	555245	83.79%	101	40.89%
亡	751		3	166	0.02505%	555411	83.81%	48	19.43%
羅	752		19	166	0.02505%	555577	83.84%	49	19.84%
飲	753		12	166	0.02505%	555743	83.86%	35	14.17%
修	754		10	165	0.0249%	555908	83.89%	73	29.55%
煙	755		13	165	0.0249%	556073	83.91%	75	30.36%
缺	756		10	165	0.0249%	556238	83.94%	91	36.84%
追	757		9	165	0.0249%	556403	83.96%	83	33.60%
印	758		6	164	0.02475%	556567	83.98%	77	31.17%
壤	759		20	164	0.02475%	556731	84.01%	14	5.67%
床	760		7	164	0.02475%	556895	84.03%	61	24.70%
戶	761		4	164	0.02475%	557059	84.06%	60	24.29%
灣	762		25	164	0.02475%	557223	84.08%	29	11.74%
繼	763		20	164	0.02475%	557387	84.11%	92	37.25%
飯	764		12	164	0.02475%	557551	84.13%	78	31.58%
令	765		5	163	0.0246%	557714	84.16%	88	35.63%
臨	766		17	163	0.0246%	557877	84.18%	86	34.82%
冷	767		7	162	0.02445%	558039	84.21%	89	36.03%
練	768		15	162	0.02445%	558201	84.23%	45	18.22%
脫	769		11	162	0.02445%	558363	84.26%	94	38.06%
劉	770		15	161	0.02429%	558524	84.28%	35	14.17%
抓	771		7	161	0.02429%	558685	84.30%	69	27.94%
朱	772		6	161	0.02429%	558846	84.33%	33	13.36%
訴	773		12	161	0.02429%	559007	84.35%	95	38.46%
速	774		10	161	0.02429%	559168	84.38%	91	36.84%
雜	775		18	161	0.02429%	559329	84.40%	102	41.30%
黎	776		15	161	0.02429%	559490	84.43%	25	10.12%
武	777		8	160	0.02414%	559650	84.45%	61	24.70%
銷	778		15	160	0.02414%	559810	84.47%	41	16.60%
壓	779		17	159	0.02399%	559969	84.50%	82	33.20%
屋	780		9	159	0.02399%	560128	84.52%	59	23.89%
腦	781		13	159	0.02399%	560287	84.55%	78	31.58%
証	782		12	159	0.02399%	560446	84.57%	64	25.91%
逐	783		10	159	0.02399%	560605	84.59%	80	32.39%
陸	784		10	159	0.02399%	560764	84.62%	48	19.43%
封	785		9	158	0.02384%	560922	84.64%	61	24.70%
移	786		11	158	0.02384%	561080	84.67%	50	20.24%
懷	787		19	157	0.02369%	561237	84.69%	93	37.65%
揮	788		12	157	0.02369%	561394	84.71%	86	34.82%
險	789		15	157	0.02369%	561551	84.74%	60	24.29%
雪	790		11	157	0.02369%	561708	84.76%	57	23.08%
亂	791		13	156	0.02354%	561864	84.78%	103	41.70%
擔	792		16	156	0.02354%	562020	84.81%	93	37.65%
游	793		12	156	0.02354%	562176	84.83%	58	23.48%
烈	794		10	156	0.02354%	562332	84.85%	96	38.87%
築	795		16	156	0.02354%	562488	84.88%	33	13.36%
困	796		7	155	0.02339%	562643	84.90%	83	33.60%
堅	797		11	155	0.02339%	562798	84.93%	87	35.22%
沉	798		7	155	0.02339%	562953	84.95%	87	35.22%
監	799		14	155	0.02339%	563108	84.97%	37	14.98%
討	800		10	155	0.02339%	563263	85.00%	83	33.60%
彩	801		11	154	0.02324%	563417	85.02%	85	34.41%
祖	802		9	154	0.02324%	563571	85.04%	67	27.13%
福	803		13	154	0.02324%	563725	85.06%	68	27.53%
店	804		8	153	0.02309%	563878	85.09%	55	22.27%
軍	805		9	153	0.02309%	564031	85.11%	60	24.29%
鎮	806		18	153	0.02309%	564184	85.13%	64	25.91%
布	807		5	152	0.02294%	564336	85.16%	73	29.55%
材	808		7	152	0.02294%	564488	85.18%	82	33.20%
短	809		12	152	0.02294%	564640	85.20%	81	32.79%
索	810		10	152	0.02294%	564792	85.23%	91	36.84%
鮮	811		17	152	0.02294%	564944	85.25%	90	36.44%
停	812		11	151	0.02279%	565095	85.27%	87	35.22%
園	813		13	151	0.02279%	565246	85.29%	66	26.72%
媽	814		13	151	0.02279%	565397	85.32%	36	14.57%
燈	815		16	151	0.02279%	565548	85.34%	64	25.91%
竹	816		6	151	0.02279%	565699	85.36%	37	14.98%
庭	817		10	149	0.02248%	565848	85.39%	55	22.27%
超	818		12	149	0.02248%	565997	85.41%	77	31.17%
妻	819		8	148	0.02233%	566145	85.43%	40	16.19%
促	820		9	147	0.02218%	566292	85.45%	72	29.15%
升	821		4	147	0.02218%	566439	85.47%	67	27.13%
夠	822		11	147	0.02218%	566586	85.50%	89	36.03%
編	823		15	147	0.02218%	566733	85.52%	62	25.10%
互	824		4	146	0.02203%	566879	85.54%	83	33.60%
域	825		11	146	0.02203%	567025	85.56%	63	25.51%
急	826		9	146	0.02203%	567171	85.58%	79	31.98%
染	827		9	146	0.02203%	567317	85.61%	47	19.03%
野	828		11	146	0.02203%	567463	85.63%	75	30.36%
掌	829		12	145	0.02188%	567608	85.65%	67	27.13%
娘	830		10	143	0.02158%	567751	85.67%	54	21.86%
簡	831		18	143	0.02158%	567894	85.69%	96	38.87%
試	832		13	143	0.02158%	568037	85.72%	67	27.13%
控	833		11	142	0.02143%	568179	85.74%	58	23.48%
洗	834		9	142	0.02143%	568321	85.76%	59	23.89%
藏	835		18	142	0.02143%	568463	85.78%	65	26.32%
買	836		12	142	0.02143%	568605	85.80%	75	30.36%
順	837		12	142	0.02143%	568747	85.82%	84	34.01%
驚	838		23	142	0.02143%	568889	85.84%	96	38.87%
含	839		7	141	0.02128%	569030	85.87%	81	32.79%
執	840		11	141	0.02128%	569171	85.89%	63	25.51%
損	841		13	141	0.02128%	569312	85.91%	52	21.05%
趙	842		14	141	0.02128%	569453	85.93%	17	6.88%
獻	843		20	140	0.02113%	569593	85.95%	60	24.29%
希	844		7	139	0.02097%	569732	85.97%	78	31.58%
號	845		13	139	0.02097%	569871	85.99%	82	33.20%
防	846		6	139	0.02097%	570010	86.01%	51	20.65%
熟	847		15	137	0.02067%	570147	86.03%	82	33.20%
田	848		5	137	0.02067%	570284	86.05%	73	29.55%
跑	849		12	137	0.02067%	570421	86.08%	70	28.34%
叔	850		8	136	0.02052%	570557	86.10%	14	5.67%
器	851		16	136	0.02052%	570693	86.12%	74	29.96%
括	852		9	136	0.02052%	570829	86.14%	83	33.60%
督	853		13	136	0.02052%	570965	86.16%	27	10.93%
舊	854		18	136	0.02052%	571101	86.18%	59	23.89%
鐵	855		21	136	0.02052%	571237	86.20%	66	26.72%
端	856		14	135	0.02037%	571372	86.22%	82	33.20%
錯	857		16	135	0.02037%	571507	86.24%	84	34.01%
錄	858		16	135	0.02037%	571642	86.26%	72	29.15%
慢	859		14	134	0.02022%	571776	86.28%	63	25.51%
聞	860		14	134	0.02022%	571910	86.30%	65	26.32%
頂	861		11	134	0.02022%	572044	86.32%	66	26.72%
骨	862		10	134	0.02022%	572178	86.34%	66	26.72%
案	863		10	133	0.02007%	572311	86.36%	58	23.48%
污	864		6	133	0.02007%	572444	86.38%	32	12.96%
架	865		9	132	0.01992%	572576	86.40%	60	24.29%
睡	866		14	132	0.01992%	572708	86.42%	60	24.29%
蘇	867		20	132	0.01992%	572840	86.44%	56	22.67%
透	868		10	132	0.01992%	572972	86.46%	79	31.98%
麗	869		19	132	0.01992%	573104	86.48%	70	28.34%
啊	870		11	131	0.01977%	573235	86.50%	61	24.70%
固	871		8	131	0.01977%	573366	86.52%	83	33.60%
貼	872		12	131	0.01977%	573497	86.54%	50	20.24%
齊	873		14	131	0.01977%	573628	86.56%	54	21.86%
傾	874		13	130	0.01962%	573758	86.58%	71	28.74%
攝	875		21	130	0.01962%	573888	86.60%	25	10.12%
植	876		12	130	0.01962%	574018	86.62%	56	22.67%
歸	877		18	130	0.01962%	574148	86.64%	79	31.98%
假	878		11	129	0.01947%	574277	86.66%	62	25.10%
典	879		8	129	0.01947%	574406	86.68%	60	24.29%
幫	880		17	129	0.01947%	574535	86.70%	78	31.58%
漸	881		14	129	0.01947%	574664	86.72%	67	27.13%
謂	882		16	129	0.01947%	574793	86.74%	67	27.13%
跳	883		13	129	0.01947%	574922	86.75%	73	29.55%
陣	884		9	128	0.01931%	575050	86.77%	67	27.13%
默	885		16	128	0.01931%	575178	86.79%	66	26.72%
借	886		10	127	0.01916%	575305	86.81%	74	29.96%
夏	887		10	127	0.01916%	575432	86.83%	74	29.96%
紛	888		10	127	0.01916%	575559	86.85%	52	21.05%
尋	889		12	126	0.01901%	575685	86.87%	84	34.01%
洋	890		9	126	0.01901%	575811	86.89%	67	27.13%
耳	891		6	126	0.01901%	575937	86.91%	66	26.72%
肉	892		6	126	0.01901%	576063	86.93%	66	26.72%
喝	893		12	125	0.01886%	576188	86.95%	55	22.27%
嚮	894		18	125	0.01886%	576313	86.96%	62	25.10%
殘	895		12	125	0.01886%	576438	86.98%	51	20.65%
浴	896		10	125	0.01886%	576563	87.00%	23	9.31%
踐	897		15	125	0.01886%	576688	87.02%	62	25.10%
遺	898		15	125	0.01886%	576813	87.04%	64	25.91%
雄	899		12	125	0.01886%	576938	87.06%	58	23.48%
抗	900		7	124	0.01871%	577062	87.08%	51	20.65%
泥	901		8	124	0.01871%	577186	87.10%	55	22.27%
詞	902		12	124	0.01871%	577310	87.11%	72	29.15%
搞	903		13	123	0.01856%	577433	87.13%	59	23.89%
擴	904		18	123	0.01856%	577556	87.15%	61	24.70%
暗	905		13	123	0.01856%	577679	87.17%	70	28.34%
油	906		8	123	0.01856%	577802	87.19%	56	22.67%
砍	907		9	123	0.01856%	577925	87.21%	24	9.72%
永	908		5	122	0.01841%	578047	87.23%	66	26.72%
票	909		11	121	0.01826%	578168	87.24%	37	14.98%
巨	910		5	120	0.01811%	578288	87.26%	71	28.74%
幸	911		8	120	0.01811%	578408	87.28%	74	29.96%
揚	912		12	120	0.01811%	578528	87.30%	64	25.91%
析	913		8	120	0.01811%	578648	87.32%	58	23.48%
略	914		11	119	0.01796%	578767	87.33%	68	27.53%
貨	915		11	119	0.01796%	578886	87.35%	39	15.79%
怪	916		8	118	0.01781%	579004	87.37%	73	29.55%
板	917		8	118	0.01781%	579122	87.39%	56	22.67%
貿	918		12	118	0.01781%	579240	87.41%	23	9.31%
頓	919		13	118	0.01781%	579358	87.42%	73	29.55%
忙	920		6	117	0.01766%	579475	87.44%	64	25.91%
減	921		12	117	0.01766%	579592	87.46%	61	24.70%
穩	922		19	117	0.01766%	579709	87.48%	64	25.91%
翻	923		18	117	0.01766%	579826	87.49%	78	31.58%
悲	924		12	116	0.0175%	579942	87.51%	56	22.67%
握	925		12	116	0.0175%	580058	87.53%	70	28.34%
傷	926		13	115	0.01735%	580173	87.55%	67	27.13%
掉	927		11	115	0.01735%	580288	87.56%	74	29.96%
松	928		8	115	0.01735%	580403	87.58%	47	19.03%
核	929		10	115	0.01735%	580518	87.60%	41	16.60%
瑾	930		15	115	0.01735%	580633	87.62%	4	1.62%
累	931		11	115	0.01735%	580748	87.63%	67	27.13%
置	932		13	115	0.01735%	580863	87.65%	77	31.17%
降	933		8	115	0.01735%	580978	87.67%	62	25.10%
龍	934		16	115	0.01735%	581093	87.69%	58	23.48%
亞	935		8	114	0.0172%	581207	87.70%	42	17.00%
堂	936		11	114	0.0172%	581321	87.72%	57	23.08%
培	937		11	114	0.0172%	581435	87.74%	64	25.91%
尚	938		8	114	0.0172%	581549	87.75%	71	28.74%
左	939		5	114	0.0172%	581663	87.77%	72	29.15%
序	940		7	114	0.0172%	581777	87.79%	64	25.91%
碎	941		13	114	0.0172%	581891	87.81%	45	18.22%
答	942		12	114	0.0172%	582005	87.82%	71	28.74%
糧	943		18	114	0.0172%	582119	87.84%	36	14.57%
遇	944		12	114	0.0172%	582233	87.86%	78	31.58%
判	945		7	113	0.01705%	582346	87.87%	57	23.08%
忘	946		7	113	0.01705%	582459	87.89%	72	29.15%
忽	947		8	113	0.01705%	582572	87.91%	75	30.36%
荒	948		10	113	0.01705%	582685	87.93%	60	24.29%
倫	949		10	112	0.0169%	582797	87.94%	33	13.36%
拍	950		8	112	0.0169%	582909	87.96%	58	23.48%
敢	951		12	112	0.0169%	583021	87.98%	72	29.15%
楊	952		13	112	0.0169%	583133	87.99%	39	15.79%
爸	953		8	112	0.0169%	583245	88.01%	20	8.10%
刊	954		5	111	0.01675%	583356	88.03%	35	14.17%
宋	955		7	111	0.01675%	583467	88.04%	28	11.34%
洲	956		9	111	0.01675%	583578	88.06%	46	18.62%
船	957		11	111	0.01675%	583689	88.08%	37	14.98%
趣	958		15	111	0.01675%	583800	88.09%	58	23.48%
億	959		15	110	0.0166%	583910	88.11%	42	17.00%
哈	960		9	110	0.0166%	584020	88.13%	37	14.98%
宗	961		8	110	0.0166%	584130	88.14%	48	19.43%
波	962		8	110	0.0166%	584240	88.16%	65	26.32%
碑	963		13	110	0.0166%	584350	88.18%	26	10.53%
禮	964		17	110	0.0166%	584460	88.19%	52	21.05%
羽	965		6	110	0.0166%	584570	88.21%	19	7.69%
購	966		17	110	0.0166%	584680	88.23%	43	17.41%
儒	967		16	109	0.01645%	584789	88.24%	15	6.07%
壯	968		7	109	0.01645%	584898	88.26%	69	27.94%
孫	969		10	109	0.01645%	585007	88.28%	46	18.62%
寶	970		20	109	0.01645%	585116	88.29%	67	27.13%
禁	971		13	109	0.01645%	585225	88.31%	58	23.48%
若	972		9	109	0.01645%	585334	88.33%	75	30.36%
街	973		12	109	0.01645%	585443	88.34%	51	20.65%
賽	974		17	109	0.01645%	585552	88.36%	27	10.93%
奶	975		5	108	0.0163%	585660	88.37%	26	10.53%
尤	976		4	108	0.0163%	585768	88.39%	68	27.53%
擊	977		17	108	0.0163%	585876	88.41%	76	30.77%
沖	978		7	108	0.0163%	585984	88.42%	57	23.08%
疇	979		19	108	0.0163%	586092	88.44%	10	4.05%
跡	980		13	108	0.0163%	586200	88.46%	64	25.91%
退	981		9	108	0.0163%	586308	88.47%	66	26.72%
遍	982		12	108	0.0163%	586416	88.49%	76	30.77%
鼓	983		13	108	0.0163%	586524	88.51%	62	25.10%
乾	984		11	107	0.01615%	586631	88.52%	64	25.91%
偉	985		11	107	0.01615%	586738	88.54%	51	20.65%
免	986		7	107	0.01615%	586845	88.55%	70	28.34%
哥	987		10	107	0.01615%	586952	88.57%	37	14.98%
哭	988		10	107	0.01615%	587059	88.59%	52	21.05%
壞	989		19	107	0.01615%	587166	88.60%	63	25.51%
換	990		12	107	0.01615%	587273	88.62%	74	29.96%
濃	991		16	107	0.01615%	587380	88.63%	59	23.89%
訪	992		11	107	0.01615%	587487	88.65%	53	21.46%
迷	993		9	107	0.01615%	587594	88.67%	59	23.89%
醒	994		16	107	0.01615%	587701	88.68%	63	25.51%
冰	995		6	106	0.016%	587807	88.70%	48	19.43%
圓	996		13	106	0.016%	587913	88.71%	62	25.10%
擇	997		16	106	0.016%	588019	88.73%	64	25.91%
桌	998		10	106	0.016%	588125	88.75%	48	19.43%
汽	999		7	106	0.016%	588231	88.76%	50	20.24%
肯	1000		8	106	0.016%	588337	88.78%	68	27.53%
谷	1001		7	106	0.016%	588443	88.79%	47	19.03%
額	1002		18	106	0.016%	588549	88.81%	43	17.41%
援	1003		12	105	0.01584%	588654	88.83%	20	8.10%
擺	1004		18	105	0.01584%	588759	88.84%	70	28.34%
檢	1005		17	105	0.01584%	588864	88.86%	51	20.65%
淚	1006		11	105	0.01584%	588969	88.87%	64	25.91%
潮	1007		15	105	0.01584%	589074	88.89%	65	26.32%
誤	1008		14	105	0.01584%	589179	88.91%	59	23.89%
酸	1009		14	105	0.01584%	589284	88.92%	34	13.77%
審	1010		15	104	0.01569%	589388	88.94%	55	22.27%
弄	1011		7	104	0.01569%	589492	88.95%	65	26.32%
橋	1012		16	104	0.01569%	589596	88.97%	29	11.74%
貴	1013		12	104	0.01569%	589700	88.98%	62	25.10%
于	1014		3	103	0.01554%	589803	89.00%	13	5.26%
均	1015		7	103	0.01554%	589906	89.02%	57	23.08%
您	1016		11	103	0.01554%	590009	89.03%	30	12.15%
旁	1017		10	103	0.01554%	590112	89.05%	66	26.72%
閃	1018		10	103	0.01554%	590215	89.06%	57	23.08%
季	1019		8	102	0.01539%	590317	89.08%	51	20.65%
楚	1020		13	102	0.01539%	590419	89.09%	62	25.10%
爺	1021		13	102	0.01539%	590521	89.11%	36	14.57%
伐	1022		6	101	0.01524%	590622	89.12%	38	15.38%
嫻	1023		15	101	0.01524%	590723	89.14%	5	2.02%
措	1024		11	101	0.01524%	590824	89.15%	53	21.46%
掛	1025		11	101	0.01524%	590925	89.17%	69	27.94%
搖	1026		13	101	0.01524%	591026	89.18%	63	25.51%
歐	1027		15	101	0.01524%	591127	89.20%	45	18.22%
災	1028		7	101	0.01524%	591228	89.22%	32	12.96%
登	1029		12	101	0.01524%	591329	89.23%	62	25.10%
茶	1030		10	101	0.01524%	591430	89.25%	33	13.36%
途	1031		10	101	0.01524%	591531	89.26%	65	26.32%
障	1032		13	101	0.01524%	591632	89.28%	34	13.77%
介	1033		4	100	0.01509%	591732	89.29%	68	27.53%
塑	1034		13	100	0.01509%	591832	89.31%	39	15.79%
奮	1035		16	100	0.01509%	591932	89.32%	63	25.51%
崇	1036		11	100	0.01509%	592032	89.34%	49	19.84%
慮	1037		15	100	0.01509%	592132	89.35%	62	25.10%
涼	1038		11	100	0.01509%	592232	89.37%	63	25.51%
版	1039		8	100	0.01509%	592332	89.38%	49	19.84%
玉	1040		5	100	0.01509%	592432	89.40%	44	17.81%
綜	1041		14	100	0.01509%	592532	89.41%	53	21.46%
繁	1042		17	100	0.01509%	592632	89.43%	62	25.10%
蛋	1043		11	100	0.01509%	592732	89.44%	47	19.03%
賣	1044		15	100	0.01509%	592832	89.46%	52	21.05%
趕	1045		14	100	0.01509%	592932	89.47%	61	24.70%
針	1046		10	100	0.01509%	593032	89.49%	62	25.10%
鳥	1047		11	100	0.01509%	593132	89.50%	46	18.62%
懂	1048		17	99	0.01494%	593231	89.52%	51	20.65%
折	1049		7	99	0.01494%	593330	89.53%	76	30.77%
漠	1050		14	99	0.01494%	593429	89.55%	34	13.77%
疾	1051		10	99	0.01494%	593528	89.56%	35	14.17%
納	1052		10	99	0.01494%	593627	89.58%	51	20.65%
混	1053		11	98	0.01479%	593725	89.59%	67	27.13%
燒	1054		16	98	0.01479%	593823	89.61%	49	19.84%
疑	1055		14	98	0.01479%	593921	89.62%	72	29.15%
童	1056		12	98	0.01479%	594019	89.64%	64	25.91%
零	1057		13	98	0.01479%	594117	89.65%	56	22.67%
勝	1058		12	97	0.01464%	594214	89.67%	63	25.51%
套	1059		10	97	0.01464%	594311	89.68%	68	27.53%
玩	1060		8	97	0.01464%	594408	89.69%	50	20.24%
盛	1061		11	97	0.01464%	594505	89.71%	61	24.70%
釋	1062		20	97	0.01464%	594602	89.72%	60	24.29%
俗	1063		9	96	0.01449%	594698	89.74%	52	21.05%
坡	1064		8	96	0.01449%	594794	89.75%	46	18.62%
庫	1065		10	96	0.01449%	594890	89.77%	34	13.77%
弱	1066		10	96	0.01449%	594986	89.78%	67	27.13%
挑	1067		9	96	0.01449%	595082	89.80%	54	21.86%
毀	1068		13	96	0.01449%	595178	89.81%	32	12.96%
烏	1069		10	96	0.01449%	595274	89.83%	25	10.12%
盾	1070		9	96	0.01449%	595370	89.84%	44	17.81%
觸	1071		20	96	0.01449%	595466	89.85%	64	25.91%
訓	1072		10	96	0.01449%	595562	89.87%	39	15.79%
厚	1073		9	95	0.01434%	595657	89.88%	64	25.91%
尖	1074		6	95	0.01434%	595752	89.90%	47	19.03%
阿	1075		7	95	0.01434%	595847	89.91%	26	10.53%
魂	1076		14	95	0.01434%	595942	89.93%	44	17.81%
麻	1077		11	95	0.01434%	596037	89.94%	51	20.65%
休	1078		6	94	0.01418%	596131	89.95%	51	20.65%
婦	1079		11	94	0.01418%	596225	89.97%	54	21.86%
惡	1080		12	94	0.01418%	596319	89.98%	61	24.70%
描	1081		12	94	0.01418%	596413	90.00%	46	18.62%
矛	1082		5	94	0.01418%	596507	90.01%	43	17.41%
乏	1083		5	93	0.01403%	596600	90.03%	59	23.89%
右	1084		5	93	0.01403%	596693	90.04%	66	26.72%
央	1085		5	93	0.01403%	596786	90.05%	45	18.22%
榮	1086		14	93	0.01403%	596879	90.07%	50	20.24%
測	1087		12	93	0.01403%	596972	90.08%	53	21.46%
瓶	1088		11	93	0.01403%	597065	90.10%	33	13.36%
穀	1089		15	93	0.01403%	597158	90.11%	6	2.43%
課	1090		15	93	0.01403%	597251	90.12%	50	20.24%
姑	1091		8	92	0.01388%	597343	90.14%	37	14.98%
寧	1092		14	92	0.01388%	597435	90.15%	53	21.46%
戲	1093		17	92	0.01388%	597527	90.17%	37	14.98%
澤	1094		16	92	0.01388%	597619	90.18%	40	16.19%
秘	1095		10	92	0.01388%	597711	90.19%	55	22.27%
舍	1096		8	92	0.01388%	597803	90.21%	34	13.77%
葯	1097		13	92	0.01388%	597895	90.22%	29	11.74%
蓋	1098		14	92	0.01388%	597987	90.23%	63	25.51%
偏	1099		11	91	0.01373%	598078	90.25%	56	22.67%
刺	1100		8	91	0.01373%	598169	90.26%	51	20.65%
危	1101		6	91	0.01373%	598260	90.28%	51	20.65%
獎	1102		15	91	0.01373%	598351	90.29%	42	17.00%
幅	1103		12	91	0.01373%	598442	90.30%	56	22.67%
淡	1104		11	91	0.01373%	598533	90.32%	60	24.29%
牧	1105		8	91	0.01373%	598624	90.33%	29	11.74%
迎	1106		7	91	0.01373%	598715	90.34%	58	23.48%
享	1107		8	90	0.01358%	598805	90.36%	49	19.84%
慎	1108		13	90	0.01358%	598895	90.37%	25	10.12%
盤	1109		15	90	0.01358%	598985	90.39%	57	23.08%
糊	1110		15	90	0.01358%	599075	90.40%	55	22.27%
蓮	1111		15	90	0.01358%	599165	90.41%	12	4.86%
蟲	1112		18	90	0.01358%	599255	90.43%	31	12.55%
警	1113		20	90	0.01358%	599345	90.44%	40	16.19%
肺	1114		8	89	0.01343%	599434	90.45%	14	5.67%
醉	1115		15	89	0.01343%	599523	90.47%	43	17.41%
努	1116		7	88	0.01328%	599611	90.48%	54	21.86%
夷	1117		6	88	0.01328%	599699	90.49%	10	4.05%
席	1118		10	88	0.01328%	599787	90.51%	47	19.03%
慣	1119		14	88	0.01328%	599875	90.52%	62	25.10%
伸	1120		7	87	0.01313%	599962	90.53%	59	23.89%
冬	1121		5	87	0.01313%	600049	90.55%	52	21.05%
呀	1122		7	87	0.01313%	600136	90.56%	40	16.19%
墨	1123		15	87	0.01313%	600223	90.57%	33	13.36%
奔	1124		8	87	0.01313%	600310	90.59%	57	23.08%
牆	1125		17	87	0.01313%	600397	90.60%	43	17.41%
誠	1126		13	87	0.01313%	600484	90.61%	51	20.65%
載	1127		13	87	0.01313%	600571	90.62%	58	23.48%
鐘	1128		20	87	0.01313%	600658	90.64%	47	19.03%
戴	1129		17	86	0.01298%	600744	90.65%	42	17.00%
托	1130		6	86	0.01298%	600830	90.66%	52	21.05%
授	1131		11	86	0.01298%	600916	90.68%	42	17.00%
琴	1132		12	86	0.01298%	601002	90.69%	22	8.91%
凡	1133		3	85	0.01283%	601087	90.70%	61	24.70%
卷	1134		8	85	0.01283%	601172	90.72%	43	17.41%
嘉	1135		14	85	0.01283%	601257	90.73%	10	4.05%
旅	1136		10	85	0.01283%	601342	90.74%	45	18.22%
泛	1137		8	85	0.01283%	601427	90.75%	61	24.70%
蒙	1138		14	85	0.01283%	601512	90.77%	48	19.43%
隱	1139		16	85	0.01283%	601597	90.78%	55	22.27%
勁	1140		9	84	0.01268%	601681	90.79%	50	20.24%
唯	1141		11	84	0.01268%	601765	90.81%	55	22.27%
擁	1142		16	84	0.01268%	601849	90.82%	60	24.29%
柔	1143		9	84	0.01268%	601933	90.83%	47	19.03%
梨	1144		11	84	0.01268%	602017	90.84%	10	4.05%
網	1145		14	84	0.01268%	602101	90.86%	38	15.38%
莫	1146		11	84	0.01268%	602185	90.87%	51	20.65%
午	1147		4	83	0.01252%	602268	90.88%	55	22.27%
延	1148		8	83	0.01252%	602351	90.89%	58	23.48%
恨	1149		9	83	0.01252%	602434	90.91%	51	20.65%
招	1150		8	83	0.01252%	602517	90.92%	59	23.89%
絲	1151		12	83	0.01252%	602600	90.93%	50	20.24%
藍	1152		18	83	0.01252%	602683	90.94%	46	18.62%
呵	1153		8	82	0.01237%	602765	90.96%	24	9.72%
干	1154		3	82	0.01237%	602847	90.97%	50	20.24%
私	1155		7	82	0.01237%	602929	90.98%	51	20.65%
純	1156		10	82	0.01237%	603011	90.99%	60	24.29%
縮	1157		17	82	0.01237%	603093	91.01%	50	20.24%
聚	1158		14	82	0.01237%	603175	91.02%	58	23.48%
薩	1159		18	82	0.01237%	603257	91.03%	20	8.10%
訂	1160		9	82	0.01237%	603339	91.04%	32	12.96%
輯	1161		16	82	0.01237%	603421	91.05%	33	13.36%
剩	1162		12	81	0.01222%	603502	91.07%	34	13.77%
卡	1163		5	81	0.01222%	603583	91.08%	36	14.57%
吹	1164		7	81	0.01222%	603664	91.09%	58	23.48%
塔	1165		13	81	0.01222%	603745	91.10%	19	7.69%
奏	1166		9	81	0.01222%	603826	91.12%	37	14.98%
婆	1167		11	81	0.01222%	603907	91.13%	31	12.55%
宣	1168		9	81	0.01222%	603988	91.14%	65	26.32%
島	1169		10	81	0.01222%	604069	91.15%	27	10.93%
智	1170		12	81	0.01222%	604150	91.16%	53	21.46%
緣	1171		15	81	0.01222%	604231	91.18%	44	17.81%
艱	1172		17	81	0.01222%	604312	91.19%	53	21.46%
衝	1173		15	81	0.01222%	604393	91.20%	43	17.41%
複	1174		14	81	0.01222%	604474	91.21%	53	21.46%
陰	1175		10	81	0.01222%	604555	91.23%	51	20.65%
佈	1176		7	80	0.01207%	604635	91.24%	48	19.43%
偶	1177		11	80	0.01207%	604715	91.25%	55	22.27%
寬	1178		15	80	0.01207%	604795	91.26%	50	20.24%
康	1179		11	80	0.01207%	604875	91.27%	47	19.03%
徵	1180		15	80	0.01207%	604955	91.29%	44	17.81%
擠	1181		17	80	0.01207%	605035	91.30%	53	21.46%
晨	1182		11	80	0.01207%	605115	91.31%	39	15.79%
灰	1183		6	80	0.01207%	605195	91.32%	43	17.41%
舒	1184		12	80	0.01207%	605275	91.33%	43	17.41%
賞	1185		15	80	0.01207%	605355	91.35%	47	19.03%
輩	1186		15	80	0.01207%	605435	91.36%	54	21.86%
雕	1187		16	80	0.01207%	605515	91.37%	30	12.15%
飄	1188		20	80	0.01207%	605595	91.38%	39	15.79%
巧	1189		5	79	0.01192%	605674	91.39%	50	20.24%
幽	1190		9	79	0.01192%	605753	91.41%	45	18.22%
徹	1191		14	79	0.01192%	605832	91.42%	50	20.24%
晶	1192		12	79	0.01192%	605911	91.43%	26	10.53%
泉	1193		9	79	0.01192%	605990	91.44%	30	12.15%
浪	1194		10	79	0.01192%	606069	91.45%	57	23.08%
珠	1195		10	79	0.01192%	606148	91.47%	45	18.22%
窮	1196		15	79	0.01192%	606227	91.48%	48	19.43%
胡	1197		9	79	0.01192%	606306	91.49%	45	18.22%
佛	1198		7	78	0.01177%	606384	91.50%	30	12.15%
啟	1199		11	78	0.01177%	606462	91.51%	48	19.43%
弟	1200		7	78	0.01177%	606540	91.53%	41	16.60%
競	1201		20	78	0.01177%	606618	91.54%	39	15.79%
紹	1202		11	78	0.01177%	606696	91.55%	51	20.65%
薄	1203		17	78	0.01177%	606774	91.56%	55	22.27%
軟	1204		11	78	0.01177%	606852	91.57%	39	15.79%
雞	1205		18	78	0.01177%	606930	91.58%	41	16.60%
兄	1206		5	77	0.01162%	607007	91.60%	31	12.55%
刀	1207		2	77	0.01162%	607084	91.61%	38	15.38%
售	1208		11	77	0.01162%	607161	91.62%	32	12.96%
憶	1209		16	77	0.01162%	607238	91.63%	45	18.22%
救	1210		11	77	0.01162%	607315	91.64%	35	14.17%
閉	1211		11	77	0.01162%	607392	91.65%	45	18.22%
雷	1212		13	77	0.01162%	607469	91.67%	28	11.34%
預	1213		13	77	0.01162%	607546	91.68%	48	19.43%
騰	1214		20	77	0.01162%	607623	91.69%	43	17.41%
鬧	1215		15	77	0.01162%	607700	91.70%	53	21.46%
僑	1216		14	76	0.01147%	607776	91.71%	16	6.48%
喊	1217		12	76	0.01147%	607852	91.72%	50	20.24%
粗	1218		11	76	0.01147%	607928	91.74%	57	23.08%
績	1219		17	76	0.01147%	608004	91.75%	53	21.46%
	1220		11	76	0.01147%	608080	91.76%	12	4.86%
謝	1221		17	76	0.01147%	608156	91.77%	30	12.15%
侵	1222		9	75	0.01132%	608231	91.78%	24	9.72%
堆	1223		11	75	0.01132%	608306	91.79%	44	17.81%
墓	1224		14	75	0.01132%	608381	91.80%	15	6.07%
壁	1225		16	75	0.01132%	608456	91.81%	45	18.22%
守	1226		6	75	0.01132%	608531	91.83%	48	19.43%
射	1227		10	75	0.01132%	608606	91.84%	36	14.57%
朵	1228		6	75	0.01132%	608681	91.85%	43	17.41%
沿	1229		8	75	0.01132%	608756	91.86%	54	21.86%
磨	1230		16	75	0.01132%	608831	91.87%	61	24.70%
荷	1231		11	75	0.01132%	608906	91.88%	23	9.31%
避	1232		16	75	0.01132%	608981	91.89%	55	22.27%
鏡	1233		19	75	0.01132%	609056	91.91%	44	17.81%
券	1234		8	74	0.01117%	609130	91.92%	13	5.26%
岸	1235		8	74	0.01117%	609204	91.93%	40	16.19%
峰	1236		10	74	0.01117%	609278	91.94%	42	17.00%
汗	1237		6	74	0.01117%	609352	91.95%	38	15.38%
池	1238		6	74	0.01117%	609426	91.96%	28	11.34%
湖	1239		12	74	0.01117%	609500	91.97%	31	12.55%
爛	1240		21	74	0.01117%	609574	91.98%	33	13.36%
稿	1241		15	74	0.01117%	609648	91.99%	35	14.17%
肩	1242		8	74	0.01117%	609722	92.01%	49	19.84%
蕩	1243		16	74	0.01117%	609796	92.02%	48	19.43%
威	1244		9	73	0.01102%	609869	92.03%	52	21.05%
抱	1245		8	73	0.01102%	609942	92.04%	56	22.67%
敬	1246		13	73	0.01102%	610015	92.05%	48	19.43%
牙	1247		4	73	0.01102%	610088	92.06%	44	17.81%
粉	1248		10	73	0.01102%	610161	92.07%	46	18.62%
萊	1249		12	73	0.01102%	610234	92.08%	12	4.86%
踏	1250		15	73	0.01102%	610307	92.09%	47	19.03%
闊	1251		17	73	0.01102%	610380	92.11%	46	18.62%
雅	1252		12	73	0.01102%	610453	92.12%	36	14.57%
丈	1253		3	72	0.01086%	610525	92.13%	34	13.77%
博	1254		12	72	0.01086%	610597	92.14%	47	19.03%
宏	1255		7	72	0.01086%	610669	92.15%	39	15.79%
尼	1256		5	72	0.01086%	610741	92.16%	26	10.53%
畢	1257		11	72	0.01086%	610813	92.17%	54	21.86%
躍	1258		21	72	0.01086%	610885	92.18%	51	20.65%
髮	1259		15	72	0.01086%	610957	92.19%	44	17.81%
呆	1260		7	71	0.01071%	611028	92.20%	40	16.19%
帝	1261		9	71	0.01071%	611099	92.21%	32	12.96%
廳	1262		25	71	0.01071%	611170	92.22%	40	16.19%
愈	1263		13	71	0.01071%	611241	92.23%	33	13.36%
抬	1264		8	71	0.01071%	611312	92.25%	45	18.22%
束	1265		7	71	0.01071%	611383	92.26%	54	21.86%
殺	1266		11	71	0.01071%	611454	92.27%	42	17.00%
罪	1267		13	71	0.01071%	611525	92.28%	42	17.00%
貧	1268		11	71	0.01071%	611596	92.29%	35	14.17%
余	1269		7	70	0.01056%	611666	92.30%	23	9.31%
側	1270		11	70	0.01056%	611736	92.31%	45	18.22%
兵	1271		7	70	0.01056%	611806	92.32%	38	15.38%
凝	1272		16	70	0.01056%	611876	92.33%	44	17.81%
啦	1273		11	70	0.01056%	611946	92.34%	33	13.36%
徒	1274		10	70	0.01056%	612016	92.35%	27	10.93%
橫	1275		16	70	0.01056%	612086	92.36%	51	20.65%
煤	1276		13	70	0.01056%	612156	92.37%	19	7.69%
硬	1277		12	70	0.01056%	612226	92.38%	56	22.67%
秀	1278		7	70	0.01056%	612296	92.39%	50	20.24%
航	1279		10	70	0.01056%	612366	92.40%	20	8.10%
貫	1280		11	70	0.01056%	612436	92.42%	41	16.60%
迅	1281		6	70	0.01056%	612506	92.43%	50	20.24%
迫	1282		8	70	0.01056%	612576	92.44%	48	19.43%
錦	1283		16	70	0.01056%	612646	92.45%	24	9.72%
顏	1284		18	70	0.01056%	612716	92.46%	42	17.00%
乃	1285		2	69	0.01041%	612785	92.47%	37	14.98%
付	1286		5	69	0.01041%	612854	92.48%	44	17.81%
債	1287		13	69	0.01041%	612923	92.49%	20	8.10%
劑	1288		16	69	0.01041%	612992	92.50%	20	8.10%
姐	1289		8	69	0.01041%	613061	92.51%	23	9.31%
孔	1290		4	69	0.01041%	613130	92.52%	36	14.57%
怒	1291		9	69	0.01041%	613199	92.53%	42	17.00%
拓	1292		8	69	0.01041%	613268	92.54%	42	17.00%
抽	1293		8	69	0.01041%	613337	92.55%	48	19.43%
葡	1294		13	69	0.01041%	613406	92.56%	16	6.48%
蹈	1295		17	69	0.01041%	613475	92.57%	22	8.91%
鬼	1296		10	69	0.01041%	613544	92.58%	40	16.19%
哲	1297		10	68	0.01026%	613612	92.59%	30	12.15%
彿	1298		8	68	0.01026%	613680	92.60%	41	16.60%
欣	1299		8	68	0.01026%	613748	92.61%	45	18.22%
緩	1300		15	68	0.01026%	613816	92.62%	43	17.41%
胞	1301		9	68	0.01026%	613884	92.63%	27	10.93%
腿	1302		14	68	0.01026%	613952	92.64%	47	19.03%
萄	1303		12	68	0.01026%	614020	92.65%	16	6.48%
趨	1304		17	68	0.01026%	614088	92.66%	45	18.22%
圳	1305		6	67	0.01011%	614155	92.67%	12	4.86%
扎	1306		4	67	0.01011%	614222	92.68%	40	16.19%
殊	1307		10	67	0.01011%	614289	92.69%	46	18.62%
浮	1308		10	67	0.01011%	614356	92.70%	32	12.96%
爬	1309		8	67	0.01011%	614423	92.72%	41	16.60%
牌	1310		12	67	0.01011%	614490	92.73%	37	14.98%
瓷	1311		11	67	0.01011%	614557	92.74%	17	6.88%
羊	1312		6	67	0.01011%	614624	92.75%	23	9.31%
衛	1313		15	67	0.01011%	614691	92.76%	41	16.60%
遊	1314		12	67	0.01011%	614758	92.77%	38	15.38%
遭	1315		14	67	0.01011%	614825	92.78%	53	21.46%
震	1316		15	67	0.01011%	614892	92.79%	42	17.00%
霧	1317		19	67	0.01011%	614959	92.80%	33	13.36%
鞋	1318		15	67	0.01011%	615026	92.81%	31	12.55%
魚	1319		11	67	0.01011%	615093	92.82%	45	18.22%
齡	1320		20	67	0.01011%	615160	92.83%	40	16.19%
勵	1321		17	66	0.009959%	615226	92.84%	44	17.81%
召	1322		5	66	0.009959%	615292	92.85%	35	14.17%
拜	1323		9	66	0.009959%	615358	92.86%	28	11.34%
暴	1324		15	66	0.009959%	615424	92.87%	43	17.41%
槍	1325		14	66	0.009959%	615490	92.88%	26	10.53%
溪	1326		13	66	0.009959%	615556	92.89%	22	8.91%
滾	1327		14	66	0.009959%	615622	92.90%	39	15.79%
仲	1328		6	65	0.009808%	615687	92.91%	10	4.05%
吳	1329		7	65	0.009808%	615752	92.92%	26	10.53%
彈	1330		15	65	0.009808%	615817	92.93%	38	15.38%
悄	1331		10	65	0.009808%	615882	92.94%	31	12.55%
搬	1332		13	65	0.009808%	615947	92.95%	35	14.17%
摸	1333		14	65	0.009808%	616012	92.95%	41	16.60%
沐	1334		7	65	0.009808%	616077	92.96%	11	4.45%
淨	1335		11	65	0.009808%	616142	92.97%	42	17.00%
甘	1336		5	65	0.009808%	616207	92.98%	48	19.43%
耕	1337		10	65	0.009808%	616272	92.99%	33	13.36%
袋	1338		11	65	0.009808%	616337	93.00%	33	13.36%
亭	1339		9	64	0.009657%	616401	93.01%	15	6.07%
伙	1340		6	64	0.009657%	616465	93.02%	43	17.41%
儘	1341		16	64	0.009657%	616529	93.03%	48	19.43%
吐	1342		6	64	0.009657%	616593	93.04%	41	16.60%
孤	1343		8	64	0.009657%	616657	93.05%	47	19.03%
忍	1344		7	64	0.009657%	616721	93.06%	46	18.62%
胸	1345		10	64	0.009657%	616785	93.07%	45	18.22%
虛	1346		12	64	0.009657%	616849	93.08%	47	19.03%
輸	1347		16	64	0.009657%	616913	93.09%	38	15.38%
仙	1348		5	63	0.009507%	616976	93.10%	28	11.34%
仿	1349		6	63	0.009507%	617039	93.11%	38	15.38%
伍	1350		6	63	0.009507%	617102	93.12%	33	13.36%
偷	1351		11	63	0.009507%	617165	93.13%	38	15.38%
徑	1352		10	63	0.009507%	617228	93.14%	46	18.62%
惜	1353		11	63	0.009507%	617291	93.15%	46	18.62%
敗	1354		11	63	0.009507%	617354	93.16%	41	16.60%
末	1355		5	63	0.009507%	617417	93.17%	48	19.43%
犯	1356		5	63	0.009507%	617480	93.18%	30	12.15%
狗	1357		8	63	0.009507%	617543	93.19%	26	10.53%
甜	1358		11	63	0.009507%	617606	93.20%	32	12.96%
符	1359		11	63	0.009507%	617669	93.20%	44	17.81%
諸	1360		15	63	0.009507%	617732	93.21%	41	16.60%
鬆	1361		18	63	0.009507%	617795	93.22%	44	17.81%
塵	1362		14	62	0.009356%	617857	93.23%	28	11.34%
宜	1363		8	62	0.009356%	617919	93.24%	43	17.41%
尊	1364		12	62	0.009356%	617981	93.25%	44	17.81%
岩	1365		8	62	0.009356%	618043	93.26%	29	11.74%
幣	1366		14	62	0.009356%	618105	93.27%	19	7.69%
洪	1367		9	62	0.009356%	618167	93.28%	29	11.74%
珍	1368		9	62	0.009356%	618229	93.29%	41	16.60%
蕭	1369		16	62	0.009356%	618291	93.30%	24	9.72%
衡	1370		16	62	0.009356%	618353	93.31%	44	17.81%
違	1371		12	62	0.009356%	618415	93.32%	33	13.36%
麥	1372		11	62	0.009356%	618477	93.33%	24	9.72%
恰	1373		9	61	0.009205%	618538	93.34%	42	17.00%
揭	1374		12	61	0.009205%	618599	93.35%	36	14.57%
杯	1375		8	61	0.009205%	618660	93.35%	29	11.74%
洞	1376		9	61	0.009205%	618721	93.36%	36	14.57%
涉	1377		10	61	0.009205%	618782	93.37%	43	17.41%
療	1378		17	61	0.009205%	618843	93.38%	20	8.10%
蝕	1379		14	61	0.009205%	618904	93.39%	9	3.64%
輪	1380		15	61	0.009205%	618965	93.40%	45	18.22%
鋒	1381		15	61	0.009205%	619026	93.41%	26	10.53%
附	1382		7	61	0.009205%	619087	93.42%	46	18.62%
顆	1383		17	61	0.009205%	619148	93.43%	36	14.57%
倍	1384		10	60	0.009054%	619208	93.44%	41	16.60%
妙	1385		7	60	0.009054%	619268	93.45%	46	18.62%
姓	1386		8	60	0.009054%	619328	93.46%	35	14.17%
慶	1387		15	60	0.009054%	619388	93.46%	39	15.79%
框	1388		10	60	0.009054%	619448	93.47%	18	7.29%
欲	1389		11	60	0.009054%	619508	93.48%	46	18.62%
渡	1390		12	60	0.009054%	619568	93.49%	32	12.96%
焦	1391		12	60	0.009054%	619628	93.50%	32	12.96%
緒	1392		14	60	0.009054%	619688	93.51%	42	17.00%
跨	1393		13	60	0.009054%	619748	93.52%	36	14.57%
輝	1394		15	60	0.009054%	619808	93.53%	42	17.00%
辭	1395		19	60	0.009054%	619868	93.54%	30	12.15%
魯	1396		15	60	0.009054%	619928	93.55%	25	10.12%
匆	1397		5	59	0.008903%	619987	93.55%	21	8.50%
昆	1398		8	59	0.008903%	620046	93.56%	16	6.48%
毫	1399		11	59	0.008903%	620105	93.57%	44	17.81%
滅	1400		13	59	0.008903%	620164	93.58%	43	17.41%
蒼	1401		14	59	0.008903%	620223	93.59%	36	14.57%
鳴	1402		14	59	0.008903%	620282	93.60%	31	12.55%
伴	1403		7	58	0.008752%	620340	93.61%	41	16.60%
尾	1404		7	58	0.008752%	620398	93.62%	37	14.98%
帳	1405		11	58	0.008752%	620456	93.63%	15	6.07%
患	1406		11	58	0.008752%	620514	93.63%	30	12.15%
棵	1407		12	58	0.008752%	620572	93.64%	28	11.34%
棉	1408		12	58	0.008752%	620630	93.65%	16	6.48%
煉	1409		13	58	0.008752%	620688	93.66%	31	12.55%
爹	1410		10	58	0.008752%	620746	93.67%	9	3.64%
狂	1411		7	58	0.008752%	620804	93.68%	42	17.00%
覆	1412		18	58	0.008752%	620862	93.69%	39	15.79%
陪	1413		10	58	0.008752%	620920	93.70%	34	13.77%
佳	1414		8	57	0.008601%	620977	93.70%	34	13.77%
恐	1415		10	57	0.008601%	621034	93.71%	43	17.41%
憑	1416		16	57	0.008601%	621091	93.72%	42	17.00%
撞	1417		15	57	0.008601%	621148	93.73%	38	15.38%
殖	1418		12	57	0.008601%	621205	93.74%	25	10.12%
汁	1419		5	57	0.008601%	621262	93.75%	18	7.29%
澡	1420		16	57	0.008601%	621319	93.76%	15	6.07%
糖	1421		16	57	0.008601%	621376	93.76%	24	9.72%
萌	1422		12	57	0.008601%	621433	93.77%	17	6.88%
誌	1423		14	57	0.008601%	621490	93.78%	41	16.60%
鋪	1424		15	57	0.008601%	621547	93.79%	43	17.41%
丁	1425		2	56	0.00845%	621603	93.80%	22	8.91%
勃	1426		9	56	0.00845%	621659	93.81%	32	12.96%
埋	1427		10	56	0.00845%	621715	93.82%	41	16.60%
塞	1428		13	56	0.00845%	621771	93.82%	42	17.00%
怨	1429		9	56	0.00845%	621827	93.83%	46	18.62%
惠	1430		12	56	0.00845%	621883	93.84%	24	9.72%
操	1431		16	56	0.00845%	621939	93.85%	44	17.81%
渾	1432		12	56	0.00845%	621995	93.86%	38	15.38%
籠	1433		22	56	0.00845%	622051	93.87%	37	14.98%
賓	1434		14	56	0.00845%	622107	93.87%	27	10.93%
辣	1435		14	56	0.00845%	622163	93.88%	17	6.88%
鋼	1436		16	56	0.00845%	622219	93.89%	29	11.74%
陶	1437		10	56	0.00845%	622275	93.90%	29	11.74%
鼻	1438		14	56	0.00845%	622331	93.91%	43	17.41%
屆	1439		8	55	0.008299%	622386	93.92%	35	14.17%
戀	1440		23	55	0.008299%	622441	93.93%	32	12.96%
旋	1441		11	55	0.008299%	622496	93.93%	37	14.98%
枝	1442		8	55	0.008299%	622551	93.94%	32	12.96%
泳	1443		8	55	0.008299%	622606	93.95%	9	3.64%
皇	1444		9	55	0.008299%	622661	93.96%	28	11.34%
丹	1445		4	54	0.008148%	622715	93.97%	21	8.50%
伊	1446		6	54	0.008148%	622769	93.97%	24	9.72%
妹	1447		8	54	0.008148%	622823	93.98%	28	11.34%
播	1448		15	54	0.008148%	622877	93.99%	38	15.38%
畝	1449		10	54	0.008148%	622931	94.00%	18	7.29%
籌	1450		20	54	0.008148%	622985	94.01%	30	12.15%
繞	1451		18	54	0.008148%	623039	94.02%	45	18.22%
肥	1452		8	54	0.008148%	623093	94.02%	30	12.15%
菌	1453		12	54	0.008148%	623147	94.03%	11	4.45%
豆	1454		7	54	0.008148%	623201	94.04%	26	10.53%
赤	1455		7	54	0.008148%	623255	94.05%	36	14.57%
伏	1456		6	53	0.007998%	623308	94.06%	43	17.41%
幻	1457		4	53	0.007998%	623361	94.06%	43	17.41%
徽	1458		17	53	0.007998%	623414	94.07%	14	5.67%
抵	1459		8	53	0.007998%	623467	94.08%	32	12.96%
搶	1460		13	53	0.007998%	623520	94.09%	28	11.34%
替	1461		12	53	0.007998%	623573	94.10%	45	18.22%
湧	1462		12	53	0.007998%	623626	94.10%	35	14.17%
祭	1463		11	53	0.007998%	623679	94.11%	10	4.05%
穆	1464		16	53	0.007998%	623732	94.12%	12	4.86%
繫	1465		19	53	0.007998%	623785	94.13%	40	16.19%
轄	1466		17	53	0.007998%	623838	94.14%	11	4.45%
辟	1467		13	53	0.007998%	623891	94.14%	12	4.86%
邁	1468		16	53	0.007998%	623944	94.15%	26	10.53%
鑒	1469		22	53	0.007998%	623997	94.16%	36	14.57%
勇	1470		9	52	0.007847%	624049	94.17%	39	15.79%
哀	1471		9	52	0.007847%	624101	94.18%	37	14.98%
斜	1472		11	52	0.007847%	624153	94.18%	40	16.19%
氏	1473		4	52	0.007847%	624205	94.19%	20	8.10%
濱	1474		17	52	0.007847%	624257	94.20%	20	8.10%
獅	1475		13	52	0.007847%	624309	94.21%	7	2.83%
疲	1476		10	52	0.007847%	624361	94.21%	30	12.15%
睜	1477		13	52	0.007847%	624413	94.22%	31	12.55%
稅	1478		12	52	0.007847%	624465	94.23%	29	11.74%
糾	1479		8	52	0.007847%	624517	94.24%	24	9.72%
臂	1480		17	52	0.007847%	624569	94.25%	24	9.72%
膽	1481		17	52	0.007847%	624621	94.25%	41	16.60%
蘭	1482		21	52	0.007847%	624673	94.26%	27	10.93%
軌	1483		9	52	0.007847%	624725	94.27%	33	13.36%
霞	1484		17	52	0.007847%	624777	94.28%	20	8.10%
頗	1485		14	52	0.007847%	624829	94.29%	41	16.60%
喚	1486		12	51	0.007696%	624880	94.29%	36	14.57%
悉	1487		11	51	0.007696%	624931	94.30%	41	16.60%
掘	1488		11	51	0.007696%	624982	94.31%	23	9.31%
撥	1489		15	51	0.007696%	625033	94.32%	31	12.55%
腰	1490		13	51	0.007696%	625084	94.32%	33	13.36%
辛	1491		7	51	0.007696%	625135	94.33%	38	15.38%
隔	1492		12	51	0.007696%	625186	94.34%	36	14.57%
亦	1493		6	50	0.007545%	625236	94.35%	33	13.36%
匹	1494		4	50	0.007545%	625286	94.35%	18	7.29%
呈	1495		7	50	0.007545%	625336	94.36%	31	12.55%
嘛	1496		14	50	0.007545%	625386	94.37%	24	9.72%
扭	1497		7	50	0.007545%	625436	94.38%	31	12.55%
湯	1498		12	50	0.007545%	625486	94.38%	21	8.50%
碰	1499		13	50	0.007545%	625536	94.39%	36	14.57%
纖	1500		23	50	0.007545%	625586	94.40%	17	6.88%
藥	1501		19	50	0.007545%	625636	94.41%	17	6.88%
遞	1502		13	50	0.007545%	625686	94.41%	31	12.55%
郁	1503		8	50	0.007545%	625736	94.42%	29	11.74%
鍛	1504		17	50	0.007545%	625786	94.43%	14	5.67%
仰	1505		6	49	0.007394%	625835	94.44%	36	14.57%
儀	1506		15	49	0.007394%	625884	94.44%	22	8.91%
圈	1507		11	49	0.007394%	625933	94.45%	36	14.57%
壽	1508		14	49	0.007394%	625982	94.46%	21	8.50%
憤	1509		15	49	0.007394%	626031	94.47%	33	13.36%
抑	1510		7	49	0.007394%	626080	94.47%	38	15.38%
敏	1511		11	49	0.007394%	626129	94.48%	27	10.93%
瓦	1512		5	49	0.007394%	626178	94.49%	25	10.12%
秦	1513		10	49	0.007394%	626227	94.50%	13	5.26%
簽	1514		19	49	0.007394%	626276	94.50%	26	10.53%
罵	1515		15	49	0.007394%	626325	94.51%	29	11.74%
迪	1516		8	49	0.007394%	626374	94.52%	23	9.31%
遙	1517		13	49	0.007394%	626423	94.53%	30	12.15%
准	1518		10	48	0.007243%	626471	94.53%	35	14.17%
勤	1519		13	48	0.007243%	626519	94.54%	37	14.98%
唐	1520		10	48	0.007243%	626567	94.55%	28	11.34%
嘆	1521		14	48	0.007243%	626615	94.55%	35	14.17%
壇	1522		16	48	0.007243%	626663	94.56%	28	11.34%
恢	1523		9	48	0.007243%	626711	94.57%	28	11.34%
悠	1524		11	48	0.007243%	626759	94.58%	34	13.77%
暖	1525		13	48	0.007243%	626807	94.58%	37	14.98%
棄	1526		11	48	0.007243%	626855	94.59%	34	13.77%
毒	1527		9	48	0.007243%	626903	94.60%	27	10.93%
溝	1528		13	48	0.007243%	626951	94.61%	32	12.96%
潔	1529		15	48	0.007243%	626999	94.61%	37	14.98%
症	1530		10	48	0.007243%	627047	94.62%	21	8.50%
繪	1531		19	48	0.007243%	627095	94.63%	24	9.72%
茲	1532		10	48	0.007243%	627143	94.63%	5	2.02%
詢	1533		13	48	0.007243%	627191	94.64%	27	10.93%
豪	1534		14	48	0.007243%	627239	94.65%	40	16.19%
貌	1535		14	48	0.007243%	627287	94.66%	34	13.77%
頁	1536		9	48	0.007243%	627335	94.66%	24	9.72%
鶴	1537		21	48	0.007243%	627383	94.67%	8	3.24%
仁	1538		4	47	0.007092%	627430	94.68%	22	8.91%
寂	1539		11	47	0.007092%	627477	94.68%	35	14.17%
寒	1540		12	47	0.007092%	627524	94.69%	36	14.57%
屈	1541		8	47	0.007092%	627571	94.70%	35	14.17%
拾	1542		9	47	0.007092%	627618	94.71%	32	12.96%
逃	1543		9	47	0.007092%	627665	94.71%	32	12.96%
鍋	1544		17	47	0.007092%	627712	94.72%	23	9.31%
餐	1545		16	47	0.007092%	627759	94.73%	22	8.91%
井	1546		4	46	0.006941%	627805	94.73%	21	8.50%
塗	1547		13	46	0.006941%	627851	94.74%	33	13.36%
奪	1548		14	46	0.006941%	627897	94.75%	35	14.17%
廢	1549		15	46	0.006941%	627943	94.76%	35	14.17%
懸	1550		20	46	0.006941%	627989	94.76%	38	15.38%
昏	1551		8	46	0.006941%	628035	94.77%	33	13.36%
潛	1552		15	46	0.006941%	628081	94.78%	32	12.96%
猛	1553		11	46	0.006941%	628127	94.78%	34	13.77%
番	1554		12	46	0.006941%	628173	94.79%	37	14.98%
范	1555		9	46	0.006941%	628219	94.80%	15	6.07%
鄰	1556		14	46	0.006941%	628265	94.80%	33	13.36%
陷	1557		10	46	0.006941%	628311	94.81%	33	13.36%
兼	1558		10	45	0.00679%	628356	94.82%	32	12.96%
叢	1559		18	45	0.00679%	628401	94.82%	32	12.96%
撲	1560		15	45	0.00679%	628446	94.83%	33	13.36%
樸	1561		16	45	0.00679%	628491	94.84%	29	11.74%
濕	1562		17	45	0.00679%	628536	94.84%	32	12.96%
礙	1563		19	45	0.00679%	628581	94.85%	28	11.34%
肚	1564		7	45	0.00679%	628626	94.86%	34	13.77%
遜	1565		13	45	0.00679%	628671	94.87%	11	4.45%
鍵	1566		17	45	0.00679%	628716	94.87%	36	14.57%
倆	1567		10	44	0.00664%	628760	94.88%	27	10.93%
厲	1568		15	44	0.00664%	628804	94.89%	23	9.31%
姻	1569		9	44	0.00664%	628848	94.89%	12	4.86%
抒	1570		7	44	0.00664%	628892	94.90%	25	10.12%
挖	1571		9	44	0.00664%	628936	94.91%	21	8.50%
泰	1572		10	44	0.00664%	628980	94.91%	19	7.69%
涵	1573		11	44	0.00664%	629024	94.92%	27	10.93%
漂	1574		14	44	0.00664%	629068	94.93%	33	13.36%
瓜	1575		5	44	0.00664%	629112	94.93%	28	11.34%
稀	1576		12	44	0.00664%	629156	94.94%	33	13.36%
罩	1577		13	44	0.00664%	629200	94.94%	33	13.36%
脖	1578		11	44	0.00664%	629244	94.95%	30	12.15%
腐	1579		14	44	0.00664%	629288	94.96%	26	10.53%
虧	1580		17	44	0.00664%	629332	94.96%	23	9.31%
讚	1581		26	44	0.00664%	629376	94.97%	35	14.17%
銅	1582		14	44	0.00664%	629420	94.98%	22	8.91%
閑	1583		12	44	0.00664%	629464	94.98%	35	14.17%
鳳	1584		14	44	0.00664%	629508	94.99%	14	5.67%
乘	1585		10	43	0.006489%	629551	95.00%	29	11.74%
伯	1586		7	43	0.006489%	629594	95.00%	20	8.10%
冠	1587		9	43	0.006489%	629637	95.01%	26	10.53%
勒	1588		11	43	0.006489%	629680	95.02%	25	10.12%
喬	1589		12	43	0.006489%	629723	95.02%	10	4.05%
奴	1590		5	43	0.006489%	629766	95.03%	11	4.45%
惑	1591		12	43	0.006489%	629809	95.04%	34	13.77%
扇	1592		10	43	0.006489%	629852	95.04%	23	9.31%
扶	1593		7	43	0.006489%	629895	95.05%	27	10.93%
挺	1594		10	43	0.006489%	629938	95.06%	31	12.55%
攻	1595		7	43	0.006489%	629981	95.06%	32	12.96%
朗	1596		10	43	0.006489%	630024	95.07%	28	11.34%
津	1597		9	43	0.006489%	630067	95.08%	18	7.29%
添	1598		11	43	0.006489%	630110	95.08%	23	9.31%
滋	1599		12	43	0.006489%	630153	95.09%	36	14.57%
潤	1600		15	43	0.006489%	630196	95.10%	31	12.55%
玻	1601		9	43	0.006489%	630239	95.10%	27	10.93%
璃	1602		15	43	0.006489%	630282	95.11%	26	10.53%
眉	1603		9	43	0.006489%	630325	95.11%	36	14.57%
絡	1604		12	43	0.006489%	630368	95.12%	27	10.93%
肅	1605		12	43	0.006489%	630411	95.13%	31	12.55%
肌	1606		6	43	0.006489%	630454	95.13%	14	5.67%
譽	1607		21	43	0.006489%	630497	95.14%	29	11.74%
豬	1608		11	43	0.006489%	630540	95.15%	22	8.91%
躺	1609		15	43	0.006489%	630583	95.15%	29	11.74%
郎	1610		8	43	0.006489%	630626	95.16%	16	6.48%
鄭	1611		14	43	0.006489%	630669	95.17%	17	6.88%
阻	1612		7	43	0.006489%	630712	95.17%	29	11.74%
霖	1613		16	43	0.006489%	630755	95.18%	5	2.02%
償	1614		17	42	0.006338%	630797	95.19%	26	10.53%
剝	1615		10	42	0.006338%	630839	95.19%	23	9.31%
君	1616		7	42	0.006338%	630881	95.20%	24	9.72%
咬	1617		9	42	0.006338%	630923	95.20%	29	11.74%
喪	1618		12	42	0.006338%	630965	95.21%	34	13.77%
彎	1619		22	42	0.006338%	631007	95.22%	31	12.55%
循	1620		12	42	0.006338%	631049	95.22%	34	13.77%
悅	1621		10	42	0.006338%	631091	95.23%	28	11.34%
戚	1622		11	42	0.006338%	631133	95.24%	17	6.88%
拖	1623		8	42	0.006338%	631175	95.24%	28	11.34%
煩	1624		13	42	0.006338%	631217	95.25%	33	13.36%
猶	1625		12	42	0.006338%	631259	95.26%	35	14.17%
膚	1626		15	42	0.006338%	631301	95.26%	21	8.50%
茫	1627		10	42	0.006338%	631343	95.27%	29	11.74%
虎	1628		8	42	0.006338%	631385	95.27%	29	11.74%
飽	1629		13	42	0.006338%	631427	95.28%	35	14.17%
飾	1630		13	42	0.006338%	631469	95.29%	35	14.17%
奉	1631		8	41	0.006187%	631510	95.29%	26	10.53%
宮	1632		10	41	0.006187%	631551	95.30%	23	9.31%
恩	1633		10	41	0.006187%	631592	95.31%	24	9.72%
掩	1634		11	41	0.006187%	631633	95.31%	32	12.96%
摩	1635		15	41	0.006187%	631674	95.32%	29	11.74%
昌	1636		8	41	0.006187%	631715	95.32%	20	8.10%
狠	1637		9	41	0.006187%	631756	95.33%	21	8.50%
皺	1638		15	41	0.006187%	631797	95.34%	21	8.50%
碗	1639		13	41	0.006187%	631838	95.34%	23	9.31%
粱	1640		13	41	0.006187%	631879	95.35%	2	0.81%
縱	1641		17	41	0.006187%	631920	95.36%	30	12.15%
蓄	1642		14	41	0.006187%	631961	95.36%	26	10.53%
覽	1643		21	41	0.006187%	632002	95.37%	22	8.91%
賈	1644		13	41	0.006187%	632043	95.37%	7	2.83%
韓	1645		17	41	0.006187%	632084	95.38%	15	6.07%
串	1646		7	40	0.006036%	632124	95.39%	32	12.96%
吉	1647		6	40	0.006036%	632164	95.39%	23	9.31%
喘	1648		12	40	0.006036%	632204	95.40%	22	8.91%
噸	1649		16	40	0.006036%	632244	95.40%	18	7.29%
娃	1650		9	40	0.006036%	632284	95.41%	9	3.64%
孟	1651		8	40	0.006036%	632324	95.42%	8	3.24%
寄	1652		11	40	0.006036%	632364	95.42%	27	10.93%
掙	1653		11	40	0.006036%	632404	95.43%	25	10.12%
敲	1654		14	40	0.006036%	632444	95.43%	33	13.36%
洛	1655		9	40	0.006036%	632484	95.44%	19	7.69%
液	1656		11	40	0.006036%	632524	95.45%	17	6.88%
滴	1657		14	40	0.006036%	632564	95.45%	31	12.55%
潑	1658		15	40	0.006036%	632604	95.46%	28	11.34%
燧	1659		17	40	0.006036%	632644	95.46%	5	2.02%
礦	1660		20	40	0.006036%	632684	95.47%	20	8.10%
翰	1661		16	40	0.006036%	632724	95.48%	6	2.43%
翼	1662		17	40	0.006036%	632764	95.48%	18	7.29%
聖	1663		13	40	0.006036%	632804	95.49%	26	10.53%
裂	1664		12	40	0.006036%	632844	95.49%	28	11.34%
賠	1665		15	40	0.006036%	632884	95.50%	10	4.05%
偽	1666		11	39	0.005885%	632923	95.51%	15	6.07%
冒	1667		9	39	0.005885%	632962	95.51%	35	14.17%
垂	1668		9	39	0.005885%	633001	95.52%	28	11.34%
拔	1669		8	39	0.005885%	633040	95.52%	26	10.53%
晃	1670		10	39	0.005885%	633079	95.53%	16	6.48%
氛	1671		8	39	0.005885%	633118	95.54%	31	12.55%
滑	1672		13	39	0.005885%	633157	95.54%	29	11.74%
瑞	1673		13	39	0.005885%	633196	95.55%	14	5.67%
甲	1674		5	39	0.005885%	633235	95.55%	26	10.53%
瘋	1675		14	39	0.005885%	633274	95.56%	26	10.53%
瘦	1676		14	39	0.005885%	633313	95.57%	27	10.93%
盆	1677		9	39	0.005885%	633352	95.57%	27	10.93%
祥	1678		10	39	0.005885%	633391	95.58%	20	8.10%
製	1679		14	39	0.005885%	633430	95.58%	23	9.31%
距	1680		12	39	0.005885%	633469	95.59%	34	13.77%
逢	1681		10	39	0.005885%	633508	95.59%	34	13.77%
頻	1682		16	39	0.005885%	633547	95.60%	27	10.93%
仔	1683		5	38	0.005734%	633585	95.61%	22	8.91%
吾	1684		7	38	0.005734%	633623	95.61%	18	7.29%
幕	1685		14	38	0.005734%	633661	95.62%	25	10.12%
慌	1686		13	38	0.005734%	633699	95.62%	24	9.72%
抖	1687		7	38	0.005734%	633737	95.63%	25	10.12%
掃	1688		11	38	0.005734%	633775	95.64%	30	12.15%
插	1689		12	38	0.005734%	633813	95.64%	27	10.93%
撒	1690		15	38	0.005734%	633851	95.65%	28	11.34%
擦	1691		17	38	0.005734%	633889	95.65%	24	9.72%
暫	1692		15	38	0.005734%	633927	95.66%	33	13.36%
枯	1693		9	38	0.005734%	633965	95.66%	26	10.53%
瀅	1694		18	38	0.005734%	634003	95.67%	3	1.22%
燃	1695		16	38	0.005734%	634041	95.68%	29	11.74%
爆	1696		19	38	0.005734%	634079	95.68%	21	8.50%
瞬	1697		17	38	0.005734%	634117	95.69%	17	6.88%
秩	1698		10	38	0.005734%	634155	95.69%	24	9.72%
紫	1699		12	38	0.005734%	634193	95.70%	23	9.31%
綿	1700		14	38	0.005734%	634231	95.70%	26	10.53%
脆	1701		10	38	0.005734%	634269	95.71%	32	12.96%
蔣	1702		15	38	0.005734%	634307	95.72%	8	3.24%
裁	1703		12	38	0.005734%	634345	95.72%	23	9.31%
誘	1704		14	38	0.005734%	634383	95.73%	29	11.74%
騎	1705		18	38	0.005734%	634421	95.73%	26	10.53%
鹽	1706		24	38	0.005734%	634459	95.74%	21	8.50%
剪	1707		11	37	0.005583%	634496	95.74%	21	8.50%
割	1708		12	37	0.005583%	634533	95.75%	30	12.15%
厭	1709		14	37	0.005583%	634570	95.76%	30	12.15%
吵	1710		7	37	0.005583%	634607	95.76%	19	7.69%
嘗	1711		14	37	0.005583%	634644	95.77%	24	9.72%
坦	1712		8	37	0.005583%	634681	95.77%	22	8.91%
姿	1713		9	37	0.005583%	634718	95.78%	31	12.55%
憂	1714		15	37	0.005583%	634755	95.78%	26	10.53%
扣	1715		6	37	0.005583%	634792	95.79%	26	10.53%
摘	1716		14	37	0.005583%	634829	95.79%	28	11.34%
椅	1717		12	37	0.005583%	634866	95.80%	20	8.10%
沈	1718		7	37	0.005583%	634903	95.81%	22	8.91%
渴	1719		12	37	0.005583%	634940	95.81%	30	12.15%
腸	1720		13	37	0.005583%	634977	95.82%	20	8.10%
膜	1721		15	37	0.005583%	635014	95.82%	13	5.26%
臟	1722		22	37	0.005583%	635051	95.83%	17	6.88%
蔬	1723		15	37	0.005583%	635088	95.83%	8	3.24%
顫	1724		22	37	0.005583%	635125	95.84%	26	10.53%
云	1725		4	36	0.005432%	635161	95.84%	18	7.29%
咪	1726		9	36	0.005432%	635197	95.85%	3	1.22%
址	1727		7	36	0.005432%	635233	95.86%	9	3.64%
屁	1728		7	36	0.005432%	635269	95.86%	21	8.50%
慰	1729		15	36	0.005432%	635305	95.87%	26	10.53%
撫	1730		15	36	0.005432%	635341	95.87%	26	10.53%
敵	1731		15	36	0.005432%	635377	95.88%	24	9.72%
昨	1732		9	36	0.005432%	635413	95.88%	23	9.31%
曹	1733		11	36	0.005432%	635449	95.89%	10	4.05%
欠	1734		4	36	0.005432%	635485	95.89%	22	8.91%
歧	1735		8	36	0.005432%	635521	95.90%	18	7.29%
歪	1736		9	36	0.005432%	635557	95.90%	25	10.12%
畜	1737		10	36	0.005432%	635593	95.91%	17	6.88%
稍	1738		12	36	0.005432%	635629	95.92%	31	12.55%
籍	1739		20	36	0.005432%	635665	95.92%	25	10.12%
脈	1740		10	36	0.005432%	635701	95.93%	31	12.55%
臥	1741		8	36	0.005432%	635737	95.93%	31	12.55%
諷	1742		16	36	0.005432%	635773	95.94%	10	4.05%
躲	1743		13	36	0.005432%	635809	95.94%	27	10.93%
采	1744		8	36	0.005432%	635845	95.95%	23	9.31%
估	1745		7	35	0.005281%	635880	95.95%	26	10.53%
允	1746		4	35	0.005281%	635915	95.96%	22	8.91%
削	1747		9	35	0.005281%	635950	95.96%	25	10.12%
咱	1748		9	35	0.005281%	635985	95.97%	18	7.29%
宿	1749		11	35	0.005281%	636020	95.97%	26	10.53%
幼	1750		5	35	0.005281%	636055	95.98%	28	11.34%
征	1751		8	35	0.005281%	636090	95.98%	24	9.72%
徐	1752		10	35	0.005281%	636125	95.99%	23	9.31%
忠	1753		8	35	0.005281%	636160	96.00%	29	11.74%
斤	1754		4	35	0.005281%	636195	96.00%	24	9.72%
杰	1755		8	35	0.005281%	636230	96.01%	14	5.67%
炮	1756		9	35	0.005281%	636265	96.01%	17	6.88%
牲	1757		9	35	0.005281%	636300	96.02%	29	11.74%
碼	1758		15	35	0.005281%	636335	96.02%	27	10.93%
縫	1759		17	35	0.005281%	636370	96.03%	27	10.93%
耐	1760		9	35	0.005281%	636405	96.03%	31	12.55%
膠	1761		15	35	0.005281%	636440	96.04%	20	8.10%
譜	1762		19	35	0.005281%	636475	96.04%	18	7.29%
鴨	1763		16	35	0.005281%	636510	96.05%	12	4.86%
噴	1764		15	34	0.005131%	636544	96.05%	23	9.31%
寺	1765		6	34	0.005131%	636578	96.06%	11	4.45%
帽	1766		12	34	0.005131%	636612	96.06%	20	8.10%
惱	1767		12	34	0.005131%	636646	96.07%	25	10.12%
慘	1768		14	34	0.005131%	636680	96.07%	25	10.12%
扔	1769		5	34	0.005131%	636714	96.08%	25	10.12%
披	1770		8	34	0.005131%	636748	96.08%	28	11.34%
擾	1771		18	34	0.005131%	636782	96.09%	27	10.93%
攤	1772		22	34	0.005131%	636816	96.09%	22	8.91%
斗	1773		4	34	0.005131%	636850	96.10%	24	9.72%
淮	1774		11	34	0.005131%	636884	96.10%	13	5.26%
申	1775		5	34	0.005131%	636918	96.11%	26	10.53%
痕	1776		11	34	0.005131%	636952	96.11%	23	9.31%
祝	1777		9	34	0.005131%	636986	96.12%	24	9.72%
窩	1778		14	34	0.005131%	637020	96.12%	26	10.53%
耀	1779		20	34	0.005131%	637054	96.13%	28	11.34%
聳	1780		17	34	0.005131%	637088	96.14%	24	9.72%
艷	1781		24	34	0.005131%	637122	96.14%	27	10.93%
葬	1782		13	34	0.005131%	637156	96.15%	18	7.29%
辯	1783		21	34	0.005131%	637190	96.15%	25	10.12%
返	1784		7	34	0.005131%	637224	96.16%	28	11.34%
逝	1785		10	34	0.005131%	637258	96.16%	27	10.93%
闆	1786		17	34	0.005131%	637292	96.17%	2	0.81%
鸝	1787		30	34	0.005131%	637326	96.17%	2	0.81%
僚	1788		14	33	0.00498%	637359	96.18%	15	6.07%
儲	1789		17	33	0.00498%	637392	96.18%	15	6.07%
刷	1790		8	33	0.00498%	637425	96.19%	26	10.53%
嗓	1791		13	33	0.00498%	637458	96.19%	20	8.10%
夕	1792		3	33	0.00498%	637491	96.20%	27	10.93%
夾	1793		7	33	0.00498%	637524	96.20%	27	10.93%
奧	1794		13	33	0.00498%	637557	96.21%	21	8.50%
孕	1795		5	33	0.00498%	637590	96.21%	22	8.91%
川	1796		3	33	0.00498%	637623	96.22%	21	8.50%
抹	1797		8	33	0.00498%	637656	96.22%	25	10.12%
捧	1798		11	33	0.00498%	637689	96.23%	27	10.93%
斑	1799		12	33	0.00498%	637722	96.23%	23	9.31%
旗	1800		14	33	0.00498%	637755	96.24%	21	8.50%
晉	1801		10	33	0.00498%	637788	96.24%	13	5.26%
暢	1802		14	33	0.00498%	637821	96.25%	30	12.15%
柳	1803		9	33	0.00498%	637854	96.25%	15	6.07%
檔	1804		17	33	0.00498%	637887	96.26%	14	5.67%
氧	1805		10	33	0.00498%	637920	96.26%	9	3.64%
淺	1806		11	33	0.00498%	637953	96.27%	25	10.12%
渠	1807		12	33	0.00498%	637986	96.27%	23	9.31%
灌	1808		21	33	0.00498%	638019	96.28%	24	9.72%
箱	1809		15	33	0.00498%	638052	96.28%	24	9.72%
紋	1810		10	33	0.00498%	638085	96.29%	21	8.50%
膀	1811		14	33	0.00498%	638118	96.29%	22	8.91%
衰	1812		10	33	0.00498%	638151	96.30%	25	10.12%
譯	1813		20	33	0.00498%	638184	96.30%	23	9.31%
賴	1814		16	33	0.00498%	638217	96.31%	26	10.53%
遵	1815		15	33	0.00498%	638250	96.31%	27	10.93%
鑽	1816		27	33	0.00498%	638283	96.32%	16	6.48%
鞭	1817		18	33	0.00498%	638316	96.32%	18	7.29%
頌	1818		13	33	0.00498%	638349	96.33%	23	9.31%
侯	1819		9	32	0.004829%	638381	96.33%	12	4.86%
吞	1820		7	32	0.004829%	638413	96.34%	22	8.91%
巍	1821		21	32	0.004829%	638445	96.34%	5	2.02%
振	1822		10	32	0.004829%	638477	96.34%	28	11.34%
桂	1823		10	32	0.004829%	638509	96.35%	15	6.07%
栗	1824		10	32	0.004829%	638541	96.35%	12	4.86%
梁	1825		11	32	0.004829%	638573	96.36%	20	8.10%
濤	1826		17	32	0.004829%	638605	96.36%	19	7.69%
灘	1827		22	32	0.004829%	638637	96.37%	17	6.88%
牽	1828		11	32	0.004829%	638669	96.37%	28	11.34%
盯	1829		7	32	0.004829%	638701	96.38%	20	8.10%
盲	1830		8	32	0.004829%	638733	96.38%	23	9.31%
盼	1831		9	32	0.004829%	638765	96.39%	24	9.72%
碧	1832		14	32	0.004829%	638797	96.39%	19	7.69%
罰	1833		14	32	0.004829%	638829	96.40%	21	8.50%
蒂	1834		13	32	0.004829%	638861	96.40%	12	4.86%
詳	1835		13	32	0.004829%	638893	96.41%	29	11.74%
豹	1836		10	32	0.004829%	638925	96.41%	3	1.22%
貝	1837		7	32	0.004829%	638957	96.42%	20	8.10%
貢	1838		10	32	0.004829%	638989	96.42%	26	10.53%
賦	1839		15	32	0.004829%	639021	96.43%	25	10.12%
隸	1840		17	32	0.004829%	639053	96.43%	7	2.83%
倡	1841		10	31	0.004678%	639084	96.44%	21	8.50%
墳	1842		15	31	0.004678%	639115	96.44%	9	3.64%
妝	1843		7	31	0.004678%	639146	96.45%	11	4.45%
妥	1844		7	31	0.004678%	639177	96.45%	23	9.31%
嫁	1845		13	31	0.004678%	639208	96.46%	17	6.88%
宇	1846		6	31	0.004678%	639239	96.46%	23	9.31%
弓	1847		3	31	0.004678%	639270	96.46%	20	8.10%
悟	1848		10	31	0.004678%	639301	96.47%	26	10.53%
截	1849		14	31	0.004678%	639332	96.47%	25	10.12%
扯	1850		7	31	0.004678%	639363	96.48%	22	8.91%
拼	1851		9	31	0.004678%	639394	96.48%	28	11.34%
掏	1852		11	31	0.004678%	639425	96.49%	22	8.91%
搭	1853		13	31	0.004678%	639456	96.49%	19	7.69%
搏	1854		13	31	0.004678%	639487	96.50%	26	10.53%
梅	1855		11	31	0.004678%	639518	96.50%	20	8.10%
歹	1856		4	31	0.004678%	639549	96.51%	4	1.62%
滲	1857		14	31	0.004678%	639580	96.51%	27	10.93%
澳	1858		16	31	0.004678%	639611	96.52%	15	6.07%
癌	1859		17	31	0.004678%	639642	96.52%	12	4.86%
租	1860		10	31	0.004678%	639673	96.53%	20	8.10%
紡	1861		10	31	0.004678%	639704	96.53%	17	6.88%
纏	1862		21	31	0.004678%	639735	96.53%	24	9.72%
腎	1863		12	31	0.004678%	639766	96.54%	3	1.22%
脾	1864		12	31	0.004678%	639797	96.54%	17	6.88%
莊	1865		11	31	0.004678%	639828	96.55%	21	8.50%
衷	1866		10	31	0.004678%	639859	96.55%	27	10.93%
遷	1867		14	31	0.004678%	639890	96.56%	18	7.29%
邀	1868		16	31	0.004678%	639921	96.56%	22	8.91%
刑	1869		6	30	0.004527%	639951	96.57%	19	7.69%
姆	1870		8	30	0.004527%	639981	96.57%	17	6.88%
彷	1871		7	30	0.004527%	640011	96.58%	22	8.91%
慕	1872		15	30	0.004527%	640041	96.58%	21	8.50%
斥	1873		5	30	0.004527%	640071	96.59%	24	9.72%
桑	1874		10	30	0.004527%	640101	96.59%	17	6.88%
浩	1875		10	30	0.004527%	640131	96.59%	21	8.50%
炭	1876		9	30	0.004527%	640161	96.60%	12	4.86%
皆	1877		9	30	0.004527%	640191	96.60%	23	9.31%
粒	1878		11	30	0.004527%	640221	96.61%	21	8.50%
罷	1879		15	30	0.004527%	640251	96.61%	21	8.50%
耗	1880		10	30	0.004527%	640281	96.62%	21	8.50%
苗	1881		9	30	0.004527%	640311	96.62%	13	5.26%
裙	1882		12	30	0.004527%	640341	96.63%	22	8.91%
謀	1883		16	30	0.004527%	640371	96.63%	25	10.12%
辨	1884		16	30	0.004527%	640401	96.64%	23	9.31%
霜	1885		17	30	0.004527%	640431	96.64%	9	3.64%
駛	1886		15	30	0.004527%	640461	96.64%	22	8.91%
傲	1887		13	29	0.004376%	640490	96.65%	25	10.12%
勸	1888		20	29	0.004376%	640519	96.65%	22	8.91%
咸	1889		9	29	0.004376%	640548	96.66%	6	2.43%
嚇	1890		17	29	0.004376%	640577	96.66%	21	8.50%
契	1891		9	29	0.004376%	640606	96.67%	16	6.48%
悶	1892		12	29	0.004376%	640635	96.67%	23	9.31%
旦	1893		5	29	0.004376%	640664	96.67%	26	10.53%
杜	1894		7	29	0.004376%	640693	96.68%	16	6.48%
桃	1895		10	29	0.004376%	640722	96.68%	15	6.07%
狹	1896		10	29	0.004376%	640751	96.69%	23	9.31%
窄	1897		10	29	0.004376%	640780	96.69%	24	9.72%
繩	1898		19	29	0.004376%	640809	96.70%	18	7.29%
胃	1899		9	29	0.004376%	640838	96.70%	17	6.88%
脂	1900		10	29	0.004376%	640867	96.71%	14	5.67%
臭	1901		10	29	0.004376%	640896	96.71%	19	7.69%
裕	1902		12	29	0.004376%	640925	96.71%	18	7.29%
贊	1903		19	29	0.004376%	640954	96.72%	25	10.12%
逼	1904		12	29	0.004376%	640983	96.72%	26	10.53%
遲	1905		15	29	0.004376%	641012	96.73%	20	8.10%
雀	1906		11	29	0.004376%	641041	96.73%	17	6.88%
霉	1907		15	29	0.004376%	641070	96.74%	9	3.64%
鞏	1908		15	29	0.004376%	641099	96.74%	15	6.07%
顛	1909		19	29	0.004376%	641128	96.74%	22	8.91%
劣	1910		6	28	0.004225%	641156	96.75%	25	10.12%
匠	1911		6	28	0.004225%	641184	96.75%	18	7.29%
填	1912		13	28	0.004225%	641212	96.76%	20	8.10%
嫩	1913		14	28	0.004225%	641240	96.76%	20	8.10%
惶	1914		12	28	0.004225%	641268	96.77%	18	7.29%
慧	1915		15	28	0.004225%	641296	96.77%	19	7.69%
扮	1916		7	28	0.004225%	641324	96.77%	21	8.50%
炎	1917		8	28	0.004225%	641352	96.78%	19	7.69%
爐	1918		20	28	0.004225%	641380	96.78%	17	6.88%
盈	1919		9	28	0.004225%	641408	96.79%	21	8.50%
矮	1920		13	28	0.004225%	641436	96.79%	20	8.10%
稻	1921		15	28	0.004225%	641464	96.80%	12	4.86%
聊	1922		11	28	0.004225%	641492	96.80%	21	8.50%
脊	1923		10	28	0.004225%	641520	96.80%	23	9.31%
萍	1924		12	28	0.004225%	641548	96.81%	9	3.64%
裸	1925		13	28	0.004225%	641576	96.81%	18	7.29%
裹	1926		14	28	0.004225%	641604	96.82%	25	10.12%
遼	1927		15	28	0.004225%	641632	96.82%	19	7.69%
邏	1928		22	28	0.004225%	641660	96.83%	20	8.10%
酷	1929		14	28	0.004225%	641688	96.83%	22	8.91%
鎖	1930		18	28	0.004225%	641716	96.83%	25	10.12%
隆	1931		11	28	0.004225%	641744	96.84%	19	7.69%
髒	1932		22	28	0.004225%	641772	96.84%	17	6.88%
魔	1933		21	28	0.004225%	641800	96.85%	21	8.50%
丟	1934		6	27	0.004074%	641827	96.85%	20	8.10%
仇	1935		4	27	0.004074%	641854	96.85%	18	7.29%
俱	1936		10	27	0.004074%	641881	96.86%	20	8.10%
剖	1937		10	27	0.004074%	641908	96.86%	19	7.69%
叉	1938		3	27	0.004074%	641935	96.87%	21	8.50%
吊	1939		6	27	0.004074%	641962	96.87%	20	8.10%
咕	1940		8	27	0.004074%	641989	96.87%	15	6.07%
哄	1941		9	27	0.004074%	642016	96.88%	20	8.10%
嘻	1942		15	27	0.004074%	642043	96.88%	11	4.45%
悔	1943		10	27	0.004074%	642070	96.89%	17	6.88%
慨	1944		12	27	0.004074%	642097	96.89%	23	9.31%
憐	1945		15	27	0.004074%	642124	96.90%	22	8.91%
拋	1946		8	27	0.004074%	642151	96.90%	23	9.31%
搓	1947		13	27	0.004074%	642178	96.90%	9	3.64%
殼	1948		12	27	0.004074%	642205	96.91%	16	6.48%
濫	1949		17	27	0.004074%	642232	96.91%	20	8.10%
瀉	1950		18	27	0.004074%	642259	96.92%	20	8.10%
炸	1951		9	27	0.004074%	642286	96.92%	18	7.29%
甩	1952		5	27	0.004074%	642313	96.92%	16	6.48%
笛	1953		11	27	0.004074%	642340	96.93%	14	5.67%
籃	1954		20	27	0.004074%	642367	96.93%	16	6.48%
綱	1955		14	27	0.004074%	642394	96.94%	13	5.26%
聰	1956		17	27	0.004074%	642421	96.94%	20	8.10%
衫	1957		8	27	0.004074%	642448	96.94%	15	6.07%
誦	1958		14	27	0.004074%	642475	96.95%	20	8.10%
輛	1959		15	27	0.004074%	642502	96.95%	19	7.69%
辱	1960		10	27	0.004074%	642529	96.96%	20	8.10%
郵	1961		11	27	0.004074%	642556	96.96%	14	5.67%
頑	1962		13	27	0.004074%	642583	96.96%	24	9.72%
馳	1963		13	27	0.004074%	642610	96.97%	18	7.29%
驢	1964		26	27	0.004074%	642637	96.97%	10	4.05%
倘	1965		10	26	0.003923%	642663	96.98%	22	8.91%
僵	1966		15	26	0.003923%	642689	96.98%	16	6.48%
勾	1967		4	26	0.003923%	642715	96.98%	19	7.69%
呂	1968		7	26	0.003923%	642741	96.99%	6	2.43%
坎	1969		7	26	0.003923%	642767	96.99%	19	7.69%
堪	1970		12	26	0.003923%	642793	97.00%	25	10.12%
娜	1971		10	26	0.003923%	642819	97.00%	7	2.83%
寓	1972		12	26	0.003923%	642845	97.00%	13	5.26%
尺	1973		4	26	0.003923%	642871	97.01%	18	7.29%
巷	1974		9	26	0.003923%	642897	97.01%	11	4.45%
巾	1975		3	26	0.003923%	642923	97.02%	16	6.48%
彼	1976		8	26	0.003923%	642949	97.02%	24	9.72%
愁	1977		13	26	0.003923%	642975	97.02%	20	8.10%
拆	1978		8	26	0.003923%	643001	97.03%	16	6.48%
捉	1979		10	26	0.003923%	643027	97.03%	20	8.10%
旨	1980		6	26	0.003923%	643053	97.04%	20	8.10%
柴	1981		10	26	0.003923%	643079	97.04%	20	8.10%
桿	1982		11	26	0.003923%	643105	97.04%	7	2.83%
椒	1983		12	26	0.003923%	643131	97.05%	9	3.64%
欄	1984		21	26	0.003923%	643157	97.05%	19	7.69%
泡	1985		8	26	0.003923%	643183	97.05%	21	8.50%
溶	1986		13	26	0.003923%	643209	97.06%	14	5.67%
漁	1987		14	26	0.003923%	643235	97.06%	18	7.29%
熬	1988		15	26	0.003923%	643261	97.07%	21	8.50%
疼	1989		10	26	0.003923%	643287	97.07%	19	7.69%
瞧	1990		17	26	0.003923%	643313	97.07%	15	6.07%
磚	1991		16	26	0.003923%	643339	97.08%	18	7.29%
禪	1992		16	26	0.003923%	643365	97.08%	3	1.22%
訊	1993		10	26	0.003923%	643391	97.09%	21	8.50%
診	1994		12	26	0.003923%	643417	97.09%	7	2.83%
誕	1995		15	26	0.003923%	643443	97.09%	23	9.31%
轟	1996		21	26	0.003923%	643469	97.10%	19	7.69%
醜	1997		17	26	0.003923%	643495	97.10%	16	6.48%
騾	1998		21	26	0.003923%	643521	97.11%	6	2.43%
齒	1999		15	26	0.003923%	643547	97.11%	23	9.31%
乳	2000		8	25	0.003772%	643572	97.11%	16	6.48%
凹	2001		5	25	0.003772%	643597	97.12%	10	4.05%
刮	2002		8	25	0.003772%	643622	97.12%	20	8.10%
哼	2003		10	25	0.003772%	643647	97.12%	16	6.48%
唇	2004		10	25	0.003772%	643672	97.13%	20	8.10%
坑	2005		7	25	0.003772%	643697	97.13%	17	6.88%
寞	2006		14	25	0.003772%	643722	97.14%	18	7.29%
嶺	2007		17	25	0.003772%	643747	97.14%	11	4.45%
弦	2008		8	25	0.003772%	643772	97.14%	19	7.69%
愚	2009		13	25	0.003772%	643797	97.15%	22	8.91%
挪	2010		10	25	0.003772%	643822	97.15%	18	7.29%
攀	2011		19	25	0.003772%	643847	97.16%	22	8.91%
曉	2012		16	25	0.003772%	643872	97.16%	19	7.69%
櫃	2013		18	25	0.003772%	643897	97.16%	17	6.88%
爽	2014		11	25	0.003772%	643922	97.17%	18	7.29%
禍	2015		13	25	0.003772%	643947	97.17%	24	9.72%
筒	2016		12	25	0.003772%	643972	97.17%	16	6.48%
縷	2017		17	25	0.003772%	643997	97.18%	16	6.48%
耶	2018		9	25	0.003772%	644022	97.18%	7	2.83%
腹	2019		13	25	0.003772%	644047	97.19%	20	8.10%
舌	2020		6	25	0.003772%	644072	97.19%	21	8.50%
芝	2021		8	25	0.003772%	644097	97.19%	11	4.45%
蔭	2022		15	25	0.003772%	644122	97.20%	20	8.10%
褲	2023		15	25	0.003772%	644147	97.20%	18	7.29%
襖	2024		18	25	0.003772%	644172	97.20%	6	2.43%
誇	2025		13	25	0.003772%	644197	97.21%	9	3.64%
闡	2026		20	25	0.003772%	644222	97.21%	20	8.10%
傢	2027		12	24	0.003622%	644246	97.22%	17	6.88%
冊	2028		5	24	0.003622%	644270	97.22%	15	6.07%
凋	2029		10	24	0.003622%	644294	97.22%	12	4.86%
卜	2030		2	24	0.003622%	644318	97.23%	7	2.83%
叮	2031		5	24	0.003622%	644342	97.23%	18	7.29%
哦	2032		10	24	0.003622%	644366	97.23%	17	6.88%
喧	2033		12	24	0.003622%	644390	97.24%	21	8.50%
嫂	2034		12	24	0.003622%	644414	97.24%	6	2.43%
峽	2035		10	24	0.003622%	644438	97.24%	17	6.88%
廊	2036		12	24	0.003622%	644462	97.25%	18	7.29%
彌	2037		17	24	0.003622%	644486	97.25%	20	8.10%
挽	2038		10	24	0.003622%	644510	97.26%	15	6.07%
攏	2039		19	24	0.003622%	644534	97.26%	19	7.69%
昂	2040		8	24	0.003622%	644558	97.26%	22	8.91%
柱	2041		9	24	0.003622%	644582	97.27%	21	8.50%
淋	2042		11	24	0.003622%	644606	97.27%	18	7.29%
熊	2043		14	24	0.003622%	644630	97.27%	12	4.86%
燦	2044		17	24	0.003622%	644654	97.28%	18	7.29%
犧	2045		21	24	0.003622%	644678	97.28%	21	8.50%
猜	2046		11	24	0.003622%	644702	97.28%	15	6.07%
琦	2047		12	24	0.003622%	644726	97.29%	1	0.40%
盒	2048		11	24	0.003622%	644750	97.29%	16	6.48%
盜	2049		12	24	0.003622%	644774	97.30%	12	4.86%
笨	2050		11	24	0.003622%	644798	97.30%	16	6.48%
紗	2051		10	24	0.003622%	644822	97.30%	17	6.88%
緯	2052		15	24	0.003622%	644846	97.31%	8	3.24%
翁	2053		10	24	0.003622%	644870	97.31%	7	2.83%
聘	2054		13	24	0.003622%	644894	97.31%	14	5.67%
肖	2055		7	24	0.003622%	644918	97.32%	10	4.05%
腔	2056		12	24	0.003622%	644942	97.32%	23	9.31%
蔗	2057		15	24	0.003622%	644966	97.32%	5	2.02%
蔥	2058		15	24	0.003622%	644990	97.33%	10	4.05%
袖	2059		10	24	0.003622%	645014	97.33%	20	8.10%
諧	2060		16	24	0.003622%	645038	97.33%	19	7.69%
賢	2061		15	24	0.003622%	645062	97.34%	16	6.48%
蹄	2062		16	24	0.003622%	645086	97.34%	15	6.07%
遮	2063		14	24	0.003622%	645110	97.35%	20	8.10%
闖	2064		18	24	0.003622%	645134	97.35%	16	6.48%
韻	2065		19	24	0.003622%	645158	97.35%	17	6.88%
驅	2066		21	24	0.003622%	645182	97.36%	22	8.91%
丘	2067		5	23	0.003471%	645205	97.36%	16	6.48%
后	2068		6	23	0.003471%	645228	97.36%	10	4.05%
喉	2069		12	23	0.003471%	645251	97.37%	20	8.10%
廂	2070		12	23	0.003471%	645274	97.37%	10	4.05%
彭	2071		12	23	0.003471%	645297	97.37%	8	3.24%
愉	2072		12	23	0.003471%	645320	97.38%	17	6.88%
押	2073		8	23	0.003471%	645343	97.38%	14	5.67%
捕	2074		10	23	0.003471%	645366	97.38%	19	7.69%
擋	2075		16	23	0.003471%	645389	97.39%	20	8.10%
械	2076		11	23	0.003471%	645412	97.39%	21	8.50%
淫	2077		11	23	0.003471%	645435	97.39%	8	3.24%
湊	2078		12	23	0.003471%	645458	97.40%	21	8.50%
漲	2079		14	23	0.003471%	645481	97.40%	20	8.10%
煥	2080		13	23	0.003471%	645504	97.41%	6	2.43%
糟	2081		17	23	0.003471%	645527	97.41%	20	8.10%
肝	2082		7	23	0.003471%	645550	97.41%	6	2.43%
脹	2083		12	23	0.003471%	645573	97.42%	17	6.88%
茂	2084		9	23	0.003471%	645596	97.42%	16	6.48%
蹤	2085		18	23	0.003471%	645619	97.42%	16	6.48%
鉆	2086		13	23	0.003471%	645642	97.43%	18	7.29%
鏈	2087		19	23	0.003471%	645665	97.43%	9	3.64%
僧	2088		14	22	0.00332%	645687	97.43%	9	3.64%
姨	2089		9	22	0.00332%	645709	97.44%	7	2.83%
寡	2090		14	22	0.00332%	645731	97.44%	17	6.88%
帆	2091		6	22	0.00332%	645753	97.44%	15	6.07%
庸	2092		11	22	0.00332%	645775	97.45%	17	6.88%
廈	2093		13	22	0.00332%	645797	97.45%	12	4.86%
憾	2094		16	22	0.00332%	645819	97.45%	16	6.48%
摔	2095		14	22	0.00332%	645841	97.46%	18	7.29%
敦	2096		12	22	0.00332%	645863	97.46%	14	5.67%
旺	2097		8	22	0.00332%	645885	97.46%	17	6.88%
晰	2098		12	22	0.00332%	645907	97.47%	19	7.69%
杆	2099		7	22	0.00332%	645929	97.47%	15	6.07%
樁	2100		15	22	0.00332%	645951	97.47%	6	2.43%
樑	2101		15	22	0.00332%	645973	97.48%	13	5.26%
毅	2102		15	22	0.00332%	645995	97.48%	15	6.07%
沾	2103		8	22	0.00332%	646017	97.48%	17	6.88%
浸	2104		10	22	0.00332%	646039	97.49%	20	8.10%
濁	2105		16	22	0.00332%	646061	97.49%	14	5.67%
瑪	2106		14	22	0.00332%	646083	97.49%	8	3.24%
疆	2107		19	22	0.00332%	646105	97.50%	13	5.26%
疊	2108		22	22	0.00332%	646127	97.50%	19	7.69%
眠	2109		10	22	0.00332%	646149	97.50%	15	6.07%
禿	2110		7	22	0.00332%	646171	97.51%	13	5.26%
罕	2111		7	22	0.00332%	646193	97.51%	14	5.67%
署	2112		13	22	0.00332%	646215	97.51%	13	5.26%
翅	2113		10	22	0.00332%	646237	97.52%	16	6.48%
膩	2114		16	22	0.00332%	646259	97.52%	15	6.07%
蓬	2115		15	22	0.00332%	646281	97.52%	16	6.48%
蘿	2116		23	22	0.00332%	646303	97.53%	9	3.64%
赴	2117		9	22	0.00332%	646325	97.53%	20	8.10%
郤	2118		9	22	0.00332%	646347	97.53%	12	4.86%
銳	2119		15	22	0.00332%	646369	97.54%	21	8.50%
閱	2120		15	22	0.00332%	646391	97.54%	18	7.29%
鵝	2121		18	22	0.00332%	646413	97.54%	15	6.07%
傣	2122		12	21	0.003169%	646434	97.55%	3	1.22%
傻	2123		13	21	0.003169%	646455	97.55%	19	7.69%
喻	2124		12	21	0.003169%	646476	97.55%	16	6.48%
嗒	2125		13	21	0.003169%	646497	97.56%	11	4.45%
壺	2126		12	21	0.003169%	646518	97.56%	8	3.24%
廉	2127		13	21	0.003169%	646539	97.56%	17	6.88%
廟	2128		15	21	0.003169%	646560	97.56%	15	6.07%
弗	2129		5	21	0.003169%	646581	97.57%	5	2.02%
役	2130		7	21	0.003169%	646602	97.57%	16	6.48%
懮	2131		18	21	0.003169%	646623	97.57%	15	6.07%
拳	2132		10	21	0.003169%	646644	97.58%	13	5.26%
梯	2133		11	21	0.003169%	646665	97.58%	13	5.26%
洒	2134		9	21	0.003169%	646686	97.58%	16	6.48%
獸	2135		19	21	0.003169%	646707	97.59%	13	5.26%
疏	2136		11	21	0.003169%	646728	97.59%	21	8.50%
缸	2137		9	21	0.003169%	646749	97.59%	9	3.64%
腫	2138		13	21	0.003169%	646770	97.60%	12	4.86%
膝	2139		15	21	0.003169%	646791	97.60%	16	6.48%
芳	2140		8	21	0.003169%	646812	97.60%	15	6.07%
芹	2141		8	21	0.003169%	646833	97.61%	3	1.22%
蘊	2142		20	21	0.003169%	646854	97.61%	16	6.48%
販	2143		11	21	0.003169%	646875	97.61%	11	4.45%
輔	2144		14	21	0.003169%	646896	97.62%	18	7.29%
逆	2145		9	21	0.003169%	646917	97.62%	13	5.26%
鈴	2146		13	21	0.003169%	646938	97.62%	15	6.07%
馮	2147		12	21	0.003169%	646959	97.62%	6	2.43%
魅	2148		15	21	0.003169%	646980	97.63%	16	6.48%
么	2149		3	20	0.003018%	647000	97.63%	6	2.43%
傅	2150		12	20	0.003018%	647020	97.63%	11	4.45%
咳	2151		9	20	0.003018%	647040	97.64%	10	4.05%
啪	2152		11	20	0.003018%	647060	97.64%	9	3.64%
啥	2153		11	20	0.003018%	647080	97.64%	12	4.86%
嘲	2154		15	20	0.003018%	647100	97.65%	19	7.69%
嘩	2155		15	20	0.003018%	647120	97.65%	11	4.45%
嘯	2156		15	20	0.003018%	647140	97.65%	17	6.88%
塌	2157		13	20	0.003018%	647160	97.66%	10	4.05%
岳	2158		8	20	0.003018%	647180	97.66%	7	2.83%
崗	2159		11	20	0.003018%	647200	97.66%	14	5.67%
憲	2160		16	20	0.003018%	647220	97.66%	10	4.05%
株	2161		10	20	0.003018%	647240	97.67%	14	5.67%
棚	2162		12	20	0.003018%	647260	97.67%	16	6.48%
淒	2163		11	20	0.003018%	647280	97.67%	15	6.07%
溢	2164		13	20	0.003018%	647300	97.68%	18	7.29%
漏	2165		14	20	0.003018%	647320	97.68%	19	7.69%
濛	2166		17	20	0.003018%	647340	97.68%	10	4.05%
灑	2167		22	20	0.003018%	647360	97.69%	13	5.26%
燕	2168		16	20	0.003018%	647380	97.69%	15	6.07%
狼	2169		10	20	0.003018%	647400	97.69%	14	5.67%
玫	2170		8	20	0.003018%	647420	97.69%	13	5.26%
畏	2171		9	20	0.003018%	647440	97.70%	20	8.10%
磁	2172		14	20	0.003018%	647460	97.70%	8	3.24%
碳	2173		14	20	0.003018%	647480	97.70%	4	1.62%
翠	2174		14	20	0.003018%	647500	97.71%	15	6.07%
膨	2175		16	20	0.003018%	647520	97.71%	15	6.07%
蔔	2176		15	20	0.003018%	647540	97.71%	7	2.83%
豈	2177		10	20	0.003018%	647560	97.72%	16	6.48%
賀	2178		12	20	0.003018%	647580	97.72%	14	5.67%
赫	2179		14	20	0.003018%	647600	97.72%	13	5.26%
輻	2180		16	20	0.003018%	647620	97.72%	7	2.83%
郊	2181		8	20	0.003018%	647640	97.73%	18	7.29%
酵	2182		14	20	0.003018%	647660	97.73%	3	1.22%
頸	2183		16	20	0.003018%	647680	97.73%	14	5.67%
魄	2184		15	20	0.003018%	647700	97.74%	18	7.29%
俄	2185		9	19	0.002867%	647719	97.74%	6	2.43%
倉	2186		10	19	0.002867%	647738	97.74%	11	4.45%
催	2187		13	19	0.002867%	647757	97.75%	15	6.07%
咖	2188		8	19	0.002867%	647776	97.75%	11	4.45%
啡	2189		11	19	0.002867%	647795	97.75%	11	4.45%
嘟	2190		13	19	0.002867%	647814	97.75%	7	2.83%
嚷	2191		20	19	0.002867%	647833	97.76%	12	4.86%
堯	2192		12	19	0.002867%	647852	97.76%	4	1.62%
宴	2193		10	19	0.002867%	647871	97.76%	10	4.05%
寸	2194		3	19	0.002867%	647890	97.77%	16	6.48%
屍	2195		9	19	0.002867%	647909	97.77%	13	5.26%
峻	2196		10	19	0.002867%	647928	97.77%	16	6.48%
嶄	2197		14	19	0.002867%	647947	97.77%	14	5.67%
彤	2198		7	19	0.002867%	647966	97.78%	3	1.22%
拐	2199		8	19	0.002867%	647985	97.78%	13	5.26%
拴	2200		9	19	0.002867%	648004	97.78%	9	3.64%
敘	2201		11	19	0.002867%	648023	97.79%	16	6.48%
斌	2202		12	19	0.002867%	648042	97.79%	4	1.62%
朽	2203		6	19	0.002867%	648061	97.79%	16	6.48%
杉	2204		7	19	0.002867%	648080	97.79%	10	4.05%
桓	2205		10	19	0.002867%	648099	97.80%	2	0.81%
櫥	2206		19	19	0.002867%	648118	97.80%	13	5.26%
淘	2207		11	19	0.002867%	648137	97.80%	8	3.24%
漆	2208		14	19	0.002867%	648156	97.81%	17	6.88%
爪	2209		4	19	0.002867%	648175	97.81%	8	3.24%
獄	2210		14	19	0.002867%	648194	97.81%	13	5.26%
痴	2211		13	19	0.002867%	648213	97.81%	13	5.26%
瞪	2212		17	19	0.002867%	648232	97.82%	16	6.48%
穌	2213		16	19	0.002867%	648251	97.82%	1	0.40%
竊	2214		23	19	0.002867%	648270	97.82%	14	5.67%
筐	2215		12	19	0.002867%	648289	97.83%	5	2.02%
筷	2216		13	19	0.002867%	648308	97.83%	8	3.24%
肢	2217		8	19	0.002867%	648327	97.83%	12	4.86%
腑	2218		12	19	0.002867%	648346	97.83%	9	3.64%
蔓	2219		15	19	0.002867%	648365	97.84%	11	4.45%
藤	2220		19	19	0.002867%	648384	97.84%	13	5.26%
虞	2221		13	19	0.002867%	648403	97.84%	7	2.83%
蟹	2222		19	19	0.002867%	648422	97.85%	4	1.62%
諒	2223		15	19	0.002867%	648441	97.85%	12	4.86%
諮	2224		16	19	0.002867%	648460	97.85%	5	2.02%
貓	2225		16	19	0.002867%	648479	97.85%	13	5.26%
遂	2226		12	19	0.002867%	648498	97.86%	17	6.88%
陡	2227		9	19	0.002867%	648517	97.86%	13	5.26%
饑	2228		20	19	0.002867%	648536	97.86%	16	6.48%
騷	2229		20	19	0.002867%	648555	97.87%	12	4.86%
凍	2230		10	18	0.002716%	648573	97.87%	13	5.26%
哇	2231		9	18	0.002716%	648591	97.87%	10	4.05%
咽	2232		9	18	0.002716%	648609	97.87%	14	5.67%
啞	2233		11	18	0.002716%	648627	97.88%	13	5.26%
垮	2234		9	18	0.002716%	648645	97.88%	12	4.86%
娟	2235		10	18	0.002716%	648663	97.88%	5	2.02%
嫌	2236		13	18	0.002716%	648681	97.88%	16	6.48%
宙	2237		8	18	0.002716%	648699	97.89%	14	5.67%
幢	2238		15	18	0.002716%	648717	97.89%	11	4.45%
愧	2239		13	18	0.002716%	648735	97.89%	14	5.67%
抄	2240		7	18	0.002716%	648753	97.90%	12	4.86%
拒	2241		8	18	0.002716%	648771	97.90%	14	5.67%
捏	2242		10	18	0.002716%	648789	97.90%	12	4.86%
撰	2243		15	18	0.002716%	648807	97.90%	15	6.07%
攔	2244		20	18	0.002716%	648825	97.91%	13	5.26%
暈	2245		13	18	0.002716%	648843	97.91%	16	6.48%
朦	2246		18	18	0.002716%	648861	97.91%	13	5.26%
柏	2247		9	18	0.002716%	648879	97.91%	16	6.48%
汪	2248		7	18	0.002716%	648897	97.92%	11	4.45%
泊	2249		8	18	0.002716%	648915	97.92%	17	6.88%
湳	2250		12	18	0.002716%	648933	97.92%	5	2.02%
滔	2251		13	18	0.002716%	648951	97.93%	9	3.64%
瀟	2252		19	18	0.002716%	648969	97.93%	14	5.67%
炒	2253		8	18	0.002716%	648987	97.93%	10	4.05%
煌	2254		13	18	0.002716%	649005	97.93%	17	6.88%
矚	2255		26	18	0.002716%	649023	97.94%	14	5.67%
糕	2256		16	18	0.002716%	649041	97.94%	15	6.07%
艾	2257		6	18	0.002716%	649059	97.94%	8	3.24%
芒	2258		7	18	0.002716%	649077	97.94%	17	6.88%
蚊	2259		10	18	0.002716%	649095	97.95%	7	2.83%
蜜	2260		14	18	0.002716%	649113	97.95%	14	5.67%
螞	2261		16	18	0.002716%	649131	97.95%	9	3.64%
諾	2262		16	18	0.002716%	649149	97.96%	10	4.05%
豎	2263		15	18	0.002716%	649167	97.96%	15	6.07%
贈	2264		19	18	0.002716%	649185	97.96%	15	6.07%
跌	2265		12	18	0.002716%	649203	97.96%	16	6.48%
邪	2266		6	18	0.002716%	649221	97.97%	14	5.67%
鄧	2267		14	18	0.002716%	649239	97.97%	8	3.24%
陌	2268		8	18	0.002716%	649257	97.97%	14	5.67%
駱	2269		16	18	0.002716%	649275	97.97%	11	4.45%
鷹	2270		24	18	0.002716%	649293	97.98%	14	5.67%
麵	2271		20	18	0.002716%	649311	97.98%	14	5.67%
唸	2272		11	17	0.002565%	649328	97.98%	6	2.43%
嗚	2273		13	17	0.002565%	649345	97.98%	10	4.05%
嚼	2274		20	17	0.002565%	649362	97.99%	12	4.86%
奠	2275		12	17	0.002565%	649379	97.99%	14	5.67%
奸	2276		6	17	0.002565%	649396	97.99%	13	5.26%
嬌	2277		15	17	0.002565%	649413	98.00%	12	4.86%
嬰	2278		17	17	0.002565%	649430	98.00%	13	5.26%
屏	2279		9	17	0.002565%	649447	98.00%	14	5.67%
帘	2280		8	17	0.002565%	649464	98.00%	11	4.45%
廷	2281		7	17	0.002565%	649481	98.01%	8	3.24%
彪	2282		11	17	0.002565%	649498	98.01%	7	2.83%
挨	2283		10	17	0.002565%	649515	98.01%	15	6.07%
掀	2284		11	17	0.002565%	649532	98.01%	15	6.07%
搜	2285		12	17	0.002565%	649549	98.02%	15	6.07%
攪	2286		23	17	0.002565%	649566	98.02%	12	4.86%
斧	2287		8	17	0.002565%	649583	98.02%	8	3.24%
晒	2288		10	17	0.002565%	649600	98.02%	9	3.64%
晴	2289		12	17	0.002565%	649617	98.03%	14	5.67%
暑	2290		12	17	0.002565%	649634	98.03%	15	6.07%
曼	2291		11	17	0.002565%	649651	98.03%	14	5.67%
柯	2292		9	17	0.002565%	649668	98.03%	8	3.24%
桶	2293		11	17	0.002565%	649685	98.04%	11	4.45%
欒	2294		23	17	0.002565%	649702	98.04%	3	1.22%
欺	2295		12	17	0.002565%	649719	98.04%	13	5.26%
毯	2296		12	17	0.002565%	649736	98.04%	10	4.05%
泣	2297		8	17	0.002565%	649753	98.05%	11	4.45%
淹	2298		11	17	0.002565%	649770	98.05%	16	6.48%
溜	2299		13	17	0.002565%	649787	98.05%	9	3.64%
灶	2300		7	17	0.002565%	649804	98.05%	12	4.86%
瓊	2301		19	17	0.002565%	649821	98.06%	7	2.83%
盧	2302		16	17	0.002565%	649838	98.06%	9	3.64%
眷	2303		11	17	0.002565%	649855	98.06%	6	2.43%
穎	2304		16	17	0.002565%	649872	98.06%	11	4.45%
竭	2305		14	17	0.002565%	649889	98.07%	14	5.67%
紐	2306		10	17	0.002565%	649906	98.07%	10	4.05%
絮	2307		12	17	0.002565%	649923	98.07%	14	5.67%
芽	2308		8	17	0.002565%	649940	98.07%	13	5.26%
蒸	2309		14	17	0.002565%	649957	98.08%	11	4.45%
蠻	2310		25	17	0.002565%	649974	98.08%	15	6.07%
覓	2311		11	17	0.002565%	649991	98.08%	15	6.07%
謙	2312		17	17	0.002565%	650008	98.08%	16	6.48%
賺	2313		17	17	0.002565%	650025	98.09%	13	5.26%
躁	2314		20	17	0.002565%	650042	98.09%	16	6.48%
閨	2315		14	17	0.002565%	650059	98.09%	13	5.26%
饒	2316		20	17	0.002565%	650076	98.10%	15	6.07%
騙	2317		19	17	0.002565%	650093	98.10%	14	5.67%
鵬	2318		19	17	0.002565%	650110	98.10%	8	3.24%
傑	2319		12	16	0.002414%	650126	98.10%	14	5.67%
僻	2320		15	16	0.002414%	650142	98.11%	15	6.07%
劍	2321		15	16	0.002414%	650158	98.11%	12	4.86%
劫	2322		7	16	0.002414%	650174	98.11%	13	5.26%
卓	2323		8	16	0.002414%	650190	98.11%	14	5.67%
吻	2324		7	16	0.002414%	650206	98.11%	9	3.64%
咧	2325		9	16	0.002414%	650222	98.12%	11	4.45%
哮	2326		10	16	0.002414%	650238	98.12%	6	2.43%
噬	2327		16	16	0.002414%	650254	98.12%	4	1.62%
坷	2328		8	16	0.002414%	650270	98.12%	14	5.67%
堵	2329		11	16	0.002414%	650286	98.13%	12	4.86%
墾	2330		16	16	0.002414%	650302	98.13%	10	4.05%
嬴	2331		16	16	0.002414%	650318	98.13%	11	4.45%
宅	2332		6	16	0.002414%	650334	98.13%	13	5.26%
尿	2333		7	16	0.002414%	650350	98.14%	12	4.86%
屑	2334		10	16	0.002414%	650366	98.14%	12	4.86%
岡	2335		8	16	0.002414%	650382	98.14%	5	2.02%
崖	2336		11	16	0.002414%	650398	98.14%	14	5.67%
帕	2337		8	16	0.002414%	650414	98.15%	9	3.64%
弊	2338		14	16	0.002414%	650430	98.15%	13	5.26%
懼	2339		21	16	0.002414%	650446	98.15%	14	5.67%
扛	2340		6	16	0.002414%	650462	98.15%	12	4.86%
挫	2341		10	16	0.002414%	650478	98.16%	15	6.07%
梢	2342		11	16	0.002414%	650494	98.16%	8	3.24%
棍	2343		12	16	0.002414%	650510	98.16%	15	6.07%
歇	2344		13	16	0.002414%	650526	98.16%	15	6.07%
渣	2345		12	16	0.002414%	650542	98.17%	4	1.62%
澆	2346		15	16	0.002414%	650558	98.17%	14	5.67%
燥	2347		17	16	0.002414%	650574	98.17%	13	5.26%
甸	2348		7	16	0.002414%	650590	98.17%	8	3.24%
睹	2349		13	16	0.002414%	650606	98.18%	14	5.67%
矽	2350		8	16	0.002414%	650622	98.18%	1	0.40%
砂	2351		9	16	0.002414%	650638	98.18%	12	4.86%
芬	2352		8	16	0.002414%	650654	98.18%	10	4.05%
茅	2353		9	16	0.002414%	650670	98.18%	14	5.67%
董	2354		13	16	0.002414%	650686	98.19%	6	2.43%
虹	2355		9	16	0.002414%	650702	98.19%	8	3.24%
蝶	2356		15	16	0.002414%	650718	98.19%	9	3.64%
袁	2357		10	16	0.002414%	650734	98.19%	6	2.43%
蹦	2358		18	16	0.002414%	650750	98.20%	10	4.05%
週	2359		11	16	0.002414%	650766	98.20%	7	2.83%
逾	2360		12	16	0.002414%	650782	98.20%	12	4.86%
釀	2361		24	16	0.002414%	650798	98.20%	10	4.05%
餃	2362		14	16	0.002414%	650814	98.21%	6	2.43%
餓	2363		15	16	0.002414%	650830	98.21%	14	5.67%
駝	2364		15	16	0.002414%	650846	98.21%	12	4.86%
驕	2365		22	16	0.002414%	650862	98.21%	14	5.67%
驟	2366		24	16	0.002414%	650878	98.22%	16	6.48%
鬍	2367		19	16	0.002414%	650894	98.22%	13	5.26%
俯	2368		10	15	0.002263%	650909	98.22%	12	4.86%
劈	2369		15	15	0.002263%	650924	98.22%	11	4.45%
卵	2370		7	15	0.002263%	650939	98.23%	9	3.64%
吁	2371		6	15	0.002263%	650954	98.23%	11	4.45%
咒	2372		8	15	0.002263%	650969	98.23%	14	5.67%
嘰	2373		15	15	0.002263%	650984	98.23%	8	3.24%
噹	2374		16	15	0.002263%	650999	98.23%	9	3.64%
嚓	2375		17	15	0.002263%	651014	98.24%	7	2.83%
囑	2376		24	15	0.002263%	651029	98.24%	15	6.07%
坊	2377		7	15	0.002263%	651044	98.24%	11	4.45%
堤	2378		12	15	0.002263%	651059	98.24%	9	3.64%
堡	2379		12	15	0.002263%	651074	98.25%	10	4.05%
塘	2380		13	15	0.002263%	651089	98.25%	12	4.86%
墩	2381		15	15	0.002263%	651104	98.25%	9	3.64%
妨	2382		7	15	0.002263%	651119	98.25%	14	5.67%
婉	2383		11	15	0.002263%	651134	98.25%	13	5.26%
孝	2384		7	15	0.002263%	651149	98.26%	7	2.83%
崩	2385		11	15	0.002263%	651164	98.26%	13	5.26%
巡	2386		7	15	0.002263%	651179	98.26%	14	5.67%
憎	2387		15	15	0.002263%	651194	98.26%	11	4.45%
懶	2388		19	15	0.002263%	651209	98.27%	14	5.67%
拘	2389		8	15	0.002263%	651224	98.27%	13	5.26%
拎	2390		8	15	0.002263%	651239	98.27%	10	4.05%
捨	2391		11	15	0.002263%	651254	98.27%	13	5.26%
撕	2392		15	15	0.002263%	651269	98.28%	14	5.67%
擱	2393		17	15	0.002263%	651284	98.28%	12	4.86%
曠	2394		19	15	0.002263%	651299	98.28%	12	4.86%
杏	2395		7	15	0.002263%	651314	98.28%	10	4.05%
栽	2396		10	15	0.002263%	651329	98.28%	15	6.07%
棋	2397		12	15	0.002263%	651344	98.29%	9	3.64%
楓	2398		13	15	0.002263%	651359	98.29%	4	1.62%
涯	2399		11	15	0.002263%	651374	98.29%	13	5.26%
淪	2400		11	15	0.002263%	651389	98.29%	12	4.86%
滯	2401		14	15	0.002263%	651404	98.30%	13	5.26%
漿	2402		15	15	0.002263%	651419	98.30%	13	5.26%
澄	2403		15	15	0.002263%	651434	98.30%	12	4.86%
澀	2404		17	15	0.002263%	651449	98.30%	13	5.26%
瀑	2405		18	15	0.002263%	651464	98.30%	6	2.43%
烘	2406		10	15	0.002263%	651479	98.31%	10	4.05%
畔	2407		10	15	0.002263%	651494	98.31%	12	4.86%
稚	2408		13	15	0.002263%	651509	98.31%	12	4.86%
絨	2409		12	15	0.002263%	651524	98.31%	13	5.26%
羞	2410		11	15	0.002263%	651539	98.32%	10	4.05%
耿	2411		10	15	0.002263%	651554	98.32%	5	2.02%
胎	2412		9	15	0.002263%	651569	98.32%	14	5.67%
膊	2413		14	15	0.002263%	651584	98.32%	12	4.86%
芙	2414		8	15	0.002263%	651599	98.32%	3	1.22%
蓉	2415		14	15	0.002263%	651614	98.33%	3	1.22%
襯	2416		21	15	0.002263%	651629	98.33%	9	3.64%
豫	2417		16	15	0.002263%	651644	98.33%	14	5.67%
貪	2418		11	15	0.002263%	651659	98.33%	14	5.67%
踩	2419		15	15	0.002263%	651674	98.34%	13	5.26%
蹟	2420		18	15	0.002263%	651689	98.34%	6	2.43%
蹲	2421		19	15	0.002263%	651704	98.34%	11	4.45%
逗	2422		10	15	0.002263%	651719	98.34%	13	5.26%
鄂	2423		11	15	0.002263%	651734	98.35%	5	2.02%
醋	2424		15	15	0.002263%	651749	98.35%	5	2.02%
銜	2425		14	15	0.002263%	651764	98.35%	12	4.86%
餅	2426		14	15	0.002263%	651779	98.35%	9	3.64%
鴻	2427		17	15	0.002263%	651794	98.35%	6	2.43%
佩	2428		8	14	0.002113%	651808	98.36%	12	4.86%
俊	2429		9	14	0.002113%	651822	98.36%	12	4.86%
倦	2430		10	14	0.002113%	651836	98.36%	13	5.26%
倚	2431		10	14	0.002113%	651850	98.36%	13	5.26%
勉	2432		9	14	0.002113%	651864	98.36%	13	5.26%
哉	2433		9	14	0.002113%	651878	98.37%	11	4.45%
哩	2434		10	14	0.002113%	651892	98.37%	10	4.05%
囂	2435		21	14	0.002113%	651906	98.37%	12	4.86%
墊	2436		14	14	0.002113%	651920	98.37%	12	4.86%
奈	2437		8	14	0.002113%	651934	98.38%	13	5.26%
妮	2438		8	14	0.002113%	651948	98.38%	3	1.22%
婛	2439		11	14	0.002113%	651962	98.38%	1	0.40%
岭	2440		8	14	0.002113%	651976	98.38%	8	3.24%
廁	2441		12	14	0.002113%	651990	98.38%	7	2.83%
忌	2442		7	14	0.002113%	652004	98.39%	11	4.45%
恍	2443		9	14	0.002113%	652018	98.39%	11	4.45%
恭	2444		10	14	0.002113%	652032	98.39%	11	4.45%
悼	2445		11	14	0.002113%	652046	98.39%	9	3.64%
惹	2446		13	14	0.002113%	652060	98.39%	13	5.26%
戒	2447		7	14	0.002113%	652074	98.40%	9	3.64%
拂	2448		8	14	0.002113%	652088	98.40%	12	4.86%
捲	2449		11	14	0.002113%	652102	98.40%	11	4.45%
昧	2450		9	14	0.002113%	652116	98.40%	13	5.26%
朧	2451		20	14	0.002113%	652130	98.41%	12	4.86%
枚	2452		8	14	0.002113%	652144	98.41%	11	4.45%
氓	2453		8	14	0.002113%	652158	98.41%	7	2.83%
沌	2454		7	14	0.002113%	652172	98.41%	9	3.64%
沸	2455		8	14	0.002113%	652186	98.41%	12	4.86%
湛	2456		12	14	0.002113%	652200	98.42%	7	2.83%
滄	2457		13	14	0.002113%	652214	98.42%	12	4.86%
煞	2458		13	14	0.002113%	652228	98.42%	12	4.86%
琢	2459		12	14	0.002113%	652242	98.42%	12	4.86%
瑰	2460		14	14	0.002113%	652256	98.42%	12	4.86%
瘤	2461		15	14	0.002113%	652270	98.43%	3	1.22%
盞	2462		13	14	0.002113%	652284	98.43%	11	4.45%
瞎	2463		15	14	0.002113%	652298	98.43%	13	5.26%
砸	2464		10	14	0.002113%	652312	98.43%	13	5.26%
竿	2465		9	14	0.002113%	652326	98.43%	7	2.83%
筋	2466		12	14	0.002113%	652340	98.44%	13	5.26%
綽	2467		14	14	0.002113%	652354	98.44%	8	3.24%
綴	2468		14	14	0.002113%	652368	98.44%	11	4.45%
綢	2469		14	14	0.002113%	652382	98.44%	11	4.45%
締	2470		15	14	0.002113%	652396	98.45%	2	0.81%
胖	2471		9	14	0.002113%	652410	98.45%	10	4.05%
舟	2472		6	14	0.002113%	652424	98.45%	8	3.24%
葛	2473		13	14	0.002113%	652438	98.45%	8	3.24%
蜂	2474		13	14	0.002113%	652452	98.45%	11	4.45%
螂	2475		15	14	0.002113%	652466	98.46%	2	0.81%
螃	2476		16	14	0.002113%	652480	98.46%	2	0.81%
蟬	2477		18	14	0.002113%	652494	98.46%	5	2.02%
迴	2478		9	14	0.002113%	652508	98.46%	12	4.86%
遣	2479		13	14	0.002113%	652522	98.46%	7	2.83%
邦	2480		6	14	0.002113%	652536	98.47%	12	4.86%
鑄	2481		22	14	0.002113%	652550	98.47%	12	4.86%
閣	2482		14	14	0.002113%	652564	98.47%	9	3.64%
韌	2483		12	14	0.002113%	652578	98.47%	12	4.86%
鴿	2484		17	14	0.002113%	652592	98.47%	7	2.83%
鼠	2485		13	14	0.002113%	652606	98.48%	8	3.24%
乙	2486		1	13	0.001962%	652619	98.48%	6	2.43%
傍	2487		12	13	0.001962%	652632	98.48%	12	4.86%
凸	2488		5	13	0.001962%	652645	98.48%	10	4.05%
卑	2489		8	13	0.001962%	652658	98.48%	12	4.86%
占	2490		5	13	0.001962%	652671	98.49%	9	3.64%
叨	2491		5	13	0.001962%	652684	98.49%	12	4.86%
吭	2492		7	13	0.001962%	652697	98.49%	9	3.64%
吟	2493		7	13	0.001962%	652710	98.49%	11	4.45%
咯	2494		9	13	0.001962%	652723	98.49%	7	2.83%
啼	2495		12	13	0.001962%	652736	98.50%	11	4.45%
喃	2496		12	13	0.001962%	652749	98.50%	7	2.83%
囚	2497		5	13	0.001962%	652762	98.50%	6	2.43%
埃	2498		10	13	0.001962%	652775	98.50%	7	2.83%
妄	2499		6	13	0.001962%	652788	98.50%	13	5.26%
寨	2500		14	13	0.001962%	652801	98.51%	11	4.45%
崔	2501		11	13	0.001962%	652814	98.51%	2	0.81%
巒	2502		22	13	0.001962%	652827	98.51%	7	2.83%
廚	2503		15	13	0.001962%	652840	98.51%	11	4.45%
徊	2504		9	13	0.001962%	652853	98.51%	10	4.05%
悵	2505		11	13	0.001962%	652866	98.52%	11	4.45%
揀	2506		12	13	0.001962%	652879	98.52%	10	4.05%
揉	2507		12	13	0.001962%	652892	98.52%	11	4.45%
撐	2508		15	13	0.001962%	652905	98.52%	11	4.45%
擬	2509		17	13	0.001962%	652918	98.52%	12	4.86%
暮	2510		15	13	0.001962%	652931	98.53%	9	3.64%
曰	2511		4	13	0.001962%	652944	98.53%	10	4.05%
汕	2512		6	13	0.001962%	652957	98.53%	4	1.62%
汰	2513		7	13	0.001962%	652970	98.53%	3	1.22%
沼	2514		8	13	0.001962%	652983	98.53%	10	4.05%
洶	2515		9	13	0.001962%	652996	98.54%	10	4.05%
浙	2516		10	13	0.001962%	653009	98.54%	8	3.24%
濺	2517		18	13	0.001962%	653022	98.54%	12	4.86%
炊	2518		8	13	0.001962%	653035	98.54%	9	3.64%
炯	2519		9	13	0.001962%	653048	98.54%	7	2.83%
烽	2520		11	13	0.001962%	653061	98.55%	5	2.02%
犁	2521		11	13	0.001962%	653074	98.55%	6	2.43%
祀	2522		7	13	0.001962%	653087	98.55%	5	2.02%
粘	2523		11	13	0.001962%	653100	98.55%	7	2.83%
粹	2524		14	13	0.001962%	653113	98.55%	12	4.86%
聾	2525		22	13	0.001962%	653126	98.56%	8	3.24%
胳	2526		10	13	0.001962%	653139	98.56%	10	4.05%
腥	2527		13	13	0.001962%	653152	98.56%	7	2.83%
臘	2528		19	13	0.001962%	653165	98.56%	10	4.05%
臺	2529		14	13	0.001962%	653178	98.56%	6	2.43%
蔡	2530		15	13	0.001962%	653191	98.57%	5	2.02%
襲	2531		22	13	0.001962%	653204	98.57%	13	5.26%
訝	2532		11	13	0.001962%	653217	98.57%	11	4.45%
謹	2533		18	13	0.001962%	653230	98.57%	11	4.45%
趴	2534		9	13	0.001962%	653243	98.57%	10	4.05%
軀	2535		18	13	0.001962%	653256	98.57%	12	4.86%
輿	2536		17	13	0.001962%	653269	98.58%	10	4.05%
闢	2537		21	13	0.001962%	653282	98.58%	11	4.45%
陋	2538		8	13	0.001962%	653295	98.58%	13	5.26%
頃	2539		11	13	0.001962%	653308	98.58%	10	4.05%
頒	2540		13	13	0.001962%	653321	98.58%	12	4.86%
饋	2541		20	13	0.001962%	653334	98.59%	9	3.64%
駁	2542		14	13	0.001962%	653347	98.59%	11	4.45%
鬱	2543		29	13	0.001962%	653360	98.59%	11	4.45%
鼎	2544		13	13	0.001962%	653373	98.59%	8	3.24%
龐	2545		19	13	0.001962%	653386	98.59%	11	4.45%
仗	2546		5	12	0.001811%	653398	98.60%	11	4.45%
兜	2547		11	12	0.001811%	653410	98.60%	7	2.83%
凌	2548		10	12	0.001811%	653422	98.60%	11	4.45%
凜	2549		15	12	0.001811%	653434	98.60%	9	3.64%
凶	2550		4	12	0.001811%	653446	98.60%	10	4.05%
剎	2551		9	12	0.001811%	653458	98.61%	9	3.64%
匙	2552		11	12	0.001811%	653470	98.61%	11	4.45%
吶	2553		7	12	0.001811%	653482	98.61%	10	4.05%
啤	2554		11	12	0.001811%	653494	98.61%	9	3.64%
喳	2555		12	12	0.001811%	653506	98.61%	4	1.62%
嗦	2556		13	12	0.001811%	653518	98.61%	8	3.24%
嗽	2557		14	12	0.001811%	653530	98.62%	6	2.43%
嘶	2558		15	12	0.001811%	653542	98.62%	7	2.83%
嚨	2559		20	12	0.001811%	653554	98.62%	11	4.45%
垃	2560		8	12	0.001811%	653566	98.62%	10	4.05%
娥	2561		10	12	0.001811%	653578	98.62%	4	1.62%
媒	2562		12	12	0.001811%	653590	98.63%	9	3.64%
宵	2563		10	12	0.001811%	653602	98.63%	11	4.45%
履	2564		15	12	0.001811%	653614	98.63%	10	4.05%
峭	2565		10	12	0.001811%	653626	98.63%	8	3.24%
御	2566		11	12	0.001811%	653638	98.63%	7	2.83%
怖	2567		8	12	0.001811%	653650	98.63%	9	3.64%
恥	2568		10	12	0.001811%	653662	98.64%	8	3.24%
懲	2569		19	12	0.001811%	653674	98.64%	11	4.45%
戈	2570		4	12	0.001811%	653686	98.64%	10	4.05%
扒	2571		5	12	0.001811%	653698	98.64%	10	4.05%
捂	2572		10	12	0.001811%	653710	98.64%	11	4.45%
掠	2573		11	12	0.001811%	653722	98.65%	12	4.86%
捷	2574		11	12	0.001811%	653734	98.65%	12	4.86%
揣	2575		12	12	0.001811%	653746	98.65%	11	4.45%
撓	2576		15	12	0.001811%	653758	98.65%	12	4.86%
杖	2577		7	12	0.001811%	653770	98.65%	5	2.02%
棺	2578		12	12	0.001811%	653782	98.65%	6	2.43%
樞	2579		15	12	0.001811%	653794	98.66%	8	3.24%
殿	2580		13	12	0.001811%	653806	98.66%	11	4.45%
洼	2581		9	12	0.001811%	653818	98.66%	8	3.24%
淑	2582		11	12	0.001811%	653830	98.66%	8	3.24%
潘	2583		15	12	0.001811%	653842	98.66%	5	2.02%
澱	2584		16	12	0.001811%	653854	98.67%	9	3.64%
煮	2585		12	12	0.001811%	653866	98.67%	11	4.45%
瑣	2586		14	12	0.001811%	653878	98.67%	12	4.86%
瓣	2587		19	12	0.001811%	653890	98.67%	12	4.86%
癱	2588		24	12	0.001811%	653902	98.67%	8	3.24%
盟	2589		13	12	0.001811%	653914	98.67%	9	3.64%
矩	2590		10	12	0.001811%	653926	98.68%	9	3.64%
碩	2591		14	12	0.001811%	653938	98.68%	11	4.45%
禽	2592		13	12	0.001811%	653950	98.68%	10	4.05%
糞	2593		17	12	0.001811%	653962	98.68%	9	3.64%
罐	2594		24	12	0.001811%	653974	98.68%	8	3.24%
翩	2595		15	12	0.001811%	653986	98.69%	9	3.64%
腕	2596		12	12	0.001811%	653998	98.69%	7	2.83%
舅	2597		13	12	0.001811%	654010	98.69%	9	3.64%
蛇	2598		11	12	0.001811%	654022	98.69%	7	2.83%
裳	2599		14	12	0.001811%	654034	98.69%	11	4.45%
賭	2600		15	12	0.001811%	654046	98.69%	10	4.05%
趁	2601		12	12	0.001811%	654058	98.70%	11	4.45%
跪	2602		13	12	0.001811%	654070	98.70%	11	4.45%
踢	2603		15	12	0.001811%	654082	98.70%	9	3.64%
逸	2604		11	12	0.001811%	654094	98.70%	12	4.86%
醬	2605		18	12	0.001811%	654106	98.70%	5	2.02%
銘	2606		14	12	0.001811%	654118	98.70%	9	3.64%
駕	2607		15	12	0.001811%	654130	98.71%	11	4.45%
乞	2608		3	11	0.00166%	654141	98.71%	10	4.05%
兇	2609		6	11	0.00166%	654152	98.71%	8	3.24%
兌	2610		7	11	0.00166%	654163	98.71%	9	3.64%
兔	2611		8	11	0.00166%	654174	98.71%	8	3.24%
兮	2612		4	11	0.00166%	654185	98.72%	8	3.24%
剔	2613		10	11	0.00166%	654196	98.72%	10	4.05%
吼	2614		7	11	0.00166%	654207	98.72%	10	4.05%
咨	2615		9	11	0.00166%	654218	98.72%	6	2.43%
哨	2616		10	11	0.00166%	654229	98.72%	9	3.64%
囊	2617		22	11	0.00166%	654240	98.72%	10	4.05%
圾	2618		7	11	0.00166%	654251	98.73%	9	3.64%
夥	2619		14	11	0.00166%	654262	98.73%	7	2.83%
姜	2620		9	11	0.00166%	654273	98.73%	7	2.83%
媚	2621		12	11	0.00166%	654284	98.73%	9	3.64%
媳	2622		13	11	0.00166%	654295	98.73%	9	3.64%
宛	2623		8	11	0.00166%	654306	98.73%	9	3.64%
尬	2624		7	11	0.00166%	654317	98.74%	11	4.45%
尷	2625		17	11	0.00166%	654328	98.74%	11	4.45%
屠	2626		11	11	0.00166%	654339	98.74%	9	3.64%
幌	2627		13	11	0.00166%	654350	98.74%	1	0.40%
彰	2628		14	11	0.00166%	654361	98.74%	8	3.24%
徘	2629		11	11	0.00166%	654372	98.74%	8	3.24%
憊	2630		16	11	0.00166%	654383	98.74%	7	2.83%
捆	2631		10	11	0.00166%	654394	98.75%	10	4.05%
揪	2632		12	11	0.00166%	654405	98.75%	8	3.24%
摟	2633		14	11	0.00166%	654416	98.75%	9	3.64%
摯	2634		15	11	0.00166%	654427	98.75%	9	3.64%
敝	2635		11	11	0.00166%	654438	98.75%	10	4.05%
昔	2636		8	11	0.00166%	654449	98.75%	11	4.45%
晝	2637		11	11	0.00166%	654460	98.76%	9	3.64%
枕	2638		8	11	0.00166%	654471	98.76%	9	3.64%
柿	2639		9	11	0.00166%	654482	98.76%	8	3.24%
桔	2640		10	11	0.00166%	654493	98.76%	9	3.64%
棒	2641		12	11	0.00166%	654504	98.76%	9	3.64%
榨	2642		14	11	0.00166%	654515	98.76%	9	3.64%
榥	2643		14	11	0.00166%	654526	98.77%	6	2.43%
沫	2644		8	11	0.00166%	654537	98.77%	9	3.64%
泄	2645		8	11	0.00166%	654548	98.77%	9	3.64%
淌	2646		11	11	0.00166%	654559	98.77%	10	4.05%
淤	2647		11	11	0.00166%	654570	98.77%	6	2.43%
漓	2648		14	11	0.00166%	654581	98.77%	9	3.64%
澇	2649		15	11	0.00166%	654592	98.78%	6	2.43%
烤	2650		10	11	0.00166%	654603	98.78%	7	2.83%
熙	2651		14	11	0.00166%	654614	98.78%	7	2.83%
熏	2652		14	11	0.00166%	654625	98.78%	7	2.83%
燙	2653		16	11	0.00166%	654636	98.78%	10	4.05%
爍	2654		19	11	0.00166%	654647	98.78%	8	3.24%
琅	2655		11	11	0.00166%	654658	98.79%	5	2.02%
盔	2656		11	11	0.00166%	654669	98.79%	3	1.22%
眺	2657		11	11	0.00166%	654680	98.79%	9	3.64%
瞥	2658		16	11	0.00166%	654691	98.79%	8	3.24%
矗	2659		24	11	0.00166%	654702	98.79%	8	3.24%
碟	2660		14	11	0.00166%	654713	98.79%	7	2.83%
秒	2661		9	11	0.00166%	654724	98.80%	7	2.83%
竄	2662		18	11	0.00166%	654735	98.80%	10	4.05%
筍	2663		12	11	0.00166%	654746	98.80%	7	2.83%
苟	2664		9	11	0.00166%	654757	98.80%	9	3.64%
萎	2665		12	11	0.00166%	654768	98.80%	10	4.05%
蔽	2666		15	11	0.00166%	654779	98.80%	10	4.05%
薛	2667		17	11	0.00166%	654790	98.81%	4	1.62%
藉	2668		18	11	0.00166%	654801	98.81%	10	4.05%
薦	2669		18	11	0.00166%	654812	98.81%	8	3.24%
蘆	2670		20	11	0.00166%	654823	98.81%	8	3.24%
誓	2671		14	11	0.00166%	654834	98.81%	10	4.05%
謊	2672		17	11	0.00166%	654845	98.81%	8	3.24%
貶	2673		12	11	0.00166%	654856	98.82%	9	3.64%
賊	2674		13	11	0.00166%	654867	98.82%	8	3.24%
贏	2675		20	11	0.00166%	654878	98.82%	10	4.05%
軒	2676		10	11	0.00166%	654889	98.82%	9	3.64%
迄	2677		6	11	0.00166%	654900	98.82%	11	4.45%
逛	2678		10	11	0.00166%	654911	98.82%	9	3.64%
酥	2679		12	11	0.00166%	654922	98.83%	7	2.83%
酬	2680		13	11	0.00166%	654933	98.83%	10	4.05%
霸	2681		21	11	0.00166%	654944	98.83%	8	3.24%
飼	2682		13	11	0.00166%	654955	98.83%	6	2.43%
驀	2683		21	11	0.00166%	654966	98.83%	10	4.05%
丫	2684		3	10	0.001509%	654976	98.83%	8	3.24%
傘	2685		12	10	0.001509%	654986	98.84%	8	3.24%
僱	2686		14	10	0.001509%	654996	98.84%	7	2.83%
儉	2687		15	10	0.001509%	655006	98.84%	8	3.24%
冉	2688		5	10	0.001509%	655016	98.84%	4	1.62%
厘	2689		9	10	0.001509%	655026	98.84%	6	2.43%
叛	2690		9	10	0.001509%	655036	98.84%	5	2.02%
叭	2691		5	10	0.001509%	655046	98.85%	5	2.02%
哆	2692		9	10	0.001509%	655056	98.85%	7	2.83%
唉	2693		10	10	0.001509%	655066	98.85%	8	3.24%
嚕	2694		18	10	0.001509%	655076	98.85%	6	2.43%
墮	2695		15	10	0.001509%	655086	98.85%	9	3.64%
壘	2696		18	10	0.001509%	655096	98.85%	9	3.64%
嫉	2697		13	10	0.001509%	655106	98.85%	8	3.24%
屢	2698		14	10	0.001509%	655116	98.86%	8	3.24%
崛	2699		11	10	0.001509%	655126	98.86%	10	4.05%
幔	2700		14	10	0.001509%	655136	98.86%	6	2.43%
幟	2701		15	10	0.001509%	655146	98.86%	9	3.64%
彬	2702		11	10	0.001509%	655156	98.86%	5	2.02%
恒	2703		9	10	0.001509%	655166	98.86%	6	2.43%
惟	2704		11	10	0.001509%	655176	98.86%	7	2.83%
扁	2705		9	10	0.001509%	655186	98.87%	7	2.83%
撇	2706		14	10	0.001509%	655196	98.87%	6	2.43%
撤	2707		14	10	0.001509%	655206	98.87%	7	2.83%
攘	2708		20	10	0.001509%	655216	98.87%	6	2.43%
攜	2709		21	10	0.001509%	655226	98.87%	10	4.05%
旬	2710		6	10	0.001509%	655236	98.87%	9	3.64%
旳	2711		7	10	0.001509%	655246	98.88%	10	4.05%
杭	2712		8	10	0.001509%	655256	98.88%	7	2.83%
梭	2713		11	10	0.001509%	655266	98.88%	8	3.24%
榜	2714		14	10	0.001509%	655276	98.88%	8	3.24%
檐	2715		17	10	0.001509%	655286	98.88%	10	4.05%
淵	2716		11	10	0.001509%	655296	98.88%	10	4.05%
渺	2717		12	10	0.001509%	655306	98.88%	10	4.05%
瀰	2718		20	10	0.001509%	655316	98.89%	7	2.83%
熄	2719		14	10	0.001509%	655326	98.89%	8	3.24%
獵	2720		18	10	0.001509%	655336	98.89%	9	3.64%
瑩	2721		15	10	0.001509%	655346	98.89%	8	3.24%
眨	2722		10	10	0.001509%	655356	98.89%	7	2.83%
眶	2723		11	10	0.001509%	655366	98.89%	10	4.05%
碌	2724		13	10	0.001509%	655376	98.89%	8	3.24%
祇	2725		8	10	0.001509%	655386	98.90%	4	1.62%
禾	2726		5	10	0.001509%	655396	98.90%	6	2.43%
窟	2727		13	10	0.001509%	655406	98.90%	8	3.24%
簌	2728		17	10	0.001509%	655416	98.90%	5	2.02%
糙	2729		17	10	0.001509%	655426	98.90%	8	3.24%
絢	2730		12	10	0.001509%	655436	98.90%	10	4.05%
繡	2731		18	10	0.001509%	655446	98.91%	8	3.24%
翔	2732		12	10	0.001509%	655456	98.91%	9	3.64%
耍	2733		9	10	0.001509%	655466	98.91%	9	3.64%
肘	2734		7	10	0.001509%	655476	98.91%	7	2.83%
菲	2735		12	10	0.001509%	655486	98.91%	6	2.43%
虔	2736		10	10	0.001509%	655496	98.91%	9	3.64%
蜓	2737		13	10	0.001509%	655506	98.91%	1	0.40%
蜻	2738		14	10	0.001509%	655516	98.92%	1	0.40%
蝦	2739		15	10	0.001509%	655526	98.92%	6	2.43%
蟥	2740		18	10	0.001509%	655536	98.92%	3	1.22%
訣	2741		11	10	0.001509%	655546	98.92%	8	3.24%
諭	2742		16	10	0.001509%	655556	98.92%	2	0.81%
謠	2743		17	10	0.001509%	655566	98.92%	8	3.24%
譏	2744		19	10	0.001509%	655576	98.93%	6	2.43%
趟	2745		15	10	0.001509%	655586	98.93%	9	3.64%
跋	2746		12	10	0.001509%	655596	98.93%	8	3.24%
郭	2747		10	10	0.001509%	655606	98.93%	10	4.05%
鄙	2748		13	10	0.001509%	655616	98.93%	9	3.64%
酣	2749		12	10	0.001509%	655626	98.93%	9	3.64%
閩	2750		14	10	0.001509%	655636	98.93%	7	2.83%
陵	2751		10	10	0.001509%	655646	98.94%	10	4.05%
隙	2752		13	10	0.001509%	655656	98.94%	9	3.64%
雍	2753		13	10	0.001509%	655666	98.94%	5	2.02%
馱	2754		13	10	0.001509%	655676	98.94%	6	2.43%
駐	2755		15	10	0.001509%	655686	98.94%	9	3.64%
魏	2756		18	10	0.001509%	655696	98.94%	6	2.43%
黏	2757		17	10	0.001509%	655706	98.94%	6	2.43%
仕	2758		5	9	0.001358%	655715	98.95%	3	1.22%
侃	2759		8	9	0.001358%	655724	98.95%	6	2.43%
兆	2760		6	9	0.001358%	655733	98.95%	8	3.24%
勺	2761		3	9	0.001358%	655742	98.95%	6	2.43%
叩	2762		5	9	0.001358%	655751	98.95%	8	3.24%
吏	2763		6	9	0.001358%	655760	98.95%	7	2.83%
吱	2764		7	9	0.001358%	655769	98.95%	5	2.02%
咐	2765		8	9	0.001358%	655778	98.96%	9	3.64%
哺	2766		10	9	0.001358%	655787	98.96%	7	2.83%
哧	2767		10	9	0.001358%	655796	98.96%	5	2.02%
喂	2768		12	9	0.001358%	655805	98.96%	7	2.83%
喇	2769		12	9	0.001358%	655814	98.96%	7	2.83%
喲	2770		12	9	0.001358%	655823	98.96%	9	3.64%
嗯	2771		13	9	0.001358%	655832	98.96%	8	3.24%
嘎	2772		14	9	0.001358%	655841	98.96%	3	1.22%
噩	2773		16	9	0.001358%	655850	98.97%	6	2.43%
姊	2774		8	9	0.001358%	655859	98.97%	7	2.83%
寥	2775		14	9	0.001358%	655868	98.97%	5	2.02%
寵	2776		19	9	0.001358%	655877	98.97%	9	3.64%
巢	2777		11	9	0.001358%	655886	98.97%	9	3.64%
巿	2778		4	9	0.001358%	655895	98.97%	4	1.62%
廓	2779		14	9	0.001358%	655904	98.97%	9	3.64%
怯	2780		8	9	0.001358%	655913	98.98%	5	2.02%
恆	2781		9	9	0.001358%	655922	98.98%	8	3.24%
恬	2782		9	9	0.001358%	655931	98.98%	8	3.24%
憋	2783		15	9	0.001358%	655940	98.98%	8	3.24%
懺	2784		20	9	0.001358%	655949	98.98%	6	2.43%
拙	2785		8	9	0.001358%	655958	98.98%	9	3.64%
挾	2786		10	9	0.001358%	655967	98.98%	9	3.64%
摧	2787		14	9	0.001358%	655976	98.99%	9	3.64%
撿	2788		16	9	0.001358%	655985	98.99%	9	3.64%
昇	2789		8	9	0.001358%	655994	98.99%	6	2.43%
梳	2790		10	9	0.001358%	656003	98.99%	8	3.24%
棲	2791		12	9	0.001358%	656012	98.99%	6	2.43%
檬	2792		18	9	0.001358%	656021	98.99%	3	1.22%
檸	2793		18	9	0.001358%	656030	98.99%	3	1.22%
沅	2794		7	9	0.001358%	656039	98.99%	2	0.81%
溯	2795		13	9	0.001358%	656048	99.00%	7	2.83%
漾	2796		14	9	0.001358%	656057	99.00%	7	2.83%
炕	2797		8	9	0.001358%	656066	99.00%	5	2.02%
焉	2798		11	9	0.001358%	656075	99.00%	6	2.43%
熔	2799		14	9	0.001358%	656084	99.00%	3	1.22%
玲	2800		9	9	0.001358%	656093	99.00%	6	2.43%
瑟	2801		13	9	0.001358%	656102	99.00%	6	2.43%
畸	2802		13	9	0.001358%	656111	99.01%	7	2.83%
瘓	2803		14	9	0.001358%	656120	99.01%	5	2.02%
癮	2804		22	9	0.001358%	656129	99.01%	8	3.24%
眯	2805		11	9	0.001358%	656138	99.01%	6	2.43%
矣	2806		7	9	0.001358%	656147	99.01%	8	3.24%
祈	2807		8	9	0.001358%	656156	99.01%	7	2.83%
稼	2808		15	9	0.001358%	656165	99.01%	8	3.24%
穗	2809		17	9	0.001358%	656174	99.02%	8	3.24%
箭	2810		15	9	0.001358%	656183	99.02%	6	2.43%
簇	2811		17	9	0.001358%	656192	99.02%	6	2.43%
篷	2812		17	9	0.001358%	656201	99.02%	4	1.62%
緲	2813		15	9	0.001358%	656210	99.02%	8	3.24%
縹	2814		17	9	0.001358%	656219	99.02%	8	3.24%
纜	2815		27	9	0.001358%	656228	99.02%	2	0.81%
翹	2816		18	9	0.001358%	656237	99.02%	9	3.64%
苔	2817		9	9	0.001358%	656246	99.03%	7	2.83%
荐	2818		10	9	0.001358%	656255	99.03%	9	3.64%
菊	2819		12	9	0.001358%	656264	99.03%	8	3.24%
蔚	2820		15	9	0.001358%	656273	99.03%	7	2.83%
蔑	2821		15	9	0.001358%	656282	99.03%	7	2.83%
蚌	2822		10	9	0.001358%	656291	99.03%	5	2.02%
蝴	2823		15	9	0.001358%	656300	99.03%	6	2.43%
蟻	2824		19	9	0.001358%	656309	99.04%	4	1.62%
衍	2825		9	9	0.001358%	656318	99.04%	3	1.22%
託	2826		10	9	0.001358%	656327	99.04%	5	2.02%
誼	2827		15	9	0.001358%	656336	99.04%	5	2.02%
謬	2828		18	9	0.001358%	656345	99.04%	9	3.64%
賬	2829		15	9	0.001358%	656354	99.04%	6	2.43%
遏	2830		12	9	0.001358%	656363	99.04%	8	3.24%
鈔	2831		12	9	0.001358%	656372	99.05%	5	2.02%
錮	2832		16	9	0.001358%	656381	99.05%	2	0.81%
鑰	2833		25	9	0.001358%	656390	99.05%	9	3.64%
陝	2834		9	9	0.001358%	656399	99.05%	9	3.64%
隘	2835		12	9	0.001358%	656408	99.05%	7	2.83%
雇	2836		12	9	0.001358%	656417	99.05%	6	2.43%
雛	2837		18	9	0.001358%	656426	99.05%	7	2.83%
骯	2838		14	9	0.001358%	656435	99.05%	8	3.24%
鹼	2839		24	9	0.001358%	656444	99.06%	5	2.02%
麓	2840		19	9	0.001358%	656453	99.06%	3	1.22%
黝	2841		17	9	0.001358%	656462	99.06%	5	2.02%
亢	2842		4	8	0.001207%	656470	99.06%	8	3.24%
侍	2843		8	8	0.001207%	656478	99.06%	7	2.83%
冤	2844		10	8	0.001207%	656486	99.06%	7	2.83%
刃	2845		3	8	0.001207%	656494	99.06%	6	2.43%
划	2846		6	8	0.001207%	656502	99.06%	6	2.43%
匪	2847		10	8	0.001207%	656510	99.07%	7	2.83%
卸	2848		8	8	0.001207%	656518	99.07%	7	2.83%
卿	2849		10	8	0.001207%	656526	99.07%	7	2.83%
嘹	2850		15	8	0.001207%	656534	99.07%	5	2.02%
埔	2851		10	8	0.001207%	656542	99.07%	2	0.81%
埠	2852		11	8	0.001207%	656550	99.07%	4	1.62%
埸	2853		11	8	0.001207%	656558	99.07%	7	2.83%
妃	2854		6	8	0.001207%	656566	99.07%	3	1.22%
孜	2855		7	8	0.001207%	656574	99.08%	5	2.02%
寇	2856		11	8	0.001207%	656582	99.08%	4	1.62%
崽	2857		12	8	0.001207%	656590	99.08%	4	1.62%
忡	2858		7	8	0.001207%	656598	99.08%	4	1.62%
愣	2859		12	8	0.001207%	656606	99.08%	7	2.83%
慾	2860		15	8	0.001207%	656614	99.08%	4	1.62%
憨	2861		16	8	0.001207%	656622	99.08%	7	2.83%
扼	2862		7	8	0.001207%	656630	99.08%	8	3.24%
拯	2863		9	8	0.001207%	656638	99.09%	6	2.43%
捎	2864		10	8	0.001207%	656646	99.09%	4	1.62%
揍	2865		12	8	0.001207%	656654	99.09%	5	2.02%
撮	2866		15	8	0.001207%	656662	99.09%	7	2.83%
擭	2867		17	8	0.001207%	656670	99.09%	5	2.02%
斟	2868		13	8	0.001207%	656678	99.09%	6	2.43%
旱	2869		7	8	0.001207%	656686	99.09%	8	3.24%
昭	2870		9	8	0.001207%	656694	99.09%	7	2.83%
晦	2871		11	8	0.001207%	656702	99.09%	7	2.83%
曳	2872		6	8	0.001207%	656710	99.10%	7	2.83%
柜	2873		9	8	0.001207%	656718	99.10%	3	1.22%
棘	2874		12	8	0.001207%	656726	99.10%	7	2.83%
槿	2875		15	8	0.001207%	656734	99.10%	1	0.40%
汨	2876		7	8	0.001207%	656742	99.10%	4	1.62%
洽	2877		9	8	0.001207%	656750	99.10%	7	2.83%
淀	2878		11	8	0.001207%	656758	99.10%	7	2.83%
澈	2879		14	8	0.001207%	656766	99.10%	7	2.83%
漉	2880		14	8	0.001207%	656774	99.11%	4	1.62%
瀾	2881		20	8	0.001207%	656782	99.11%	6	2.43%
牢	2882		7	8	0.001207%	656790	99.11%	8	3.24%
犬	2883		4	8	0.001207%	656798	99.11%	6	2.43%
猴	2884		12	8	0.001207%	656806	99.11%	6	2.43%
玡	2885		8	8	0.001207%	656814	99.11%	2	0.81%
疙	2886		8	8	0.001207%	656822	99.11%	6	2.43%
睬	2887		13	8	0.001207%	656830	99.11%	8	3.24%
瞭	2888		17	8	0.001207%	656838	99.12%	7	2.83%
硯	2889		12	8	0.001207%	656846	99.12%	2	0.81%
确	2890		12	8	0.001207%	656854	99.12%	3	1.22%
稽	2891		15	8	0.001207%	656862	99.12%	7	2.83%
笙	2892		11	8	0.001207%	656870	99.12%	4	1.62%
箋	2893		14	8	0.001207%	656878	99.12%	6	2.43%
篩	2894		16	8	0.001207%	656886	99.12%	7	2.83%
簍	2895		17	8	0.001207%	656894	99.12%	5	2.02%
簾	2896		19	8	0.001207%	656902	99.13%	6	2.43%
粥	2897		12	8	0.001207%	656910	99.13%	6	2.43%
糜	2898		17	8	0.001207%	656918	99.13%	6	2.43%
綁	2899		13	8	0.001207%	656926	99.13%	5	2.02%
緻	2900		15	8	0.001207%	656934	99.13%	7	2.83%
緬	2901		15	8	0.001207%	656942	99.13%	3	1.22%
縛	2902		16	8	0.001207%	656950	99.13%	8	3.24%
繃	2903		17	8	0.001207%	656958	99.13%	7	2.83%
耘	2904		10	8	0.001207%	656966	99.13%	8	3.24%
肇	2905		14	8	0.001207%	656974	99.14%	4	1.62%
腮	2906		13	8	0.001207%	656982	99.14%	7	2.83%
舔	2907		14	8	0.001207%	656990	99.14%	5	2.02%
荊	2908		10	8	0.001207%	656998	99.14%	7	2.83%
莽	2909		11	8	0.001207%	657006	99.14%	6	2.43%
薪	2910		17	8	0.001207%	657014	99.14%	6	2.43%
薰	2911		18	8	0.001207%	657022	99.14%	6	2.43%
藻	2912		20	8	0.001207%	657030	99.14%	5	2.02%
蛙	2913		12	8	0.001207%	657038	99.15%	5	2.02%
裊	2914		13	8	0.001207%	657046	99.15%	4	1.62%
襟	2915		18	8	0.001207%	657054	99.15%	7	2.83%
詐	2916		12	8	0.001207%	657062	99.15%	8	3.24%
詫	2917		13	8	0.001207%	657070	99.15%	7	2.83%
諱	2918		16	8	0.001207%	657078	99.15%	7	2.83%
謎	2919		17	8	0.001207%	657086	99.15%	5	2.02%
謐	2920		17	8	0.001207%	657094	99.15%	8	3.24%
賃	2921		13	8	0.001207%	657102	99.16%	6	2.43%
賤	2922		15	8	0.001207%	657110	99.16%	5	2.02%
賜	2923		15	8	0.001207%	657118	99.16%	7	2.83%
逮	2924		11	8	0.001207%	657126	99.16%	8	3.24%
鏟	2925		19	8	0.001207%	657134	99.16%	7	2.83%
閒	2926		12	8	0.001207%	657142	99.16%	7	2.83%
陀	2927		7	8	0.001207%	657150	99.16%	4	1.62%
雁	2928		12	8	0.001207%	657158	99.16%	6	2.43%
餵	2929		17	8	0.001207%	657166	99.16%	6	2.43%
髓	2930		23	8	0.001207%	657174	99.17%	5	2.02%
鴉	2931		15	8	0.001207%	657182	99.17%	7	2.83%
黛	2932		17	8	0.001207%	657190	99.17%	5	2.02%
佐	2933		7	7	0.001056%	657197	99.17%	6	2.43%
冀	2934		16	7	0.001056%	657204	99.17%	6	2.43%
冥	2935		10	7	0.001056%	657211	99.17%	4	1.62%
冽	2936		8	7	0.001056%	657218	99.17%	4	1.62%
凱	2937		12	7	0.001056%	657225	99.17%	6	2.43%
凳	2938		14	7	0.001056%	657232	99.17%	7	2.83%
卉	2939		5	7	0.001056%	657239	99.18%	7	2.83%
呻	2940		8	7	0.001056%	657246	99.18%	7	2.83%
呱	2941		8	7	0.001056%	657253	99.18%	3	1.22%
咚	2942		8	7	0.001056%	657260	99.18%	5	2.02%
啄	2943		11	7	0.001056%	657267	99.18%	5	2.02%
啃	2944		11	7	0.001056%	657274	99.18%	5	2.02%
嘿	2945		15	7	0.001056%	657281	99.18%	5	2.02%
坪	2946		8	7	0.001056%	657288	99.18%	4	1.62%
垢	2947		9	7	0.001056%	657295	99.18%	6	2.43%
墅	2948		14	7	0.001056%	657302	99.19%	6	2.43%
墻	2949		16	7	0.001056%	657309	99.19%	4	1.62%
壟	2950		19	7	0.001056%	657316	99.19%	5	2.02%
奕	2951		9	7	0.001056%	657323	99.19%	5	2.02%
奎	2952		9	7	0.001056%	657330	99.19%	3	1.22%
妒	2953		7	7	0.001056%	657337	99.19%	5	2.02%
妓	2954		7	7	0.001056%	657344	99.19%	7	2.83%
娛	2955		10	7	0.001056%	657351	99.19%	7	2.83%
嫡	2956		14	7	0.001056%	657358	99.19%	1	0.40%
峙	2957		9	7	0.001056%	657365	99.19%	7	2.83%
巔	2958		22	7	0.001056%	657372	99.20%	6	2.43%
惆	2959		11	7	0.001056%	657379	99.20%	7	2.83%
慈	2960		13	7	0.001056%	657386	99.20%	7	2.83%
愷	2961		13	7	0.001056%	657393	99.20%	2	0.81%
戳	2962		18	7	0.001056%	657400	99.20%	6	2.43%
拌	2963		8	7	0.001056%	657407	99.20%	5	2.02%
拽	2964		9	7	0.001056%	657414	99.20%	7	2.83%
拱	2965		9	7	0.001056%	657421	99.20%	6	2.43%
掂	2966		11	7	0.001056%	657428	99.20%	4	1.62%
掐	2967		11	7	0.001056%	657435	99.21%	4	1.62%
摹	2968		15	7	0.001056%	657442	99.21%	6	2.43%
撈	2969		15	7	0.001056%	657449	99.21%	7	2.83%
撅	2970		15	7	0.001056%	657456	99.21%	7	2.83%
擅	2971		16	7	0.001056%	657463	99.21%	7	2.83%
撼	2972		16	7	0.001056%	657470	99.21%	7	2.83%
擰	2973		17	7	0.001056%	657477	99.21%	7	2.83%
攬	2974		24	7	0.001056%	657484	99.21%	7	2.83%
敊	2975		10	7	0.001056%	657491	99.21%	5	2.02%
斂	2976		17	7	0.001056%	657498	99.22%	6	2.43%
斬	2977		11	7	0.001056%	657505	99.22%	7	2.83%
柵	2978		9	7	0.001056%	657512	99.22%	6	2.43%
柄	2979		9	7	0.001056%	657519	99.22%	5	2.02%
桐	2980		10	7	0.001056%	657526	99.22%	7	2.83%
棗	2981		12	7	0.001056%	657533	99.22%	6	2.43%
楠	2982		13	7	0.001056%	657540	99.22%	5	2.02%
椰	2983		13	7	0.001056%	657547	99.22%	6	2.43%
榻	2984		14	7	0.001056%	657554	99.22%	6	2.43%
欽	2985		12	7	0.001056%	657561	99.22%	7	2.83%
歉	2986		14	7	0.001056%	657568	99.23%	7	2.83%
殷	2987		10	7	0.001056%	657575	99.23%	7	2.83%
氨	2988		10	7	0.001056%	657582	99.23%	3	1.22%
汛	2989		6	7	0.001056%	657589	99.23%	1	0.40%
涕	2990		10	7	0.001056%	657596	99.23%	7	2.83%
湘	2991		12	7	0.001056%	657603	99.23%	4	1.62%
潰	2992		15	7	0.001056%	657610	99.23%	5	2.02%
濾	2993		18	7	0.001056%	657617	99.23%	6	2.43%
瀚	2994		19	7	0.001056%	657624	99.23%	6	2.43%
烯	2995		11	7	0.001056%	657631	99.24%	1	0.40%
煦	2996		13	7	0.001056%	657638	99.24%	6	2.43%
狐	2997		8	7	0.001056%	657645	99.24%	4	1.62%
狡	2998		9	7	0.001056%	657652	99.24%	6	2.43%
瘩	2999		15	7	0.001056%	657659	99.24%	5	2.02%
癢	3000		20	7	0.001056%	657666	99.24%	6	2.43%
睦	3001		13	7	0.001056%	657673	99.24%	5	2.02%
瞄	3002		14	7	0.001056%	657680	99.24%	6	2.43%
瞌	3003		15	7	0.001056%	657687	99.24%	2	0.81%
瞻	3004		18	7	0.001056%	657694	99.24%	6	2.43%
砌	3005		9	7	0.001056%	657701	99.25%	7	2.83%
磕	3006		15	7	0.001056%	657708	99.25%	6	2.43%
磷	3007		17	7	0.001056%	657715	99.25%	4	1.62%
礫	3008		20	7	0.001056%	657722	99.25%	6	2.43%
秉	3009		8	7	0.001056%	657729	99.25%	5	2.02%
籽	3010		9	7	0.001056%	657736	99.25%	5	2.02%
紮	3011		11	7	0.001056%	657743	99.25%	5	2.02%
縈	3012		16	7	0.001056%	657750	99.25%	6	2.43%
繚	3013		18	7	0.001056%	657757	99.25%	6	2.43%
聶	3014		18	7	0.001056%	657764	99.26%	3	1.22%
肆	3015		13	7	0.001056%	657771	99.26%	6	2.43%
肴	3016		8	7	0.001056%	657778	99.26%	5	2.02%
肪	3017		8	7	0.001056%	657785	99.26%	3	1.22%
脯	3018		11	7	0.001056%	657792	99.26%	6	2.43%
膳	3019		16	7	0.001056%	657799	99.26%	5	2.02%
茵	3020		10	7	0.001056%	657806	99.26%	3	1.22%
菩	3021		12	7	0.001056%	657813	99.26%	7	2.83%
蕉	3022		16	7	0.001056%	657820	99.26%	4	1.62%
蚰	3023		11	7	0.001056%	657827	99.26%	1	0.40%
蟑	3024		17	7	0.001056%	657834	99.27%	1	0.40%
蠕	3025		20	7	0.001056%	657841	99.27%	6	2.43%
袍	3026		10	7	0.001056%	657848	99.27%	6	2.43%
襪	3027		20	7	0.001056%	657855	99.27%	6	2.43%
諦	3028		16	7	0.001056%	657862	99.27%	6	2.43%
謫	3029		18	7	0.001056%	657869	99.27%	3	1.22%
賄	3030		13	7	0.001056%	657876	99.27%	4	1.62%
趾	3031		11	7	0.001056%	657883	99.27%	5	2.02%
軋	3032		8	7	0.001056%	657890	99.27%	5	2.02%
軼	3033		12	7	0.001056%	657897	99.28%	5	2.02%
遁	3034		12	7	0.001056%	657904	99.28%	7	2.83%
邃	3035		17	7	0.001056%	657911	99.28%	6	2.43%
醇	3036		15	7	0.001056%	657918	99.28%	6	2.43%
鋁	3037		15	7	0.001056%	657925	99.28%	5	2.02%
鍾	3038		17	7	0.001056%	657932	99.28%	6	2.43%
鑼	3039		27	7	0.001056%	657939	99.28%	7	2.83%
霍	3040		16	7	0.001056%	657946	99.28%	6	2.43%
霽	3041		22	7	0.001056%	657953	99.28%	5	2.02%
霾	3042		22	7	0.001056%	657960	99.28%	7	2.83%
靄	3043		24	7	0.001056%	657967	99.29%	7	2.83%
餡	3044		16	7	0.001056%	657974	99.29%	6	2.43%
馨	3045		20	7	0.001056%	657981	99.29%	7	2.83%
髦	3046		14	7	0.001056%	657988	99.29%	5	2.02%
鬃	3047		18	7	0.001056%	657995	99.29%	6	2.43%
鶚	3048		20	7	0.001056%	658002	99.29%	1	0.40%
丑	3049		4	6	0.0009054%	658008	99.29%	5	2.02%
佑	3050		7	6	0.0009054%	658014	99.29%	5	2.02%
佼	3051		8	6	0.0009054%	658020	99.29%	3	1.22%
侄	3052		8	6	0.0009054%	658026	99.29%	3	1.22%
偵	3053		11	6	0.0009054%	658032	99.30%	4	1.62%
傭	3054		13	6	0.0009054%	658038	99.30%	3	1.22%
僕	3055		14	6	0.0009054%	658044	99.30%	4	1.62%
剁	3056		8	6	0.0009054%	658050	99.30%	3	1.22%
剃	3057		9	6	0.0009054%	658056	99.30%	6	2.43%
勘	3058		11	6	0.0009054%	658062	99.30%	4	1.62%
匿	3059		11	6	0.0009054%	658068	99.30%	6	2.43%
吆	3060		6	6	0.0009054%	658074	99.30%	6	2.43%
唧	3061		10	6	0.0009054%	658080	99.30%	3	1.22%
嘀	3062		14	6	0.0009054%	658086	99.30%	4	1.62%
囉	3063		22	6	0.0009054%	658092	99.30%	4	1.62%
垠	3064		9	6	0.0009054%	658098	99.31%	4	1.62%
墜	3065		15	6	0.0009054%	658104	99.31%	6	2.43%
壑	3066		17	6	0.0009054%	658110	99.31%	6	2.43%
奢	3067		11	6	0.0009054%	658116	99.31%	5	2.02%
娓	3068		10	6	0.0009054%	658122	99.31%	3	1.22%
嫦	3069		14	6	0.0009054%	658128	99.31%	3	1.22%
宰	3070		10	6	0.0009054%	658134	99.31%	6	2.43%
寢	3071		14	6	0.0009054%	658140	99.31%	5	2.02%
屜	3072		11	6	0.0009054%	658146	99.31%	4	1.62%
嵌	3073		12	6	0.0009054%	658152	99.31%	6	2.43%
庶	3074		11	6	0.0009054%	658158	99.31%	3	1.22%
廬	3075		19	6	0.0009054%	658164	99.32%	5	2.02%
徉	3076		9	6	0.0009054%	658170	99.32%	6	2.43%
徜	3077		11	6	0.0009054%	658176	99.32%	6	2.43%
忱	3078		7	6	0.0009054%	658182	99.32%	6	2.43%
怦	3079		8	6	0.0009054%	658188	99.32%	3	1.22%
怹	3080		9	6	0.0009054%	658194	99.32%	6	2.43%
惘	3081		11	6	0.0009054%	658200	99.32%	6	2.43%
惰	3082		12	6	0.0009054%	658206	99.32%	6	2.43%
慷	3083		14	6	0.0009054%	658212	99.32%	5	2.02%
懈	3084		16	6	0.0009054%	658218	99.32%	6	2.43%
抿	3085		8	6	0.0009054%	658224	99.32%	5	2.02%
拚	3086		8	6	0.0009054%	658230	99.33%	6	2.43%
搗	3087		13	6	0.0009054%	658236	99.33%	6	2.43%
摺	3088		14	6	0.0009054%	658242	99.33%	4	1.62%
擎	3089		17	6	0.0009054%	658248	99.33%	6	2.43%
敞	3090		12	6	0.0009054%	658254	99.33%	6	2.43%
曆	3091		16	6	0.0009054%	658260	99.33%	6	2.43%
朴	3092		6	6	0.0009054%	658266	99.33%	5	2.02%
杠	3093		7	6	0.0009054%	658272	99.33%	5	2.02%
栩	3094		10	6	0.0009054%	658278	99.33%	3	1.22%
梧	3095		11	6	0.0009054%	658284	99.33%	6	2.43%
椎	3096		12	6	0.0009054%	658290	99.33%	2	0.81%
棱	3097		12	6	0.0009054%	658296	99.34%	4	1.62%
槐	3098		14	6	0.0009054%	658302	99.34%	5	2.02%
沱	3099		8	6	0.0009054%	658308	99.34%	4	1.62%
洩	3100		9	6	0.0009054%	658314	99.34%	5	2.02%
涌	3101		10	6	0.0009054%	658320	99.34%	4	1.62%
淳	3102		11	6	0.0009054%	658326	99.34%	5	2.02%
渦	3103		12	6	0.0009054%	658332	99.34%	5	2.02%
滬	3104		14	6	0.0009054%	658338	99.34%	4	1.62%
濘	3105		17	6	0.0009054%	658344	99.34%	6	2.43%
炙	3106		8	6	0.0009054%	658350	99.34%	6	2.43%
炫	3107		9	6	0.0009054%	658356	99.34%	6	2.43%
燭	3108		17	6	0.0009054%	658362	99.35%	6	2.43%
玄	3109		5	6	0.0009054%	658368	99.35%	6	2.43%
珊	3110		9	6	0.0009054%	658374	99.35%	3	1.22%
琳	3111		12	6	0.0009054%	658380	99.35%	6	2.43%
瑜	3112		13	6	0.0009054%	658386	99.35%	6	2.43%
疚	3113		8	6	0.0009054%	658392	99.35%	5	2.02%
疫	3114		9	6	0.0009054%	658398	99.35%	6	2.43%
皓	3115		12	6	0.0009054%	658404	99.35%	2	0.81%
瞅	3116		14	6	0.0009054%	658410	99.35%	5	2.02%
硝	3117		12	6	0.0009054%	658416	99.35%	6	2.43%
秤	3118		10	6	0.0009054%	658422	99.35%	2	0.81%
竺	3119		8	6	0.0009054%	658428	99.36%	2	0.81%
篤	3120		16	6	0.0009054%	658434	99.36%	4	1.62%
糶	3121		25	6	0.0009054%	658440	99.36%	3	1.22%
絹	3122		13	6	0.0009054%	658446	99.36%	5	2.02%
繆	3123		17	6	0.0009054%	658452	99.36%	5	2.02%
繳	3124		19	6	0.0009054%	658458	99.36%	5	2.02%
羡	3125		12	6	0.0009054%	658464	99.36%	6	2.43%
羨	3126		13	6	0.0009054%	658470	99.36%	6	2.43%
翳	3127		17	6	0.0009054%	658476	99.36%	5	2.02%
脅	3128		10	6	0.0009054%	658482	99.36%	6	2.43%
胯	3129		10	6	0.0009054%	658488	99.36%	5	2.02%
腺	3130		13	6	0.0009054%	658494	99.37%	6	2.43%
臀	3131		17	6	0.0009054%	658500	99.37%	4	1.62%
臣	3132		6	6	0.0009054%	658506	99.37%	5	2.02%
苯	3133		9	6	0.0009054%	658512	99.37%	3	1.22%
茸	3134		10	6	0.0009054%	658518	99.37%	3	1.22%
莎	3135		11	6	0.0009054%	658524	99.37%	4	1.62%
莉	3136		11	6	0.0009054%	658530	99.37%	4	1.62%
萃	3137		12	6	0.0009054%	658536	99.37%	4	1.62%
蘋	3138		20	6	0.0009054%	658542	99.37%	4	1.62%
蘢	3139		20	6	0.0009054%	658548	99.37%	4	1.62%
虐	3140		9	6	0.0009054%	658554	99.37%	6	2.43%
蛀	3141		11	6	0.0009054%	658560	99.38%	4	1.62%
蛛	3142		12	6	0.0009054%	658566	99.38%	4	1.62%
蜿	3143		14	6	0.0009054%	658572	99.38%	6	2.43%
蜘	3144		14	6	0.0009054%	658578	99.38%	4	1.62%
蜒	3145		14	6	0.0009054%	658584	99.38%	6	2.43%
蠟	3146		21	6	0.0009054%	658590	99.38%	5	2.02%
袱	3147		11	6	0.0009054%	658596	99.38%	6	2.43%
裔	3148		13	6	0.0009054%	658602	99.38%	6	2.43%
褪	3149		15	6	0.0009054%	658608	99.38%	6	2.43%
訶	3150		12	6	0.0009054%	658614	99.38%	3	1.22%
豁	3151		17	6	0.0009054%	658620	99.38%	6	2.43%
貞	3152		9	6	0.0009054%	658626	99.39%	4	1.62%
賂	3153		13	6	0.0009054%	658632	99.39%	4	1.62%
跤	3154		13	6	0.0009054%	658638	99.39%	6	2.43%
蹭	3155		19	6	0.0009054%	658644	99.39%	5	2.02%
輾	3156		17	6	0.0009054%	658650	99.39%	6	2.43%
轎	3157		19	6	0.0009054%	658656	99.39%	4	1.62%
辰	3158		7	6	0.0009054%	658662	99.39%	6	2.43%
迭	3159		8	6	0.0009054%	658668	99.39%	5	2.02%
迸	3160		9	6	0.0009054%	658674	99.39%	5	2.02%
遐	3161		12	6	0.0009054%	658680	99.39%	6	2.43%
釆	3162		7	6	0.0009054%	658686	99.39%	4	1.62%
釘	3163		10	6	0.0009054%	658692	99.40%	5	2.02%
釣	3164		11	6	0.0009054%	658698	99.40%	6	2.43%
鉛	3165		13	6	0.0009054%	658704	99.40%	4	1.62%
錚	3166		16	6	0.0009054%	658710	99.40%	2	0.81%
錘	3167		17	6	0.0009054%	658716	99.40%	6	2.43%
霎	3168		16	6	0.0009054%	658722	99.40%	5	2.02%
顱	3169		25	6	0.0009054%	658728	99.40%	6	2.43%
馭	3170		12	6	0.0009054%	658734	99.40%	5	2.02%
骼	3171		16	6	0.0009054%	658740	99.40%	4	1.62%
鬚	3172		22	6	0.0009054%	658746	99.40%	4	1.62%
鬲	3173		10	6	0.0009054%	658752	99.40%	2	0.81%
魁	3174		14	6	0.0009054%	658758	99.41%	6	2.43%
鱗	3175		23	6	0.0009054%	658764	99.41%	6	2.43%
鵑	3176		18	6	0.0009054%	658770	99.41%	4	1.62%
黯	3177		21	6	0.0009054%	658776	99.41%	4	1.62%
龜	3178		16	6	0.0009054%	658782	99.41%	6	2.43%
丸	3179		3	5	0.0007545%	658787	99.41%	4	1.62%
乍	3180		5	5	0.0007545%	658792	99.41%	5	2.02%
亟	3181		8	5	0.0007545%	658797	99.41%	5	2.02%
佗	3182		7	5	0.0007545%	658802	99.41%	4	1.62%
俠	3183		9	5	0.0007545%	658807	99.41%	5	2.02%
侶	3184		9	5	0.0007545%	658812	99.41%	5	2.02%
侮	3185		9	5	0.0007545%	658817	99.41%	5	2.02%
俞	3186		9	5	0.0007545%	658822	99.41%	2	0.81%
兀	3187		3	5	0.0007545%	658827	99.42%	5	2.02%
冕	3188		11	5	0.0007545%	658832	99.42%	5	2.02%
冶	3189		7	5	0.0007545%	658837	99.42%	5	2.02%
凄	3190		10	5	0.0007545%	658842	99.42%	5	2.02%
剜	3191		10	5	0.0007545%	658847	99.42%	2	0.81%
勻	3192		4	5	0.0007545%	658852	99.42%	5	2.02%
厄	3193		4	5	0.0007545%	658857	99.42%	5	2.02%
咄	3194		8	5	0.0007545%	658862	99.42%	3	1.22%
咆	3195		8	5	0.0007545%	658867	99.42%	5	2.02%
咋	3196		8	5	0.0007545%	658872	99.42%	4	1.62%
咦	3197		9	5	0.0007545%	658877	99.42%	3	1.22%
唔	3198		10	5	0.0007545%	658882	99.42%	3	1.22%
啜	3199		11	5	0.0007545%	658887	99.42%	4	1.62%
喀	3200		12	5	0.0007545%	658892	99.43%	3	1.22%
嗜	3201		13	5	0.0007545%	658897	99.43%	4	1.62%
嘔	3202		14	5	0.0007545%	658902	99.43%	5	2.02%
嘈	3203		14	5	0.0007545%	658907	99.43%	4	1.62%
嘮	3204		15	5	0.0007545%	658912	99.43%	5	2.02%
噪	3205		16	5	0.0007545%	658917	99.43%	5	2.02%
噢	3206		16	5	0.0007545%	658922	99.43%	3	1.22%
坳	3207		8	5	0.0007545%	658927	99.43%	3	1.22%
垣	3208		9	5	0.0007545%	658932	99.43%	4	1.62%
夭	3209		4	5	0.0007545%	658937	99.43%	5	2.02%
妖	3210		7	5	0.0007545%	658942	99.43%	5	2.02%
妾	3211		8	5	0.0007545%	658947	99.43%	4	1.62%
娶	3212		11	5	0.0007545%	658952	99.43%	5	2.02%
婪	3213		11	5	0.0007545%	658957	99.44%	5	2.02%
孰	3214		11	5	0.0007545%	658962	99.44%	3	1.22%
宕	3215		8	5	0.0007545%	658967	99.44%	5	2.02%
屎	3216		9	5	0.0007545%	658972	99.44%	5	2.02%
峋	3217		9	5	0.0007545%	658977	99.44%	4	1.62%
嶙	3218		15	5	0.0007545%	658982	99.44%	4	1.62%
嶼	3219		17	5	0.0007545%	658987	99.44%	3	1.22%
巳	3220		3	5	0.0007545%	658992	99.44%	2	0.81%
帚	3221		8	5	0.0007545%	658997	99.44%	5	2.02%
帥	3222		9	5	0.0007545%	659002	99.44%	5	2.02%
并	3223		6	5	0.0007545%	659007	99.44%	4	1.62%
弘	3224		5	5	0.0007545%	659012	99.44%	5	2.02%
悌	3225		10	5	0.0007545%	659017	99.44%	1	0.40%
惋	3226		11	5	0.0007545%	659022	99.44%	4	1.62%
惕	3227		11	5	0.0007545%	659027	99.45%	5	2.02%
惚	3228		11	5	0.0007545%	659032	99.45%	4	1.62%
愫	3229		13	5	0.0007545%	659037	99.45%	4	1.62%
慚	3230		14	5	0.0007545%	659042	99.45%	5	2.02%
懊	3231		16	5	0.0007545%	659047	99.45%	5	2.02%
懇	3232		17	5	0.0007545%	659052	99.45%	4	1.62%
扉	3233		12	5	0.0007545%	659057	99.45%	3	1.22%
抨	3234		8	5	0.0007545%	659062	99.45%	4	1.62%
挎	3235		9	5	0.0007545%	659067	99.45%	5	2.02%
揹	3236		12	5	0.0007545%	659072	99.45%	4	1.62%
摻	3237		14	5	0.0007545%	659077	99.45%	5	2.02%
暉	3238		13	5	0.0007545%	659082	99.45%	5	2.02%
暇	3239		13	5	0.0007545%	659087	99.45%	5	2.02%
札	3240		5	5	0.0007545%	659092	99.46%	4	1.62%
栓	3241		10	5	0.0007545%	659097	99.46%	2	0.81%
桎	3242		10	5	0.0007545%	659102	99.46%	5	2.02%
梏	3243		11	5	0.0007545%	659107	99.46%	5	2.02%
棕	3244		12	5	0.0007545%	659112	99.46%	3	1.22%
棠	3245		12	5	0.0007545%	659117	99.46%	2	0.81%
棧	3246		12	5	0.0007545%	659122	99.46%	4	1.62%
楞	3247		13	5	0.0007545%	659127	99.46%	3	1.22%
橡	3248		16	5	0.0007545%	659132	99.46%	4	1.62%
殆	3249		9	5	0.0007545%	659137	99.46%	5	2.02%
氈	3250		17	5	0.0007545%	659142	99.46%	3	1.22%
氫	3251		11	5	0.0007545%	659147	99.46%	2	0.81%
沛	3252		7	5	0.0007545%	659152	99.46%	4	1.62%
沃	3253		7	5	0.0007545%	659157	99.47%	5	2.02%
沏	3254		7	5	0.0007545%	659162	99.47%	4	1.62%
沮	3255		8	5	0.0007545%	659167	99.47%	4	1.62%
涎	3256		11	5	0.0007545%	659172	99.47%	5	2.02%
淆	3257		11	5	0.0007545%	659177	99.47%	3	1.22%
淄	3258		11	5	0.0007545%	659182	99.47%	2	0.81%
渲	3259		12	5	0.0007545%	659187	99.47%	5	2.02%
湮	3260		12	5	0.0007545%	659192	99.47%	4	1.62%
湍	3261		12	5	0.0007545%	659197	99.47%	5	2.02%
溺	3262		13	5	0.0007545%	659202	99.47%	4	1.62%
漚	3263		14	5	0.0007545%	659207	99.47%	4	1.62%
潭	3264		15	5	0.0007545%	659212	99.47%	5	2.02%
潺	3265		15	5	0.0007545%	659217	99.47%	3	1.22%
瀕	3266		19	5	0.0007545%	659222	99.48%	5	2.02%
灼	3267		7	5	0.0007545%	659227	99.48%	5	2.02%
焊	3268		11	5	0.0007545%	659232	99.48%	3	1.22%
焰	3269		12	5	0.0007545%	659237	99.48%	5	2.02%
燼	3270		18	5	0.0007545%	659242	99.48%	3	1.22%
狄	3271		7	5	0.0007545%	659247	99.48%	4	1.62%
猩	3272		12	5	0.0007545%	659252	99.48%	3	1.22%
瘀	3273		13	5	0.0007545%	659257	99.48%	3	1.22%
瘡	3274		15	5	0.0007545%	659262	99.48%	5	2.02%
癖	3275		18	5	0.0007545%	659267	99.48%	3	1.22%
皂	3276		7	5	0.0007545%	659272	99.48%	4	1.62%
眸	3277		11	5	0.0007545%	659277	99.48%	5	2.02%
瞞	3278		16	5	0.0007545%	659282	99.48%	4	1.62%
碓	3279		13	5	0.0007545%	659287	99.48%	3	1.22%
磋	3280		15	5	0.0007545%	659292	99.49%	3	1.22%
祠	3281		9	5	0.0007545%	659297	99.49%	4	1.62%
祿	3282		12	5	0.0007545%	659302	99.49%	3	1.22%
禱	3283		18	5	0.0007545%	659307	99.49%	4	1.62%
秧	3284		10	5	0.0007545%	659312	99.49%	5	2.02%
稠	3285		13	5	0.0007545%	659317	99.49%	3	1.22%
穫	3286		19	5	0.0007545%	659322	99.49%	4	1.62%
穴	3287		5	5	0.0007545%	659327	99.49%	5	2.02%
穹	3288		8	5	0.0007545%	659332	99.49%	5	2.02%
窣	3289		13	5	0.0007545%	659337	99.49%	3	1.22%
窪	3290		14	5	0.0007545%	659342	99.49%	4	1.62%
窯	3291		15	5	0.0007545%	659347	99.49%	1	0.40%
窸	3292		16	5	0.0007545%	659352	99.49%	3	1.22%
竅	3293		18	5	0.0007545%	659357	99.50%	4	1.62%
竇	3294		20	5	0.0007545%	659362	99.50%	2	0.81%
竣	3295		12	5	0.0007545%	659367	99.50%	3	1.22%
箕	3296		14	5	0.0007545%	659372	99.50%	5	2.02%
篡	3297		16	5	0.0007545%	659377	99.50%	5	2.02%
篝	3298		16	5	0.0007545%	659382	99.50%	4	1.62%
簪	3299		18	5	0.0007545%	659387	99.50%	3	1.22%
簸	3300		19	5	0.0007545%	659392	99.50%	5	2.02%
籟	3301		22	5	0.0007545%	659397	99.50%	5	2.02%
籮	3302		25	5	0.0007545%	659402	99.50%	4	1.62%
籲	3303		32	5	0.0007545%	659407	99.50%	5	2.02%
綻	3304		14	5	0.0007545%	659412	99.50%	5	2.02%
繽	3305		20	5	0.0007545%	659417	99.50%	5	2.02%
羔	3306		10	5	0.0007545%	659422	99.51%	5	2.02%
羿	3307		9	5	0.0007545%	659427	99.51%	1	0.40%
耽	3308		10	5	0.0007545%	659432	99.51%	5	2.02%
聆	3309		11	5	0.0007545%	659437	99.51%	4	1.62%
胺	3310		10	5	0.0007545%	659442	99.51%	2	0.81%
臻	3311		16	5	0.0007545%	659447	99.51%	4	1.62%
舖	3312		15	5	0.0007545%	659452	99.51%	5	2.02%
舜	3313		12	5	0.0007545%	659457	99.51%	3	1.22%
苛	3314		9	5	0.0007545%	659462	99.51%	5	2.02%
苞	3315		9	5	0.0007545%	659467	99.51%	4	1.62%
蓑	3316		14	5	0.0007545%	659472	99.51%	4	1.62%
薯	3317		17	5	0.0007545%	659477	99.51%	3	1.22%
蕻	3318		17	5	0.0007545%	659482	99.51%	3	1.22%
蜀	3319		13	5	0.0007545%	659487	99.52%	3	1.22%
蜷	3320		14	5	0.0007545%	659492	99.52%	5	2.02%
螳	3321		17	5	0.0007545%	659497	99.52%	1	0.40%
蠅	3322		19	5	0.0007545%	659502	99.52%	3	1.22%
蠢	3323		21	5	0.0007545%	659507	99.52%	4	1.62%
褐	3324		14	5	0.0007545%	659512	99.52%	5	2.02%
褒	3325		15	5	0.0007545%	659517	99.52%	5	2.02%
訟	3326		11	5	0.0007545%	659522	99.52%	3	1.22%
詭	3327		13	5	0.0007545%	659527	99.52%	5	2.02%
誡	3328		14	5	0.0007545%	659532	99.52%	4	1.62%
謢	3329		17	5	0.0007545%	659537	99.52%	3	1.22%
譚	3330		19	5	0.0007545%	659542	99.52%	4	1.62%
跚	3331		12	5	0.0007545%	659547	99.52%	5	2.02%
跛	3332		12	5	0.0007545%	659552	99.52%	4	1.62%
踵	3333		16	5	0.0007545%	659557	99.53%	5	2.02%
蹊	3334		17	5	0.0007545%	659562	99.53%	5	2.02%
蹣	3335		18	5	0.0007545%	659567	99.53%	5	2.02%
蹬	3336		19	5	0.0007545%	659572	99.53%	4	1.62%
軸	3337		12	5	0.0007545%	659577	99.53%	4	1.62%
轍	3338		18	5	0.0007545%	659582	99.53%	5	2.02%
鄒	3339		12	5	0.0007545%	659587	99.53%	1	0.40%
釉	3340		13	5	0.0007545%	659592	99.53%	2	0.81%
	3341		12	5	0.0007545%	659597	99.53%	5	2.02%
銼	3342		15	5	0.0007545%	659602	99.53%	3	1.22%
錶	3343		16	5	0.0007545%	659607	99.53%	5	2.02%
鋸	3344		16	5	0.0007545%	659612	99.53%	5	2.02%
錫	3345		16	5	0.0007545%	659617	99.53%	5	2.02%
閥	3346		14	5	0.0007545%	659622	99.54%	4	1.62%
闌	3347		17	5	0.0007545%	659627	99.54%	5	2.02%
霄	3348		15	5	0.0007545%	659632	99.54%	5	2.02%
霆	3349		15	5	0.0007545%	659637	99.54%	5	2.02%
霓	3350		16	5	0.0007545%	659642	99.54%	4	1.62%
韋	3351		9	5	0.0007545%	659647	99.54%	2	0.81%
韭	3352		9	5	0.0007545%	659652	99.54%	3	1.22%
頹	3353		16	5	0.0007545%	659657	99.54%	4	1.62%
頤	3354		16	5	0.0007545%	659662	99.54%	4	1.62%
颯	3355		14	5	0.0007545%	659667	99.54%	3	1.22%
颳	3356		15	5	0.0007545%	659672	99.54%	3	1.22%
馴	3357		13	5	0.0007545%	659677	99.54%	3	1.22%
駿	3358		17	5	0.0007545%	659682	99.54%	2	0.81%
丐	3359		4	4	0.0006036%	659686	99.55%	4	1.62%
丙	3360		5	4	0.0006036%	659690	99.55%	3	1.22%
乖	3361		8	4	0.0006036%	659694	99.55%	3	1.22%
亙	3362		6	4	0.0006036%	659698	99.55%	3	1.22%
佇	3363		7	4	0.0006036%	659702	99.55%	4	1.62%
伽	3364		7	4	0.0006036%	659706	99.55%	3	1.22%
併	3365		8	4	0.0006036%	659710	99.55%	4	1.62%
俘	3366		9	4	0.0006036%	659714	99.55%	3	1.22%
倔	3367		10	4	0.0006036%	659718	99.55%	4	1.62%
僳	3368		14	4	0.0006036%	659722	99.55%	1	0.40%
儂	3369		15	4	0.0006036%	659726	99.55%	1	0.40%
兢	3370		14	4	0.0006036%	659730	99.55%	2	0.81%
勿	3371		4	4	0.0006036%	659734	99.55%	4	1.62%
匝	3372		5	4	0.0006036%	659738	99.55%	2	0.81%
匣	3373		7	4	0.0006036%	659742	99.55%	2	0.81%
匱	3374		14	4	0.0006036%	659746	99.55%	4	1.62%
匾	3375		11	4	0.0006036%	659750	99.55%	3	1.22%
叼	3376		5	4	0.0006036%	659754	99.56%	4	1.62%
叱	3377		5	4	0.0006036%	659758	99.56%	4	1.62%
哎	3378		9	4	0.0006036%	659762	99.56%	4	1.62%
哽	3379		10	4	0.0006036%	659766	99.56%	4	1.62%
唾	3380		12	4	0.0006036%	659770	99.56%	4	1.62%
嗷	3381		14	4	0.0006036%	659774	99.56%	2	0.81%
噙	3382		16	4	0.0006036%	659778	99.56%	4	1.62%
噥	3383		16	4	0.0006036%	659782	99.56%	3	1.22%
噠	3384		16	4	0.0006036%	659786	99.56%	2	0.81%
嚎	3385		17	4	0.0006036%	659790	99.56%	4	1.62%
嚐	3386		17	4	0.0006036%	659794	99.56%	1	0.40%
坱	3387		8	4	0.0006036%	659798	99.56%	3	1.22%
墟	3388		15	4	0.0006036%	659802	99.56%	3	1.22%
壩	3389		24	4	0.0006036%	659806	99.56%	2	0.81%
夸	3390		6	4	0.0006036%	659810	99.56%	4	1.62%
姍	3391		8	4	0.0006036%	659814	99.56%	2	0.81%
妲	3392		8	4	0.0006036%	659818	99.57%	2	0.81%
姬	3393		10	4	0.0006036%	659822	99.57%	2	0.81%
嬉	3394		15	4	0.0006036%	659826	99.57%	4	1.62%
嫵	3395		15	4	0.0006036%	659830	99.57%	2	0.81%
嬸	3396		18	4	0.0006036%	659834	99.57%	2	0.81%
孽	3397		20	4	0.0006036%	659838	99.57%	4	1.62%
寅	3398		11	4	0.0006036%	659842	99.57%	1	0.40%
尉	3399		11	4	0.0006036%	659846	99.57%	2	0.81%
屹	3400		6	4	0.0006036%	659850	99.57%	4	1.62%
峨	3401		10	4	0.0006036%	659854	99.57%	3	1.22%
崎	3402		11	4	0.0006036%	659858	99.57%	4	1.62%
嶗	3403		15	4	0.0006036%	659862	99.57%	2	0.81%
巉	3404		20	4	0.0006036%	659866	99.57%	2	0.81%
巫	3405		7	4	0.0006036%	659870	99.57%	4	1.62%
幀	3406		12	4	0.0006036%	659874	99.57%	4	1.62%
庄	3407		6	4	0.0006036%	659878	99.57%	4	1.62%
廖	3408		14	4	0.0006036%	659882	99.57%	2	0.81%
廝	3409		15	4	0.0006036%	659886	99.58%	4	1.62%
弛	3410		6	4	0.0006036%	659890	99.58%	4	1.62%
彙	3411		13	4	0.0006036%	659894	99.58%	3	1.22%
徙	3412		11	4	0.0006036%	659898	99.58%	3	1.22%
怏	3413		8	4	0.0006036%	659902	99.58%	2	0.81%
怔	3414		8	4	0.0006036%	659906	99.58%	4	1.62%
怜	3415		8	4	0.0006036%	659910	99.58%	4	1.62%
悍	3416		10	4	0.0006036%	659914	99.58%	4	1.62%
悖	3417		10	4	0.0006036%	659918	99.58%	4	1.62%
悒	3418		10	4	0.0006036%	659922	99.58%	3	1.22%
悴	3419		11	4	0.0006036%	659926	99.58%	4	1.62%
悻	3420		11	4	0.0006036%	659930	99.58%	2	0.81%
愕	3421		12	4	0.0006036%	659934	99.58%	4	1.62%
惴	3422		12	4	0.0006036%	659938	99.58%	2	0.81%
憫	3423		15	4	0.0006036%	659942	99.58%	3	1.22%
憔	3424		15	4	0.0006036%	659946	99.58%	4	1.62%
憩	3425		16	4	0.0006036%	659950	99.59%	3	1.22%
懣	3426		18	4	0.0006036%	659954	99.59%	4	1.62%
戎	3427		6	4	0.0006036%	659958	99.59%	2	0.81%
拇	3428		8	4	0.0006036%	659962	99.59%	4	1.62%
捐	3429		10	4	0.0006036%	659966	99.59%	4	1.62%
掬	3430		11	4	0.0006036%	659970	99.59%	4	1.62%
掰	3431		12	4	0.0006036%	659974	99.59%	4	1.62%
搐	3432		13	4	0.0006036%	659978	99.59%	4	1.62%
擒	3433		16	4	0.0006036%	659982	99.59%	1	0.40%
擲	3434		18	4	0.0006036%	659986	99.59%	3	1.22%
擷	3435		18	4	0.0006036%	659990	99.59%	4	1.62%
攫	3436		23	4	0.0006036%	659994	99.59%	4	1.62%
斕	3437		21	4	0.0006036%	659998	99.59%	3	1.22%
斡	3438		14	4	0.0006036%	660002	99.59%	2	0.81%
晌	3439		10	4	0.0006036%	660006	99.59%	4	1.62%
晾	3440		12	4	0.0006036%	660010	99.59%	4	1.62%
曙	3441		17	4	0.0006036%	660014	99.59%	3	1.22%
朔	3442		10	4	0.0006036%	660018	99.60%	2	0.81%
柚	3443		9	4	0.0006036%	660022	99.60%	3	1.22%
棟	3444		12	4	0.0006036%	660026	99.60%	4	1.62%
楹	3445		13	4	0.0006036%	660030	99.60%	3	1.22%
楝	3446		13	4	0.0006036%	660034	99.60%	2	0.81%
槽	3447		15	4	0.0006036%	660038	99.60%	2	0.81%
槳	3448		15	4	0.0006036%	660042	99.60%	2	0.81%
樺	3449		16	4	0.0006036%	660046	99.60%	2	0.81%
橙	3450		16	4	0.0006036%	660050	99.60%	4	1.62%
櫻	3451		21	4	0.0006036%	660054	99.60%	3	1.22%
毋	3452		4	4	0.0006036%	660058	99.60%	3	1.22%
氯	3453		12	4	0.0006036%	660062	99.60%	4	1.62%
汝	3454		6	4	0.0006036%	660066	99.60%	3	1.22%
泌	3455		8	4	0.0006036%	660070	99.60%	3	1.22%
泯	3456		8	4	0.0006036%	660074	99.60%	3	1.22%
涔	3457		10	4	0.0006036%	660078	99.60%	2	0.81%
涸	3458		11	4	0.0006036%	660082	99.60%	4	1.62%
淅	3459		11	4	0.0006036%	660086	99.61%	3	1.22%
淩	3460		11	4	0.0006036%	660090	99.61%	4	1.62%
涷	3461		11	4	0.0006036%	660094	99.61%	4	1.62%
湃	3462		12	4	0.0006036%	660098	99.61%	4	1.62%
漩	3463		14	4	0.0006036%	660102	99.61%	3	1.22%
澎	3464		15	4	0.0006036%	660106	99.61%	4	1.62%
炳	3465		9	4	0.0006036%	660110	99.61%	3	1.22%
煎	3466		13	4	0.0006036%	660114	99.61%	4	1.62%
熨	3467		15	4	0.0006036%	660118	99.61%	4	1.62%
熠	3468		15	4	0.0006036%	660122	99.61%	2	0.81%
猾	3469		13	4	0.0006036%	660126	99.61%	3	1.22%
獷	3470		18	4	0.0006036%	660130	99.61%	4	1.62%
玨	3471		8	4	0.0006036%	660134	99.61%	3	1.22%
璀	3472		15	4	0.0006036%	660138	99.61%	4	1.62%
璧	3473		18	4	0.0006036%	660142	99.61%	4	1.62%
疤	3474		9	4	0.0006036%	660146	99.61%	2	0.81%
痙	3475		12	4	0.0006036%	660150	99.62%	4	1.62%
痘	3476		12	4	0.0006036%	660154	99.62%	1	0.40%
痰	3477		13	4	0.0006036%	660158	99.62%	3	1.22%
瘠	3478		15	4	0.0006036%	660162	99.62%	4	1.62%
瘸	3479		16	4	0.0006036%	660166	99.62%	3	1.22%
癟	3480		19	4	0.0006036%	660170	99.62%	4	1.62%
矯	3481		17	4	0.0006036%	660174	99.62%	4	1.62%
硫	3482		11	4	0.0006036%	660178	99.62%	4	1.62%
磅	3483		15	4	0.0006036%	660182	99.62%	4	1.62%
磯	3484		17	4	0.0006036%	660186	99.62%	3	1.22%
祟	3485		10	4	0.0006036%	660190	99.62%	3	1.22%
禹	3486		9	4	0.0006036%	660194	99.62%	2	0.81%
稈	3487		12	4	0.0006036%	660198	99.62%	4	1.62%
窒	3488		11	4	0.0006036%	660202	99.62%	4	1.62%
窺	3489		16	4	0.0006036%	660206	99.62%	4	1.62%
笈	3490		10	4	0.0006036%	660210	99.62%	1	0.40%
篆	3491		15	4	0.0006036%	660214	99.62%	4	1.62%
簧	3492		18	4	0.0006036%	660218	99.63%	3	1.22%
簿	3493		19	4	0.0006036%	660222	99.63%	3	1.22%
籬	3494		25	4	0.0006036%	660226	99.63%	4	1.62%
紊	3495		10	4	0.0006036%	660230	99.63%	4	1.62%
紜	3496		10	4	0.0006036%	660234	99.63%	4	1.62%
紳	3497		11	4	0.0006036%	660238	99.63%	4	1.62%
縶	3498		17	4	0.0006036%	660242	99.63%	1	0.40%
翌	3499		11	4	0.0006036%	660246	99.63%	4	1.62%
腆	3500		12	4	0.0006036%	660250	99.63%	2	0.81%
膏	3501		14	4	0.0006036%	660254	99.63%	4	1.62%
膛	3502		15	4	0.0006036%	660258	99.63%	4	1.62%
艘	3503		15	4	0.0006036%	660262	99.63%	3	1.22%
艦	3504		20	4	0.0006036%	660266	99.63%	1	0.40%
芭	3505		8	4	0.0006036%	660270	99.63%	3	1.22%
芥	3506		8	4	0.0006036%	660274	99.63%	3	1.22%
芸	3507		8	4	0.0006036%	660278	99.63%	1	0.40%
茄	3508		9	4	0.0006036%	660282	99.64%	2	0.81%
苑	3509		9	4	0.0006036%	660286	99.64%	4	1.62%
茖	3510		10	4	0.0006036%	660290	99.64%	4	1.62%
茬	3511		10	4	0.0006036%	660294	99.64%	3	1.22%
葦	3512		13	4	0.0006036%	660298	99.64%	4	1.62%
葫	3513		13	4	0.0006036%	660302	99.64%	2	0.81%
蕊	3514		16	4	0.0006036%	660306	99.64%	4	1.62%
蕃	3515		16	4	0.0006036%	660310	99.64%	1	0.40%
蕪	3516		16	4	0.0006036%	660314	99.64%	3	1.22%
藩	3517		19	4	0.0006036%	660318	99.64%	4	1.62%
蘸	3518		23	4	0.0006036%	660322	99.64%	4	1.62%
蚜	3519		10	4	0.0006036%	660326	99.64%	1	0.40%
蟈	3520		17	4	0.0006036%	660330	99.64%	1	0.40%
蟄	3521		17	4	0.0006036%	660334	99.64%	3	1.22%
褂	3522		13	4	0.0006036%	660338	99.64%	4	1.62%
褓	3523		14	4	0.0006036%	660342	99.64%	4	1.62%
褥	3524		15	4	0.0006036%	660346	99.64%	3	1.22%
褸	3525		16	4	0.0006036%	660350	99.65%	4	1.62%
襄	3526		17	4	0.0006036%	660354	99.65%	4	1.62%
襤	3527		19	4	0.0006036%	660358	99.65%	4	1.62%
訥	3528		11	4	0.0006036%	660362	99.65%	3	1.22%
訧	3529		11	4	0.0006036%	660366	99.65%	4	1.62%
詛	3530		12	4	0.0006036%	660370	99.65%	4	1.62%
誨	3531		14	4	0.0006036%	660374	99.65%	4	1.62%
謗	3532		17	4	0.0006036%	660378	99.65%	4	1.62%
謨	3533		18	4	0.0006036%	660382	99.65%	2	0.81%
謾	3534		18	4	0.0006036%	660386	99.65%	4	1.62%
譬	3535		20	4	0.0006036%	660390	99.65%	4	1.62%
貯	3536		12	4	0.0006036%	660394	99.65%	4	1.62%
贅	3537		18	4	0.0006036%	660398	99.65%	4	1.62%
跺	3538		13	4	0.0006036%	660402	99.65%	4	1.62%
蹌	3539		17	4	0.0006036%	660406	99.65%	3	1.22%
蹇	3540		17	4	0.0006036%	660410	99.65%	1	0.40%
轆	3541		18	4	0.0006036%	660414	99.66%	3	1.22%
迂	3542		6	4	0.0006036%	660418	99.66%	4	1.62%
迢	3543		8	4	0.0006036%	660422	99.66%	2	0.81%
釅	3544		27	4	0.0006036%	660426	99.66%	3	1.22%
鈍	3545		12	4	0.0006036%	660430	99.66%	4	1.62%
鈦	3546		12	4	0.0006036%	660434	99.66%	2	0.81%
鉤	3547		13	4	0.0006036%	660438	99.66%	2	0.81%
鋤	3548		15	4	0.0006036%	660442	99.66%	3	1.22%
錳	3549		16	4	0.0006036%	660446	99.66%	3	1.22%
鎬	3550		18	4	0.0006036%	660450	99.66%	3	1.22%
鑿	3551		28	4	0.0006036%	660454	99.66%	3	1.22%
阜	3552		8	4	0.0006036%	660458	99.66%	4	1.62%
隕	3553		12	4	0.0006036%	660462	99.66%	2	0.81%
隧	3554		15	4	0.0006036%	660466	99.66%	3	1.22%
雌	3555		14	4	0.0006036%	660470	99.66%	4	1.62%
霏	3556		16	4	0.0006036%	660474	99.66%	2	0.81%
頰	3557		16	4	0.0006036%	660478	99.66%	4	1.62%
顥	3558		21	4	0.0006036%	660482	99.67%	4	1.62%
颱	3559		14	4	0.0006036%	660486	99.67%	1	0.40%
駭	3560		16	4	0.0006036%	660490	99.67%	3	1.22%
騁	3561		17	4	0.0006036%	660494	99.67%	3	1.22%
驥	3562		26	4	0.0006036%	660498	99.67%	3	1.22%
骸	3563		16	4	0.0006036%	660502	99.67%	2	0.81%
鮑	3564		16	4	0.0006036%	660506	99.67%	2	0.81%
鯊	3565		18	4	0.0006036%	660510	99.67%	3	1.22%
鱖	3566		23	4	0.0006036%	660514	99.67%	1	0.40%
鶢	3567		20	4	0.0006036%	660518	99.67%	3	1.22%
鹹	3568		20	4	0.0006036%	660522	99.67%	3	1.22%
鹿	3569		11	4	0.0006036%	660526	99.67%	4	1.62%
黔	3570		16	4	0.0006036%	660530	99.67%	3	1.22%
齋	3571		17	4	0.0006036%	660534	99.67%	3	1.22%
齣	3572		20	4	0.0006036%	660538	99.67%	3	1.22%
齜	3573		21	4	0.0006036%	660542	99.67%	4	1.62%
佃	3574		7	3	0.0004527%	660545	99.67%	3	1.22%
体	3575		7	3	0.0004527%	660548	99.68%	3	1.22%
侉	3576		8	3	0.0004527%	660551	99.68%	1	0.40%
俏	3577		9	3	0.0004527%	660554	99.68%	3	1.22%
偌	3578		11	3	0.0004527%	660557	99.68%	3	1.22%
偎	3579		11	3	0.0004527%	660560	99.68%	3	1.22%
偕	3580		11	3	0.0004527%	660563	99.68%	3	1.22%
倏	3581		11	3	0.0004527%	660566	99.68%	3	1.22%
儼	3582		22	3	0.0004527%	660569	99.68%	3	1.22%
冗	3583		4	3	0.0004527%	660572	99.68%	3	1.22%
几	3584		2	3	0.0004527%	660575	99.68%	2	0.81%
函	3585		8	3	0.0004527%	660578	99.68%	3	1.22%
剌	3586		9	3	0.0004527%	660581	99.68%	2	0.81%
剿	3587		13	3	0.0004527%	660584	99.68%	3	1.22%
勛	3588		12	3	0.0004527%	660587	99.68%	3	1.22%
匡	3589		6	3	0.0004527%	660590	99.68%	2	0.81%
吝	3590		7	3	0.0004527%	660593	99.68%	3	1.22%
咀	3591		8	3	0.0004527%	660596	99.68%	3	1.22%
呷	3592		8	3	0.0004527%	660599	99.68%	2	0.81%
咎	3593		8	3	0.0004527%	660602	99.68%	3	1.22%
呴	3594		8	3	0.0004527%	660605	99.68%	1	0.40%
咫	3595		9	3	0.0004527%	660608	99.68%	3	1.22%
哏	3596		9	3	0.0004527%	660611	99.68%	1	0.40%
啶	3597		11	3	0.0004527%	660614	99.69%	2	0.81%
嗨	3598		13	3	0.0004527%	660617	99.69%	2	0.81%
嗇	3599		13	3	0.0004527%	660620	99.69%	3	1.22%
嗤	3600		13	3	0.0004527%	660623	99.69%	2	0.81%
嗅	3601		13	3	0.0004527%	660626	99.69%	3	1.22%
嗆	3602		13	3	0.0004527%	660629	99.69%	3	1.22%
嘍	3603		14	3	0.0004527%	660632	99.69%	3	1.22%
嗶	3604		14	3	0.0004527%	660635	99.69%	2	0.81%
噓	3605		15	3	0.0004527%	660638	99.69%	3	1.22%
嚀	3606		17	3	0.0004527%	660641	99.69%	2	0.81%
囀	3607		21	3	0.0004527%	660644	99.69%	2	0.81%
圃	3608		10	3	0.0004527%	660647	99.69%	3	1.22%
圪	3609		6	3	0.0004527%	660650	99.69%	2	0.81%
坯	3610		8	3	0.0004527%	660653	99.69%	2	0.81%
坭	3611		8	3	0.0004527%	660656	99.69%	1	0.40%
壼	3612		13	3	0.0004527%	660659	99.69%	1	0.40%
复	3613		9	3	0.0004527%	660662	99.69%	3	1.22%
奚	3614		10	3	0.0004527%	660665	99.69%	3	1.22%
妊	3615		7	3	0.0004527%	660668	99.69%	3	1.22%
姚	3616		9	3	0.0004527%	660671	99.69%	3	1.22%
娑	3617		10	3	0.0004527%	660674	99.69%	3	1.22%
娠	3618		10	3	0.0004527%	660677	99.69%	3	1.22%
婭	3619		11	3	0.0004527%	660680	99.70%	1	0.40%
婿	3620		12	3	0.0004527%	660683	99.70%	3	1.22%
嫣	3621		14	3	0.0004527%	660686	99.70%	3	1.22%
尹	3622		4	3	0.0004527%	660689	99.70%	2	0.81%
屐	3623		10	3	0.0004527%	660692	99.70%	2	0.81%
岑	3624		7	3	0.0004527%	660695	99.70%	1	0.40%
岬	3625		8	3	0.0004527%	660698	99.70%	1	0.40%
崢	3626		11	3	0.0004527%	660701	99.70%	3	1.22%
嶇	3627		14	3	0.0004527%	660704	99.70%	3	1.22%
嶸	3628		17	3	0.0004527%	660707	99.70%	3	1.22%
幛	3629		14	3	0.0004527%	660710	99.70%	2	0.81%
彊	3630		16	3	0.0004527%	660713	99.70%	3	1.22%
彗	3631		11	3	0.0004527%	660716	99.70%	1	0.40%
徨	3632		12	3	0.0004527%	660719	99.70%	3	1.22%
怵	3633		8	3	0.0004527%	660722	99.70%	3	1.22%
怠	3634		9	3	0.0004527%	660725	99.70%	3	1.22%
恙	3635		10	3	0.0004527%	660728	99.70%	3	1.22%
恕	3636		10	3	0.0004527%	660731	99.70%	3	1.22%
恿	3637		11	3	0.0004527%	660734	99.70%	3	1.22%
惦	3638		11	3	0.0004527%	660737	99.70%	3	1.22%
慄	3639		13	3	0.0004527%	660740	99.70%	3	1.22%
慫	3640		15	3	0.0004527%	660743	99.70%	3	1.22%
憬	3641		15	3	0.0004527%	660746	99.71%	3	1.22%
懦	3642		17	3	0.0004527%	660749	99.71%	3	1.22%
扦	3643		6	3	0.0004527%	660752	99.71%	1	0.40%
抉	3644		7	3	0.0004527%	660755	99.71%	3	1.22%
扳	3645		7	3	0.0004527%	660758	99.71%	3	1.22%
拄	3646		8	3	0.0004527%	660761	99.71%	2	0.81%
拗	3647		8	3	0.0004527%	660764	99.71%	3	1.22%
拭	3648		9	3	0.0004527%	660767	99.71%	2	0.81%
拷	3649		9	3	0.0004527%	660770	99.71%	2	0.81%
挈	3650		10	3	0.0004527%	660773	99.71%	2	0.81%
掖	3651		11	3	0.0004527%	660776	99.71%	2	0.81%
捻	3652		11	3	0.0004527%	660779	99.71%	3	1.22%
捺	3653		11	3	0.0004527%	660782	99.71%	3	1.22%
捶	3654		12	3	0.0004527%	660785	99.71%	3	1.22%
搪	3655		13	3	0.0004527%	660788	99.71%	3	1.22%
摁	3656		13	3	0.0004527%	660791	99.71%	3	1.22%
搧	3657		13	3	0.0004527%	660794	99.71%	2	0.81%
撩	3658		15	3	0.0004527%	660797	99.71%	3	1.22%
攢	3659		22	3	0.0004527%	660800	99.71%	2	0.81%
攣	3660		23	3	0.0004527%	660803	99.71%	3	1.22%
攥	3661		23	3	0.0004527%	660806	99.71%	2	0.81%
敷	3662		15	3	0.0004527%	660809	99.71%	3	1.22%
暄	3663		13	3	0.0004527%	660812	99.72%	3	1.22%
曇	3664		16	3	0.0004527%	660815	99.72%	3	1.22%
杞	3665		7	3	0.0004527%	660818	99.72%	2	0.81%
柑	3666		9	3	0.0004527%	660821	99.72%	1	0.40%
枸	3667		9	3	0.0004527%	660824	99.72%	2	0.81%
桅	3668		10	3	0.0004527%	660827	99.72%	1	0.40%
梓	3669		11	3	0.0004527%	660830	99.72%	3	1.22%
梱	3670		11	3	0.0004527%	660833	99.72%	2	0.81%
梆	3671		11	3	0.0004527%	660836	99.72%	2	0.81%
楣	3672		13	3	0.0004527%	660839	99.72%	3	1.22%
槁	3673		14	3	0.0004527%	660842	99.72%	2	0.81%
槓	3674		14	3	0.0004527%	660845	99.72%	3	1.22%
榷	3675		14	3	0.0004527%	660848	99.72%	3	1.22%
榴	3676		14	3	0.0004527%	660851	99.72%	2	0.81%
樟	3677		15	3	0.0004527%	660854	99.72%	2	0.81%
樊	3678		15	3	0.0004527%	660857	99.72%	2	0.81%
橘	3679		16	3	0.0004527%	660860	99.72%	3	1.22%
檀	3680		17	3	0.0004527%	660863	99.72%	2	0.81%
檯	3681		18	3	0.0004527%	660866	99.72%	3	1.22%
殃	3682		9	3	0.0004527%	660869	99.72%	3	1.22%
殉	3683		10	3	0.0004527%	660872	99.72%	3	1.22%
汔	3684		6	3	0.0004527%	660875	99.72%	2	0.81%
沆	3685		7	3	0.0004527%	660878	99.73%	2	0.81%
泓	3686		8	3	0.0004527%	660881	99.73%	3	1.22%
沓	3687		8	3	0.0004527%	660884	99.73%	3	1.22%
泒	3688		8	3	0.0004527%	660887	99.73%	2	0.81%
洌	3689		9	3	0.0004527%	660890	99.73%	3	1.22%
浦	3690		10	3	0.0004527%	660893	99.73%	3	1.22%
涓	3691		10	3	0.0004527%	660896	99.73%	2	0.81%
浹	3692		10	3	0.0004527%	660899	99.73%	3	1.22%
渤	3693		12	3	0.0004527%	660902	99.73%	2	0.81%
渝	3694		12	3	0.0004527%	660905	99.73%	3	1.22%
溉	3695		12	3	0.0004527%	660908	99.73%	3	1.22%
滓	3696		13	3	0.0004527%	660911	99.73%	1	0.40%
滁	3697		13	3	0.0004527%	660914	99.73%	1	0.40%
漬	3698		14	3	0.0004527%	660917	99.73%	3	1.22%
漣	3699		14	3	0.0004527%	660920	99.73%	3	1.22%
漪	3700		14	3	0.0004527%	660923	99.73%	3	1.22%
滌	3701		14	3	0.0004527%	660926	99.73%	3	1.22%
濯	3702		17	3	0.0004527%	660929	99.73%	2	0.81%
濡	3703		17	3	0.0004527%	660932	99.73%	3	1.22%
瀏	3704		18	3	0.0004527%	660935	99.73%	3	1.22%
瀝	3705		19	3	0.0004527%	660938	99.73%	2	0.81%
烹	3706		11	3	0.0004527%	660941	99.73%	2	0.81%
焚	3707		12	3	0.0004527%	660944	99.74%	3	1.22%
煽	3708		14	3	0.0004527%	660947	99.74%	3	1.22%
熾	3709		16	3	0.0004527%	660950	99.74%	3	1.22%
燎	3710		16	3	0.0004527%	660953	99.74%	3	1.22%
爵	3711		17	3	0.0004527%	660956	99.74%	3	1.22%
犢	3712		19	3	0.0004527%	660959	99.74%	3	1.22%
猖	3713		11	3	0.0004527%	660962	99.74%	3	1.22%
瑯	3714		13	3	0.0004527%	660965	99.74%	3	1.22%
瑕	3715		13	3	0.0004527%	660968	99.74%	3	1.22%
瑤	3716		14	3	0.0004527%	660971	99.74%	2	0.81%
瓢	3717		16	3	0.0004527%	660974	99.74%	3	1.22%
甭	3718		9	3	0.0004527%	660977	99.74%	3	1.22%
痢	3719		12	3	0.0004527%	660980	99.74%	3	1.22%
瘍	3720		14	3	0.0004527%	660983	99.74%	2	0.81%
瘟	3721		15	3	0.0004527%	660986	99.74%	3	1.22%
癆	3722		17	3	0.0004527%	660989	99.74%	2	0.81%
皖	3723		12	3	0.0004527%	660992	99.74%	3	1.22%
盎	3724		10	3	0.0004527%	660995	99.74%	3	1.22%
眩	3725		10	3	0.0004527%	660998	99.74%	3	1.22%
睫	3726		13	3	0.0004527%	661001	99.74%	3	1.22%
睞	3727		13	3	0.0004527%	661004	99.74%	3	1.22%
睿	3728		14	3	0.0004527%	661007	99.74%	3	1.22%
瞇	3729		15	3	0.0004527%	661010	99.74%	2	0.81%
瞑	3730		15	3	0.0004527%	661013	99.75%	3	1.22%
瞟	3731		16	3	0.0004527%	661016	99.75%	3	1.22%
瞰	3732		17	3	0.0004527%	661019	99.75%	1	0.40%
瞼	3733		18	3	0.0004527%	661022	99.75%	3	1.22%
矢	3734		5	3	0.0004527%	661025	99.75%	3	1.22%
砰	3735		10	3	0.0004527%	661028	99.75%	3	1.22%
碾	3736		15	3	0.0004527%	661031	99.75%	2	0.81%
磺	3737		17	3	0.0004527%	661034	99.75%	2	0.81%
礪	3738		20	3	0.0004527%	661037	99.75%	3	1.22%
祁	3739		7	3	0.0004527%	661040	99.75%	2	0.81%
祕	3740		9	3	0.0004527%	661043	99.75%	1	0.40%
穢	3741		18	3	0.0004527%	661046	99.75%	3	1.22%
窈	3742		10	3	0.0004527%	661049	99.75%	3	1.22%
窕	3743		11	3	0.0004527%	661052	99.75%	3	1.22%
窠	3744		13	3	0.0004527%	661055	99.75%	3	1.22%
窿	3745		17	3	0.0004527%	661058	99.75%	3	1.22%
笠	3746		11	3	0.0004527%	661061	99.75%	2	0.81%
籤	3747		23	3	0.0004527%	661064	99.75%	2	0.81%
粑	3748		10	3	0.0004527%	661067	99.75%	1	0.40%
糌	3749		15	3	0.0004527%	661070	99.75%	1	0.40%
糯	3750		20	3	0.0004527%	661073	99.75%	2	0.81%
絆	3751		11	3	0.0004527%	661076	99.75%	3	1.22%
絞	3752		12	3	0.0004527%	661079	99.76%	3	1.22%
綸	3753		14	3	0.0004527%	661082	99.76%	3	1.22%
綹	3754		14	3	0.0004527%	661085	99.76%	3	1.22%
繹	3755		19	3	0.0004527%	661088	99.76%	3	1.22%
纂	3756		20	3	0.0004527%	661091	99.76%	3	1.22%
纔	3757		23	3	0.0004527%	661094	99.76%	2	0.81%
罹	3758		16	3	0.0004527%	661097	99.76%	2	0.81%
羈	3759		24	3	0.0004527%	661100	99.76%	3	1.22%
羥	3760		13	3	0.0004527%	661103	99.76%	2	0.81%
翎	3761		11	3	0.0004527%	661106	99.76%	3	1.22%
肋	3762		6	3	0.0004527%	661109	99.76%	3	1.22%
膿	3763		17	3	0.0004527%	661112	99.76%	1	0.40%
舷	3764		11	3	0.0004527%	661115	99.76%	3	1.22%
舶	3765		11	3	0.0004527%	661118	99.76%	3	1.22%
芯	3766		8	3	0.0004527%	661121	99.76%	3	1.22%
茗	3767		10	3	0.0004527%	661124	99.76%	1	0.40%
莖	3768		11	3	0.0004527%	661127	99.76%	3	1.22%
莆	3769		11	3	0.0004527%	661130	99.76%	1	0.40%
莧	3770		11	3	0.0004527%	661133	99.76%	2	0.81%
萵	3771		13	3	0.0004527%	661136	99.76%	1	0.40%
蒲	3772		14	3	0.0004527%	661139	99.76%	3	1.22%
蕾	3773		17	3	0.0004527%	661142	99.76%	3	1.22%
薇	3774		17	3	0.0004527%	661145	99.77%	2	0.81%
藐	3775		18	3	0.0004527%	661148	99.77%	2	0.81%
蘚	3776		21	3	0.0004527%	661151	99.77%	3	1.22%
蚓	3777		10	3	0.0004527%	661154	99.77%	1	0.40%
蚕	3778		10	3	0.0004527%	661157	99.77%	3	1.22%
蚯	3779		11	3	0.0004527%	661160	99.77%	1	0.40%
蛹	3780		13	3	0.0004527%	661163	99.77%	2	0.81%
蛻	3781		13	3	0.0004527%	661166	99.77%	3	1.22%
蝠	3782		15	3	0.0004527%	661169	99.77%	2	0.81%
蝙	3783		15	3	0.0004527%	661172	99.77%	2	0.81%
蠋	3784		19	3	0.0004527%	661175	99.77%	2	0.81%
襁	3785		16	3	0.0004527%	661178	99.77%	3	1.22%
訛	3786		11	3	0.0004527%	661181	99.77%	3	1.22%
詠	3787		12	3	0.0004527%	661184	99.77%	2	0.81%
詮	3788		13	3	0.0004527%	661187	99.77%	3	1.22%
誣	3789		14	3	0.0004527%	661190	99.77%	3	1.22%
誹	3790		15	3	0.0004527%	661193	99.77%	3	1.22%
諺	3791		16	3	0.0004527%	661196	99.77%	3	1.22%
諜	3792		16	3	0.0004527%	661199	99.77%	1	0.40%
赭	3793		15	3	0.0004527%	661202	99.77%	2	0.81%
踞	3794		15	3	0.0004527%	661205	99.77%	3	1.22%
踱	3795		16	3	0.0004527%	661208	99.77%	3	1.22%
蹋	3796		17	3	0.0004527%	661211	99.78%	2	0.81%
蹩	3797		18	3	0.0004527%	661214	99.78%	3	1.22%
躇	3798		19	3	0.0004527%	661217	99.78%	3	1.22%
躊	3799		21	3	0.0004527%	661220	99.78%	3	1.22%
輒	3800		14	3	0.0004527%	661223	99.78%	2	0.81%
轅	3801		17	3	0.0004527%	661226	99.78%	3	1.22%
迆	3802		6	3	0.0004527%	661229	99.78%	3	1.22%
遛	3803		13	3	0.0004527%	661232	99.78%	3	1.22%
鈕	3804		12	3	0.0004527%	661235	99.78%	2	0.81%
鈉	3805		12	3	0.0004527%	661238	99.78%	2	0.81%
鉀	3806		13	3	0.0004527%	661241	99.78%	3	1.22%
鉺	3807		14	3	0.0004527%	661244	99.78%	1	0.40%
銹	3808		15	3	0.0004527%	661247	99.78%	3	1.22%
錐	3809		16	3	0.0004527%	661250	99.78%	3	1.22%
鎳	3810		18	3	0.0004527%	661253	99.78%	1	0.40%
鐫	3811		21	3	0.0004527%	661256	99.78%	1	0.40%
鑲	3812		25	3	0.0004527%	661259	99.78%	3	1.22%
閂	3813		9	3	0.0004527%	661262	99.78%	3	1.22%
閡	3814		14	3	0.0004527%	661265	99.78%	2	0.81%
阱	3815		6	3	0.0004527%	661268	99.78%	3	1.22%
阪	3816		6	3	0.0004527%	661271	99.78%	2	0.81%
隅	3817		11	3	0.0004527%	661274	99.78%	3	1.22%
陲	3818		11	3	0.0004527%	661277	99.79%	3	1.22%
雹	3819		13	3	0.0004527%	661280	99.79%	2	0.81%
鞍	3820		15	3	0.0004527%	661283	99.79%	3	1.22%
頷	3821		16	3	0.0004527%	661286	99.79%	3	1.22%
顒	3822		18	3	0.0004527%	661289	99.79%	2	0.81%
飢	3823		10	3	0.0004527%	661292	99.79%	3	1.22%
饅	3824		19	3	0.0004527%	661295	99.79%	3	1.22%
驃	3825		21	3	0.0004527%	661298	99.79%	2	0.81%
鱔	3826		23	3	0.0004527%	661301	99.79%	3	1.22%
鴦	3827		16	3	0.0004527%	661304	99.79%	2	0.81%
鴛	3828		16	3	0.0004527%	661307	99.79%	2	0.81%
鶯	3829		21	3	0.0004527%	661310	99.79%	2	0.81%
鷺	3830		24	3	0.0004527%	661313	99.79%	3	1.22%
鼾	3831		17	3	0.0004527%	661316	99.79%	3	1.22%
丞	3832		6	2	0.0003018%	661318	99.79%	1	0.40%
乇	3833		3	2	0.0003018%	661320	99.79%	2	0.81%
亥	3834		6	2	0.0003018%	661322	99.79%	2	0.81%
仨	3835		5	2	0.0003018%	661324	99.79%	2	0.81%
伢	3836		6	2	0.0003018%	661326	99.79%	2	0.81%
佣	3837		7	2	0.0003018%	661328	99.79%	2	0.81%
侈	3838		8	2	0.0003018%	661330	99.79%	2	0.81%
侖	3839		8	2	0.0003018%	661332	99.79%	2	0.81%
俑	3840		9	2	0.0003018%	661334	99.79%	2	0.81%
俐	3841		9	2	0.0003018%	661336	99.79%	2	0.81%
倩	3842		10	2	0.0003018%	661338	99.79%	2	0.81%
倖	3843		10	2	0.0003018%	661340	99.79%	2	0.81%
偑	3844		11	2	0.0003018%	661342	99.80%	2	0.81%
傀	3845		12	2	0.0003018%	661344	99.80%	1	0.40%
儡	3846		17	2	0.0003018%	661346	99.80%	1	0.40%
儷	3847		21	2	0.0003018%	661348	99.80%	2	0.81%
凰	3848		11	2	0.0003018%	661350	99.80%	2	0.81%
刁	3849		2	2	0.0003018%	661352	99.80%	2	0.81%
刪	3850		7	2	0.0003018%	661354	99.80%	2	0.81%
刨	3851		7	2	0.0003018%	661356	99.80%	2	0.81%
劬	3852		7	2	0.0003018%	661358	99.80%	1	0.40%
募	3853		13	2	0.0003018%	661360	99.80%	2	0.81%
匈	3854		6	2	0.0003018%	661362	99.80%	2	0.81%
吩	3855		7	2	0.0003018%	661364	99.80%	2	0.81%
唆	3856		10	2	0.0003018%	661366	99.80%	2	0.81%
唏	3857		10	2	0.0003018%	661368	99.80%	2	0.81%
唄	3858		10	2	0.0003018%	661370	99.80%	2	0.81%
唬	3859		11	2	0.0003018%	661372	99.80%	1	0.40%
啣	3860		11	2	0.0003018%	661374	99.80%	2	0.81%
啁	3861		11	2	0.0003018%	661376	99.80%	2	0.81%
啐	3862		11	2	0.0003018%	661378	99.80%	2	0.81%
唰	3863		11	2	0.0003018%	661380	99.80%	1	0.40%
啻	3864		12	2	0.0003018%	661382	99.80%	2	0.81%
喔	3865		12	2	0.0003018%	661384	99.80%	2	0.81%
喋	3866		12	2	0.0003018%	661386	99.80%	1	0.40%
啾	3867		12	2	0.0003018%	661388	99.80%	2	0.81%
喑	3868		12	2	0.0003018%	661390	99.80%	2	0.81%
嗡	3869		13	2	0.0003018%	661392	99.80%	2	0.81%
嗩	3870		13	2	0.0003018%	661394	99.80%	2	0.81%
嘧	3871		14	2	0.0003018%	661396	99.80%	1	0.40%
噘	3872		15	2	0.0003018%	661398	99.80%	2	0.81%
嚅	3873		17	2	0.0003018%	661400	99.80%	1	0.40%
囁	3874		21	2	0.0003018%	661402	99.80%	1	0.40%
囔	3875		25	2	0.0003018%	661404	99.80%	1	0.40%
囹	3876		8	2	0.0003018%	661406	99.80%	1	0.40%
圄	3877		10	2	0.0003018%	661408	99.81%	1	0.40%
圭	3878		6	2	0.0003018%	661410	99.81%	1	0.40%
坤	3879		8	2	0.0003018%	661412	99.81%	2	0.81%
垛	3880		9	2	0.0003018%	661414	99.81%	1	0.40%
塈	3881		12	2	0.0003018%	661416	99.81%	1	0.40%
塢	3882		13	2	0.0003018%	661418	99.81%	2	0.81%
塾	3883		14	2	0.0003018%	661420	99.81%	2	0.81%
墥	3884		15	2	0.0003018%	661422	99.81%	2	0.81%
夙	3885		6	2	0.0003018%	661424	99.81%	2	0.81%
奄	3886		8	2	0.0003018%	661426	99.81%	1	0.40%
妍	3887		7	2	0.0003018%	661428	99.81%	2	0.81%
姥	3888		9	2	0.0003018%	661430	99.81%	1	0.40%
娩	3889		10	2	0.0003018%	661432	99.81%	2	0.81%
娼	3890		11	2	0.0003018%	661434	99.81%	2	0.81%
媧	3891		12	2	0.0003018%	661436	99.81%	2	0.81%
嬃	3892		15	2	0.0003018%	661438	99.81%	1	0.40%
孀	3893		20	2	0.0003018%	661440	99.81%	2	0.81%
孬	3894		10	2	0.0003018%	661442	99.81%	2	0.81%
宦	3895		9	2	0.0003018%	661444	99.81%	2	0.81%
尸	3896		3	2	0.0003018%	661446	99.81%	2	0.81%
屯	3897		4	2	0.0003018%	661448	99.81%	1	0.40%
岐	3898		7	2	0.0003018%	661450	99.81%	2	0.81%
峪	3899		10	2	0.0003018%	661452	99.81%	1	0.40%
崑	3900		11	2	0.0003018%	661454	99.81%	1	0.40%
崚	3901		11	2	0.0003018%	661456	99.81%	1	0.40%
嶒	3902		15	2	0.0003018%	661458	99.81%	1	0.40%
帖	3903		8	2	0.0003018%	661460	99.81%	2	0.81%
帛	3904		8	2	0.0003018%	661462	99.81%	1	0.40%
帙	3905		8	2	0.0003018%	661464	99.81%	2	0.81%
帷	3906		11	2	0.0003018%	661466	99.81%	2	0.81%
幄	3907		12	2	0.0003018%	661468	99.81%	2	0.81%
幡	3908		15	2	0.0003018%	661470	99.81%	2	0.81%
庇	3909		7	2	0.0003018%	661472	99.81%	2	0.81%
庚	3910		8	2	0.0003018%	661474	99.81%	2	0.81%
廾	3911		3	2	0.0003018%	661476	99.82%	2	0.81%
弔	3912		4	2	0.0003018%	661478	99.82%	2	0.81%
弩	3913		8	2	0.0003018%	661480	99.82%	2	0.81%
徇	3914		9	2	0.0003018%	661482	99.82%	2	0.81%
徬	3915		13	2	0.0003018%	661484	99.82%	2	0.81%
徭	3916		13	2	0.0003018%	661486	99.82%	1	0.40%
忿	3917		8	2	0.0003018%	661488	99.82%	2	0.81%
怡	3918		8	2	0.0003018%	661490	99.82%	2	0.81%
恃	3919		9	2	0.0003018%	661492	99.82%	2	0.81%
恪	3920		9	2	0.0003018%	661494	99.82%	2	0.81%
恣	3921		10	2	0.0003018%	661496	99.82%	2	0.81%
恁	3922		10	2	0.0003018%	661498	99.82%	2	0.81%
惊	3923		11	2	0.0003018%	661500	99.82%	2	0.81%
愜	3924		12	2	0.0003018%	661502	99.82%	1	0.40%
愎	3925		12	2	0.0003018%	661504	99.82%	2	0.81%
愾	3926		13	2	0.0003018%	661506	99.82%	2	0.81%
憧	3927		15	2	0.0003018%	661508	99.82%	2	0.81%
懅	3928		16	2	0.0003018%	661510	99.82%	2	0.81%
懵	3929		19	2	0.0003018%	661512	99.82%	2	0.81%
懾	3930		21	2	0.0003018%	661514	99.82%	2	0.81%
戕	3931		8	2	0.0003018%	661516	99.82%	2	0.81%
抔	3932		7	2	0.0003018%	661518	99.82%	2	0.81%
捅	3933		10	2	0.0003018%	661520	99.82%	2	0.81%
掇	3934		11	2	0.0003018%	661522	99.82%	1	0.40%
掣	3935		12	2	0.0003018%	661524	99.82%	2	0.81%
揖	3936		12	2	0.0003018%	661526	99.82%	2	0.81%
摒	3937		12	2	0.0003018%	661528	99.82%	2	0.81%
揶	3938		12	2	0.0003018%	661530	99.82%	2	0.81%
揄	3939		12	2	0.0003018%	661532	99.82%	2	0.81%
撂	3940		14	2	0.0003018%	661534	99.82%	2	0.81%
攙	3941		20	2	0.0003018%	661536	99.82%	1	0.40%
敖	3942		11	2	0.0003018%	661538	99.82%	2	0.81%
斃	3943		17	2	0.0003018%	661540	99.82%	2	0.81%
旭	3944		6	2	0.0003018%	661542	99.83%	2	0.81%
晏	3945		10	2	0.0003018%	661544	99.83%	2	0.81%
曖	3946		17	2	0.0003018%	661546	99.83%	2	0.81%
曬	3947		23	2	0.0003018%	661548	99.83%	1	0.40%
胦	3948		9	2	0.0003018%	661550	99.83%	2	0.81%
机	3949		6	2	0.0003018%	661552	99.83%	1	0.40%
杅	3950		7	2	0.0003018%	661554	99.83%	2	0.81%
枉	3951		8	2	0.0003018%	661556	99.83%	2	0.81%
柬	3952		9	2	0.0003018%	661558	99.83%	2	0.81%
柮	3953		9	2	0.0003018%	661560	99.83%	1	0.40%
桀	3954		10	2	0.0003018%	661562	99.83%	2	0.81%
梵	3955		11	2	0.0003018%	661564	99.83%	1	0.40%
楨	3956		13	2	0.0003018%	661566	99.83%	1	0.40%
榆	3957		13	2	0.0003018%	661568	99.83%	2	0.81%
椹	3958		13	2	0.0003018%	661570	99.83%	1	0.40%
楂	3959		13	2	0.0003018%	661572	99.83%	2	0.81%
棰	3960		13	2	0.0003018%	661574	99.83%	2	0.81%
榛	3961		14	2	0.0003018%	661576	99.83%	2	0.81%
榭	3962		14	2	0.0003018%	661578	99.83%	2	0.81%
樵	3963		16	2	0.0003018%	661580	99.83%	2	0.81%
櫛	3964		17	2	0.0003018%	661582	99.83%	2	0.81%
檻	3965		18	2	0.0003018%	661584	99.83%	2	0.81%
欞	3966		28	2	0.0003018%	661586	99.83%	2	0.81%
氆	3967		16	2	0.0003018%	661588	99.83%	1	0.40%
氌	3968		19	2	0.0003018%	661590	99.83%	1	0.40%
氤	3969		10	2	0.0003018%	661592	99.83%	2	0.81%
氮	3970		12	2	0.0003018%	661594	99.83%	2	0.81%
氳	3971		14	2	0.0003018%	661596	99.83%	2	0.81%
汐	3972		6	2	0.0003018%	661598	99.83%	2	0.81%
沁	3973		7	2	0.0003018%	661600	99.83%	2	0.81%
沂	3974		7	2	0.0003018%	661602	99.83%	2	0.81%
泱	3975		8	2	0.0003018%	661604	99.83%	1	0.40%
泠	3976		8	2	0.0003018%	661606	99.83%	2	0.81%
洁	3977		9	2	0.0003018%	661608	99.84%	2	0.81%
洇	3978		9	2	0.0003018%	661610	99.84%	1	0.40%
涮	3979		11	2	0.0003018%	661612	99.84%	2	0.81%
湎	3980		12	2	0.0003018%	661614	99.84%	2	0.81%
澗	3981		15	2	0.0003018%	661616	99.84%	2	0.81%
澹	3982		16	2	0.0003018%	661618	99.84%	1	0.40%
濮	3983		17	2	0.0003018%	661620	99.84%	2	0.81%
濼	3984		18	2	0.0003018%	661622	99.84%	1	0.40%
瀘	3985		19	2	0.0003018%	661624	99.84%	2	0.81%
炖	3986		8	2	0.0003018%	661626	99.84%	2	0.81%
炷	3987		9	2	0.0003018%	661628	99.84%	1	0.40%
烙	3988		10	2	0.0003018%	661630	99.84%	2	0.81%
烷	3989		11	2	0.0003018%	661632	99.84%	1	0.40%
焙	3990		12	2	0.0003018%	661634	99.84%	1	0.40%
煒	3991		13	2	0.0003018%	661636	99.84%	1	0.40%
牟	3992		6	2	0.0003018%	661638	99.84%	2	0.81%
牡	3993		7	2	0.0003018%	661640	99.84%	2	0.81%
犀	3994		12	2	0.0003018%	661642	99.84%	2	0.81%
狽	3995		10	2	0.0003018%	661644	99.84%	2	0.81%
狸	3996		10	2	0.0003018%	661646	99.84%	2	0.81%
猙	3997		11	2	0.0003018%	661648	99.84%	2	0.81%
猝	3998		11	2	0.0003018%	661650	99.84%	2	0.81%
猿	3999		13	2	0.0003018%	661652	99.84%	2	0.81%
獗	4000		15	2	0.0003018%	661654	99.84%	2	0.81%
獰	4001		17	2	0.0003018%	661656	99.84%	2	0.81%
獺	4002		19	2	0.0003018%	661658	99.84%	1	0.40%
玦	4003		8	2	0.0003018%	661660	99.84%	1	0.40%
珀	4004		9	2	0.0003018%	661662	99.84%	2	0.81%
琉	4005		10	2	0.0003018%	661664	99.84%	2	0.81%
珗	4006		10	2	0.0003018%	661666	99.84%	1	0.40%
琥	4007		12	2	0.0003018%	661668	99.84%	2	0.81%
琵	4008		12	2	0.0003018%	661670	99.84%	2	0.81%
琶	4009		12	2	0.0003018%	661672	99.84%	2	0.81%
璜	4010		16	2	0.0003018%	661674	99.85%	2	0.81%
璨	4011		17	2	0.0003018%	661676	99.85%	2	0.81%
璫	4012		17	2	0.0003018%	661678	99.85%	1	0.40%
瓏	4013		20	2	0.0003018%	661680	99.85%	2	0.81%
甄	4014		14	2	0.0003018%	661682	99.85%	2	0.81%
甥	4015		12	2	0.0003018%	661684	99.85%	2	0.81%
甫	4016		7	2	0.0003018%	661686	99.85%	2	0.81%
痍	4017		11	2	0.0003018%	661688	99.85%	2	0.81%
痒	4018		11	2	0.0003018%	661690	99.85%	2	0.81%
瘁	4019		13	2	0.0003018%	661692	99.85%	2	0.81%
痹	4020		13	2	0.0003018%	661694	99.85%	1	0.40%
瘢	4021		15	2	0.0003018%	661696	99.85%	2	0.81%
癜	4022		18	2	0.0003018%	661698	99.85%	2	0.81%
癩	4023		21	2	0.0003018%	661700	99.85%	2	0.81%
癲	4024		24	2	0.0003018%	661702	99.85%	1	0.40%
癹	4025		9	2	0.0003018%	661704	99.85%	2	0.81%
皎	4026		11	2	0.0003018%	661706	99.85%	1	0.40%
皚	4027		15	2	0.0003018%	661708	99.85%	1	0.40%
盅	4028		9	2	0.0003018%	661710	99.85%	2	0.81%
盪	4029		17	2	0.0003018%	661712	99.85%	1	0.40%
盬	4030		18	2	0.0003018%	661714	99.85%	2	0.81%
矜	4031		9	2	0.0003018%	661716	99.85%	2	0.81%
砝	4032		10	2	0.0003018%	661718	99.85%	2	0.81%
砭	4033		10	2	0.0003018%	661720	99.85%	2	0.81%
硅	4034		11	2	0.0003018%	661722	99.85%	1	0.40%
碘	4035		13	2	0.0003018%	661724	99.85%	1	0.40%
碉	4036		13	2	0.0003018%	661726	99.85%	2	0.81%
碣	4037		14	2	0.0003018%	661728	99.85%	2	0.81%
碴	4038		14	2	0.0003018%	661730	99.85%	2	0.81%
磐	4039		15	2	0.0003018%	661732	99.85%	2	0.81%
礁	4040		17	2	0.0003018%	661734	99.85%	1	0.40%
祼	4041		12	2	0.0003018%	661736	99.85%	1	0.40%
禎	4042		13	2	0.0003018%	661738	99.85%	2	0.81%
禦	4043		16	2	0.0003018%	661740	99.86%	2	0.81%
窘	4044		12	2	0.0003018%	661742	99.86%	2	0.81%
窖	4045		12	2	0.0003018%	661744	99.86%	2	0.81%
笆	4046		10	2	0.0003018%	661746	99.86%	2	0.81%
箏	4047		14	2	0.0003018%	661748	99.86%	2	0.81%
箍	4048		14	2	0.0003018%	661750	99.86%	2	0.81%
篙	4049		16	2	0.0003018%	661752	99.86%	1	0.40%
簫	4050		18	2	0.0003018%	661754	99.86%	2	0.81%
粟	4051		12	2	0.0003018%	661756	99.86%	1	0.40%
粼	4052		14	2	0.0003018%	661758	99.86%	1	0.40%
糢	4053		17	2	0.0003018%	661760	99.86%	1	0.40%
絀	4054		11	2	0.0003018%	661762	99.86%	2	0.81%
絻	4055		13	2	0.0003018%	661764	99.86%	2	0.81%
綣	4056		14	2	0.0003018%	661766	99.86%	2	0.81%
緘	4057		15	2	0.0003018%	661768	99.86%	2	0.81%
緝	4058		15	2	0.0003018%	661770	99.86%	2	0.81%
緞	4059		15	2	0.0003018%	661772	99.86%	2	0.81%
繭	4060		19	2	0.0003018%	661774	99.86%	2	0.81%
辮	4061		20	2	0.0003018%	661776	99.86%	2	0.81%
繾	4062		20	2	0.0003018%	661778	99.86%	2	0.81%
纍	4063		21	2	0.0003018%	661780	99.86%	1	0.40%
罌	4064		20	2	0.0003018%	661782	99.86%	1	0.40%
羲	4065		16	2	0.0003018%	661784	99.86%	2	0.81%
羶	4066		19	2	0.0003018%	661786	99.86%	2	0.81%
羹	4067		19	2	0.0003018%	661788	99.86%	2	0.81%
翕	4068		12	2	0.0003018%	661790	99.86%	2	0.81%
翟	4069		14	2	0.0003018%	661792	99.86%	2	0.81%
翱	4070		16	2	0.0003018%	661794	99.86%	2	0.81%
耙	4071		10	2	0.0003018%	661796	99.86%	2	0.81%
聇	4072		11	2	0.0003018%	661798	99.86%	2	0.81%
胛	4073		9	2	0.0003018%	661800	99.86%	2	0.81%
脛	4074		11	2	0.0003018%	661802	99.86%	2	0.81%
腱	4075		13	2	0.0003018%	661804	99.86%	2	0.81%
臆	4076		17	2	0.0003018%	661806	99.87%	2	0.81%
膺	4077		17	2	0.0003018%	661808	99.87%	2	0.81%
膾	4078		17	2	0.0003018%	661810	99.87%	2	0.81%
臏	4079		18	2	0.0003018%	661812	99.87%	1	0.40%
臧	4080		14	2	0.0003018%	661814	99.87%	2	0.81%
臼	4081		6	2	0.0003018%	661816	99.87%	1	0.40%
舫	4082		10	2	0.0003018%	661818	99.87%	2	0.81%
艇	4083		13	2	0.0003018%	661820	99.87%	2	0.81%
艙	4084		16	2	0.0003018%	661822	99.87%	2	0.81%
芍	4085		7	2	0.0003018%	661824	99.87%	2	0.81%
苓	4086		9	2	0.0003018%	661826	99.87%	2	0.81%
荔	4087		10	2	0.0003018%	661828	99.87%	1	0.40%
莘	4088		11	2	0.0003018%	661830	99.87%	1	0.40%
堇	4089		11	2	0.0003018%	661832	99.87%	1	0.40%
萋	4090		12	2	0.0003018%	661834	99.87%	1	0.40%
菁	4091		12	2	0.0003018%	661836	99.87%	2	0.81%
菇	4092		12	2	0.0003018%	661838	99.87%	2	0.81%
萛	4093		12	2	0.0003018%	661840	99.87%	1	0.40%
蒜	4094		14	2	0.0003018%	661842	99.87%	2	0.81%
蒔	4095		14	2	0.0003018%	661844	99.87%	2	0.81%
蕤	4096		16	2	0.0003018%	661846	99.87%	2	0.81%
薑	4097		17	2	0.0003018%	661848	99.87%	1	0.40%
藹	4098		20	2	0.0003018%	661850	99.87%	2	0.81%
虜	4099		13	2	0.0003018%	661852	99.87%	2	0.81%
虫	4100		6	2	0.0003018%	661854	99.87%	2	0.81%
蛆	4101		11	2	0.0003018%	661856	99.87%	1	0.40%
蚱	4102		11	2	0.0003018%	661858	99.87%	2	0.81%
蜃	4103		13	2	0.0003018%	661860	99.87%	2	0.81%
蜡	4104		14	2	0.0003018%	661862	99.87%	1	0.40%
螢	4105		16	2	0.0003018%	661864	99.87%	2	0.81%
螺	4106		17	2	0.0003018%	661866	99.87%	2	0.81%
螬	4107		17	2	0.0003018%	661868	99.87%	1	0.40%
蠐	4108		20	2	0.0003018%	661870	99.87%	1	0.40%
蠶	4109		24	2	0.0003018%	661872	99.88%	2	0.81%
衙	4110		13	2	0.0003018%	661874	99.88%	2	0.81%
袒	4111		10	2	0.0003018%	661876	99.88%	2	0.81%
袛	4112		10	2	0.0003018%	661878	99.88%	1	0.40%
裾	4113		13	2	0.0003018%	661880	99.88%	2	0.81%
訐	4114		10	2	0.0003018%	661882	99.88%	2	0.81%
訕	4115		10	2	0.0003018%	661884	99.88%	2	0.81%
諉	4116		15	2	0.0003018%	661886	99.88%	2	0.81%
諫	4117		16	2	0.0003018%	661888	99.88%	1	0.40%
諳	4118		16	2	0.0003018%	661890	99.88%	2	0.81%
謔	4119		16	2	0.0003018%	661892	99.88%	2	0.81%
謳	4120		18	2	0.0003018%	661894	99.88%	2	0.81%
謮	4121		18	2	0.0003018%	661896	99.88%	1	0.40%
讖	4122		24	2	0.0003018%	661898	99.88%	2	0.81%
豌	4123		15	2	0.0003018%	661900	99.88%	2	0.81%
貽	4124		12	2	0.0003018%	661902	99.88%	2	0.81%
賑	4125		14	2	0.0003018%	661904	99.88%	2	0.81%
贛	4126		24	2	0.0003018%	661906	99.88%	2	0.81%
赦	4127		11	2	0.0003018%	661908	99.88%	2	0.81%
趄	4128		12	2	0.0003018%	661910	99.88%	1	0.40%
趑	4129		13	2	0.0003018%	661912	99.88%	1	0.40%
趺	4130		11	2	0.0003018%	661914	99.88%	2	0.81%
跎	4131		12	2	0.0003018%	661916	99.88%	2	0.81%
跩	4132		13	2	0.0003018%	661918	99.88%	1	0.40%
踉	4133		14	2	0.0003018%	661920	99.88%	1	0.40%
蹂	4134		16	2	0.0003018%	661922	99.88%	2	0.81%
踽	4135		16	2	0.0003018%	661924	99.88%	1	0.40%
蹉	4136		17	2	0.0003018%	661926	99.88%	2	0.81%
蹙	4137		18	2	0.0003018%	661928	99.88%	2	0.81%
蹶	4138		19	2	0.0003018%	661930	99.88%	2	0.81%
躡	4139		25	2	0.0003018%	661932	99.88%	1	0.40%
躪	4140		27	2	0.0003018%	661934	99.88%	2	0.81%
躬	4141		10	2	0.0003018%	661936	99.88%	2	0.81%
辜	4142		12	2	0.0003018%	661938	99.89%	2	0.81%
迦	4143		8	2	0.0003018%	661940	99.89%	1	0.40%
迥	4144		8	2	0.0003018%	661942	99.89%	2	0.81%
逅	4145		9	2	0.0003018%	661944	99.89%	2	0.81%
逍	4146		10	2	0.0003018%	661946	99.89%	2	0.81%
遒	4147		12	2	0.0003018%	661948	99.89%	2	0.81%
遨	4148		14	2	0.0003018%	661950	99.89%	2	0.81%
邂	4149		16	2	0.0003018%	661952	99.89%	2	0.81%
邈	4150		17	2	0.0003018%	661954	99.89%	2	0.81%
邑	4151		7	2	0.0003018%	661956	99.89%	1	0.40%
郅	4152		8	2	0.0003018%	661958	99.89%	2	0.81%
郡	4153		9	2	0.0003018%	661960	99.89%	1	0.40%
酯	4154		13	2	0.0003018%	661962	99.89%	1	0.40%
釁	4155		25	2	0.0003018%	661964	99.89%	2	0.81%
釜	4156		10	2	0.0003018%	661966	99.89%	2	0.81%
鈣	4157		12	2	0.0003018%	661968	99.89%	2	0.81%
鈞	4158		12	2	0.0003018%	661970	99.89%	2	0.81%
鈐	4159		12	2	0.0003018%	661972	99.89%	2	0.81%
鉗	4160		13	2	0.0003018%	661974	99.89%	1	0.40%
鉸	4161		14	2	0.0003018%	661976	99.89%	2	0.81%
錠	4162		16	2	0.0003018%	661978	99.89%	2	0.81%
鍍	4163		17	2	0.0003018%	661980	99.89%	2	0.81%
錨	4164		17	2	0.0003018%	661982	99.89%	2	0.81%
鍘	4165		17	2	0.0003018%	661984	99.89%	2	0.81%
鎔	4166		18	2	0.0003018%	661986	99.89%	2	0.81%
鏘	4167		19	2	0.0003018%	661988	99.89%	2	0.81%
鏗	4168		19	2	0.0003018%	661990	99.89%	2	0.81%
鐀	4169		20	2	0.0003018%	661992	99.89%	2	0.81%
鐮	4170		21	2	0.0003018%	661994	99.89%	1	0.40%
閔	4171		12	2	0.0003018%	661996	99.89%	2	0.81%
閻	4172		16	2	0.0003018%	661998	99.89%	1	0.40%
閹	4173		16	2	0.0003018%	662000	99.89%	2	0.81%
阮	4174		6	2	0.0003018%	662002	99.89%	1	0.40%
陃	4175		8	2	0.0003018%	662004	99.89%	1	0.40%
隄	4176		11	2	0.0003018%	662006	99.90%	1	0.40%
靡	4177		19	2	0.0003018%	662008	99.90%	1	0.40%
靨	4178		23	2	0.0003018%	662010	99.90%	2	0.81%
靶	4179		13	2	0.0003018%	662012	99.90%	2	0.81%
鞅	4180		14	2	0.0003018%	662014	99.90%	2	0.81%
顴	4181		26	2	0.0003018%	662016	99.90%	2	0.81%
颶	4182		17	2	0.0003018%	662018	99.90%	2	0.81%
飪	4183		12	2	0.0003018%	662020	99.90%	1	0.40%
餒	4184		15	2	0.0003018%	662022	99.90%	2	0.81%
馥	4185		18	2	0.0003018%	662024	99.90%	2	0.81%
驄	4186		21	2	0.0003018%	662026	99.90%	1	0.40%
驛	4187		23	2	0.0003018%	662028	99.90%	2	0.81%
鬢	4188		24	2	0.0003018%	662030	99.90%	2	0.81%
魆	4189		15	2	0.0003018%	662032	99.90%	1	0.40%
魘	4190		24	2	0.0003018%	662034	99.90%	2	0.81%
魷	4191		15	2	0.0003018%	662036	99.90%	2	0.81%
鯛	4192		19	2	0.0003018%	662038	99.90%	1	0.40%
鰥	4193		21	2	0.0003018%	662040	99.90%	2	0.81%
鳩	4194		13	2	0.0003018%	662042	99.90%	2	0.81%
鴯	4195		17	2	0.0003018%	662044	99.90%	1	0.40%
鵠	4196		18	2	0.0003018%	662046	99.90%	1	0.40%
鵲	4197		19	2	0.0003018%	662048	99.90%	2	0.81%
鸚	4198		28	2	0.0003018%	662050	99.90%	2	0.81%
鹵	4199		11	2	0.0003018%	662052	99.90%	2	0.81%
齌	4200		18	2	0.0003018%	662054	99.90%	1	0.40%
齪	4201		22	2	0.0003018%	662056	99.90%	2	0.81%
齷	4202		24	2	0.0003018%	662058	99.90%	2	0.81%
万	4203		3	1	0.0001509%	662059	99.90%	1	0.40%
乒	4204		6	1	0.0001509%	662060	99.90%	1	0.40%
乓	4205		6	1	0.0001509%	662061	99.90%	1	0.40%
仃	4206		4	1	0.0001509%	662062	99.90%	1	0.40%
仄	4207		4	1	0.0001509%	662063	99.90%	1	0.40%
伉	4208		6	1	0.0001509%	662064	99.90%	1	0.40%
伓	4209		6	1	0.0001509%	662065	99.90%	1	0.40%
佞	4210		7	1	0.0001509%	662066	99.90%	1	0.40%
伺	4211		7	1	0.0001509%	662067	99.90%	1	0.40%
伶	4212		7	1	0.0001509%	662068	99.90%	1	0.40%
佝	4213		7	1	0.0001509%	662069	99.90%	1	0.40%
佤	4214		7	1	0.0001509%	662070	99.90%	1	0.40%
佬	4215		8	1	0.0001509%	662071	99.91%	1	0.40%
佻	4216		8	1	0.0001509%	662072	99.91%	1	0.40%
侚	4217		8	1	0.0001509%	662073	99.91%	1	0.40%
俟	4218		9	1	0.0001509%	662074	99.91%	1	0.40%
俚	4219		9	1	0.0001509%	662075	99.91%	1	0.40%
俓	4220		9	1	0.0001509%	662076	99.91%	1	0.40%
倣	4221		10	1	0.0001509%	662077	99.91%	1	0.40%
倥	4222		10	1	0.0001509%	662078	99.91%	1	0.40%
倬	4223		10	1	0.0001509%	662079	99.91%	1	0.40%
偭	4224		11	1	0.0001509%	662080	99.91%	1	0.40%
傯	4225		13	1	0.0001509%	662081	99.91%	1	0.40%
僂	4226		13	1	0.0001509%	662082	99.91%	1	0.40%
僥	4227		14	1	0.0001509%	662083	99.91%	1	0.40%
僭	4228		14	1	0.0001509%	662084	99.91%	1	0.40%
儈	4229		15	1	0.0001509%	662085	99.91%	1	0.40%
冼	4230		8	1	0.0001509%	662086	99.91%	1	0.40%
凈	4231		10	1	0.0001509%	662087	99.91%	1	0.40%
刖	4232		6	1	0.0001509%	662088	99.91%	1	0.40%
剷	4233		13	1	0.0001509%	662089	99.91%	1	0.40%
劭	4234		7	1	0.0001509%	662090	99.91%	1	0.40%
劾	4235		8	1	0.0001509%	662091	99.91%	1	0.40%
勰	4236		15	1	0.0001509%	662092	99.91%	1	0.40%
勳	4237		16	1	0.0001509%	662093	99.91%	1	0.40%
匕	4238		2	1	0.0001509%	662094	99.91%	1	0.40%
匼	4239		8	1	0.0001509%	662095	99.91%	1	0.40%
卒	4240		8	1	0.0001509%	662096	99.91%	1	0.40%
卦	4241		8	1	0.0001509%	662097	99.91%	1	0.40%
厥	4242		12	1	0.0001509%	662098	99.91%	1	0.40%
叵	4243		5	1	0.0001509%	662099	99.91%	1	0.40%
吋	4244		6	1	0.0001509%	662100	99.91%	1	0.40%
呎	4245		7	1	0.0001509%	662101	99.91%	1	0.40%
吮	4246		7	1	0.0001509%	662102	99.91%	1	0.40%
吜	4247		7	1	0.0001509%	662103	99.91%	1	0.40%
	4248		8	1	0.0001509%	662104	99.91%	1	0.40%
咿	4249		9	1	0.0001509%	662105	99.91%	1	0.40%
哞	4250		9	1	0.0001509%	662106	99.91%	1	0.40%
唁	4251		10	1	0.0001509%	662107	99.91%	1	0.40%
唑	4252		10	1	0.0001509%	662108	99.91%	1	0.40%
啷	4253		12	1	0.0001509%	662109	99.91%	1	0.40%
喏	4254		12	1	0.0001509%	662110	99.91%	1	0.40%
嗑	4255		13	1	0.0001509%	662111	99.91%	1	0.40%
嗣	4256		13	1	0.0001509%	662112	99.91%	1	0.40%
嗐	4257		13	1	0.0001509%	662113	99.91%	1	0.40%
嗝	4258		13	1	0.0001509%	662114	99.91%	1	0.40%
嗔	4259		13	1	0.0001509%	662115	99.91%	1	0.40%
嗲	4260		13	1	0.0001509%	662116	99.91%	1	0.40%
噎	4261		15	1	0.0001509%	662117	99.91%	1	0.40%
噗	4262		15	1	0.0001509%	662118	99.91%	1	0.40%
噌	4263		15	1	0.0001509%	662119	99.91%	1	0.40%
噁	4264		15	1	0.0001509%	662120	99.91%	1	0.40%
嘬	4265		15	1	0.0001509%	662121	99.91%	1	0.40%
噯	4266		16	1	0.0001509%	662122	99.91%	1	0.40%
噲	4267		16	1	0.0001509%	662123	99.91%	1	0.40%
嚥	4268		19	1	0.0001509%	662124	99.91%	1	0.40%
囈	4269		22	1	0.0001509%	662125	99.91%	1	0.40%
	4270		7	1	0.0001509%	662126	99.91%	1	0.40%
坍	4271		7	1	0.0001509%	662127	99.91%	1	0.40%
埌	4272		10	1	0.0001509%	662128	99.91%	1	0.40%
堲	4273		10	1	0.0001509%	662129	99.91%	1	0.40%
堰	4274		12	1	0.0001509%	662130	99.91%	1	0.40%
	4275		12	1	0.0001509%	662131	99.91%	1	0.40%
堞	4276		12	1	0.0001509%	662132	99.91%	1	0.40%
壅	4277		16	1	0.0001509%	662133	99.91%	1	0.40%
壕	4278		17	1	0.0001509%	662134	99.91%	1	0.40%
壬	4279		4	1	0.0001509%	662135	99.91%	1	0.40%
壹	4280		12	1	0.0001509%	662136	99.91%	1	0.40%
囍	4281		24	1	0.0001509%	662137	99.92%	1	0.40%
奐	4282		9	1	0.0001509%	662138	99.92%	1	0.40%
奓	4283		9	1	0.0001509%	662139	99.92%	1	0.40%
妞	4284		7	1	0.0001509%	662140	99.92%	1	0.40%
姒	4285		8	1	0.0001509%	662141	99.92%	1	0.40%
姣	4286		9	1	0.0001509%	662142	99.92%	1	0.40%
姦	4287		9	1	0.0001509%	662143	99.92%	1	0.40%
娭	4288		10	1	0.0001509%	662144	99.92%	1	0.40%
婀	4289		11	1	0.0001509%	662145	99.92%	1	0.40%
婊	4290		11	1	0.0001509%	662146	99.92%	1	0.40%
媛	4291		12	1	0.0001509%	662147	99.92%	1	0.40%
媿	4292		13	1	0.0001509%	662148	99.92%	1	0.40%
嫗	4293		14	1	0.0001509%	662149	99.92%	1	0.40%
嫖	4294		14	1	0.0001509%	662150	99.92%	1	0.40%
孵	4295		14	1	0.0001509%	662151	99.92%	1	0.40%
孿	4296		22	1	0.0001509%	662152	99.92%	1	0.40%
寐	4297		12	1	0.0001509%	662153	99.92%	1	0.40%
寮	4298		15	1	0.0001509%	662154	99.92%	1	0.40%
尃	4299		10	1	0.0001509%	662155	99.92%	1	0.40%
尥	4300		6	1	0.0001509%	662156	99.92%	1	0.40%
屌	4301		9	1	0.0001509%	662157	99.92%	1	0.40%
岔	4302		7	1	0.0001509%	662158	99.92%	1	0.40%
岫	4303		8	1	0.0001509%	662159	99.92%	1	0.40%
峱	4304		10	1	0.0001509%	662160	99.92%	1	0.40%
崦	4305		11	1	0.0001509%	662161	99.92%	1	0.40%
嵫	4306		12	1	0.0001509%	662162	99.92%	1	0.40%
嵂	4307		12	1	0.0001509%	662163	99.92%	1	0.40%
嵯	4308		13	1	0.0001509%	662164	99.92%	1	0.40%
嵬	4309		13	1	0.0001509%	662165	99.92%	1	0.40%
嵺	4310		14	1	0.0001509%	662166	99.92%	1	0.40%
嶵	4311		16	1	0.0001509%	662167	99.92%	1	0.40%
幵	4312		6	1	0.0001509%	662168	99.92%	1	0.40%
庖	4313		8	1	0.0001509%	662169	99.92%	1	0.40%
廩	4314		16	1	0.0001509%	662170	99.92%	1	0.40%
廿	4315		4	1	0.0001509%	662171	99.92%	1	0.40%
异	4316		6	1	0.0001509%	662172	99.92%	1	0.40%
彔	4317		8	1	0.0001509%	662173	99.92%	1	0.40%
忪	4318		7	1	0.0001509%	662174	99.92%	1	0.40%
怀	4319		7	1	0.0001509%	662175	99.92%	1	0.40%
怙	4320		8	1	0.0001509%	662176	99.92%	1	0.40%
悚	4321		10	1	0.0001509%	662177	99.92%	1	0.40%
悽	4322		11	1	0.0001509%	662178	99.92%	1	0.40%
悸	4323		11	1	0.0001509%	662179	99.92%	1	0.40%
惺	4324		12	1	0.0001509%	662180	99.92%	1	0.40%
愴	4325		13	1	0.0001509%	662181	99.92%	1	0.40%
愿	4326		14	1	0.0001509%	662182	99.92%	1	0.40%
慟	4327		14	1	0.0001509%	662183	99.92%	1	0.40%
慒	4328		14	1	0.0001509%	662184	99.92%	1	0.40%
慓	4329		14	1	0.0001509%	662185	99.92%	1	0.40%
慼	4330		15	1	0.0001509%	662186	99.92%	1	0.40%
憚	4331		15	1	0.0001509%	662187	99.92%	1	0.40%
懋	4332		17	1	0.0001509%	662188	99.92%	1	0.40%
戛	4333		11	1	0.0001509%	662189	99.92%	1	0.40%
戡	4334		13	1	0.0001509%	662190	99.92%	1	0.40%
戢	4335		13	1	0.0001509%	662191	99.92%	1	0.40%
戾	4336		8	1	0.0001509%	662192	99.92%	1	0.40%
扑	4337		5	1	0.0001509%	662193	99.92%	1	0.40%
抃	4338		7	1	0.0001509%	662194	99.92%	1	0.40%
抇	4339		7	1	0.0001509%	662195	99.92%	1	0.40%
拈	4340		8	1	0.0001509%	662196	99.92%	1	0.40%
抻	4341		8	1	0.0001509%	662197	99.92%	1	0.40%
拫	4342		9	1	0.0001509%	662198	99.92%	1	0.40%
捍	4343		10	1	0.0001509%	662199	99.92%	1	0.40%
捋	4344		10	1	0.0001509%	662200	99.92%	1	0.40%
挭	4345		10	1	0.0001509%	662201	99.92%	1	0.40%
捱	4346		11	1	0.0001509%	662202	99.92%	1	0.40%
捫	4347		11	1	0.0001509%	662203	99.93%	1	0.40%
掄	4348		11	1	0.0001509%	662204	99.93%	1	0.40%
捽	4349		11	1	0.0001509%	662205	99.93%	1	0.40%
掽	4350		11	1	0.0001509%	662206	99.93%	1	0.40%
揩	4351		12	1	0.0001509%	662207	99.93%	1	0.40%
揘	4352		12	1	0.0001509%	662208	99.93%	1	0.40%
搨	4353		13	1	0.0001509%	662209	99.93%	1	0.40%
搡	4354		13	1	0.0001509%	662210	99.93%	1	0.40%
摳	4355		14	1	0.0001509%	662211	99.93%	1	0.40%
摽	4356		14	1	0.0001509%	662212	99.93%	1	0.40%
摞	4357		14	1	0.0001509%	662213	99.93%	1	0.40%
摜	4358		14	1	0.0001509%	662214	99.93%	1	0.40%
擼	4359		14	1	0.0001509%	662215	99.93%	1	0.40%
撬	4360		15	1	0.0001509%	662216	99.93%	1	0.40%
撳	4361		15	1	0.0001509%	662217	99.93%	1	0.40%
摰	4362		15	1	0.0001509%	662218	99.93%	1	0.40%
撻	4363		16	1	0.0001509%	662219	99.93%	1	0.40%
撾	4364		16	1	0.0001509%	662220	99.93%	1	0.40%
擗	4365		16	1	0.0001509%	662221	99.93%	1	0.40%
擯	4366		17	1	0.0001509%	662222	99.93%	1	0.40%
攛	4367		21	1	0.0001509%	662223	99.93%	1	0.40%
攸	4368		7	1	0.0001509%	662224	99.93%	1	0.40%
敕	4369		11	1	0.0001509%	662225	99.93%	1	0.40%
敨	4370		12	1	0.0001509%	662226	99.93%	1	0.40%
斛	4371		11	1	0.0001509%	662227	99.93%	1	0.40%
旃	4372		10	1	0.0001509%	662228	99.93%	1	0.40%
旎	4373		11	1	0.0001509%	662229	99.93%	1	0.40%
旖	4374		14	1	0.0001509%	662230	99.93%	1	0.40%
旯	4375		6	1	0.0001509%	662231	99.93%	1	0.40%
旮	4376		6	1	0.0001509%	662232	99.93%	1	0.40%
昤	4377		9	1	0.0001509%	662233	99.93%	1	0.40%
昵	4378		9	1	0.0001509%	662234	99.93%	1	0.40%
昫	4379		9	1	0.0001509%	662235	99.93%	1	0.40%
晤	4380		11	1	0.0001509%	662236	99.93%	1	0.40%
暱	4381		15	1	0.0001509%	662237	99.93%	1	0.40%
暹	4382		16	1	0.0001509%	662238	99.93%	1	0.40%
曄	4383		16	1	0.0001509%	662239	99.93%	1	0.40%
曝	4384		19	1	0.0001509%	662240	99.93%	1	0.40%
曦	4385		20	1	0.0001509%	662241	99.93%	1	0.40%
曩	4386		21	1	0.0001509%	662242	99.93%	1	0.40%
朮	4387		5	1	0.0001509%	662243	99.93%	1	0.40%
杵	4388		8	1	0.0001509%	662244	99.93%	1	0.40%
杲	4389		8	1	0.0001509%	662245	99.93%	1	0.40%
柩	4390		9	1	0.0001509%	662246	99.93%	1	0.40%
柢	4391		9	1	0.0001509%	662247	99.93%	1	0.40%
枷	4392		9	1	0.0001509%	662248	99.93%	1	0.40%
柭	4393		9	1	0.0001509%	662249	99.93%	1	0.40%
栝	4394		10	1	0.0001509%	662250	99.93%	1	0.40%
梗	4395		11	1	0.0001509%	662251	99.93%	1	0.40%
梟	4396		11	1	0.0001509%	662252	99.93%	1	0.40%
梜	4397		11	1	0.0001509%	662253	99.93%	1	0.40%
桷	4398		11	1	0.0001509%	662254	99.93%	1	0.40%
棣	4399		12	1	0.0001509%	662255	99.93%	1	0.40%
椏	4400		12	1	0.0001509%	662256	99.93%	1	0.40%
棖	4401		12	1	0.0001509%	662257	99.93%	1	0.40%
楫	4402		13	1	0.0001509%	662258	99.93%	1	0.40%
楸	4403		13	1	0.0001509%	662259	99.93%	1	0.40%
榫	4404		14	1	0.0001509%	662260	99.93%	1	0.40%
槌	4405		14	1	0.0001509%	662261	99.93%	1	0.40%
榖	4406		14	1	0.0001509%	662262	99.93%	1	0.40%
榧	4407		14	1	0.0001509%	662263	99.93%	1	0.40%
橄	4408		16	1	0.0001509%	662264	99.93%	1	0.40%
檁	4409		17	1	0.0001509%	662265	99.93%	1	0.40%
檥	4410		17	1	0.0001509%	662266	99.93%	1	0.40%
檳	4411		18	1	0.0001509%	662267	99.93%	1	0.40%
櫚	4412		19	1	0.0001509%	662268	99.93%	1	0.40%
櫨	4413		20	1	0.0001509%	662269	99.93%	1	0.40%
欖	4414		25	1	0.0001509%	662270	99.94%	1	0.40%
歅	4415		13	1	0.0001509%	662271	99.94%	1	0.40%
歎	4416		15	1	0.0001509%	662272	99.94%	1	0.40%
歙	4417		16	1	0.0001509%	662273	99.94%	1	0.40%
殞	4418		14	1	0.0001509%	662274	99.94%	1	0.40%
殫	4419		16	1	0.0001509%	662275	99.94%	1	0.40%
殮	4420		17	1	0.0001509%	662276	99.94%	1	0.40%
殯	4421		18	1	0.0001509%	662277	99.94%	1	0.40%
殲	4422		21	1	0.0001509%	662278	99.94%	1	0.40%
殳	4423		4	1	0.0001509%	662279	99.94%	1	0.40%
毆	4424		15	1	0.0001509%	662280	99.94%	1	0.40%
毈	4425		16	1	0.0001509%	662281	99.94%	1	0.40%
毗	4426		9	1	0.0001509%	662282	99.94%	1	0.40%
毽	4427		13	1	0.0001509%	662283	99.94%	1	0.40%
氅	4428		16	1	0.0001509%	662284	99.94%	1	0.40%
氐	4429		5	1	0.0001509%	662285	99.94%	1	0.40%
氟	4430		9	1	0.0001509%	662286	99.94%	1	0.40%
氰	4431		12	1	0.0001509%	662287	99.94%	1	0.40%
汙	4432		6	1	0.0001509%	662288	99.94%	1	0.40%
汲	4433		7	1	0.0001509%	662289	99.94%	1	0.40%
汾	4434		7	1	0.0001509%	662290	99.94%	1	0.40%
汸	4435		7	1	0.0001509%	662291	99.94%	1	0.40%
汩	4436		7	1	0.0001509%	662292	99.94%	1	0.40%
沬	4437		8	1	0.0001509%	662293	99.94%	1	0.40%
泔	4438		8	1	0.0001509%	662294	99.94%	1	0.40%
泞	4439		8	1	0.0001509%	662295	99.94%	1	0.40%
洸	4440		9	1	0.0001509%	662296	99.94%	1	0.40%
洮	4441		9	1	0.0001509%	662297	99.94%	1	0.40%
洵	4442		9	1	0.0001509%	662298	99.94%	1	0.40%
浚	4443		10	1	0.0001509%	662299	99.94%	1	0.40%
涅	4444		10	1	0.0001509%	662300	99.94%	1	0.40%
浠	4445		10	1	0.0001509%	662301	99.94%	1	0.40%
涂	4446		10	1	0.0001509%	662302	99.94%	1	0.40%
淇	4447		11	1	0.0001509%	662303	99.94%	1	0.40%
渚	4448		11	1	0.0001509%	662304	99.94%	1	0.40%
淖	4449		11	1	0.0001509%	662305	99.94%	1	0.40%
渥	4450		12	1	0.0001509%	662306	99.94%	1	0.40%
湄	4451		12	1	0.0001509%	662307	99.94%	1	0.40%
湲	4452		12	1	0.0001509%	662308	99.94%	1	0.40%
溤	4453		12	1	0.0001509%	662309	99.94%	1	0.40%
滂	4454		13	1	0.0001509%	662310	99.94%	1	0.40%
滇	4455		13	1	0.0001509%	662311	99.94%	1	0.40%
溥	4456		13	1	0.0001509%	662312	99.94%	1	0.40%
溽	4457		13	1	0.0001509%	662313	99.94%	1	0.40%
滘	4458		13	1	0.0001509%	662314	99.94%	1	0.40%
漱	4459		14	1	0.0001509%	662315	99.94%	1	0.40%
滻	4460		14	1	0.0001509%	662316	99.94%	1	0.40%
潎	4461		14	1	0.0001509%	662317	99.94%	1	0.40%
滹	4462		14	1	0.0001509%	662318	99.94%	1	0.40%
潦	4463		15	1	0.0001509%	662319	99.94%	1	0.40%
潸	4464		15	1	0.0001509%	662320	99.94%	1	0.40%
滕	4465		15	1	0.0001509%	662321	99.94%	1	0.40%
瀆	4466		18	1	0.0001509%	662322	99.94%	1	0.40%
灝	4467		24	1	0.0001509%	662323	99.94%	1	0.40%
灠	4468		24	1	0.0001509%	662324	99.94%	1	0.40%
炬	4469		9	1	0.0001509%	662325	99.94%	1	0.40%
烴	4470		11	1	0.0001509%	662326	99.94%	1	0.40%
煇	4471		13	1	0.0001509%	662327	99.94%	1	0.40%
熒	4472		14	1	0.0001509%	662328	99.94%	1	0.40%
熹	4473		16	1	0.0001509%	662329	99.94%	1	0.40%
燠	4474		17	1	0.0001509%	662330	99.94%	1	0.40%
爻	4475		4	1	0.0001509%	662331	99.94%	1	0.40%
爿	4476		4	1	0.0001509%	662332	99.94%	1	0.40%
牒	4477		13	1	0.0001509%	662333	99.94%	1	0.40%
牝	4478		6	1	0.0001509%	662334	99.94%	1	0.40%
牠	4479		7	1	0.0001509%	662335	99.94%	1	0.40%
牾	4480		11	1	0.0001509%	662336	99.95%	1	0.40%
犍	4481		13	1	0.0001509%	662337	99.95%	1	0.40%
獪	4482		16	1	0.0001509%	662338	99.95%	1	0.40%
玖	4483		7	1	0.0001509%	662339	99.95%	1	0.40%
玵	4484		8	1	0.0001509%	662340	99.95%	1	0.40%
玷	4485		9	1	0.0001509%	662341	99.95%	1	0.40%
珂	4486		9	1	0.0001509%	662342	99.95%	1	0.40%
珈	4487		9	1	0.0001509%	662343	99.95%	1	0.40%
珮	4488		10	1	0.0001509%	662344	99.95%	1	0.40%
琇	4489		11	1	0.0001509%	662345	99.95%	1	0.40%
琪	4490		12	1	0.0001509%	662346	99.95%	1	0.40%
琛	4491		12	1	0.0001509%	662347	99.95%	1	0.40%
瑙	4492		13	1	0.0001509%	662348	99.95%	1	0.40%
瑛	4493		13	1	0.0001509%	662349	99.95%	1	0.40%
瑋	4494		13	1	0.0001509%	662350	99.95%	1	0.40%
瑢	4495		14	1	0.0001509%	662351	99.95%	1	0.40%
璽	4496		19	1	0.0001509%	662352	99.95%	1	0.40%
瓘	4497		22	1	0.0001509%	662353	99.95%	1	0.40%
甑	4498		17	1	0.0001509%	662354	99.95%	1	0.40%
甬	4499		7	1	0.0001509%	662355	99.95%	1	0.40%
畎	4500		9	1	0.0001509%	662356	99.95%	1	0.40%
畚	4501		10	1	0.0001509%	662357	99.95%	1	0.40%
畦	4502		11	1	0.0001509%	662358	99.95%	1	0.40%
畿	4503		15	1	0.0001509%	662359	99.95%	1	0.40%
疹	4504		10	1	0.0001509%	662360	99.95%	1	0.40%
疸	4505		10	1	0.0001509%	662361	99.95%	1	0.40%
痌	4506		11	1	0.0001509%	662362	99.95%	1	0.40%
	4507		13	1	0.0001509%	662363	99.95%	1	0.40%
痲	4508		13	1	0.0001509%	662364	99.95%	1	0.40%
痱	4509		13	1	0.0001509%	662365	99.95%	1	0.40%
痳	4510		13	1	0.0001509%	662366	99.95%	1	0.40%
痼	4511		13	1	0.0001509%	662367	99.95%	1	0.40%
瘐	4512		13	1	0.0001509%	662368	99.95%	1	0.40%
痽	4513		13	1	0.0001509%	662369	99.95%	1	0.40%
瘧	4514		14	1	0.0001509%	662370	99.95%	1	0.40%
瘖	4515		14	1	0.0001509%	662371	99.95%	1	0.40%
癥	4516		20	1	0.0001509%	662372	99.95%	1	0.40%
癸	4517		9	1	0.0001509%	662373	99.95%	1	0.40%
皈	4518		9	1	0.0001509%	662374	99.95%	1	0.40%
皙	4519		13	1	0.0001509%	662375	99.95%	1	0.40%
皿	4520		5	1	0.0001509%	662376	99.95%	1	0.40%
盂	4521		8	1	0.0001509%	662377	99.95%	1	0.40%
盍	4522		10	1	0.0001509%	662378	99.95%	1	0.40%
盹	4523		9	1	0.0001509%	662379	99.95%	1	0.40%
眛	4524		10	1	0.0001509%	662380	99.95%	1	0.40%
眥	4525		11	1	0.0001509%	662381	99.95%	1	0.40%
睨	4526		13	1	0.0001509%	662382	99.95%	1	0.40%
睚	4527		13	1	0.0001509%	662383	99.95%	1	0.40%
睽	4528		14	1	0.0001509%	662384	99.95%	1	0.40%
瞳	4529		17	1	0.0001509%	662385	99.95%	1	0.40%
瞵	4530		17	1	0.0001509%	662386	99.95%	1	0.40%
瞿	4531		18	1	0.0001509%	662387	99.95%	1	0.40%
矍	4532		20	1	0.0001509%	662388	99.95%	1	0.40%
砣	4533		10	1	0.0001509%	662389	99.95%	1	0.40%
硒	4534		11	1	0.0001509%	662390	99.95%	1	0.40%
硤	4535		12	1	0.0001509%	662391	99.95%	1	0.40%
磊	4536		15	1	0.0001509%	662392	99.95%	1	0.40%
磈	4537		15	1	0.0001509%	662393	99.95%	1	0.40%
磣	4538		16	1	0.0001509%	662394	99.95%	1	0.40%
磴	4539		17	1	0.0001509%	662395	99.95%	1	0.40%
磳	4540		17	1	0.0001509%	662396	99.95%	1	0.40%
礔	4541		18	1	0.0001509%	662397	99.95%	1	0.40%
礡	4542		19	1	0.0001509%	662398	99.95%	1	0.40%
祗	4543		9	1	0.0001509%	662399	99.95%	1	0.40%
祺	4544		12	1	0.0001509%	662400	99.95%	1	0.40%
禕	4545		13	1	0.0001509%	662401	99.95%	1	0.40%
禒	4546		13	1	0.0001509%	662402	99.96%	1	0.40%
禧	4547		16	1	0.0001509%	662403	99.96%	1	0.40%
禺	4548		9	1	0.0001509%	662404	99.96%	1	0.40%
种	4549		9	1	0.0001509%	662405	99.96%	1	0.40%
秣	4550		10	1	0.0001509%	662406	99.96%	1	0.40%
秸	4551		11	1	0.0001509%	662407	99.96%	1	0.40%
稜	4552		13	1	0.0001509%	662408	99.96%	1	0.40%
稔	4553		13	1	0.0001509%	662409	99.96%	1	0.40%
稞	4554		13	1	0.0001509%	662410	99.96%	1	0.40%
稷	4555		15	1	0.0001509%	662411	99.96%	1	0.40%
竽	4556		9	1	0.0001509%	662412	99.96%	1	0.40%
笊	4557		10	1	0.0001509%	662413	99.96%	1	0.40%
笴	4558		11	1	0.0001509%	662414	99.96%	1	0.40%
笸	4559		11	1	0.0001509%	662415	99.96%	1	0.40%
筠	4560		13	1	0.0001509%	662416	99.96%	1	0.40%
筱	4561		13	1	0.0001509%	662417	99.96%	1	0.40%
筵	4562		14	1	0.0001509%	662418	99.96%	1	0.40%
箘	4563		14	1	0.0001509%	662419	99.96%	1	0.40%
箴	4564		15	1	0.0001509%	662420	99.96%	1	0.40%
篋	4565		15	1	0.0001509%	662421	99.96%	1	0.40%
篦	4566		16	1	0.0001509%	662422	99.96%	1	0.40%
篱	4567		17	1	0.0001509%	662423	99.96%	1	0.40%
簟	4568		18	1	0.0001509%	662424	99.96%	1	0.40%
籈	4569		19	1	0.0001509%	662425	99.96%	1	0.40%
籐	4570		21	1	0.0001509%	662426	99.96%	1	0.40%
籣	4571		23	1	0.0001509%	662427	99.96%	1	0.40%
粕	4572		11	1	0.0001509%	662428	99.96%	1	0.40%
粵	4573		13	1	0.0001509%	662429	99.96%	1	0.40%
糅	4574		15	1	0.0001509%	662430	99.96%	1	0.40%
紂	4575		9	1	0.0001509%	662431	99.96%	1	0.40%
紉	4576		9	1	0.0001509%	662432	99.96%	1	0.40%
絳	4577		12	1	0.0001509%	662433	99.96%	1	0.40%
絜	4578		12	1	0.0001509%	662434	99.96%	1	0.40%
綑	4579		13	1	0.0001509%	662435	99.96%	1	0.40%
綏	4580		13	1	0.0001509%	662436	99.96%	1	0.40%
綰	4581		14	1	0.0001509%	662437	99.96%	1	0.40%
綺	4582		14	1	0.0001509%	662438	99.96%	1	0.40%
綪	4583		14	1	0.0001509%	662439	99.96%	1	0.40%
縝	4584		16	1	0.0001509%	662440	99.96%	1	0.40%
縉	4585		16	1	0.0001509%	662441	99.96%	1	0.40%
縋	4586		16	1	0.0001509%	662442	99.96%	1	0.40%
繅	4587		17	1	0.0001509%	662443	99.96%	1	0.40%
縳	4588		17	1	0.0001509%	662444	99.96%	1	0.40%
繵	4589		19	1	0.0001509%	662445	99.96%	1	0.40%
缽	4590		11	1	0.0001509%	662446	99.96%	1	0.40%
罔	4591		8	1	0.0001509%	662447	99.96%	1	0.40%
羌	4592		8	1	0.0001509%	662448	99.96%	1	0.40%
翡	4593		14	1	0.0001509%	662449	99.96%	1	0.40%
翬	4594		15	1	0.0001509%	662450	99.96%	1	0.40%
翦	4595		15	1	0.0001509%	662451	99.96%	1	0.40%
耆	4596		10	1	0.0001509%	662452	99.96%	1	0.40%
耹	4597		10	1	0.0001509%	662453	99.96%	1	0.40%
聵	4598		18	1	0.0001509%	662454	99.96%	1	0.40%
聿	4599		6	1	0.0001509%	662455	99.96%	1	0.40%
肓	4600		7	1	0.0001509%	662456	99.96%	1	0.40%
胝	4601		9	1	0.0001509%	662457	99.96%	1	0.40%
胍	4602		9	1	0.0001509%	662458	99.96%	1	0.40%
胰	4603		10	1	0.0001509%	662459	99.96%	1	0.40%
胭	4604		10	1	0.0001509%	662460	99.96%	1	0.40%
胼	4605		10	1	0.0001509%	662461	99.96%	1	0.40%
脤	4606		11	1	0.0001509%	662462	99.96%	1	0.40%
腋	4607		12	1	0.0001509%	662463	99.96%	1	0.40%
膈	4608		14	1	0.0001509%	662464	99.96%	1	0.40%
膲	4609		16	1	0.0001509%	662465	99.96%	1	0.40%
臃	4610		17	1	0.0001509%	662466	99.96%	1	0.40%
舄	4611		12	1	0.0001509%	662467	99.96%	1	0.40%
舐	4612		10	1	0.0001509%	662468	99.96%	1	0.40%
舢	4613		9	1	0.0001509%	662469	99.97%	1	0.40%
舨	4614		10	1	0.0001509%	662470	99.97%	1	0.40%
芋	4615		7	1	0.0001509%	662471	99.97%	1	0.40%
芟	4616		8	1	0.0001509%	662472	99.97%	1	0.40%
芾	4617		8	1	0.0001509%	662473	99.97%	1	0.40%
芮	4618		8	1	0.0001509%	662474	99.97%	1	0.40%
茉	4619		9	1	0.0001509%	662475	99.97%	1	0.40%
苜	4620		9	1	0.0001509%	662476	99.97%	1	0.40%
茴	4621		10	1	0.0001509%	662477	99.97%	1	0.40%
荏	4622		10	1	0.0001509%	662478	99.97%	1	0.40%
茹	4623		10	1	0.0001509%	662479	99.97%	1	0.40%
茨	4624		10	1	0.0001509%	662480	99.97%	1	0.40%
茜	4625		10	1	0.0001509%	662481	99.97%	1	0.40%
茯	4626		10	1	0.0001509%	662482	99.97%	1	0.40%
茧	4627		10	1	0.0001509%	662483	99.97%	1	0.40%
荿	4628		10	1	0.0001509%	662484	99.97%	1	0.40%
莞	4629		11	1	0.0001509%	662485	99.97%	1	0.40%
莒	4630		11	1	0.0001509%	662486	99.97%	1	0.40%
莓	4631		11	1	0.0001509%	662487	99.97%	1	0.40%
莠	4632		11	1	0.0001509%	662488	99.97%	1	0.40%
荼	4633		11	1	0.0001509%	662489	99.97%	1	0.40%
荳	4634		11	1	0.0001509%	662490	99.97%	1	0.40%
荵	4635		11	1	0.0001509%	662491	99.97%	1	0.40%
菠	4636		12	1	0.0001509%	662492	99.97%	1	0.40%
菱	4637		12	1	0.0001509%	662493	99.97%	1	0.40%
葩	4638		13	1	0.0001509%	662494	99.97%	1	0.40%
葆	4639		13	1	0.0001509%	662495	99.97%	1	0.40%
葳	4640		13	1	0.0001509%	662496	99.97%	1	0.40%
蒿	4641		14	1	0.0001509%	662497	99.97%	1	0.40%
蒞	4642		14	1	0.0001509%	662498	99.97%	1	0.40%
蓓	4643		14	1	0.0001509%	662499	99.97%	1	0.40%
蒐	4644		14	1	0.0001509%	662500	99.97%	1	0.40%
蒫	4645		14	1	0.0001509%	662501	99.97%	1	0.40%
蓿	4646		15	1	0.0001509%	662502	99.97%	1	0.40%
蔫	4647		15	1	0.0001509%	662503	99.97%	1	0.40%
蓼	4648		15	1	0.0001509%	662504	99.97%	1	0.40%
蕺	4649		17	1	0.0001509%	662505	99.97%	1	0.40%
薈	4650		17	1	0.0001509%	662506	99.97%	1	0.40%
薸	4651		18	1	0.0001509%	662507	99.97%	1	0.40%
藪	4652		19	1	0.0001509%	662508	99.97%	1	0.40%
蘑	4653		20	1	0.0001509%	662509	99.97%	1	0.40%
虱	4654		8	1	0.0001509%	662510	99.97%	1	0.40%
蚪	4655		10	1	0.0001509%	662511	99.97%	1	0.40%
蚣	4656		10	1	0.0001509%	662512	99.97%	1	0.40%
蚶	4657		11	1	0.0001509%	662513	99.97%	1	0.40%
蜈	4658		13	1	0.0001509%	662514	99.97%	1	0.40%
蜩	4659		14	1	0.0001509%	662515	99.97%	1	0.40%
蜚	4660		14	1	0.0001509%	662516	99.97%	1	0.40%
蝸	4661		15	1	0.0001509%	662517	99.97%	1	0.40%
蝌	4662		15	1	0.0001509%	662518	99.97%	1	0.40%
蝺	4663		15	1	0.0001509%	662519	99.97%	1	0.40%
螯	4664		17	1	0.0001509%	662520	99.97%	1	0.40%
蠣	4665		21	1	0.0001509%	662521	99.97%	1	0.40%
蠹	4666		24	1	0.0001509%	662522	99.97%	1	0.40%
衩	4667		8	1	0.0001509%	662523	99.97%	1	0.40%
袂	4668		9	1	0.0001509%	662524	99.97%	1	0.40%
袪	4669		10	1	0.0001509%	662525	99.97%	1	0.40%
袓	4670		10	1	0.0001509%	662526	99.97%	1	0.40%
袤	4671		11	1	0.0001509%	662527	99.97%	1	0.40%
裱	4672		13	1	0.0001509%	662528	99.97%	1	0.40%
褶	4673		16	1	0.0001509%	662529	99.97%	1	0.40%
褻	4674		17	1	0.0001509%	662530	99.97%	1	0.40%
襌	4675		17	1	0.0001509%	662531	99.97%	1	0.40%
襠	4676		18	1	0.0001509%	662532	99.97%	1	0.40%
覃	4677		12	1	0.0001509%	662533	99.97%	1	0.40%
覷	4678		19	1	0.0001509%	662534	99.97%	1	0.40%
訇	4679		9	1	0.0001509%	662535	99.98%	1	0.40%
訢	4680		11	1	0.0001509%	662536	99.98%	1	0.40%
註	4681		12	1	0.0001509%	662537	99.98%	1	0.40%
詔	4682		12	1	0.0001509%	662538	99.98%	1	0.40%
詆	4683		12	1	0.0001509%	662539	99.98%	1	0.40%
詼	4684		13	1	0.0001509%	662540	99.98%	1	0.40%
詣	4685		13	1	0.0001509%	662541	99.98%	1	0.40%
詹	4686		13	1	0.0001509%	662542	99.98%	1	0.40%
誆	4687		13	1	0.0001509%	662543	99.98%	1	0.40%
諂	4688		15	1	0.0001509%	662544	99.98%	1	0.40%
諍	4689		15	1	0.0001509%	662545	99.98%	1	0.40%
謁	4690		16	1	0.0001509%	662546	99.98%	1	0.40%
諯	4691		16	1	0.0001509%	662547	99.98%	1	0.40%
謅	4692		17	1	0.0001509%	662548	99.98%	1	0.40%
謚	4693		17	1	0.0001509%	662549	99.98%	1	0.40%
譎	4694		19	1	0.0001509%	662550	99.98%	1	0.40%
譪	4695		20	1	0.0001509%	662551	99.98%	1	0.40%
譴	4696		21	1	0.0001509%	662552	99.98%	1	0.40%
豚	4697		11	1	0.0001509%	662553	99.98%	1	0.40%
貂	4698		12	1	0.0001509%	662554	99.98%	1	0.40%
賡	4699		15	1	0.0001509%	662555	99.98%	1	0.40%
贓	4700		21	1	0.0001509%	662556	99.98%	1	0.40%
贖	4701		22	1	0.0001509%	662557	99.98%	1	0.40%
贙	4702		23	1	0.0001509%	662558	99.98%	1	0.40%
趵	4703		10	1	0.0001509%	662559	99.98%	1	0.40%
趿	4704		11	1	0.0001509%	662560	99.98%	1	0.40%
跐	4705		13	1	0.0001509%	662561	99.98%	1	0.40%
踅	4706		14	1	0.0001509%	662562	99.98%	1	0.40%
踝	4707		15	1	0.0001509%	662563	99.98%	1	0.40%
踟	4708		15	1	0.0001509%	662564	99.98%	1	0.40%
踡	4709		15	1	0.0001509%	662565	99.98%	1	0.40%
踮	4710		15	1	0.0001509%	662566	99.98%	1	0.40%
踴	4711		16	1	0.0001509%	662567	99.98%	1	0.40%
踼	4712		16	1	0.0001509%	662568	99.98%	1	0.40%
蹚	4713		18	1	0.0001509%	662569	99.98%	1	0.40%
蹴	4714		19	1	0.0001509%	662570	99.98%	1	0.40%
躆	4715		20	1	0.0001509%	662571	99.98%	1	0.40%
躕	4716		22	1	0.0001509%	662572	99.98%	1	0.40%
躦	4717		26	1	0.0001509%	662573	99.98%	1	0.40%
軔	4718		10	1	0.0001509%	662574	99.98%	1	0.40%
軾	4719		13	1	0.0001509%	662575	99.98%	1	0.40%
輓	4720		14	1	0.0001509%	662576	99.98%	1	0.40%
輟	4721		15	1	0.0001509%	662577	99.98%	1	0.40%
輥	4722		15	1	0.0001509%	662578	99.98%	1	0.40%
轤	4723		23	1	0.0001509%	662579	99.98%	1	0.40%
迍	4724		7	1	0.0001509%	662580	99.98%	1	0.40%
迕	4725		7	1	0.0001509%	662581	99.98%	1	0.40%
迤	4726		8	1	0.0001509%	662582	99.98%	1	0.40%
迨	4727		8	1	0.0001509%	662583	99.98%	1	0.40%
迠	4728		9	1	0.0001509%	662584	99.98%	1	0.40%
适	4729		9	1	0.0001509%	662585	99.98%	1	0.40%
逕	4730		10	1	0.0001509%	662586	99.98%	1	0.40%
逞	4731		10	1	0.0001509%	662587	99.98%	1	0.40%
迼	4732		10	1	0.0001509%	662588	99.98%	1	0.40%
逡	4733		10	1	0.0001509%	662589	99.98%	1	0.40%
遑	4734		12	1	0.0001509%	662590	99.98%	1	0.40%
遢	4735		13	1	0.0001509%	662591	99.98%	1	0.40%
遴	4736		15	1	0.0001509%	662592	99.98%	1	0.40%
邇	4737		17	1	0.0001509%	662593	99.98%	1	0.40%
邋	4738		18	1	0.0001509%	662594	99.98%	1	0.40%
邐	4739		22	1	0.0001509%	662595	99.98%	1	0.40%
邢	4740		6	1	0.0001509%	662596	99.98%	1	0.40%
邵	4741		7	1	0.0001509%	662597	99.98%	1	0.40%
邱	4742		7	1	0.0001509%	662598	99.98%	1	0.40%
酊	4743		9	1	0.0001509%	662599	99.98%	1	0.40%
酐	4744		10	1	0.0001509%	662600	99.98%	1	0.40%
酢	4745		12	1	0.0001509%	662601	99.99%	1	0.40%
酩	4746		13	1	0.0001509%	662602	99.99%	1	0.40%
醃	4747		15	1	0.0001509%	662603	99.99%	1	0.40%
醞	4748		17	1	0.0001509%	662604	99.99%	1	0.40%
醚	4749		17	1	0.0001509%	662605	99.99%	1	0.40%
醛	4750		17	1	0.0001509%	662606	99.99%	1	0.40%
釔	4751		9	1	0.0001509%	662607	99.99%	1	0.40%
釗	4752		10	1	0.0001509%	662608	99.99%	1	0.40%
釽	4753		12	1	0.0001509%	662609	99.99%	1	0.40%
鈾	4754		13	1	0.0001509%	662610	99.99%	1	0.40%
鉑	4755		13	1	0.0001509%	662611	99.99%	1	0.40%
鈿	4756		13	1	0.0001509%	662612	99.99%	1	0.40%
銓	4757		14	1	0.0001509%	662613	99.99%	1	0.40%
銨	4758		14	1	0.0001509%	662614	99.99%	1	0.40%
	4759		15	1	0.0001509%	662615	99.99%	1	0.40%
鋃	4760		15	1	0.0001509%	662616	99.99%	1	0.40%
錛	4761		16	1	0.0001509%	662617	99.99%	1	0.40%
鎂	4762		17	1	0.0001509%	662618	99.99%	1	0.40%
鍊	4763		17	1	0.0001509%	662619	99.99%	1	0.40%
鍥	4764		17	1	0.0001509%	662620	99.99%	1	0.40%
鍚	4765		17	1	0.0001509%	662621	99.99%	1	0.40%
鍜	4766		17	1	0.0001509%	662622	99.99%	1	0.40%
鎊	4767		18	1	0.0001509%	662623	99.99%	1	0.40%
鏃	4768		19	1	0.0001509%	662624	99.99%	1	0.40%
鏖	4769		19	1	0.0001509%	662625	99.99%	1	0.40%
鏤	4770		19	1	0.0001509%	662626	99.99%	1	0.40%
鏹	4771		19	1	0.0001509%	662627	99.99%	1	0.40%
鏽	4772		20	1	0.0001509%	662628	99.99%	1	0.40%
鐉	4773		20	1	0.0001509%	662629	99.99%	1	0.40%
鐳	4774		21	1	0.0001509%	662630	99.99%	1	0.40%
鐺	4775		21	1	0.0001509%	662631	99.99%	1	0.40%
鐸	4776		21	1	0.0001509%	662632	99.99%	1	0.40%
鑊	4777		22	1	0.0001509%	662633	99.99%	1	0.40%
鑣	4778		23	1	0.0001509%	662634	99.99%	1	0.40%
鑫	4779		24	1	0.0001509%	662635	99.99%	1	0.40%
鑾	4780		27	1	0.0001509%	662636	99.99%	1	0.40%
閎	4781		12	1	0.0001509%	662637	99.99%	1	0.40%
閘	4782		13	1	0.0001509%	662638	99.99%	1	0.40%
閞	4783		13	1	0.0001509%	662639	99.99%	1	0.40%
闇	4784		17	1	0.0001509%	662640	99.99%	1	0.40%
陛	4785		9	1	0.0001509%	662641	99.99%	1	0.40%
陜	4786		9	1	0.0001509%	662642	99.99%	1	0.40%
陬	4787		10	1	0.0001509%	662643	99.99%	1	0.40%
隴	4788		18	1	0.0001509%	662644	99.99%	1	0.40%
隼	4789		10	1	0.0001509%	662645	99.99%	1	0.40%
雋	4790		13	1	0.0001509%	662646	99.99%	1	0.40%
巂	4791		18	1	0.0001509%	662647	99.99%	1	0.40%
霪	4792		19	1	0.0001509%	662648	99.99%	1	0.40%
霰	4793		20	1	0.0001509%	662649	99.99%	1	0.40%
靚	4794		15	1	0.0001509%	662650	99.99%	1	0.40%
靴	4795		13	1	0.0001509%	662651	99.99%	1	0.40%
鞘	4796		16	1	0.0001509%	662652	99.99%	1	0.40%
鞠	4797		17	1	0.0001509%	662653	99.99%	1	0.40%
韁	4798		22	1	0.0001509%	662654	99.99%	1	0.40%
頎	4799		13	1	0.0001509%	662655	99.99%	1	0.40%
頧	4800		15	1	0.0001509%	662656	99.99%	1	0.40%
顟	4801		20	1	0.0001509%	662657	99.99%	1	0.40%
顰	4802		24	1	0.0001509%	662658	99.99%	1	0.40%
颺	4803		18	1	0.0001509%	662659	99.99%	1	0.40%
飆	4804		21	1	0.0001509%	662660	99.99%	1	0.40%
飩	4805		12	1	0.0001509%	662661	99.99%	1	0.40%
餛	4806		16	1	0.0001509%	662662	99.99%	1	0.40%
餚	4807		16	1	0.0001509%	662663	99.99%	1	0.40%
餮	4808		18	1	0.0001509%	662664	99.99%	1	0.40%
饈	4809		19	1	0.0001509%	662665	99.99%	1	0.40%
饕	4810		22	1	0.0001509%	662666	99.99%	1	0.40%
饞	4811		25	1	0.0001509%	662667	99.9999999999%	1	0.40%
駒	4812		15	1	0.0001509%	662668	99.9999999999%	1	0.40%
騏	4813		18	1	0.0001509%	662669	99.9999999999%	1	0.40%
騫	4814		20	1	0.0001509%	662670	99.9999999999%	1	0.40%
驍	4815		22	1	0.0001509%	662671	99.9999999999%	1	0.40%
驪	4816		29	1	0.0001509%	662672	99.9999999999%	1	0.40%
骰	4817		14	1	0.0001509%	662673	99.9999999999%	1	0.40%
骷	4818		15	1	0.0001509%	662674	99.9999999999%	1	0.40%
骿	4819		16	1	0.0001509%	662675	99.9999999999%	1	0.40%
髏	4820		21	1	0.0001509%	662676	99.9999999999%	1	0.40%
髯	4821		15	1	0.0001509%	662677	99.9999999999%	1	0.40%
髻	4822		16	1	0.0001509%	662678	99.9999999999%	1	0.40%
魈	4823		17	1	0.0001509%	662679	99.9999999999%	1	0.40%
魑	4824		21	1	0.0001509%	662680	99.9999999999%	1	0.40%
鯉	4825		18	1	0.0001509%	662681	99.9999999999%	1	0.40%
鯁	4826		18	1	0.0001509%	662682	99.9999999999%	1	0.40%
鯨	4827		19	1	0.0001509%	662683	99.9999999999%	1	0.40%
鯧	4828		19	1	0.0001509%	662684	99.9999999999%	1	0.40%
鰍	4829		20	1	0.0001509%	662685	99.9999999999%	1	0.40%
鰻	4830		22	1	0.0001509%	662686	99.9999999999%	1	0.40%
鰲	4831		22	1	0.0001509%	662687	99.9999999999%	1	0.40%
鳶	4832		14	1	0.0001509%	662688	99.9999999999%	1	0.40%
鵖	4833		18	1	0.0001509%	662689	99.9999999999%	1	0.40%
鵡	4834		19	1	0.0001509%	662690	99.9999999999%	1	0.40%
鶩	4835		20	1	0.0001509%	662691	99.9999999999%	1	0.40%
鷗	4836		22	1	0.0001509%	662692	99.9999999999%	1	0.40%
鷸	4837		23	1	0.0001509%	662693	99.9999999999%	1	0.40%
麋	4838		17	1	0.0001509%	662694	99.9999999999%	1	0.40%
麟	4839		23	1	0.0001509%	662695	99.9999999999%	1	0.40%
齟	4840		20	1	0.0001509%	662696	99.9999999999%	1	0.40%
齦	4841		21	1	0.0001509%	662697	99.9999999999%	1	0.40%
齬	4842		22	1	0.0001509%	662698	99.9999999999%	1	0.40%
齲	4843		24	1	0.0001509%	662699	99.9999999999%	1	0.40%
鸗	4844		28	1	0.0001509%	662700	99.9999999999%	1	0.40%
