單字	序號	部首	筆劃	頻次	頻率	累積頻次	累積頻率	見檔次	見檔率
的	1		8	30617	4.624%	30617	4.624%	327	99.99%
一	2		1	10915	1.648%	41532	6.272%	324	99.08%
是	3		9	8823	1.333%	50355	7.605%	299	91.44%
了	4		2	8252	1.246%	58607	8.851%	323	98.78%
在	5		6	7297	1.102%	65904	9.953%	327	99.99%
不	6		4	6405	0.9673%	72309	10.92%	291	88.99%
人	7		2	5612	0.8476%	77921	11.77%	312	95.41%
這	8		10	5510	0.8322%	83431	12.60%	307	93.88%
有	9		6	5343	0.8069%	88774	13.41%	310	94.80%
我	10		7	5271	0.7961%	94045	14.20%	229	70.03%
們	11		10	4813	0.7269%	98858	14.93%	285	87.16%
大	12		3	4627	0.6988%	103485	15.63%	312	95.41%
和	13		8	4445	0.6713%	107930	16.30%	319	97.55%
上	14		3	4182	0.6316%	112112	16.93%	299	91.44%
地	15		6	4054	0.6123%	116166	17.54%	295	90.21%
來	16		8	4012	0.6059%	120178	18.15%	284	86.85%
個	17		10	3996	0.6035%	124174	18.75%	289	88.38%
中	18		4	3760	0.5679%	127934	19.32%	306	93.58%
他	19		5	3480	0.5256%	131414	19.85%	275	84.10%
國	20		11	3470	0.5241%	134884	20.37%	272	83.18%
到	21		8	3280	0.4954%	138164	20.87%	294	89.91%
主	22		5	3272	0.4942%	141436	21.36%	263	80.43%
就	23		12	2932	0.4428%	144368	21.80%	256	78.29%
要	24		9	2914	0.4401%	147282	22.24%	265	81.04%
為	25		9	2825	0.4267%	150107	22.67%	293	89.60%
著	26		12	2809	0.4242%	152916	23.09%	210	64.22%
年	27		6	2794	0.422%	155710	23.52%	261	79.82%
作	28		7	2599	0.3925%	158309	23.91%	254	77.68%
以	29		5	2550	0.3851%	160859	24.29%	295	90.21%
時	30		10	2542	0.3839%	163401	24.68%	293	89.60%
說	31		14	2468	0.3727%	165869	25.05%	241	73.70%
子	32		3	2420	0.3655%	168289	25.42%	218	66.67%
會	33		13	2408	0.3637%	170697	25.78%	273	83.49%
出	34		5	2366	0.3573%	173063	26.14%	289	88.38%
生	35		5	2358	0.3561%	175421	26.49%	265	81.04%
產	36		11	2347	0.3545%	177768	26.85%	212	64.83%
工	37		3	2238	0.338%	180006	27.19%	234	71.56%
學	38		16	2236	0.3377%	182242	27.52%	192	58.72%
動	39		11	2187	0.3303%	184429	27.85%	267	81.65%
下	40		3	2181	0.3294%	186610	28.18%	268	81.96%
也	41		3	2179	0.3291%	188789	28.51%	262	80.12%
義	42		13	2107	0.3182%	190896	28.83%	211	64.53%
得	43		11	2092	0.3159%	192988	29.15%	261	79.82%
十	44		2	2091	0.3158%	195079	29.46%	257	78.59%
民	45		5	2024	0.3057%	197103	29.77%	226	69.11%
裏	46		13	2003	0.3025%	199106	30.07%	196	59.94%
對	47		14	1983	0.2995%	201089	30.37%	279	85.32%
過	48		12	1981	0.2992%	203070	30.67%	259	79.20%
多	49		6	1933	0.2919%	205003	30.96%	277	84.71%
同	50		6	1928	0.2912%	206931	31.25%	283	86.54%
命	51		8	1839	0.2777%	208770	31.53%	178	54.43%
能	52		10	1829	0.2762%	210599	31.81%	229	70.03%
用	53		5	1827	0.2759%	212426	32.08%	248	75.84%
家	54		10	1784	0.2694%	214210	32.35%	240	73.39%
發	55		12	1783	0.2693%	215993	32.62%	264	80.73%
成	56		6	1757	0.2654%	217750	32.89%	262	80.12%
革	57		9	1724	0.2604%	219474	33.15%	140	42.81%
行	58		6	1719	0.2596%	221193	33.41%	283	86.54%
那	59		6	1693	0.2557%	222886	33.66%	198	60.55%
好	60		6	1689	0.2551%	224575	33.92%	231	70.64%
於	61		8	1664	0.2513%	226239	34.17%	261	79.82%
去	62		5	1662	0.251%	227901	34.42%	228	69.72%
想	63		13	1657	0.2503%	229558	34.67%	187	57.19%
面	64		9	1645	0.2484%	231203	34.92%	243	74.31%
起	65		10	1644	0.2483%	232847	35.17%	234	71.56%
可	66		5	1632	0.2465%	234479	35.41%	228	69.72%
自	67		6	1632	0.2465%	236111	35.66%	237	72.48%
方	68		4	1612	0.2435%	237723	35.90%	237	72.48%
而	69		6	1608	0.2429%	239331	36.15%	236	72.17%
天	70		4	1579	0.2385%	240910	36.38%	239	73.09%
種	71		14	1574	0.2377%	242484	36.62%	227	69.42%
都	72		9	1573	0.2376%	244057	36.86%	251	76.76%
把	73		7	1560	0.2356%	245617	37.09%	224	68.50%
經	74		13	1552	0.2344%	247169	37.33%	252	77.06%
進	75		11	1546	0.2335%	248715	37.56%	282	86.24%
水	76		4	1535	0.2318%	250250	37.79%	181	55.35%
現	77		11	1517	0.2291%	251767	38.02%	229	70.03%
級	78		10	1505	0.2273%	253272	38.25%	133	40.67%
分	79		4	1475	0.2228%	254747	38.47%	250	76.45%
還	80		16	1461	0.2207%	256208	38.69%	255	77.98%
看	81		9	1453	0.2194%	257661	38.91%	179	54.74%
小	82		3	1439	0.2173%	259100	39.13%	199	60.86%
三	83		3	1433	0.2164%	260533	39.35%	245	74.92%
從	84		11	1432	0.2163%	261965	39.56%	232	70.95%
樣	85		15	1428	0.2157%	263393	39.78%	208	63.61%
階	86		11	1422	0.2148%	264815	39.99%	127	38.84%
部	87		10	1376	0.2078%	266191	40.20%	243	74.31%
後	88		9	1365	0.2062%	267556	40.41%	266	81.35%
社	89		7	1351	0.204%	268907	40.61%	166	50.76%
正	90		5	1350	0.2039%	270257	40.82%	236	72.17%
前	91		9	1335	0.2016%	271592	41.02%	255	77.98%
思	92		9	1335	0.2016%	272927	41.22%	174	53.21%
無	93		12	1333	0.2013%	274260	41.42%	213	65.14%
本	94		5	1324	0.200%	275584	41.62%	209	63.91%
高	95		10	1315	0.1986%	276899	41.82%	254	77.68%
然	96		12	1314	0.1984%	278213	42.02%	204	62.39%
文	97		4	1313	0.1983%	279526	42.22%	154	47.09%
理	98		11	1306	0.1972%	280832	42.41%	203	62.08%
山	99		3	1287	0.1944%	282119	42.61%	143	43.73%
實	100		14	1281	0.1935%	283400	42.80%	207	63.30%
些	101		8	1278	0.193%	284678	42.99%	234	71.56%
當	102		13	1266	0.1912%	285944	43.19%	232	70.95%
開	103		12	1257	0.1898%	287201	43.38%	236	72.17%
麼	104		14	1255	0.1895%	288456	43.56%	170	51.99%
日	105		4	1245	0.188%	289701	43.75%	218	66.67%
老	106		6	1233	0.1862%	290934	43.94%	156	47.71%
全	107		6	1230	0.1858%	292164	44.12%	253	77.37%
長	108		8	1226	0.1852%	293390	44.31%	241	73.70%
又	109		2	1214	0.1833%	294604	44.49%	215	65.75%
反	110		4	1213	0.1832%	295817	44.68%	203	62.08%
它	111		5	1180	0.1782%	296997	44.85%	202	61.77%
所	112		8	1178	0.1779%	298175	45.03%	223	68.20%
二	113		2	1172	0.177%	299347	45.21%	233	71.25%
事	114		8	1167	0.1762%	300514	45.39%	215	65.75%
之	115		4	1163	0.1756%	301677	45.56%	233	71.25%
鬥	116		10	1158	0.1749%	302835	45.74%	167	51.07%
道	117		12	1155	0.1744%	303990	45.91%	208	63.61%
爭	118		8	1148	0.1734%	305138	46.08%	190	58.10%
力	119		2	1140	0.1722%	306278	46.26%	231	70.64%
美	120		9	1122	0.1695%	307400	46.43%	152	46.48%
政	121		9	1105	0.1669%	308505	46.59%	152	46.48%
毛	122		4	1098	0.1658%	309603	46.76%	139	42.51%
代	123		5	1093	0.1651%	310696	46.92%	189	57.80%
頭	124		16	1090	0.1646%	311786	47.09%	167	51.07%
新	125		13	1081	0.1633%	312867	47.25%	235	71.87%
沒	126		7	1065	0.1608%	313932	47.41%	197	60.24%
農	127		13	1064	0.1607%	314996	47.57%	131	40.06%
你	128		7	1062	0.1604%	316058	47.73%	106	32.42%
心	129		4	1053	0.159%	317111	47.89%	202	61.77%
手	130		4	1045	0.1578%	318156	48.05%	185	56.57%
兩	131		8	1028	0.1553%	319184	48.21%	241	73.70%
黨	132		20	1025	0.1548%	320209	48.36%	141	43.12%
法	133		8	1015	0.1533%	321224	48.51%	183	55.96%
加	134		5	1012	0.1528%	322236	48.67%	250	76.45%
重	135		9	1003	0.1515%	323239	48.82%	224	68.50%
隊	136		11	1002	0.1513%	324241	48.97%	157	48.01%
花	137		8	998	0.1507%	325239	49.12%	127	38.84%
最	138		12	991	0.1497%	326230	49.27%	250	76.45%
化	139		4	990	0.1495%	327220	49.42%	187	57.19%
群	140		13	985	0.1488%	328205	49.57%	161	49.24%
量	141		12	983	0.1485%	329188	49.72%	194	59.33%
論	142		15	969	0.1463%	330157	49.86%	146	44.65%
定	143		8	954	0.1441%	331111	50.01%	213	65.14%
五	144		4	953	0.1439%	332064	50.15%	228	69.72%
使	145		8	953	0.1439%	333017	50.29%	252	77.06%
問	146		11	952	0.1438%	333969	50.44%	180	55.05%
物	147		8	944	0.1426%	334913	50.58%	147	44.95%
點	148		17	943	0.1424%	335856	50.72%	196	59.94%
表	149		8	936	0.1414%	336792	50.86%	203	62.08%
意	150		13	930	0.1405%	337722	51.01%	209	63.91%
戰	151		16	924	0.1395%	338646	51.14%	166	50.76%
利	152		7	919	0.1388%	339565	51.28%	202	61.77%
眾	153		11	911	0.1376%	340476	51.42%	143	43.73%
情	154		11	910	0.1374%	341386	51.56%	203	62.08%
如	155		6	909	0.1373%	342295	51.70%	191	58.41%
但	156		7	892	0.1347%	343187	51.83%	200	61.16%
者	157		8	892	0.1347%	344079	51.97%	179	54.74%
像	158		14	889	0.1343%	344968	52.10%	152	46.48%
走	159		7	888	0.1341%	345856	52.23%	157	48.01%
四	160		5	883	0.1334%	346739	52.37%	198	60.55%
度	161		9	883	0.1334%	347622	52.50%	182	55.66%
很	162		9	882	0.1332%	348504	52.63%	205	62.69%
路	163		13	881	0.1331%	349385	52.77%	167	51.07%
西	164		6	880	0.1329%	350265	52.90%	184	56.27%
東	165		8	879	0.1328%	351144	53.03%	199	60.86%
公	166		4	877	0.1325%	352021	53.16%	188	57.49%
只	167		5	874	0.132%	352895	53.30%	190	58.10%
間	168		12	874	0.132%	353769	53.43%	223	68.20%
等	169		12	864	0.1305%	354633	53.56%	227	69.42%
活	170		9	850	0.1284%	355483	53.69%	190	58.10%
各	171		6	842	0.1272%	356325	53.81%	205	62.69%
結	172		12	839	0.1267%	357164	53.94%	198	60.55%
題	173		18	837	0.1264%	358001	54.07%	133	40.67%
百	174		6	836	0.1263%	358837	54.19%	202	61.77%
員	175		10	822	0.1241%	359659	54.32%	180	55.05%
明	176		8	822	0.1241%	360481	54.44%	198	60.55%
展	177		10	816	0.1232%	361297	54.57%	176	53.82%
氣	178		10	813	0.1228%	362110	54.69%	163	49.85%
業	179		13	806	0.1217%	362916	54.81%	152	46.48%
比	180		4	806	0.1217%	363722	54.93%	205	62.69%
幾	181		12	799	0.1207%	364521	55.05%	176	53.82%
軍	182		9	793	0.1198%	365314	55.17%	142	43.43%
解	183		13	792	0.1196%	366106	55.29%	189	57.80%
海	184		10	791	0.1195%	366897	55.41%	132	40.37%
向	185		6	788	0.119%	367685	55.53%	209	63.91%
她	186		6	777	0.1173%	368462	55.65%	66	20.18%
合	187		6	769	0.1161%	369231	55.76%	196	59.94%
資	188		13	766	0.1157%	369997	55.88%	126	38.53%
萬	189		13	759	0.1146%	370756	55.99%	183	55.96%
其	190		8	757	0.1143%	371513	56.11%	210	64.22%
性	191		8	757	0.1143%	372270	56.22%	159	48.62%
九	192		2	756	0.1142%	373026	56.34%	159	48.62%
聲	193		17	754	0.1139%	373780	56.45%	142	43.43%
月	194		4	753	0.1137%	374533	56.56%	182	55.66%
席	195		10	746	0.1127%	375279	56.68%	117	35.78%
已	196		3	740	0.1118%	376019	56.79%	198	60.55%
外	197		5	732	0.1106%	376751	56.90%	201	61.47%
提	198		12	732	0.1106%	377483	57.01%	200	61.16%
內	199		4	727	0.1098%	378210	57.12%	186	56.88%
體	200		23	724	0.1093%	378934	57.23%	171	52.29%
次	201		6	716	0.1081%	379650	57.34%	206	63.00%
由	202		5	715	0.108%	380365	57.45%	206	63.00%
因	203		6	710	0.1072%	381075	57.55%	185	56.57%
見	204		7	710	0.1072%	381785	57.66%	158	48.32%
放	205		8	709	0.1071%	382494	57.77%	189	57.80%
打	206		5	708	0.1069%	383202	57.87%	176	53.82%
六	207		4	699	0.1056%	383901	57.98%	179	54.74%
教	208		11	698	0.1054%	384599	58.08%	122	37.31%
志	209		7	695	0.105%	385294	58.19%	146	44.65%
關	210		19	694	0.1048%	385988	58.29%	196	59.94%
風	211		9	692	0.1045%	386680	58.40%	159	48.62%
治	212		8	691	0.1044%	387371	58.50%	147	44.95%
領	213		14	690	0.1042%	388061	58.61%	180	55.05%
更	214		7	685	0.1035%	388746	58.71%	182	55.66%
建	215		9	676	0.1021%	389422	58.81%	164	50.15%
白	216		5	671	0.1013%	390093	58.91%	130	39.76%
光	217		6	661	0.09983%	390754	59.01%	151	46.18%
認	218		14	660	0.09968%	391414	59.11%	141	43.12%
造	219		10	657	0.09922%	392071	59.21%	172	52.60%
相	220		9	653	0.09862%	392724	59.31%	174	53.21%
平	221		5	651	0.09832%	393375	59.41%	182	55.66%
立	222		5	647	0.09771%	394022	59.51%	202	61.77%
統	223		11	647	0.09771%	394669	59.61%	152	46.48%
世	224		5	646	0.09756%	395315	59.70%	146	44.65%
己	225		3	642	0.09696%	395957	59.80%	170	51.99%
第	226		11	642	0.09696%	396599	59.90%	173	52.91%
語	227		14	636	0.09605%	397235	59.99%	81	24.77%
導	228		16	634	0.09575%	397869	60.09%	150	45.87%
運	229		12	634	0.09575%	398503	60.18%	163	49.85%
真	230		10	632	0.09545%	399135	60.28%	163	49.85%
回	231		6	629	0.095%	399764	60.38%	146	44.65%
果	232		8	629	0.095%	400393	60.47%	186	56.88%
並	233		8	622	0.09394%	401015	60.56%	216	66.06%
指	234		9	617	0.09318%	401632	60.66%	176	53.82%
少	235		4	614	0.09273%	402246	60.75%	178	54.43%
別	236		7	613	0.09258%	402859	60.84%	177	54.13%
千	237		3	613	0.09258%	403472	60.94%	181	55.35%
原	238		10	610	0.09213%	404082	61.03%	175	53.52%
話	239		13	609	0.09198%	404691	61.12%	148	45.26%
總	240		17	608	0.09182%	405299	61.21%	184	56.27%
界	241		9	606	0.09152%	405905	61.30%	159	48.62%
色	242		6	604	0.09122%	406509	61.39%	127	38.84%
特	243		10	601	0.09077%	407110	61.48%	189	57.80%
條	244		11	598	0.09031%	407708	61.57%	171	52.29%
候	245		10	596	0.09001%	408304	61.66%	159	48.62%
究	246		7	593	0.08956%	408897	61.75%	112	34.25%
給	247		12	593	0.08956%	409490	61.84%	183	55.96%
阿	248		7	593	0.08956%	410083	61.93%	72	22.02%
形	249		7	591	0.08926%	410674	62.02%	147	44.95%
馬	250		10	591	0.08926%	411265	62.11%	163	49.85%
機	251		16	590	0.08911%	411855	62.20%	171	52.29%
科	252		9	590	0.08911%	412445	62.29%	109	33.33%
金	253		8	586	0.0885%	413031	62.38%	107	32.72%
線	254		15	583	0.08805%	413614	62.47%	130	39.76%
紅	255		9	580	0.0876%	414194	62.55%	128	39.14%
通	256		10	576	0.08699%	414770	62.64%	181	55.35%
今	257		4	574	0.08669%	415344	62.73%	201	61.47%
變	258		23	573	0.08654%	415917	62.81%	157	48.01%
做	259		11	571	0.08624%	416488	62.90%	151	46.18%
才	260		3	571	0.08624%	417059	62.99%	162	49.54%
常	261		11	568	0.08578%	417627	63.07%	180	55.05%
名	262		6	566	0.08548%	418193	63.16%	149	45.57%
共	263		6	565	0.08533%	418758	63.24%	174	53.21%
術	264		11	563	0.08503%	419321	63.33%	126	38.53%
決	265		7	562	0.08488%	419883	63.41%	136	41.59%
被	266		10	562	0.08488%	420445	63.50%	177	54.13%
亞	267		8	560	0.08458%	421005	63.58%	87	26.61%
藝	268		19	554	0.08367%	421559	63.67%	60	18.35%
處	269		11	554	0.08367%	422113	63.75%	174	53.21%
場	270		12	551	0.08322%	422664	63.83%	157	48.01%
邊	271		18	551	0.08322%	423215	63.92%	126	38.53%
區	272		11	550	0.08306%	423765	64.00%	144	44.04%
身	273		7	550	0.08306%	424315	64.08%	156	47.71%
觀	274		25	548	0.08276%	424863	64.17%	128	39.14%
兒	275		8	547	0.08261%	425410	64.25%	93	28.44%
南	276		9	547	0.08261%	425957	64.33%	139	42.51%
石	277		5	546	0.08246%	426503	64.41%	100	30.58%
研	278		9	546	0.08246%	427049	64.50%	95	29.05%
車	279		7	546	0.08246%	427595	64.58%	89	27.22%
深	280		11	542	0.08186%	428137	64.66%	166	50.76%
團	281		14	540	0.08155%	428677	64.74%	129	39.45%
此	282		6	536	0.08095%	429213	64.82%	179	54.74%
聯	283		17	534	0.08065%	429747	64.90%	149	45.57%
八	284		2	532	0.08035%	430279	64.98%	164	50.15%
應	285		17	526	0.07944%	430805	65.06%	175	53.52%
眼	286		11	522	0.07884%	431327	65.14%	114	34.86%
期	287		12	521	0.07868%	431848	65.22%	161	49.24%
位	288		7	520	0.07853%	432368	65.30%	169	51.68%
取	289		8	517	0.07808%	432885	65.38%	182	55.66%
知	290		8	511	0.07717%	433396	65.45%	152	46.48%
必	291		5	509	0.07687%	433905	65.53%	136	41.59%
品	292		9	504	0.07612%	434409	65.61%	86	26.30%
船	293		11	501	0.07566%	434910	65.68%	51	15.60%
根	294		10	500	0.07551%	435410	65.76%	160	48.93%
切	295		4	498	0.07521%	435908	65.83%	162	49.54%
組	296		11	497	0.07506%	436405	65.91%	132	40.37%
青	297		8	495	0.07476%	436900	65.98%	120	36.70%
記	298		10	491	0.07415%	437391	66.06%	122	37.31%
流	299		9	488	0.0737%	437879	66.13%	133	40.67%
清	300		11	487	0.07355%	438366	66.21%	152	46.48%
基	301		11	485	0.07325%	438851	66.28%	129	39.45%
及	302		4	483	0.07295%	439334	66.35%	173	52.91%
口	303		3	479	0.07234%	439813	66.42%	145	44.34%
門	304		8	479	0.07234%	440292	66.50%	146	44.65%
入	305		2	477	0.07204%	440769	66.57%	178	54.43%
越	306		12	476	0.07189%	441245	66.64%	126	38.53%
土	307		3	474	0.07159%	441719	66.71%	103	31.50%
廣	308		15	472	0.07128%	442191	66.78%	159	48.62%
甚	309		9	469	0.07083%	442660	66.85%	115	35.17%
改	310		7	467	0.07053%	443127	66.92%	129	39.45%
神	311		9	466	0.07038%	443593	66.99%	144	44.04%
象	312		12	466	0.07038%	444059	67.06%	115	35.17%
春	313		9	465	0.07023%	444524	67.14%	84	25.69%
字	314		6	462	0.06977%	444986	67.20%	105	32.11%
步	315		7	461	0.06962%	445447	67.27%	169	51.68%
幹	316		13	460	0.06947%	445907	67.34%	106	32.42%
拉	317		8	459	0.06932%	446366	67.41%	110	33.64%
聽	318		22	459	0.06932%	446825	67.48%	117	35.78%
爾	319		14	458	0.06917%	447283	67.55%	91	27.83%
英	320		9	458	0.06917%	447741	67.62%	103	31.50%
北	321		5	457	0.06902%	448198	67.69%	133	40.67%
許	322		11	453	0.06842%	448651	67.76%	184	56.27%
務	323		11	452	0.06826%	449103	67.83%	131	40.06%
空	324		8	450	0.06796%	449553	67.89%	146	44.65%
集	325		12	449	0.06781%	450002	67.96%	140	42.81%
強	326		11	448	0.06766%	450450	68.03%	164	50.15%
接	327		11	448	0.06766%	450898	68.10%	182	55.66%
據	328		16	448	0.06766%	451346	68.17%	159	48.62%
完	329		7	447	0.06751%	451793	68.23%	170	51.99%
七	330		2	443	0.0669%	452236	68.30%	153	46.79%
價	331		15	443	0.0669%	452679	68.37%	56	17.13%
計	332		9	443	0.0669%	453122	68.43%	116	35.47%
求	333		7	442	0.06675%	453564	68.50%	121	37.00%
電	334		13	442	0.06675%	454006	68.57%	104	31.80%
修	335		10	439	0.0663%	454445	68.63%	112	34.25%
克	336		7	439	0.0663%	454884	68.70%	137	41.90%
任	337		6	438	0.06615%	455322	68.77%	149	45.57%
數	338		15	438	0.06615%	455760	68.83%	149	45.57%
林	339		8	438	0.06615%	456198	68.90%	109	33.33%
每	340		7	438	0.06615%	456636	68.96%	147	44.95%
直	341		8	438	0.06615%	457074	69.03%	166	50.76%
書	342		10	437	0.066%	457511	69.10%	112	34.25%
驗	343		23	437	0.066%	457948	69.16%	112	34.25%
或	344		8	436	0.06585%	458384	69.23%	139	42.51%
近	345		7	436	0.06585%	458820	69.29%	173	52.91%
住	346		7	431	0.06509%	459251	69.36%	116	35.47%
安	347		6	428	0.06464%	459679	69.42%	120	36.70%
感	348		13	427	0.06449%	460106	69.49%	135	41.28%
料	349		10	426	0.06434%	460532	69.55%	96	29.36%
澤	350		16	425	0.06419%	460957	69.62%	96	29.36%
火	351		4	420	0.06343%	461377	69.68%	110	33.64%
受	352		8	419	0.06328%	461796	69.74%	169	51.68%
將	353		11	419	0.06328%	462215	69.81%	156	47.71%
巴	354		4	419	0.06328%	462634	69.87%	77	23.55%
批	355		7	419	0.06328%	463053	69.93%	115	35.17%
質	356		15	419	0.06328%	463472	70.00%	114	34.86%
目	357		5	417	0.06298%	463889	70.06%	166	50.76%
派	358		9	416	0.06283%	464305	70.12%	116	35.47%
設	359		11	414	0.06253%	464719	70.19%	134	40.98%
勝	360		12	412	0.06222%	465131	70.25%	123	37.61%
與	361		14	408	0.06162%	465539	70.31%	123	37.61%
難	362		19	406	0.06132%	465945	70.37%	161	49.24%
里	363		7	404	0.06101%	466349	70.43%	120	36.70%
列	364		6	403	0.06086%	466752	70.49%	120	36.70%
制	365		8	403	0.06086%	467155	70.55%	133	40.67%
先	366		6	402	0.06071%	467557	70.61%	166	50.76%
寫	367		15	402	0.06071%	467959	70.67%	88	26.91%
報	368		12	401	0.06056%	468360	70.73%	123	37.61%
確	369		15	400	0.06041%	468760	70.80%	119	36.39%
勞	370		12	399	0.06026%	469159	70.86%	119	36.39%
帝	371		9	399	0.06026%	469558	70.92%	102	31.19%
遠	372		13	399	0.06026%	469957	70.98%	141	43.12%
歷	373		16	398	0.06011%	470355	71.04%	117	35.78%
達	374		12	398	0.06011%	470753	71.10%	138	42.20%
愛	375		13	397	0.05996%	471150	71.16%	114	34.86%
堅	376		11	395	0.05966%	471545	71.22%	120	36.70%
言	377		7	394	0.0595%	471939	71.28%	96	29.36%
保	378		9	393	0.05935%	472332	71.33%	150	45.87%
斷	379		18	393	0.05935%	472725	71.39%	156	47.71%
帶	380		11	392	0.0592%	473117	71.45%	140	42.81%
古	381		5	390	0.0589%	473507	71.51%	94	28.75%
印	382		6	389	0.05875%	473896	71.57%	72	22.02%
市	383		5	388	0.0586%	474284	71.63%	110	33.64%
熱	384		15	388	0.0586%	474672	71.69%	143	43.73%
具	385		8	387	0.05845%	475059	71.75%	127	38.84%
舉	386		17	387	0.05845%	475446	71.81%	151	46.18%
女	387		3	385	0.05815%	475831	71.86%	87	26.61%
格	388		10	385	0.05815%	476216	71.92%	110	33.64%
極	389		13	385	0.05815%	476601	71.98%	152	46.48%
史	390		5	382	0.05769%	476983	72.04%	104	31.80%
交	391		6	379	0.05724%	477362	72.09%	130	39.76%
江	392		6	379	0.05724%	477741	72.15%	66	20.18%
落	393		13	378	0.05709%	478119	72.21%	130	39.76%
卻	394		9	377	0.05694%	478496	72.27%	109	33.33%
收	395		6	377	0.05694%	478873	72.32%	122	37.31%
望	396		11	376	0.05679%	479249	72.38%	111	33.94%
什	397		4	375	0.05664%	479624	72.44%	92	28.13%
傳	398		13	375	0.05664%	479999	72.49%	137	41.90%
持	399		9	375	0.05664%	480374	72.55%	146	44.65%
再	400		6	374	0.05648%	480748	72.61%	149	45.57%
河	401		8	374	0.05648%	481122	72.66%	82	25.08%
示	402		5	374	0.05648%	481496	72.72%	128	39.14%
且	403		5	373	0.05633%	481869	72.78%	159	48.62%
策	404		12	373	0.05633%	482242	72.83%	58	17.74%
習	405		11	371	0.05603%	482613	72.89%	113	34.56%
樹	406		16	369	0.05573%	482982	72.94%	89	27.22%
村	407		7	366	0.05528%	483348	73.00%	97	29.66%
歌	408		14	365	0.05512%	483713	73.05%	64	19.57%
快	409		7	363	0.05482%	484076	73.11%	122	37.31%
擊	410		17	363	0.05482%	484439	73.16%	104	31.80%
識	411		19	362	0.05467%	484801	73.22%	102	31.19%
往	412		8	360	0.05437%	485161	73.27%	127	38.84%
際	413		13	360	0.05437%	485521	73.33%	126	38.53%
飛	414		9	360	0.05437%	485881	73.38%	94	28.75%
斯	415		12	359	0.05422%	486240	73.44%	97	29.66%
須	416		12	358	0.05407%	486598	73.49%	110	33.64%
件	417		6	354	0.05346%	486952	73.54%	131	40.06%
整	418		16	353	0.05331%	487305	73.60%	139	42.51%
至	419		6	353	0.05331%	487658	73.65%	149	45.57%
笑	420		10	352	0.05316%	488010	73.70%	69	21.10%
連	421		10	352	0.05316%	488362	73.76%	129	39.45%
增	422		15	350	0.05286%	488712	73.81%	118	36.09%
滿	423		14	350	0.05286%	489062	73.86%	128	39.14%
辦	424		16	350	0.05286%	489412	73.91%	124	37.92%
半	425		5	349	0.05271%	489761	73.97%	118	36.09%
育	426		7	349	0.05271%	490110	74.02%	96	29.36%
覺	427		20	349	0.05271%	490459	74.07%	124	37.92%
尼	428		5	347	0.05241%	490806	74.12%	64	19.57%
站	429		10	347	0.05241%	491153	74.18%	102	31.19%
首	430		9	347	0.05241%	491500	74.23%	139	42.51%
織	431		18	346	0.05226%	491846	74.28%	114	34.86%
紀	432		9	345	0.0521%	492191	74.33%	95	29.05%
米	433		6	341	0.0515%	492532	74.39%	87	26.61%
影	434		15	339	0.0512%	492871	74.44%	113	34.56%
兵	435		7	337	0.0509%	493208	74.49%	82	25.08%
呢	436		8	337	0.0509%	493545	74.54%	103	31.50%
非	437		8	337	0.0509%	493882	74.59%	122	37.31%
黑	438		12	337	0.0509%	494219	74.64%	91	27.83%
養	439		15	336	0.05075%	494555	74.69%	77	23.55%
叫	440		5	335	0.05059%	494890	74.74%	100	30.58%
式	441		6	335	0.05059%	495225	74.79%	107	32.72%
精	442		14	335	0.05059%	495560	74.84%	141	43.12%
支	443		4	333	0.05029%	495893	74.89%	126	38.53%
程	444		12	331	0.04999%	496224	74.94%	116	35.47%
管	445		14	331	0.04999%	496555	74.99%	133	40.67%
偉	446		11	330	0.04984%	496885	75.04%	95	29.05%
田	447		5	330	0.04984%	497215	75.09%	88	26.91%
破	448		10	330	0.04984%	497545	75.14%	116	35.47%
敵	449		15	329	0.04969%	497874	75.19%	75	22.94%
片	450		4	329	0.04969%	498203	75.24%	114	34.86%
王	451		4	329	0.04969%	498532	75.29%	89	27.22%
積	452		16	328	0.04954%	498860	75.34%	123	37.61%
信	453		9	325	0.04908%	499185	75.39%	114	34.86%
底	454		8	318	0.04803%	499503	75.44%	137	41.90%
武	455		8	318	0.04803%	499821	75.49%	111	33.94%
值	456		10	317	0.04788%	500138	75.53%	69	21.10%
朝	457		12	316	0.04772%	500454	75.58%	77	23.55%
服	458		8	315	0.04757%	500769	75.63%	100	30.58%
權	459		22	315	0.04757%	501084	75.68%	71	21.71%
參	460		11	314	0.04742%	501398	75.72%	135	41.28%
調	461		15	314	0.04742%	501712	75.77%	122	37.31%
圍	462		12	313	0.04727%	502025	75.82%	108	33.03%
談	463		15	313	0.04727%	502338	75.87%	118	36.09%
親	464		16	312	0.04712%	502650	75.91%	105	32.11%
離	465		18	311	0.04697%	502961	75.96%	122	37.31%
畫	466		12	310	0.04682%	503271	76.01%	47	14.37%
蘇	467		20	309	0.04667%	503580	76.05%	80	24.46%
吃	468		6	308	0.04652%	503888	76.10%	73	22.32%
照	469		13	307	0.04637%	504195	76.15%	124	37.92%
容	470		10	306	0.04621%	504501	76.19%	134	40.98%
早	471		6	306	0.04621%	504807	76.24%	118	36.09%
議	472		20	306	0.04621%	505113	76.29%	115	35.17%
友	473		4	305	0.04606%	505418	76.33%	88	26.91%
師	474		10	305	0.04606%	505723	76.38%	57	17.43%
廠	475		15	303	0.04576%	506026	76.42%	85	25.99%
黃	476		12	303	0.04576%	506329	76.47%	77	23.55%
創	477		12	299	0.04516%	506628	76.51%	95	29.05%
怎	478		9	299	0.04516%	506927	76.56%	109	33.33%
較	479		13	299	0.04516%	507226	76.60%	109	33.33%
張	480		11	298	0.04501%	507524	76.65%	111	33.94%
裝	481		13	298	0.04501%	507822	76.69%	122	37.31%
台	482		5	297	0.04485%	508119	76.74%	70	21.41%
雲	483		12	297	0.04485%	508416	76.78%	62	18.96%
族	484		11	296	0.0447%	508712	76.83%	73	22.32%
講	485		17	296	0.0447%	509008	76.87%	101	30.89%
局	486		7	295	0.04455%	509303	76.92%	93	28.44%
詞	487		12	295	0.04455%	509598	76.96%	31	9.48%
錯	488		16	294	0.0444%	509892	77.01%	83	25.38%
則	489		9	293	0.04425%	510185	77.05%	108	33.03%
跟	490		13	290	0.0438%	510475	77.10%	83	25.38%
緊	491		14	289	0.04365%	510764	77.14%	127	38.84%
轉	492		18	289	0.04365%	511053	77.18%	106	32.42%
魚	493		11	289	0.04365%	511342	77.23%	39	11.93%
委	494		8	288	0.0435%	511630	77.27%	83	25.38%
規	495		11	288	0.0435%	511918	77.31%	99	30.28%
興	496		16	287	0.04334%	512205	77.36%	125	38.23%
始	497		8	286	0.04319%	512491	77.40%	135	41.28%
似	498		7	285	0.04304%	512776	77.44%	85	25.99%
烈	499		10	285	0.04304%	513061	77.49%	117	35.78%
病	500		10	285	0.04304%	513346	77.53%	69	21.10%
商	501		11	284	0.04289%	513630	77.57%	58	17.74%
李	502		7	284	0.04289%	513914	77.61%	48	14.68%
略	503		11	284	0.04289%	514198	77.66%	101	30.89%
元	504		4	283	0.04274%	514481	77.70%	61	18.65%
號	505		13	283	0.04274%	514764	77.74%	102	31.19%
採	506		11	281	0.04244%	515045	77.79%	109	33.33%
況	507		8	281	0.04244%	515326	77.83%	107	32.72%
節	508		13	280	0.04229%	515606	77.87%	106	32.42%
輕	509		14	280	0.04229%	515886	77.91%	101	30.89%
嚴	510		20	278	0.04199%	516164	77.95%	125	38.23%
城	511		9	278	0.04199%	516442	78.00%	76	23.24%
陽	512		11	278	0.04199%	516720	78.04%	83	25.38%
歡	513		22	275	0.04153%	516995	78.08%	110	33.64%
肥	514		8	275	0.04153%	517270	78.12%	40	12.23%
音	515		9	275	0.04153%	517545	78.16%	69	21.10%
濟	516		17	274	0.04138%	517819	78.20%	75	22.94%
醫	517		18	273	0.04123%	518092	78.25%	33	10.09%
材	518		7	271	0.04093%	518363	78.29%	71	21.71%
響	519		21	271	0.04093%	518634	78.33%	112	34.25%
孩	520		9	270	0.04078%	518904	78.37%	46	14.07%
約	521		9	270	0.04078%	519174	78.41%	102	31.19%
夠	522		11	269	0.04063%	519443	78.45%	118	36.09%
座	523		10	269	0.04063%	519712	78.49%	85	25.99%
密	524		11	267	0.04032%	519979	78.53%	105	32.11%
技	525		7	267	0.04032%	520246	78.57%	85	25.99%
腳	526		13	267	0.04032%	520513	78.61%	76	23.24%
舞	527		14	265	0.04002%	520778	78.65%	70	21.41%
侵	528		9	264	0.03987%	521042	78.69%	76	23.24%
倒	529		10	264	0.03987%	521306	78.73%	100	30.58%
夫	530		4	264	0.03987%	521570	78.77%	79	24.16%
洲	531		9	264	0.03987%	521834	78.81%	51	15.60%
便	532		9	263	0.03972%	522097	78.85%	109	33.33%
夜	533		8	263	0.03972%	522360	78.89%	79	24.16%
誤	534		14	262	0.03957%	522622	78.93%	64	19.57%
恩	535		10	261	0.03942%	522883	78.97%	33	10.09%
京	536		8	260	0.03927%	523143	79.01%	71	21.71%
何	537		7	260	0.03927%	523403	79.05%	124	37.92%
係	538		9	260	0.03927%	523663	79.09%	67	20.49%
段	539		9	260	0.03927%	523923	79.13%	102	31.19%
雨	540		8	259	0.03912%	524182	79.17%	76	23.24%
太	541		4	258	0.03896%	524440	79.20%	103	31.50%
曾	542		12	257	0.03881%	524697	79.24%	114	34.86%
層	543		15	256	0.03866%	524953	79.28%	80	24.46%
專	544		11	255	0.03851%	525208	79.32%	95	29.05%
抗	545		7	255	0.03851%	525463	79.36%	96	29.36%
油	546		8	254	0.03836%	525717	79.40%	64	19.57%
証	547		12	254	0.03836%	525971	79.44%	67	20.49%
句	548		5	253	0.03821%	526224	79.47%	71	21.71%
該	549		13	253	0.03821%	526477	79.51%	97	29.66%
雙	550		18	253	0.03821%	526730	79.55%	69	21.10%
勢	551		13	251	0.03791%	526981	79.59%	111	33.94%
推	552		11	251	0.03791%	527232	79.63%	98	29.97%
棋	553		12	251	0.03791%	527483	79.66%	12	3.67%
幣	554		14	250	0.03776%	527733	79.70%	6	1.84%
燈	555		16	249	0.03761%	527982	79.74%	46	14.07%
鮮	556		17	249	0.03761%	528231	79.78%	71	21.71%
充	557		5	248	0.03745%	528479	79.81%	116	35.47%
漢	558		14	247	0.0373%	528726	79.85%	56	17.13%
剛	559		10	245	0.037%	528971	79.89%	81	24.77%
單	560		12	245	0.037%	529216	79.93%	110	33.64%
德	561		15	245	0.037%	529461	79.96%	89	27.22%
備	562		12	244	0.03685%	529705	80.00%	109	33.33%
消	563		10	244	0.03685%	529949	80.04%	119	36.39%
壓	564		17	243	0.0367%	530192	80.07%	104	31.80%
府	565		8	243	0.0367%	530435	80.11%	82	25.08%
吧	566		7	242	0.03655%	530677	80.15%	66	20.18%
徹	567		14	242	0.03655%	530919	80.18%	83	25.38%
布	568		5	241	0.0364%	531160	80.22%	84	25.69%
念	569		8	241	0.0364%	531401	80.26%	84	25.69%
縣	570		16	241	0.0364%	531642	80.29%	56	17.13%
需	571		14	241	0.0364%	531883	80.33%	102	31.19%
士	572		3	239	0.0361%	532122	80.36%	84	25.69%
包	573		5	238	0.03594%	532360	80.40%	109	33.33%
讓	574		24	238	0.03594%	532598	80.44%	107	32.72%
準	575		13	237	0.03579%	532835	80.47%	109	33.33%
突	576		9	236	0.03564%	533071	80.51%	86	26.30%
靠	577		15	236	0.03564%	533307	80.54%	94	28.75%
告	578		7	235	0.03549%	533542	80.58%	113	34.56%
游	579		12	235	0.03549%	533777	80.61%	85	25.99%
器	580		16	234	0.03534%	534011	80.65%	102	31.19%
苦	581		9	234	0.03534%	534245	80.69%	85	25.99%
判	582		7	233	0.03519%	534478	80.72%	66	20.18%
劃	583		14	233	0.03519%	534711	80.76%	88	26.91%
引	584		4	231	0.03489%	534942	80.79%	114	34.86%
木	585		4	231	0.03489%	535173	80.83%	73	22.32%
死	586		6	230	0.03474%	535403	80.86%	96	29.36%
省	587		9	230	0.03474%	535633	80.89%	90	27.52%
院	588		9	230	0.03474%	535863	80.93%	70	21.41%
即	589		7	229	0.03459%	536092	80.96%	119	36.39%
害	590		10	229	0.03459%	536321	81.00%	88	26.91%
續	591		21	229	0.03459%	536550	81.03%	110	33.64%
般	592		10	229	0.03459%	536779	81.07%	103	31.50%
貨	593		11	229	0.03459%	537008	81.10%	30	9.17%
敢	594		12	228	0.03443%	537236	81.14%	81	24.77%
細	595		11	227	0.03428%	537463	81.17%	99	30.28%
刻	596		8	226	0.03413%	537689	81.21%	93	28.44%
棉	597		12	226	0.03413%	537915	81.24%	29	8.87%
賽	598		17	226	0.03413%	538141	81.27%	29	8.87%
奇	599		8	225	0.03398%	538366	81.31%	82	25.08%
存	600		6	223	0.03368%	538589	81.34%	104	31.80%
掌	601		12	223	0.03368%	538812	81.38%	103	31.50%
貧	602		11	223	0.03368%	539035	81.41%	35	10.70%
除	603		9	220	0.03323%	539255	81.44%	122	37.31%
班	604		10	219	0.03307%	539474	81.48%	61	18.65%
副	605		11	218	0.03292%	539692	81.51%	81	24.77%
低	606		7	217	0.03277%	539909	81.54%	93	28.44%
宣	607		9	217	0.03277%	540126	81.57%	93	28.44%
衛	608		15	217	0.03277%	540343	81.61%	76	23.24%
讀	609		22	217	0.03277%	540560	81.64%	64	19.57%
項	610		12	217	0.03277%	540777	81.67%	78	23.85%
寧	611		14	215	0.03247%	540992	81.70%	72	22.02%
湖	612		12	215	0.03247%	541207	81.74%	41	12.54%
哪	613		10	214	0.03232%	541421	81.77%	75	22.94%
樂	614		15	214	0.03232%	541635	81.80%	73	22.32%
矛	615		5	214	0.03232%	541849	81.83%	52	15.90%
停	616		11	213	0.03217%	542062	81.87%	84	25.69%
注	617		8	213	0.03217%	542275	81.90%	110	33.64%
豬	618		11	212	0.03202%	542487	81.93%	15	4.59%
舊	619		18	211	0.03187%	542698	81.96%	83	25.38%
繼	620		20	209	0.03156%	542907	81.99%	106	32.42%
待	621		9	208	0.03141%	543115	82.02%	105	32.11%
算	622		14	208	0.03141%	543323	82.06%	82	25.08%
華	623		12	208	0.03141%	543531	82.09%	89	27.22%
唱	624		11	207	0.03126%	543738	82.12%	43	13.15%
富	625		12	207	0.03126%	543945	82.15%	99	30.28%
星	626		9	207	0.03126%	544152	82.18%	67	20.49%
標	627		15	207	0.03126%	544359	82.21%	89	27.22%
考	628		6	207	0.03126%	544566	82.24%	70	21.41%
份	629		6	206	0.03111%	544772	82.28%	97	29.66%
圖	630		14	206	0.03111%	544978	82.31%	97	29.66%
隻	631		10	205	0.03096%	545183	82.34%	64	19.57%
晚	632		11	204	0.03081%	545387	82.37%	92	28.13%
盾	633		9	204	0.03081%	545591	82.40%	45	13.76%
草	634		10	204	0.03081%	545795	82.43%	77	23.55%
司	635		5	203	0.03066%	545998	82.46%	70	21.41%
隨	636		15	203	0.03066%	546201	82.49%	106	32.42%
亮	637		9	202	0.03051%	546403	82.52%	68	20.80%
嗎	638		13	202	0.03051%	546605	82.55%	69	21.10%
塔	639		13	202	0.03051%	546807	82.58%	52	15.90%
壞	640		19	200	0.03021%	547007	82.61%	80	24.46%
誰	641		15	200	0.03021%	547207	82.64%	79	24.16%
豐	642		18	200	0.03021%	547407	82.67%	83	25.38%
態	643		14	198	0.0299%	547605	82.70%	90	27.52%
穿	644		9	198	0.0299%	547803	82.73%	80	24.46%
周	645		8	196	0.0296%	547999	82.76%	97	29.66%
喜	646		12	196	0.0296%	548195	82.79%	66	20.18%
類	647		19	196	0.0296%	548391	82.82%	77	23.55%
波	648		8	195	0.02945%	548586	82.85%	76	23.24%
頂	649		11	195	0.02945%	548781	82.88%	61	18.65%
僅	650		13	194	0.0293%	548975	82.91%	95	29.05%
顯	651		23	194	0.0293%	549169	82.94%	102	31.19%
陣	652		9	193	0.02915%	549362	82.97%	81	24.77%
坐	653		7	192	0.029%	549554	83.00%	69	21.10%
戲	654		17	192	0.029%	549746	83.03%	25	7.65%
板	655		8	192	0.029%	549938	83.06%	65	19.88%
抓	656		7	191	0.02885%	550129	83.08%	63	19.27%
演	657		14	191	0.02885%	550320	83.11%	41	12.54%
送	658		9	190	0.0287%	550510	83.14%	78	23.85%
復	659		12	188	0.02839%	550698	83.17%	82	25.08%
雄	660		12	188	0.02839%	550886	83.20%	63	19.27%
綠	661		14	187	0.02824%	551073	83.23%	61	18.65%
查	662		9	186	0.02809%	551259	83.25%	75	22.94%
針	663		10	186	0.02809%	551445	83.28%	65	19.88%
房	664		8	185	0.02794%	551630	83.31%	57	17.43%
揮	665		12	185	0.02794%	551815	83.34%	77	23.55%
景	666		12	185	0.02794%	552000	83.37%	72	22.02%
速	667		10	185	0.02794%	552185	83.39%	73	22.32%
例	668		8	184	0.02779%	552369	83.42%	65	19.88%
蘭	669		21	184	0.02779%	552553	83.45%	49	14.98%
助	670		7	183	0.02764%	552736	83.48%	101	30.89%
執	671		11	183	0.02764%	552919	83.51%	65	19.88%
察	672		14	183	0.02764%	553102	83.53%	73	22.32%
留	673		10	183	0.02764%	553285	83.56%	90	27.52%
映	674		9	182	0.02749%	553467	83.59%	66	20.18%
翻	675		18	182	0.02749%	553649	83.62%	72	22.02%
握	676		12	181	0.02734%	553830	83.64%	86	26.30%
絕	677		12	181	0.02734%	554011	83.67%	85	25.99%
校	678		10	180	0.02718%	554191	83.70%	58	17.74%
視	679		12	180	0.02718%	554371	83.72%	95	29.05%
謂	680		16	180	0.02718%	554551	83.75%	65	19.88%
搞	681		13	179	0.02703%	554730	83.78%	57	17.43%
易	682		8	179	0.02703%	554909	83.81%	104	31.80%
普	683		12	179	0.02703%	555088	83.83%	90	27.52%
詩	684		13	179	0.02703%	555267	83.86%	48	14.68%
令	685		5	178	0.02688%	555445	83.89%	79	24.16%
沙	686		7	178	0.02688%	555623	83.91%	70	21.41%
迎	687		7	178	0.02688%	555801	83.94%	93	28.44%
另	688		5	177	0.02673%	555978	83.97%	105	32.11%
央	689		5	177	0.02673%	556155	83.99%	57	17.43%
峰	690		10	176	0.02658%	556331	84.02%	40	12.23%
限	691		8	175	0.02643%	556506	84.05%	86	26.30%
初	692		7	174	0.02628%	556680	84.07%	89	27.22%
稱	693		14	174	0.02628%	556854	84.10%	82	25.08%
歲	694		13	173	0.02613%	557027	84.13%	74	22.63%
啊	695		11	172	0.02598%	557199	84.15%	51	15.60%
乎	696		5	171	0.02583%	557370	84.18%	88	26.91%
依	697		8	171	0.02583%	557541	84.20%	81	24.77%
劇	698		15	171	0.02583%	557712	84.23%	50	15.29%
維	699		14	171	0.02583%	557883	84.26%	66	20.18%
背	700		9	171	0.02583%	558054	84.28%	77	23.55%
足	701		7	171	0.02583%	558225	84.31%	90	27.52%
客	702		9	170	0.02567%	558395	84.33%	60	18.35%
怕	703		8	170	0.02567%	558565	84.36%	76	23.24%
負	704		9	170	0.02567%	558735	84.38%	69	21.10%
右	705		5	169	0.02552%	558904	84.41%	85	25.99%
食	706		9	169	0.02552%	559073	84.44%	55	16.82%
封	707		9	168	0.02537%	559241	84.46%	56	17.13%
雖	708		17	168	0.02537%	559409	84.49%	94	28.75%
魯	709		15	168	0.02537%	559577	84.51%	34	10.40%
塊	710		13	167	0.02522%	559744	84.54%	65	19.88%
威	711		9	167	0.02522%	559911	84.56%	80	24.46%
葉	712		13	167	0.02522%	560078	84.59%	65	19.88%
雪	713		11	167	0.02522%	560245	84.61%	48	14.68%
唯	714		11	166	0.02507%	560411	84.64%	43	13.15%
鐵	715		21	166	0.02507%	560577	84.66%	54	16.51%
找	716		7	165	0.02492%	560742	84.69%	77	23.55%
臉	717		17	165	0.02492%	560907	84.71%	46	14.07%
冰	718		6	164	0.02477%	561071	84.74%	25	7.65%
鄉	719		11	164	0.02477%	561235	84.76%	70	21.41%
久	720		3	163	0.02462%	561398	84.79%	99	30.28%
幫	721		17	163	0.02462%	561561	84.81%	91	27.83%
施	722		9	163	0.02462%	561724	84.84%	62	18.96%
止	723		4	163	0.02462%	561887	84.86%	88	26.91%
系	724		7	163	0.02462%	562050	84.88%	76	23.24%
責	725		11	163	0.02462%	562213	84.91%	84	25.69%
急	726		9	162	0.02447%	562375	84.93%	73	22.32%
概	727		13	162	0.02447%	562537	84.96%	56	17.13%
致	728		9	162	0.02447%	562699	84.98%	100	30.58%
失	729		5	161	0.02432%	562860	85.01%	92	28.13%
激	730		16	161	0.02432%	563021	85.03%	102	31.19%
衣	731		6	161	0.02432%	563182	85.06%	67	20.49%
買	732		12	161	0.02432%	563343	85.08%	50	15.29%
閃	733		10	161	0.02432%	563504	85.10%	50	15.29%
官	734		8	160	0.02416%	563664	85.13%	57	17.43%
試	735		13	160	0.02416%	563824	85.15%	65	19.88%
野	736		11	160	0.02416%	563984	85.18%	57	17.43%
呼	737		8	159	0.02401%	564143	85.20%	82	25.08%
左	738		5	159	0.02401%	564302	85.22%	74	22.63%
踐	739		15	159	0.02401%	564461	85.25%	52	15.90%
選	740		15	159	0.02401%	564620	85.27%	63	19.27%
故	741		9	158	0.02386%	564778	85.30%	67	20.49%
永	742		5	158	0.02386%	564936	85.32%	74	22.63%
獲	743		17	158	0.02386%	565094	85.34%	74	22.63%
迅	744		6	157	0.02371%	565251	85.37%	59	18.04%
錢	745		16	157	0.02371%	565408	85.39%	48	14.68%
鼓	746		13	157	0.02371%	565565	85.42%	81	24.77%
丹	747		4	156	0.02356%	565721	85.44%	21	6.42%
島	748		10	156	0.02356%	565877	85.46%	34	10.40%
排	749		11	156	0.02356%	566033	85.49%	83	25.38%
盡	750		14	156	0.02356%	566189	85.51%	94	28.75%
章	751		11	156	0.02356%	566345	85.53%	61	18.65%
護	752		21	156	0.02356%	566501	85.56%	78	23.85%
配	753		10	156	0.02356%	566657	85.58%	59	18.04%
互	754		4	154	0.02326%	566811	85.60%	61	18.65%
供	755		8	154	0.02326%	566965	85.63%	76	23.24%
固	756		8	154	0.02326%	567119	85.65%	80	24.46%
律	757		9	154	0.02326%	567273	85.67%	63	19.27%
職	758		18	154	0.02326%	567427	85.70%	46	14.07%
討	759		10	154	0.02326%	567581	85.72%	54	16.51%
佔	760		7	153	0.02311%	567734	85.74%	65	19.88%
忽	761		8	153	0.02311%	567887	85.77%	61	18.65%
露	762		21	153	0.02311%	568040	85.79%	95	29.05%
香	763		9	153	0.02311%	568193	85.81%	51	15.60%
散	764		12	152	0.02296%	568345	85.84%	69	21.10%
旁	765		10	152	0.02296%	568497	85.86%	68	20.80%
曲	766		6	151	0.02281%	568648	85.88%	65	19.88%
構	767		14	151	0.02281%	568799	85.90%	47	14.37%
玉	768		5	151	0.02281%	568950	85.93%	45	13.76%
藥	769		19	151	0.02281%	569101	85.95%	27	8.26%
拿	770		10	150	0.02265%	569251	85.97%	70	21.41%
浪	771		10	150	0.02265%	569401	85.99%	58	17.74%
優	772		17	149	0.0225%	569550	86.02%	68	20.80%
微	773		13	149	0.0225%	569699	86.04%	51	15.60%
滅	774		13	149	0.0225%	569848	86.06%	71	21.71%
溫	775		13	149	0.0225%	569997	86.08%	61	18.65%
勇	776		9	148	0.02235%	570145	86.11%	67	20.49%
否	777		7	148	0.02235%	570293	86.13%	55	16.82%
呀	778		7	148	0.02235%	570441	86.15%	36	11.01%
塑	779		13	148	0.02235%	570589	86.17%	24	7.34%
娘	780		10	148	0.02235%	570737	86.20%	41	12.54%
警	781		20	148	0.02235%	570885	86.22%	57	17.43%
錄	782		16	148	0.02235%	571033	86.24%	40	12.23%
吸	783		7	147	0.0222%	571180	86.26%	74	22.63%
息	784		10	147	0.0222%	571327	86.29%	80	24.46%
熟	785		15	147	0.0222%	571474	86.31%	71	21.71%
獨	786		16	147	0.0222%	571621	86.33%	74	22.63%
礎	787		18	146	0.02205%	571767	86.35%	62	18.96%
終	788		11	146	0.02205%	571913	86.37%	86	26.30%
防	789		6	146	0.02205%	572059	86.40%	67	20.49%
斤	790		4	145	0.0219%	572204	86.42%	36	11.01%
辯	791		21	145	0.0219%	572349	86.44%	36	11.01%
屋	792		9	144	0.02175%	572493	86.46%	46	14.07%
益	793		10	144	0.02175%	572637	86.48%	59	18.04%
礦	794		20	144	0.02175%	572781	86.51%	24	7.34%
困	795		7	143	0.0216%	572924	86.53%	72	22.02%
揚	796		12	143	0.0216%	573067	86.55%	73	22.32%
核	797		10	143	0.0216%	573210	86.57%	42	12.84%
評	798		12	143	0.0216%	573353	86.59%	55	16.82%
射	799		10	142	0.02145%	573495	86.61%	60	18.35%
功	800		5	141	0.02129%	573636	86.63%	81	24.77%
巨	801		5	141	0.02129%	573777	86.66%	75	22.94%
暴	802		15	141	0.02129%	573918	86.68%	72	22.02%
未	803		5	141	0.02129%	574059	86.70%	92	28.13%
母	804		5	141	0.02129%	574200	86.72%	43	13.15%
貫	805		11	141	0.02129%	574341	86.74%	55	16.82%
趕	806		14	141	0.02129%	574482	86.76%	62	18.96%
某	807		9	140	0.02114%	574622	86.78%	60	18.35%
遍	808		12	140	0.02114%	574762	86.80%	77	23.55%
換	809		12	139	0.02099%	574901	86.83%	55	16.82%
睛	810		13	139	0.02099%	575040	86.85%	51	15.60%
型	811		9	138	0.02084%	575178	86.87%	59	18.04%
秋	812		9	138	0.02084%	575316	86.89%	52	15.90%
促	813		9	137	0.02069%	575453	86.91%	68	20.80%
寺	814		6	137	0.02069%	575590	86.93%	9	2.75%
簡	815		18	136	0.02054%	575726	86.95%	72	22.02%
迫	816		8	136	0.02054%	575862	86.97%	75	22.94%
靈	817		24	136	0.02054%	575998	86.99%	67	20.49%
孔	818		4	135	0.02039%	576133	87.01%	29	8.87%
忙	819		6	134	0.02024%	576267	87.03%	59	18.04%
燒	820		16	134	0.02024%	576401	87.05%	57	17.43%
登	821		12	134	0.02024%	576535	87.07%	53	16.21%
素	822		10	134	0.02024%	576669	87.09%	58	17.74%
茶	823		10	134	0.02024%	576803	87.11%	27	8.26%
靜	824		16	134	0.02024%	576937	87.13%	51	15.60%
願	825		19	134	0.02024%	577071	87.15%	78	23.85%
唐	826		10	133	0.02009%	577204	87.17%	17	5.20%
洋	827		9	133	0.02009%	577337	87.19%	62	18.96%
畝	828		10	133	0.02009%	577470	87.21%	29	8.87%
乾	829		11	132	0.01994%	577602	87.23%	56	17.13%
餘	830		15	132	0.01994%	577734	87.25%	68	20.80%
丁	831		2	131	0.01978%	577865	87.27%	39	11.93%
善	832		12	131	0.01978%	577996	87.29%	67	20.49%
岸	833		8	131	0.01978%	578127	87.31%	54	16.51%
差	834		10	131	0.01978%	578258	87.33%	65	19.88%
按	835		9	131	0.01978%	578389	87.35%	79	24.16%
煙	836		13	131	0.01978%	578520	87.37%	48	14.68%
糧	837		18	131	0.01978%	578651	87.39%	36	11.01%
良	838		7	131	0.01978%	578782	87.41%	56	17.13%
陳	839		10	131	0.01978%	578913	87.43%	51	15.60%
雜	840		18	131	0.01978%	579044	87.45%	70	21.41%
攻	841		7	130	0.01963%	579174	87.47%	51	15.60%
噸	842		16	129	0.01948%	579303	87.49%	23	7.03%
童	843		12	129	0.01948%	579432	87.51%	27	8.26%
旗	844		14	128	0.01933%	579560	87.53%	68	20.80%
植	845		12	128	0.01933%	579688	87.55%	41	12.54%
槍	846		14	128	0.01933%	579816	87.57%	45	13.76%
營	847		17	128	0.01933%	579944	87.59%	52	15.90%
訴	848		12	128	0.01933%	580072	87.61%	70	21.41%
仍	849		4	127	0.01918%	580199	87.63%	71	21.71%
境	850		14	127	0.01918%	580326	87.64%	61	18.65%
羅	851		19	127	0.01918%	580453	87.66%	49	14.98%
赤	852		7	127	0.01918%	580580	87.68%	31	9.48%
跑	853		12	127	0.01918%	580707	87.70%	56	17.13%
震	854		15	127	0.01918%	580834	87.72%	30	9.17%
顧	855		21	127	0.01918%	580961	87.74%	59	18.04%
彩	856		11	126	0.01903%	581087	87.76%	51	15.60%
源	857		13	126	0.01903%	581213	87.78%	60	18.35%
狀	858		8	126	0.01903%	581339	87.80%	69	21.10%
跳	859		13	126	0.01903%	581465	87.82%	53	16.21%
沉	860		7	125	0.01888%	581590	87.84%	63	19.27%
佈	861		7	124	0.01873%	581714	87.85%	60	18.35%
努	862		7	123	0.01858%	581837	87.87%	67	20.49%
喝	863		12	123	0.01858%	581960	87.89%	34	10.40%
均	864		7	123	0.01858%	582083	87.91%	42	12.84%
培	865		11	123	0.01858%	582206	87.93%	51	15.60%
彈	866		15	123	0.01858%	582329	87.95%	39	11.93%
祖	867		9	123	0.01858%	582452	87.97%	68	20.80%
貴	868		12	123	0.01858%	582575	87.98%	65	19.88%
典	869		8	122	0.01843%	582697	88.00%	44	13.46%
季	870		8	122	0.01843%	582819	88.02%	63	19.27%
答	871		12	122	0.01843%	582941	88.04%	65	19.88%
製	872		14	122	0.01843%	583063	88.06%	57	17.43%
角	873		7	122	0.01843%	583185	88.08%	65	19.88%
請	874		15	122	0.01843%	583307	88.10%	67	20.49%
鋼	875		16	122	0.01843%	583429	88.11%	32	9.79%
伯	876		7	121	0.01827%	583550	88.13%	34	10.40%
述	877		8	121	0.01827%	583671	88.15%	53	16.21%
戶	878		4	120	0.01812%	583791	88.17%	36	11.01%
投	879		7	120	0.01812%	583911	88.19%	69	21.10%
擴	880		18	120	0.01812%	584031	88.20%	60	18.35%
牙	881		4	120	0.01812%	584151	88.22%	32	9.79%
福	882		13	120	0.01812%	584271	88.24%	52	15.90%
輪	883		15	120	0.01812%	584391	88.26%	49	14.98%
傷	884		13	119	0.01797%	584510	88.28%	49	14.98%
弟	885		7	119	0.01797%	584629	88.29%	45	13.76%
括	886		9	119	0.01797%	584748	88.31%	68	20.80%
架	887		9	119	0.01797%	584867	88.33%	47	14.37%
模	888		15	119	0.01797%	584986	88.35%	70	21.41%
皮	889		5	119	0.01797%	585105	88.37%	56	17.13%
降	890		8	119	0.01797%	585224	88.38%	67	20.49%
驚	891		23	119	0.01797%	585343	88.40%	55	16.82%
齊	892		14	119	0.01797%	585462	88.42%	63	19.27%
松	893		8	118	0.01782%	585580	88.44%	34	10.40%
績	894		17	118	0.01782%	585698	88.46%	47	14.37%
谷	895		7	118	0.01782%	585816	88.47%	44	13.46%
含	896		7	117	0.01767%	585933	88.49%	54	16.51%
奶	897		5	117	0.01767%	586050	88.51%	16	4.89%
缺	898		10	117	0.01767%	586167	88.53%	56	17.13%
複	899		14	117	0.01767%	586284	88.54%	62	18.96%
奮	900		16	116	0.01752%	586400	88.56%	68	20.80%
掉	901		11	116	0.01752%	586516	88.58%	70	21.41%
爺	902		13	116	0.01752%	586632	88.60%	27	8.26%
財	903		10	116	0.01752%	586748	88.61%	36	11.01%
零	904		13	116	0.01752%	586864	88.63%	55	16.82%
怪	905		8	115	0.01737%	586979	88.65%	56	17.13%
紙	906		10	115	0.01737%	587094	88.67%	50	15.29%
飯	907		12	115	0.01737%	587209	88.68%	45	13.76%
麗	908		19	115	0.01737%	587324	88.70%	50	15.29%
奪	909		14	114	0.01722%	587438	88.72%	61	18.65%
枝	910		8	114	0.01722%	587552	88.74%	49	14.98%
撾	911		16	113	0.01707%	587665	88.75%	12	3.67%
既	912		9	113	0.01707%	587778	88.77%	71	21.71%
睡	913		14	113	0.01707%	587891	88.79%	34	10.40%
秘	914		10	113	0.01707%	588004	88.80%	40	12.23%
竹	915		6	113	0.01707%	588117	88.82%	26	7.95%
證	916		19	113	0.01707%	588230	88.84%	49	14.98%
賣	917		15	113	0.01707%	588343	88.86%	40	12.23%
懷	918		19	112	0.01692%	588455	88.87%	84	25.69%
擔	919		16	112	0.01692%	588567	88.89%	64	19.57%
犯	920		5	112	0.01692%	588679	88.91%	49	14.98%
球	921		11	112	0.01692%	588791	88.92%	34	10.40%
環	922		17	112	0.01692%	588903	88.94%	61	18.65%
盤	923		15	112	0.01692%	589015	88.96%	40	12.23%
稻	924		15	112	0.01692%	589127	88.97%	33	10.09%
竟	925		11	112	0.01692%	589239	88.99%	72	22.02%
逐	926		10	112	0.01692%	589351	89.01%	66	20.18%
冷	927		7	111	0.01676%	589462	89.02%	46	14.07%
套	928		10	111	0.01676%	589573	89.04%	62	18.96%
屬	929		21	111	0.01676%	589684	89.06%	60	18.35%
州	930		6	111	0.01676%	589795	89.07%	36	11.01%
蕩	931		16	111	0.01676%	589906	89.09%	42	12.84%
企	932		6	110	0.01661%	590016	89.11%	47	14.37%
園	933		13	110	0.01661%	590126	89.12%	56	17.13%
宗	934		8	110	0.01661%	590236	89.14%	43	13.15%
彿	935		8	110	0.01661%	590346	89.16%	41	12.54%
罷	936		15	110	0.01661%	590456	89.17%	41	12.54%
超	937		12	110	0.01661%	590566	89.19%	53	16.21%
鐘	938		20	110	0.01661%	590676	89.21%	42	12.84%
束	939		7	109	0.01646%	590785	89.22%	73	22.32%
血	940		6	109	0.01646%	590894	89.24%	52	15.90%
鑽	941		27	109	0.01646%	591003	89.26%	33	10.09%
鬧	942		15	109	0.01646%	591112	89.27%	52	15.90%
剝	943		10	108	0.01631%	591220	89.29%	43	13.15%
協	944		8	108	0.01631%	591328	89.31%	57	17.43%
效	945		10	108	0.01631%	591436	89.32%	62	18.96%
煤	946		13	108	0.01631%	591544	89.34%	23	7.03%
透	947		10	108	0.01631%	591652	89.36%	64	19.57%
店	948		8	107	0.01616%	591759	89.37%	25	7.65%
痛	949		12	107	0.01616%	591866	89.39%	48	14.68%
亂	950		13	106	0.01601%	591972	89.40%	56	17.13%
姑	951		8	106	0.01601%	592078	89.42%	34	10.40%
居	952		8	106	0.01601%	592184	89.44%	53	16.21%
忘	953		7	106	0.01601%	592290	89.45%	61	18.65%
承	954		8	106	0.01601%	592396	89.47%	68	20.80%
招	955		8	106	0.01601%	592502	89.48%	46	14.07%
潮	956		15	106	0.01601%	592608	89.50%	54	16.51%
脫	957		11	106	0.01601%	592714	89.52%	67	20.49%
費	958		12	106	0.01601%	592820	89.53%	46	14.07%
躍	959		21	106	0.01601%	592926	89.55%	60	18.35%
陰	960		10	106	0.01601%	593032	89.56%	58	17.74%
雁	961		12	106	0.01601%	593138	89.58%	12	3.67%
館	962		16	106	0.01601%	593244	89.60%	41	12.54%
升	963		4	105	0.01586%	593349	89.61%	58	17.74%
慢	964		14	105	0.01586%	593454	89.63%	47	14.37%
搖	965		13	105	0.01586%	593559	89.64%	48	14.68%
析	966		8	105	0.01586%	593664	89.66%	33	10.09%
龍	967		16	105	0.01586%	593769	89.68%	51	15.60%
介	968		4	104	0.01571%	593873	89.69%	52	15.90%
殖	969		12	104	0.01571%	593977	89.71%	32	9.79%
漸	970		14	104	0.01571%	594081	89.72%	46	14.07%
購	971		17	104	0.01571%	594185	89.74%	21	6.42%
寨	972		14	103	0.01556%	594288	89.75%	18	5.51%
毒	973		9	103	0.01556%	594391	89.77%	38	11.62%
獻	974		20	103	0.01556%	594494	89.78%	55	16.82%
蓋	975		14	103	0.01556%	594597	89.80%	61	18.65%
謀	976		16	103	0.01556%	594700	89.82%	56	17.13%
吹	977		7	102	0.0154%	594802	89.83%	47	14.37%
彷	978		7	102	0.0154%	594904	89.85%	36	11.01%
削	979		9	101	0.01525%	595005	89.86%	44	13.46%
姐	980		8	101	0.01525%	595106	89.88%	9	2.75%
桃	981		10	101	0.01525%	595207	89.89%	31	9.48%
粉	982		10	101	0.01525%	595308	89.91%	51	15.60%
街	983		12	101	0.01525%	595409	89.92%	41	12.54%
酸	984		14	101	0.01525%	595510	89.94%	26	7.95%
壯	985		7	100	0.0151%	595610	89.95%	63	19.27%
描	986		12	100	0.0151%	595710	89.97%	36	11.01%
索	987		10	100	0.0151%	595810	89.98%	63	19.27%
繫	988		19	100	0.0151%	595910	90.00%	54	16.51%
伍	989		6	99	0.01495%	596009	90.01%	47	14.37%
域	990		11	99	0.01495%	596108	90.03%	40	12.23%
宇	991		6	99	0.01495%	596207	90.04%	20	6.12%
懂	992		17	99	0.01495%	596306	90.06%	52	15.90%
替	993		12	99	0.01495%	596405	90.07%	59	18.04%
楚	994		13	99	0.01495%	596504	90.09%	67	20.49%
盛	995		11	99	0.01495%	596603	90.10%	56	17.13%
肯	996		8	99	0.01495%	596702	90.12%	59	18.04%
嘴	997		15	98	0.0148%	596800	90.13%	44	13.46%
酒	998		10	98	0.0148%	596898	90.15%	27	8.26%
鎮	999		18	98	0.0148%	596996	90.16%	38	11.62%
霧	1000		19	98	0.0148%	597094	90.18%	33	10.09%
尚	1001		8	97	0.01465%	597191	90.19%	33	10.09%
珠	1002		10	97	0.01465%	597288	90.21%	44	13.46%
窮	1003		15	97	0.01465%	597385	90.22%	49	14.98%
蒙	1004		14	97	0.01465%	597482	90.24%	43	13.15%
哲	1005		10	96	0.0145%	597578	90.25%	23	7.03%
川	1006		3	96	0.0145%	597674	90.26%	25	7.65%
希	1007		7	96	0.0145%	597770	90.28%	69	21.10%
播	1008		15	96	0.0145%	597866	90.29%	39	11.93%
擺	1009		18	96	0.0145%	597962	90.31%	63	19.27%
汽	1010		7	96	0.0145%	598058	90.32%	37	11.31%
荷	1011		11	96	0.0145%	598154	90.34%	20	6.12%
雷	1012		13	96	0.0145%	598250	90.35%	49	14.98%
味	1013		8	95	0.01435%	598345	90.37%	57	17.43%
延	1014		8	95	0.01435%	598440	90.38%	36	11.01%
朋	1015		8	95	0.01435%	598535	90.39%	44	13.46%
渡	1016		12	95	0.01435%	598630	90.41%	30	9.17%
父	1017		4	95	0.01435%	598725	90.42%	31	9.48%
鍵	1018		17	95	0.01435%	598820	90.44%	33	10.09%
探	1019		11	94	0.0142%	598914	90.45%	47	14.37%
沿	1020		8	94	0.0142%	599008	90.47%	53	16.21%
範	1021		15	94	0.0142%	599102	90.48%	53	16.21%
篇	1022		15	94	0.0142%	599196	90.49%	43	13.15%
載	1023		13	94	0.0142%	599290	90.51%	43	13.15%
吳	1024		7	93	0.01405%	599383	90.52%	18	5.51%
壁	1025		16	93	0.01405%	599476	90.54%	38	11.62%
泰	1026		10	93	0.01405%	599569	90.55%	27	8.26%
艱	1027		17	93	0.01405%	599662	90.57%	55	16.82%
幅	1028		12	92	0.01389%	599754	90.58%	39	11.93%
朵	1029		6	92	0.01389%	599846	90.59%	31	9.48%
秀	1030		7	92	0.01389%	599938	90.61%	47	14.37%
端	1031		14	92	0.01389%	600030	90.62%	62	18.96%
着	1032		11	92	0.01389%	600122	90.63%	50	15.29%
腿	1033		14	92	0.01389%	600214	90.65%	33	10.09%
苗	1034		9	92	0.01389%	600306	90.66%	31	9.48%
適	1035		14	92	0.01389%	600398	90.68%	57	17.43%
佛	1036		7	91	0.01374%	600489	90.69%	17	5.20%
夏	1037		10	91	0.01374%	600580	90.70%	40	12.23%
幕	1038		14	91	0.01374%	600671	90.72%	42	12.84%
掛	1039		11	91	0.01374%	600762	90.73%	47	14.37%
疊	1040		22	91	0.01374%	600853	90.74%	18	5.51%
禁	1041		13	91	0.01374%	600944	90.76%	53	16.21%
絲	1042		12	91	0.01374%	601035	90.77%	52	15.90%
駐	1043		15	91	0.01374%	601126	90.79%	43	13.15%
井	1044		4	90	0.01359%	601216	90.80%	22	6.73%
召	1045		5	90	0.01359%	601306	90.81%	54	16.51%
哈	1046		9	90	0.01359%	601396	90.83%	37	11.31%
啦	1047		11	90	0.01359%	601486	90.84%	26	7.95%
尖	1048		6	90	0.01359%	601576	90.85%	47	14.37%
托	1049		6	90	0.01359%	601666	90.87%	52	15.90%
揭	1050		12	90	0.01359%	601756	90.88%	48	14.68%
撮	1051		15	90	0.01359%	601846	90.89%	26	7.95%
猛	1052		11	90	0.01359%	601936	90.91%	49	14.98%
男	1053		7	90	0.01359%	602026	90.92%	34	10.40%
筆	1054		12	90	0.01359%	602116	90.94%	56	17.13%
遇	1055		12	90	0.01359%	602206	90.95%	51	15.60%
順	1056		12	90	0.01359%	602296	90.96%	52	15.90%
傅	1057		12	89	0.01344%	602385	90.98%	10	3.06%
巧	1058		5	89	0.01344%	602474	90.99%	45	13.76%
窗	1059		12	89	0.01344%	602563	91.00%	39	11.93%
累	1060		11	89	0.01344%	602652	91.02%	46	14.07%
練	1061		15	89	0.01344%	602741	91.03%	47	14.37%
膽	1062		17	89	0.01344%	602830	91.04%	34	10.40%
臨	1063		17	89	0.01344%	602919	91.06%	61	18.65%
莊	1064		11	89	0.01344%	603008	91.07%	39	11.93%
陸	1065		10	89	0.01344%	603097	91.08%	40	12.23%
借	1066		10	88	0.01329%	603185	91.10%	44	13.46%
劉	1067		15	88	0.01329%	603273	91.11%	28	8.56%
咱	1068		9	88	0.01329%	603361	91.12%	29	8.87%
宙	1069		8	88	0.01329%	603449	91.14%	13	3.98%
惡	1070		12	88	0.01329%	603537	91.15%	45	13.76%
歐	1071		15	88	0.01329%	603625	91.16%	29	8.87%
禮	1072		17	88	0.01329%	603713	91.18%	42	12.84%
莫	1073		11	88	0.01329%	603801	91.19%	37	11.31%
退	1074		9	88	0.01329%	603889	91.20%	47	14.37%
阻	1075		7	88	0.01329%	603977	91.22%	56	17.13%
億	1076		15	87	0.01314%	604064	91.23%	43	13.15%
午	1077		4	87	0.01314%	604151	91.24%	52	15.90%
婦	1078		11	87	0.01314%	604238	91.26%	41	12.54%
挑	1079		9	87	0.01314%	604325	91.27%	52	15.90%
泥	1080		8	87	0.01314%	604412	91.28%	39	11.93%
淡	1081		11	87	0.01314%	604499	91.30%	34	10.40%
煉	1082		13	87	0.01314%	604586	91.31%	43	13.15%
瓦	1083		5	87	0.01314%	604673	91.32%	43	13.15%
腦	1084		13	87	0.01314%	604760	91.33%	47	14.37%
追	1085		9	87	0.01314%	604847	91.35%	46	14.07%
途	1086		10	87	0.01314%	604934	91.36%	60	18.35%
插	1087		12	86	0.01299%	605020	91.37%	48	14.68%
訓	1088		10	86	0.01299%	605106	91.39%	38	11.62%
輝	1089		15	86	0.01299%	605192	91.40%	59	18.04%
險	1090		15	86	0.01299%	605278	91.41%	52	15.90%
弄	1091		7	85	0.01284%	605363	91.43%	54	16.51%
摸	1092		14	85	0.01284%	605448	91.44%	40	12.23%
濃	1093		16	85	0.01284%	605533	91.45%	40	12.23%
瑞	1094		13	85	0.01284%	605618	91.46%	23	7.03%
迷	1095		9	85	0.01284%	605703	91.48%	45	13.76%
伊	1096		6	84	0.01269%	605787	91.49%	28	8.56%
折	1097		7	84	0.01269%	605871	91.50%	56	17.13%
洗	1098		9	84	0.01269%	605955	91.52%	40	12.23%
碼	1099		15	84	0.01269%	606039	91.53%	24	7.34%
聞	1100		14	84	0.01269%	606123	91.54%	51	15.60%
胡	1101		9	84	0.01269%	606207	91.55%	38	11.62%
航	1102		10	84	0.01269%	606291	91.57%	23	7.03%
課	1103		15	84	0.01269%	606375	91.58%	34	10.40%
危	1104		6	83	0.01254%	606458	91.59%	42	12.84%
厚	1105		9	83	0.01254%	606541	91.60%	53	16.21%
坡	1106		8	83	0.01254%	606624	91.62%	29	8.87%
寶	1107		20	83	0.01254%	606707	91.63%	51	15.60%
尺	1108		4	83	0.01254%	606790	91.64%	23	7.03%
敗	1109		11	83	0.01254%	606873	91.65%	46	14.07%
朱	1110		6	83	0.01254%	606956	91.67%	17	5.20%
梅	1111		11	83	0.01254%	607039	91.68%	22	6.73%
灰	1112		6	83	0.01254%	607122	91.69%	43	13.15%
狂	1113		7	83	0.01254%	607205	91.70%	46	14.07%
藍	1114		18	83	0.01254%	607288	91.72%	36	11.01%
袖	1115		10	83	0.01254%	607371	91.73%	46	14.07%
鳥	1116		11	83	0.01254%	607454	91.74%	32	9.79%
伙	1117		6	82	0.01238%	607536	91.75%	50	15.29%
傾	1118		13	82	0.01238%	607618	91.77%	40	12.23%
室	1119		9	82	0.01238%	607700	91.78%	41	12.54%
榮	1120		14	82	0.01238%	607782	91.79%	51	15.60%
毀	1121		13	82	0.01238%	607864	91.80%	40	12.23%
泛	1122		8	82	0.01238%	607946	91.82%	59	18.04%
測	1123		12	82	0.01238%	608028	91.83%	31	9.48%
穩	1124		19	82	0.01238%	608110	91.84%	40	12.23%
箭	1125		15	82	0.01238%	608192	91.85%	22	6.73%
置	1126		13	82	0.01238%	608274	91.87%	42	12.84%
罪	1127		13	82	0.01238%	608356	91.88%	38	11.62%
預	1128		13	82	0.01238%	608438	91.89%	46	14.07%
堂	1129		11	81	0.01223%	608519	91.90%	40	12.23%
宋	1130		7	81	0.01223%	608600	91.91%	19	5.81%
輯	1131		16	81	0.01223%	608681	91.93%	17	5.20%
附	1132		7	81	0.01223%	608762	91.94%	50	15.29%
飼	1133		13	81	0.01223%	608843	91.95%	12	3.67%
假	1134		11	80	0.01208%	608923	91.96%	38	11.62%
堆	1135		11	80	0.01208%	609003	91.98%	41	12.54%
宮	1136		10	80	0.01208%	609083	91.99%	18	5.51%
橋	1137		16	80	0.01208%	609163	92.00%	38	11.62%
歸	1138		18	80	0.01208%	609243	92.01%	53	16.21%
濤	1139		17	80	0.01208%	609323	92.02%	15	4.59%
炮	1140		9	80	0.01208%	609403	92.04%	31	9.48%
率	1141		11	80	0.01208%	609483	92.05%	46	14.07%
築	1142		16	80	0.01208%	609563	92.06%	39	11.93%
耳	1143		6	80	0.01208%	609643	92.07%	41	12.54%
虎	1144		8	80	0.01208%	609723	92.08%	34	10.40%
卡	1145		5	79	0.01193%	609802	92.10%	41	12.54%
喊	1146		12	79	0.01193%	609881	92.11%	30	9.17%
奔	1147		8	79	0.01193%	609960	92.12%	45	13.76%
殺	1148		11	79	0.01193%	610039	92.13%	40	12.23%
短	1149		12	79	0.01193%	610118	92.14%	48	14.68%
蟲	1150		18	79	0.01193%	610197	92.16%	28	8.56%
補	1151		12	79	0.01193%	610276	92.17%	40	12.23%
訪	1152		11	79	0.01193%	610355	92.18%	40	12.23%
邏	1153		22	79	0.01193%	610434	92.19%	15	4.59%
勁	1154		9	78	0.01178%	610512	92.20%	46	14.07%
塘	1155		13	78	0.01178%	610590	92.22%	19	5.81%
沖	1156		7	78	0.01178%	610668	92.23%	44	13.46%
硬	1157		12	78	0.01178%	610746	92.24%	42	12.84%
頓	1158		13	78	0.01178%	610824	92.25%	51	15.60%
騰	1159		20	78	0.01178%	610902	92.26%	38	11.62%
吉	1160		6	77	0.01163%	610979	92.27%	30	9.17%
橫	1161		16	77	0.01163%	611056	92.29%	52	15.90%
爛	1162		21	77	0.01163%	611133	92.30%	44	13.46%
祝	1163		9	77	0.01163%	611210	92.31%	44	13.46%
粗	1164		11	77	0.01163%	611287	92.32%	49	14.98%
納	1165		10	77	0.01163%	611364	92.33%	44	13.46%
荒	1166		10	77	0.01163%	611441	92.34%	40	12.23%
凡	1167		3	76	0.01148%	611517	92.36%	45	13.76%
拔	1168		8	76	0.01148%	611593	92.37%	36	11.01%
混	1169		11	76	0.01148%	611669	92.38%	49	14.98%
牛	1170		4	76	0.01148%	611745	92.39%	48	14.68%
銅	1171		14	76	0.01148%	611821	92.40%	22	6.73%
闊	1172		17	76	0.01148%	611897	92.41%	53	16.21%
岩	1173		8	75	0.01133%	611972	92.42%	24	7.34%
慈	1174		13	75	0.01133%	612047	92.44%	12	3.67%
旋	1175		11	75	0.01133%	612122	92.45%	23	7.03%
暗	1176		13	75	0.01133%	612197	92.46%	40	12.23%
泳	1177		8	75	0.01133%	612272	92.47%	12	3.67%
紡	1178		10	75	0.01133%	612347	92.48%	10	3.06%
藏	1179		18	75	0.01133%	612422	92.49%	47	14.37%
銀	1180		14	75	0.01133%	612497	92.50%	39	11.93%
飄	1181		20	75	0.01133%	612572	92.51%	37	11.31%
伸	1182		7	74	0.01118%	612646	92.53%	44	13.46%
呵	1183		8	74	0.01118%	612720	92.54%	27	8.26%
寬	1184		15	74	0.01118%	612794	92.55%	40	12.23%
晨	1185		11	74	0.01118%	612868	92.56%	38	11.62%
檢	1186		17	74	0.01118%	612942	92.57%	47	14.37%
減	1187		12	74	0.01118%	613016	92.58%	48	14.68%
異	1188		11	74	0.01118%	613090	92.59%	47	14.37%
移	1189		11	74	0.01118%	613164	92.60%	50	15.29%
符	1190		11	74	0.01118%	613238	92.62%	40	12.23%
醒	1191		16	74	0.01118%	613312	92.63%	41	12.54%
骨	1192		10	74	0.01118%	613386	92.64%	50	15.29%
冬	1193		5	73	0.01102%	613459	92.65%	33	10.09%
悟	1194		10	73	0.01102%	613532	92.66%	46	14.07%
洛	1195		9	73	0.01102%	613605	92.67%	27	8.26%
粒	1196		11	73	0.01102%	613678	92.68%	25	7.65%
遭	1197		14	73	0.01102%	613751	92.69%	51	15.60%
倍	1198		10	72	0.01087%	613823	92.70%	44	13.46%
兄	1199		5	72	0.01087%	613895	92.71%	33	10.09%
勤	1200		13	72	0.01087%	613967	92.73%	42	12.84%
操	1201		16	72	0.01087%	614039	92.74%	41	12.54%
智	1202		12	72	0.01087%	614111	92.75%	34	10.40%
宜	1203		8	71	0.01072%	614182	92.76%	40	12.23%
庫	1204		10	71	0.01072%	614253	92.77%	28	8.56%
抽	1205		8	71	0.01072%	614324	92.78%	48	14.68%
樓	1206		15	71	0.01072%	614395	92.79%	33	10.09%
療	1207		17	71	0.01072%	614466	92.80%	20	6.12%
碰	1208		13	71	0.01072%	614537	92.81%	43	13.15%
赫	1209		14	71	0.01072%	614608	92.82%	21	6.42%
鬼	1210		10	71	0.01072%	614679	92.83%	32	9.79%
免	1211		7	70	0.01057%	614749	92.84%	52	15.90%
媽	1212		13	70	0.01057%	614819	92.85%	11	3.36%
寒	1213		12	70	0.01057%	614889	92.86%	42	12.84%
案	1214		10	70	0.01057%	614959	92.88%	32	9.79%
梁	1215		11	70	0.01057%	615029	92.89%	18	5.51%
聚	1216		14	70	0.01057%	615099	92.90%	38	11.62%
若	1217		9	70	0.01057%	615169	92.91%	43	13.15%
菜	1218		12	70	0.01057%	615239	92.92%	28	8.56%
輛	1219		15	70	0.01057%	615309	92.93%	30	9.17%
旺	1220		8	69	0.01042%	615378	92.94%	22	6.73%
曉	1221		16	69	0.01042%	615447	92.95%	27	8.26%
杯	1222		8	69	0.01042%	615516	92.96%	26	7.95%
爐	1223		20	69	0.01042%	615585	92.97%	17	5.20%
羊	1224		6	69	0.01042%	615654	92.98%	23	7.03%
薄	1225		17	69	0.01042%	615723	92.99%	33	10.09%
釋	1226		20	69	0.01042%	615792	93.00%	39	11.93%
麥	1227		11	69	0.01042%	615861	93.01%	30	9.17%
哥	1228		10	68	0.01027%	615929	93.02%	34	10.40%
妹	1229		8	68	0.01027%	615997	93.03%	13	3.98%
愈	1230		13	68	0.01027%	616065	93.04%	21	6.42%
慣	1231		14	68	0.01027%	616133	93.05%	49	14.98%
欣	1232		8	68	0.01027%	616201	93.06%	43	13.15%
磨	1233		16	68	0.01027%	616269	93.07%	32	9.79%
邢	1234		6	68	0.01027%	616337	93.08%	4	1.22%
鞏	1235		15	68	0.01027%	616405	93.09%	37	11.31%
健	1236		11	67	0.01012%	616472	93.10%	46	14.07%
决	1237		6	67	0.01012%	616539	93.11%	31	9.48%
刀	1238		2	67	0.01012%	616606	93.12%	37	11.31%
杜	1239		7	67	0.01012%	616673	93.13%	30	9.17%
桂	1240		10	67	0.01012%	616740	93.14%	13	3.98%
洞	1241		9	67	0.01012%	616807	93.15%	35	10.70%
港	1242		12	67	0.01012%	616874	93.16%	27	8.26%
螟	1243		16	67	0.01012%	616941	93.17%	1	0.31%
襲	1244		22	67	0.01012%	617008	93.18%	34	10.40%
趣	1245		15	67	0.01012%	617075	93.19%	39	11.93%
冠	1246		9	66	0.009968%	617141	93.20%	22	6.73%
勒	1247		11	66	0.009968%	617207	93.21%	31	9.48%
守	1248		6	66	0.009968%	617273	93.22%	44	13.46%
幸	1249		8	66	0.009968%	617339	93.23%	33	10.09%
徒	1250		10	66	0.009968%	617405	93.24%	33	10.09%
忠	1251		8	66	0.009968%	617471	93.25%	40	12.23%
慮	1252		15	66	0.009968%	617537	93.26%	35	10.70%
敬	1253		13	66	0.009968%	617603	93.27%	33	10.09%
昌	1254		8	66	0.009968%	617669	93.28%	19	5.81%
狠	1255		9	66	0.009968%	617735	93.29%	27	8.26%
薩	1256		18	66	0.009968%	617801	93.30%	31	9.48%
覽	1257		21	66	0.009968%	617867	93.31%	24	7.34%
誼	1258		15	66	0.009968%	617933	93.32%	34	10.40%
貌	1259		14	66	0.009968%	617999	93.33%	40	12.23%
鹽	1260		24	66	0.009968%	618065	93.34%	15	4.59%
凝	1261		16	65	0.009817%	618130	93.35%	30	9.17%
割	1262		12	65	0.009817%	618195	93.36%	33	10.09%
怒	1263		9	65	0.009817%	618260	93.37%	37	11.31%
慶	1264		15	65	0.009817%	618325	93.38%	31	9.48%
柬	1265		9	65	0.009817%	618390	93.39%	9	2.75%
繁	1266		17	65	0.009817%	618455	93.40%	40	12.23%
蒼	1267		14	65	0.009817%	618520	93.41%	27	8.26%
賓	1268		14	65	0.009817%	618585	93.42%	20	6.12%
輸	1269		16	65	0.009817%	618650	93.43%	25	7.65%
雕	1270		16	65	0.009817%	618715	93.44%	24	7.34%
伴	1271		7	64	0.009666%	618779	93.45%	41	12.54%
坦	1272		8	64	0.009666%	618843	93.46%	33	10.09%
旱	1273		7	64	0.009666%	618907	93.47%	28	8.56%
肩	1274		8	64	0.009666%	618971	93.48%	32	9.79%
儀	1275		15	63	0.009515%	619034	93.49%	28	8.56%
援	1276		12	63	0.009515%	619097	93.50%	40	12.23%
擁	1277		16	63	0.009515%	619160	93.51%	42	12.84%
涼	1278		11	63	0.009515%	619223	93.52%	33	10.09%
甲	1279		5	63	0.009515%	619286	93.53%	24	7.34%
碎	1280		13	63	0.009515%	619349	93.54%	46	14.07%
紛	1281		10	63	0.009515%	619412	93.55%	35	10.70%
遺	1282		15	63	0.009515%	619475	93.56%	36	11.01%
壤	1283		20	62	0.009364%	619537	93.57%	29	8.87%
烏	1284		10	62	0.009364%	619599	93.58%	25	7.65%
股	1285		8	62	0.009364%	619661	93.59%	45	13.76%
冒	1286		9	61	0.009213%	619722	93.59%	33	10.09%
勃	1287		9	61	0.009213%	619783	93.60%	30	9.17%
攪	1288		23	61	0.009213%	619844	93.61%	14	4.28%
救	1289		11	61	0.009213%	619905	93.62%	38	11.62%
殿	1290		13	61	0.009213%	619966	93.63%	14	4.28%
毫	1291		11	61	0.009213%	620027	93.64%	45	13.76%
湧	1292		12	61	0.009213%	620088	93.65%	36	11.01%
滾	1293		14	61	0.009213%	620149	93.66%	27	8.26%
灣	1294		25	61	0.009213%	620210	93.67%	22	6.73%
炸	1295		9	61	0.009213%	620271	93.68%	30	9.17%
菌	1296		12	61	0.009213%	620332	93.69%	9	2.75%
蛋	1297		11	61	0.009213%	620393	93.70%	25	7.65%
諾	1298		16	61	0.009213%	620454	93.71%	21	6.42%
謝	1299		17	61	0.009213%	620515	93.71%	38	11.62%
貝	1300		7	61	0.009213%	620576	93.72%	19	5.81%
貢	1301		10	61	0.009213%	620637	93.73%	37	11.31%
避	1302		16	61	0.009213%	620698	93.74%	45	13.76%
銳	1303		15	61	0.009213%	620759	93.75%	30	9.17%
偷	1304		11	60	0.009062%	620819	93.76%	26	7.95%
獎	1305		15	60	0.009062%	620879	93.77%	22	6.73%
庭	1306		10	60	0.009062%	620939	93.78%	34	10.40%
康	1307		11	60	0.009062%	620999	93.79%	39	11.93%
抱	1308		8	60	0.009062%	621059	93.80%	43	13.15%
殘	1309		12	60	0.009062%	621119	93.81%	38	11.62%
汗	1310		6	60	0.009062%	621179	93.81%	29	8.87%
灌	1311		21	60	0.009062%	621239	93.82%	24	7.34%
灘	1312		22	60	0.009062%	621299	93.83%	21	6.42%
耕	1313		10	60	0.009062%	621359	93.84%	28	8.56%
肉	1314		6	60	0.009062%	621419	93.85%	32	9.79%
鴨	1315		16	60	0.009062%	621479	93.86%	12	3.67%
埔	1316		10	59	0.008911%	621538	93.87%	10	3.06%
彎	1317		22	59	0.008911%	621597	93.88%	31	9.48%
拖	1318		8	59	0.008911%	621656	93.89%	32	9.79%
挖	1319		9	59	0.008911%	621715	93.90%	37	11.31%
桌	1320		10	59	0.008911%	621774	93.90%	24	7.34%
漫	1321		14	59	0.008911%	621833	93.91%	38	11.62%
災	1322		7	59	0.008911%	621892	93.92%	23	7.03%
牲	1323		9	59	0.008911%	621951	93.93%	36	11.01%
狗	1324		8	59	0.008911%	622010	93.94%	28	8.56%
紹	1325		11	59	0.008911%	622069	93.95%	38	11.62%
譯	1326		20	59	0.008911%	622128	93.96%	11	3.36%
辟	1327		13	59	0.008911%	622187	93.97%	22	6.73%
迪	1328		8	59	0.008911%	622246	93.98%	24	7.34%
偏	1329		11	58	0.00876%	622304	93.98%	37	11.31%
妙	1330		7	58	0.00876%	622362	93.99%	36	11.01%
捕	1331		10	58	0.00876%	622420	94.00%	23	7.03%
末	1332		5	58	0.00876%	622478	94.01%	34	10.40%
牧	1333		8	58	0.00876%	622536	94.02%	21	6.42%
瑰	1334		14	58	0.00876%	622594	94.03%	11	3.36%
皇	1335		9	58	0.00876%	622652	94.04%	24	7.34%
編	1336		15	58	0.00876%	622710	94.05%	40	12.23%
虛	1337		12	58	0.00876%	622768	94.05%	32	9.79%
飽	1338		13	58	0.00876%	622826	94.06%	28	8.56%
伏	1339		6	57	0.008609%	622883	94.07%	30	9.17%
仰	1340		6	57	0.008609%	622940	94.08%	32	9.79%
措	1341		11	57	0.008609%	622997	94.09%	35	10.70%
洪	1342		9	57	0.008609%	623054	94.10%	22	6.73%
溝	1343		13	57	0.008609%	623111	94.11%	28	8.56%
牡	1344		7	57	0.008609%	623168	94.12%	5	1.53%
私	1345		7	57	0.008609%	623225	94.12%	24	7.34%
臂	1346		17	57	0.008609%	623282	94.13%	24	7.34%
輩	1347		15	57	0.008609%	623339	94.14%	31	9.48%
床	1348		7	56	0.008458%	623395	94.15%	27	8.26%
徑	1349		10	56	0.008458%	623451	94.16%	33	10.09%
抬	1350		8	56	0.008458%	623507	94.17%	31	9.48%
森	1351		12	56	0.008458%	623563	94.17%	35	10.70%
淚	1352		11	56	0.008458%	623619	94.18%	30	9.17%
爬	1353		8	56	0.008458%	623675	94.19%	32	9.79%
薛	1354		17	56	0.008458%	623731	94.20%	5	1.53%
隆	1355		11	56	0.008458%	623787	94.21%	30	9.17%
騎	1356		18	56	0.008458%	623843	94.22%	22	6.73%
鬆	1357		18	56	0.008458%	623899	94.23%	33	10.09%
休	1358		6	55	0.008306%	623954	94.23%	35	10.70%
划	1359		6	55	0.008306%	624009	94.24%	11	3.36%
圓	1360		13	55	0.008306%	624064	94.25%	35	10.70%
塞	1361		13	55	0.008306%	624119	94.26%	38	11.62%
掃	1362		11	55	0.008306%	624174	94.27%	37	11.31%
緩	1363		15	55	0.008306%	624229	94.28%	27	8.26%
衝	1364		15	55	0.008306%	624284	94.28%	23	7.03%
隱	1365		16	55	0.008306%	624339	94.29%	32	9.79%
叔	1366		8	54	0.008155%	624393	94.30%	12	3.67%
嘆	1367		14	54	0.008155%	624447	94.31%	25	7.65%
孤	1368		8	54	0.008155%	624501	94.32%	35	10.70%
帥	1369		9	54	0.008155%	624555	94.32%	24	7.34%
干	1370		3	54	0.008155%	624609	94.33%	29	8.87%
彭	1371		12	54	0.008155%	624663	94.34%	8	2.45%
扎	1372		4	54	0.008155%	624717	94.35%	35	10.70%
櫻	1373		21	54	0.008155%	624771	94.36%	3	0.92%
氨	1374		10	54	0.008155%	624825	94.37%	5	1.53%
轟	1375		21	54	0.008155%	624879	94.37%	31	9.48%
錫	1376		16	54	0.008155%	624933	94.38%	11	3.36%
乙	1377		1	53	0.008004%	624986	94.39%	9	2.75%
倡	1378		10	53	0.008004%	625039	94.40%	29	8.87%
刺	1379		8	53	0.008004%	625092	94.41%	35	10.70%
卷	1380		8	53	0.008004%	625145	94.41%	26	7.95%
奴	1381		5	53	0.008004%	625198	94.42%	19	5.81%
婆	1382		11	53	0.008004%	625251	94.43%	15	4.59%
恰	1383		9	53	0.008004%	625304	94.44%	35	10.70%
悉	1384		11	53	0.008004%	625357	94.45%	34	10.40%
您	1385		11	53	0.008004%	625410	94.45%	8	2.45%
憶	1386		16	53	0.008004%	625463	94.46%	28	8.56%
框	1387		10	53	0.008004%	625516	94.47%	18	5.51%
楊	1388		13	53	0.008004%	625569	94.48%	28	8.56%
池	1389		6	53	0.008004%	625622	94.49%	15	4.59%
玩	1390		8	53	0.008004%	625675	94.49%	31	9.48%
疑	1391		14	53	0.008004%	625728	94.50%	40	12.23%
碗	1392		13	53	0.008004%	625781	94.51%	21	6.42%
秒	1393		9	53	0.008004%	625834	94.52%	14	4.28%
綫	1394		14	53	0.008004%	625887	94.53%	13	3.98%
聖	1395		13	53	0.008004%	625940	94.53%	26	7.95%
鑫	1396		24	53	0.008004%	625993	94.54%	1	0.31%
碧	1397		14	52	0.007853%	626045	94.55%	22	6.73%
縱	1398		17	52	0.007853%	626097	94.56%	35	10.70%
繞	1399		18	52	0.007853%	626149	94.57%	37	11.31%
肅	1400		12	52	0.007853%	626201	94.57%	40	12.23%
賞	1401		15	52	0.007853%	626253	94.58%	33	10.09%
駛	1402		15	52	0.007853%	626305	94.59%	22	6.73%
予	1403		4	51	0.007702%	626356	94.60%	36	11.01%
仔	1404		5	51	0.007702%	626407	94.60%	30	9.17%
叛	1405		9	51	0.007702%	626458	94.61%	21	6.42%
奧	1406		13	51	0.007702%	626509	94.62%	25	7.65%
强	1407		12	51	0.007702%	626560	94.63%	27	8.26%
悄	1408		10	51	0.007702%	626611	94.64%	18	5.51%
抵	1409		8	51	0.007702%	626662	94.64%	35	10.70%
捉	1410		10	51	0.007702%	626713	94.65%	19	5.81%
昏	1411		8	51	0.007702%	626764	94.66%	30	9.17%
浮	1412		10	51	0.007702%	626815	94.67%	28	8.56%
玫	1413		8	51	0.007702%	626866	94.67%	9	2.75%
蔣	1414		15	51	0.007702%	626917	94.68%	13	3.98%
仙	1415		5	50	0.007551%	626967	94.69%	25	7.65%
峽	1416		10	50	0.007551%	627017	94.70%	12	3.67%
恢	1417		9	50	0.007551%	627067	94.70%	33	10.09%
戴	1418		17	50	0.007551%	627117	94.71%	31	9.48%
摘	1419		14	50	0.007551%	627167	94.72%	30	9.17%
液	1420		11	50	0.007551%	627217	94.73%	19	5.81%
眉	1421		9	50	0.007551%	627267	94.73%	29	8.87%
純	1422		10	50	0.007551%	627317	94.74%	36	11.01%
耀	1423		20	50	0.007551%	627367	94.75%	35	10.70%
腰	1424		13	50	0.007551%	627417	94.76%	27	8.26%
覆	1425		18	50	0.007551%	627467	94.76%	36	11.01%
豆	1426		7	50	0.007551%	627517	94.77%	18	5.51%
雞	1427		18	50	0.007551%	627567	94.78%	21	6.42%
額	1428		18	50	0.007551%	627617	94.79%	31	9.48%
亡	1429		3	49	0.0074%	627666	94.79%	31	9.48%
叢	1430		18	49	0.0074%	627715	94.80%	26	7.95%
尤	1431		4	49	0.0074%	627764	94.81%	28	8.56%
屆	1432		8	49	0.0074%	627813	94.82%	26	7.95%
栽	1433		10	49	0.0074%	627862	94.82%	24	7.34%
棵	1434		12	49	0.0074%	627911	94.83%	22	6.73%
淨	1435		11	49	0.0074%	627960	94.84%	26	7.95%
玻	1436		9	49	0.0074%	628009	94.85%	21	6.42%
璃	1437		15	49	0.0074%	628058	94.85%	21	6.42%
胸	1438		10	49	0.0074%	628107	94.86%	29	8.87%
艇	1439		13	49	0.0074%	628156	94.87%	11	3.36%
蘆	1440		20	49	0.0074%	628205	94.88%	9	2.75%
訊	1441		10	49	0.0074%	628254	94.88%	29	8.87%
賈	1442		13	49	0.0074%	628303	94.89%	6	1.84%
乘	1443		10	48	0.007249%	628351	94.90%	33	10.09%
堡	1444		12	48	0.007249%	628399	94.91%	30	9.17%
尊	1445		12	48	0.007249%	628447	94.91%	26	7.95%
搭	1446		13	48	0.007249%	628495	94.92%	25	7.65%
染	1447		9	48	0.007249%	628543	94.93%	32	9.79%
株	1448		10	48	0.007249%	628591	94.93%	18	5.51%
殊	1449		10	48	0.007249%	628639	94.94%	30	9.17%
牌	1450		12	48	0.007249%	628687	94.95%	25	7.65%
珍	1451		9	48	0.007249%	628735	94.96%	30	9.17%
疾	1452		10	48	0.007249%	628783	94.96%	24	7.34%
豪	1453		14	48	0.007249%	628831	94.97%	39	11.93%
遲	1454		15	48	0.007249%	628879	94.98%	22	6.73%
邦	1455		6	48	0.007249%	628927	94.98%	27	8.26%
郵	1456		11	48	0.007249%	628975	94.99%	7	2.14%
頁	1457		9	48	0.007249%	629023	95.00%	13	3.98%
頑	1458		13	48	0.007249%	629071	95.01%	29	8.87%
麻	1459		11	48	0.007249%	629119	95.01%	27	8.26%
偽	1460		11	47	0.007098%	629166	95.02%	19	5.81%
兆	1461		6	47	0.007098%	629213	95.03%	5	1.53%
尾	1462		7	47	0.007098%	629260	95.04%	32	9.79%
崇	1463		11	47	0.007098%	629307	95.04%	31	9.48%
恨	1464		9	47	0.007098%	629354	95.05%	28	8.56%
憲	1465		16	47	0.007098%	629401	95.06%	17	5.20%
敏	1466		11	47	0.007098%	629448	95.06%	23	7.03%
旅	1467		10	47	0.007098%	629495	95.07%	24	7.34%
泉	1468		9	47	0.007098%	629542	95.08%	24	7.34%
漁	1469		14	47	0.007098%	629589	95.08%	22	6.73%
玄	1470		5	47	0.007098%	629636	95.09%	7	2.14%
礙	1471		19	47	0.007098%	629683	95.10%	31	9.48%
踏	1472		15	47	0.007098%	629730	95.11%	30	9.17%
鋒	1473		15	47	0.007098%	629777	95.11%	33	10.09%
陷	1474		10	47	0.007098%	629824	95.12%	34	10.40%
俄	1475		9	46	0.006947%	629870	95.13%	16	4.89%
僧	1476		14	46	0.006947%	629916	95.13%	7	2.14%
匆	1477		5	46	0.006947%	629962	95.14%	18	5.51%
匯	1478		13	46	0.006947%	630008	95.15%	28	8.56%
娃	1479		9	46	0.006947%	630054	95.16%	9	2.75%
擠	1480		17	46	0.006947%	630100	95.16%	25	7.65%
朗	1481		10	46	0.006947%	630146	95.17%	30	9.17%
涉	1482		10	46	0.006947%	630192	95.18%	31	9.48%
灶	1483		7	46	0.006947%	630238	95.18%	10	3.06%
稀	1484		12	46	0.006947%	630284	95.19%	34	10.40%
籃	1485		20	46	0.006947%	630330	95.20%	12	3.67%
觸	1486		20	46	0.006947%	630376	95.20%	38	11.62%
讚	1487		26	46	0.006947%	630422	95.21%	33	10.09%
鋪	1488		15	46	0.006947%	630468	95.22%	32	9.79%
顆	1489		17	46	0.006947%	630514	95.22%	29	8.87%
默	1490		16	46	0.006947%	630560	95.23%	25	7.65%
于	1491		3	45	0.006796%	630605	95.24%	5	1.53%
倉	1492		10	45	0.006796%	630650	95.25%	19	5.81%
埋	1493		10	45	0.006796%	630695	95.25%	28	8.56%
壩	1494		24	45	0.006796%	630740	95.26%	13	3.98%
姿	1495		9	45	0.006796%	630785	95.27%	26	7.95%
孟	1496		8	45	0.006796%	630830	95.27%	11	3.36%
授	1497		11	45	0.006796%	630875	95.28%	21	6.42%
搶	1498		13	45	0.006796%	630920	95.29%	31	9.48%
毅	1499		15	45	0.006796%	630965	95.29%	28	8.56%
爹	1500		10	45	0.006796%	631010	95.30%	8	2.45%
緻	1501		15	45	0.006796%	631055	95.31%	24	7.34%
錦	1502		16	45	0.006796%	631100	95.31%	23	7.03%
闖	1503		18	45	0.006796%	631145	95.32%	25	7.65%
頌	1504		13	45	0.006796%	631190	95.33%	24	7.34%
俗	1505		9	44	0.006645%	631234	95.33%	30	9.17%
叉	1506		3	44	0.006645%	631278	95.34%	8	2.45%
孫	1507		10	44	0.006645%	631322	95.35%	25	7.65%
尋	1508		12	44	0.006645%	631366	95.35%	33	10.09%
控	1509		11	44	0.006645%	631410	95.36%	28	8.56%
撲	1510		15	44	0.006645%	631454	95.37%	29	8.87%
燃	1511		16	44	0.006645%	631498	95.37%	25	7.65%
甜	1512		11	44	0.006645%	631542	95.38%	22	6.73%
紫	1513		12	44	0.006645%	631586	95.39%	20	6.12%
縮	1514		17	44	0.006645%	631630	95.39%	25	7.65%
袋	1515		11	44	0.006645%	631674	95.40%	24	7.34%
顏	1516		18	44	0.006645%	631718	95.41%	32	9.79%
馳	1517		13	44	0.006645%	631762	95.41%	21	6.42%
魂	1518		14	44	0.006645%	631806	95.42%	24	7.34%
串	1519		7	43	0.006494%	631849	95.43%	27	8.26%
嘗	1520		14	43	0.006494%	631892	95.43%	20	6.12%
妄	1521		6	43	0.006494%	631935	95.44%	22	6.73%
巡	1522		7	43	0.006494%	631978	95.45%	21	6.42%
惜	1523		11	43	0.006494%	632021	95.45%	29	8.87%
挺	1524		10	43	0.006494%	632064	95.46%	28	8.56%
損	1525		13	43	0.006494%	632107	95.47%	32	9.79%
柱	1526		9	43	0.006494%	632150	95.47%	25	7.65%
桑	1527		10	43	0.006494%	632193	95.48%	16	4.89%
棄	1528		11	43	0.006494%	632236	95.48%	29	8.87%
綜	1529		14	43	0.006494%	632279	95.49%	22	6.73%
葦	1530		13	43	0.006494%	632322	95.50%	9	2.75%
裡	1531		12	43	0.006494%	632365	95.50%	16	4.89%
隔	1532		12	43	0.006494%	632408	95.51%	34	10.40%
鳴	1533		14	43	0.006494%	632451	95.52%	29	8.87%
鼻	1534		14	43	0.006494%	632494	95.52%	25	7.65%
付	1535		5	42	0.006343%	632536	95.53%	31	9.48%
劑	1536		16	42	0.006343%	632578	95.54%	15	4.59%
恐	1537		10	42	0.006343%	632620	95.54%	28	8.56%
悠	1538		11	42	0.006343%	632662	95.55%	24	7.34%
拼	1539		9	42	0.006343%	632704	95.56%	13	3.98%
振	1540		10	42	0.006343%	632746	95.56%	27	8.26%
搬	1541		13	42	0.006343%	632788	95.57%	27	8.26%
摩	1542		15	42	0.006343%	632830	95.57%	23	7.03%
旦	1543		5	42	0.006343%	632872	95.58%	21	6.42%
浸	1544		10	42	0.006343%	632914	95.59%	22	6.73%
濕	1545		17	42	0.006343%	632956	95.59%	21	6.42%
版	1546		8	42	0.006343%	632998	95.60%	20	6.12%
畜	1547		10	42	0.006343%	633040	95.61%	24	7.34%
瞧	1548		17	42	0.006343%	633082	95.61%	18	5.51%
碑	1549		13	42	0.006343%	633124	95.62%	14	4.28%
葯	1550		13	42	0.006343%	633166	95.63%	19	5.81%
逃	1551		9	42	0.006343%	633208	95.63%	27	8.26%
違	1552		12	42	0.006343%	633250	95.64%	20	6.12%
鏡	1553		19	42	0.006343%	633292	95.64%	22	6.73%
雅	1554		12	42	0.006343%	633334	95.65%	24	7.34%
髮	1555		15	42	0.006343%	633376	95.66%	28	8.56%
鬍	1556		19	42	0.006343%	633418	95.66%	12	3.67%
圈	1557		11	41	0.006192%	633459	95.67%	24	7.34%
墓	1558		14	41	0.006192%	633500	95.68%	11	3.36%
墨	1559		15	41	0.006192%	633541	95.68%	20	6.12%
墻	1560		16	41	0.006192%	633582	95.69%	18	5.51%
寸	1561		3	41	0.006192%	633623	95.69%	18	5.51%
廟	1562		15	41	0.006192%	633664	95.70%	13	3.98%
拍	1563		8	41	0.006192%	633705	95.71%	27	8.26%
昨	1564		9	41	0.006192%	633746	95.71%	29	8.87%
械	1565		11	41	0.006192%	633787	95.72%	23	7.03%
番	1566		12	41	0.006192%	633828	95.73%	31	9.48%
網	1567		14	41	0.006192%	633869	95.73%	27	8.26%
腐	1568		14	41	0.006192%	633910	95.74%	25	7.65%
詠	1569		12	41	0.006192%	633951	95.74%	9	2.75%
譴	1570		21	41	0.006192%	633992	95.75%	18	5.51%
倆	1571		10	40	0.006041%	634032	95.76%	16	4.89%
夢	1572		14	40	0.006041%	634072	95.76%	23	7.03%
序	1573		7	40	0.006041%	634112	95.77%	27	8.26%
弱	1574		10	40	0.006041%	634152	95.77%	30	9.17%
憤	1575		15	40	0.006041%	634192	95.78%	26	7.95%
捧	1576		11	40	0.006041%	634232	95.79%	28	8.56%
撞	1577		15	40	0.006041%	634272	95.79%	22	6.73%
梩	1578		11	40	0.006041%	634312	95.80%	6	1.84%
滑	1579		13	40	0.006041%	634352	95.80%	21	6.42%
狹	1580		10	40	0.006041%	634392	95.81%	21	6.42%
症	1581		10	40	0.006041%	634432	95.82%	12	3.67%
蛇	1582		11	40	0.006041%	634472	95.82%	25	7.65%
蠶	1583		24	40	0.006041%	634512	95.83%	9	2.75%
贊	1584		19	40	0.006041%	634552	95.83%	21	6.42%
鞋	1585		15	40	0.006041%	634592	95.84%	17	5.20%
倫	1586		10	39	0.00589%	634631	95.85%	23	7.03%
側	1587		11	39	0.00589%	634670	95.85%	20	6.12%
哨	1588		10	39	0.00589%	634709	95.86%	16	4.89%
噴	1589		15	39	0.00589%	634748	95.86%	25	7.65%
嚮	1590		18	39	0.00589%	634787	95.87%	20	6.12%
屈	1591		8	39	0.00589%	634826	95.88%	18	5.51%
掩	1592		11	39	0.00589%	634865	95.88%	29	8.87%
擦	1593		17	39	0.00589%	634904	95.89%	24	7.34%
暖	1594		13	39	0.00589%	634943	95.89%	25	7.65%
柔	1595		9	39	0.00589%	634982	95.90%	22	6.73%
燦	1596		17	39	0.00589%	635021	95.91%	25	7.65%
瘦	1597		14	39	0.00589%	635060	95.91%	15	4.59%
監	1598		14	39	0.00589%	635099	95.92%	17	5.20%
緒	1599		14	39	0.00589%	635138	95.92%	23	7.03%
膠	1600		15	39	0.00589%	635177	95.93%	9	2.75%
舜	1601		12	39	0.00589%	635216	95.93%	2	0.61%
葡	1602		13	39	0.00589%	635255	95.94%	10	3.06%
衡	1603		16	39	0.00589%	635294	95.95%	25	7.65%
訂	1604		9	39	0.00589%	635333	95.95%	24	7.34%
霞	1605		17	39	0.00589%	635372	95.96%	17	5.20%
匹	1606		4	38	0.005739%	635410	95.96%	15	4.59%
奏	1607		9	38	0.005739%	635448	95.97%	20	6.12%
姆	1608		8	38	0.005739%	635486	95.98%	15	4.59%
幽	1609		9	38	0.005739%	635524	95.98%	24	7.34%
抹	1610		8	38	0.005739%	635562	95.99%	26	7.95%
泡	1611		8	38	0.005739%	635600	95.99%	13	3.98%
泊	1612		8	38	0.005739%	635638	96.00%	20	6.12%
溪	1613		13	38	0.005739%	635676	96.00%	17	5.20%
疆	1614		19	38	0.005739%	635714	96.01%	19	5.81%
繪	1615		19	38	0.005739%	635752	96.02%	18	5.51%
蓬	1616		15	38	0.005739%	635790	96.02%	21	6.42%
貿	1617		12	38	0.005739%	635828	96.03%	15	4.59%
軌	1618		9	38	0.005739%	635866	96.03%	12	3.67%
辛	1619		7	38	0.005739%	635904	96.04%	24	7.34%
刊	1620		5	37	0.005588%	635941	96.04%	24	7.34%
勵	1621		17	37	0.005588%	635978	96.05%	30	9.17%
寄	1622		11	37	0.005588%	636015	96.06%	24	7.34%
徵	1623		15	37	0.005588%	636052	96.06%	20	6.12%
忍	1624		7	37	0.005588%	636089	96.07%	26	7.95%
敘	1625		11	37	0.005588%	636126	96.07%	20	6.12%
柏	1626		9	37	0.005588%	636163	96.08%	16	4.89%
殲	1627		21	37	0.005588%	636200	96.08%	16	4.89%
溉	1628		12	37	0.005588%	636237	96.09%	13	3.98%
琴	1629		12	37	0.005588%	636274	96.09%	13	3.98%
瓜	1630		5	37	0.005588%	636311	96.10%	19	5.81%
督	1631		13	37	0.005588%	636348	96.11%	18	5.51%
糖	1632		16	37	0.005588%	636385	96.11%	16	4.89%
綱	1633		14	37	0.005588%	636422	96.12%	22	6.73%
舅	1634		13	37	0.005588%	636459	96.12%	2	0.61%
誕	1635		15	37	0.005588%	636496	96.13%	18	5.51%
距	1636		12	37	0.005588%	636533	96.13%	29	8.87%
遵	1637		15	37	0.005588%	636570	96.14%	25	7.65%
隸	1638		17	37	0.005588%	636607	96.14%	15	4.59%
顛	1639		19	37	0.005588%	636644	96.15%	17	5.20%
啟	1640		11	36	0.005437%	636680	96.16%	29	8.87%
嶺	1641		17	36	0.005437%	636716	96.16%	22	6.73%
廢	1642		15	36	0.005437%	636752	96.17%	23	7.03%
挨	1643		10	36	0.005437%	636788	96.17%	25	7.65%
晶	1644		12	36	0.005437%	636824	96.18%	19	5.81%
添	1645		11	36	0.005437%	636860	96.18%	29	8.87%
濱	1646		17	36	0.005437%	636896	96.19%	16	4.89%
耐	1647		9	36	0.005437%	636932	96.19%	24	7.34%
裂	1648		12	36	0.005437%	636968	96.20%	25	7.65%
鍛	1649		17	36	0.005437%	637004	96.20%	26	7.95%
鴻	1650		17	36	0.005437%	637040	96.21%	4	1.22%
麵	1651		20	36	0.005437%	637076	96.22%	5	1.53%
准	1652		10	35	0.005286%	637111	96.22%	25	7.65%
姓	1653		8	35	0.005286%	637146	96.23%	23	7.03%
婷	1654		12	35	0.005286%	637181	96.23%	1	0.31%
幻	1655		4	35	0.005286%	637216	96.24%	25	7.65%
幼	1656		5	35	0.005286%	637251	96.24%	24	7.34%
廳	1657		25	35	0.005286%	637286	96.25%	17	5.20%
扶	1658		7	35	0.005286%	637321	96.25%	18	5.51%
拾	1659		9	35	0.005286%	637356	96.26%	19	5.81%
籠	1660		22	35	0.005286%	637391	96.26%	21	6.42%
萄	1661		12	35	0.005286%	637426	96.27%	9	2.75%
辨	1662		16	35	0.005286%	637461	96.27%	25	7.65%
飾	1663		13	35	0.005286%	637496	96.28%	23	7.03%
鷹	1664		24	35	0.005286%	637531	96.28%	13	3.98%
乏	1665		5	34	0.005135%	637565	96.29%	26	7.95%
伐	1666		6	34	0.005135%	637599	96.29%	24	7.34%
凌	1667		10	34	0.005135%	637633	96.30%	20	6.12%
剩	1668		12	34	0.005135%	637667	96.30%	29	8.87%
壽	1669		14	34	0.005135%	637701	96.31%	23	7.03%
夾	1670		7	34	0.005135%	637735	96.32%	22	6.73%
崗	1671		11	34	0.005135%	637769	96.32%	25	7.65%
帆	1672		6	34	0.005135%	637803	96.33%	11	3.36%
廊	1673		12	34	0.005135%	637837	96.33%	16	4.89%
征	1674		8	34	0.005135%	637871	96.34%	25	7.65%
慧	1675		15	34	0.005135%	637905	96.34%	22	6.73%
攝	1676		21	34	0.005135%	637939	96.35%	22	6.73%
牢	1677		7	34	0.005135%	637973	96.35%	27	8.26%
犧	1678		21	34	0.005135%	638007	96.36%	19	5.81%
甘	1679		5	34	0.005135%	638041	96.36%	28	8.56%
秧	1680		10	34	0.005135%	638075	96.37%	10	3.06%
繩	1681		19	34	0.005135%	638109	96.37%	18	5.51%
蝶	1682		15	34	0.005135%	638143	96.38%	8	2.45%
賀	1683		12	34	0.005135%	638177	96.38%	25	7.65%
蹈	1684		17	34	0.005135%	638211	96.39%	10	3.06%
醉	1685		15	34	0.005135%	638245	96.39%	17	5.20%
哩	1686		10	33	0.004984%	638278	96.40%	16	4.89%
哭	1687		10	33	0.004984%	638311	96.40%	15	4.59%
彼	1688		8	33	0.004984%	638344	96.41%	27	8.26%
捨	1689		11	33	0.004984%	638377	96.41%	23	7.03%
晗	1690		11	33	0.004984%	638410	96.42%	2	0.61%
梯	1691		11	33	0.004984%	638443	96.42%	13	3.98%
歇	1692		13	33	0.004984%	638476	96.43%	17	5.20%
津	1693		9	33	0.004984%	638509	96.43%	11	3.36%
淺	1694		11	33	0.004984%	638542	96.44%	27	8.26%
焦	1695		12	33	0.004984%	638575	96.44%	23	7.03%
矮	1696		13	33	0.004984%	638608	96.45%	15	4.59%
競	1697		20	33	0.004984%	638641	96.45%	16	4.89%
篷	1698		17	33	0.004984%	638674	96.46%	7	2.14%
署	1699		13	33	0.004984%	638707	96.46%	21	6.42%
蒸	1700		14	33	0.004984%	638740	96.47%	16	4.89%
諜	1701		16	33	0.004984%	638773	96.47%	2	0.61%
跡	1702		13	33	0.004984%	638806	96.48%	22	6.73%
遙	1703		13	33	0.004984%	638839	96.48%	23	7.03%
采	1704		8	33	0.004984%	638872	96.49%	21	6.42%
騙	1705		19	33	0.004984%	638905	96.49%	18	5.51%
丈	1706		3	32	0.004833%	638937	96.50%	20	6.12%
偶	1707		11	32	0.004833%	638969	96.50%	29	8.87%
兼	1708		10	32	0.004833%	639001	96.51%	21	6.42%
凍	1709		10	32	0.004833%	639033	96.51%	13	3.98%
吐	1710		6	32	0.004833%	639065	96.52%	25	7.65%
呆	1711		7	32	0.004833%	639097	96.52%	16	4.89%
帽	1712		12	32	0.004833%	639129	96.53%	24	7.34%
徐	1713		10	32	0.004833%	639161	96.53%	15	4.59%
循	1714		12	32	0.004833%	639193	96.54%	27	8.26%
扭	1715		7	32	0.004833%	639225	96.54%	20	6.12%
拋	1716		8	32	0.004833%	639257	96.54%	24	7.34%
撤	1717		14	32	0.004833%	639289	96.55%	18	5.51%
撒	1718		15	32	0.004833%	639321	96.55%	25	7.65%
柴	1719		10	32	0.004833%	639353	96.56%	23	7.03%
漂	1720		14	32	0.004833%	639385	96.56%	19	5.81%
潔	1721		15	32	0.004833%	639417	96.57%	25	7.65%
砂	1722		9	32	0.004833%	639449	96.57%	12	3.67%
穆	1723		16	32	0.004833%	639481	96.58%	16	4.89%
簽	1724		19	32	0.004833%	639513	96.58%	18	5.51%
粥	1725		12	32	0.004833%	639545	96.59%	3	0.92%
糊	1726		15	32	0.004833%	639577	96.59%	22	6.73%
翠	1727		14	32	0.004833%	639609	96.60%	23	7.03%
邁	1728		16	32	0.004833%	639641	96.60%	26	7.95%
郊	1729		8	32	0.004833%	639673	96.61%	19	5.81%
仁	1730		4	31	0.004682%	639704	96.61%	11	3.36%
厲	1731		15	31	0.004682%	639735	96.62%	25	7.65%
峨	1732		10	31	0.004682%	639766	96.62%	9	2.75%
掠	1733		11	31	0.004682%	639797	96.63%	20	6.12%
搜	1734		12	31	0.004682%	639828	96.63%	17	5.20%
晃	1735		10	31	0.004682%	639859	96.64%	16	4.89%
澆	1736		15	31	0.004682%	639890	96.64%	14	4.28%
牆	1737		17	31	0.004682%	639921	96.65%	16	4.89%
畢	1738		11	31	0.004682%	639952	96.65%	20	6.12%
瘋	1739		14	31	0.004682%	639983	96.65%	24	7.34%
籽	1740		9	31	0.004682%	640014	96.66%	7	2.14%
纓	1741		23	31	0.004682%	640045	96.66%	5	1.53%
貼	1742		12	31	0.004682%	640076	96.67%	22	6.73%
遞	1743		13	31	0.004682%	640107	96.67%	17	5.20%
丘	1744		5	30	0.004531%	640137	96.68%	13	3.98%
享	1745		8	30	0.004531%	640167	96.68%	22	6.73%
亭	1746		9	30	0.004531%	640197	96.69%	12	3.67%
仗	1747		5	30	0.004531%	640227	96.69%	21	6.42%
仿	1748		6	30	0.004531%	640257	96.70%	16	4.89%
匈	1749		6	30	0.004531%	640287	96.70%	4	1.22%
惕	1750		11	30	0.004531%	640317	96.71%	20	6.12%
敲	1751		14	30	0.004531%	640347	96.71%	21	6.42%
暫	1752		15	30	0.004531%	640377	96.71%	19	5.81%
曆	1753		16	30	0.004531%	640407	96.72%	9	2.75%
殼	1754		12	30	0.004531%	640437	96.72%	19	5.81%
潤	1755		15	30	0.004531%	640467	96.73%	26	7.95%
炎	1756		8	30	0.004531%	640497	96.73%	13	3.98%
炭	1757		9	30	0.004531%	640527	96.74%	15	4.59%
瓶	1758		11	30	0.004531%	640557	96.74%	14	4.28%
票	1759		11	30	0.004531%	640587	96.75%	14	4.28%
稍	1760		12	30	0.004531%	640617	96.75%	22	6.73%
紗	1761		10	30	0.004531%	640647	96.75%	18	5.51%
綿	1762		14	30	0.004531%	640677	96.76%	22	6.73%
緣	1763		15	30	0.004531%	640707	96.76%	22	6.73%
舍	1764		8	30	0.004531%	640737	96.77%	21	6.42%
茫	1765		10	30	0.004531%	640767	96.77%	16	4.89%
軟	1766		11	30	0.004531%	640797	96.78%	24	7.34%
霸	1767		21	30	0.004531%	640827	96.78%	18	5.51%
頃	1768		11	30	0.004531%	640857	96.79%	17	5.20%
鼠	1769		13	30	0.004531%	640887	96.79%	7	2.14%
丟	1770		6	29	0.00438%	640916	96.80%	21	6.42%
亦	1771		6	29	0.00438%	640945	96.80%	16	4.89%
估	1772		7	29	0.00438%	640974	96.80%	24	7.34%
佐	1773		7	29	0.00438%	641003	96.81%	10	3.06%
卵	1774		7	29	0.00438%	641032	96.81%	12	3.67%
君	1775		7	29	0.00438%	641061	96.82%	17	5.20%
嫩	1776		14	29	0.00438%	641090	96.82%	16	4.89%
憑	1777		16	29	0.00438%	641119	96.83%	24	7.34%
拜	1778		9	29	0.00438%	641148	96.83%	20	6.12%
掘	1779		11	29	0.00438%	641177	96.83%	17	5.20%
梢	1780		11	29	0.00438%	641206	96.84%	14	4.28%
氮	1781		12	29	0.00438%	641235	96.84%	5	1.53%
爆	1782		19	29	0.00438%	641264	96.85%	22	6.73%
疏	1783		11	29	0.00438%	641293	96.85%	20	6.12%
硫	1784		11	29	0.00438%	641322	96.86%	6	1.84%
繡	1785		18	29	0.00438%	641351	96.86%	17	5.20%
誠	1786		13	29	0.00438%	641380	96.87%	23	7.03%
逆	1787		9	29	0.00438%	641409	96.87%	11	3.36%
遷	1788		14	29	0.00438%	641438	96.87%	15	4.59%
閱	1789		15	29	0.00438%	641467	96.88%	18	5.51%
陪	1790		10	29	0.00438%	641496	96.88%	17	5.20%
頻	1791		16	29	0.00438%	641525	96.89%	17	5.20%
傘	1792		12	28	0.004229%	641553	96.89%	11	3.36%
匠	1793		6	28	0.004229%	641581	96.90%	12	3.67%
垂	1794		9	28	0.004229%	641609	96.90%	17	5.20%
壟	1795		19	28	0.004229%	641637	96.90%	17	5.20%
娣	1796		10	28	0.004229%	641665	96.91%	1	0.31%
患	1797		11	28	0.004229%	641693	96.91%	18	5.51%
斜	1798		11	28	0.004229%	641721	96.92%	18	5.51%
杆	1799		7	28	0.004229%	641749	96.92%	19	5.81%
沃	1800		7	28	0.004229%	641777	96.93%	14	4.28%
渠	1801		12	28	0.004229%	641805	96.93%	14	4.28%
潑	1802		15	28	0.004229%	641833	96.93%	20	6.12%
炒	1803		8	28	0.004229%	641861	96.94%	3	0.92%
稼	1804		15	28	0.004229%	641889	96.94%	14	4.28%
肚	1805		7	28	0.004229%	641917	96.95%	21	6.42%
膀	1806		14	28	0.004229%	641945	96.95%	20	6.12%
諸	1807		15	28	0.004229%	641973	96.96%	14	4.28%
閻	1808		16	28	0.004229%	642001	96.96%	9	2.75%
障	1809		13	28	0.004229%	642029	96.96%	21	6.42%
韓	1810		17	28	0.004229%	642057	96.97%	12	3.67%
黎	1811		15	28	0.004229%	642085	96.97%	21	6.42%
凶	1812		4	27	0.004078%	642112	96.98%	16	4.89%
刮	1813		8	27	0.004078%	642139	96.98%	18	5.51%
剪	1814		11	27	0.004078%	642166	96.98%	11	3.36%
嚇	1815		17	27	0.004078%	642193	96.99%	23	7.03%
寮	1816		15	27	0.004078%	642220	96.99%	7	2.14%
巾	1817		3	27	0.004078%	642247	97.00%	20	6.12%
惠	1818		12	27	0.004078%	642274	97.00%	10	3.06%
戒	1819		7	27	0.004078%	642301	97.00%	18	5.51%
拒	1820		8	27	0.004078%	642328	97.01%	14	4.28%
搏	1821		13	27	0.004078%	642355	97.01%	22	6.73%
擋	1822		16	27	0.004078%	642382	97.02%	21	6.42%
棚	1823		12	27	0.004078%	642409	97.02%	12	3.67%
款	1824		12	27	0.004078%	642436	97.03%	18	5.51%
滴	1825		14	27	0.004078%	642463	97.03%	19	5.81%
焰	1826		12	27	0.004078%	642490	97.03%	13	3.98%
煩	1827		13	27	0.004078%	642517	97.04%	21	6.42%
爽	1828		11	27	0.004078%	642544	97.04%	21	6.42%
猜	1829		11	27	0.004078%	642571	97.05%	18	5.51%
盆	1830		9	27	0.004078%	642598	97.05%	15	4.59%
臘	1831		19	27	0.004078%	642625	97.05%	15	4.59%
蓮	1832		15	27	0.004078%	642652	97.06%	15	4.59%
蹲	1833		19	27	0.004078%	642679	97.06%	18	5.51%
躺	1834		15	27	0.004078%	642706	97.07%	21	6.42%
逼	1835		12	27	0.004078%	642733	97.07%	21	6.42%
邀	1836		16	27	0.004078%	642760	97.07%	19	5.81%
鄭	1837		14	27	0.004078%	642787	97.08%	15	4.59%
鎖	1838		18	27	0.004078%	642814	97.08%	19	5.81%
博	1839		12	26	0.003927%	642840	97.09%	19	5.81%
吊	1840		6	26	0.003927%	642866	97.09%	17	5.20%
咬	1841		9	26	0.003927%	642892	97.09%	11	3.36%
售	1842		11	26	0.003927%	642918	97.10%	16	4.89%
喂	1843		12	26	0.003927%	642944	97.10%	10	3.06%
坊	1844		7	26	0.003927%	642970	97.11%	7	2.14%
塗	1845		13	26	0.003927%	642996	97.11%	21	6.42%
峻	1846		10	26	0.003927%	643022	97.11%	18	5.51%
截	1847		14	26	0.003927%	643048	97.12%	20	6.12%
披	1848		8	26	0.003927%	643074	97.12%	22	6.73%
晴	1849		12	26	0.003927%	643100	97.13%	20	6.12%
歪	1850		9	26	0.003927%	643126	97.13%	19	5.81%
氏	1851		4	26	0.003927%	643152	97.13%	14	4.28%
氛	1852		8	26	0.003927%	643178	97.14%	18	5.51%
畏	1853		9	26	0.003927%	643204	97.14%	20	6.12%
盟	1854		13	26	0.003927%	643230	97.14%	14	4.28%
祥	1855		10	26	0.003927%	643256	97.15%	12	3.67%
胖	1856		9	26	0.003927%	643282	97.15%	8	2.45%
萍	1857		12	26	0.003927%	643308	97.16%	5	1.53%
遮	1858		14	26	0.003927%	643334	97.16%	18	5.51%
遼	1859		15	26	0.003927%	643360	97.16%	13	3.98%
鈴	1860		13	26	0.003927%	643386	97.17%	16	4.89%
銨	1861		14	26	0.003927%	643412	97.17%	5	1.53%
銷	1862		15	26	0.003927%	643438	97.18%	15	4.59%
陡	1863		9	26	0.003927%	643464	97.18%	13	3.98%
刷	1864		8	25	0.003776%	643489	97.18%	16	4.89%
喻	1865		12	25	0.003776%	643514	97.19%	16	4.89%
埃	1866		10	25	0.003776%	643539	97.19%	15	4.59%
堤	1867		12	25	0.003776%	643564	97.20%	13	3.98%
塵	1868		14	25	0.003776%	643589	97.20%	21	6.42%
壘	1869		18	25	0.003776%	643614	97.20%	14	4.28%
姊	1870		8	25	0.003776%	643639	97.21%	5	1.53%
慌	1871		13	25	0.003776%	643664	97.21%	13	3.98%
掙	1872		11	25	0.003776%	643689	97.21%	17	5.20%
掀	1873		11	25	0.003776%	643714	97.22%	21	6.42%
擇	1874		16	25	0.003776%	643739	97.22%	16	4.89%
昂	1875		8	25	0.003776%	643764	97.23%	20	6.12%
桔	1876		10	25	0.003776%	643789	97.23%	7	2.14%
棕	1877		12	25	0.003776%	643814	97.23%	5	1.53%
棍	1878		12	25	0.003776%	643839	97.24%	17	5.20%
欲	1879		11	25	0.003776%	643864	97.24%	19	5.81%
欺	1880		12	25	0.003776%	643889	97.24%	19	5.81%
浩	1881		10	25	0.003776%	643914	97.25%	14	4.28%
溶	1882		13	25	0.003776%	643939	97.25%	15	4.59%
溜	1883		13	25	0.003776%	643964	97.26%	16	4.89%
瓣	1884		19	25	0.003776%	643989	97.26%	16	4.89%
皺	1885		15	25	0.003776%	644014	97.26%	16	4.89%
盜	1886		12	25	0.003776%	644039	97.27%	14	4.28%
罵	1887		15	25	0.003776%	644064	97.27%	14	4.28%
舒	1888		12	25	0.003776%	644089	97.27%	18	5.51%
芳	1889		8	25	0.003776%	644114	97.28%	18	5.51%
芽	1890		8	25	0.003776%	644139	97.28%	14	4.28%
裁	1891		12	25	0.003776%	644164	97.29%	15	4.59%
誌	1892		14	25	0.003776%	644189	97.29%	20	6.12%
鄰	1893		14	25	0.003776%	644214	97.29%	20	6.12%
酷	1894		14	25	0.003776%	644239	97.30%	19	5.81%
闡	1895		20	25	0.003776%	644264	97.30%	14	4.28%
鵑	1896		18	25	0.003776%	644289	97.30%	7	2.14%
凱	1897		12	24	0.003625%	644313	97.31%	8	2.45%
啥	1898		11	24	0.003625%	644337	97.31%	13	3.98%
坑	1899		7	24	0.003625%	644361	97.32%	14	4.28%
奘	1900		10	24	0.003625%	644385	97.32%	2	0.61%
崖	1901		11	24	0.003625%	644409	97.32%	13	3.98%
弦	1902		8	24	0.003625%	644433	97.33%	16	4.89%
摧	1903		14	24	0.003625%	644457	97.33%	21	6.42%
昔	1904		8	24	0.003625%	644481	97.33%	12	3.67%
柳	1905		9	24	0.003625%	644505	97.34%	15	4.59%
棒	1906		12	24	0.003625%	644529	97.34%	17	5.20%
樸	1907		16	24	0.003625%	644553	97.34%	18	5.51%
氯	1908		12	24	0.003625%	644577	97.35%	4	1.22%
渾	1909		12	24	0.003625%	644601	97.35%	19	5.81%
甸	1910		7	24	0.003625%	644625	97.36%	11	3.36%
笛	1911		11	24	0.003625%	644649	97.36%	6	1.84%
箱	1912		15	24	0.003625%	644673	97.36%	12	3.67%
翅	1913		10	24	0.003625%	644697	97.37%	14	4.28%
脈	1914		10	24	0.003625%	644721	97.37%	15	4.59%
艘	1915		15	24	0.003625%	644745	97.37%	11	3.36%
跨	1916		13	24	0.003625%	644769	97.38%	14	4.28%
躲	1917		13	24	0.003625%	644793	97.38%	16	4.89%
遣	1918		13	24	0.003625%	644817	97.38%	14	4.28%
閣	1919		14	24	0.003625%	644841	97.39%	16	4.89%
鹹	1920		20	24	0.003625%	644865	97.39%	5	1.53%
齡	1921		20	24	0.003625%	644889	97.40%	16	4.89%
乃	1922		2	23	0.003474%	644912	97.40%	13	3.98%
余	1923		7	23	0.003474%	644935	97.40%	5	1.53%
匪	1924		10	23	0.003474%	644958	97.41%	9	2.75%
喃	1925		12	23	0.003474%	644981	97.41%	8	2.45%
嘛	1926		14	23	0.003474%	645004	97.41%	16	4.89%
奈	1927		8	23	0.003474%	645027	97.42%	18	5.51%
懸	1928		20	23	0.003474%	645050	97.42%	14	4.28%
拆	1929		8	23	0.003474%	645073	97.42%	14	4.28%
捷	1930		11	23	0.003474%	645096	97.43%	17	5.20%
搗	1931		13	23	0.003474%	645119	97.43%	12	3.67%
朽	1932		6	23	0.003474%	645142	97.43%	14	4.28%
浙	1933		10	23	0.003474%	645165	97.44%	14	4.28%
潭	1934		15	23	0.003474%	645188	97.44%	9	2.75%
縛	1935		16	23	0.003474%	645211	97.44%	15	4.59%
縫	1936		17	23	0.003474%	645234	97.45%	19	5.81%
腹	1937		13	23	0.003474%	645257	97.45%	12	3.67%
膝	1938		15	23	0.003474%	645280	97.45%	15	4.59%
臭	1939		10	23	0.003474%	645303	97.46%	17	5.20%
艙	1940		16	23	0.003474%	645326	97.46%	10	3.06%
葬	1941		13	23	0.003474%	645349	97.47%	13	3.98%
蝕	1942		14	23	0.003474%	645372	97.47%	15	4.59%
融	1943		16	23	0.003474%	645395	97.47%	21	6.42%
蠟	1944		21	23	0.003474%	645418	97.48%	4	1.22%
邵	1945		7	23	0.003474%	645441	97.48%	1	0.31%
鄒	1946		12	23	0.003474%	645464	97.48%	2	0.61%
鋤	1947		15	23	0.003474%	645487	97.49%	11	3.36%
鍋	1948		17	23	0.003474%	645510	97.49%	12	3.67%
驕	1949		22	23	0.003474%	645533	97.49%	17	5.20%
仇	1950		4	22	0.003323%	645555	97.50%	17	5.20%
俊	1951		9	22	0.003323%	645577	97.50%	14	4.28%
儉	1952		15	22	0.003323%	645599	97.50%	9	2.75%
剎	1953		9	22	0.003323%	645621	97.51%	13	3.98%
哦	1954		10	22	0.003323%	645643	97.51%	14	4.28%
嘉	1955		14	22	0.003323%	645665	97.51%	9	2.75%
坪	1956		8	22	0.003323%	645687	97.52%	10	3.06%
奉	1957		8	22	0.003323%	645709	97.52%	20	6.12%
妥	1958		7	22	0.003323%	645731	97.52%	15	4.59%
嫁	1959		13	22	0.003323%	645753	97.53%	12	3.67%
宿	1960		11	22	0.003323%	645775	97.53%	18	5.51%
岭	1961		8	22	0.003323%	645797	97.53%	4	1.22%
悲	1962		12	22	0.003323%	645819	97.54%	12	3.67%
愉	1963		12	22	0.003323%	645841	97.54%	16	4.89%
撥	1964		15	22	0.003323%	645863	97.54%	20	6.12%
撓	1965		15	22	0.003323%	645885	97.55%	17	5.20%
攏	1966		19	22	0.003323%	645907	97.55%	15	4.59%
旬	1967		6	22	0.003323%	645929	97.55%	15	4.59%
漲	1968		14	22	0.003323%	645951	97.56%	18	5.51%
獵	1969		18	22	0.003323%	645973	97.56%	13	3.98%
盞	1970		13	22	0.003323%	645995	97.56%	11	3.36%
磚	1971		16	22	0.003323%	646017	97.57%	11	3.36%
秦	1972		10	22	0.003323%	646039	97.57%	9	2.75%
糞	1973		17	22	0.003323%	646061	97.57%	9	2.75%
糾	1974		8	22	0.003323%	646083	97.58%	17	5.20%
苕	1975		9	22	0.003323%	646105	97.58%	3	0.92%
蔽	1976		15	22	0.003323%	646127	97.58%	16	4.89%
詳	1977		13	22	0.003323%	646149	97.59%	19	5.81%
譜	1978		19	22	0.003323%	646171	97.59%	13	3.98%
蹟	1979		18	22	0.003323%	646193	97.59%	16	4.89%
返	1980		7	22	0.003323%	646215	97.60%	18	5.51%
遜	1981		13	22	0.003323%	646237	97.60%	12	3.67%
顫	1982		22	22	0.003323%	646259	97.60%	16	4.89%
鵝	1983		18	22	0.003323%	646281	97.61%	13	3.98%
鹿	1984		11	22	0.003323%	646303	97.61%	9	2.75%
傲	1985		13	21	0.003172%	646324	97.61%	14	4.28%
催	1986		13	21	0.003172%	646345	97.62%	15	4.59%
儘	1987		16	21	0.003172%	646366	97.62%	15	4.59%
喚	1988		12	21	0.003172%	646387	97.62%	17	5.20%
墳	1989		15	21	0.003172%	646408	97.62%	7	2.14%
寂	1990		11	21	0.003172%	646429	97.63%	15	4.59%
怨	1991		9	21	0.003172%	646450	97.63%	11	3.36%
悶	1992		12	21	0.003172%	646471	97.63%	13	3.98%
懇	1993		17	21	0.003172%	646492	97.64%	13	3.98%
撐	1994		15	21	0.003172%	646513	97.64%	11	3.36%
擬	1995		17	21	0.003172%	646534	97.64%	15	4.59%
晉	1996		10	21	0.003172%	646555	97.65%	8	2.45%
枯	1997		9	21	0.003172%	646576	97.65%	17	5.20%
櫚	1998		19	21	0.003172%	646597	97.65%	3	0.92%
沼	1999		8	21	0.003172%	646618	97.66%	7	2.14%
淋	2000		11	21	0.003172%	646639	97.66%	16	4.89%
潛	2001		15	21	0.003172%	646660	97.66%	15	4.59%
牽	2002		11	21	0.003172%	646681	97.67%	17	5.20%
獅	2003		13	21	0.003172%	646702	97.67%	7	2.14%
皆	2004		9	21	0.003172%	646723	97.67%	13	3.98%
脅	2005		10	21	0.003172%	646744	97.68%	18	5.51%
莽	2006		11	21	0.003172%	646765	97.68%	11	3.36%
蘋	2007		20	21	0.003172%	646786	97.68%	5	1.53%
螺	2008		17	21	0.003172%	646807	97.69%	6	1.84%
診	2009		12	21	0.003172%	646828	97.69%	8	2.45%
謬	2010		18	21	0.003172%	646849	97.69%	14	4.28%
豈	2011		10	21	0.003172%	646870	97.69%	16	4.89%
遊	2012		12	21	0.003172%	646891	97.70%	11	3.36%
錶	2013		16	21	0.003172%	646912	97.70%	8	2.45%
鑄	2014		22	21	0.003172%	646933	97.70%	8	2.45%
鑒	2015		22	21	0.003172%	646954	97.71%	16	4.89%
霍	2016		16	21	0.003172%	646975	97.71%	14	4.28%
凳	2017		14	20	0.003021%	646995	97.71%	12	3.67%
劣	2018		6	20	0.003021%	647015	97.72%	12	3.67%
厘	2019		9	20	0.003021%	647035	97.72%	11	3.36%
吟	2020		7	20	0.003021%	647055	97.72%	15	4.59%
喪	2021		12	20	0.003021%	647075	97.73%	18	5.51%
嘩	2022		15	20	0.003021%	647095	97.73%	11	3.36%
嵋	2023		12	20	0.003021%	647115	97.73%	1	0.31%
彪	2024		11	20	0.003021%	647135	97.73%	13	3.98%
扇	2025		10	20	0.003021%	647155	97.74%	12	3.67%
拳	2026		10	20	0.003021%	647175	97.74%	16	4.89%
柯	2027		9	20	0.003021%	647195	97.74%	3	0.92%
沸	2028		8	20	0.003021%	647215	97.75%	11	3.36%
濛	2029		17	20	0.003021%	647235	97.75%	6	1.84%
獸	2030		19	20	0.003021%	647255	97.75%	9	2.75%
瑣	2031		14	20	0.003021%	647275	97.76%	6	1.84%
甫	2032		7	20	0.003021%	647295	97.76%	12	3.67%
疲	2033		10	20	0.003021%	647315	97.76%	15	4.59%
盲	2034		8	20	0.003021%	647335	97.76%	13	3.98%
盼	2035		9	20	0.003021%	647355	97.77%	16	4.89%
筒	2036		12	20	0.003021%	647375	97.77%	10	3.06%
罕	2037		7	20	0.003021%	647395	97.77%	15	4.59%
脂	2038		10	20	0.003021%	647415	97.78%	14	4.28%
膜	2039		15	20	0.003021%	647435	97.78%	9	2.75%
艦	2040		20	20	0.003021%	647455	97.78%	7	2.14%
艷	2041		24	20	0.003021%	647475	97.79%	15	4.59%
茂	2042		9	20	0.003021%	647495	97.79%	15	4.59%
蔑	2043		15	20	0.003021%	647515	97.79%	15	4.59%
薯	2044		17	20	0.003021%	647535	97.80%	8	2.45%
褲	2045		15	20	0.003021%	647555	97.80%	15	4.59%
襯	2046		21	20	0.003021%	647575	97.80%	14	4.28%
誘	2047		14	20	0.003021%	647595	97.80%	12	3.67%
趨	2048		17	20	0.003021%	647615	97.81%	17	5.20%
辭	2049		19	20	0.003021%	647635	97.81%	16	4.89%
週	2050		11	20	0.003021%	647655	97.81%	12	3.67%
郭	2051		10	20	0.003021%	647675	97.82%	12	3.67%
閘	2052		13	20	0.003021%	647695	97.82%	7	2.14%
闢	2053		21	20	0.003021%	647715	97.82%	14	4.28%
霖	2054		16	20	0.003021%	647735	97.83%	3	0.92%
鞭	2055		18	20	0.003021%	647755	97.83%	11	3.36%
乳	2056		8	19	0.00287%	647774	97.83%	12	3.67%
傍	2057		12	19	0.00287%	647793	97.83%	15	4.59%
冊	2058		5	19	0.00287%	647812	97.84%	12	3.67%
卑	2059		8	19	0.00287%	647831	97.84%	11	3.36%
呈	2060		7	19	0.00287%	647850	97.84%	16	4.89%
喧	2061		12	19	0.00287%	647869	97.85%	13	3.98%
嚷	2062		20	19	0.00287%	647888	97.85%	14	4.28%
婚	2063		11	19	0.00287%	647907	97.85%	6	1.84%
嫂	2064		12	19	0.00287%	647926	97.85%	8	2.45%
宏	2065		7	19	0.00287%	647945	97.86%	10	3.06%
屠	2066		11	19	0.00287%	647964	97.86%	13	3.98%
嶄	2067		14	19	0.00287%	647983	97.86%	14	4.28%
巒	2068		22	19	0.00287%	648002	97.87%	9	2.75%
帳	2069		11	19	0.00287%	648021	97.87%	11	3.36%
恥	2070		10	19	0.00287%	648040	97.87%	11	3.36%
扣	2071		6	19	0.00287%	648059	97.87%	16	4.89%
扯	2072		7	19	0.00287%	648078	97.88%	16	4.89%
扮	2073		7	19	0.00287%	648097	97.88%	12	3.67%
攀	2074		19	19	0.00287%	648116	97.88%	16	4.89%
攔	2075		20	19	0.00287%	648135	97.89%	14	4.28%
斗	2076		4	19	0.00287%	648154	97.89%	14	4.28%
曰	2077		4	19	0.00287%	648173	97.89%	6	1.84%
棗	2078		12	19	0.00287%	648192	97.89%	7	2.14%
殷	2079		10	19	0.00287%	648211	97.90%	12	3.67%
沈	2080		7	19	0.00287%	648230	97.90%	11	3.36%
沾	2081		8	19	0.00287%	648249	97.90%	13	3.98%
洱	2082		9	19	0.00287%	648268	97.91%	1	0.31%
灑	2083		22	19	0.00287%	648287	97.91%	12	3.67%
熊	2084		14	19	0.00287%	648306	97.91%	9	2.75%
申	2085		5	19	0.00287%	648325	97.91%	13	3.98%
畔	2086		10	19	0.00287%	648344	97.92%	15	4.59%
竭	2087		14	19	0.00287%	648363	97.92%	13	3.98%
籍	2088		20	19	0.00287%	648382	97.92%	18	5.51%
紋	2089		10	19	0.00287%	648401	97.93%	15	4.59%
聳	2090		17	19	0.00287%	648420	97.93%	15	4.59%
舌	2091		6	19	0.00287%	648439	97.93%	16	4.89%
舟	2092		6	19	0.00287%	648458	97.93%	15	4.59%
芬	2093		8	19	0.00287%	648477	97.94%	13	3.98%
蔭	2094		15	19	0.00287%	648496	97.94%	14	4.28%
衰	2095		10	19	0.00287%	648515	97.94%	15	4.59%
裙	2096		12	19	0.00287%	648534	97.95%	13	3.98%
逮	2097		11	19	0.00287%	648553	97.95%	10	3.06%
閑	2098		12	19	0.00287%	648572	97.95%	14	4.28%
陵	2099		10	19	0.00287%	648591	97.95%	11	3.36%
驅	2100		21	19	0.00287%	648610	97.96%	17	5.20%
驟	2101		24	19	0.00287%	648629	97.96%	16	4.89%
魔	2102		21	19	0.00287%	648648	97.96%	10	3.06%
龐	2103		19	19	0.00287%	648667	97.97%	17	5.20%
佳	2104		8	18	0.002718%	648685	97.97%	14	4.28%
倪	2105		10	18	0.002718%	648703	97.97%	4	1.22%
傢	2106		12	18	0.002718%	648721	97.97%	13	3.98%
允	2107		4	18	0.002718%	648739	97.98%	11	3.36%
劍	2108		15	18	0.002718%	648757	97.98%	14	4.28%
叮	2109		5	18	0.002718%	648775	97.98%	8	2.45%
吵	2110		7	18	0.002718%	648793	97.99%	9	2.75%
垮	2111		9	18	0.002718%	648811	97.99%	16	4.89%
填	2112		13	18	0.002718%	648829	97.99%	14	4.28%
彌	2113		17	18	0.002718%	648847	97.99%	13	3.98%
慨	2114		12	18	0.002718%	648865	98.00%	14	4.28%
抖	2115		7	18	0.002718%	648883	98.00%	13	3.98%
攤	2116		22	18	0.002718%	648901	98.00%	9	2.75%
斥	2117		5	18	0.002718%	648919	98.00%	18	5.51%
曼	2118		11	18	0.002718%	648937	98.01%	14	4.28%
歧	2119		8	18	0.002718%	648955	98.01%	8	2.45%
汛	2120		6	18	0.002718%	648973	98.01%	3	0.92%
烯	2121		11	18	0.002718%	648991	98.02%	2	0.61%
猶	2122		12	18	0.002718%	649009	98.02%	13	3.98%
盧	2123		16	18	0.002718%	649027	98.02%	13	3.98%
睜	2124		13	18	0.002718%	649045	98.02%	13	3.98%
砍	2125		9	18	0.002718%	649063	98.03%	13	3.98%
砟	2126		10	18	0.002718%	649081	98.03%	1	0.31%
絡	2127		12	18	0.002718%	649099	98.03%	14	4.28%
緬	2128		15	18	0.002718%	649117	98.03%	6	1.84%
纏	2129		21	18	0.002718%	649135	98.04%	13	3.98%
罐	2130		24	18	0.002718%	649153	98.04%	15	4.59%
脆	2131		10	18	0.002718%	649171	98.04%	14	4.28%
脾	2132		12	18	0.002718%	649189	98.04%	11	3.36%
臥	2133		8	18	0.002718%	649207	98.05%	14	4.28%
衷	2134		10	18	0.002718%	649225	98.05%	16	4.89%
譽	2135		21	18	0.002718%	649243	98.05%	15	4.59%
趁	2136		12	18	0.002718%	649261	98.06%	15	4.59%
跪	2137		13	18	0.002718%	649279	98.06%	7	2.14%
郎	2138		8	18	0.002718%	649297	98.06%	11	3.36%
鋸	2139		16	18	0.002718%	649315	98.06%	6	1.84%
馱	2140		13	18	0.002718%	649333	98.07%	7	2.14%
駕	2141		15	18	0.002718%	649351	98.07%	14	4.28%
佩	2142		8	17	0.002567%	649368	98.07%	15	4.59%
俯	2143		10	17	0.002567%	649385	98.07%	17	5.20%
儲	2144		17	17	0.002567%	649402	98.08%	9	2.75%
吱	2145		7	17	0.002567%	649419	98.08%	8	2.45%
喀	2146		12	17	0.002567%	649436	98.08%	7	2.14%
堵	2147		11	17	0.002567%	649453	98.08%	13	3.98%
奸	2148		6	17	0.002567%	649470	98.09%	11	3.36%
巿	2149		4	17	0.002567%	649487	98.09%	8	2.45%
并	2150		6	17	0.002567%	649504	98.09%	8	2.45%
廂	2151		12	17	0.002567%	649521	98.10%	5	1.53%
慎	2152		13	17	0.002567%	649538	98.10%	10	3.06%
慰	2153		15	17	0.002567%	649555	98.10%	15	4.59%
懼	2154		21	17	0.002567%	649572	98.10%	13	3.98%
捏	2155		10	17	0.002567%	649589	98.11%	10	3.06%
撫	2156		15	17	0.002567%	649606	98.11%	11	3.36%
斑	2157		12	17	0.002567%	649623	98.11%	11	3.36%
晰	2158		12	17	0.002567%	649640	98.11%	13	3.98%
浦	2159		10	17	0.002567%	649657	98.12%	9	2.75%
煌	2160		13	17	0.002567%	649674	98.12%	16	4.89%
熙	2161		14	17	0.002567%	649691	98.12%	10	3.06%
琅	2162		11	17	0.002567%	649708	98.12%	7	2.14%
瑪	2163		14	17	0.002567%	649725	98.13%	11	3.36%
砌	2164		9	17	0.002567%	649742	98.13%	16	4.89%
磷	2165		17	17	0.002567%	649759	98.13%	3	0.92%
租	2166		10	17	0.002567%	649776	98.13%	10	3.06%
窄	2167		10	17	0.002567%	649793	98.14%	11	3.36%
粟	2168		12	17	0.002567%	649810	98.14%	5	1.53%
縴	2169		17	17	0.002567%	649827	98.14%	3	0.92%
罩	2170		13	17	0.002567%	649844	98.14%	12	3.67%
聊	2171		11	17	0.002567%	649861	98.15%	12	3.67%
胞	2172		9	17	0.002567%	649878	98.15%	11	3.36%
臣	2173		6	17	0.002567%	649895	98.15%	15	4.59%
菩	2174		12	17	0.002567%	649912	98.15%	5	1.53%
蒂	2175		13	17	0.002567%	649929	98.16%	12	3.67%
誣	2176		14	17	0.002567%	649946	98.16%	11	3.36%
譬	2177		20	17	0.002567%	649963	98.16%	8	2.45%
貪	2178		11	17	0.002567%	649980	98.16%	13	3.98%
賊	2179		13	17	0.002567%	649997	98.17%	12	3.67%
趟	2180		15	17	0.002567%	650014	98.17%	13	3.98%
辣	2181		14	17	0.002567%	650031	98.17%	12	3.67%
逝	2182		10	17	0.002567%	650048	98.17%	15	4.59%
鑼	2183		27	17	0.002567%	650065	98.18%	10	3.06%
閉	2184		11	17	0.002567%	650082	98.18%	15	4.59%
隋	2185		11	17	0.002567%	650099	98.18%	3	0.92%
頗	2186		14	17	0.002567%	650116	98.18%	10	3.06%
駁	2187		14	17	0.002567%	650133	98.19%	14	4.28%
償	2188		17	16	0.002416%	650149	98.19%	13	3.98%
勾	2189		4	16	0.002416%	650165	98.19%	14	4.28%
呂	2190		7	16	0.002416%	650181	98.19%	5	1.53%
咧	2191		9	16	0.002416%	650197	98.20%	6	1.84%
唉	2192		10	16	0.002416%	650213	98.20%	9	2.75%
唇	2193		10	16	0.002416%	650229	98.20%	11	3.36%
喉	2194		12	16	0.002416%	650245	98.20%	13	3.98%
嘯	2195		15	16	0.002416%	650261	98.21%	11	3.36%
坎	2196		7	16	0.002416%	650277	98.21%	9	2.75%
妻	2197		8	16	0.002416%	650293	98.21%	9	2.75%
宅	2198		6	16	0.002416%	650309	98.21%	11	3.36%
尿	2199		7	16	0.002416%	650325	98.22%	7	2.14%
嵌	2200		12	16	0.002416%	650341	98.22%	8	2.45%
怯	2201		8	16	0.002416%	650357	98.22%	7	2.14%
憂	2202		15	16	0.002416%	650373	98.22%	12	3.67%
戈	2203		4	16	0.002416%	650389	98.23%	11	3.36%
捲	2204		11	16	0.002416%	650405	98.23%	11	3.36%
擾	2205		18	16	0.002416%	650421	98.23%	10	3.06%
暢	2206		14	16	0.002416%	650437	98.23%	14	4.28%
榖	2207		14	16	0.002416%	650453	98.24%	8	2.45%
槳	2208		15	16	0.002416%	650469	98.24%	9	2.75%
汁	2209		5	16	0.002416%	650485	98.24%	9	2.75%
污	2210		6	16	0.002416%	650501	98.24%	13	3.98%
沫	2211		8	16	0.002416%	650517	98.25%	11	3.36%
湊	2212		12	16	0.002416%	650533	98.25%	15	4.59%
渴	2213		12	16	0.002416%	650549	98.25%	11	3.36%
漿	2214		15	16	0.002416%	650565	98.25%	11	3.36%
灸	2215		7	16	0.002416%	650581	98.26%	3	0.92%
煮	2216		12	16	0.002416%	650597	98.26%	7	2.14%
眠	2217		10	16	0.002416%	650613	98.26%	6	1.84%
眨	2218		10	16	0.002416%	650629	98.26%	9	2.75%
眺	2219		11	16	0.002416%	650645	98.26%	13	3.98%
礁	2220		17	16	0.002416%	650661	98.27%	3	0.92%
祠	2221		9	16	0.002416%	650677	98.27%	6	1.84%
筋	2222		12	16	0.002416%	650693	98.27%	11	3.36%
簇	2223		17	16	0.002416%	650709	98.27%	10	3.06%
絢	2224		12	16	0.002416%	650725	98.28%	9	2.75%
縷	2225		17	16	0.002416%	650741	98.28%	7	2.14%
繳	2226		19	16	0.002416%	650757	98.28%	14	4.28%
翰	2227		16	16	0.002416%	650773	98.28%	7	2.14%
翼	2228		17	16	0.002416%	650789	98.29%	9	2.75%
胎	2229		9	16	0.002416%	650805	98.29%	5	1.53%
蜜	2230		14	16	0.002416%	650821	98.29%	9	2.75%
衫	2231		8	16	0.002416%	650837	98.29%	9	2.75%
誇	2232		13	16	0.002416%	650853	98.30%	11	3.36%
販	2233		11	16	0.002416%	650869	98.30%	10	3.06%
賦	2234		15	16	0.002416%	650885	98.30%	13	3.98%
郁	2235		8	16	0.002416%	650901	98.30%	11	3.36%
傑	2236		12	15	0.002265%	650916	98.31%	9	2.75%
傻	2237		13	15	0.002265%	650931	98.31%	13	3.98%
勘	2238		11	15	0.002265%	650946	98.31%	8	2.45%
勻	2239		4	15	0.002265%	650961	98.31%	10	3.06%
却	2240		7	15	0.002265%	650976	98.31%	13	3.98%
吞	2241		7	15	0.002265%	650991	98.32%	10	3.06%
喘	2242		12	15	0.002265%	651006	98.32%	11	3.36%
坂	2243		7	15	0.002265%	651021	98.32%	5	1.53%
墾	2244		16	15	0.002265%	651036	98.32%	10	3.06%
壇	2245		16	15	0.002265%	651051	98.33%	10	3.06%
夕	2246		3	15	0.002265%	651066	98.33%	14	4.28%
峭	2247		10	15	0.002265%	651081	98.33%	12	3.67%
巍	2248		21	15	0.002265%	651096	98.33%	10	3.06%
幟	2249		15	15	0.002265%	651111	98.34%	12	3.67%
悅	2250		10	15	0.002265%	651126	98.34%	13	3.98%
戀	2251		23	15	0.002265%	651141	98.34%	13	3.98%
捍	2252		10	15	0.002265%	651156	98.34%	12	3.67%
曹	2253		11	15	0.002265%	651171	98.34%	7	2.14%
杠	2254		7	15	0.002265%	651186	98.35%	4	1.22%
桶	2255		11	15	0.002265%	651201	98.35%	11	3.36%
棠	2256		12	15	0.002265%	651216	98.35%	6	1.84%
檀	2257		17	15	0.002265%	651231	98.35%	3	0.92%
欄	2258		21	15	0.002265%	651246	98.36%	12	3.67%
歉	2259		14	15	0.002265%	651261	98.36%	13	3.98%
洶	2260		9	15	0.002265%	651276	98.36%	11	3.36%
滔	2261		13	15	0.002265%	651291	98.36%	9	2.75%
滲	2262		14	15	0.002265%	651306	98.36%	12	3.67%
犁	2263		11	15	0.002265%	651321	98.37%	8	2.45%
狼	2264		10	15	0.002265%	651336	98.37%	13	3.98%
穗	2265		17	15	0.002265%	651351	98.37%	10	3.06%
窩	2266		14	15	0.002265%	651366	98.37%	12	3.67%
竿	2267		9	15	0.002265%	651381	98.38%	6	1.84%
籌	2268		20	15	0.002265%	651396	98.38%	8	2.45%
籮	2269		25	15	0.002265%	651411	98.38%	7	2.14%
紐	2270		10	15	0.002265%	651426	98.38%	10	3.06%
翁	2271		10	15	0.002265%	651441	98.39%	9	2.75%
耶	2272		9	15	0.002265%	651456	98.39%	12	3.67%
肆	2273		13	15	0.002265%	651471	98.39%	9	2.75%
膛	2274		15	15	0.002265%	651486	98.39%	7	2.14%
莉	2275		11	15	0.002265%	651501	98.39%	3	0.92%
萊	2276		12	15	0.002265%	651516	98.40%	11	3.36%
菲	2277		12	15	0.002265%	651531	98.40%	9	2.75%
蓄	2278		14	15	0.002265%	651546	98.40%	11	3.36%
袁	2279		10	15	0.002265%	651561	98.40%	6	1.84%
賭	2280		15	15	0.002265%	651576	98.41%	6	1.84%
迴	2281		9	15	0.002265%	651591	98.41%	14	4.28%
逢	2282		10	15	0.002265%	651606	98.41%	15	4.59%
釣	2283		11	15	0.002265%	651621	98.41%	6	1.84%
鈞	2284		12	15	0.002265%	651636	98.41%	13	3.98%
閒	2285		12	15	0.002265%	651651	98.42%	10	3.06%
陶	2286		10	15	0.002265%	651666	98.42%	11	3.36%
霜	2287		17	15	0.002265%	651681	98.42%	11	3.36%
騾	2288		21	15	0.002265%	651696	98.42%	6	1.84%
驢	2289		26	15	0.002265%	651711	98.43%	3	0.92%
鵬	2290		19	15	0.002265%	651726	98.43%	4	1.22%
丙	2291		5	14	0.002114%	651740	98.43%	6	1.84%
乒	2292		6	14	0.002114%	651754	98.43%	5	1.53%
乓	2293		6	14	0.002114%	651768	98.43%	5	1.53%
冀	2294		16	14	0.002114%	651782	98.44%	7	2.14%
冶	2295		7	14	0.002114%	651796	98.44%	6	1.84%
勛	2296		12	14	0.002114%	651810	98.44%	8	2.45%
勸	2297		20	14	0.002114%	651824	98.44%	13	3.98%
勺	2298		3	14	0.002114%	651838	98.45%	4	1.22%
嗡	2299		13	14	0.002114%	651852	98.45%	6	1.84%
囊	2300		22	14	0.002114%	651866	98.45%	2	0.61%
嫌	2301		13	14	0.002114%	651880	98.45%	11	3.36%
岐	2302		7	14	0.002114%	651894	98.45%	3	0.92%
嶼	2303		17	14	0.002114%	651908	98.46%	5	1.53%
巫	2304		7	14	0.002114%	651922	98.46%	3	0.92%
恒	2305		9	14	0.002114%	651936	98.46%	8	2.45%
惑	2306		12	14	0.002114%	651950	98.46%	11	3.36%
惶	2307		12	14	0.002114%	651964	98.46%	9	2.75%
愧	2308		13	14	0.002114%	651978	98.47%	11	3.36%
押	2309		8	14	0.002114%	651992	98.47%	8	2.45%
掏	2310		11	14	0.002114%	652006	98.47%	11	3.36%
揀	2311		12	14	0.002114%	652020	98.47%	6	1.84%
敦	2312		12	14	0.002114%	652034	98.47%	9	2.75%
旨	2313		6	14	0.002114%	652048	98.48%	10	3.06%
朦	2314		18	14	0.002114%	652062	98.48%	9	2.75%
榜	2315		14	14	0.002114%	652076	98.48%	14	4.28%
樁	2316		15	14	0.002114%	652090	98.48%	8	2.45%
櫓	2317		19	14	0.002114%	652104	98.49%	5	1.53%
湛	2318		12	14	0.002114%	652118	98.49%	6	1.84%
滋	2319		12	14	0.002114%	652132	98.49%	12	3.67%
溢	2320		13	14	0.002114%	652146	98.49%	14	4.28%
漓	2321		14	14	0.002114%	652160	98.49%	6	1.84%
漠	2322		14	14	0.002114%	652174	98.50%	9	2.75%
漆	2323		14	14	0.002114%	652188	98.50%	9	2.75%
炕	2324		8	14	0.002114%	652202	98.50%	8	2.45%
烘	2325		10	14	0.002114%	652216	98.50%	6	1.84%
盯	2326		7	14	0.002114%	652230	98.50%	11	3.36%
瞎	2327		15	14	0.002114%	652244	98.51%	8	2.45%
祭	2328		11	14	0.002114%	652258	98.51%	8	2.45%
稅	2329		12	14	0.002114%	652272	98.51%	8	2.45%
稿	2330		15	14	0.002114%	652286	98.51%	6	1.84%
穀	2331		15	14	0.002114%	652300	98.51%	3	0.92%
竄	2332		18	14	0.002114%	652314	98.52%	12	3.67%
筐	2333		12	14	0.002114%	652328	98.52%	9	2.75%
紮	2334		11	14	0.002114%	652342	98.52%	10	3.06%
羞	2335		11	14	0.002114%	652356	98.52%	13	3.98%
肌	2336		6	14	0.002114%	652370	98.53%	6	1.84%
肺	2337		8	14	0.002114%	652384	98.53%	11	3.36%
腔	2338		12	14	0.002114%	652398	98.53%	12	3.67%
臟	2339		22	14	0.002114%	652412	98.53%	11	3.36%
茸	2340		10	14	0.002114%	652426	98.53%	5	1.53%
蕾	2341		17	14	0.002114%	652440	98.54%	5	1.53%
謠	2342		17	14	0.002114%	652454	98.54%	10	3.06%
豎	2343		15	14	0.002114%	652468	98.54%	13	3.98%
賴	2344		16	14	0.002114%	652482	98.54%	14	4.28%
軀	2345		18	14	0.002114%	652496	98.54%	9	2.75%
輔	2346		14	14	0.002114%	652510	98.55%	12	3.67%
輻	2347		16	14	0.002114%	652524	98.55%	8	2.45%
酚	2348		11	14	0.002114%	652538	98.55%	3	0.92%
錠	2349		16	14	0.002114%	652552	98.55%	3	0.92%
隙	2350		13	14	0.002114%	652566	98.55%	12	3.67%
韌	2351		12	14	0.002114%	652580	98.56%	10	3.06%
駒	2352		15	14	0.002114%	652594	98.56%	3	0.92%
魄	2353		15	14	0.002114%	652608	98.56%	11	3.36%
傣	2354		12	13	0.001963%	652621	98.56%	3	0.92%
僻	2355		15	13	0.001963%	652634	98.57%	10	3.06%
勿	2356		4	13	0.001963%	652647	98.57%	4	1.22%
卸	2357		8	13	0.001963%	652660	98.57%	7	2.14%
嗓	2358		13	13	0.001963%	652673	98.57%	9	2.75%
嗚	2359		13	13	0.001963%	652686	98.57%	9	2.75%
契	2360		9	13	0.001963%	652699	98.58%	7	2.14%
妨	2361		7	13	0.001963%	652712	98.58%	12	3.67%
媳	2362		13	13	0.001963%	652725	98.58%	3	0.92%
宴	2363		10	13	0.001963%	652738	98.58%	6	1.84%
寡	2364		14	13	0.001963%	652751	98.58%	8	2.45%
審	2365		15	13	0.001963%	652764	98.58%	10	3.06%
崔	2366		11	13	0.001963%	652777	98.59%	5	1.53%
怖	2367		8	13	0.001963%	652790	98.59%	12	3.67%
拘	2368		8	13	0.001963%	652803	98.59%	11	3.36%
撈	2369		15	13	0.001963%	652816	98.59%	12	3.67%
曬	2370		23	13	0.001963%	652829	98.59%	7	2.14%
朔	2371		10	13	0.001963%	652842	98.60%	7	2.14%
桐	2372		10	13	0.001963%	652855	98.60%	4	1.22%
榴	2373		14	13	0.001963%	652868	98.60%	10	3.06%
樑	2374		15	13	0.001963%	652881	98.60%	10	3.06%
橡	2375		16	13	0.001963%	652894	98.60%	8	2.45%
潘	2376		15	13	0.001963%	652907	98.61%	7	2.14%
煥	2377		13	13	0.001963%	652920	98.61%	8	2.45%
煞	2378		13	13	0.001963%	652933	98.61%	10	3.06%
獄	2379		14	13	0.001963%	652946	98.61%	11	3.36%
盈	2380		9	13	0.001963%	652959	98.61%	10	3.06%
窺	2381		16	13	0.001963%	652972	98.62%	8	2.45%
粹	2382		14	13	0.001963%	652985	98.62%	9	2.75%
絮	2383		12	13	0.001963%	652998	98.62%	6	1.84%
辮	2384		20	13	0.001963%	653011	98.62%	5	1.53%
纖	2385		23	13	0.001963%	653024	98.62%	9	2.75%
翔	2386		12	13	0.001963%	653037	98.63%	11	3.36%
胃	2387		9	13	0.001963%	653050	98.63%	6	1.84%
脖	2388		11	13	0.001963%	653063	98.63%	6	1.84%
腸	2389		13	13	0.001963%	653076	98.63%	12	3.67%
艾	2390		6	13	0.001963%	653089	98.63%	9	2.75%
茉	2391		9	13	0.001963%	653102	98.64%	2	0.61%
蕭	2392		16	13	0.001963%	653115	98.64%	10	3.06%
蠻	2393		25	13	0.001963%	653128	98.64%	11	3.36%
裕	2394		12	13	0.001963%	653141	98.64%	10	3.06%
賢	2395		15	13	0.001963%	653154	98.64%	8	2.45%
跋	2396		12	13	0.001963%	653167	98.65%	11	3.36%
逸	2397		11	13	0.001963%	653180	98.65%	12	3.67%
鈉	2398		12	13	0.001963%	653193	98.65%	2	0.61%
陌	2399		8	13	0.001963%	653206	98.65%	11	3.36%
頸	2400		16	13	0.001963%	653219	98.65%	5	1.53%
飲	2401		12	13	0.001963%	653232	98.66%	10	3.06%
饒	2402		20	13	0.001963%	653245	98.66%	9	2.75%
魏	2403		18	13	0.001963%	653258	98.66%	3	0.92%
龕	2404		22	13	0.001963%	653271	98.66%	6	1.84%
云	2405		4	12	0.001812%	653283	98.66%	5	1.53%
侯	2406		9	12	0.001812%	653295	98.67%	10	3.06%
僱	2407		14	12	0.001812%	653307	98.67%	9	2.75%
函	2408		8	12	0.001812%	653319	98.67%	7	2.14%
厭	2409		14	12	0.001812%	653331	98.67%	10	3.06%
吆	2410		6	12	0.001812%	653343	98.67%	10	3.06%
吼	2411		7	12	0.001812%	653355	98.67%	8	2.45%
喬	2412		12	12	0.001812%	653367	98.68%	9	2.75%
嗯	2413		13	12	0.001812%	653379	98.68%	7	2.14%
嚨	2414		20	12	0.001812%	653391	98.68%	9	2.75%
囑	2415		24	12	0.001812%	653403	98.68%	8	2.45%
孕	2416		5	12	0.001812%	653415	98.68%	7	2.14%
寓	2417		12	12	0.001812%	653427	98.69%	8	2.45%
屍	2418		9	12	0.001812%	653439	98.69%	9	2.75%
巳	2419		3	12	0.001812%	653451	98.69%	9	2.75%
巷	2420		9	12	0.001812%	653463	98.69%	9	2.75%
廓	2421		14	12	0.001812%	653475	98.69%	10	3.06%
弗	2422		5	12	0.001812%	653487	98.69%	8	2.45%
役	2423		7	12	0.001812%	653499	98.70%	11	3.36%
徽	2424		17	12	0.001812%	653511	98.70%	7	2.14%
慘	2425		14	12	0.001812%	653523	98.70%	10	3.06%
慕	2426		15	12	0.001812%	653535	98.70%	10	3.06%
扔	2427		5	12	0.001812%	653547	98.70%	8	2.45%
拱	2428		9	12	0.001812%	653559	98.70%	8	2.45%
挾	2429		10	12	0.001812%	653571	98.71%	7	2.14%
捆	2430		10	12	0.001812%	653583	98.71%	8	2.45%
挽	2431		10	12	0.001812%	653595	98.71%	11	3.36%
揪	2432		12	12	0.001812%	653607	98.71%	8	2.45%
敞	2433		12	12	0.001812%	653619	98.71%	11	3.36%
暮	2434		15	12	0.001812%	653631	98.72%	11	3.36%
杏	2435		7	12	0.001812%	653643	98.72%	7	2.14%
梭	2436		11	12	0.001812%	653655	98.72%	8	2.45%
梨	2437		11	12	0.001812%	653667	98.72%	8	2.45%
椅	2438		12	12	0.001812%	653679	98.72%	9	2.75%
檐	2439		17	12	0.001812%	653691	98.72%	12	3.67%
淒	2440		11	12	0.001812%	653703	98.73%	8	2.45%
淆	2441		11	12	0.001812%	653715	98.73%	10	3.06%
澈	2442		14	12	0.001812%	653727	98.73%	10	3.06%
瀉	2443		18	12	0.001812%	653739	98.73%	11	3.36%
瀑	2444		18	12	0.001812%	653751	98.73%	6	1.84%
灼	2445		7	12	0.001812%	653763	98.74%	10	3.06%
燥	2446		17	12	0.001812%	653775	98.74%	5	1.53%
疼	2447		10	12	0.001812%	653787	98.74%	7	2.14%
盒	2448		11	12	0.001812%	653799	98.74%	6	1.84%
瞿	2449		18	12	0.001812%	653811	98.74%	1	0.31%
碳	2450		14	12	0.001812%	653823	98.74%	4	1.22%
稠	2451		13	12	0.001812%	653835	98.75%	10	3.06%
竺	2452		8	12	0.001812%	653847	98.75%	3	0.92%
糠	2453		17	12	0.001812%	653859	98.75%	2	0.61%
糟	2454		17	12	0.001812%	653871	98.75%	9	2.75%
絨	2455		12	12	0.001812%	653883	98.75%	10	3.06%
繭	2456		19	12	0.001812%	653895	98.76%	6	1.84%
缽	2457		11	12	0.001812%	653907	98.76%	6	1.84%
耗	2458		10	12	0.001812%	653919	98.76%	10	3.06%
胚	2459		9	12	0.001812%	653931	98.76%	1	0.31%
茅	2460		9	12	0.001812%	653943	98.76%	8	2.45%
荊	2461		10	12	0.001812%	653955	98.76%	9	2.75%
蘿	2462		23	12	0.001812%	653967	98.77%	4	1.22%
裹	2463		14	12	0.001812%	653979	98.77%	9	2.75%
誓	2464		14	12	0.001812%	653991	98.77%	7	2.14%
賺	2465		17	12	0.001812%	654003	98.77%	5	1.53%
趙	2466		14	12	0.001812%	654015	98.77%	9	2.75%
輿	2467		17	12	0.001812%	654027	98.78%	6	1.84%
邪	2468		6	12	0.001812%	654039	98.78%	11	3.36%
釁	2469		25	12	0.001812%	654051	98.78%	8	2.45%
釘	2470		10	12	0.001812%	654063	98.78%	9	2.75%
雀	2471		11	12	0.001812%	654075	98.78%	11	3.36%
韶	2472		14	12	0.001812%	654087	98.78%	1	0.31%
餐	2473		16	12	0.001812%	654099	98.79%	7	2.14%
魅	2474		15	12	0.001812%	654111	98.79%	7	2.14%
齒	2475		15	12	0.001812%	654123	98.79%	9	2.75%
劈	2476		15	11	0.001661%	654134	98.79%	10	3.06%
咖	2477		8	11	0.001661%	654145	98.79%	4	1.22%
哀	2478		9	11	0.001661%	654156	98.80%	8	2.45%
哼	2479		10	11	0.001661%	654167	98.80%	7	2.14%
啡	2480		11	11	0.001661%	654178	98.80%	4	1.22%
嘻	2481		15	11	0.001661%	654189	98.80%	6	1.84%
嬌	2482		15	11	0.001661%	654200	98.80%	7	2.14%
宰	2483		10	11	0.001661%	654211	98.80%	7	2.14%
屏	2484		9	11	0.001661%	654222	98.81%	10	3.06%
履	2485		15	11	0.001661%	654233	98.81%	11	3.36%
帕	2486		8	11	0.001661%	654244	98.81%	10	3.06%
悔	2487		10	11	0.001661%	654255	98.81%	10	3.06%
憎	2488		15	11	0.001661%	654266	98.81%	6	1.84%
懲	2489		19	11	0.001661%	654277	98.81%	11	3.36%
抑	2490		7	11	0.001661%	654288	98.82%	9	2.75%
拂	2491		8	11	0.001661%	654299	98.82%	10	3.06%
拐	2492		8	11	0.001661%	654310	98.82%	10	3.06%
撼	2493		16	11	0.001661%	654321	98.82%	8	2.45%
撿	2494		16	11	0.001661%	654332	98.82%	8	2.45%
斬	2495		11	11	0.001661%	654343	98.82%	11	3.36%
晝	2496		11	11	0.001661%	654354	98.83%	11	3.36%
朧	2497		20	11	0.001661%	654365	98.83%	8	2.45%
梧	2498		11	11	0.001661%	654376	98.83%	6	1.84%
榷	2499		14	11	0.001661%	654387	98.83%	4	1.22%
泄	2500		8	11	0.001661%	654398	98.83%	8	2.45%
漏	2501		14	11	0.001661%	654409	98.83%	8	2.45%
滯	2502		14	11	0.001661%	654420	98.83%	10	3.06%
澄	2503		15	11	0.001661%	654431	98.84%	8	2.45%
澎	2504		15	11	0.001661%	654442	98.84%	9	2.75%
濺	2505		18	11	0.001661%	654453	98.84%	10	3.06%
燕	2506		16	11	0.001661%	654464	98.84%	7	2.14%
瓊	2507		19	11	0.001661%	654475	98.84%	7	2.14%
眯	2508		11	11	0.001661%	654486	98.84%	8	2.45%
矗	2509		24	11	0.001661%	654497	98.85%	9	2.75%
碌	2510		13	11	0.001661%	654508	98.85%	9	2.75%
碩	2511		14	11	0.001661%	654519	98.85%	6	1.84%
祈	2512		8	11	0.001661%	654530	98.85%	8	2.45%
秩	2513		10	11	0.001661%	654541	98.85%	9	2.75%
繃	2514		17	11	0.001661%	654552	98.85%	3	0.92%
聰	2515		17	11	0.001661%	654563	98.86%	9	2.75%
肘	2516		7	11	0.001661%	654574	98.86%	4	1.22%
膚	2517		15	11	0.001661%	654585	98.86%	10	3.06%
茨	2518		10	11	0.001661%	654596	98.86%	8	2.45%
董	2519		13	11	0.001661%	654607	98.86%	7	2.14%
虧	2520		17	11	0.001661%	654618	98.86%	10	3.06%
虹	2521		9	11	0.001661%	654629	98.87%	8	2.45%
詭	2522		13	11	0.001661%	654640	98.87%	10	3.06%
謙	2523		17	11	0.001661%	654651	98.87%	8	2.45%
謹	2524		18	11	0.001661%	654662	98.87%	6	1.84%
贏	2525		20	11	0.001661%	654673	98.87%	10	3.06%
跌	2526		12	11	0.001661%	654684	98.87%	8	2.45%
軸	2527		12	11	0.001661%	654695	98.88%	7	2.14%
醇	2528		15	11	0.001661%	654706	98.88%	5	1.53%
鎌	2529		18	11	0.001661%	654717	98.88%	3	0.92%
閥	2530		14	11	0.001661%	654728	98.88%	6	1.84%
韻	2531		19	11	0.001661%	654739	98.88%	8	2.45%
駝	2532		15	11	0.001661%	654750	98.88%	8	2.45%
丫	2533		3	10	0.00151%	654760	98.89%	8	2.45%
伽	2534		7	10	0.00151%	654770	98.89%	3	0.92%
侍	2535		8	10	0.00151%	654780	98.89%	6	1.84%
俏	2536		9	10	0.00151%	654790	98.89%	4	1.22%
偵	2537		11	10	0.00151%	654800	98.89%	9	2.75%
僕	2538		14	10	0.00151%	654810	98.89%	6	1.84%
僑	2539		14	10	0.00151%	654820	98.90%	7	2.14%
剿	2540		13	10	0.00151%	654830	98.90%	6	1.84%
哎	2541		9	10	0.00151%	654840	98.90%	7	2.14%
哄	2542		9	10	0.00151%	654850	98.90%	6	1.84%
嗨	2543		13	10	0.00151%	654860	98.90%	6	1.84%
媚	2544		12	10	0.00151%	654870	98.90%	7	2.14%
廈	2545		13	10	0.00151%	654880	98.90%	7	2.14%
彙	2546		13	10	0.00151%	654890	98.91%	1	0.31%
彥	2547		9	10	0.00151%	654900	98.91%	4	1.22%
惟	2548		11	10	0.00151%	654910	98.91%	6	1.84%
懈	2549		16	10	0.00151%	654920	98.91%	7	2.14%
扁	2550		9	10	0.00151%	654930	98.91%	10	3.06%
抒	2551		7	10	0.00151%	654940	98.91%	7	2.14%
摔	2552		14	10	0.00151%	654950	98.92%	8	2.45%
斐	2553		12	10	0.00151%	654960	98.92%	1	0.31%
杭	2554		8	10	0.00151%	654970	98.92%	5	1.53%
枚	2555		8	10	0.00151%	654980	98.92%	8	2.45%
柜	2556		9	10	0.00151%	654990	98.92%	2	0.61%
棘	2557		12	10	0.00151%	655000	98.92%	4	1.22%
槽	2558		15	10	0.00151%	655010	98.92%	5	1.53%
欠	2559		4	10	0.00151%	655020	98.93%	7	2.14%
淹	2560		11	10	0.00151%	655030	98.93%	9	2.75%
涵	2561		11	10	0.00151%	655040	98.93%	5	1.53%
湯	2562		12	10	0.00151%	655050	98.93%	7	2.14%
湃	2563		12	10	0.00151%	655060	98.93%	9	2.75%
潰	2564		15	10	0.00151%	655070	98.93%	8	2.45%
澳	2565		16	10	0.00151%	655080	98.93%	7	2.14%
濫	2566		17	10	0.00151%	655090	98.94%	10	3.06%
炔	2567		8	10	0.00151%	655100	98.94%	1	0.31%
烷	2568		11	10	0.00151%	655110	98.94%	1	0.31%
焚	2569		12	10	0.00151%	655120	98.94%	9	2.75%
疇	2570		19	10	0.00151%	655130	98.94%	7	2.14%
疤	2571		9	10	0.00151%	655140	98.94%	3	0.92%
瞬	2572		17	10	0.00151%	655150	98.95%	7	2.14%
矩	2573		10	10	0.00151%	655160	98.95%	7	2.14%
硝	2574		12	10	0.00151%	655170	98.95%	6	1.84%
磁	2575		14	10	0.00151%	655180	98.95%	9	2.75%
碾	2576		15	10	0.00151%	655190	98.95%	6	1.84%
禍	2577		13	10	0.00151%	655200	98.95%	7	2.14%
禾	2578		5	10	0.00151%	655210	98.95%	6	1.84%
稚	2579		13	10	0.00151%	655220	98.96%	9	2.75%
竇	2580		20	10	0.00151%	655230	98.96%	3	0.92%
竊	2581		23	10	0.00151%	655240	98.96%	6	1.84%
笨	2582		11	10	0.00151%	655250	98.96%	9	2.75%
筍	2583		12	10	0.00151%	655260	98.96%	7	2.14%
篙	2584		16	10	0.00151%	655270	98.96%	4	1.22%
篩	2585		16	10	0.00151%	655280	98.96%	7	2.14%
紳	2586		11	10	0.00151%	655290	98.97%	6	1.84%
翹	2587		18	10	0.00151%	655300	98.97%	7	2.14%
脊	2588		10	10	0.00151%	655310	98.97%	8	2.45%
膊	2589		14	10	0.00151%	655320	98.97%	9	2.75%
舵	2590		11	10	0.00151%	655330	98.97%	6	1.84%
芒	2591		7	10	0.00151%	655340	98.97%	8	2.45%
苔	2592		9	10	0.00151%	655350	98.98%	3	0.92%
蔚	2593		15	10	0.00151%	655360	98.98%	7	2.14%
蕊	2594		16	10	0.00151%	655370	98.98%	7	2.14%
藤	2595		19	10	0.00151%	655380	98.98%	9	2.75%
蘊	2596		20	10	0.00151%	655390	98.98%	6	1.84%
蟒	2597		17	10	0.00151%	655400	98.98%	3	0.92%
蠅	2598		19	10	0.00151%	655410	98.98%	5	1.53%
裳	2599		14	10	0.00151%	655420	98.99%	10	3.06%
誦	2600		14	10	0.00151%	655430	98.99%	8	2.45%
賬	2601		15	10	0.00151%	655440	98.99%	6	1.84%
踞	2602		15	10	0.00151%	655450	98.99%	6	1.84%
蹦	2603		18	10	0.00151%	655460	98.99%	7	2.14%
躁	2604		20	10	0.00151%	655470	98.99%	9	2.75%
轎	2605		19	10	0.00151%	655480	99.00%	5	1.53%
辰	2606		7	10	0.00151%	655490	99.00%	9	2.75%
鄙	2607		13	10	0.00151%	655500	99.00%	6	1.84%
鉛	2608		13	10	0.00151%	655510	99.00%	9	2.75%
銘	2609		14	10	0.00151%	655520	99.00%	10	3.06%
鍾	2610		17	10	0.00151%	655530	99.00%	7	2.14%
陀	2611		7	10	0.00151%	655540	99.00%	6	1.84%
隘	2612		12	10	0.00151%	655550	99.01%	7	2.14%
霄	2613		15	10	0.00151%	655560	99.01%	7	2.14%
饑	2614		20	10	0.00151%	655570	99.01%	7	2.14%
髒	2615		22	10	0.00151%	655580	99.01%	7	2.14%
鬚	2616		22	10	0.00151%	655590	99.01%	6	1.84%
儂	2617		15	9	0.001359%	655599	99.01%	2	0.61%
儒	2618		16	9	0.001359%	655608	99.01%	3	0.92%
兌	2619		7	9	0.001359%	655617	99.02%	7	2.14%
卓	2620		8	9	0.001359%	655626	99.02%	9	2.75%
卜	2621		2	9	0.001359%	655635	99.02%	7	2.14%
卿	2622		10	9	0.001359%	655644	99.02%	6	1.84%
吏	2623		6	9	0.001359%	655653	99.02%	5	1.53%
喇	2624		12	9	0.001359%	655662	99.02%	7	2.14%
噓	2625		15	9	0.001359%	655671	99.02%	6	1.84%
址	2626		7	9	0.001359%	655680	99.03%	6	1.84%
埠	2627		11	9	0.001359%	655689	99.03%	7	2.14%
塢	2628		13	9	0.001359%	655698	99.03%	2	0.61%
妖	2629		7	9	0.001359%	655707	99.03%	8	2.45%
宛	2630		8	9	0.001359%	655716	99.03%	8	2.45%
庸	2631		11	9	0.001359%	655725	99.03%	6	1.84%
廉	2632		13	9	0.001359%	655734	99.03%	8	2.45%
彗	2633		11	9	0.001359%	655743	99.03%	2	0.61%
恍	2634		9	9	0.001359%	655752	99.04%	7	2.14%
悍	2635		10	9	0.001359%	655761	99.04%	7	2.14%
惱	2636		12	9	0.001359%	655770	99.04%	7	2.14%
愚	2637		13	9	0.001359%	655779	99.04%	8	2.45%
戚	2638		11	9	0.001359%	655788	99.04%	8	2.45%
扳	2639		7	9	0.001359%	655797	99.04%	3	0.92%
拌	2640		8	9	0.001359%	655806	99.04%	6	1.84%
拙	2641		8	9	0.001359%	655815	99.05%	8	2.45%
拇	2642		8	9	0.001359%	655824	99.05%	6	1.84%
挪	2643		10	9	0.001359%	655833	99.05%	7	2.14%
揑	2644		12	9	0.001359%	655842	99.05%	5	1.53%
撕	2645		15	9	0.001359%	655851	99.05%	6	1.84%
擅	2646		16	9	0.001359%	655860	99.05%	6	1.84%
昭	2647		9	9	0.001359%	655869	99.05%	7	2.14%
欖	2648		25	9	0.001359%	655878	99.06%	4	1.22%
毯	2649		12	9	0.001359%	655887	99.06%	7	2.14%
氫	2650		11	9	0.001359%	655896	99.06%	5	1.53%
涯	2651		11	9	0.001359%	655905	99.06%	5	1.53%
澗	2652		15	9	0.001359%	655914	99.06%	6	1.84%
爪	2653		4	9	0.001359%	655923	99.06%	9	2.75%
猖	2654		11	9	0.001359%	655932	99.06%	7	2.14%
砸	2655		10	9	0.001359%	655941	99.06%	7	2.14%
笙	2656		11	9	0.001359%	655950	99.07%	4	1.22%
簾	2657		19	9	0.001359%	655959	99.07%	8	2.45%
繹	2658		19	9	0.001359%	655968	99.07%	5	1.53%
缸	2659		9	9	0.001359%	655977	99.07%	7	2.14%
耽	2660		10	9	0.001359%	655986	99.07%	7	2.14%
膏	2661		14	9	0.001359%	655995	99.07%	7	2.14%
芭	2662		8	9	0.001359%	656004	99.07%	2	0.61%
苑	2663		9	9	0.001359%	656013	99.08%	6	1.84%
茬	2664		10	9	0.001359%	656022	99.08%	5	1.53%
蕉	2665		16	9	0.001359%	656031	99.08%	4	1.22%
虫	2666		6	9	0.001359%	656040	99.08%	5	1.53%
蜂	2667		13	9	0.001359%	656049	99.08%	6	1.84%
蜿	2668		14	9	0.001359%	656058	99.08%	8	2.45%
褂	2669		13	9	0.001359%	656067	99.08%	7	2.14%
襟	2670		18	9	0.001359%	656076	99.09%	7	2.14%
襖	2671		18	9	0.001359%	656085	99.09%	5	1.53%
襪	2672		20	9	0.001359%	656094	99.09%	8	2.45%
詢	2673		13	9	0.001359%	656103	99.09%	7	2.14%
諧	2674		16	9	0.001359%	656112	99.09%	9	2.75%
諷	2675		16	9	0.001359%	656121	99.09%	7	2.14%
貞	2676		9	9	0.001359%	656130	99.09%	5	1.53%
貸	2677		12	9	0.001359%	656139	99.09%	6	1.84%
踩	2678		15	9	0.001359%	656148	99.10%	7	2.14%
蹄	2679		16	9	0.001359%	656157	99.10%	7	2.14%
軋	2680		8	9	0.001359%	656166	99.10%	6	1.84%
酬	2681		13	9	0.001359%	656175	99.10%	8	2.45%
鎊	2682		18	9	0.001359%	656184	99.10%	3	0.92%
鐮	2683		21	9	0.001359%	656193	99.10%	9	2.75%
陝	2684		9	9	0.001359%	656202	99.10%	7	2.14%
霎	2685		16	9	0.001359%	656211	99.11%	5	1.53%
餓	2686		15	9	0.001359%	656220	99.11%	7	2.14%
饅	2687		19	9	0.001359%	656229	99.11%	3	0.92%
鬱	2688		29	9	0.001359%	656238	99.11%	6	1.84%
乍	2689		5	8	0.001208%	656246	99.11%	6	1.84%
倦	2690		10	8	0.001208%	656254	99.11%	7	2.14%
僚	2691		14	8	0.001208%	656262	99.11%	6	1.84%
僵	2692		15	8	0.001208%	656270	99.11%	6	1.84%
冤	2693		10	8	0.001208%	656278	99.12%	5	1.53%
况	2694		7	8	0.001208%	656286	99.12%	7	2.14%
凈	2695		10	8	0.001208%	656294	99.12%	6	1.84%
匙	2696		11	8	0.001208%	656302	99.12%	4	1.22%
咐	2697		8	8	0.001208%	656310	99.12%	7	2.14%
哉	2698		9	8	0.001208%	656318	99.12%	5	1.53%
哺	2699		10	8	0.001208%	656326	99.12%	6	1.84%
唧	2700		10	8	0.001208%	656334	99.12%	4	1.22%
啞	2701		11	8	0.001208%	656342	99.13%	7	2.14%
啾	2702		12	8	0.001208%	656350	99.13%	4	1.22%
囉	2703		22	8	0.001208%	656358	99.13%	6	1.84%
圾	2704		7	8	0.001208%	656366	99.13%	6	1.84%
垃	2705		8	8	0.001208%	656374	99.13%	6	1.84%
屑	2706		10	8	0.001208%	656382	99.13%	3	0.92%
屹	2707		6	8	0.001208%	656390	99.13%	7	2.14%
崎	2708		11	8	0.001208%	656398	99.13%	6	1.84%
弓	2709		3	8	0.001208%	656406	99.13%	5	1.53%
弘	2710		5	8	0.001208%	656414	99.14%	1	0.31%
彤	2711		7	8	0.001208%	656422	99.14%	4	1.22%
徙	2712		11	8	0.001208%	656430	99.14%	4	1.22%
怔	2713		8	8	0.001208%	656438	99.14%	6	1.84%
恭	2714		10	8	0.001208%	656446	99.14%	6	1.84%
惹	2715		13	8	0.001208%	656454	99.14%	7	2.14%
愁	2716		13	8	0.001208%	656462	99.14%	7	2.14%
抄	2717		7	8	0.001208%	656470	99.14%	7	2.14%
拓	2718		8	8	0.001208%	656478	99.15%	5	1.53%
揉	2719		12	8	0.001208%	656486	99.15%	5	1.53%
摹	2720		15	8	0.001208%	656494	99.15%	5	1.53%
敷	2721		15	8	0.001208%	656502	99.15%	6	1.84%
斂	2722		17	8	0.001208%	656510	99.15%	4	1.22%
曳	2723		6	8	0.001208%	656518	99.15%	8	2.45%
朴	2724		6	8	0.001208%	656526	99.15%	3	0.92%
杈	2725		7	8	0.001208%	656534	99.15%	5	1.53%
柑	2726		9	8	0.001208%	656542	99.16%	3	0.92%
棺	2727		12	8	0.001208%	656550	99.16%	5	1.53%
椰	2728		13	8	0.001208%	656558	99.16%	5	1.53%
橄	2729		16	8	0.001208%	656566	99.16%	3	0.92%
氧	2730		10	8	0.001208%	656574	99.16%	7	2.14%
沛	2731		7	8	0.001208%	656582	99.16%	7	2.14%
浴	2732		10	8	0.001208%	656590	99.16%	8	2.45%
淙	2733		11	8	0.001208%	656598	99.16%	4	1.22%
渦	2734		12	8	0.001208%	656606	99.17%	4	1.22%
澇	2735		15	8	0.001208%	656614	99.17%	5	1.53%
澡	2736		16	8	0.001208%	656622	99.17%	5	1.53%
炳	2737		9	8	0.001208%	656630	99.17%	7	2.14%
燭	2738		17	8	0.001208%	656638	99.17%	5	1.53%
爍	2739		19	8	0.001208%	656646	99.17%	8	2.45%
爸	2740		8	8	0.001208%	656654	99.17%	2	0.61%
狡	2741		9	8	0.001208%	656662	99.17%	8	2.45%
猴	2742		12	8	0.001208%	656670	99.17%	6	1.84%
猾	2743		13	8	0.001208%	656678	99.18%	8	2.45%
瑩	2744		15	8	0.001208%	656686	99.18%	6	1.84%
瓷	2745		11	8	0.001208%	656694	99.18%	8	2.45%
痴	2746		13	8	0.001208%	656702	99.18%	5	1.53%
皚	2747		15	8	0.001208%	656710	99.18%	4	1.22%
盔	2748		11	8	0.001208%	656718	99.18%	5	1.53%
瞄	2749		14	8	0.001208%	656726	99.18%	6	1.84%
瞻	2750		18	8	0.001208%	656734	99.18%	7	2.14%
矯	2751		17	8	0.001208%	656742	99.19%	7	2.14%
穹	2752		8	8	0.001208%	656750	99.19%	8	2.45%
綁	2753		13	8	0.001208%	656758	99.19%	6	1.84%
綽	2754		14	8	0.001208%	656766	99.19%	5	1.53%
綢	2755		14	8	0.001208%	656774	99.19%	8	2.45%
繽	2756		20	8	0.001208%	656782	99.19%	8	2.45%
纜	2757		27	8	0.001208%	656790	99.19%	6	1.84%
肢	2758		8	8	0.001208%	656798	99.19%	3	0.92%
胳	2759		10	8	0.001208%	656806	99.20%	6	1.84%
脹	2760		12	8	0.001208%	656814	99.20%	5	1.53%
臀	2761		17	8	0.001208%	656822	99.20%	1	0.31%
苷	2762		9	8	0.001208%	656830	99.20%	1	0.31%
茲	2763		10	8	0.001208%	656838	99.20%	7	2.14%
菠	2764		12	8	0.001208%	656846	99.20%	1	0.31%
葱	2765		13	8	0.001208%	656854	99.20%	6	1.84%
蔬	2766		15	8	0.001208%	656862	99.20%	6	1.84%
蘸	2767		23	8	0.001208%	656870	99.20%	5	1.53%
蚊	2768		10	8	0.001208%	656878	99.21%	6	1.84%
蜒	2769		14	8	0.001208%	656886	99.21%	7	2.14%
蝴	2770		15	8	0.001208%	656894	99.21%	5	1.53%
袱	2771		11	8	0.001208%	656902	99.21%	4	1.22%
裸	2772		13	8	0.001208%	656910	99.21%	5	1.53%
諒	2773		15	8	0.001208%	656918	99.21%	6	1.84%
諮	2774		16	8	0.001208%	656926	99.21%	5	1.53%
豁	2775		17	8	0.001208%	656934	99.21%	8	2.45%
貯	2776		12	8	0.001208%	656942	99.22%	6	1.84%
賜	2777		15	8	0.001208%	656950	99.22%	6	1.84%
赳	2778		9	8	0.001208%	656958	99.22%	4	1.22%
辱	2779		10	8	0.001208%	656966	99.22%	8	2.45%
逞	2780		10	8	0.001208%	656974	99.22%	8	2.45%
邃	2781		17	8	0.001208%	656982	99.22%	7	2.14%
醜	2782		17	8	0.001208%	656990	99.22%	7	2.14%
釀	2783		24	8	0.001208%	656998	99.22%	8	2.45%
鈕	2784		12	8	0.001208%	657006	99.23%	3	0.92%
鑲	2785		25	8	0.001208%	657014	99.23%	7	2.14%
陋	2786		8	8	0.001208%	657022	99.23%	8	2.45%
靶	2787		13	8	0.001208%	657030	99.23%	5	1.53%
餵	2788		17	8	0.001208%	657038	99.23%	3	0.92%
駭	2789		16	8	0.001208%	657046	99.23%	6	1.84%
鮑	2790		16	8	0.001208%	657054	99.23%	5	1.53%
鷗	2791		22	8	0.001208%	657062	99.23%	5	1.53%
丑	2792		4	7	0.001057%	657069	99.24%	4	1.22%
乖	2793		8	7	0.001057%	657076	99.24%	5	1.53%
倚	2794		10	7	0.001057%	657083	99.24%	7	2.14%
俱	2795		10	7	0.001057%	657090	99.24%	5	1.53%
兀	2796		3	7	0.001057%	657097	99.24%	5	1.53%
募	2797		13	7	0.001057%	657104	99.24%	7	2.14%
勳	2798		16	7	0.001057%	657111	99.24%	3	0.92%
后	2799		6	7	0.001057%	657118	99.24%	6	1.84%
咒	2800		8	7	0.001057%	657125	99.24%	5	1.53%
咳	2801		9	7	0.001057%	657132	99.24%	4	1.22%
咭	2802		9	7	0.001057%	657139	99.25%	3	0.92%
哮	2803		10	7	0.001057%	657146	99.25%	7	2.14%
啪	2804		11	7	0.001057%	657153	99.25%	4	1.22%
啼	2805		12	7	0.001057%	657160	99.25%	5	1.53%
喏	2806		12	7	0.001057%	657167	99.25%	5	1.53%
嘀	2807		14	7	0.001057%	657174	99.25%	4	1.22%
嘈	2808		14	7	0.001057%	657181	99.25%	3	0.92%
噢	2809		16	7	0.001057%	657188	99.25%	7	2.14%
嚼	2810		20	7	0.001057%	657195	99.25%	5	1.53%
坍	2811		7	7	0.001057%	657202	99.26%	4	1.22%
堪	2812		12	7	0.001057%	657209	99.26%	5	1.53%
奕	2813		9	7	0.001057%	657216	99.26%	3	0.92%
奠	2814		12	7	0.001057%	657223	99.26%	7	2.14%
姚	2815		9	7	0.001057%	657230	99.26%	6	1.84%
屜	2816		11	7	0.001057%	657237	99.26%	4	1.22%
岡	2817		8	7	0.001057%	657244	99.26%	6	1.84%
崩	2818		11	7	0.001057%	657251	99.26%	6	1.84%
幢	2819		15	7	0.001057%	657258	99.26%	5	1.53%
庚	2820		8	7	0.001057%	657265	99.26%	3	0.92%
廚	2821		15	7	0.001057%	657272	99.27%	3	0.92%
御	2822		11	7	0.001057%	657279	99.27%	7	2.14%
憐	2823		15	7	0.001057%	657286	99.27%	5	1.53%
戮	2824		15	7	0.001057%	657293	99.27%	2	0.61%
扛	2825		6	7	0.001057%	657300	99.27%	6	1.84%
拚	2826		8	7	0.001057%	657307	99.27%	5	1.53%
捐	2827		10	7	0.001057%	657314	99.27%	5	1.53%
挫	2828		10	7	0.001057%	657321	99.27%	6	1.84%
摯	2829		15	7	0.001057%	657328	99.27%	7	2.14%
擱	2830		17	7	0.001057%	657335	99.28%	5	1.53%
晒	2831		10	7	0.001057%	657342	99.28%	7	2.14%
曙	2832		17	7	0.001057%	657349	99.28%	4	1.22%
枕	2833		8	7	0.001057%	657356	99.28%	7	2.14%
枷	2834		9	7	0.001057%	657363	99.28%	6	1.84%
棰	2835		13	7	0.001057%	657370	99.28%	2	0.61%
榨	2836		14	7	0.001057%	657377	99.28%	7	2.14%
橙	2837		16	7	0.001057%	657384	99.28%	5	1.53%
櫃	2838		18	7	0.001057%	657391	99.28%	5	1.53%
泵	2839		9	7	0.001057%	657398	99.28%	5	1.53%
涌	2840		10	7	0.001057%	657405	99.29%	5	1.53%
渣	2841		12	7	0.001057%	657412	99.29%	7	2.14%
漣	2842		14	7	0.001057%	657419	99.29%	4	1.22%
滬	2843		14	7	0.001057%	657426	99.29%	5	1.53%
瀾	2844		20	7	0.001057%	657433	99.29%	6	1.84%
灩	2845		31	7	0.001057%	657440	99.29%	3	0.92%
熄	2846		14	7	0.001057%	657447	99.29%	7	2.14%
瑙	2847		13	7	0.001057%	657454	99.29%	6	1.84%
疫	2848		9	7	0.001057%	657461	99.29%	3	0.92%
瘡	2849		15	7	0.001057%	657468	99.30%	2	0.61%
皂	2850		7	7	0.001057%	657475	99.30%	7	2.14%
瞪	2851		17	7	0.001057%	657482	99.30%	7	2.14%
硼	2852		13	7	0.001057%	657489	99.30%	2	0.61%
磅	2853		15	7	0.001057%	657496	99.30%	6	1.84%
礡	2854		19	7	0.001057%	657503	99.30%	6	1.84%
禪	2855		16	7	0.001057%	657510	99.30%	5	1.53%
穴	2856		5	7	0.001057%	657517	99.30%	7	2.14%
窟	2857		13	7	0.001057%	657524	99.30%	2	0.61%
籲	2858		32	7	0.001057%	657531	99.30%	3	0.92%
絞	2859		12	7	0.001057%	657538	99.31%	4	1.22%
綴	2860		14	7	0.001057%	657545	99.31%	4	1.22%
締	2861		15	7	0.001057%	657552	99.31%	4	1.22%
罰	2862		14	7	0.001057%	657559	99.31%	6	1.84%
羽	2863		6	7	0.001057%	657566	99.31%	6	1.84%
耘	2864		10	7	0.001057%	657573	99.31%	4	1.22%
聾	2865		22	7	0.001057%	657580	99.31%	4	1.22%
肖	2866		7	7	0.001057%	657587	99.31%	6	1.84%
肝	2867		7	7	0.001057%	657594	99.31%	4	1.22%
范	2868		9	7	0.001057%	657601	99.32%	6	1.84%
荐	2869		10	7	0.001057%	657608	99.32%	2	0.61%
虜	2870		13	7	0.001057%	657615	99.32%	7	2.14%
蝦	2871		15	7	0.001057%	657622	99.32%	5	1.53%
衢	2872		24	7	0.001057%	657629	99.32%	3	0.92%
謅	2873		17	7	0.001057%	657636	99.32%	3	0.92%
譚	2874		19	7	0.001057%	657643	99.32%	6	1.84%
豫	2875		16	7	0.001057%	657650	99.32%	6	1.84%
貶	2876		12	7	0.001057%	657657	99.32%	6	1.84%
賠	2877		15	7	0.001057%	657664	99.32%	4	1.22%
赴	2878		9	7	0.001057%	657671	99.33%	5	1.53%
逗	2879		10	7	0.001057%	657678	99.33%	7	2.14%
鈍	2880		12	7	0.001057%	657685	99.33%	5	1.53%
鑿	2881		28	7	0.001057%	657692	99.33%	7	2.14%
閩	2882		14	7	0.001057%	657699	99.33%	3	0.92%
霆	2883		15	7	0.001057%	657706	99.33%	6	1.84%
韋	2884		9	7	0.001057%	657713	99.33%	5	1.53%
頒	2885		13	7	0.001057%	657720	99.33%	7	2.14%
駱	2886		16	7	0.001057%	657727	99.33%	3	0.92%
魁	2887		14	7	0.001057%	657734	99.34%	7	2.14%
鴉	2888		15	7	0.001057%	657741	99.34%	5	1.53%
鶴	2889		21	7	0.001057%	657748	99.34%	5	1.53%
仃	2890		4	6	0.0009062%	657754	99.34%	1	0.31%
伶	2891		7	6	0.0009062%	657760	99.34%	1	0.31%
俘	2892		9	6	0.0009062%	657766	99.34%	6	1.84%
侮	2893		9	6	0.0009062%	657772	99.34%	6	1.84%
兢	2894		14	6	0.0009062%	657778	99.34%	3	0.92%
冕	2895		11	6	0.0009062%	657784	99.34%	6	1.84%
凄	2896		10	6	0.0009062%	657790	99.34%	5	1.53%
刁	2897		2	6	0.0009062%	657796	99.34%	5	1.53%
刑	2898		6	6	0.0009062%	657802	99.35%	5	1.53%
剃	2899		9	6	0.0009062%	657808	99.35%	3	0.92%
勉	2900		9	6	0.0009062%	657814	99.35%	6	1.84%
叨	2901		5	6	0.0009062%	657820	99.35%	4	1.22%
叭	2902		5	6	0.0009062%	657826	99.35%	4	1.22%
吭	2903		7	6	0.0009062%	657832	99.35%	5	1.53%
吾	2904		7	6	0.0009062%	657838	99.35%	4	1.22%
咆	2905		8	6	0.0009062%	657844	99.35%	6	1.84%
呱	2906		8	6	0.0009062%	657850	99.35%	2	0.61%
咸	2907		9	6	0.0009062%	657856	99.35%	6	1.84%
啃	2908		11	6	0.0009062%	657862	99.35%	5	1.53%
喁	2909		12	6	0.0009062%	657868	99.36%	2	0.61%
嗬	2910		14	6	0.0009062%	657874	99.36%	6	1.84%
嘲	2911		15	6	0.0009062%	657880	99.36%	6	1.84%
噗	2912		15	6	0.0009062%	657886	99.36%	5	1.53%
嘶	2913		15	6	0.0009062%	657892	99.36%	5	1.53%
墩	2914		15	6	0.0009062%	657898	99.36%	3	0.92%
壑	2915		17	6	0.0009062%	657904	99.36%	5	1.53%
妍	2916		7	6	0.0009062%	657910	99.36%	6	1.84%
姻	2917		9	6	0.0009062%	657916	99.36%	3	0.92%
娛	2918		10	6	0.0009062%	657922	99.36%	4	1.22%
娓	2919		10	6	0.0009062%	657928	99.36%	3	0.92%
嬰	2920		17	6	0.0009062%	657934	99.37%	6	1.84%
寞	2921		14	6	0.0009062%	657940	99.37%	5	1.53%
岑	2922		7	6	0.0009062%	657946	99.37%	3	0.92%
岔	2923		7	6	0.0009062%	657952	99.37%	5	1.53%
岳	2924		8	6	0.0009062%	657958	99.37%	5	1.53%
巔	2925		22	6	0.0009062%	657964	99.37%	6	1.84%
庇	2926		7	6	0.0009062%	657970	99.37%	5	1.53%
憾	2927		16	6	0.0009062%	657976	99.37%	5	1.53%
懶	2928		19	6	0.0009062%	657982	99.37%	6	1.84%
扼	2929		7	6	0.0009062%	657988	99.37%	4	1.22%
拎	2930		8	6	0.0009062%	657994	99.37%	4	1.22%
捎	2931		10	6	0.0009062%	658000	99.38%	1	0.31%
搓	2932		13	6	0.0009062%	658006	99.38%	4	1.22%
摟	2933		14	6	0.0009062%	658012	99.38%	4	1.22%
摻	2934		14	6	0.0009062%	658018	99.38%	4	1.22%
擎	2935		17	6	0.0009062%	658024	99.38%	4	1.22%
擰	2936		17	6	0.0009062%	658030	99.38%	5	1.53%
攘	2937		20	6	0.0009062%	658036	99.38%	3	0.92%
攬	2938		24	6	0.0009062%	658042	99.38%	6	1.84%
敕	2939		11	6	0.0009062%	658048	99.38%	4	1.22%
暑	2940		12	6	0.0009062%	658054	99.38%	6	1.84%
杉	2941		7	6	0.0009062%	658060	99.38%	3	0.92%
柞	2942		9	6	0.0009062%	658066	99.39%	2	0.61%
梳	2943		10	6	0.0009062%	658072	99.39%	6	1.84%
桅	2944		10	6	0.0009062%	658078	99.39%	4	1.22%
栖	2945		10	6	0.0009062%	658084	99.39%	3	0.92%
梵	2946		11	6	0.0009062%	658090	99.39%	2	0.61%
樵	2947		16	6	0.0009062%	658096	99.39%	3	0.92%
氈	2948		17	6	0.0009062%	658102	99.39%	1	0.31%
沁	2949		7	6	0.0009062%	658108	99.39%	6	1.84%
沱	2950		8	6	0.0009062%	658114	99.39%	4	1.22%
沽	2951		8	6	0.0009062%	658120	99.39%	4	1.22%
洽	2952		9	6	0.0009062%	658126	99.39%	6	1.84%
淞	2953		11	6	0.0009062%	658132	99.40%	1	0.31%
淵	2954		11	6	0.0009062%	658138	99.40%	5	1.53%
漩	2955		14	6	0.0009062%	658144	99.40%	3	0.92%
漾	2956		14	6	0.0009062%	658150	99.40%	6	1.84%
滸	2957		14	6	0.0009062%	658156	99.40%	2	0.61%
濁	2958		16	6	0.0009062%	658162	99.40%	6	1.84%
濘	2959		17	6	0.0009062%	658168	99.40%	5	1.53%
炊	2960		8	6	0.0009062%	658174	99.40%	5	1.53%
炯	2961		9	6	0.0009062%	658180	99.40%	3	0.92%
煜	2962		13	6	0.0009062%	658186	99.40%	2	0.61%
煽	2963		14	6	0.0009062%	658192	99.40%	6	1.84%
熬	2964		15	6	0.0009062%	658198	99.41%	5	1.53%
狽	2965		10	6	0.0009062%	658204	99.41%	6	1.84%
甩	2966		5	6	0.0009062%	658210	99.41%	6	1.84%
疥	2967		9	6	0.0009062%	658216	99.41%	1	0.31%
疹	2968		10	6	0.0009062%	658222	99.41%	4	1.22%
痕	2969		11	6	0.0009062%	658228	99.41%	6	1.84%
癱	2970		24	6	0.0009062%	658234	99.41%	5	1.53%
眸	2971		11	6	0.0009062%	658240	99.41%	3	0.92%
瞋	2972		15	6	0.0009062%	658246	99.41%	2	0.61%
瞞	2973		16	6	0.0009062%	658252	99.41%	5	1.53%
磺	2974		17	6	0.0009062%	658258	99.41%	3	0.92%
秸	2975		11	6	0.0009062%	658264	99.42%	4	1.22%
穫	2976		19	6	0.0009062%	658270	99.42%	5	1.53%
筷	2977		13	6	0.0009062%	658276	99.42%	5	1.53%
簪	2978		18	6	0.0009062%	658282	99.42%	5	1.53%
粼	2979		14	6	0.0009062%	658288	99.42%	3	0.92%
緯	2980		15	6	0.0009062%	658294	99.42%	3	0.92%
繚	2981		18	6	0.0009062%	658300	99.42%	5	1.53%
翡	2982		14	6	0.0009062%	658306	99.42%	5	1.53%
耿	2983		10	6	0.0009062%	658312	99.42%	3	0.92%
脯	2984		11	6	0.0009062%	658318	99.42%	3	0.92%
茁	2985		9	6	0.0009062%	658324	99.42%	6	1.84%
苞	2986		9	6	0.0009062%	658330	99.43%	4	1.22%
苯	2987		9	6	0.0009062%	658336	99.43%	4	1.22%
荔	2988		10	6	0.0009062%	658342	99.43%	2	0.61%
莖	2989		11	6	0.0009062%	658348	99.43%	4	1.22%
荻	2990		11	6	0.0009062%	658354	99.43%	2	0.61%
蒲	2991		14	6	0.0009062%	658360	99.43%	6	1.84%
蔓	2992		15	6	0.0009062%	658366	99.43%	5	1.53%
薪	2993		17	6	0.0009062%	658372	99.43%	6	1.84%
藐	2994		18	6	0.0009062%	658378	99.43%	4	1.22%
藉	2995		18	6	0.0009062%	658384	99.43%	4	1.22%
藩	2996		19	6	0.0009062%	658390	99.43%	3	0.92%
裊	2997		13	6	0.0009062%	658396	99.44%	3	0.92%
詔	2998		12	6	0.0009062%	658402	99.44%	3	0.92%
訶	2999		12	6	0.0009062%	658408	99.44%	4	1.22%
諄	3000		15	6	0.0009062%	658414	99.44%	3	0.92%
諦	3001		16	6	0.0009062%	658420	99.44%	5	1.53%
貓	3002		16	6	0.0009062%	658426	99.44%	6	1.84%
贈	3003		19	6	0.0009062%	658432	99.44%	5	1.53%
贖	3004		22	6	0.0009062%	658438	99.44%	4	1.22%
軛	3005		11	6	0.0009062%	658444	99.44%	3	0.92%
逛	3006		10	6	0.0009062%	658450	99.44%	5	1.53%
遂	3007		12	6	0.0009062%	658456	99.44%	4	1.22%
鄧	3008		14	6	0.0009062%	658462	99.45%	4	1.22%
醺	3009		21	6	0.0009062%	658468	99.45%	2	0.61%
釸	3010		11	6	0.0009062%	658474	99.45%	1	0.31%
鈔	3011		12	6	0.0009062%	658480	99.45%	5	1.53%
鈾	3012		13	6	0.0009062%	658486	99.45%	2	0.61%
鍊	3013		17	6	0.0009062%	658492	99.45%	5	1.53%
錘	3014		17	6	0.0009062%	658498	99.45%	5	1.53%
隼	3015		10	6	0.0009062%	658504	99.45%	3	0.92%
靖	3016		13	6	0.0009062%	658510	99.45%	3	0.92%
颱	3017		14	6	0.0009062%	658516	99.45%	3	0.92%
鬢	3018		24	6	0.0009062%	658522	99.45%	5	1.53%
鱗	3019		23	6	0.0009062%	658528	99.46%	5	1.53%
鳳	3020		14	6	0.0009062%	658534	99.46%	4	1.22%
亨	3021		7	5	0.0007551%	658539	99.46%	2	0.61%
仲	3022		6	5	0.0007551%	658544	99.46%	4	1.22%
侶	3023		9	5	0.0007551%	658549	99.46%	4	1.22%
債	3024		13	5	0.0007551%	658554	99.46%	4	1.22%
儼	3025		22	5	0.0007551%	658559	99.46%	5	1.53%
兜	3026		11	5	0.0007551%	658564	99.46%	5	1.53%
凜	3027		15	5	0.0007551%	658569	99.46%	5	1.53%
卉	3028		5	5	0.0007551%	658574	99.46%	5	1.53%
卒	3029		8	5	0.0007551%	658579	99.46%	4	1.22%
吁	3030		6	5	0.0007551%	658584	99.46%	3	0.92%
吻	3031		7	5	0.0007551%	658589	99.46%	3	0.92%
咕	3032		8	5	0.0007551%	658594	99.47%	3	0.92%
咀	3033		8	5	0.0007551%	658599	99.47%	4	1.22%
呻	3034		8	5	0.0007551%	658604	99.47%	5	1.53%
咚	3035		8	5	0.0007551%	658609	99.47%	3	0.92%
咽	3036		9	5	0.0007551%	658614	99.47%	5	1.53%
唾	3037		12	5	0.0007551%	658619	99.47%	5	1.53%
喲	3038		12	5	0.0007551%	658624	99.47%	5	1.53%
嘿	3039		15	5	0.0007551%	658629	99.47%	4	1.22%
嚓	3040		17	5	0.0007551%	658634	99.47%	3	0.92%
囂	3041		21	5	0.0007551%	658639	99.47%	5	1.53%
囗	3042		3	5	0.0007551%	658644	99.47%	1	0.31%
囪	3043		7	5	0.0007551%	658649	99.47%	3	0.92%
圃	3044		10	5	0.0007551%	658654	99.47%	4	1.22%
堰	3045		12	5	0.0007551%	658659	99.48%	3	0.92%
塌	3046		13	5	0.0007551%	658664	99.48%	5	1.53%
墊	3047		14	5	0.0007551%	658669	99.48%	4	1.22%
墜	3048		15	5	0.0007551%	658674	99.48%	5	1.53%
妞	3049		7	5	0.0007551%	658679	99.48%	1	0.31%
媒	3050		12	5	0.0007551%	658684	99.48%	5	1.53%
嬉	3051		15	5	0.0007551%	658689	99.48%	4	1.22%
孵	3052		14	5	0.0007551%	658694	99.48%	3	0.92%
寥	3053		14	5	0.0007551%	658699	99.48%	4	1.22%
寢	3054		14	5	0.0007551%	658704	99.48%	5	1.53%
窰	3055		15	5	0.0007551%	658709	99.48%	5	1.53%
尹	3056		4	5	0.0007551%	658714	99.48%	3	0.92%
屢	3057		14	5	0.0007551%	658719	99.48%	5	1.53%
崆	3058		11	5	0.0007551%	658724	99.48%	1	0.31%
嶇	3059		14	5	0.0007551%	658729	99.49%	5	1.53%
嶂	3060		14	5	0.0007551%	658734	99.49%	5	1.53%
廷	3061		7	5	0.0007551%	658739	99.49%	5	1.53%
忌	3062		7	5	0.0007551%	658744	99.49%	4	1.22%
恕	3063		10	5	0.0007551%	658749	99.49%	4	1.22%
惋	3064		11	5	0.0007551%	658754	99.49%	5	1.53%
憋	3065		15	5	0.0007551%	658759	99.49%	4	1.22%
掐	3066		11	5	0.0007551%	658764	99.49%	5	1.53%
掣	3067		12	5	0.0007551%	658769	99.49%	2	0.61%
撰	3068		15	5	0.0007551%	658774	99.49%	3	0.92%
攙	3069		20	5	0.0007551%	658779	99.49%	4	1.22%
旳	3070		7	5	0.0007551%	658784	99.49%	5	1.53%
昆	3071		8	5	0.0007551%	658789	99.49%	4	1.22%
昉	3072		8	5	0.0007551%	658794	99.50%	1	0.31%
暇	3073		13	5	0.0007551%	658799	99.50%	5	1.53%
暈	3074		13	5	0.0007551%	658804	99.50%	3	0.92%
杰	3075		8	5	0.0007551%	658809	99.50%	4	1.22%
柄	3076		9	5	0.0007551%	658814	99.50%	5	1.53%
椏	3077		12	5	0.0007551%	658819	99.50%	2	0.61%
楣	3078		13	5	0.0007551%	658824	99.50%	2	0.61%
橘	3079		16	5	0.0007551%	658829	99.50%	1	0.31%
欽	3080		12	5	0.0007551%	658834	99.50%	3	0.92%
氓	3081		8	5	0.0007551%	658839	99.50%	4	1.22%
汀	3082		5	5	0.0007551%	658844	99.50%	4	1.22%
淘	3083		11	5	0.0007551%	658849	99.50%	3	0.92%
溯	3084		13	5	0.0007551%	658854	99.50%	4	1.22%
滌	3085		14	5	0.0007551%	658859	99.51%	5	1.53%
澦	3086		16	5	0.0007551%	658864	99.51%	1	0.31%
瀋	3087		18	5	0.0007551%	658869	99.51%	3	0.92%
瀝	3088		19	5	0.0007551%	658874	99.51%	3	0.92%
烤	3089		10	5	0.0007551%	658879	99.51%	3	0.92%
焉	3090		11	5	0.0007551%	658884	99.51%	4	1.22%
焙	3091		12	5	0.0007551%	658889	99.51%	1	0.31%
煬	3092		13	5	0.0007551%	658894	99.51%	2	0.61%
熔	3093		14	5	0.0007551%	658899	99.51%	4	1.22%
燙	3094		16	5	0.0007551%	658904	99.51%	4	1.22%
狄	3095		7	5	0.0007551%	658909	99.51%	3	0.92%
琢	3096		12	5	0.0007551%	658914	99.51%	3	0.92%
甄	3097		14	5	0.0007551%	658919	99.51%	1	0.31%
疙	3098		8	5	0.0007551%	658924	99.52%	4	1.22%
瘓	3099		14	5	0.0007551%	658929	99.52%	4	1.22%
瘟	3100		15	5	0.0007551%	658934	99.52%	5	1.53%
矚	3101		26	5	0.0007551%	658939	99.52%	4	1.22%
碁	3102		13	5	0.0007551%	658944	99.52%	1	0.31%
祀	3103		7	5	0.0007551%	658949	99.52%	3	0.92%
祜	3104		9	5	0.0007551%	658954	99.52%	1	0.31%
禱	3105		18	5	0.0007551%	658959	99.52%	4	1.22%
窣	3106		13	5	0.0007551%	658964	99.52%	2	0.61%
窪	3107		14	5	0.0007551%	658969	99.52%	3	0.92%
篡	3108		16	5	0.0007551%	658974	99.52%	4	1.22%
簿	3109		19	5	0.0007551%	658979	99.52%	2	0.61%
簸	3110		19	5	0.0007551%	658984	99.52%	3	0.92%
籬	3111		25	5	0.0007551%	658989	99.53%	3	0.92%
粘	3112		11	5	0.0007551%	658994	99.53%	5	1.53%
粵	3113		13	5	0.0007551%	658999	99.53%	3	0.92%
繇	3114		17	5	0.0007551%	659004	99.53%	1	0.31%
翩	3115		15	5	0.0007551%	659009	99.53%	3	0.92%
聶	3116		18	5	0.0007551%	659014	99.53%	4	1.22%
腥	3117		13	5	0.0007551%	659019	99.53%	5	1.53%
膩	3118		16	5	0.0007551%	659024	99.53%	4	1.22%
舀	3119		10	5	0.0007551%	659029	99.53%	5	1.53%
舷	3120		11	5	0.0007551%	659034	99.53%	5	1.53%
芝	3121		8	5	0.0007551%	659039	99.53%	1	0.31%
萌	3122		12	5	0.0007551%	659044	99.53%	5	1.53%
蕈	3123		16	5	0.0007551%	659049	99.53%	1	0.31%
虔	3124		10	5	0.0007551%	659054	99.53%	4	1.22%
蚌	3125		10	5	0.0007551%	659059	99.54%	3	0.92%
蛙	3126		12	5	0.0007551%	659064	99.54%	4	1.22%
褐	3127		14	5	0.0007551%	659069	99.54%	4	1.22%
諺	3128		16	5	0.0007551%	659074	99.54%	5	1.53%
諱	3129		16	5	0.0007551%	659079	99.54%	5	1.53%
謫	3130		18	5	0.0007551%	659084	99.54%	3	0.92%
豹	3131		10	5	0.0007551%	659089	99.54%	3	0.92%
賤	3132		15	5	0.0007551%	659094	99.54%	4	1.22%
躬	3133		10	5	0.0007551%	659099	99.54%	5	1.53%
酣	3134		12	5	0.0007551%	659104	99.54%	5	1.53%
醋	3135		15	5	0.0007551%	659109	99.54%	2	0.61%
醛	3136		17	5	0.0007551%	659114	99.54%	1	0.31%
醬	3137		18	5	0.0007551%	659119	99.54%	2	0.61%
鉆	3138		13	5	0.0007551%	659124	99.55%	5	1.53%
銬	3139		14	5	0.0007551%	659129	99.55%	3	0.92%
銹	3140		15	5	0.0007551%	659134	99.55%	2	0.61%
鏟	3141		19	5	0.0007551%	659139	99.55%	5	1.53%
鏈	3142		19	5	0.0007551%	659144	99.55%	2	0.61%
鐐	3143		20	5	0.0007551%	659149	99.55%	3	0.92%
鑊	3144		22	5	0.0007551%	659154	99.55%	1	0.31%
陜	3145		9	5	0.0007551%	659159	99.55%	3	0.92%
隧	3146		15	5	0.0007551%	659164	99.55%	3	0.92%
靄	3147		24	5	0.0007551%	659169	99.55%	4	1.22%
頤	3148		16	5	0.0007551%	659174	99.55%	2	0.61%
馮	3149		12	5	0.0007551%	659179	99.55%	4	1.22%
駿	3150		17	5	0.0007551%	659184	99.55%	4	1.22%
騷	3151		20	5	0.0007551%	659189	99.56%	5	1.53%
驀	3152		21	5	0.0007551%	659194	99.56%	5	1.53%
鶯	3153		21	5	0.0007551%	659199	99.56%	4	1.22%
黏	3154		17	5	0.0007551%	659204	99.56%	3	0.92%
黯	3155		21	5	0.0007551%	659209	99.56%	4	1.22%
鼎	3156		13	5	0.0007551%	659214	99.56%	5	1.53%
伎	3157		6	4	0.0006041%	659218	99.56%	3	0.92%
佤	3158		7	4	0.0006041%	659222	99.56%	1	0.31%
併	3159		8	4	0.0006041%	659226	99.56%	4	1.22%
俠	3160		9	4	0.0006041%	659230	99.56%	3	0.92%
俾	3161		10	4	0.0006041%	659234	99.56%	1	0.31%
兇	3162		6	4	0.0006041%	659238	99.56%	4	1.22%
兔	3163		8	4	0.0006041%	659242	99.56%	4	1.22%
刨	3164		7	4	0.0006041%	659246	99.56%	4	1.22%
剖	3165		10	4	0.0006041%	659250	99.56%	4	1.22%
剔	3166		10	4	0.0006041%	659254	99.57%	4	1.22%
匐	3167		11	4	0.0006041%	659258	99.57%	4	1.22%
厄	3168		4	4	0.0006041%	659262	99.57%	3	0.92%
叼	3169		5	4	0.0006041%	659266	99.57%	4	1.22%
叱	3170		5	4	0.0006041%	659270	99.57%	4	1.22%
吩	3171		7	4	0.0006041%	659274	99.57%	4	1.22%
吶	3172		7	4	0.0006041%	659278	99.57%	3	0.92%
咄	3173		8	4	0.0006041%	659282	99.57%	2	0.61%
唔	3174		10	4	0.0006041%	659286	99.57%	3	0.92%
喳	3175		12	4	0.0006041%	659290	99.57%	2	0.61%
嗅	3176		13	4	0.0006041%	659294	99.57%	2	0.61%
嘖	3177		14	4	0.0006041%	659298	99.57%	2	0.61%
噹	3178		16	4	0.0006041%	659302	99.57%	2	0.61%
嚀	3179		17	4	0.0006041%	659306	99.57%	2	0.61%
嚁	3180		17	4	0.0006041%	659310	99.57%	1	0.31%
嚶	3181		20	4	0.0006041%	659314	99.57%	2	0.61%
壼	3182		13	4	0.0006041%	659318	99.57%	3	0.92%
夸	3183		6	4	0.0006041%	659322	99.58%	3	0.92%
妒	3184		7	4	0.0006041%	659326	99.58%	3	0.92%
姜	3185		9	4	0.0006041%	659330	99.58%	3	0.92%
姨	3186		9	4	0.0006041%	659334	99.58%	4	1.22%
宸	3187		10	4	0.0006041%	659338	99.58%	2	0.61%
寅	3188		11	4	0.0006041%	659342	99.58%	4	1.22%
屁	3189		7	4	0.0006041%	659346	99.58%	4	1.22%
峙	3190		9	4	0.0006041%	659350	99.58%	4	1.22%
峪	3191		10	4	0.0006041%	659354	99.58%	4	1.22%
峴	3192		10	4	0.0006041%	659358	99.58%	2	0.61%
巢	3193		11	4	0.0006041%	659362	99.58%	3	0.92%
帚	3194		8	4	0.0006041%	659366	99.58%	3	0.92%
庄	3195		6	4	0.0006041%	659370	99.58%	2	0.61%
廖	3196		14	4	0.0006041%	659374	99.58%	3	0.92%
廝	3197		15	4	0.0006041%	659378	99.58%	2	0.61%
徊	3198		9	4	0.0006041%	659382	99.58%	4	1.22%
忱	3199		7	4	0.0006041%	659386	99.58%	4	1.22%
怡	3200		8	4	0.0006041%	659390	99.59%	3	0.92%
恙	3201		10	4	0.0006041%	659394	99.59%	2	0.61%
惦	3202		11	4	0.0006041%	659398	99.59%	3	0.92%
悼	3203		11	4	0.0006041%	659402	99.59%	4	1.22%
愕	3204		12	4	0.0006041%	659406	99.59%	4	1.22%
慷	3205		14	4	0.0006041%	659410	99.59%	4	1.22%
慚	3206		14	4	0.0006041%	659414	99.59%	4	1.22%
憩	3207		16	4	0.0006041%	659418	99.59%	3	0.92%
拭	3208		9	4	0.0006041%	659422	99.59%	3	0.92%
挎	3209		9	4	0.0006041%	659426	99.59%	2	0.61%
揩	3210		12	4	0.0006041%	659430	99.59%	2	0.61%
捶	3211		12	4	0.0006041%	659434	99.59%	2	0.61%
撅	3212		15	4	0.0006041%	659438	99.59%	3	0.92%
擻	3213		18	4	0.0006041%	659442	99.59%	4	1.22%
攣	3214		23	4	0.0006041%	659446	99.59%	3	0.92%
斌	3215		12	4	0.0006041%	659450	99.59%	1	0.31%
斧	3216		8	4	0.0006041%	659454	99.60%	3	0.92%
晤	3217		11	4	0.0006041%	659458	99.60%	3	0.92%
曠	3218		19	4	0.0006041%	659462	99.60%	4	1.22%
杖	3219		7	4	0.0006041%	659466	99.60%	4	1.22%
杞	3220		7	4	0.0006041%	659470	99.60%	3	0.92%
枉	3221		8	4	0.0006041%	659474	99.60%	3	0.92%
柿	3222		9	4	0.0006041%	659478	99.60%	3	0.92%
枸	3223		9	4	0.0006041%	659482	99.60%	3	0.92%
桓	3224		10	4	0.0006041%	659486	99.60%	3	0.92%
栩	3225		10	4	0.0006041%	659490	99.60%	2	0.61%
梓	3226		11	4	0.0006041%	659494	99.60%	3	0.92%
桿	3227		11	4	0.0006041%	659498	99.60%	4	1.22%
楓	3228		13	4	0.0006041%	659502	99.60%	3	0.92%
氰	3229		12	4	0.0006041%	659506	99.60%	2	0.61%
汪	3230		7	4	0.0006041%	659510	99.60%	4	1.22%
洒	3231		9	4	0.0006041%	659514	99.60%	3	0.92%
淤	3232		11	4	0.0006041%	659518	99.60%	2	0.61%
淑	3233		11	4	0.0006041%	659522	99.61%	3	0.92%
淮	3234		11	4	0.0006041%	659526	99.61%	3	0.92%
淩	3235		11	4	0.0006041%	659530	99.61%	2	0.61%
渲	3236		12	4	0.0006041%	659534	99.61%	3	0.92%
湮	3237		12	4	0.0006041%	659538	99.61%	4	1.22%
渺	3238		12	4	0.0006041%	659542	99.61%	4	1.22%
滄	3239		13	4	0.0006041%	659546	99.61%	4	1.22%
潺	3240		15	4	0.0006041%	659550	99.61%	1	0.31%
澀	3241		17	4	0.0006041%	659554	99.61%	4	1.22%
炬	3242		9	4	0.0006041%	659558	99.61%	4	1.22%
煦	3243		13	4	0.0006041%	659562	99.61%	4	1.22%
熠	3244		15	4	0.0006041%	659566	99.61%	2	0.61%
熾	3245		16	4	0.0006041%	659570	99.61%	4	1.22%
猙	3246		11	4	0.0006041%	659574	99.61%	3	0.92%
獰	3247		17	4	0.0006041%	659578	99.61%	3	0.92%
璀	3248		15	4	0.0006041%	659582	99.61%	3	0.92%
璞	3249		16	4	0.0006041%	659586	99.62%	2	0.61%
瓏	3250		20	4	0.0006041%	659590	99.62%	3	0.92%
畦	3251		11	4	0.0006041%	659594	99.62%	3	0.92%
痙	3252		12	4	0.0006041%	659598	99.62%	3	0.92%
瘧	3253		14	4	0.0006041%	659602	99.62%	3	0.92%
皿	3254		5	4	0.0006041%	659606	99.62%	4	1.22%
盹	3255		9	4	0.0006041%	659610	99.62%	2	0.61%
眷	3256		11	4	0.0006041%	659614	99.62%	3	0.92%
睹	3257		13	4	0.0006041%	659618	99.62%	4	1.22%
矣	3258		7	4	0.0006041%	659622	99.62%	4	1.22%
矸	3259		8	4	0.0006041%	659626	99.62%	1	0.31%
磕	3260		15	4	0.0006041%	659630	99.62%	4	1.22%
禺	3261		9	4	0.0006041%	659634	99.62%	1	0.31%
禽	3262		13	4	0.0006041%	659638	99.62%	4	1.22%
禿	3263		7	4	0.0006041%	659642	99.62%	3	0.92%
秫	3264		10	4	0.0006041%	659646	99.62%	3	0.92%
秭	3265		10	4	0.0006041%	659650	99.62%	1	0.31%
稈	3266		12	4	0.0006041%	659654	99.63%	3	0.92%
稗	3267		13	4	0.0006041%	659658	99.63%	3	0.92%
穎	3268		16	4	0.0006041%	659662	99.63%	4	1.22%
笆	3269		10	4	0.0006041%	659666	99.63%	2	0.61%
箋	3270		14	4	0.0006041%	659670	99.63%	2	0.61%
篤	3271		16	4	0.0006041%	659674	99.63%	2	0.61%
簍	3272		17	4	0.0006041%	659678	99.63%	2	0.61%
簧	3273		18	4	0.0006041%	659682	99.63%	3	0.92%
粑	3274		10	4	0.0006041%	659686	99.63%	2	0.61%
綻	3275		14	4	0.0006041%	659690	99.63%	4	1.22%
綺	3276		14	4	0.0006041%	659694	99.63%	4	1.22%
緲	3277		15	4	0.0006041%	659698	99.63%	4	1.22%
縹	3278		17	4	0.0006041%	659702	99.63%	4	1.22%
纂	3279		20	4	0.0006041%	659706	99.63%	2	0.61%
翊	3280		11	4	0.0006041%	659710	99.63%	3	0.92%
耍	3281		9	4	0.0006041%	659714	99.63%	4	1.22%
胭	3282		10	4	0.0006041%	659718	99.64%	2	0.61%
腺	3283		13	4	0.0006041%	659722	99.64%	4	1.22%
臆	3284		17	4	0.0006041%	659726	99.64%	4	1.22%
芊	3285		7	4	0.0006041%	659730	99.64%	2	0.61%
芙	3286		8	4	0.0006041%	659734	99.64%	2	0.61%
芷	3287		8	4	0.0006041%	659738	99.64%	2	0.61%
芮	3288		8	4	0.0006041%	659742	99.64%	1	0.31%
苟	3289		9	4	0.0006041%	659746	99.64%	3	0.92%
苡	3290		9	4	0.0006041%	659750	99.64%	1	0.31%
菊	3291		12	4	0.0006041%	659754	99.64%	3	0.92%
萎	3292		12	4	0.0006041%	659758	99.64%	2	0.61%
葺	3293		13	4	0.0006041%	659762	99.64%	3	0.92%
蔗	3294		15	4	0.0006041%	659766	99.64%	3	0.92%
蔔	3295		15	4	0.0006041%	659770	99.64%	2	0.61%
薜	3296		17	4	0.0006041%	659774	99.64%	2	0.61%
薦	3297		18	4	0.0006041%	659778	99.64%	4	1.22%
藻	3298		20	4	0.0006041%	659782	99.64%	4	1.22%
蟀	3299		17	4	0.0006041%	659786	99.65%	2	0.61%
蟋	3300		17	4	0.0006041%	659790	99.65%	2	0.61%
衍	3301		9	4	0.0006041%	659794	99.65%	3	0.92%
訝	3302		11	4	0.0006041%	659798	99.65%	3	0.92%
誹	3303		15	4	0.0006041%	659802	99.65%	4	1.22%
謁	3304		16	4	0.0006041%	659806	99.65%	1	0.31%
謗	3305		17	4	0.0006041%	659810	99.65%	4	1.22%
賒	3306		14	4	0.0006041%	659814	99.65%	3	0.92%
踢	3307		15	4	0.0006041%	659818	99.65%	3	0.92%
蹤	3308		18	4	0.0006041%	659822	99.65%	3	0.92%
蹬	3309		19	4	0.0006041%	659826	99.65%	4	1.22%
迄	3310		6	4	0.0006041%	659830	99.65%	4	1.22%
迦	3311		8	4	0.0006041%	659834	99.65%	1	0.31%
迭	3312		8	4	0.0006041%	659838	99.65%	1	0.31%
遐	3313		12	4	0.0006041%	659842	99.65%	4	1.22%
邑	3314		7	4	0.0006041%	659846	99.65%	3	0.92%
醞	3315		17	4	0.0006041%	659850	99.66%	4	1.22%
鉀	3316		13	4	0.0006041%	659854	99.66%	2	0.61%
鋁	3317		15	4	0.0006041%	659858	99.66%	3	0.92%
錳	3318		16	4	0.0006041%	659862	99.66%	3	0.92%
錨	3319		17	4	0.0006041%	659866	99.66%	4	1.22%
鍬	3320		17	4	0.0006041%	659870	99.66%	2	0.61%
鎳	3321		18	4	0.0006041%	659874	99.66%	3	0.92%
鑰	3322		25	4	0.0006041%	659878	99.66%	3	0.92%
闌	3323		17	4	0.0006041%	659882	99.66%	4	1.22%
阜	3324		8	4	0.0006041%	659886	99.66%	2	0.61%
霏	3325		16	4	0.0006041%	659890	99.66%	2	0.61%
鞠	3326		17	4	0.0006041%	659894	99.66%	4	1.22%
頰	3327		16	4	0.0006041%	659898	99.66%	3	0.92%
頹	3328		16	4	0.0006041%	659902	99.66%	2	0.61%
颯	3329		14	4	0.0006041%	659906	99.66%	2	0.61%
颼	3330		18	4	0.0006041%	659910	99.66%	2	0.61%
馨	3331		20	4	0.0006041%	659914	99.66%	4	1.22%
馴	3332		13	4	0.0006041%	659918	99.67%	4	1.22%
髯	3333		15	4	0.0006041%	659922	99.67%	2	0.61%
鳩	3334		13	4	0.0006041%	659926	99.67%	2	0.61%
鴿	3335		17	4	0.0006041%	659930	99.67%	4	1.22%
麓	3336		19	4	0.0006041%	659934	99.67%	4	1.22%
麩	3337		15	4	0.0006041%	659938	99.67%	1	0.31%
龜	3338		16	4	0.0006041%	659942	99.67%	3	0.92%
亙	3339		6	3	0.0004531%	659945	99.67%	2	0.61%
伲	3340		7	3	0.0004531%	659948	99.67%	1	0.31%
佑	3341		7	3	0.0004531%	659951	99.67%	3	0.92%
佬	3342		8	3	0.0004531%	659954	99.67%	3	0.92%
侄	3343		8	3	0.0004531%	659957	99.67%	3	0.92%
倖	3344		10	3	0.0004531%	659960	99.67%	3	0.92%
倔	3345		10	3	0.0004531%	659963	99.67%	3	0.92%
倘	3346		10	3	0.0004531%	659966	99.67%	3	0.92%
偎	3347		11	3	0.0004531%	659969	99.67%	3	0.92%
倏	3348		11	3	0.0004531%	659972	99.67%	3	0.92%
傀	3349		12	3	0.0004531%	659975	99.67%	3	0.92%
儡	3350		17	3	0.0004531%	659978	99.67%	3	0.92%
冥	3351		10	3	0.0004531%	659981	99.67%	2	0.61%
冽	3352		8	3	0.0004531%	659984	99.68%	3	0.92%
凹	3353		5	3	0.0004531%	659987	99.68%	3	0.92%
凸	3354		5	3	0.0004531%	659990	99.68%	3	0.92%
剌	3355		9	3	0.0004531%	659993	99.68%	2	0.61%
匍	3356		9	3	0.0004531%	659996	99.68%	3	0.92%
匕	3357		2	3	0.0004531%	659999	99.68%	3	0.92%
叩	3358		5	3	0.0004531%	660002	99.68%	3	0.92%
咋	3359		8	3	0.0004531%	660005	99.68%	3	0.92%
咤	3360		9	3	0.0004531%	660008	99.68%	3	0.92%
咦	3361		9	3	0.0004531%	660011	99.68%	3	0.92%
咿	3362		9	3	0.0004531%	660014	99.68%	2	0.61%
唆	3363		10	3	0.0004531%	660017	99.68%	2	0.61%
哧	3364		10	3	0.0004531%	660020	99.68%	2	0.61%
啤	3365		11	3	0.0004531%	660023	99.68%	2	0.61%
唸	3366		11	3	0.0004531%	660026	99.68%	3	0.92%
唰	3367		11	3	0.0004531%	660029	99.68%	2	0.61%
嗽	3368		14	3	0.0004531%	660032	99.68%	1	0.31%
嘔	3369		14	3	0.0004531%	660035	99.68%	2	0.61%
噁	3370		15	3	0.0004531%	660038	99.68%	3	0.92%
嚕	3371		18	3	0.0004531%	660041	99.68%	3	0.92%
囡	3372		6	3	0.0004531%	660044	99.68%	1	0.31%
圩	3373		6	3	0.0004531%	660047	99.68%	2	0.61%
垛	3374		9	3	0.0004531%	660050	99.69%	1	0.31%
墟	3375		15	3	0.0004531%	660053	99.69%	3	0.92%
墮	3376		15	3	0.0004531%	660056	99.69%	3	0.92%
夤	3377		14	3	0.0004531%	660059	99.69%	1	0.31%
夭	3378		4	3	0.0004531%	660062	99.69%	3	0.92%
妊	3379		7	3	0.0004531%	660065	99.69%	2	0.61%
娑	3380		10	3	0.0004531%	660068	99.69%	3	0.92%
娟	3381		10	3	0.0004531%	660071	99.69%	1	0.31%
娠	3382		10	3	0.0004531%	660074	99.69%	2	0.61%
娥	3383		10	3	0.0004531%	660077	99.69%	3	0.92%
婉	3384		11	3	0.0004531%	660080	99.69%	3	0.92%
婪	3385		11	3	0.0004531%	660083	99.69%	3	0.92%
嫉	3386		13	3	0.0004531%	660086	99.69%	3	0.92%
宦	3387		9	3	0.0004531%	660089	99.69%	1	0.31%
宵	3388		10	3	0.0004531%	660092	99.69%	3	0.92%
寇	3389		11	3	0.0004531%	660095	99.69%	3	0.92%
峁	3390		8	3	0.0004531%	660098	99.69%	2	0.61%
岱	3391		8	3	0.0004531%	660101	99.69%	2	0.61%
嶙	3392		15	3	0.0004531%	660104	99.69%	2	0.61%
嶒	3393		15	3	0.0004531%	660107	99.69%	2	0.61%
巉	3394		20	3	0.0004531%	660110	99.69%	3	0.92%
帛	3395		8	3	0.0004531%	660113	99.69%	2	0.61%
幡	3396		15	3	0.0004531%	660116	99.70%	3	0.92%
庵	3397		11	3	0.0004531%	660119	99.70%	3	0.92%
廬	3398		19	3	0.0004531%	660122	99.70%	3	0.92%
弊	3399		14	3	0.0004531%	660125	99.70%	2	0.61%
怵	3400		8	3	0.0004531%	660128	99.70%	3	0.92%
恤	3401		9	3	0.0004531%	660131	99.70%	2	0.61%
愣	3402		12	3	0.0004531%	660134	99.70%	3	0.92%
惺	3403		12	3	0.0004531%	660137	99.70%	2	0.61%
慫	3404		15	3	0.0004531%	660140	99.70%	3	0.92%
憨	3405		16	3	0.0004531%	660143	99.70%	3	0.92%
懦	3406		17	3	0.0004531%	660146	99.70%	2	0.61%
戌	3407		6	3	0.0004531%	660149	99.70%	3	0.92%
扒	3408		5	3	0.0004531%	660152	99.70%	3	0.92%
捂	3409		10	3	0.0004531%	660155	99.70%	2	0.61%
捱	3410		11	3	0.0004531%	660158	99.70%	1	0.31%
捺	3411		11	3	0.0004531%	660161	99.70%	3	0.92%
揍	3412		12	3	0.0004531%	660164	99.70%	2	0.61%
搾	3413		13	3	0.0004531%	660167	99.70%	2	0.61%
撇	3414		14	3	0.0004531%	660170	99.70%	3	0.92%
撩	3415		15	3	0.0004531%	660173	99.70%	2	0.61%
撳	3416		15	3	0.0004531%	660176	99.70%	2	0.61%
擲	3417		18	3	0.0004531%	660179	99.70%	3	0.92%
攜	3418		21	3	0.0004531%	660182	99.71%	3	0.92%
攫	3419		23	3	0.0004531%	660185	99.71%	3	0.92%
斕	3420		21	3	0.0004531%	660188	99.71%	3	0.92%
昧	3421		9	3	0.0004531%	660191	99.71%	3	0.92%
札	3422		5	3	0.0004531%	660194	99.71%	2	0.61%
杷	3423		8	3	0.0004531%	660197	99.71%	3	0.92%
枇	3424		8	3	0.0004531%	660200	99.71%	3	0.92%
柵	3425		9	3	0.0004531%	660203	99.71%	3	0.92%
柩	3426		9	3	0.0004531%	660206	99.71%	2	0.61%
栗	3427		10	3	0.0004531%	660209	99.71%	3	0.92%
栲	3428		10	3	0.0004531%	660212	99.71%	1	0.31%
栳	3429		10	3	0.0004531%	660215	99.71%	1	0.31%
棲	3430		12	3	0.0004531%	660218	99.71%	3	0.92%
椥	3431		12	3	0.0004531%	660221	99.71%	1	0.31%
楷	3432		13	3	0.0004531%	660224	99.71%	2	0.61%
榕	3433		14	3	0.0004531%	660227	99.71%	3	0.92%
榛	3434		14	3	0.0004531%	660230	99.71%	3	0.92%
槐	3435		14	3	0.0004531%	660233	99.71%	2	0.61%
樺	3436		16	3	0.0004531%	660236	99.71%	3	0.92%
檳	3437		18	3	0.0004531%	660239	99.71%	1	0.31%
檯	3438		18	3	0.0004531%	660242	99.71%	1	0.31%
櫟	3439		19	3	0.0004531%	660245	99.71%	3	0.92%
殆	3440		9	3	0.0004531%	660248	99.72%	3	0.92%
氟	3441		9	3	0.0004531%	660251	99.72%	2	0.61%
沂	3442		7	3	0.0004531%	660254	99.72%	1	0.31%
泣	3443		8	3	0.0004531%	660257	99.72%	3	0.92%
泌	3444		8	3	0.0004531%	660260	99.72%	2	0.61%
沬	3445		8	3	0.0004531%	660263	99.72%	3	0.92%
洄	3446		9	3	0.0004531%	660266	99.72%	2	0.61%
涅	3447		10	3	0.0004531%	660269	99.72%	3	0.92%
涂	3448		10	3	0.0004531%	660272	99.72%	2	0.61%
淳	3449		11	3	0.0004531%	660275	99.72%	3	0.92%
淌	3450		11	3	0.0004531%	660278	99.72%	2	0.61%
淅	3451		11	3	0.0004531%	660281	99.72%	2	0.61%
淫	3452		11	3	0.0004531%	660284	99.72%	3	0.92%
湍	3453		12	3	0.0004531%	660287	99.72%	3	0.92%
湫	3454		12	3	0.0004531%	660290	99.72%	1	0.31%
滓	3455		13	3	0.0004531%	660293	99.72%	3	0.92%
滂	3456		13	3	0.0004531%	660296	99.72%	3	0.92%
滇	3457		13	3	0.0004531%	660299	99.72%	3	0.92%
漪	3458		14	3	0.0004531%	660302	99.72%	2	0.61%
澱	3459		16	3	0.0004531%	660305	99.72%	3	0.92%
濯	3460		17	3	0.0004531%	660308	99.72%	2	0.61%
濰	3461		17	3	0.0004531%	660311	99.72%	1	0.31%
瀏	3462		18	3	0.0004531%	660314	99.73%	3	0.92%
瀟	3463		19	3	0.0004531%	660317	99.73%	2	0.61%
瀲	3464		20	3	0.0004531%	660320	99.73%	3	0.92%
烙	3465		10	3	0.0004531%	660323	99.73%	3	0.92%
燻	3466		18	3	0.0004531%	660326	99.73%	2	0.61%
犀	3467		12	3	0.0004531%	660329	99.73%	3	0.92%
狐	3468		8	3	0.0004531%	660332	99.73%	1	0.31%
狸	3469		10	3	0.0004531%	660335	99.73%	1	0.31%
獷	3470		18	3	0.0004531%	660338	99.73%	3	0.92%
珮	3471		10	3	0.0004531%	660341	99.73%	2	0.61%
珪	3472		10	3	0.0004531%	660344	99.73%	1	0.31%
瑤	3473		14	3	0.0004531%	660347	99.73%	2	0.61%
璨	3474		17	3	0.0004531%	660350	99.73%	2	0.61%
瓔	3475		21	3	0.0004531%	660353	99.73%	3	0.92%
瓚	3476		23	3	0.0004531%	660356	99.73%	1	0.31%
甦	3477		12	3	0.0004531%	660359	99.73%	3	0.92%
町	3478		7	3	0.0004531%	660362	99.73%	1	0.31%
痒	3479		11	3	0.0004531%	660365	99.73%	2	0.61%
痹	3480		13	3	0.0004531%	660368	99.73%	3	0.92%
瘍	3481		14	3	0.0004531%	660371	99.73%	2	0.61%
瘩	3482		15	3	0.0004531%	660374	99.73%	3	0.92%
瞅	3483		14	3	0.0004531%	660377	99.73%	2	0.61%
瞥	3484		16	3	0.0004531%	660380	99.74%	2	0.61%
瞰	3485		17	3	0.0004531%	660383	99.74%	3	0.92%
矢	3486		5	3	0.0004531%	660386	99.74%	3	0.92%
砰	3487		10	3	0.0004531%	660389	99.74%	2	0.61%
碉	3488		13	3	0.0004531%	660392	99.74%	2	0.61%
礫	3489		20	3	0.0004531%	660395	99.74%	3	0.92%
祁	3490		7	3	0.0004531%	660398	99.74%	1	0.31%
祐	3491		9	3	0.0004531%	660401	99.74%	1	0.31%
禹	3492		9	3	0.0004531%	660404	99.74%	3	0.92%
窠	3493		13	3	0.0004531%	660407	99.74%	2	0.61%
笤	3494		11	3	0.0004531%	660410	99.74%	2	0.61%
篆	3495		15	3	0.0004531%	660413	99.74%	3	0.92%
籟	3496		22	3	0.0004531%	660416	99.74%	2	0.61%
粱	3497		13	3	0.0004531%	660419	99.74%	2	0.61%
紉	3498		9	3	0.0004531%	660422	99.74%	2	0.61%
紜	3499		10	3	0.0004531%	660425	99.74%	3	0.92%
絹	3500		13	3	0.0004531%	660428	99.74%	3	0.92%
縈	3501		16	3	0.0004531%	660431	99.74%	3	0.92%
羡	3502		12	3	0.0004531%	660434	99.74%	3	0.92%
羹	3503		19	3	0.0004531%	660437	99.74%	3	0.92%
聆	3504		11	3	0.0004531%	660440	99.74%	3	0.92%
聘	3505		13	3	0.0004531%	660443	99.74%	3	0.92%
胛	3506		9	3	0.0004531%	660446	99.75%	2	0.61%
胺	3507		10	3	0.0004531%	660449	99.75%	3	0.92%
腈	3508		12	3	0.0004531%	660452	99.75%	1	0.31%
腕	3509		12	3	0.0004531%	660455	99.75%	3	0.92%
舂	3510		11	3	0.0004531%	660458	99.75%	1	0.31%
舔	3511		14	3	0.0004531%	660461	99.75%	2	0.61%
芋	3512		7	3	0.0004531%	660464	99.75%	2	0.61%
苛	3513		9	3	0.0004531%	660467	99.75%	3	0.92%
荀	3514		10	3	0.0004531%	660470	99.75%	2	0.61%
葵	3515		13	3	0.0004531%	660473	99.75%	3	0.92%
葫	3516		13	3	0.0004531%	660476	99.75%	3	0.92%
蓉	3517		14	3	0.0004531%	660479	99.75%	2	0.61%
蔫	3518		15	3	0.0004531%	660482	99.75%	2	0.61%
蕨	3519		16	3	0.0004531%	660485	99.75%	1	0.31%
蘢	3520		20	3	0.0004531%	660488	99.75%	2	0.61%
虱	3521		8	3	0.0004531%	660491	99.75%	1	0.31%
蛛	3522		12	3	0.0004531%	660494	99.75%	3	0.92%
蛾	3523		13	3	0.0004531%	660497	99.75%	2	0.61%
螢	3524		16	3	0.0004531%	660500	99.75%	3	0.92%
衙	3525		13	3	0.0004531%	660503	99.75%	3	0.92%
袒	3526		10	3	0.0004531%	660506	99.75%	2	0.61%
袓	3527		10	3	0.0004531%	660509	99.75%	2	0.61%
裴	3528		13	3	0.0004531%	660512	99.76%	2	0.61%
訢	3529		11	3	0.0004531%	660515	99.76%	3	0.92%
詐	3530		12	3	0.0004531%	660518	99.76%	3	0.92%
詰	3531		13	3	0.0004531%	660521	99.76%	2	0.61%
誅	3532		13	3	0.0004531%	660524	99.76%	3	0.92%
誨	3533		14	3	0.0004531%	660527	99.76%	3	0.92%
豋	3534		13	3	0.0004531%	660530	99.76%	1	0.31%
豺	3535		10	3	0.0004531%	660533	99.76%	3	0.92%
贍	3536		20	3	0.0004531%	660536	99.76%	2	0.61%
贛	3537		24	3	0.0004531%	660539	99.76%	2	0.61%
赭	3538		15	3	0.0004531%	660542	99.76%	3	0.92%
踝	3539		15	3	0.0004531%	660545	99.76%	3	0.92%
踴	3540		16	3	0.0004531%	660548	99.76%	2	0.61%
蹂	3541		16	3	0.0004531%	660551	99.76%	2	0.61%
踵	3542		16	3	0.0004531%	660554	99.76%	3	0.92%
蹚	3543		18	3	0.0004531%	660557	99.76%	3	0.92%
輒	3544		14	3	0.0004531%	660560	99.76%	2	0.61%
輾	3545		17	3	0.0004531%	660563	99.76%	3	0.92%
轍	3546		18	3	0.0004531%	660566	99.76%	2	0.61%
辜	3547		12	3	0.0004531%	660569	99.76%	3	0.92%
迂	3548		6	3	0.0004531%	660572	99.76%	1	0.31%
迥	3549		8	3	0.0004531%	660575	99.76%	3	0.92%
迸	3550		9	3	0.0004531%	660578	99.77%	1	0.31%
逍	3551		10	3	0.0004531%	660581	99.77%	3	0.92%
逾	3552		12	3	0.0004531%	660584	99.77%	3	0.92%
邛	3553		5	3	0.0004531%	660587	99.77%	1	0.31%
郡	3554		9	3	0.0004531%	660590	99.77%	2	0.61%
鈣	3555		12	3	0.0004531%	660593	99.77%	3	0.92%
鉻	3556		14	3	0.0004531%	660596	99.77%	2	0.61%
鋅	3557		15	3	0.0004531%	660599	99.77%	2	0.61%
錐	3558		16	3	0.0004531%	660602	99.77%	3	0.92%
鍘	3559		17	3	0.0004531%	660605	99.77%	1	0.31%
鏜	3560		19	3	0.0004531%	660608	99.77%	1	0.31%
鏵	3561		20	3	0.0004531%	660611	99.77%	2	0.61%
閭	3562		15	3	0.0004531%	660614	99.77%	2	0.61%
陛	3563		9	3	0.0004531%	660617	99.77%	3	0.92%
隅	3564		11	3	0.0004531%	660620	99.77%	3	0.92%
雇	3565		12	3	0.0004531%	660623	99.77%	2	0.61%
雋	3566		13	3	0.0004531%	660626	99.77%	3	0.92%
雛	3567		18	3	0.0004531%	660629	99.77%	3	0.92%
雹	3568		13	3	0.0004531%	660632	99.77%	2	0.61%
霹	3569		21	3	0.0004531%	660635	99.77%	2	0.61%
靴	3570		13	3	0.0004531%	660638	99.77%	3	0.92%
颳	3571		15	3	0.0004531%	660641	99.77%	2	0.61%
飢	3572		10	3	0.0004531%	660644	99.77%	2	0.61%
餅	3573		14	3	0.0004531%	660647	99.78%	3	0.92%
鯉	3574		18	3	0.0004531%	660650	99.78%	3	0.92%
鯨	3575		19	3	0.0004531%	660653	99.78%	1	0.31%
鰭	3576		21	3	0.0004531%	660656	99.78%	1	0.31%
鴦	3577		16	3	0.0004531%	660659	99.78%	2	0.61%
鴛	3578		16	3	0.0004531%	660662	99.78%	2	0.61%
鵲	3579		19	3	0.0004531%	660665	99.78%	2	0.61%
麟	3580		23	3	0.0004531%	660668	99.78%	1	0.31%
黝	3581		17	3	0.0004531%	660671	99.78%	2	0.61%
乞	3582		3	2	0.0003021%	660673	99.78%	2	0.61%
亢	3583		4	2	0.0003021%	660675	99.78%	2	0.61%
亥	3584		6	2	0.0003021%	660677	99.78%	2	0.61%
仄	3585		4	2	0.0003021%	660679	99.78%	2	0.61%
佇	3586		7	2	0.0003021%	660681	99.78%	2	0.61%
佞	3587		7	2	0.0003021%	660683	99.78%	2	0.61%
佣	3588		7	2	0.0003021%	660685	99.78%	2	0.61%
侖	3589		8	2	0.0003021%	660687	99.78%	2	0.61%
俞	3590		9	2	0.0003021%	660689	99.78%	2	0.61%
倭	3591		10	2	0.0003021%	660691	99.78%	1	0.31%
僳	3592		14	2	0.0003021%	660693	99.78%	1	0.31%
冉	3593		5	2	0.0003021%	660695	99.78%	1	0.31%
冼	3594		8	2	0.0003021%	660697	99.78%	1	0.31%
凋	3595		10	2	0.0003021%	660699	99.78%	2	0.61%
几	3596		2	2	0.0003021%	660701	99.78%	2	0.61%
刃	3597		3	2	0.0003021%	660703	99.78%	2	0.61%
刪	3598		7	2	0.0003021%	660705	99.78%	2	0.61%
券	3599		8	2	0.0003021%	660707	99.78%	2	0.61%
劊	3600		15	2	0.0003021%	660709	99.78%	2	0.61%
劭	3601		7	2	0.0003021%	660711	99.79%	1	0.31%
勰	3602		15	2	0.0003021%	660713	99.79%	1	0.31%
匾	3603		11	2	0.0003021%	660715	99.79%	1	0.31%
占	3604		5	2	0.0003021%	660717	99.79%	2	0.61%
厩	3605		11	2	0.0003021%	660719	99.79%	1	0.31%
吋	3606		6	2	0.0003021%	660721	99.79%	2	0.61%
吠	3607		7	2	0.0003021%	660723	99.79%	2	0.61%
哇	3608		9	2	0.0003021%	660725	99.79%	2	0.61%
咯	3609		9	2	0.0003021%	660727	99.79%	1	0.31%
唷	3610		10	2	0.0003021%	660729	99.79%	1	0.31%
唏	3611		10	2	0.0003021%	660731	99.79%	1	0.31%
啄	3612		11	2	0.0003021%	660733	99.79%	2	0.61%
唬	3613		11	2	0.0003021%	660735	99.79%	2	0.61%
喔	3614		12	2	0.0003021%	660737	99.79%	2	0.61%
𠺝	3615		13	2	0.0003021%	660739	99.79%	1	0.31%
嘟	3616		13	2	0.0003021%	660741	99.79%	1	0.31%
嗐	3617		13	2	0.0003021%	660743	99.79%	1	0.31%
嗔	3618		13	2	0.0003021%	660745	99.79%	2	0.61%
嗒	3619		13	2	0.0003021%	660747	99.79%	1	0.31%
嘍	3620		14	2	0.0003021%	660749	99.79%	1	0.31%
嘎	3621		14	2	0.0003021%	660751	99.79%	2	0.61%
嘹	3622		15	2	0.0003021%	660753	99.79%	2	0.61%
噘	3623		15	2	0.0003021%	660755	99.79%	1	0.31%
噙	3624		16	2	0.0003021%	660757	99.79%	2	0.61%
噥	3625		16	2	0.0003021%	660759	99.79%	1	0.31%
噯	3626		16	2	0.0003021%	660761	99.79%	2	0.61%
噬	3627		16	2	0.0003021%	660763	99.79%	2	0.61%
噶	3628		16	2	0.0003021%	660765	99.79%	1	0.31%
噠	3629		16	2	0.0003021%	660767	99.79%	2	0.61%
嚎	3630		17	2	0.0003021%	660769	99.79%	2	0.61%
嚐	3631		17	2	0.0003021%	660771	99.79%	2	0.61%
坯	3632		8	2	0.0003021%	660773	99.79%	2	0.61%
坳	3633		8	2	0.0003021%	660775	99.79%	1	0.31%
垢	3634		9	2	0.0003021%	660777	99.80%	2	0.61%
埂	3635		10	2	0.0003021%	660779	99.80%	2	0.61%
埸	3636		11	2	0.0003021%	660781	99.80%	2	0.61%
埡	3637		11	2	0.0003021%	660783	99.80%	1	0.31%
塍	3638		13	2	0.0003021%	660785	99.80%	2	0.61%
塾	3639		14	2	0.0003021%	660787	99.80%	2	0.61%
墅	3640		14	2	0.0003021%	660789	99.80%	2	0.61%
壙	3641		18	2	0.0003021%	660791	99.80%	2	0.61%
壺	3642		12	2	0.0003021%	660793	99.80%	2	0.61%
夷	3643		6	2	0.0003021%	660795	99.80%	1	0.31%
奄	3644		8	2	0.0003021%	660797	99.80%	1	0.31%
妝	3645		7	2	0.0003021%	660799	99.80%	1	0.31%
妺	3646		8	2	0.0003021%	660801	99.80%	1	0.31%
姬	3647		10	2	0.0003021%	660803	99.80%	2	0.61%
娶	3648		11	2	0.0003021%	660805	99.80%	2	0.61%
媲	3649		13	2	0.0003021%	660807	99.80%	2	0.61%
嫻	3650		15	2	0.0003021%	660809	99.80%	1	0.31%
嫵	3651		15	2	0.0003021%	660811	99.80%	2	0.61%
嬴	3652		16	2	0.0003021%	660813	99.80%	1	0.31%
孑	3653		3	2	0.0003021%	660815	99.80%	1	0.31%
孜	3654		7	2	0.0003021%	660817	99.80%	1	0.31%
孚	3655		7	2	0.0003021%	660819	99.80%	2	0.61%
孺	3656		17	2	0.0003021%	660821	99.80%	1	0.31%
孽	3657		20	2	0.0003021%	660823	99.80%	1	0.31%
寐	3658		12	2	0.0003021%	660825	99.80%	2	0.61%
岷	3659		8	2	0.0003021%	660827	99.80%	1	0.31%
崚	3660		11	2	0.0003021%	660829	99.80%	2	0.61%
嵐	3661		12	2	0.0003021%	660831	99.80%	1	0.31%
帙	3662		8	2	0.0003021%	660833	99.80%	2	0.61%
幀	3663		12	2	0.0003021%	660835	99.80%	1	0.31%
幌	3664		13	2	0.0003021%	660837	99.80%	2	0.61%
幔	3665		14	2	0.0003021%	660839	99.80%	2	0.61%
庶	3666		11	2	0.0003021%	660841	99.80%	2	0.61%
弛	3667		6	2	0.0003021%	660843	99.81%	2	0.61%
弧	3668		8	2	0.0003021%	660845	99.81%	2	0.61%
彝	3669		18	2	0.0003021%	660847	99.81%	2	0.61%
彬	3670		11	2	0.0003021%	660849	99.81%	1	0.31%
徘	3671		11	2	0.0003021%	660851	99.81%	2	0.61%
忸	3672		7	2	0.0003021%	660853	99.81%	2	0.61%
忿	3673		8	2	0.0003021%	660855	99.81%	1	0.31%
怩	3674		8	2	0.0003021%	660857	99.81%	2	0.61%
怦	3675		8	2	0.0003021%	660859	99.81%	1	0.31%
怠	3676		9	2	0.0003021%	660861	99.81%	2	0.61%
恬	3677		9	2	0.0003021%	660863	99.81%	2	0.61%
恿	3678		11	2	0.0003021%	660865	99.81%	2	0.61%
悴	3679		11	2	0.0003021%	660867	99.81%	2	0.61%
悻	3680		11	2	0.0003021%	660869	99.81%	1	0.31%
悰	3681		11	2	0.0003021%	660871	99.81%	1	0.31%
惊	3682		11	2	0.0003021%	660873	99.81%	1	0.31%
惰	3683		12	2	0.0003021%	660875	99.81%	2	0.61%
惴	3684		12	2	0.0003021%	660877	99.81%	1	0.31%
慄	3685		13	2	0.0003021%	660879	99.81%	2	0.61%
憧	3686		15	2	0.0003021%	660881	99.81%	2	0.61%
憫	3687		15	2	0.0003021%	660883	99.81%	2	0.61%
憬	3688		15	2	0.0003021%	660885	99.81%	2	0.61%
憚	3689		15	2	0.0003021%	660887	99.81%	2	0.61%
懮	3690		18	2	0.0003021%	660889	99.81%	1	0.31%
懾	3691		21	2	0.0003021%	660891	99.81%	2	0.61%
戇	3692		28	2	0.0003021%	660893	99.81%	2	0.61%
戊	3693		5	2	0.0003021%	660895	99.81%	2	0.61%
戟	3694		12	2	0.0003021%	660897	99.81%	2	0.61%
扈	3695		11	2	0.0003021%	660899	99.81%	2	0.61%
扉	3696		12	2	0.0003021%	660901	99.81%	2	0.61%
拄	3697		8	2	0.0003021%	660903	99.81%	2	0.61%
拈	3698		8	2	0.0003021%	660905	99.81%	2	0.61%
拗	3699		8	2	0.0003021%	660907	99.81%	2	0.61%
捌	3700		10	2	0.0003021%	660909	99.81%	1	0.31%
捋	3701		10	2	0.0003021%	660911	99.82%	2	0.61%
掄	3702		11	2	0.0003021%	660913	99.82%	2	0.61%
据	3703		11	2	0.0003021%	660915	99.82%	2	0.61%
掮	3704		11	2	0.0003021%	660917	99.82%	1	0.31%
揣	3705		12	2	0.0003021%	660919	99.82%	2	0.61%
揖	3706		12	2	0.0003021%	660921	99.82%	2	0.61%
搔	3707		13	2	0.0003021%	660923	99.82%	1	0.31%
搐	3708		13	2	0.0003021%	660925	99.82%	1	0.31%
摺	3709		14	2	0.0003021%	660927	99.82%	1	0.31%
摭	3710		14	2	0.0003021%	660929	99.82%	1	0.31%
撂	3711		14	2	0.0003021%	660931	99.82%	2	0.61%
撘	3712		15	2	0.0003021%	660933	99.82%	2	0.61%
㩗	3713		16	2	0.0003021%	660935	99.82%	2	0.61%
撻	3714		16	2	0.0003021%	660937	99.82%	2	0.61%
擄	3715		16	2	0.0003021%	660939	99.82%	2	0.61%
擂	3716		16	2	0.0003021%	660941	99.82%	2	0.61%
擒	3717		16	2	0.0003021%	660943	99.82%	2	0.61%
攆	3718		18	2	0.0003021%	660945	99.82%	2	0.61%
斟	3719		13	2	0.0003021%	660947	99.82%	2	0.61%
晾	3720		12	2	0.0003021%	660949	99.82%	2	0.61%
晻	3721		12	2	0.0003021%	660951	99.82%	1	0.31%
暉	3722		13	2	0.0003021%	660953	99.82%	2	0.61%
暄	3723		13	2	0.0003021%	660955	99.82%	2	0.61%
暹	3724		16	2	0.0003021%	660957	99.82%	2	0.61%
曦	3725		20	2	0.0003021%	660959	99.82%	2	0.61%
朿	3726		6	2	0.0003021%	660961	99.82%	2	0.61%
桉	3727		10	2	0.0003021%	660963	99.82%	2	0.61%
楠	3728		13	2	0.0003021%	660965	99.82%	2	0.61%
楞	3729		13	2	0.0003021%	660967	99.82%	2	0.61%
楹	3730		13	2	0.0003021%	660969	99.82%	2	0.61%
榆	3731		13	2	0.0003021%	660971	99.82%	2	0.61%
椿	3732		13	2	0.0003021%	660973	99.82%	2	0.61%
楂	3733		13	2	0.0003021%	660975	99.82%	2	0.61%
槁	3734		14	2	0.0003021%	660977	99.83%	2	0.61%
榭	3735		14	2	0.0003021%	660979	99.83%	2	0.61%
榞	3736		14	2	0.0003021%	660981	99.83%	1	0.31%
樟	3737		15	2	0.0003021%	660983	99.83%	2	0.61%
橢	3738		16	2	0.0003021%	660985	99.83%	2	0.61%
檔	3739		17	2	0.0003021%	660987	99.83%	2	0.61%
檻	3740		18	2	0.0003021%	660989	99.83%	2	0.61%
櫥	3741		19	2	0.0003021%	660991	99.83%	2	0.61%
歹	3742		4	2	0.0003021%	660993	99.83%	2	0.61%
殃	3743		9	2	0.0003021%	660995	99.83%	2	0.61%
殉	3744		10	2	0.0003021%	660997	99.83%	1	0.31%
殮	3745		17	2	0.0003021%	660999	99.83%	2	0.61%
殯	3746		18	2	0.0003021%	661001	99.83%	1	0.31%
毆	3747		15	2	0.0003021%	661003	99.83%	2	0.61%
氦	3748		10	2	0.0003021%	661005	99.83%	2	0.61%
汝	3749		6	2	0.0003021%	661007	99.83%	1	0.31%
沐	3750		7	2	0.0003021%	661009	99.83%	2	0.61%
汨	3751		7	2	0.0003021%	661011	99.83%	1	0.31%
汾	3752		7	2	0.0003021%	661013	99.83%	2	0.61%
汴	3753		7	2	0.0003021%	661015	99.83%	1	0.31%
汩	3754		7	2	0.0003021%	661017	99.83%	1	0.31%
泓	3755		8	2	0.0003021%	661019	99.83%	2	0.61%
沓	3756		8	2	0.0003021%	661021	99.83%	1	0.31%
涕	3757		10	2	0.0003021%	661023	99.83%	2	0.61%
涇	3758		10	2	0.0003021%	661025	99.83%	2	0.61%
涓	3759		10	2	0.0003021%	661027	99.83%	1	0.31%
浚	3760		10	2	0.0003021%	661029	99.83%	2	0.61%
湘	3761		12	2	0.0003021%	661031	99.83%	2	0.61%
渭	3762		12	2	0.0003021%	661033	99.83%	2	0.61%
渝	3763		12	2	0.0003021%	661035	99.83%	2	0.61%
渙	3764		12	2	0.0003021%	661037	99.83%	2	0.61%
漬	3765		14	2	0.0003021%	661039	99.83%	2	0.61%
漉	3766		14	2	0.0003021%	661041	99.83%	1	0.31%
滕	3767		15	2	0.0003021%	661043	99.84%	2	0.61%
潾	3768		15	2	0.0003021%	661045	99.84%	1	0.31%
濾	3769		18	2	0.0003021%	661047	99.84%	2	0.61%
瀆	3770		18	2	0.0003021%	661049	99.84%	2	0.61%
瀨	3771		19	2	0.0003021%	661051	99.84%	1	0.31%
瀚	3772		19	2	0.0003021%	661053	99.84%	2	0.61%
炫	3773		9	2	0.0003021%	661055	99.84%	2	0.61%
焊	3774		11	2	0.0003021%	661057	99.84%	2	0.61%
烴	3775		11	2	0.0003021%	661059	99.84%	2	0.61%
熨	3776		15	2	0.0003021%	661061	99.84%	1	0.31%
燉	3777		16	2	0.0003021%	661063	99.84%	2	0.61%
熹	3778		16	2	0.0003021%	661065	99.84%	2	0.61%
燼	3779		18	2	0.0003021%	661067	99.84%	2	0.61%
爵	3780		17	2	0.0003021%	661069	99.84%	2	0.61%
爿	3781		4	2	0.0003021%	661071	99.84%	1	0.31%
猥	3782		12	2	0.0003021%	661073	99.84%	1	0.31%
珊	3783		9	2	0.0003021%	661075	99.84%	2	0.61%
玲	3784		9	2	0.0003021%	661077	99.84%	2	0.61%
琉	3785		10	2	0.0003021%	661079	99.84%	2	0.61%
珞	3786		10	2	0.0003021%	661081	99.84%	2	0.61%
珙	3787		10	2	0.0003021%	661083	99.84%	1	0.31%
琳	3788		12	2	0.0003021%	661085	99.84%	2	0.61%
琤	3789		12	2	0.0003021%	661087	99.84%	1	0.31%
瑚	3790		13	2	0.0003021%	661089	99.84%	2	0.61%
瑟	3791		13	2	0.0003021%	661091	99.84%	2	0.61%
畸	3792		13	2	0.0003021%	661093	99.84%	2	0.61%
疚	3793		8	2	0.0003021%	661095	99.84%	2	0.61%
疽	3794		10	2	0.0003021%	661097	99.84%	1	0.31%
痢	3795		12	2	0.0003021%	661099	99.84%	2	0.61%
瘁	3796		13	2	0.0003021%	661101	99.84%	2	0.61%
痺	3797		13	2	0.0003021%	661103	99.84%	2	0.61%
瘠	3798		15	2	0.0003021%	661105	99.84%	2	0.61%
瘤	3799		15	2	0.0003021%	661107	99.84%	1	0.31%
瘸	3800		16	2	0.0003021%	661109	99.85%	2	0.61%
癖	3801		18	2	0.0003021%	661111	99.85%	1	0.31%
癮	3802		22	2	0.0003021%	661113	99.85%	2	0.61%
皎	3803		11	2	0.0003021%	661115	99.85%	2	0.61%
皖	3804		12	2	0.0003021%	661117	99.85%	2	0.61%
盎	3805		10	2	0.0003021%	661119	99.85%	2	0.61%
盱	3806		8	2	0.0003021%	661121	99.85%	1	0.31%
眈	3807		9	2	0.0003021%	661123	99.85%	1	0.31%
眩	3808		10	2	0.0003021%	661125	99.85%	2	0.61%
睫	3809		13	2	0.0003021%	661127	99.85%	2	0.61%
睦	3810		13	2	0.0003021%	661129	99.85%	2	0.61%
睿	3811		14	2	0.0003021%	661131	99.85%	2	0.61%
瞌	3812		15	2	0.0003021%	661133	99.85%	2	0.61%
瞟	3813		16	2	0.0003021%	661135	99.85%	2	0.61%
矬	3814		12	2	0.0003021%	661137	99.85%	1	0.31%
矽	3815		8	2	0.0003021%	661139	99.85%	2	0.61%
砵	3816		10	2	0.0003021%	661141	99.85%	1	0.31%
硯	3817		12	2	0.0003021%	661143	99.85%	1	0.31%
碇	3818		13	2	0.0003021%	661145	99.85%	1	0.31%
磯	3819		17	2	0.0003021%	661147	99.85%	2	0.61%
祟	3820		10	2	0.0003021%	661149	99.85%	1	0.31%
祿	3821		12	2	0.0003021%	661151	99.85%	2	0.61%
禦	3822		16	2	0.0003021%	661153	99.85%	2	0.61%
秉	3823		8	2	0.0003021%	661155	99.85%	2	0.61%
稞	3824		13	2	0.0003021%	661157	99.85%	2	0.61%
稽	3825		15	2	0.0003021%	661159	99.85%	2	0.61%
穡	3826		18	2	0.0003021%	661161	99.85%	1	0.31%
窒	3827		11	2	0.0003021%	661163	99.85%	2	0.61%
窸	3828		16	2	0.0003021%	661165	99.85%	1	0.31%
竅	3829		18	2	0.0003021%	661167	99.85%	2	0.61%
笠	3830		11	2	0.0003021%	661169	99.85%	2	0.61%
筏	3831		12	2	0.0003021%	661171	99.85%	2	0.61%
箏	3832		14	2	0.0003021%	661173	99.85%	2	0.61%
箍	3833		14	2	0.0003021%	661175	99.86%	2	0.61%
篾	3834		17	2	0.0003021%	661177	99.86%	2	0.61%
簌	3835		17	2	0.0003021%	661179	99.86%	1	0.31%
糕	3836		16	2	0.0003021%	661181	99.86%	2	0.61%
糙	3837		17	2	0.0003021%	661183	99.86%	1	0.31%
絆	3838		11	2	0.0003021%	661185	99.86%	2	0.61%
紵	3839		11	2	0.0003021%	661187	99.86%	1	0.31%
綸	3840		14	2	0.0003021%	661189	99.86%	2	0.61%
綷	3841		14	2	0.0003021%	661191	99.86%	2	0.61%
緞	3842		15	2	0.0003021%	661193	99.86%	2	0.61%
纍	3843		21	2	0.0003021%	661195	99.86%	1	0.31%
罈	3844		18	2	0.0003021%	661197	99.86%	1	0.31%
羔	3845		10	2	0.0003021%	661199	99.86%	2	0.61%
羨	3846		13	2	0.0003021%	661201	99.86%	2	0.61%
羲	3847		16	2	0.0003021%	661203	99.86%	2	0.61%
翱	3848		16	2	0.0003021%	661205	99.86%	2	0.61%
翳	3849		17	2	0.0003021%	661207	99.86%	1	0.31%
耙	3850		10	2	0.0003021%	661209	99.86%	2	0.61%
肇	3851		14	2	0.0003021%	661211	99.86%	2	0.61%
肪	3852		8	2	0.0003021%	661213	99.86%	2	0.61%
脛	3853		11	2	0.0003021%	661215	99.86%	2	0.61%
腑	3854		12	2	0.0003021%	661217	99.86%	2	0.61%
腎	3855		12	2	0.0003021%	661219	99.86%	2	0.61%
腌	3856		12	2	0.0003021%	661221	99.86%	2	0.61%
腮	3857		13	2	0.0003021%	661223	99.86%	2	0.61%
腫	3858		13	2	0.0003021%	661225	99.86%	2	0.61%
膳	3859		16	2	0.0003021%	661227	99.86%	2	0.61%
膿	3860		17	2	0.0003021%	661229	99.86%	2	0.61%
臼	3861		6	2	0.0003021%	661231	99.86%	2	0.61%
舖	3862		15	2	0.0003021%	661233	99.86%	2	0.61%
舢	3863		9	2	0.0003021%	661235	99.86%	2	0.61%
苖	3864		9	2	0.0003021%	661237	99.86%	2	0.61%
茵	3865		10	2	0.0003021%	661239	99.86%	2	0.61%
茱	3866		10	2	0.0003021%	661241	99.87%	1	0.31%
茭	3867		10	2	0.0003021%	661243	99.87%	2	0.61%
莎	3868		11	2	0.0003021%	661245	99.87%	2	0.61%
莢	3869		11	2	0.0003021%	661247	99.87%	1	0.31%
莠	3870		11	2	0.0003021%	661249	99.87%	2	0.61%
荼	3871		11	2	0.0003021%	661251	99.87%	2	0.61%
萃	3872		12	2	0.0003021%	661253	99.87%	2	0.61%
菽	3873		12	2	0.0003021%	661255	99.87%	2	0.61%
葛	3874		13	2	0.0003021%	661257	99.87%	2	0.61%
蒿	3875		14	2	0.0003021%	661259	99.87%	2	0.61%
蓓	3876		14	2	0.0003021%	661261	99.87%	1	0.31%
蕪	3877		16	2	0.0003021%	661263	99.87%	2	0.61%
薇	3878		17	2	0.0003021%	661265	99.87%	2	0.61%
薅	3879		17	2	0.0003021%	661267	99.87%	1	0.31%
虞	3880		13	2	0.0003021%	661269	99.87%	2	0.61%
虬	3881		7	2	0.0003021%	661271	99.87%	1	0.31%
蚰	3882		11	2	0.0003021%	661273	99.87%	1	0.31%
蛔	3883		12	2	0.0003021%	661275	99.87%	1	0.31%
蛐	3884		12	2	0.0003021%	661277	99.87%	1	0.31%
蛞	3885		12	2	0.0003021%	661279	99.87%	1	0.31%
蜓	3886		13	2	0.0003021%	661281	99.87%	2	0.61%
蛻	3887		13	2	0.0003021%	661283	99.87%	2	0.61%
蜘	3888		14	2	0.0003021%	661285	99.87%	2	0.61%
蜡	3889		14	2	0.0003021%	661287	99.87%	1	0.31%
蝸	3890		15	2	0.0003021%	661289	99.87%	2	0.61%
蝓	3891		15	2	0.0003021%	661291	99.87%	1	0.31%
蟈	3892		17	2	0.0003021%	661293	99.87%	1	0.31%
蟄	3893		17	2	0.0003021%	661295	99.87%	1	0.31%
蟹	3894		19	2	0.0003021%	661297	99.87%	2	0.61%
蠢	3895		21	2	0.0003021%	661299	99.87%	2	0.61%
袈	3896		11	2	0.0003021%	661301	99.87%	2	0.61%
裟	3897		13	2	0.0003021%	661303	99.87%	2	0.61%
褚	3898		13	2	0.0003021%	661305	99.87%	2	0.61%
裱	3899		13	2	0.0003021%	661307	99.88%	1	0.31%
褒	3900		15	2	0.0003021%	661309	99.88%	2	0.61%
褶	3901		16	2	0.0003021%	661311	99.88%	2	0.61%
褻	3902		17	2	0.0003021%	661313	99.88%	2	0.61%
覓	3903		11	2	0.0003021%	661315	99.88%	2	0.61%
覷	3904		19	2	0.0003021%	661317	99.88%	2	0.61%
訇	3905		9	2	0.0003021%	661319	99.88%	1	0.31%
訕	3906		10	2	0.0003021%	661321	99.88%	2	0.61%
訣	3907		11	2	0.0003021%	661323	99.88%	1	0.31%
訥	3908		11	2	0.0003021%	661325	99.88%	1	0.31%
訛	3909		11	2	0.0003021%	661327	99.88%	2	0.61%
詁	3910		12	2	0.0003021%	661329	99.88%	1	0.31%
詛	3911		12	2	0.0003021%	661331	99.88%	2	0.61%
詣	3912		13	2	0.0003021%	661333	99.88%	2	0.61%
誡	3913		14	2	0.0003021%	661335	99.88%	2	0.61%
諏	3914		15	2	0.0003021%	661337	99.88%	1	0.31%
諤	3915		16	2	0.0003021%	661339	99.88%	1	0.31%
謊	3916		17	2	0.0003021%	661341	99.88%	2	0.61%
謐	3917		17	2	0.0003021%	661343	99.88%	1	0.31%
譏	3918		19	2	0.0003021%	661345	99.88%	2	0.61%
豌	3919		15	2	0.0003021%	661347	99.88%	2	0.61%
豚	3920		11	2	0.0003021%	661349	99.88%	2	0.61%
贅	3921		18	2	0.0003021%	661351	99.88%	2	0.61%
趐	3922		13	2	0.0003021%	661353	99.88%	1	0.31%
跏	3923		12	2	0.0003021%	661355	99.88%	1	0.31%
跤	3924		13	2	0.0003021%	661357	99.88%	2	0.61%
踉	3925		14	2	0.0003021%	661359	99.88%	1	0.31%
踄	3926		14	2	0.0003021%	661361	99.88%	2	0.61%
踟	3927		15	2	0.0003021%	661363	99.88%	1	0.31%
踮	3928		15	2	0.0003021%	661365	99.88%	2	0.61%
踱	3929		16	2	0.0003021%	661367	99.88%	2	0.61%
蹋	3930		17	2	0.0003021%	661369	99.88%	2	0.61%
蹌	3931		17	2	0.0003021%	661371	99.88%	1	0.31%
躂	3932		20	2	0.0003021%	661373	99.89%	1	0.31%
躕	3933		22	2	0.0003021%	661375	99.89%	1	0.31%
躡	3934		25	2	0.0003021%	661377	99.89%	1	0.31%
躪	3935		27	2	0.0003021%	661379	99.89%	2	0.61%
軒	3936		10	2	0.0003021%	661381	99.89%	2	0.61%
轆	3937		18	2	0.0003021%	661383	99.89%	1	0.31%
迢	3938		8	2	0.0003021%	661385	99.89%	1	0.31%
遁	3939		12	2	0.0003021%	661387	99.89%	2	0.61%
遨	3940		14	2	0.0003021%	661389	99.89%	2	0.61%
遽	3941		16	2	0.0003021%	661391	99.89%	2	0.61%
邠	3942		6	2	0.0003021%	661393	99.89%	1	0.31%
郝	3943		9	2	0.0003021%	661395	99.89%	2	0.61%
鄂	3944		11	2	0.0003021%	661397	99.89%	1	0.31%
酥	3945		12	2	0.0003021%	661399	99.89%	1	0.31%
酮	3946		13	2	0.0003021%	661401	99.89%	1	0.31%
鈷	3947		13	2	0.0003021%	661403	99.89%	2	0.61%
銜	3948		14	2	0.0003021%	661405	99.89%	2	0.61%
銹	3949		15	2	0.0003021%	661407	99.89%	2	0.61%
鍚	3950		17	2	0.0003021%	661409	99.89%	1	0.31%
鐸	3951		21	2	0.0003021%	661411	99.89%	2	0.61%
閶	3952		16	2	0.0003021%	661413	99.89%	1	0.31%
阡	3953		5	2	0.0003021%	661415	99.89%	2	0.61%
陂	3954		7	2	0.0003021%	661417	99.89%	2	0.61%
陲	3955		11	2	0.0003021%	661419	99.89%	2	0.61%
隕	3956		12	2	0.0003021%	661421	99.89%	1	0.31%
霾	3957		22	2	0.0003021%	661423	99.89%	2	0.61%
靂	3958		24	2	0.0003021%	661425	99.89%	1	0.31%
顗	3959		19	2	0.0003021%	661427	99.89%	2	0.61%
顥	3960		21	2	0.0003021%	661429	99.89%	1	0.31%
餾	3961		18	2	0.0003021%	661431	99.89%	1	0.31%
馥	3962		18	2	0.0003021%	661433	99.89%	2	0.61%
馭	3963		12	2	0.0003021%	661435	99.89%	2	0.61%
騁	3964		17	2	0.0003021%	661437	99.89%	2	0.61%
骯	3965		14	2	0.0003021%	661439	99.90%	2	0.61%
髦	3966		14	2	0.0003021%	661441	99.90%	2	0.61%
髻	3967		16	2	0.0003021%	661443	99.90%	2	0.61%
髭	3968		16	2	0.0003021%	661445	99.90%	1	0.31%
髹	3969		16	2	0.0003021%	661447	99.90%	2	0.61%
鬮	3970		26	2	0.0003021%	661449	99.90%	1	0.31%
鮭	3971		17	2	0.0003021%	661451	99.90%	1	0.31%
鯊	3972		18	2	0.0003021%	661453	99.90%	2	0.61%
鰵	3973		22	2	0.0003021%	661455	99.90%	1	0.31%
鰱	3974		22	2	0.0003021%	661457	99.90%	1	0.31%
鳧	3975		13	2	0.0003021%	661459	99.90%	1	0.31%
鷺	3976		24	2	0.0003021%	661461	99.90%	2	0.61%
鸚	3977		28	2	0.0003021%	661463	99.90%	2	0.61%
麝	3978		21	2	0.0003021%	661465	99.90%	2	0.61%
黍	3979		12	2	0.0003021%	661467	99.90%	1	0.31%
黛	3980		17	2	0.0003021%	661469	99.90%	2	0.61%
鼕	3981		18	2	0.0003021%	661471	99.90%	1	0.31%
齋	3982		17	2	0.0003021%	661473	99.90%	2	0.61%
齣	3983		20	2	0.0003021%	661475	99.90%	2	0.61%
龔	3984		22	2	0.0003021%	661477	99.90%	1	0.31%
丕	3985		5	1	0.000151%	661478	99.90%	1	0.31%
亘	3986		6	1	0.000151%	661479	99.90%	1	0.31%
丞	3987		6	1	0.000151%	661480	99.90%	1	0.31%
丰	3988		4	1	0.000151%	661481	99.90%	1	0.31%
亳	3989		10	1	0.000151%	661482	99.90%	1	0.31%
仕	3990		5	1	0.000151%	661483	99.90%	1	0.31%
仞	3991		5	1	0.000151%	661484	99.90%	1	0.31%
伕	3992		6	1	0.000151%	661485	99.90%	1	0.31%
伋	3993		6	1	0.000151%	661486	99.90%	1	0.31%
伢	3994		6	1	0.000151%	661487	99.90%	1	0.31%
伺	3995		7	1	0.000151%	661488	99.90%	1	0.31%
体	3996		7	1	0.000151%	661489	99.90%	1	0.31%
侃	3997		8	1	0.000151%	661490	99.90%	1	0.31%
俟	3998		9	1	0.000151%	661491	99.90%	1	0.31%
俸	3999		10	1	0.000151%	661492	99.90%	1	0.31%
倩	4000		10	1	0.000151%	661493	99.90%	1	0.31%
偃	4001		11	1	0.000151%	661494	99.90%	1	0.31%
偌	4002		11	1	0.000151%	661495	99.90%	1	0.31%
偈	4003		11	1	0.000151%	661496	99.90%	1	0.31%
倕	4004		11	1	0.000151%	661497	99.90%	1	0.31%
傋	4005		12	1	0.000151%	661498	99.90%	1	0.31%
傭	4006		13	1	0.000151%	661499	99.90%	1	0.31%
僇	4007		13	1	0.000151%	661500	99.90%	1	0.31%
僮	4008		14	1	0.000151%	661501	99.90%	1	0.31%
僥	4009		14	1	0.000151%	661502	99.90%	1	0.31%
僖	4010		14	1	0.000151%	661503	99.90%	1	0.31%
儆	4011		15	1	0.000151%	661504	99.90%	1	0.31%
儋	4012		15	1	0.000151%	661505	99.91%	1	0.31%
儔	4013		16	1	0.000151%	661506	99.91%	1	0.31%
兀	4014		3	1	0.000151%	661507	99.91%	1	0.31%
剡	4015		10	1	0.000151%	661508	99.91%	1	0.31%
劌	4016		15	1	0.000151%	661509	99.91%	1	0.31%
劫	4017		7	1	0.000151%	661510	99.91%	1	0.31%
匝	4018		5	1	0.000151%	661511	99.91%	1	0.31%
叡	4019		16	1	0.000151%	661512	99.91%	1	0.31%
吝	4020		7	1	0.000151%	661513	99.91%	1	0.31%
呷	4021		8	1	0.000151%	661514	99.91%	1	0.31%
咪	4022		9	1	0.000151%	661515	99.91%	1	0.31%
咫	4023		9	1	0.000151%	661516	99.91%	1	0.31%
哳	4024		10	1	0.000151%	661517	99.91%	1	0.31%
唄	4025		10	1	0.000151%	661518	99.91%	1	0.31%
啉	4026		11	1	0.000151%	661519	99.91%	1	0.31%
唹	4027		11	1	0.000151%	661520	99.91%	1	0.31%
喟	4028		12	1	0.000151%	661521	99.91%	1	0.31%
喑	4029		12	1	0.000151%	661522	99.91%	1	0.31%
啷	4030		12	1	0.000151%	661523	99.91%	1	0.31%
嗖	4031		12	1	0.000151%	661524	99.91%	1	0.31%
嗇	4032		13	1	0.000151%	661525	99.91%	1	0.31%
嗆	4033		13	1	0.000151%	661526	99.91%	1	0.31%
嘭	4034		15	1	0.000151%	661527	99.91%	1	0.31%
嘰	4035		15	1	0.000151%	661528	99.91%	1	0.31%
噼	4036		16	1	0.000151%	661529	99.91%	1	0.31%
噫	4037		16	1	0.000151%	661530	99.91%	1	0.31%
噩	4038		16	1	0.000151%	661531	99.91%	1	0.31%
噤	4039		16	1	0.000151%	661532	99.91%	1	0.31%
噪	4040		16	1	0.000151%	661533	99.91%	1	0.31%
嚏	4041		17	1	0.000151%	661534	99.91%	1	0.31%
嚫	4042		19	1	0.000151%	661535	99.91%	1	0.31%
囁	4043		21	1	0.000151%	661536	99.91%	1	0.31%
囈	4044		22	1	0.000151%	661537	99.91%	1	0.31%
囌	4045		23	1	0.000151%	661538	99.91%	1	0.31%
囚	4046		5	1	0.000151%	661539	99.91%	1	0.31%
囿	4047		9	1	0.000151%	661540	99.91%	1	0.31%
圳	4048		6	1	0.000151%	661541	99.91%	1	0.31%
圮	4049		6	1	0.000151%	661542	99.91%	1	0.31%
圻	4050		7	1	0.000151%	661543	99.91%	1	0.31%
坷	4051		8	1	0.000151%	661544	99.91%	1	0.31%
坤	4052		8	1	0.000151%	661545	99.91%	1	0.31%
垣	4053		9	1	0.000151%	661546	99.91%	1	0.31%
堊	4054		11	1	0.000151%	661547	99.91%	1	0.31%
堯	4055		12	1	0.000151%	661548	99.91%	1	0.31%
堷	4056		12	1	0.000151%	661549	99.91%	1	0.31%
埵	4057		12	1	0.000151%	661550	99.91%	1	0.31%
塈	4058		12	1	0.000151%	661551	99.91%	1	0.31%
壕	4059		17	1	0.000151%	661552	99.91%	1	0.31%
复	4060		9	1	0.000151%	661553	99.91%	1	0.31%
夔	4061		21	1	0.000151%	661554	99.91%	1	0.31%
奚	4062		10	1	0.000151%	661555	99.91%	1	0.31%
奭	4063		15	1	0.000151%	661556	99.91%	1	0.31%
妃	4064		6	1	0.000151%	661557	99.91%	1	0.31%
妣	4065		7	1	0.000151%	661558	99.91%	1	0.31%
妗	4066		7	1	0.000151%	661559	99.91%	1	0.31%
妮	4067		8	1	0.000151%	661560	99.91%	1	0.31%
姹	4068		9	1	0.000151%	661561	99.91%	1	0.31%
姣	4069		9	1	0.000151%	661562	99.91%	1	0.31%
娜	4070		10	1	0.000151%	661563	99.91%	1	0.31%
婀	4071		11	1	0.000151%	661564	99.91%	1	0.31%
娼	4072		11	1	0.000151%	661565	99.91%	1	0.31%
婢	4073		11	1	0.000151%	661566	99.91%	1	0.31%
婭	4074		11	1	0.000151%	661567	99.91%	1	0.31%
婿	4075		12	1	0.000151%	661568	99.91%	1	0.31%
嫣	4076		14	1	0.000151%	661569	99.91%	1	0.31%
孝	4077		7	1	0.000151%	661570	99.91%	1	0.31%
寰	4078		16	1	0.000151%	661571	99.91%	1	0.31%
寵	4079		19	1	0.000151%	661572	99.92%	1	0.31%
尉	4080		11	1	0.000151%	661573	99.92%	1	0.31%
尢	4081		3	1	0.000151%	661574	99.92%	1	0.31%
尬	4082		7	1	0.000151%	661575	99.92%	1	0.31%
尷	4083		17	1	0.000151%	661576	99.92%	1	0.31%
尸	4084		3	1	0.000151%	661577	99.92%	1	0.31%
屐	4085		10	1	0.000151%	661578	99.92%	1	0.31%
屭	4086		24	1	0.000151%	661579	99.92%	1	0.31%
岫	4087		8	1	0.000151%	661580	99.92%	1	0.31%
峒	4088		9	1	0.000151%	661581	99.92%	1	0.31%
峋	4089		9	1	0.000151%	661582	99.92%	1	0.31%
峇	4090		9	1	0.000151%	661583	99.92%	1	0.31%
崛	4091		11	1	0.000151%	661584	99.92%	1	0.31%
崢	4092		11	1	0.000151%	661585	99.92%	1	0.31%
崑	4093		11	1	0.000151%	661586	99.92%	1	0.31%
崙	4094		11	1	0.000151%	661587	99.92%	1	0.31%
崧	4095		11	1	0.000151%	661588	99.92%	1	0.31%
嵒	4096		12	1	0.000151%	661589	99.92%	1	0.31%
嵯	4097		13	1	0.000151%	661590	99.92%	1	0.31%
嵬	4098		13	1	0.000151%	661591	99.92%	1	0.31%
嶽	4099		17	1	0.000151%	661592	99.92%	1	0.31%
嶸	4100		17	1	0.000151%	661593	99.92%	1	0.31%
帘	4101		8	1	0.000151%	661594	99.92%	1	0.31%
帖	4102		8	1	0.000151%	661595	99.92%	1	0.31%
帷	4103		11	1	0.000151%	661596	99.92%	1	0.31%
廁	4104		12	1	0.000151%	661597	99.92%	1	0.31%
廄	4105		12	1	0.000151%	661598	99.92%	1	0.31%
廋	4106		12	1	0.000151%	661599	99.92%	1	0.31%
廡	4107		15	1	0.000151%	661600	99.92%	1	0.31%
弈	4108		9	1	0.000151%	661601	99.92%	1	0.31%
弩	4109		8	1	0.000151%	661602	99.92%	1	0.31%
彆	4110		14	1	0.000151%	661603	99.92%	1	0.31%
彊	4111		16	1	0.000151%	661604	99.92%	1	0.31%
彰	4112		14	1	0.000151%	661605	99.92%	1	0.31%
徨	4113		12	1	0.000151%	661606	99.92%	1	0.31%
忪	4114		7	1	0.000151%	661607	99.92%	1	0.31%
忒	4115		7	1	0.000151%	661608	99.92%	1	0.31%
忡	4116		7	1	0.000151%	661609	99.92%	1	0.31%
恃	4117		9	1	0.000151%	661610	99.92%	1	0.31%
悌	4118		10	1	0.000151%	661611	99.92%	1	0.31%
惘	4119		11	1	0.000151%	661612	99.92%	1	0.31%
惝	4120		11	1	0.000151%	661613	99.92%	1	0.31%
愴	4121		13	1	0.000151%	661614	99.92%	1	0.31%
愿	4122		14	1	0.000151%	661615	99.92%	1	0.31%
慟	4123		14	1	0.000151%	661616	99.92%	1	0.31%
慾	4124		15	1	0.000151%	661617	99.92%	1	0.31%
憔	4125		15	1	0.000151%	661618	99.92%	1	0.31%
懊	4126		16	1	0.000151%	661619	99.92%	1	0.31%
懋	4127		17	1	0.000151%	661620	99.92%	1	0.31%
懺	4128		20	1	0.000151%	661621	99.92%	1	0.31%
懿	4129		22	1	0.000151%	661622	99.92%	1	0.31%
戍	4130		6	1	0.000151%	661623	99.92%	1	0.31%
戛	4131		11	1	0.000151%	661624	99.92%	1	0.31%
戳	4132		18	1	0.000151%	661625	99.92%	1	0.31%
扙	4133		6	1	0.000151%	661626	99.92%	1	0.31%
扺	4134		7	1	0.000151%	661627	99.92%	1	0.31%
抨	4135		8	1	0.000151%	661628	99.92%	1	0.31%
拷	4136		9	1	0.000151%	661629	99.92%	1	0.31%
拯	4137		9	1	0.000151%	661630	99.92%	1	0.31%
拴	4138		9	1	0.000151%	661631	99.92%	1	0.31%
挂	4139		9	1	0.000151%	661632	99.92%	1	0.31%
拫	4140		9	1	0.000151%	661633	99.92%	1	0.31%
捫	4141		11	1	0.000151%	661634	99.92%	1	0.31%
捻	4142		11	1	0.000151%	661635	99.92%	1	0.31%
掗	4143		11	1	0.000151%	661636	99.92%	1	0.31%
掁	4144		11	1	0.000151%	661637	99.92%	1	0.31%
掍	4145		11	1	0.000151%	661638	99.93%	1	0.31%
摒	4146		12	1	0.000151%	661639	99.93%	1	0.31%
掰	4147		12	1	0.000151%	661640	99.93%	1	0.31%
搪	4148		13	1	0.000151%	661641	99.93%	1	0.31%
搧	4149		13	1	0.000151%	661642	99.93%	1	0.31%
撬	4150		15	1	0.000151%	661643	99.93%	1	0.31%
摰	4151		15	1	0.000151%	661644	99.93%	1	0.31%
撣	4152		15	1	0.000151%	661645	99.93%	1	0.31%
擐	4153		16	1	0.000151%	661646	99.93%	1	0.31%
擉	4154		16	1	0.000151%	661647	99.93%	1	0.31%
擭	4155		17	1	0.000151%	661648	99.93%	1	0.31%
攢	4156		22	1	0.000151%	661649	99.93%	1	0.31%
敊	4157		10	1	0.000151%	661650	99.93%	1	0.31%
敝	4158		11	1	0.000151%	661651	99.93%	1	0.31%
敖	4159		11	1	0.000151%	661652	99.93%	1	0.31%
旭	4160		6	1	0.000151%	661653	99.93%	1	0.31%
昐	4161		8	1	0.000151%	661654	99.93%	1	0.31%
昵	4162		9	1	0.000151%	661655	99.93%	1	0.31%
昺	4163		9	1	0.000151%	661656	99.93%	1	0.31%
晌	4164		10	1	0.000151%	661657	99.93%	1	0.31%
晢	4165		11	1	0.000151%	661658	99.93%	1	0.31%
晲	4166		12	1	0.000151%	661659	99.93%	1	0.31%
暱	4167		15	1	0.000151%	661660	99.93%	1	0.31%
曇	4168		16	1	0.000151%	661661	99.93%	1	0.31%
暸	4169		16	1	0.000151%	661662	99.93%	1	0.31%
曨	4170		20	1	0.000151%	661663	99.93%	1	0.31%
朕	4171		10	1	0.000151%	661664	99.93%	1	0.31%
杓	4172		7	1	0.000151%	661665	99.93%	1	0.31%
枋	4173		8	1	0.000151%	661666	99.93%	1	0.31%
枴	4174		9	1	0.000151%	661667	99.93%	1	0.31%
柚	4175		9	1	0.000151%	661668	99.93%	1	0.31%
柆	4176		9	1	0.000151%	661669	99.93%	1	0.31%
柺	4177		9	1	0.000151%	661670	99.93%	1	0.31%
栟	4178		10	1	0.000151%	661671	99.93%	1	0.31%
栴	4179		10	1	0.000151%	661672	99.93%	1	0.31%
梗	4180		11	1	0.000151%	661673	99.93%	1	0.31%
梆	4181		11	1	0.000151%	661674	99.93%	1	0.31%
梣	4182		11	1	0.000151%	661675	99.93%	1	0.31%
梠	4183		11	1	0.000151%	661676	99.93%	1	0.31%
棟	4184		12	1	0.000151%	661677	99.93%	1	0.31%
棧	4185		12	1	0.000151%	661678	99.93%	1	0.31%
椎	4186		12	1	0.000151%	661679	99.93%	1	0.31%
棱	4187		12	1	0.000151%	661680	99.93%	1	0.31%
楨	4188		13	1	0.000151%	661681	99.93%	1	0.31%
楫	4189		13	1	0.000151%	661682	99.93%	1	0.31%
楝	4190		13	1	0.000151%	661683	99.93%	1	0.31%
榻	4191		14	1	0.000151%	661684	99.93%	1	0.31%
槌	4192		14	1	0.000151%	661685	99.93%	1	0.31%
槃	4193		14	1	0.000151%	661686	99.93%	1	0.31%
槨	4194		15	1	0.000151%	661687	99.93%	1	0.31%
樞	4195		15	1	0.000151%	661688	99.93%	1	0.31%
樊	4196		15	1	0.000151%	661689	99.93%	1	0.31%
樅	4197		15	1	0.000151%	661690	99.93%	1	0.31%
樗	4198		15	1	0.000151%	661691	99.93%	1	0.31%
檄	4199		17	1	0.000151%	661692	99.93%	1	0.31%
櫛	4200		17	1	0.000151%	661693	99.93%	1	0.31%
檉	4201		17	1	0.000151%	661694	99.93%	1	0.31%
櫂	4202		18	1	0.000151%	661695	99.93%	1	0.31%
檮	4203		18	1	0.000151%	661696	99.93%	1	0.31%
櫧	4204		19	1	0.000151%	661697	99.93%	1	0.31%
櫞	4205		19	1	0.000151%	661698	99.93%	1	0.31%
櫨	4206		20	1	0.000151%	661699	99.93%	1	0.31%
櫸	4207		21	1	0.000151%	661700	99.93%	1	0.31%
欑	4208		23	1	0.000151%	661701	99.93%	1	0.31%
欬	4209		10	1	0.000151%	661702	99.93%	1	0.31%
欻	4210		12	1	0.000151%	661703	99.93%	1	0.31%
歛	4211		17	1	0.000151%	661704	99.94%	1	0.31%
毗	4212		9	1	0.000151%	661705	99.94%	1	0.31%
毖	4213		9	1	0.000151%	661706	99.94%	1	0.31%
毘	4214		9	1	0.000151%	661707	99.94%	1	0.31%
氤	4215		10	1	0.000151%	661708	99.94%	1	0.31%
氬	4216		12	1	0.000151%	661709	99.94%	1	0.31%
氳	4217		14	1	0.000151%	661710	99.94%	1	0.31%
汕	4218		6	1	0.000151%	661711	99.94%	1	0.31%
汊	4219		6	1	0.000151%	661712	99.94%	1	0.31%
汔	4220		6	1	0.000151%	661713	99.94%	1	0.31%
汞	4221		7	1	0.000151%	661714	99.94%	1	0.31%
沅	4222		7	1	0.000151%	661715	99.94%	1	0.31%
沌	4223		7	1	0.000151%	661716	99.94%	1	0.31%
汲	4224		7	1	0.000151%	661717	99.94%	1	0.31%
汶	4225		7	1	0.000151%	661718	99.94%	1	0.31%
泗	4226		8	1	0.000151%	661719	99.94%	1	0.31%
泅	4227		8	1	0.000151%	661720	99.94%	1	0.31%
洼	4228		9	1	0.000151%	661721	99.94%	1	0.31%
洊	4229		9	1	0.000151%	661722	99.94%	1	0.31%
洙	4230		9	1	0.000151%	661723	99.94%	1	0.31%
涑	4231		10	1	0.000151%	661724	99.94%	1	0.31%
浠	4232		10	1	0.000151%	661725	99.94%	1	0.31%
涸	4233		11	1	0.000151%	661726	99.94%	1	0.31%
淪	4234		11	1	0.000151%	661727	99.94%	1	0.31%
涪	4235		11	1	0.000151%	661728	99.94%	1	0.31%
淬	4236		11	1	0.000151%	661729	99.94%	1	0.31%
淀	4237		11	1	0.000151%	661730	99.94%	1	0.31%
涷	4238		11	1	0.000151%	661731	99.94%	1	0.31%
淖	4239		11	1	0.000151%	661732	99.94%	1	0.31%
渥	4240		12	1	0.000151%	661733	99.94%	1	0.31%
渤	4241		12	1	0.000151%	661734	99.94%	1	0.31%
湲	4242		12	1	0.000151%	661735	99.94%	1	0.31%
溺	4243		13	1	0.000151%	661736	99.94%	1	0.31%
滃	4244		13	1	0.000151%	661737	99.94%	1	0.31%
漱	4245		14	1	0.000151%	661738	99.94%	1	0.31%
漕	4246		14	1	0.000151%	661739	99.94%	1	0.31%
漥	4247		14	1	0.000151%	661740	99.94%	1	0.31%
滻	4248		14	1	0.000151%	661741	99.94%	1	0.31%
漚	4249		14	1	0.000151%	661742	99.94%	1	0.31%
潼	4250		15	1	0.000151%	661743	99.94%	1	0.31%
潏	4251		15	1	0.000151%	661744	99.94%	1	0.31%
潻	4252		15	1	0.000151%	661745	99.94%	1	0.31%
澧	4253		16	1	0.000151%	661746	99.94%	1	0.31%
澹	4254		16	1	0.000151%	661747	99.94%	1	0.31%
濞	4255		17	1	0.000151%	661748	99.94%	1	0.31%
瀕	4256		19	1	0.000151%	661749	99.94%	1	0.31%
瀘	4257		19	1	0.000151%	661750	99.94%	1	0.31%
瀰	4258		20	1	0.000151%	661751	99.94%	1	0.31%
炙	4259		8	1	0.000151%	661752	99.94%	1	0.31%
煎	4260		13	1	0.000151%	661753	99.94%	1	0.31%
煇	4261		13	1	0.000151%	661754	99.94%	1	0.31%
熏	4262		14	1	0.000151%	661755	99.94%	1	0.31%
燎	4263		16	1	0.000151%	661756	99.94%	1	0.31%
燜	4264		16	1	0.000151%	661757	99.94%	1	0.31%
燧	4265		17	1	0.000151%	661758	99.94%	1	0.31%
犍	4266		13	1	0.000151%	661759	99.94%	1	0.31%
犛	4267		15	1	0.000151%	661760	99.94%	1	0.31%
狙	4268		8	1	0.000151%	661761	99.94%	1	0.31%
猩	4269		12	1	0.000151%	661762	99.94%	1	0.31%
猱	4270		12	1	0.000151%	661763	99.94%	1	0.31%
猿	4271		13	1	0.000151%	661764	99.94%	1	0.31%
獗	4272		15	1	0.000151%	661765	99.94%	1	0.31%
獠	4273		15	1	0.000151%	661766	99.94%	1	0.31%
玕	4274		7	1	0.000151%	661767	99.94%	1	0.31%
珀	4275		9	1	0.000151%	661768	99.94%	1	0.31%
珂	4276		9	1	0.000151%	661769	99.94%	1	0.31%
琥	4277		12	1	0.000151%	661770	99.95%	1	0.31%
琵	4278		12	1	0.000151%	661771	99.95%	1	0.31%
琶	4279		12	1	0.000151%	661772	99.95%	1	0.31%
瑕	4280		13	1	0.000151%	661773	99.95%	1	0.31%
瑛	4281		13	1	0.000151%	661774	99.95%	1	0.31%
瑜	4282		13	1	0.000151%	661775	99.95%	1	0.31%
瑱	4283		14	1	0.000151%	661776	99.95%	1	0.31%
璫	4284		17	1	0.000151%	661777	99.95%	1	0.31%
瓖	4285		21	1	0.000151%	661778	99.95%	1	0.31%
甍	4286		16	1	0.000151%	661779	99.95%	1	0.31%
甓	4287		18	1	0.000151%	661780	99.95%	1	0.31%
甥	4288		12	1	0.000151%	661781	99.95%	1	0.31%
畚	4289		10	1	0.000151%	661782	99.95%	1	0.31%
疝	4290		8	1	0.000151%	661783	99.95%	1	0.31%
疸	4291		10	1	0.000151%	661784	99.95%	1	0.31%
痞	4292		12	1	0.000151%	661785	99.95%	1	0.31%
痳	4293		13	1	0.000151%	661786	99.95%	1	0.31%
痼	4294		13	1	0.000151%	661787	99.95%	1	0.31%
瘖	4295		14	1	0.000151%	661788	99.95%	1	0.31%
瘴	4296		16	1	0.000151%	661789	99.95%	1	0.31%
癌	4297		17	1	0.000151%	661790	99.95%	1	0.31%
癈	4298		17	1	0.000151%	661791	99.95%	1	0.31%
癘	4299		18	1	0.000151%	661792	99.95%	1	0.31%
癭	4300		22	1	0.000151%	661793	99.95%	1	0.31%
癲	4301		24	1	0.000151%	661794	99.95%	1	0.31%
皋	4302		10	1	0.000151%	661795	99.95%	1	0.31%
盅	4303		9	1	0.000151%	661796	99.95%	1	0.31%
盰	4304		8	1	0.000151%	661797	99.95%	1	0.31%
眶	4305		11	1	0.000151%	661798	99.95%	1	0.31%
睏	4306		12	1	0.000151%	661799	99.95%	1	0.31%
睬	4307		13	1	0.000151%	661800	99.95%	1	0.31%
睥	4308		13	1	0.000151%	661801	99.95%	1	0.31%
睨	4309		13	1	0.000151%	661802	99.95%	1	0.31%
瞭	4310		17	1	0.000151%	661803	99.95%	1	0.31%
矓	4311		21	1	0.000151%	661804	99.95%	1	0.31%
砢	4312		10	1	0.000151%	661805	99.95%	1	0.31%
硌	4313		11	1	0.000151%	661806	99.95%	1	0.31%
砦	4314		11	1	0.000151%	661807	99.95%	1	0.31%
确	4315		12	1	0.000151%	661808	99.95%	1	0.31%
碱	4316		14	1	0.000151%	661809	99.95%	1	0.31%
碟	4317		14	1	0.000151%	661810	99.95%	1	0.31%
碣	4318		14	1	0.000151%	661811	99.95%	1	0.31%
碴	4319		14	1	0.000151%	661812	99.95%	1	0.31%
碭	4320		14	1	0.000151%	661813	99.95%	1	0.31%
磬	4321		16	1	0.000151%	661814	99.95%	1	0.31%
磩	4322		16	1	0.000151%	661815	99.95%	1	0.31%
磣	4323		16	1	0.000151%	661816	99.95%	1	0.31%
礝	4324		19	1	0.000151%	661817	99.95%	1	0.31%
礪	4325		20	1	0.000151%	661818	99.95%	1	0.31%
礱	4326		21	1	0.000151%	661819	99.95%	1	0.31%
祇	4327		8	1	0.000151%	661820	99.95%	1	0.31%
祅	4328		8	1	0.000151%	661821	99.95%	1	0.31%
禎	4329		13	1	0.000151%	661822	99.95%	1	0.31%
禧	4330		16	1	0.000151%	661823	99.95%	1	0.31%
秤	4331		10	1	0.000151%	661824	99.95%	1	0.31%
秣	4332		10	1	0.000151%	661825	99.95%	1	0.31%
稔	4333		13	1	0.000151%	661826	99.95%	1	0.31%
稟	4334		13	1	0.000151%	661827	99.95%	1	0.31%
稷	4335		15	1	0.000151%	661828	99.95%	1	0.31%
穌	4336		16	1	0.000151%	661829	99.95%	1	0.31%
窋	4337		10	1	0.000151%	661830	99.95%	1	0.31%
窔	4338		11	1	0.000151%	661831	99.95%	1	0.31%
窖	4339		12	1	0.000151%	661832	99.95%	1	0.31%
窳	4340		15	1	0.000151%	661833	99.95%	1	0.31%
窿	4341		17	1	0.000151%	661834	99.95%	1	0.31%
竣	4342		12	1	0.000151%	661835	99.95%	1	0.31%
笏	4343		10	1	0.000151%	661836	99.95%	1	0.31%
笊	4344		10	1	0.000151%	661837	99.96%	1	0.31%
箕	4345		14	1	0.000151%	661838	99.96%	1	0.31%
筵	4346		14	1	0.000151%	661839	99.96%	1	0.31%
箔	4347		14	1	0.000151%	661840	99.96%	1	0.31%
箬	4348		15	1	0.000151%	661841	99.96%	1	0.31%
篝	4349		16	1	0.000151%	661842	99.96%	1	0.31%
篱	4350		17	1	0.000151%	661843	99.96%	1	0.31%
簣	4351		18	1	0.000151%	661844	99.96%	1	0.31%
粕	4352		11	1	0.000151%	661845	99.96%	1	0.31%
粢	4353		12	1	0.000151%	661846	99.96%	1	0.31%
粧	4354		12	1	0.000151%	661847	99.96%	1	0.31%
粳	4355		13	1	0.000151%	661848	99.96%	1	0.31%
粲	4356		13	1	0.000151%	661849	99.96%	1	0.31%
糌	4357		15	1	0.000151%	661850	99.96%	1	0.31%
紇	4358		9	1	0.000151%	661851	99.96%	1	0.31%
紈	4359		9	1	0.000151%	661852	99.96%	1	0.31%
紊	4360		10	1	0.000151%	661853	99.96%	1	0.31%
絳	4361		12	1	0.000151%	661854	99.96%	1	0.31%
絛	4362		13	1	0.000151%	661855	99.96%	1	0.31%
緋	4363		14	1	0.000151%	661856	99.96%	1	0.31%
緪	4364		15	1	0.000151%	661857	99.96%	1	0.31%
縉	4365		16	1	0.000151%	661858	99.96%	1	0.31%
繅	4366		17	1	0.000151%	661859	99.96%	1	0.31%
繕	4367		18	1	0.000151%	661860	99.96%	1	0.31%
繒	4368		18	1	0.000151%	661861	99.96%	1	0.31%
繢	4369		18	1	0.000151%	661862	99.96%	1	0.31%
纛	4370		25	1	0.000151%	661863	99.96%	1	0.31%
罟	4371		10	1	0.000151%	661864	99.96%	1	0.31%
羈	4372		24	1	0.000151%	661865	99.96%	1	0.31%
羚	4373		11	1	0.000151%	661866	99.96%	1	0.31%
羰	4374		15	1	0.000151%	661867	99.96%	1	0.31%
翌	4375		11	1	0.000151%	661868	99.96%	1	0.31%
翕	4376		12	1	0.000151%	661869	99.96%	1	0.31%
翮	4377		16	1	0.000151%	661870	99.96%	1	0.31%
耄	4378		9	1	0.000151%	661871	99.96%	1	0.31%
耠	4379		12	1	0.000151%	661872	99.96%	1	0.31%
聇	4380		11	1	0.000151%	661873	99.96%	1	0.31%
胝	4381		9	1	0.000151%	661874	99.96%	1	0.31%
胜	4382		9	1	0.000151%	661875	99.96%	1	0.31%
胰	4383		10	1	0.000151%	661876	99.96%	1	0.31%
胼	4384		10	1	0.000151%	661877	99.96%	1	0.31%
腋	4385		12	1	0.000151%	661878	99.96%	1	0.31%
腆	4386		12	1	0.000151%	661879	99.96%	1	0.31%
腴	4387		12	1	0.000151%	661880	99.96%	1	0.31%
膂	4388		14	1	0.000151%	661881	99.96%	1	0.31%
膺	4389		17	1	0.000151%	661882	99.96%	1	0.31%
臺	4390		14	1	0.000151%	661883	99.96%	1	0.31%
臻	4391		16	1	0.000151%	661884	99.96%	1	0.31%
臾	4392		8	1	0.000151%	661885	99.96%	1	0.31%
舐	4393		10	1	0.000151%	661886	99.96%	1	0.31%
舫	4394		10	1	0.000151%	661887	99.96%	1	0.31%
舨	4395		10	1	0.000151%	661888	99.96%	1	0.31%
舶	4396		11	1	0.000151%	661889	99.96%	1	0.31%
舸	4397		11	1	0.000151%	661890	99.96%	1	0.31%
艄	4398		13	1	0.000151%	661891	99.96%	1	0.31%
芥	4399		8	1	0.000151%	661892	99.96%	1	0.31%
茄	4400		9	1	0.000151%	661893	99.96%	1	0.31%
苾	4401		9	1	0.000151%	661894	99.96%	1	0.31%
芻	4402		10	1	0.000151%	661895	99.96%	1	0.31%
茜	4403		10	1	0.000151%	661896	99.96%	1	0.31%
荇	4404		10	1	0.000151%	661897	99.96%	1	0.31%
茧	4405		10	1	0.000151%	661898	99.96%	1	0.31%
莞	4406		11	1	0.000151%	661899	99.96%	1	0.31%
莒	4407		11	1	0.000151%	661900	99.96%	1	0.31%
莧	4408		11	1	0.000151%	661901	99.96%	1	0.31%
菱	4409		12	1	0.000151%	661902	99.96%	1	0.31%
菴	4410		12	1	0.000151%	661903	99.97%	1	0.31%
菇	4411		12	1	0.000151%	661904	99.97%	1	0.31%
萱	4412		13	1	0.000151%	661905	99.97%	1	0.31%
萼	4413		13	1	0.000151%	661906	99.97%	1	0.31%
葩	4414		13	1	0.000151%	661907	99.97%	1	0.31%
葳	4415		13	1	0.000151%	661908	99.97%	1	0.31%
蒜	4416		14	1	0.000151%	661909	99.97%	1	0.31%
蒐	4417		14	1	0.000151%	661910	99.97%	1	0.31%
蓊	4418		14	1	0.000151%	661911	99.97%	1	0.31%
蒔	4419		14	1	0.000151%	661912	99.97%	1	0.31%
蔡	4420		15	1	0.000151%	661913	99.97%	1	0.31%
蕤	4421		16	1	0.000151%	661914	99.97%	1	0.31%
蕢	4422		16	1	0.000151%	661915	99.97%	1	0.31%
薔	4423		17	1	0.000151%	661916	99.97%	1	0.31%
薟	4424		17	1	0.000151%	661917	99.97%	1	0.31%
薰	4425		18	1	0.000151%	661918	99.97%	1	0.31%
藪	4426		19	1	0.000151%	661919	99.97%	1	0.31%
藹	4427		20	1	0.000151%	661920	99.97%	1	0.31%
蘑	4428		20	1	0.000151%	661921	99.97%	1	0.31%
蘚	4429		21	1	0.000151%	661922	99.97%	1	0.31%
虐	4430		9	1	0.000151%	661923	99.97%	1	0.31%
蚤	4431		10	1	0.000151%	661924	99.97%	1	0.31%
蚩	4432		10	1	0.000151%	661925	99.97%	1	0.31%
蚣	4433		10	1	0.000151%	661926	99.97%	1	0.31%
蚜	4434		10	1	0.000151%	661927	99.97%	1	0.31%
蚕	4435		10	1	0.000151%	661928	99.97%	1	0.31%
蚱	4436		11	1	0.000151%	661929	99.97%	1	0.31%
蛟	4437		12	1	0.000151%	661930	99.97%	1	0.31%
蛤	4438		12	1	0.000151%	661931	99.97%	1	0.31%
蛹	4439		13	1	0.000151%	661932	99.97%	1	0.31%
蜈	4440		13	1	0.000151%	661933	99.97%	1	0.31%
蜀	4441		13	1	0.000151%	661934	99.97%	1	0.31%
蜻	4442		14	1	0.000151%	661935	99.97%	1	0.31%
蜢	4443		14	1	0.000151%	661936	99.97%	1	0.31%
蜷	4444		14	1	0.000151%	661937	99.97%	1	0.31%
蜚	4445		14	1	0.000151%	661938	99.97%	1	0.31%
螂	4446		15	1	0.000151%	661939	99.97%	1	0.31%
蝞	4447		15	1	0.000151%	661940	99.97%	1	0.31%
螞	4448		16	1	0.000151%	661941	99.97%	1	0.31%
螳	4449		17	1	0.000151%	661942	99.97%	1	0.31%
蟆	4450		17	1	0.000151%	661943	99.97%	1	0.31%
螫	4451		17	1	0.000151%	661944	99.97%	1	0.31%
蟬	4452		18	1	0.000151%	661945	99.97%	1	0.31%
蟻	4453		19	1	0.000151%	661946	99.97%	1	0.31%
蠕	4454		20	1	0.000151%	661947	99.97%	1	0.31%
衩	4455		8	1	0.000151%	661948	99.97%	1	0.31%
袂	4456		9	1	0.000151%	661949	99.97%	1	0.31%
衲	4457		9	1	0.000151%	661950	99.97%	1	0.31%
袍	4458		10	1	0.000151%	661951	99.97%	1	0.31%
袛	4459		10	1	0.000151%	661952	99.97%	1	0.31%
裘	4460		13	1	0.000151%	661953	99.97%	1	0.31%
褪	4461		15	1	0.000151%	661954	99.97%	1	0.31%
褸	4462		16	1	0.000151%	661955	99.97%	1	0.31%
襤	4463		19	1	0.000151%	661956	99.97%	1	0.31%
覃	4464		12	1	0.000151%	661957	99.97%	1	0.31%
覦	4465		16	1	0.000151%	661958	99.97%	1	0.31%
覬	4466		17	1	0.000151%	661959	99.97%	1	0.31%
訖	4467		10	1	0.000151%	661960	99.97%	1	0.31%
註	4468		12	1	0.000151%	661961	99.97%	1	0.31%
詎	4469		12	1	0.000151%	661962	99.97%	1	0.31%
詮	4470		13	1	0.000151%	661963	99.97%	1	0.31%
訾	4471		13	1	0.000151%	661964	99.97%	1	0.31%
詡	4472		13	1	0.000151%	661965	99.97%	1	0.31%
詵	4473		13	1	0.000151%	661966	99.97%	1	0.31%
誚	4474		14	1	0.000151%	661967	99.97%	1	0.31%
諛	4475		15	1	0.000151%	661968	99.97%	1	0.31%
諫	4476		16	1	0.000151%	661969	99.98%	1	0.31%
諭	4477		16	1	0.000151%	661970	99.98%	1	0.31%
謎	4478		17	1	0.000151%	661971	99.98%	1	0.31%
謄	4479		17	1	0.000151%	661972	99.98%	1	0.31%
謢	4480		17	1	0.000151%	661973	99.98%	1	0.31%
謳	4481		18	1	0.000151%	661974	99.98%	1	0.31%
謾	4482		18	1	0.000151%	661975	99.98%	1	0.31%
謦	4483		18	1	0.000151%	661976	99.98%	1	0.31%
讕	4484		24	1	0.000151%	661977	99.98%	1	0.31%
豢	4485		13	1	0.000151%	661978	99.98%	1	0.31%
豳	4486		17	1	0.000151%	661979	99.98%	1	0.31%
豸	4487		7	1	0.000151%	661980	99.98%	1	0.31%
貂	4488		12	1	0.000151%	661981	99.98%	1	0.31%
貳	4489		12	1	0.000151%	661982	99.98%	1	0.31%
賄	4490		13	1	0.000151%	661983	99.98%	1	0.31%
賡	4491		15	1	0.000151%	661984	99.98%	1	0.31%
贓	4492		21	1	0.000151%	661985	99.98%	1	0.31%
贔	4493		21	1	0.000151%	661986	99.98%	1	0.31%
趾	4494		11	1	0.000151%	661987	99.98%	1	0.31%
趺	4495		11	1	0.000151%	661988	99.98%	1	0.31%
趿	4496		11	1	0.000151%	661989	99.98%	1	0.31%
踪	4497		14	1	0.000151%	661990	99.98%	1	0.31%
踫	4498		15	1	0.000151%	661991	99.98%	1	0.31%
踡	4499		15	1	0.000151%	661992	99.98%	1	0.31%
蹊	4500		17	1	0.000151%	661993	99.98%	1	0.31%
蹙	4501		18	1	0.000151%	661994	99.98%	1	0.31%
蹡	4502		18	1	0.000151%	661995	99.98%	1	0.31%
蹩	4503		18	1	0.000151%	661996	99.98%	1	0.31%
躇	4504		19	1	0.000151%	661997	99.98%	1	0.31%
躉	4505		20	1	0.000151%	661998	99.98%	1	0.31%
躊	4506		21	1	0.000151%	661999	99.98%	1	0.31%
躓	4507		22	1	0.000151%	662000	99.98%	1	0.31%
躝	4508		24	1	0.000151%	662001	99.98%	1	0.31%
躦	4509		26	1	0.000151%	662002	99.98%	1	0.31%
軼	4510		12	1	0.000151%	662003	99.98%	1	0.31%
轄	4511		17	1	0.000151%	662004	99.98%	1	0.31%
迤	4512		8	1	0.000151%	662005	99.98%	1	0.31%
逕	4513		10	1	0.000151%	662006	99.98%	1	0.31%
逡	4514		10	1	0.000151%	662007	99.98%	1	0.31%
逵	4515		11	1	0.000151%	662008	99.98%	1	0.31%
逶	4516		11	1	0.000151%	662009	99.98%	1	0.31%
遏	4517		12	1	0.000151%	662010	99.98%	1	0.31%
邱	4518		7	1	0.000151%	662011	99.98%	1	0.31%
郃	4519		8	1	0.000151%	662012	99.98%	1	0.31%
郤	4520		9	1	0.000151%	662013	99.98%	1	0.31%
鄔	4521		12	1	0.000151%	662014	99.98%	1	0.31%
鄱	4522		14	1	0.000151%	662015	99.98%	1	0.31%
鄴	4523		15	1	0.000151%	662016	99.98%	1	0.31%
鄺	4524		17	1	0.000151%	662017	99.98%	1	0.31%
酈	4525		21	1	0.000151%	662018	99.98%	1	0.31%
酊	4526		9	1	0.000151%	662019	99.98%	1	0.31%
酌	4527		10	1	0.000151%	662020	99.98%	1	0.31%
酩	4528		13	1	0.000151%	662021	99.98%	1	0.31%
酵	4529		14	1	0.000151%	662022	99.98%	1	0.31%
酹	4530		14	1	0.000151%	662023	99.98%	1	0.31%
醣	4531		17	1	0.000151%	662024	99.98%	1	0.31%
釆	4532		7	1	0.000151%	662025	99.98%	1	0.31%
釜	4533		10	1	0.000151%	662026	99.98%	1	0.31%
釵	4534		11	1	0.000151%	662027	99.98%	1	0.31%
釩	4535		11	1	0.000151%	662028	99.98%	1	0.31%
鉤	4536		13	1	0.000151%	662029	99.98%	1	0.31%
鉉	4537		13	1	0.000151%	662030	99.98%	1	0.31%
鉬	4538		13	1	0.000151%	662031	99.98%	1	0.31%
銖	4539		14	1	0.000151%	662032	99.98%	1	0.31%
銓	4540		14	1	0.000151%	662033	99.98%	1	0.31%
銛	4541		14	1	0.000151%	662034	99.98%	1	0.31%
鋌	4542		15	1	0.000151%	662035	99.99%	1	0.31%
錚	4543		16	1	0.000151%	662036	99.99%	1	0.31%
錙	4544		16	1	0.000151%	662037	99.99%	1	0.31%
鍍	4545		17	1	0.000151%	662038	99.99%	1	0.31%
鍔	4546		17	1	0.000151%	662039	99.99%	1	0.31%
鍜	4547		17	1	0.000151%	662040	99.99%	1	0.31%
鎬	4548		18	1	0.000151%	662041	99.99%	1	0.31%
鎧	4549		18	1	0.000151%	662042	99.99%	1	0.31%
鏖	4550		19	1	0.000151%	662043	99.99%	1	0.31%
鏤	4551		19	1	0.000151%	662044	99.99%	1	0.31%
鏨	4552		19	1	0.000151%	662045	99.99%	1	0.31%
鏹	4553		19	1	0.000151%	662046	99.99%	1	0.31%
鏽	4554		20	1	0.000151%	662047	99.99%	1	0.31%
鐍	4555		20	1	0.000151%	662048	99.99%	1	0.31%
鐺	4556		21	1	0.000151%	662049	99.99%	1	0.31%
鑣	4557		23	1	0.000151%	662050	99.99%	1	0.31%
鑢	4558		23	1	0.000151%	662051	99.99%	1	0.31%
閔	4559		12	1	0.000151%	662052	99.99%	1	0.31%
閎	4560		12	1	0.000151%	662053	99.99%	1	0.31%
閨	4561		14	1	0.000151%	662054	99.99%	1	0.31%
閰	4562		14	1	0.000151%	662055	99.99%	1	0.31%
闆	4563		17	1	0.000151%	662056	99.99%	1	0.31%
闕	4564		18	1	0.000151%	662057	99.99%	1	0.31%
闥	4565		21	1	0.000151%	662058	99.99%	1	0.31%
阪	4566		6	1	0.000151%	662059	99.99%	1	0.31%
陬	4567		10	1	0.000151%	662060	99.99%	1	0.31%
隑	4568		12	1	0.000151%	662061	99.99%	1	0.31%
雍	4569		13	1	0.000151%	662062	99.99%	1	0.31%
雌	4570		14	1	0.000151%	662063	99.99%	1	0.31%
霉	4571		15	1	0.000151%	662064	99.99%	1	0.31%
霓	4572		16	1	0.000151%	662065	99.99%	1	0.31%
靚	4573		15	1	0.000151%	662066	99.99%	1	0.31%
靛	4574		16	1	0.000151%	662067	99.99%	1	0.31%
靡	4575		19	1	0.000151%	662068	99.99%	1	0.31%
靦	4576		16	1	0.000151%	662069	99.99%	1	0.31%
靨	4577		23	1	0.000151%	662070	99.99%	1	0.31%
鞍	4578		15	1	0.000151%	662071	99.99%	1	0.31%
韁	4579		22	1	0.000151%	662072	99.99%	1	0.31%
韙	4580		18	1	0.000151%	662073	99.99%	1	0.31%
韞	4581		19	1	0.000151%	662074	99.99%	1	0.31%
頲	4582		16	1	0.000151%	662075	99.99%	1	0.31%
顱	4583		25	1	0.000151%	662076	99.99%	1	0.31%
颺	4584		18	1	0.000151%	662077	99.99%	1	0.31%
飆	4585		21	1	0.000151%	662078	99.99%	1	0.31%
飴	4586		13	1	0.000151%	662079	99.99%	1	0.31%
餒	4587		15	1	0.000151%	662080	99.99%	1	0.31%
餞	4588		16	1	0.000151%	662081	99.99%	1	0.31%
餡	4589		16	1	0.000151%	662082	99.99%	1	0.31%
餚	4590		16	1	0.000151%	662083	99.99%	1	0.31%
餬	4591		17	1	0.000151%	662084	99.99%	1	0.31%
饞	4592		25	1	0.000151%	662085	99.99%	1	0.31%
駑	4593		15	1	0.000151%	662086	99.99%	1	0.31%
駘	4594		15	1	0.000151%	662087	99.99%	1	0.31%
駢	4595		16	1	0.000151%	662088	99.99%	1	0.31%
騏	4596		18	1	0.000151%	662089	99.99%	1	0.31%
驛	4597		23	1	0.000151%	662090	99.99%	1	0.31%
驥	4598		26	1	0.000151%	662091	99.99%	1	0.31%
驪	4599		29	1	0.000151%	662092	99.99%	1	0.31%
髓	4600		23	1	0.000151%	662093	99.99%	1	0.31%
髲	4601		15	1	0.000151%	662094	99.99%	1	0.31%
鬃	4602		18	1	0.000151%	662095	99.99%	1	0.31%
鯽	4603		18	1	0.000151%	662096	99.99%	1	0.31%
鵡	4604		19	1	0.000151%	662097	99.99%	1	0.31%
鶿	4605		20	1	0.000151%	662098	99.99%	1	0.31%
鷲	4606		23	1	0.000151%	662099	99.99%	1	0.31%
鸞	4607		30	1	0.000151%	662100	99.99%	1	0.31%
鸝	4608		30	1	0.000151%	662101	99.9999999999%	1	0.31%
鹵	4609		11	1	0.000151%	662102	99.9999999999%	1	0.31%
麋	4610		17	1	0.000151%	662103	99.9999999999%	1	0.31%
黟	4611		18	1	0.000151%	662104	99.9999999999%	1	0.31%
黧	4612		20	1	0.000151%	662105	99.9999999999%	1	0.31%
