單字	序號	部首	筆劃	頻次	頻率	累積頻次	累積頻率	見檔次	見檔率
一	2		1	11165	1.683%	11165	5.363%	411	99.99%
有	6		6	7311	1.102%	18476	10.40%	411	99.99%
的	1		8	24414	3.680%	42890	3.680%	410	99.76%
不	4		4	9190	1.385%	52080	8.150%	410	99.76%
在	7		6	6186	0.9324%	58266	11.33%	409	99.51%
是	3		9	9301	1.402%	67567	6.765%	407	99.03%
以	19		5	3414	0.5146%	70981	18.46%	406	98.78%
大	11		3	4027	0.607%	75008	14.07%	402	97.81%
為	16		9	3642	0.5489%	78650	16.88%	402	97.81%
人	5		2	7622	1.149%	86272	9.298%	400	97.32%
中	10		4	4114	0.6201%	90386	13.46%	400	97.32%
上	17		3	3527	0.5316%	93913	17.42%	400	97.32%
可	22		5	3037	0.4577%	96950	19.87%	400	97.32%
出	24		5	2727	0.411%	99677	20.72%	399	97.08%
個	12		10	3833	0.5777%	103510	14.64%	397	96.59%
而	30		6	2514	0.3789%	106024	23.10%	397	96.59%
會	14		13	3750	0.5652%	109774	15.78%	395	96.11%
時	20		10	3254	0.4905%	113028	18.95%	395	96.11%
來	18		8	3516	0.5299%	116544	17.95%	394	95.86%
多	35		6	2336	0.3521%	118880	24.90%	387	94.16%
這	13		10	3781	0.5699%	122661	15.21%	385	93.67%
過	32		12	2421	0.3649%	125082	23.84%	383	93.19%
於	51		8	1841	0.2775%	126923	29.86%	383	93.19%
要	23		9	2950	0.4446%	129873	20.31%	382	92.94%
但	59		7	1769	0.2666%	131642	32.05%	381	92.70%
年	28		6	2654	0.400%	134296	22.34%	380	92.46%
了	8		2	5037	0.7592%	139333	12.09%	379	92.21%
他	15		5	3688	0.5559%	143021	16.34%	378	91.97%
到	25		8	2704	0.4076%	145725	21.13%	377	91.73%
能	44		10	2008	0.3027%	147733	27.84%	377	91.73%
後	45		9	1989	0.2998%	149722	28.14%	376	91.48%
之	27		4	2654	0.400%	152376	21.94%	374	91.00%
對	36		14	2310	0.3482%	154686	25.25%	374	91.00%
成	56		6	1821	0.2745%	156507	31.24%	371	90.27%
然	43		12	2050	0.309%	158557	27.54%	370	90.02%
得	29		11	2575	0.3881%	161132	22.73%	367	89.29%
下	42		3	2094	0.3156%	163226	27.23%	367	89.29%
如	58		6	1787	0.2693%	165013	31.78%	366	89.05%
所	69		8	1511	0.2277%	166524	34.49%	366	89.05%
其	78		8	1438	0.2167%	167962	36.48%	365	88.81%
作	39		7	2202	0.3319%	170164	26.26%	363	88.32%
發	75		12	1469	0.2214%	171633	35.83%	362	88.08%
現	86		11	1390	0.2095%	173023	38.19%	361	87.83%
因	87		6	1379	0.2078%	174402	38.40%	360	87.59%
分	72		4	1489	0.2244%	175891	35.16%	359	87.35%
同	89		6	1353	0.2039%	177244	38.81%	359	87.35%
都	55		9	1832	0.2761%	179076	30.97%	357	86.86%
十	41		2	2131	0.3212%	181207	26.91%	356	86.62%
當	77		13	1441	0.2172%	182648	36.27%	356	86.62%
前	83		9	1404	0.2116%	184052	37.56%	356	86.62%
生	40		5	2160	0.3256%	186212	26.59%	355	86.37%
外	73		5	1480	0.2231%	187692	35.39%	354	86.13%
最	101		12	1290	0.1944%	188982	41.19%	354	86.13%
地	33		6	2362	0.356%	191344	24.20%	353	85.89%
只	80		5	1434	0.2161%	192778	36.92%	353	85.89%
和	38		8	2223	0.3351%	195001	25.93%	352	85.64%
也	26		3	2686	0.4048%	197687	21.54%	351	85.40%
自	37		6	2303	0.3471%	199990	25.60%	351	85.40%
經	68		13	1519	0.229%	201509	34.26%	351	85.40%
方	48		4	1921	0.2895%	203430	29.01%	350	85.16%
面	76		9	1450	0.2186%	204880	36.05%	350	85.16%
說	34		14	2351	0.3544%	207231	24.55%	347	84.43%
就	46		12	1951	0.2941%	209182	28.43%	346	84.18%
們	31		10	2454	0.3699%	211636	23.47%	345	83.94%
此	112		6	1171	0.1765%	212807	43.21%	345	83.94%
家	49		10	1918	0.2891%	214725	29.30%	342	83.21%
行	64		6	1627	0.2452%	216352	33.33%	342	83.21%
實	105		14	1224	0.1845%	217576	41.94%	341	82.97%
本	67		5	1528	0.2303%	219104	34.03%	340	82.73%
用	65		5	1562	0.2354%	220666	33.57%	339	82.48%
無	70		12	1501	0.2262%	222167	34.71%	338	82.24%
事	57		8	1804	0.2719%	223971	31.51%	336	81.75%
日	81		4	1423	0.2145%	225394	37.13%	335	81.51%
定	102		8	1274	0.192%	226668	41.38%	335	81.51%
已	96		3	1314	0.1981%	227982	40.21%	334	81.27%
些	100		8	1290	0.1944%	229272	41.00%	332	80.78%
理	103		11	1245	0.1877%	230517	41.57%	332	80.78%
意	79		13	1437	0.2166%	231954	36.70%	331	80.54%
者	98		8	1303	0.1964%	233257	40.61%	330	80.29%
與	94		14	1331	0.2006%	234588	39.82%	329	80.05%
由	118		5	1122	0.1691%	235710	44.24%	329	80.05%
間	115		12	1145	0.1726%	236855	43.73%	328	79.81%
去	60		5	1742	0.2626%	238597	32.31%	327	79.56%
心	61		4	1732	0.2611%	240329	32.57%	327	79.56%
好	62		6	1731	0.2609%	242060	32.83%	326	79.32%
至	143		6	932	0.1405%	242992	48.04%	323	78.59%
開	97		12	1306	0.1968%	244298	40.41%	322	78.35%
及	99		4	1299	0.1958%	245597	40.80%	321	78.10%
兩	123		8	1067	0.1608%	246664	45.07%	321	78.10%
高	127		10	1043	0.1572%	247707	45.70%	320	77.86%
重	146		9	923	0.1391%	248630	48.46%	320	77.86%
從	133		11	988	0.1489%	249618	46.61%	317	77.13%
力	114		2	1148	0.173%	250766	43.56%	316	76.89%
加	130		5	998	0.1504%	251764	46.16%	316	76.89%
三	90		3	1350	0.2035%	253114	39.01%	314	76.40%
還	111		16	1191	0.1795%	254305	43.03%	314	76.40%
動	121		11	1109	0.1672%	255414	44.74%	314	76.40%
更	155		7	897	0.1352%	256311	49.69%	313	76.16%
情	82		11	1417	0.2136%	257728	37.34%	312	75.91%
相	161		9	871	0.1313%	258599	50.49%	312	75.91%
國	21		11	3052	0.460%	261651	19.41%	311	75.67%
又	104		2	1229	0.1852%	262880	41.76%	311	75.67%
長	129		8	1011	0.1524%	263891	46.01%	311	75.67%
應	134		17	965	0.1454%	264856	46.76%	311	75.67%
二	106		2	1218	0.1836%	266074	42.12%	309	75.18%
少	173		4	808	0.1218%	266882	51.99%	309	75.18%
正	158		5	883	0.1331%	267765	50.09%	308	74.94%
小	74		3	1478	0.2228%	269243	35.61%	307	74.70%
內	151		4	906	0.1366%	270149	49.15%	307	74.70%
主	93		5	1336	0.2014%	271485	39.62%	306	74.45%
明	139		8	941	0.1418%	272426	47.48%	306	74.45%
沒	85		7	1400	0.211%	273826	37.98%	305	74.21%
受	170		8	817	0.1231%	274643	51.63%	305	74.21%
起	109		10	1205	0.1816%	275848	42.67%	303	73.72%
法	91		8	1347	0.203%	277195	39.21%	302	73.48%
並	177		8	779	0.1174%	277974	52.47%	301	73.24%
問	120		11	1113	0.1678%	279087	44.58%	299	72.75%
度	145		9	927	0.1397%	280014	48.32%	298	72.51%
天	66		4	1555	0.2344%	281569	33.80%	296	72.02%
或	138		8	951	0.1433%	282520	47.33%	294	71.53%
入	188		2	753	0.1135%	283273	53.74%	293	71.29%
道	116		12	1141	0.172%	284414	43.90%	292	71.05%
點	128		17	1042	0.1571%	285456	45.86%	292	71.05%
種	122		14	1093	0.1647%	286549	44.91%	291	70.80%
表	126		8	1053	0.1587%	287602	45.55%	291	70.80%
樣	119		15	1119	0.1687%	288721	44.41%	290	70.56%
新	135		13	960	0.1447%	289681	46.90%	290	70.56%
全	160		6	879	0.1325%	290560	50.36%	290	70.56%
關	165		19	846	0.1275%	291406	51.01%	290	70.56%
著	53		12	1837	0.2769%	293243	30.41%	289	70.32%
見	140		7	941	0.1418%	294184	47.62%	288	70.07%
子	54		3	1832	0.2761%	296016	30.69%	287	69.83%
進	159		11	882	0.1329%	296898	50.23%	287	69.83%
四	157		5	893	0.1346%	297791	49.96%	286	69.59%
看	88		9	1370	0.2065%	299161	38.60%	285	69.34%
很	125		9	1057	0.1593%	300218	45.39%	284	69.10%
將	156		11	895	0.1349%	301113	49.82%	282	68.61%
便	137		9	952	0.1435%	302065	47.19%	281	68.37%
等	172		12	811	0.1222%	302876	51.87%	281	68.37%
果	186		8	755	0.1138%	303631	53.52%	281	68.37%
身	163		7	864	0.1302%	304495	50.75%	280	68.13%
知	132		8	991	0.1494%	305486	46.46%	278	67.64%
向	181		6	773	0.1165%	306259	52.94%	278	67.64%
次	167		6	823	0.124%	307082	51.26%	277	67.40%
才	189		3	750	0.113%	307832	53.86%	277	67.40%
我	9		7	4964	0.7482%	312796	12.84%	276	67.15%
機	150		16	907	0.1367%	313703	49.01%	276	67.15%
五	141		4	939	0.1415%	314642	47.76%	275	66.91%
使	182		8	770	0.1161%	315412	53.06%	275	66.91%
想	110		13	1203	0.1813%	316615	42.85%	273	66.42%
代	164		5	851	0.1283%	317466	50.88%	271	65.94%
位	190		7	747	0.1126%	318213	53.97%	271	65.94%
則	207		9	702	0.1058%	318915	55.83%	271	65.94%
學	71		16	1500	0.2261%	320415	34.94%	270	65.69%
工	95		3	1319	0.1988%	321734	40.02%	270	65.69%
部	175		10	804	0.1212%	322538	52.24%	270	65.69%
再	176		6	787	0.1186%	323325	52.36%	270	65.69%
期	218		12	679	0.1023%	324004	56.97%	270	65.69%
別	212		7	690	0.104%	324694	56.35%	269	65.45%
接	231		11	666	0.1004%	325360	58.28%	269	65.45%
性	136		8	959	0.1445%	326319	47.05%	268	65.21%
反	202		4	714	0.1076%	327033	55.29%	267	64.96%
通	230		10	667	0.1005%	327700	58.18%	267	64.96%
那	47		6	1939	0.2923%	329639	28.72%	266	64.72%
何	216		7	682	0.1028%	330321	56.76%	266	64.72%
今	240		4	648	0.09767%	330969	59.18%	266	64.72%
未	271		5	578	0.08712%	331547	62.02%	266	64.72%
目	206		5	710	0.107%	332257	55.72%	265	64.48%
提	223		12	674	0.1016%	332931	57.48%	265	64.48%
港	52		12	1840	0.2773%	334771	30.14%	264	64.23%
公	107		4	1212	0.1827%	335983	42.31%	264	64.23%
認	219		14	679	0.1023%	336662	57.07%	264	64.23%
名	205		6	711	0.1072%	337373	55.61%	263	63.99%
處	227		11	670	0.101%	338043	57.88%	263	63.99%
手	152		4	902	0.136%	338945	49.28%	262	63.75%
被	203		10	713	0.1075%	339658	55.40%	262	63.75%
原	277		10	570	0.08591%	340228	62.54%	262	63.75%
麼	84		14	1404	0.2116%	341632	37.77%	260	63.26%
合	168		6	819	0.1234%	342451	51.38%	259	63.02%
立	191		5	747	0.1126%	343198	54.08%	259	63.02%
常	225		11	673	0.1014%	343871	57.68%	259	63.02%
回	171		6	812	0.1224%	344683	51.75%	258	62.77%
解	282		13	567	0.08546%	345250	62.97%	258	62.77%
數	213		15	690	0.104%	345940	56.45%	257	62.53%
卻	224		9	673	0.1014%	346613	57.58%	254	61.80%
難	233		19	665	0.1002%	347278	58.49%	254	61.80%
民	63		5	1663	0.2507%	348941	33.08%	253	61.56%
結	278		12	569	0.08576%	349510	62.63%	253	61.56%
近	297		7	524	0.07898%	350034	64.20%	251	61.07%
比	251		4	618	0.09315%	350652	60.22%	250	60.83%
百	162		6	869	0.131%	351521	50.62%	249	60.58%
感	174		13	808	0.1218%	352329	52.12%	249	60.58%
題	193		18	740	0.1115%	353069	54.31%	249	60.58%
變	208		23	699	0.1054%	353768	55.93%	249	60.58%
平	204		5	712	0.1073%	354480	55.51%	248	60.34%
特	291		10	542	0.08169%	355022	63.72%	248	60.34%
甚	195		9	732	0.1103%	355754	54.53%	247	60.10%
即	302		7	513	0.07732%	356267	64.59%	247	60.10%
先	298		6	522	0.07868%	356789	64.28%	246	59.85%
信	229		9	667	0.1005%	357456	58.08%	245	59.61%
界	249		9	621	0.0936%	358077	60.03%	245	59.61%
論	250		15	619	0.0933%	358696	60.13%	245	59.61%
把	166		7	844	0.1272%	359540	51.13%	244	59.37%
月	187		4	754	0.1136%	360294	53.63%	244	59.37%
直	241		8	648	0.09767%	360942	59.28%	244	59.37%
幾	235		12	660	0.09948%	361602	58.68%	243	59.12%
望	264		11	592	0.08923%	362194	61.41%	243	59.12%
取	295		8	526	0.07928%	362720	64.04%	243	59.12%
香	117		9	1136	0.1712%	363856	44.07%	242	58.88%
場	148		12	915	0.1379%	364771	48.74%	242	58.88%
真	180		10	774	0.1167%	365545	52.82%	242	58.88%
每	209		7	697	0.1051%	366242	56.04%	242	58.88%
七	215		2	685	0.1032%	366927	56.66%	242	58.88%
必	268		5	581	0.08757%	367508	61.76%	242	58.88%
九	124		2	1061	0.1599%	368569	45.23%	239	58.15%
水	147		4	921	0.1388%	369490	48.60%	239	58.15%
持	265		9	586	0.08832%	370076	61.50%	237	57.66%
氣	194		10	738	0.1112%	370814	54.42%	236	57.42%
體	211		23	696	0.1049%	371510	56.25%	236	57.42%
總	236		17	660	0.09948%	372170	58.78%	236	57.42%
風	199		9	724	0.1091%	372894	54.97%	235	57.18%
任	221		6	676	0.1019%	373570	57.27%	235	57.18%
容	337		10	451	0.06798%	374021	67.14%	235	57.18%
文	142		4	938	0.1414%	374959	47.90%	234	56.93%
化	226		4	670	0.101%	375629	57.78%	234	56.93%
非	292		8	539	0.08124%	376168	63.80%	234	56.93%
美	131		9	998	0.1504%	377166	46.31%	232	56.45%
安	267		6	582	0.08772%	377748	61.67%	232	56.45%
八	222		2	676	0.1019%	378424	57.38%	231	56.20%
頭	144		16	932	0.1405%	379356	48.18%	230	55.96%
做	183		11	768	0.1158%	380124	53.17%	230	55.96%
物	192		8	740	0.1115%	380864	54.19%	230	55.96%
各	293		6	532	0.08019%	381396	63.88%	230	55.96%
令	321		5	477	0.0719%	381873	66.01%	229	55.72%
且	344		5	437	0.06587%	382310	67.60%	229	55.72%
許	303		11	512	0.07717%	382822	64.67%	228	55.47%
政	50		9	1860	0.2803%	384682	29.58%	227	55.23%
話	198		13	730	0.110%	385412	54.86%	227	55.23%
另	367		5	400	0.06029%	385812	69.06%	227	55.23%
影	274		15	576	0.08682%	386388	62.28%	226	54.99%
放	281		8	567	0.08546%	386955	62.88%	226	54.99%
亦	245		6	628	0.09465%	387583	59.66%	225	54.74%
活	247		9	623	0.0939%	388206	59.85%	225	54.74%
己	149		3	908	0.1369%	389114	48.87%	224	54.50%
強	323		11	474	0.07144%	389588	66.15%	224	54.50%
太	220		4	678	0.1022%	390266	57.17%	223	54.26%
保	256		9	611	0.09209%	390877	60.68%	223	54.26%
六	257		4	610	0.09194%	391487	60.77%	223	54.26%
利	201		7	716	0.1079%	392203	55.18%	222	54.01%
仍	328		4	470	0.07084%	392673	66.51%	221	53.77%
計	234		9	662	0.09978%	393335	58.59%	220	53.53%
該	311		13	506	0.07627%	393841	65.28%	220	53.53%
指	312		9	499	0.07521%	394340	65.35%	220	53.53%
世	254		5	613	0.09239%	394953	60.50%	218	53.04%
給	286		12	562	0.08471%	395515	63.31%	218	53.04%
員	154		10	897	0.1352%	396412	49.55%	217	52.80%
較	288		13	550	0.0829%	396962	63.47%	216	52.55%
雖	377		17	390	0.05878%	397352	69.65%	216	52.55%
往	294		8	528	0.07958%	397880	63.96%	215	52.31%
打	308		5	509	0.07672%	398389	65.05%	215	52.31%
口	266		3	584	0.08802%	398973	61.58%	214	52.07%
市	153		5	900	0.1357%	399873	49.42%	212	51.58%
求	319		7	479	0.0722%	400352	65.87%	212	51.58%
連	369		10	398	0.05999%	400750	69.18%	211	51.34%
改	279		7	568	0.08561%	401318	62.71%	210	51.09%
展	289		10	548	0.0826%	401866	63.56%	210	51.09%
視	358		12	416	0.0627%	402282	68.51%	210	51.09%
制	196		8	731	0.1102%	403013	54.64%	209	50.85%
言	316		7	486	0.07325%	403499	65.65%	209	50.85%
式	327		6	472	0.07114%	403971	66.44%	209	50.85%
萬	276		13	572	0.08621%	404543	62.45%	208	50.61%
失	345		5	437	0.06587%	404980	67.67%	208	50.61%
老	197		6	731	0.1102%	405711	54.75%	207	50.36%
曾	361		12	409	0.06165%	406120	68.69%	207	50.36%
業	185		13	768	0.1158%	406888	53.40%	206	50.12%
門	258		8	609	0.09179%	407497	60.87%	206	50.12%
帶	359		11	412	0.0621%	407909	68.57%	206	50.12%
覺	246		20	627	0.0945%	408536	59.75%	205	49.88%
士	253		3	614	0.09254%	409150	60.41%	205	49.88%
色	259		6	608	0.09164%	409758	60.96%	205	49.88%
收	299		6	521	0.07853%	410279	64.36%	204	49.64%
形	324		7	473	0.07129%	410752	66.23%	204	49.64%
否	364		7	403	0.06074%	411155	68.88%	203	49.39%
足	398		7	365	0.05501%	411520	70.84%	203	49.39%
完	368		7	398	0.05999%	411918	69.12%	202	49.15%
始	414		8	353	0.05321%	412271	71.71%	202	49.15%
除	464		9	313	0.04718%	412584	74.22%	202	49.15%
傳	370		13	397	0.05984%	412981	69.24%	201	48.91%
觀	353		25	428	0.06451%	413409	68.19%	199	48.42%
選	169		15	819	0.1234%	414228	51.50%	198	48.18%
聲	242		17	641	0.09661%	414869	59.37%	198	48.18%
量	306		12	511	0.07702%	415380	64.90%	198	48.18%
第	315		11	487	0.0734%	415867	65.58%	198	48.18%
千	238		3	656	0.09888%	416523	58.98%	197	47.93%
示	339		5	449	0.06768%	416972	67.27%	197	47.93%
記	336		10	452	0.06813%	417424	67.07%	196	47.69%
程	346		12	437	0.06587%	417861	67.73%	196	47.69%
極	396		13	365	0.05501%	418226	70.73%	196	47.69%
東	287		8	551	0.08305%	418777	63.39%	195	47.45%
決	290		7	544	0.08199%	419321	63.64%	195	47.45%
白	275		5	576	0.08682%	419897	62.37%	194	47.20%
滿	352		14	428	0.06451%	420325	68.13%	194	47.20%
走	214		7	689	0.1038%	421014	56.56%	193	46.96%
清	325		11	473	0.07129%	421487	66.30%	193	46.96%
件	331		6	466	0.07024%	421953	66.72%	193	46.96%
深	334		11	461	0.06948%	422414	66.93%	193	46.96%
根	457		10	319	0.04808%	422733	73.89%	193	46.96%
產	261		11	596	0.08983%	423329	61.14%	192	46.72%
報	305		12	511	0.07702%	423840	64.82%	192	46.72%
流	320		9	478	0.07205%	424318	65.94%	192	46.72%
早	341		6	440	0.06632%	424758	67.40%	192	46.72%
達	362		12	409	0.06165%	425167	68.75%	192	46.72%
需	413		14	354	0.05336%	425521	71.65%	192	46.72%
引	454		4	321	0.04838%	425842	73.74%	192	46.72%
像	217		14	680	0.1025%	426522	56.87%	191	46.47%
資	244		13	632	0.09526%	427154	59.56%	191	46.47%
西	310		6	507	0.07642%	427661	65.20%	191	46.47%
顯	435		23	338	0.05094%	427999	72.80%	191	46.47%
共	200		6	716	0.1079%	428715	55.07%	190	46.23%
份	333		6	464	0.06994%	429179	66.86%	190	46.23%
切	405		4	360	0.05426%	429539	71.22%	190	46.23%
交	322		6	475	0.07159%	430014	66.08%	189	45.99%
若	374		9	394	0.05939%	430408	69.48%	189	45.99%
響	391		21	371	0.05592%	430779	70.45%	189	45.99%
條	350		11	431	0.06496%	431210	68.00%	187	45.50%
管	373		14	395	0.05954%	431605	69.42%	187	45.50%
易	399		8	364	0.05486%	431969	70.90%	187	45.50%
步	402		7	362	0.05456%	432331	71.06%	187	45.50%
遠	381		13	385	0.05803%	432716	69.89%	186	45.26%
算	408		14	356	0.05366%	433072	71.38%	186	45.26%
約	415		9	353	0.05321%	433425	71.76%	186	45.26%
似	423		7	349	0.0526%	433774	72.18%	186	45.26%
社	239		7	649	0.09782%	434423	59.08%	185	45.01%
單	338		12	450	0.06783%	434873	67.20%	185	45.01%
建	272		9	577	0.08697%	435450	62.11%	184	44.77%
包	429		5	343	0.0517%	435793	72.49%	184	44.77%
女	113		3	1154	0.1739%	436947	43.38%	183	44.53%
議	179		20	776	0.117%	437723	52.71%	183	44.53%
電	270		13	581	0.08757%	438304	61.93%	183	44.53%
候	300		10	520	0.07838%	438824	64.43%	183	44.53%
據	468		16	309	0.04657%	439133	74.41%	183	44.53%
眼	284		11	564	0.08501%	439697	63.14%	182	44.28%
神	376		9	391	0.05893%	440088	69.59%	182	44.28%
局	252		7	617	0.093%	440705	60.31%	181	44.04%
樂	210		15	696	0.1049%	441401	56.14%	179	43.55%
半	375		5	391	0.05893%	441792	69.54%	179	43.55%
消	393		10	369	0.05562%	442161	70.57%	179	43.55%
你	92		7	1344	0.2026%	443505	39.41%	178	43.31%
運	356		12	421	0.06345%	443926	68.38%	178	43.31%
況	446		8	328	0.04944%	444254	73.35%	178	43.31%
海	269		10	581	0.08757%	444835	61.85%	177	43.07%
金	273		8	577	0.08697%	445412	62.19%	177	43.07%
路	318		13	480	0.07235%	445892	65.80%	177	43.07%
談	386		15	379	0.05712%	446271	70.17%	177	43.07%
讓	462		24	314	0.04733%	446585	74.13%	177	43.07%
首	470		9	309	0.04657%	446894	74.50%	177	43.07%
光	248		6	622	0.09375%	447516	59.94%	176	42.82%
角	389		7	371	0.05592%	447887	70.34%	176	42.82%
裏	178		13	779	0.1174%	448666	52.59%	175	42.58%
例	431		8	340	0.05125%	449006	72.60%	175	42.58%
致	497		9	288	0.04341%	449294	75.70%	175	42.58%
故	366		9	401	0.06044%	449695	69.00%	174	42.34%
書	237		10	659	0.09933%	450354	58.88%	173	42.09%
基	307		11	510	0.07687%	450864	64.97%	172	41.85%
調	385		15	380	0.05728%	451244	70.12%	172	41.85%
落	409		13	356	0.05366%	451600	71.44%	172	41.85%
整	422		16	350	0.05275%	451950	72.13%	172	41.85%
照	427		13	346	0.05215%	452296	72.39%	172	41.85%
張	329		11	470	0.07084%	452766	66.58%	171	41.61%
爭	351		8	429	0.06466%	453195	68.06%	171	41.61%
教	243		11	633	0.09541%	453828	59.47%	170	41.36%
治	280		8	568	0.08561%	454396	62.80%	170	41.36%
快	378		7	389	0.05863%	454785	69.71%	170	41.36%
轉	443		18	331	0.04989%	455116	73.20%	170	41.36%
留	465		10	312	0.04703%	455428	74.27%	170	41.36%
絕	467		12	311	0.04688%	455739	74.36%	170	41.36%
英	228		9	668	0.1007%	456407	57.98%	168	40.88%
字	357		6	419	0.06315%	456826	68.44%	168	40.88%
格	419		10	351	0.0529%	457177	71.97%	168	40.88%
思	379		9	389	0.05863%	457566	69.77%	167	40.63%
義	387		13	376	0.05667%	457942	70.23%	167	40.63%
熱	463		15	313	0.04718%	458255	74.17%	167	40.63%
兒	255		8	612	0.09224%	458867	60.59%	166	40.39%
造	407		10	358	0.05396%	459225	71.33%	166	40.39%
眾	412		11	355	0.05351%	459580	71.60%	166	40.39%
乎	453		5	321	0.04838%	459901	73.69%	166	40.39%
夠	504		11	285	0.04296%	460186	76.00%	166	40.39%
愛	232		13	665	0.1002%	460851	58.39%	165	40.15%
統	313		11	498	0.07506%	461349	65.43%	165	40.15%
支	363		4	408	0.0615%	461757	68.82%	165	40.15%
權	285		22	562	0.08471%	462319	63.22%	164	39.90%
推	461		11	315	0.04748%	462634	74.08%	164	39.90%
底	510		8	280	0.0422%	462914	76.26%	164	39.90%
般	535		10	267	0.04024%	463181	77.29%	164	39.90%
元	283		4	565	0.08516%	463746	63.05%	163	39.66%
象	460		12	316	0.04763%	464062	74.03%	163	39.66%
希	509		7	282	0.0425%	464344	76.22%	163	39.66%
確	543		15	263	0.03964%	464607	77.60%	163	39.66%
隨	564		15	252	0.03798%	464859	78.41%	163	39.66%
務	332		11	466	0.07024%	465325	66.79%	162	39.42%
服	348		8	435	0.06557%	465760	67.87%	162	39.42%
它	365		5	402	0.06059%	466162	68.94%	162	39.42%
精	481		14	296	0.04461%	466458	75.00%	162	39.42%
識	449		19	325	0.04899%	466783	73.50%	161	39.17%
商	314		11	489	0.0737%	467272	65.50%	160	38.93%
空	342		8	439	0.06617%	467711	67.47%	160	38.93%
類	400		19	363	0.05471%	468074	70.95%	160	38.93%
際	437		13	335	0.05049%	468409	72.90%	160	38.93%
低	438		7	334	0.05034%	468743	72.95%	160	38.93%
府	184		8	768	0.1158%	469511	53.29%	159	38.69%
品	262		9	594	0.08953%	470105	61.23%	159	38.69%
初	573		7	248	0.03738%	470353	78.75%	159	38.69%
友	317		4	480	0.07235%	470833	65.72%	158	38.44%
離	388		18	375	0.05652%	471208	70.29%	158	38.44%
告	441		7	331	0.04989%	471539	73.10%	158	38.44%
怎	417		9	352	0.05305%	471891	71.87%	157	38.20%
命	425		8	347	0.0523%	472238	72.29%	157	38.20%
專	459		11	318	0.04793%	472556	73.98%	157	38.20%
願	519		19	276	0.0416%	472832	76.63%	157	38.20%
她	108		6	1208	0.1821%	474040	42.49%	156	37.96%
馬	401		10	363	0.05471%	474403	71.01%	156	37.96%
興	486		16	294	0.04431%	474697	75.22%	156	37.96%
盡	501		14	286	0.04311%	474983	75.87%	156	37.96%
料	528		10	270	0.0407%	475253	77.00%	156	37.96%
聯	309		17	507	0.07642%	475760	65.13%	155	37.71%
設	390		11	371	0.05592%	476131	70.40%	155	37.71%
態	483		14	295	0.04446%	476426	75.09%	155	37.71%
價	355		15	424	0.06391%	476850	68.32%	154	37.47%
輕	458		14	319	0.04808%	477169	73.93%	154	37.47%
段	518		9	276	0.0416%	477445	76.59%	154	37.47%
終	590		11	238	0.03587%	477683	79.37%	154	37.47%
增	447		15	327	0.04929%	478010	73.40%	152	36.98%
免	498		7	287	0.04326%	478297	75.74%	152	36.98%
區	304		11	511	0.07702%	478808	64.74%	151	36.74%
倒	503		10	285	0.04296%	479093	75.96%	151	36.74%
值	602		10	228	0.03437%	479321	79.79%	151	36.74%
花	296		8	524	0.07898%	479845	64.12%	150	36.50%
費	397		12	365	0.05501%	480210	70.79%	150	36.50%
質	476		15	300	0.04522%	480510	74.77%	150	36.50%
稱	601		14	229	0.03452%	480739	79.76%	150	36.50%
寫	383		15	381	0.05743%	481120	70.00%	149	36.25%
住	392		7	369	0.05562%	481489	70.51%	149	36.25%
歡	411		22	355	0.05351%	481844	71.55%	149	36.25%
呢	434		8	338	0.05094%	482182	72.75%	149	36.25%
假	490		11	291	0.04386%	482473	75.39%	149	36.25%
舉	451		17	323	0.04868%	482796	73.60%	148	36.01%
須	487		12	294	0.04431%	483090	75.26%	147	35.77%
請	489		15	293	0.04416%	483383	75.35%	147	35.77%
顧	514		21	278	0.0419%	483661	76.43%	146	35.52%
功	515		5	277	0.04175%	483938	76.47%	146	35.52%
續	536		21	266	0.04009%	484204	77.33%	146	35.52%
息	545		10	261	0.03934%	484465	77.68%	146	35.52%
考	557		6	255	0.03843%	484720	78.15%	146	35.52%
聽	380		22	388	0.05848%	485108	69.83%	145	35.28%
華	403		12	361	0.05441%	485469	71.11%	145	35.28%
竟	496		11	288	0.04341%	485757	75.66%	145	35.28%
試	499		13	287	0.04326%	486044	75.79%	145	35.28%
參	516		11	277	0.04175%	486321	76.51%	145	35.28%
勢	517		13	276	0.0416%	486597	76.55%	145	35.28%
找	533		7	268	0.04039%	486865	77.20%	145	35.28%
台	326		5	472	0.07114%	487337	66.37%	144	35.04%
獨	472		16	302	0.04552%	487639	74.59%	144	35.04%
準	546		13	261	0.03934%	487900	77.72%	144	35.04%
錢	410		16	356	0.05366%	488256	71.49%	143	34.79%
節	439		13	333	0.05019%	488589	73.00%	143	34.79%
廣	445		15	328	0.04944%	488917	73.30%	143	34.79%
具	522		8	272	0.041%	489189	76.76%	143	34.79%
係	544		9	261	0.03934%	489450	77.64%	143	34.79%
邊	330		18	468	0.07054%	489918	66.65%	142	34.55%
線	343		15	438	0.06602%	490356	67.54%	142	34.55%
什	354		4	426	0.06421%	490782	68.25%	142	34.55%
投	432		7	340	0.05125%	491122	72.65%	142	34.55%
讀	450		22	324	0.04883%	491446	73.55%	142	34.55%
喜	418		12	351	0.0529%	491797	71.92%	141	34.31%
究	494		7	289	0.04356%	492086	75.57%	141	34.31%
辦	531		16	269	0.04054%	492355	77.12%	141	34.31%
擔	568		16	250	0.03768%	492605	78.57%	141	34.31%
客	430		9	341	0.0514%	492946	72.55%	140	34.06%
獲	596		17	233	0.03512%	493179	79.59%	140	34.06%
待	500		9	286	0.04311%	493465	75.83%	139	33.82%
標	542		15	263	0.03964%	493728	77.56%	139	33.82%
久	556		3	255	0.03843%	493983	78.11%	139	33.82%
組	433		11	340	0.05125%	494323	72.70%	138	33.58%
斷	520		18	275	0.04145%	494598	76.68%	138	33.58%
屬	636		21	211	0.0318%	494809	80.93%	138	33.58%
死	424		6	348	0.05245%	495157	72.23%	137	33.33%
境	566		14	251	0.03783%	495408	78.49%	137	33.33%
刻	575		8	246	0.03708%	495654	78.83%	137	33.33%
司	340		5	447	0.06737%	496101	67.34%	136	33.09%
集	521		12	273	0.04115%	496374	76.72%	136	33.09%
嚴	643		20	208	0.03135%	496582	81.15%	136	33.09%
片	395		4	366	0.05517%	496948	70.68%	135	32.85%
親	426		16	347	0.0523%	497295	72.34%	135	32.85%
排	548		11	258	0.03889%	497553	77.80%	135	32.85%
歷	571		16	249	0.03753%	497802	78.68%	135	32.85%
濟	335		17	453	0.06828%	498255	67.00%	134	32.60%
領	523		14	272	0.041%	498527	76.80%	134	32.60%
討	547		10	259	0.03904%	498786	77.76%	134	32.60%
車	263		7	594	0.08953%	499380	61.32%	133	32.36%
存	475		6	300	0.04522%	499680	74.73%	133	32.36%
負	612		9	226	0.03406%	499906	80.14%	133	32.36%
繼	647		20	207	0.0312%	500113	81.27%	133	32.36%
笑	406		10	359	0.05411%	500472	71.28%	132	32.12%
注	605		8	228	0.03437%	500700	79.90%	132	32.12%
差	622		10	220	0.03316%	500920	80.47%	132	32.12%
層	488		15	293	0.04416%	501213	75.31%	131	31.87%
苦	505		9	285	0.04296%	501498	76.04%	131	31.87%
派	420		9	351	0.0529%	501849	72.02%	130	31.63%
團	532		14	268	0.04039%	502117	77.16%	130	31.63%
星	484		9	295	0.04446%	502412	75.13%	129	31.39%
雙	537		18	266	0.04009%	502678	77.37%	129	31.39%
備	627		12	215	0.03241%	502893	80.64%	129	31.39%
謂	660		16	202	0.03045%	503095	81.67%	129	31.39%
叫	444		5	329	0.04959%	503424	73.25%	128	31.14%
導	587		16	239	0.03602%	503663	79.27%	128	31.14%
止	715		4	181	0.02728%	503844	83.25%	128	31.14%
吃	349		6	431	0.06496%	504275	67.93%	127	30.90%
責	569		11	250	0.03768%	504525	78.60%	127	30.90%
破	672		10	198	0.02984%	504723	82.03%	127	30.90%
男	260		7	607	0.09149%	505330	61.05%	126	30.66%
演	372		14	396	0.05969%	505726	69.36%	126	30.66%
青	502		8	286	0.04311%	506012	75.92%	126	30.66%
證	563		19	252	0.03798%	506264	78.38%	126	30.66%
括	668		9	199	0.02999%	506463	81.91%	126	30.66%
買	416		12	353	0.05321%	506816	71.81%	125	30.41%
適	697		14	187	0.02819%	507003	82.75%	125	30.41%
北	455		5	320	0.04823%	507323	73.79%	124	30.17%
跟	492		13	290	0.04371%	507613	75.48%	124	30.17%
夫	534		4	267	0.04024%	507880	77.25%	124	30.17%
驗	574		23	247	0.03723%	508127	78.79%	124	30.17%
背	679		9	193	0.02909%	508320	82.24%	124	30.17%
超	674		12	197	0.02969%	508517	82.09%	123	29.93%
筆	495		12	289	0.04356%	508806	75.61%	122	29.68%
坐	565		7	251	0.03783%	509057	78.45%	122	29.68%
供	579		8	243	0.03663%	509300	78.97%	122	29.68%
紅	440		9	333	0.05019%	509633	73.05%	121	29.44%
居	526		8	270	0.0407%	509903	76.92%	121	29.44%
裝	530		13	269	0.04054%	510172	77.08%	121	29.44%
環	562		17	252	0.03798%	510424	78.34%	121	29.44%
項	598		12	233	0.03512%	510657	79.66%	121	29.44%
錯	619		16	222	0.03346%	510879	80.37%	121	29.44%
紀	631		9	213	0.0321%	511092	80.77%	121	29.44%
維	676		14	196	0.02954%	511288	82.15%	121	29.44%
構	682		14	192	0.02894%	511480	82.33%	121	29.44%
依	693		8	188	0.02834%	511668	82.64%	121	29.44%
害	718		10	180	0.02713%	511848	83.33%	121	29.44%
簡	756		18	165	0.02487%	512013	84.32%	121	29.44%
案	394		10	366	0.05517%	512379	70.62%	120	29.20%
院	404		9	361	0.05441%	512740	71.17%	120	29.20%
怕	576		8	245	0.03693%	512985	78.86%	120	29.20%
停	629		11	213	0.0321%	513198	80.70%	120	29.20%
緊	654		14	205	0.0309%	513403	81.49%	120	29.20%
肯	655		8	205	0.0309%	513608	81.52%	120	29.20%
誰	513		15	279	0.04205%	513887	76.38%	119	28.95%
素	554		10	257	0.03874%	514144	78.03%	119	28.95%
奇	614		8	224	0.03376%	514368	80.21%	119	28.95%
壓	508		17	283	0.04265%	514651	76.17%	118	28.71%
策	512		12	279	0.04205%	514930	76.34%	118	28.71%
益	582		10	242	0.03648%	515172	79.08%	118	28.71%
漸	588		14	239	0.03602%	515411	79.30%	118	28.71%
餘	698		15	187	0.02819%	515598	82.78%	118	28.71%
疑	725		14	178	0.02683%	515776	83.52%	118	28.71%
嗎	551		13	257	0.03874%	516033	77.92%	117	28.47%
景	615		12	223	0.03361%	516256	80.24%	117	28.47%
助	683		7	191	0.02879%	516447	82.35%	117	28.47%
山	301		3	514	0.07747%	516961	64.51%	116	28.22%
飛	539		9	264	0.03979%	517225	77.45%	116	28.22%
句	620		5	221	0.03331%	517446	80.41%	116	28.22%
古	482		5	295	0.04446%	517741	75.04%	115	27.98%
級	589		10	239	0.03602%	517980	79.34%	115	27.98%
歲	592		13	237	0.03572%	518217	79.44%	115	27.98%
布	595		5	234	0.03527%	518451	79.55%	115	27.98%
語	621		14	221	0.03331%	518672	80.44%	115	27.98%
露	720		21	180	0.02713%	518852	83.39%	115	27.98%
黑	452		12	322	0.04853%	519174	73.65%	114	27.74%
晚	586		11	240	0.03617%	519414	79.23%	114	27.74%
細	663		11	201	0.0303%	519615	81.76%	114	27.74%
短	671		12	198	0.02984%	519813	82.00%	114	27.74%
充	755		5	165	0.02487%	519978	84.29%	114	27.74%
術	428		11	345	0.052%	520323	72.44%	113	27.49%
越	442		12	331	0.04989%	520654	73.15%	113	27.49%
味	584		8	240	0.03617%	520894	79.16%	113	27.49%
念	640		8	209	0.0315%	521103	81.05%	113	27.49%
史	646		5	207	0.0312%	521310	81.24%	113	27.49%
善	694		12	188	0.02834%	521498	82.67%	113	27.49%
良	773		7	160	0.02412%	521658	84.74%	113	27.49%
音	347		9	437	0.06587%	522095	67.80%	112	27.25%
南	474		9	301	0.04537%	522396	74.68%	112	27.25%
職	529		18	269	0.04054%	522665	77.04%	112	27.25%
換	649		12	206	0.03105%	522871	81.33%	112	27.25%
拿	652		10	205	0.0309%	523076	81.43%	112	27.25%
突	787		9	156	0.02351%	523232	85.07%	112	27.25%
朋	480		8	296	0.04461%	523528	74.95%	111	27.01%
師	506		10	284	0.04281%	523812	76.09%	111	27.01%
型	658		9	202	0.03045%	524014	81.61%	111	27.01%
評	688		12	191	0.02879%	524205	82.50%	111	27.01%
衣	485		6	295	0.04446%	524500	75.17%	110	26.76%
戰	561		16	252	0.03798%	524752	78.30%	110	26.76%
圖	585		14	240	0.03617%	524992	79.19%	110	26.76%
效	604		10	228	0.03437%	525220	79.86%	110	26.76%
承	690		8	190	0.02864%	525410	82.56%	110	26.76%
科	524		9	271	0.04085%	525681	76.84%	109	26.52%
修	641		10	208	0.03135%	525889	81.08%	109	26.52%
均	737		7	171	0.02577%	526060	83.84%	109	26.52%
呼	783		8	157	0.02366%	526217	84.97%	109	26.52%
委	382		8	384	0.05788%	526601	69.94%	108	26.28%
吧	594		7	234	0.03527%	526835	79.52%	108	26.28%
預	635		13	212	0.03195%	527047	80.89%	108	26.28%
養	695		15	188	0.02834%	527235	82.70%	108	26.28%
某	723		9	179	0.02698%	527414	83.47%	108	26.28%
積	750		16	168	0.02532%	527582	84.17%	108	26.28%
置	767		13	162	0.02442%	527744	84.59%	108	26.28%
講	572		17	249	0.03753%	527993	78.72%	107	26.03%
查	581		9	243	0.03663%	528236	79.05%	107	26.03%
退	611		9	227	0.03421%	528463	80.10%	107	26.03%
施	624		9	219	0.03301%	528682	80.54%	107	26.03%
規	637		11	211	0.0318%	528893	80.96%	107	26.03%
周	681		8	192	0.02894%	529085	82.30%	107	26.03%
亂	743		13	169	0.02547%	529254	83.99%	107	26.03%
慮	765		15	162	0.02442%	529416	84.54%	107	26.03%
火	493		4	289	0.04356%	529705	75.53%	106	25.79%
劃	550		14	257	0.03874%	529962	77.88%	106	25.79%
透	740		10	171	0.02577%	530133	83.91%	106	25.79%
官	491		8	291	0.04386%	530424	75.44%	105	25.55%
傷	511		13	279	0.04205%	530703	76.30%	105	25.55%
號	608		13	228	0.03437%	530931	80.00%	105	25.55%
付	721		5	179	0.02698%	531110	83.42%	105	25.55%
懷	766		19	162	0.02442%	531272	84.57%	105	25.55%
批	625		7	217	0.03271%	531489	80.57%	104	25.30%
異	815		11	149	0.02246%	531638	85.71%	104	25.30%
食	360		9	410	0.0618%	532048	68.63%	103	25.06%
群	632		13	213	0.0321%	532261	80.80%	103	25.06%
升	645		4	207	0.0312%	532468	81.21%	103	25.06%
習	686		11	191	0.02879%	532659	82.44%	103	25.06%
訴	736		12	172	0.02592%	532831	83.81%	103	25.06%
趣	738		15	171	0.02577%	533002	83.86%	103	25.06%
限	748		8	169	0.02547%	533171	84.12%	103	25.06%
既	759		9	164	0.02472%	533335	84.39%	103	25.06%
列	818		6	148	0.02231%	533483	85.78%	103	25.06%
溫	469		13	309	0.04657%	533792	74.45%	102	24.82%
病	507		10	284	0.04281%	534076	76.13%	102	24.82%
採	653		11	205	0.0309%	534281	81.46%	102	24.82%
冷	741		7	170	0.02562%	534451	83.94%	102	24.82%
答	746		12	169	0.02547%	534620	84.07%	102	24.82%
缺	752		10	167	0.02517%	534787	84.22%	102	24.82%
避	796		16	154	0.02321%	534941	85.28%	102	24.82%
途	867		10	137	0.02065%	535078	86.82%	102	24.82%
印	642		6	208	0.03135%	535286	81.11%	101	24.57%
吸	665		7	200	0.03014%	535486	81.82%	101	24.57%
舊	691		18	189	0.02849%	535675	82.58%	101	24.57%
房	384		8	380	0.05728%	536055	70.06%	100	24.33%
斯	479		12	296	0.04461%	536351	74.91%	100	24.33%
研	650		9	206	0.03105%	536557	81.36%	100	24.33%
拉	667		8	200	0.03014%	536757	81.88%	100	24.33%
賣	696		15	187	0.02819%	536944	82.73%	100	24.33%
富	724		12	178	0.02683%	537122	83.50%	100	24.33%
永	745		5	169	0.02547%	537291	84.04%	100	24.33%
林	456		8	320	0.04823%	537611	73.84%	99	24.09%
皮	466		5	312	0.04703%	537923	74.31%	98	23.84%
康	538		11	264	0.03979%	538187	77.41%	98	23.84%
黃	600		12	232	0.03497%	538419	79.73%	98	23.84%
靜	648		16	207	0.0312%	538626	81.30%	98	23.84%
壞	772		19	160	0.02412%	538786	84.71%	98	23.84%
優	791		17	154	0.02321%	538940	85.16%	98	23.84%
圍	798		12	153	0.02306%	539093	85.32%	98	23.84%
尋	809		12	150	0.02261%	539243	85.58%	98	23.84%
驚	863		23	138	0.0208%	539381	86.74%	98	23.84%
班	659		10	202	0.03045%	539583	81.64%	97	23.60%
土	754		3	166	0.02502%	539749	84.27%	97	23.60%
忽	799		8	153	0.02306%	539902	85.35%	97	23.60%
略	814		11	149	0.02246%	540051	85.69%	97	23.60%
紙	651		10	206	0.03105%	540257	81.40%	96	23.36%
聞	687		14	191	0.02879%	540448	82.47%	96	23.36%
微	714		13	181	0.02728%	540629	83.23%	96	23.36%
熟	852		15	140	0.0211%	540769	86.51%	96	23.36%
觸	861		20	138	0.0208%	540907	86.70%	96	23.36%
陸	617		10	223	0.03361%	541130	80.31%	95	23.11%
城	630		9	213	0.0321%	541343	80.73%	95	23.11%
德	670		15	198	0.02984%	541541	81.97%	95	23.11%
怪	701		8	185	0.02788%	541726	82.87%	95	23.11%
製	712		14	182	0.02743%	541908	83.17%	95	23.11%
烈	742		10	170	0.02562%	542078	83.97%	95	23.11%
律	764		9	162	0.02442%	542240	84.52%	95	23.11%
送	739		9	171	0.02577%	542411	83.89%	94	22.87%
密	758		11	164	0.02472%	542575	84.37%	94	22.87%
堅	808		11	150	0.02261%	542725	85.55%	94	22.87%
模	821		15	148	0.02231%	542873	85.85%	94	22.87%
育	525		7	271	0.04085%	543144	76.88%	93	22.63%
勝	774		12	159	0.02397%	543303	84.76%	93	22.63%
守	839		6	142	0.0214%	543445	86.24%	93	22.63%
順	853		12	140	0.0211%	543585	86.53%	93	22.63%
按	898		9	128	0.01929%	543713	87.44%	93	22.63%
站	597		10	233	0.03512%	543946	79.62%	92	22.38%
福	618		13	222	0.03346%	544168	80.34%	92	22.38%
血	626		6	216	0.03256%	544384	80.60%	92	22.38%
減	628		12	214	0.03226%	544598	80.67%	92	22.38%
宣	768		9	161	0.02427%	544759	84.61%	92	22.38%
執	832		11	143	0.02155%	544902	86.09%	92	22.38%
遇	841		12	142	0.0214%	545044	86.28%	92	22.38%
困	922		7	123	0.01854%	545167	87.90%	92	22.38%
尤	926		4	122	0.01839%	545289	87.97%	92	22.38%
遊	593		12	235	0.03542%	545524	79.48%	91	22.14%
拍	708		8	184	0.02773%	545708	83.06%	91	22.14%
沙	734		7	172	0.02592%	545880	83.76%	91	22.14%
席	555		10	256	0.03859%	546136	78.07%	90	21.90%
夜	580		8	243	0.03663%	546379	79.01%	90	21.90%
雨	609		8	228	0.03437%	546607	80.04%	90	21.90%
器	633		16	212	0.03195%	546819	80.83%	90	21.90%
協	656		8	204	0.03075%	547023	81.55%	90	21.90%
楚	835		13	143	0.02155%	547166	86.15%	90	21.90%
掉	848		11	140	0.0211%	547306	86.43%	90	21.90%
腳	859		13	138	0.0208%	547444	86.66%	90	21.90%
貴	874		12	136	0.0205%	547580	86.97%	90	21.90%
予	897		4	128	0.01929%	547708	87.42%	90	21.90%
陽	473		11	302	0.04552%	548010	74.64%	89	21.65%
巴	527		4	270	0.0407%	548280	76.96%	89	21.65%
急	812		9	149	0.02246%	548429	85.64%	89	21.65%
速	838		10	143	0.02155%	548572	86.21%	89	21.65%
擊	850		17	140	0.0211%	548712	86.47%	89	21.65%
擇	869		16	136	0.0205%	548848	86.86%	89	21.65%
穿	709		9	183	0.02758%	549031	83.09%	88	21.41%
宜	843		8	141	0.02125%	549172	86.32%	88	21.41%
雜	855		18	139	0.02095%	549311	86.57%	88	21.41%
幸	901		8	127	0.01914%	549438	87.50%	88	21.41%
軍	559		9	254	0.03828%	549692	78.22%	87	21.17%
休	729		6	174	0.02623%	549866	83.63%	87	21.17%
創	749		12	168	0.02532%	550034	84.14%	87	21.17%
腦	803		13	152	0.02291%	550186	85.44%	87	21.17%
沉	813		7	149	0.02246%	550335	85.67%	87	21.17%
追	826		9	145	0.02186%	550480	85.95%	87	21.17%
唯	953		11	116	0.01748%	550596	88.46%	87	21.17%
套	954		10	116	0.01748%	550712	88.47%	87	21.17%
克	421		7	350	0.05275%	551062	72.08%	86	20.92%
概	810		13	150	0.02261%	551212	85.60%	86	20.92%
移	816		11	149	0.02246%	551361	85.73%	86	20.92%
配	879		10	135	0.02035%	551496	87.07%	86	20.92%
惜	917		11	124	0.01869%	551620	87.80%	86	20.92%
棄	939		11	120	0.01809%	551740	88.21%	86	20.92%
復	955		12	116	0.01748%	551856	88.49%	86	20.92%
李	477		7	299	0.04507%	552155	74.82%	85	20.68%
灣	578		25	245	0.03693%	552400	78.94%	85	20.68%
豐	583		18	241	0.03632%	552641	79.12%	85	20.68%
玩	616		8	223	0.03361%	552864	80.27%	85	20.68%
街	711		12	182	0.02743%	553046	83.14%	85	20.68%
零	804		13	152	0.02291%	553198	85.46%	85	20.68%
章	825		11	145	0.02186%	553343	85.93%	85	20.68%
擁	849		16	140	0.0211%	553483	86.45%	85	20.68%
迎	957		7	116	0.01748%	553599	88.53%	85	20.68%
激	965		16	115	0.01733%	553714	88.66%	85	20.68%
石	606		5	228	0.03437%	553942	79.93%	84	20.44%
亞	644		8	207	0.0312%	554149	81.18%	84	20.44%
率	662		11	201	0.0303%	554350	81.73%	84	20.44%
痛	727		12	177	0.02668%	554527	83.58%	84	20.44%
副	786		11	156	0.02351%	554683	85.05%	84	20.44%
毛	822		4	148	0.02231%	554831	85.87%	84	20.44%
散	824		12	145	0.02186%	554976	85.91%	84	20.44%
險	862		15	138	0.0208%	555114	86.72%	84	20.44%
歸	888		18	130	0.01959%	555244	87.25%	84	20.44%
忘	908		7	126	0.01899%	555370	87.63%	84	20.44%
述	912		8	125	0.01884%	555495	87.71%	84	20.44%
靈	913		24	125	0.01884%	555620	87.73%	84	20.44%
慣	918		14	124	0.01869%	555744	87.82%	84	20.44%
替	980		12	111	0.01673%	555855	88.92%	84	20.44%
樓	549		15	258	0.03889%	556113	77.84%	83	20.19%
系	719		7	180	0.02713%	556293	83.36%	83	20.19%
財	726		10	178	0.02683%	556471	83.55%	83	20.19%
午	775		4	159	0.02397%	556630	84.78%	83	20.19%
鐘	846		20	141	0.02125%	556771	86.39%	83	20.19%
威	915		9	124	0.01869%	556895	87.77%	83	20.19%
普	938		12	120	0.01809%	557015	88.19%	83	20.19%
脫	1005		11	108	0.01628%	557123	89.33%	83	20.19%
孩	552		9	257	0.03874%	557380	77.95%	82	19.95%
技	675		7	196	0.02954%	557576	82.12%	82	19.95%
左	706		5	184	0.02773%	557760	83.01%	82	19.95%
飯	753		12	167	0.02517%	557927	84.25%	82	19.95%
座	777		10	159	0.02397%	558086	84.83%	82	19.95%
享	856		8	138	0.0208%	558224	86.60%	82	19.95%
右	885		5	131	0.01974%	558355	87.19%	82	19.95%
尚	931		8	121	0.01824%	558476	88.06%	82	19.95%
附	943		7	119	0.01794%	558595	88.28%	82	19.95%
衝	956		15	116	0.01748%	558711	88.51%	82	19.95%
損	1002		13	108	0.01628%	558819	89.28%	82	19.95%
黨	371		20	397	0.05984%	559216	69.30%	81	19.71%
護	599		21	232	0.03497%	559448	79.69%	81	19.71%
款	669		12	199	0.02999%	559647	81.94%	81	19.71%
控	840		11	142	0.0214%	559789	86.26%	81	19.71%
剛	864		10	137	0.02065%	559926	86.76%	81	19.71%
納	871		10	136	0.0205%	560062	86.91%	81	19.71%
誤	873		14	136	0.0205%	560198	86.95%	81	19.71%
察	881		14	133	0.02005%	560331	87.11%	81	19.71%
懂	893		17	129	0.01944%	560460	87.35%	81	19.71%
翻	925		18	123	0.01854%	560583	87.95%	81	19.71%
恐	994		10	109	0.01643%	560692	89.15%	81	19.71%
京	591		8	237	0.03572%	560929	79.41%	80	19.46%
防	811		6	150	0.02261%	561079	85.62%	80	19.46%
波	876		8	135	0.02035%	561214	87.01%	80	19.46%
源	877		13	135	0.02035%	561349	87.03%	80	19.46%
凡	951		3	116	0.01748%	561465	88.42%	80	19.46%
狀	984		8	111	0.01673%	561576	88.99%	80	19.46%
藝	558		19	254	0.03828%	561830	78.19%	79	19.22%
購	661		17	202	0.03045%	562032	81.70%	79	19.22%
探	785		11	157	0.02366%	562189	85.02%	79	19.22%
額	805		18	152	0.02291%	562341	85.49%	79	19.22%
錄	967		16	115	0.01733%	562456	88.70%	79	19.22%
敢	979		12	111	0.01673%	562567	88.90%	79	19.22%
掌	1001		12	108	0.01628%	562675	89.27%	79	19.22%
招	1020		8	104	0.01568%	562779	89.57%	79	19.22%
營	684		17	191	0.02879%	562970	82.38%	78	18.98%
草	732		10	173	0.02608%	563143	83.71%	78	18.98%
臉	747		17	169	0.02547%	563312	84.09%	78	18.98%
陣	899		9	128	0.01929%	563440	87.46%	78	18.98%
佔	900		7	127	0.01914%	563567	87.48%	78	18.98%
介	921		4	123	0.01854%	563690	87.88%	78	18.98%
亮	933		9	120	0.01809%	563810	88.10%	78	18.98%
逐	987		10	111	0.01673%	563921	89.04%	78	18.98%
銀	471		14	303	0.04567%	564224	74.55%	77	18.73%
革	639		9	211	0.0318%	564435	81.02%	77	18.73%
爾	760		14	164	0.02472%	564599	84.42%	77	18.73%
誠	896		13	129	0.01944%	564728	87.40%	77	18.73%
映	903		9	127	0.01914%	564855	87.54%	77	18.73%
揮	947		12	117	0.01763%	564972	88.35%	77	18.73%
幫	961		17	115	0.01733%	565087	88.59%	77	18.73%
弱	962		10	115	0.01733%	565202	88.61%	77	18.73%
朝	975		12	112	0.01688%	565314	88.83%	77	18.73%
擺	1037		18	100	0.01507%	565414	89.83%	77	18.73%
票	553		11	257	0.03874%	565671	77.99%	76	18.49%
店	603		8	228	0.03437%	565899	79.83%	76	18.49%
戲	710		17	182	0.02743%	566081	83.12%	76	18.49%
鐵	797		21	154	0.02321%	566235	85.30%	76	18.49%
洲	802		9	152	0.02291%	566387	85.42%	76	18.49%
夢	819		14	148	0.02231%	566535	85.80%	76	18.49%
室	823		9	146	0.02201%	566681	85.89%	76	18.49%
階	827		11	145	0.02186%	566826	85.98%	76	18.49%
旁	834		10	143	0.02155%	566969	86.13%	76	18.49%
哪	875		10	135	0.02035%	567104	86.99%	76	18.49%
賞	892		15	130	0.01959%	567234	87.33%	76	18.49%
幹	968		13	114	0.01718%	567348	88.72%	76	18.49%
毫	981		11	111	0.01673%	567459	88.94%	76	18.49%
訪	771		11	161	0.02427%	567620	84.69%	75	18.25%
庭	776		10	159	0.02397%	567779	84.81%	75	18.25%
暗	858		13	138	0.0208%	567917	86.64%	75	18.25%
抗	865		7	137	0.02065%	568054	86.78%	75	18.25%
私	870		7	136	0.0205%	568190	86.89%	75	18.25%
偶	883		11	132	0.0199%	568322	87.15%	75	18.25%
耳	942		6	119	0.01794%	568441	88.26%	75	18.25%
釋	958		20	116	0.01748%	568557	88.54%	75	18.25%
股	448		8	326	0.04914%	568883	73.45%	74	18.00%
球	623		11	220	0.03316%	569103	80.51%	74	18.00%
省	788		9	155	0.02336%	569258	85.09%	74	18.00%
堂	792		11	154	0.02321%	569412	85.19%	74	18.00%
浪	889		10	130	0.01959%	569542	87.27%	74	18.00%
健	992		11	109	0.01643%	569651	89.12%	74	18.00%
羅	478		19	297	0.04477%	569948	74.86%	73	17.76%
勞	664		12	200	0.03014%	570148	81.79%	73	17.76%
江	779		6	159	0.02397%	570307	84.88%	73	17.76%
殺	780		11	158	0.02381%	570465	84.90%	73	17.76%
陳	806		10	151	0.02276%	570616	85.51%	73	17.76%
麗	854		19	140	0.0211%	570756	86.55%	73	17.76%
忙	916		6	124	0.01869%	570880	87.78%	73	17.76%
序	974		7	112	0.01688%	570992	88.82%	73	17.76%
畢	985		11	111	0.01673%	571103	89.00%	73	17.76%
鼓	1026		13	104	0.01568%	571207	89.66%	73	17.76%
固	1030		8	102	0.01537%	571309	89.73%	73	17.76%
靠	1068		15	96	0.01447%	571405	90.29%	73	17.76%
警	613		20	225	0.03391%	571630	80.17%	72	17.52%
母	673		5	197	0.02969%	571827	82.06%	72	17.52%
雲	731		12	174	0.02623%	572001	83.68%	72	17.52%
牌	794		12	154	0.02321%	572155	85.23%	72	17.52%
慢	829		14	144	0.0217%	572299	86.02%	72	17.52%
僅	884		13	131	0.01974%	572430	87.17%	72	17.52%
尊	1000		12	108	0.01628%	572538	89.25%	72	17.52%
淡	1017		11	105	0.01583%	572643	89.52%	72	17.52%
臨	1046		17	99	0.01492%	572742	89.97%	72	17.52%
校	541		10	263	0.03964%	573005	77.52%	71	17.27%
洋	677		9	195	0.02939%	573200	82.18%	71	17.27%
屋	678		9	193	0.02909%	573393	82.21%	71	17.27%
酒	728		10	176	0.02653%	573569	83.60%	71	17.27%
莫	770		11	161	0.02427%	573730	84.66%	71	17.27%
碼	831		15	144	0.0217%	573874	86.06%	71	17.27%
估	934		7	120	0.01809%	573994	88.12%	71	17.27%
禁	940		13	120	0.01809%	574114	88.22%	71	17.27%
端	1009		14	107	0.01613%	574221	89.40%	71	17.27%
握	1089		12	92	0.01387%	574313	90.59%	71	17.27%
劇	436		15	336	0.05064%	574649	72.85%	70	17.03%
迷	801		9	153	0.02306%	574802	85.39%	70	17.03%
油	851		8	140	0.0211%	574942	86.49%	70	17.03%
龍	887		16	131	0.01974%	575073	87.23%	70	17.03%
訂	895		9	129	0.01944%	575202	87.38%	70	17.03%
搞	978		13	111	0.01673%	575313	88.88%	70	17.03%
抱	1016		8	105	0.01583%	575418	89.51%	70	17.03%
隔	1040		12	100	0.01507%	575518	89.88%	70	17.03%
藏	1060		18	97	0.01462%	575615	90.17%	70	17.03%
愈	634		13	212	0.03195%	575827	80.86%	69	16.79%
售	666		11	200	0.03014%	576027	81.85%	69	16.79%
園	722		13	179	0.02698%	576206	83.44%	69	16.79%
跑	837		12	143	0.02155%	576349	86.19%	69	16.79%
跳	972		13	113	0.01703%	576462	88.78%	69	16.79%
禮	986		17	111	0.01673%	576573	89.02%	69	16.79%
趕	1023		14	104	0.01568%	576677	89.62%	69	16.79%
志	1041		7	99	0.01492%	576776	89.89%	69	16.79%
硬	1058		12	97	0.01462%	576873	90.14%	69	16.79%
隊	700		11	186	0.02803%	577059	82.84%	68	16.55%
頓	790		13	155	0.02336%	577214	85.14%	68	16.55%
互	1054		4	97	0.01462%	577311	90.09%	68	16.55%
穩	1090		19	92	0.01387%	577403	90.60%	68	16.55%
鬆	1106		18	90	0.01357%	577493	90.82%	68	16.55%
醫	638		18	211	0.0318%	577704	80.99%	67	16.30%
木	762		4	163	0.02457%	577867	84.47%	67	16.30%
彈	778		15	159	0.02397%	578026	84.86%	67	16.30%
睡	795		14	154	0.02321%	578180	85.25%	67	16.30%
里	842		7	142	0.0214%	578322	86.30%	67	16.30%
昨	945		9	118	0.01779%	578440	88.31%	67	16.30%
忍	963		7	115	0.01733%	578555	88.63%	67	16.30%
載	1024		13	104	0.01568%	578659	89.63%	67	16.30%
努	1062		7	96	0.01447%	578755	90.20%	67	16.30%
榮	1064		14	96	0.01447%	578851	90.23%	67	16.30%
燈	657		16	203	0.0306%	579054	81.58%	66	16.06%
索	928		10	122	0.01839%	579176	88.01%	66	16.06%
敗	996		11	109	0.01643%	579285	89.18%	66	16.06%
乾	999		11	108	0.01628%	579393	89.23%	66	16.06%
緣	1053		15	98	0.01477%	579491	90.07%	66	16.06%
惡	1056		12	97	0.01462%	579588	90.12%	66	16.06%
畫	751		12	167	0.02517%	579755	84.19%	65	15.82%
佳	952		8	116	0.01748%	579871	88.44%	65	15.82%
傾	1107		13	89	0.01341%	579960	90.83%	65	15.82%
迫	1141		8	84	0.01266%	580044	91.27%	65	15.82%
歌	577		14	245	0.03693%	580289	78.90%	64	15.57%
曲	702		6	185	0.02788%	580474	82.89%	64	15.57%
春	733		9	172	0.02592%	580646	83.73%	64	15.57%
隻	757		10	165	0.02487%	580811	84.34%	64	15.57%
床	769		7	161	0.02427%	580972	84.64%	64	15.57%
父	781		4	158	0.02381%	581130	84.93%	64	15.57%
王	782		4	158	0.02381%	581288	84.95%	64	15.57%
判	935		7	120	0.01809%	581408	88.13%	64	15.57%
測	982		12	111	0.01673%	581519	88.95%	64	15.57%
寶	1015		20	105	0.01583%	581624	89.49%	64	15.57%
貼	1034		12	101	0.01522%	581725	89.79%	64	15.57%
鬧	1081		15	94	0.01417%	581819	90.47%	64	15.57%
架	1137		9	84	0.01266%	581903	91.22%	64	15.57%
遍	1159		12	82	0.01236%	581985	91.50%	64	15.57%
署	567		13	251	0.03783%	582236	78.53%	63	15.33%
肉	800		6	153	0.02306%	582389	85.37%	63	15.33%
默	905		16	127	0.01914%	582516	87.58%	63	15.33%
含	969		7	113	0.01703%	582629	88.73%	63	15.33%
潮	1003		15	108	0.01628%	582737	89.30%	63	15.33%
詞	1006		12	108	0.01628%	582845	89.35%	63	15.33%
頂	1036		11	101	0.01522%	582946	89.82%	63	15.33%
寧	1078		14	94	0.01417%	583040	90.43%	63	15.33%
輪	1084		15	93	0.01402%	583133	90.52%	63	15.33%
踏	1123		15	87	0.01311%	583220	91.04%	63	15.33%
掛	1125		11	86	0.01296%	583306	91.07%	63	15.33%
葉	680		13	193	0.02909%	583499	82.27%	62	15.09%
貨	713		11	182	0.02743%	583681	83.20%	62	15.09%
登	830		12	144	0.0217%	583825	86.04%	62	15.09%
塊	911		13	125	0.01884%	583950	87.69%	62	15.09%
漫	919		14	124	0.01869%	584074	87.84%	62	15.09%
犯	932		5	121	0.01824%	584195	88.08%	62	15.09%
紛	990		10	110	0.01658%	584305	89.09%	62	15.09%
危	1083		6	93	0.01402%	584398	90.50%	62	15.09%
啟	744		11	169	0.02547%	584567	84.02%	61	14.84%
舞	866		14	137	0.02065%	584704	86.80%	61	14.84%
幅	973		12	112	0.01688%	584816	88.80%	61	14.84%
銷	998		15	109	0.01643%	584925	89.22%	61	14.84%
篇	1010		15	107	0.01613%	585032	89.41%	61	14.84%
醒	1011		16	107	0.01613%	585139	89.43%	61	14.84%
降	1025		8	104	0.01568%	585243	89.65%	61	14.84%
欣	1028		8	103	0.01552%	585346	89.70%	61	14.84%
鬥	1069		10	96	0.01447%	585442	90.30%	61	14.84%
繁	1095		17	91	0.01372%	585533	90.67%	61	14.84%
盤	1103		15	90	0.01357%	585623	90.78%	61	14.84%
煩	1154		13	82	0.01236%	585705	91.44%	61	14.84%
乏	1203		5	75	0.0113%	585780	92.02%	61	14.84%
織	910		18	126	0.01899%	585906	87.67%	60	14.60%
綠	949		14	117	0.01763%	586023	88.39%	60	14.60%
患	1008		11	107	0.01613%	586130	89.38%	60	14.60%
睛	1022		13	104	0.01568%	586234	89.60%	60	14.60%
刺	1082		8	93	0.01402%	586327	90.49%	60	14.60%
弄	1109		7	89	0.01341%	586416	90.86%	60	14.60%
虛	1127		12	86	0.01296%	586502	91.10%	60	14.60%
阿	570		7	250	0.03768%	586752	78.64%	59	14.36%
童	836		12	143	0.02155%	586895	86.17%	59	14.36%
蓋	971		14	113	0.01703%	587008	88.77%	59	14.36%
補	1047		12	99	0.01492%	587107	89.98%	59	14.36%
挑	1050		9	98	0.01477%	587205	90.03%	59	14.36%
編	1052		15	98	0.01477%	587303	90.06%	59	14.36%
偏	1071		11	95	0.01432%	587398	90.33%	59	14.36%
彩	1098		11	90	0.01357%	587488	90.71%	59	14.36%
搖	1136		13	84	0.01266%	587572	91.21%	59	14.36%
隱	1143		16	84	0.01266%	587656	91.30%	59	14.36%
皆	1145		9	83	0.01251%	587739	91.32%	59	14.36%
符	1248		11	70	0.01055%	587809	92.51%	59	14.36%
婚	560		11	252	0.03798%	588061	78.26%	58	14.11%
煙	716		13	181	0.02728%	588242	83.28%	58	14.11%
蘇	890		20	130	0.01959%	588372	87.29%	58	14.11%
仔	914		5	124	0.01869%	588496	87.75%	58	14.11%
餐	920		16	124	0.01869%	588620	87.86%	58	14.11%
骨	944		10	119	0.01794%	588739	88.30%	58	14.11%
絲	946		12	118	0.01779%	588857	88.33%	58	14.11%
枝	989		8	110	0.01658%	588967	89.07%	58	14.11%
洗	1032		9	101	0.01522%	589068	89.76%	58	14.11%
倍	1086		10	92	0.01387%	589160	90.54%	58	14.11%
厚	1114		9	88	0.01326%	589248	90.93%	58	14.11%
抵	1135		8	84	0.01266%	589332	91.20%	58	14.11%
悲	1162		12	81	0.01221%	589413	91.53%	58	14.11%
遺	1165		15	81	0.01221%	589494	91.57%	58	14.11%
聚	1178		14	79	0.01191%	589573	91.73%	58	14.11%
材	1185		7	78	0.01176%	589651	91.81%	58	14.11%
悉	1206		11	75	0.0113%	589726	92.05%	58	14.11%
封	1228		9	72	0.01085%	589798	92.30%	58	14.11%
阻	1250		7	70	0.01055%	589868	92.53%	58	14.11%
頗	1251		14	70	0.01055%	589938	92.54%	58	14.11%
樹	610		16	227	0.03421%	590165	80.07%	57	13.87%
裡	860		12	138	0.0208%	590303	86.68%	57	13.87%
競	886		20	131	0.01974%	590434	87.21%	57	13.87%
夏	930		10	121	0.01824%	590555	88.04%	57	13.87%
秘	1013		10	106	0.01598%	590661	89.46%	57	13.87%
旅	1042		10	99	0.01492%	590760	89.91%	57	13.87%
齊	1061		14	97	0.01462%	590857	90.19%	57	13.87%
塞	1093		13	91	0.01372%	590948	90.64%	57	13.87%
閒	1142		12	84	0.01266%	591032	91.29%	57	13.87%
干	1194		3	77	0.01161%	591109	91.91%	57	13.87%
番	1209		12	75	0.0113%	591184	92.09%	57	13.87%
涉	1230		10	72	0.01085%	591256	92.32%	57	13.87%
混	1246		11	70	0.01055%	591326	92.49%	57	13.87%
魚	692		11	189	0.02849%	591515	82.61%	56	13.63%
唱	705		11	184	0.02773%	591699	82.98%	56	13.63%
館	761		16	164	0.02472%	591863	84.44%	56	13.63%
武	793		8	154	0.02321%	592017	85.21%	56	13.63%
抽	902		8	127	0.01914%	592144	87.52%	56	13.63%
柔	948		9	117	0.01763%	592261	88.37%	56	13.63%
罪	950		13	117	0.01763%	592378	88.40%	56	13.63%
歐	964		15	115	0.01733%	592493	88.65%	56	13.63%
衛	997		15	109	0.01643%	592602	89.20%	56	13.63%
乘	1029		10	102	0.01537%	592704	89.71%	56	13.63%
舒	1139		12	84	0.01266%	592788	91.25%	56	13.63%
盛	1156		11	82	0.01236%	592870	91.46%	56	13.63%
範	1157		15	82	0.01236%	592952	91.47%	56	13.63%
圓	1161		13	81	0.01221%	593033	91.52%	56	13.63%
促	1188		9	77	0.01161%	593110	91.84%	56	13.63%
諸	1210		15	75	0.0113%	593185	92.10%	56	13.63%
趨	1263		17	69	0.0104%	593254	92.67%	56	13.63%
泛	1299		8	65	0.009797%	593319	93.03%	56	13.63%
課	891		15	130	0.01959%	593449	87.31%	55	13.38%
喝	906		12	126	0.01899%	593575	87.60%	55	13.38%
窗	909		12	126	0.01899%	593701	87.65%	55	13.38%
練	924		15	123	0.01854%	593824	87.93%	55	13.38%
檢	1065		17	96	0.01447%	593920	90.25%	55	13.38%
鄉	1085		11	93	0.01402%	594013	90.53%	55	13.38%
折	1088		7	92	0.01387%	594105	90.57%	55	13.38%
廿	1097		4	90	0.01357%	594195	90.70%	55	13.38%
濃	1102		16	90	0.01357%	594285	90.76%	55	13.38%
束	1111		7	89	0.01341%	594374	90.89%	55	13.38%
針	1113		10	89	0.01341%	594463	90.91%	55	13.38%
亡	1118		3	87	0.01311%	594550	90.98%	55	13.38%
鮮	1132		17	85	0.01281%	594635	91.16%	55	13.38%
薄	1147		17	83	0.01251%	594718	91.35%	55	13.38%
巨	1205		5	75	0.0113%	594793	92.04%	55	13.38%
鏡	868		19	137	0.02065%	594930	86.84%	54	13.14%
族	880		11	134	0.0202%	595064	87.09%	54	13.14%
戶	937		4	120	0.01809%	595184	88.17%	54	13.14%
版	941		8	119	0.01794%	595303	88.24%	54	13.14%
堆	1063		11	96	0.01447%	595399	90.22%	54	13.14%
宗	1087		8	92	0.01387%	595491	90.56%	54	13.14%
智	1126		12	86	0.01296%	595577	91.08%	54	13.14%
幻	1134		4	84	0.01266%	595661	91.19%	54	13.14%
遲	1160		15	82	0.01236%	595743	91.51%	54	13.14%
俗	1170		9	79	0.01191%	595822	91.63%	54	13.14%
嘗	1181		14	78	0.01176%	595900	91.76%	54	13.14%
揚	1184		12	78	0.01176%	595978	91.80%	54	13.14%
罷	1187		15	78	0.01176%	596056	91.83%	54	13.14%
擴	1195		18	77	0.01161%	596133	91.93%	54	13.14%
複	1202		14	76	0.01146%	596209	92.01%	54	13.14%
妙	1252		7	69	0.0104%	596278	92.55%	54	13.14%
陷	1291		10	66	0.009948%	596344	92.95%	54	13.14%
藉	1360		18	59	0.008893%	596403	93.60%	54	13.14%
督	730		13	174	0.02623%	596577	83.66%	53	12.90%
億	817		15	148	0.02231%	596725	85.76%	53	12.90%
藥	878		19	135	0.02035%	596860	87.05%	53	12.90%
野	959		11	116	0.01748%	596976	88.56%	53	12.90%
婦	970		11	113	0.01703%	597089	88.75%	53	12.90%
牙	1004		4	108	0.01628%	597197	89.31%	53	12.90%
板	1027		8	103	0.01552%	597300	89.68%	53	12.90%
訊	1033		10	101	0.01522%	597401	89.77%	53	12.90%
髮	1049		15	99	0.01492%	597500	90.01%	53	12.90%
伴	1092		7	91	0.01372%	597591	90.63%	53	12.90%
染	1119		9	87	0.01311%	597678	90.99%	53	12.90%
純	1176		10	79	0.01191%	597757	91.70%	53	12.90%
稍	1339		12	61	0.009194%	597818	93.41%	53	12.90%
廠	833		15	143	0.02155%	597961	86.11%	52	12.65%
淚	1066		11	96	0.01447%	598057	90.26%	52	12.65%
縮	1075		17	95	0.01432%	598152	90.39%	52	12.65%
彷	1129		7	85	0.01281%	598237	91.12%	52	12.65%
偉	1150		11	82	0.01236%	598319	91.39%	52	12.65%
寄	1222		11	73	0.011%	598392	92.23%	52	12.65%
軟	1273		11	68	0.01025%	598460	92.77%	52	12.65%
橫	1286		16	66	0.009948%	598526	92.90%	52	12.65%
儘	1304		16	64	0.009646%	598590	93.08%	52	12.65%
米	685		6	191	0.02879%	598781	82.41%	51	12.41%
河	882		8	133	0.02005%	598914	87.13%	51	12.41%
牛	894		4	129	0.01944%	599043	87.37%	51	12.41%
央	977		5	111	0.01673%	599154	88.87%	51	12.41%
藍	991		18	110	0.01658%	599264	89.10%	51	12.41%
訓	1091		10	92	0.01387%	599356	90.61%	51	12.41%
裁	1180		12	79	0.01191%	599435	91.75%	51	12.41%
巧	1182		5	78	0.01176%	599513	91.77%	51	12.41%
借	1189		10	77	0.01161%	599590	91.86%	51	12.41%
姿	1193		9	77	0.01161%	599667	91.90%	51	12.41%
麻	1198		11	77	0.01161%	599744	91.96%	51	12.41%
暴	1258		15	69	0.0104%	599813	92.61%	51	12.41%
耐	1261		9	69	0.0104%	599882	92.65%	51	12.41%
欲	1298		11	65	0.009797%	599947	93.02%	51	12.41%
核	699		10	186	0.02803%	600133	82.81%	50	12.17%
雄	904		12	127	0.01914%	600260	87.56%	50	12.17%
州	907		6	126	0.01899%	600386	87.61%	50	12.17%
賺	1067		17	96	0.01447%	600482	90.27%	50	12.17%
暫	1099		15	90	0.01357%	600572	90.72%	50	12.17%
吹	1128		7	85	0.01281%	600657	91.11%	50	12.17%
典	1199		8	76	0.01146%	600733	91.97%	50	12.17%
渡	1225		12	73	0.011%	600806	92.26%	50	12.17%
浮	1245		10	70	0.01055%	600876	92.48%	50	12.17%
疲	1260		10	69	0.0104%	600945	92.64%	50	12.17%
閉	1303		11	65	0.009797%	601010	93.07%	50	12.17%
卡	1019		5	104	0.01568%	601114	89.55%	49	11.92%
妻	1094		8	91	0.01372%	601205	90.66%	49	11.92%
辛	1158		7	82	0.01236%	601287	91.49%	49	11.92%
廳	1171		25	79	0.01191%	601366	91.64%	49	11.92%
涼	1197		11	77	0.01161%	601443	91.95%	49	11.92%
嘴	1214		15	74	0.01115%	601517	92.14%	49	11.92%
徵	1224		15	73	0.011%	601590	92.25%	49	11.92%
憑	1243		16	70	0.01055%	601660	92.46%	49	11.92%
幕	1278		14	67	0.0101%	601727	92.82%	49	11.92%
析	1328		8	62	0.009345%	601789	93.31%	49	11.92%
徹	1356		14	59	0.008893%	601848	93.56%	49	11.92%
島	847		10	140	0.0211%	601988	86.41%	48	11.68%
企	857		6	138	0.0208%	602126	86.62%	48	11.68%
滋	1043		12	99	0.01492%	602225	89.92%	48	11.68%
倫	1070		10	95	0.01432%	602320	90.32%	48	11.68%
村	1100		7	90	0.01357%	602410	90.74%	48	11.68%
救	1196		11	77	0.01161%	602487	91.94%	48	11.68%
孤	1266		8	68	0.01025%	602555	92.70%	48	11.68%
旦	1269		5	68	0.01025%	602623	92.73%	48	11.68%
彼	1343		8	60	0.009043%	602683	93.44%	48	11.68%
怨	1344		9	60	0.009043%	602743	93.45%	48	11.68%
狂	1348		7	60	0.009043%	602803	93.49%	48	11.68%
讚	1351		26	60	0.009043%	602863	93.52%	48	11.68%
泥	1057		8	97	0.01462%	602960	90.13%	47	11.44%
殊	1101		10	90	0.01357%	603050	90.75%	47	11.44%
珠	1115		10	88	0.01326%	603138	90.94%	47	11.44%
詢	1116		13	88	0.01326%	603226	90.95%	47	11.44%
杯	1130		8	85	0.01281%	603311	91.13%	47	11.44%
寂	1133		11	84	0.01266%	603395	91.17%	47	11.44%
距	1140		12	84	0.01266%	603479	91.26%	47	11.44%
粉	1175		10	79	0.01191%	603558	91.69%	47	11.44%
績	1177		17	79	0.01191%	603637	91.71%	47	11.44%
博	1191		12	77	0.01161%	603714	91.88%	47	11.44%
彿	1216		8	74	0.01115%	603788	92.16%	47	11.44%
扮	1229		7	72	0.01085%	603860	92.31%	47	11.44%
孔	1233		4	71	0.0107%	603931	92.35%	47	11.44%
爆	1283		19	67	0.0101%	603998	92.87%	47	11.44%
奪	1294		14	65	0.009797%	604063	92.98%	47	11.44%
冒	1305		9	64	0.009646%	604127	93.09%	47	11.44%
播	1334		15	61	0.009194%	604188	93.36%	47	11.44%
勵	1379		17	57	0.008591%	604245	93.76%	47	11.44%
兼	1435		10	53	0.007988%	604298	94.23%	47	11.44%
秋	735		9	172	0.02592%	604470	83.79%	46	11.19%
障	976		13	112	0.01688%	604582	88.85%	46	11.19%
圈	1014		11	105	0.01583%	604687	89.48%	46	11.19%
呀	1055		7	97	0.01462%	604784	90.10%	46	11.19%
緩	1059		15	97	0.01462%	604881	90.16%	46	11.19%
恨	1080		9	94	0.01417%	604975	90.46%	46	11.19%
罵	1146		15	83	0.01251%	605058	91.34%	46	11.19%
皇	1174		9	79	0.01191%	605137	91.68%	46	11.19%
灰	1208		6	75	0.0113%	605212	92.07%	46	11.19%
屆	1234		8	71	0.0107%	605283	92.36%	46	11.19%
徑	1255		10	69	0.0104%	605352	92.58%	46	11.19%
憶	1257		16	69	0.0104%	605421	92.60%	46	11.19%
袋	1272		11	68	0.01025%	605489	92.76%	46	11.19%
辯	1274		21	68	0.01025%	605557	92.78%	46	11.19%
准	1292		10	65	0.009797%	605622	92.96%	46	11.19%
抑	1333		7	61	0.009194%	605683	93.35%	46	11.19%
震	1377		15	58	0.008742%	605741	93.75%	46	11.19%
疏	1427		11	54	0.008139%	605795	94.16%	46	11.19%
奏	784		9	157	0.02366%	605952	85.00%	45	10.95%
蘭	872		21	136	0.0205%	606088	86.93%	45	10.95%
尼	1031		5	102	0.01537%	606190	89.74%	45	10.95%
甘	1073		5	95	0.01432%	606285	90.36%	45	10.95%
胡	1121		9	87	0.01311%	606372	91.02%	45	10.95%
茶	1169		10	80	0.01206%	606452	91.62%	45	10.95%
徒	1183		10	78	0.01176%	606530	91.79%	45	10.95%
潛	1201		15	76	0.01146%	606606	91.99%	45	10.95%
拖	1235		8	71	0.0107%	606677	92.37%	45	10.95%
君	1242		7	70	0.01055%	606747	92.45%	45	10.95%
幼	1254		5	69	0.0104%	606816	92.57%	45	10.95%
寬	1267		15	68	0.01025%	606884	92.71%	45	10.95%
漢	1282		14	67	0.0101%	606951	92.86%	45	10.95%
窮	1301		15	65	0.009797%	607016	93.05%	45	10.95%
祖	1310		9	64	0.009646%	607080	93.13%	45	10.95%
衡	1312		16	64	0.009646%	607144	93.15%	45	10.95%
辭	1314		19	64	0.009646%	607208	93.17%	45	10.95%
陰	1323		10	63	0.009496%	607271	93.26%	45	10.95%
貌	1331		14	62	0.009345%	607333	93.33%	45	10.95%
操	1335		16	61	0.009194%	607394	93.37%	45	10.95%
裂	1341		12	61	0.009194%	607455	93.43%	45	10.95%
憂	1345		15	60	0.009043%	607515	93.46%	45	10.95%
添	1358		11	59	0.008893%	607574	93.58%	45	10.95%
延	1394		8	56	0.008441%	607630	93.89%	45	10.95%
末	1396		5	56	0.008441%	607686	93.91%	45	10.95%
遭	1433		14	54	0.008139%	607740	94.21%	45	10.95%
勇	1437		9	53	0.007988%	607793	94.25%	45	10.95%
壯	1462		7	51	0.007687%	607844	94.44%	45	10.95%
跡	1517		13	48	0.007235%	607892	94.85%	45	10.95%
姐	540		8	263	0.03964%	608155	77.48%	44	10.71%
季	820		8	148	0.02231%	608303	85.82%	44	10.71%
射	828		10	144	0.0217%	608447	86.00%	44	10.71%
詩	929		13	122	0.01839%	608569	88.03%	44	10.71%
田	1051		5	98	0.01477%	608667	90.04%	44	10.71%
哭	1108		10	89	0.01341%	608756	90.85%	44	10.71%
刊	1144		5	83	0.01251%	608839	91.31%	44	10.71%
湖	1207		12	75	0.0113%	608914	92.06%	44	10.71%
雅	1220		12	74	0.01115%	608988	92.21%	44	10.71%
昏	1237		8	71	0.0107%	609059	92.39%	44	10.71%
甜	1239		11	71	0.0107%	609130	92.41%	44	10.71%
粗	1302		11	65	0.009797%	609195	93.06%	44	10.71%
覆	1313		18	64	0.009646%	609259	93.16%	44	10.71%
擠	1336		17	61	0.009194%	609320	93.38%	44	10.71%
拒	1346		8	60	0.009043%	609380	93.47%	44	10.71%
爛	1385		21	57	0.008591%	609437	93.81%	44	10.71%
奈	1421		8	54	0.008139%	609491	94.12%	44	10.71%
絡	1428		12	54	0.008139%	609545	94.17%	44	10.71%
膚	607		15	228	0.03437%	609773	79.97%	43	10.46%
飲	1117		12	88	0.01326%	609861	90.97%	43	10.46%
盾	1218		9	74	0.01115%	609935	92.19%	43	10.46%
碎	1219		13	74	0.01115%	610009	92.20%	43	10.46%
矛	1226		5	73	0.011%	610082	92.27%	43	10.46%
燒	1271		16	68	0.01025%	610150	92.75%	43	10.46%
兵	1275		7	67	0.0101%	610217	92.79%	43	10.46%
返	1315		7	64	0.009646%	610281	93.18%	43	10.46%
佈	1325		7	62	0.009345%	610343	93.28%	43	10.46%
累	1329		11	62	0.009345%	610405	93.32%	43	10.46%
胸	1359		10	59	0.008893%	610464	93.59%	43	10.46%
厭	1370		14	58	0.008742%	610522	93.68%	43	10.46%
尖	1380		6	57	0.008591%	610579	93.77%	43	10.46%
牽	1411		11	55	0.00829%	610634	94.03%	43	10.46%
欠	1423		4	54	0.008139%	610688	94.13%	43	10.46%
築	1045		16	99	0.01492%	610787	89.95%	42	10.22%
耀	1105		20	90	0.01357%	610877	90.80%	42	10.22%
鬼	1232		10	72	0.01085%	610949	92.34%	42	10.22%
碰	1300		13	65	0.009797%	611014	93.04%	42	10.22%
敏	1308		11	64	0.009646%	611078	93.12%	42	10.22%
沖	1347		7	60	0.009043%	611138	93.48%	42	10.22%
伸	1352		7	59	0.008893%	611197	93.53%	42	10.22%
塵	1353		14	59	0.008893%	611256	93.53%	42	10.22%
糊	1386		15	57	0.008591%	611313	93.82%	42	10.22%
秀	1400		7	56	0.008441%	611369	93.94%	42	10.22%
乃	1403		2	55	0.00829%	611424	93.97%	42	10.22%
奮	1422		16	54	0.008139%	611478	94.12%	42	10.22%
緒	1442		14	53	0.007988%	611531	94.29%	42	10.22%
搶	1449		13	52	0.007838%	611583	94.34%	42	10.22%
豈	1500		10	49	0.007385%	611632	94.73%	42	10.22%
菜	844		12	141	0.02125%	611773	86.34%	41	9.98%
岸	1079		8	94	0.01417%	611867	90.45%	41	9.98%
弟	1110		7	89	0.01341%	611956	90.87%	41	9.98%
肥	1120		8	87	0.01311%	612043	91.00%	41	9.98%
游	1168		12	80	0.01206%	612123	91.61%	41	9.98%
撥	1217		15	74	0.01115%	612197	92.17%	41	9.98%
摸	1268		14	68	0.01025%	612265	92.72%	41	9.98%
晨	1309		11	64	0.009646%	612329	93.13%	41	9.98%
邀	1342		16	61	0.009194%	612390	93.44%	41	9.98%
姓	1354		8	59	0.008893%	612449	93.54%	41	9.98%
坦	1406		8	55	0.00829%	612504	93.99%	41	9.98%
殘	1410		12	55	0.00829%	612559	94.02%	41	9.98%
湧	1426		12	54	0.008139%	612613	94.16%	41	9.98%
慘	1493		14	49	0.007385%	612662	94.68%	41	9.98%
匯	689		13	190	0.02864%	612852	82.53%	40	9.73%
哥	993		10	109	0.01643%	612961	89.13%	40	9.73%
戀	995		23	109	0.01643%	613070	89.17%	40	9.73%
申	1074		5	95	0.01432%	613165	90.38%	40	9.73%
跌	1122		12	87	0.01311%	613252	91.03%	40	9.73%
啊	1293		11	65	0.009797%	613317	92.97%	40	9.73%
措	1295		11	65	0.009797%	613382	92.99%	40	9.73%
遙	1361		13	59	0.008893%	613441	93.61%	40	9.73%
紹	1373		11	58	0.008742%	613499	93.71%	40	9.73%
尾	1392		7	56	0.008441%	613555	93.87%	40	9.73%
顏	1402		18	56	0.008441%	613611	93.96%	40	9.73%
稀	1415		12	55	0.00829%	613666	94.07%	40	9.73%
聖	1429		13	54	0.008139%	613720	94.18%	40	9.73%
慰	1447		15	52	0.007838%	613772	94.32%	40	9.73%
賴	1455		16	52	0.007838%	613824	94.39%	40	9.73%
妨	1473		7	50	0.007536%	613874	94.53%	40	9.73%
猛	1546		11	46	0.006933%	613920	95.05%	40	9.73%
逼	1576		12	44	0.006632%	613964	95.26%	40	9.73%
籍	923		20	123	0.01854%	614087	87.91%	39	9.49%
膠	1039		15	100	0.01507%	614187	89.86%	39	9.49%
朗	1279		10	67	0.0101%	614254	92.83%	39	9.49%
寒	1355		12	59	0.008893%	614313	93.55%	39	9.49%
闊	1388		17	57	0.008591%	614370	93.84%	39	9.49%
汗	1397		6	56	0.008441%	614426	93.92%	39	9.49%
籌	1401		20	56	0.008441%	614482	93.95%	39	9.49%
眉	1414		9	55	0.00829%	614537	94.06%	39	9.49%
曉	1439		16	53	0.007988%	614590	94.26%	39	9.49%
齡	1443		20	53	0.007988%	614643	94.29%	39	9.49%
沿	1451		8	52	0.007838%	614695	94.36%	39	9.49%
縱	1466		17	51	0.007687%	614746	94.47%	39	9.49%
剩	1504		12	48	0.007235%	614794	94.76%	39	9.49%
逃	1536		9	47	0.007084%	614841	94.99%	39	9.49%
磨	1547		16	46	0.006933%	614887	95.06%	39	9.49%
詳	1557		13	45	0.006783%	614932	95.13%	39	9.49%
掩	1569		11	44	0.006632%	614976	95.21%	39	9.49%
監	927		14	122	0.01839%	615098	87.99%	38	9.25%
簽	1018		19	105	0.01583%	615203	89.54%	38	9.25%
輸	1048		16	99	0.01492%	615302	90.00%	38	9.25%
啦	1166		11	80	0.01206%	615382	91.58%	38	9.25%
悠	1256		11	69	0.0104%	615451	92.59%	38	9.25%
飾	1285		13	67	0.0101%	615518	92.89%	38	9.25%
膽	1287		17	66	0.009948%	615584	92.91%	38	9.25%
飄	1324		20	63	0.009496%	615647	93.27%	38	9.25%
諾	1330		16	62	0.009345%	615709	93.32%	38	9.25%
稿	1340		15	61	0.009194%	615770	93.42%	38	9.25%
融	1349		16	60	0.009043%	615830	93.50%	38	9.25%
丈	1364		3	58	0.008742%	615888	93.63%	38	9.25%
冰	1367		6	58	0.008742%	615946	93.66%	38	9.25%
插	1409		12	55	0.00829%	616001	94.02%	38	9.25%
珍	1441		9	53	0.007988%	616054	94.28%	38	9.25%
猶	1452		12	52	0.007838%	616106	94.36%	38	9.25%
埋	1461		10	51	0.007687%	616157	94.43%	38	9.25%
側	1469		11	50	0.007536%	616207	94.50%	38	9.25%
纏	1482		21	50	0.007536%	616257	94.59%	38	9.25%
勁	1562		9	44	0.006632%	616301	95.16%	38	9.25%
贊	1592		19	43	0.006481%	616344	95.36%	38	9.25%
躍	1593		21	43	0.006481%	616387	95.37%	38	9.25%
彭	707		12	184	0.02773%	616571	83.03%	37	9.00%
船	789		11	155	0.02336%	616726	85.12%	37	9.00%
坡	1124		8	86	0.01296%	616812	91.06%	37	9.00%
偷	1212		11	74	0.01115%	616886	92.12%	37	9.00%
盟	1231		13	72	0.01085%	616958	92.33%	37	9.00%
賓	1290		14	66	0.009948%	617024	92.94%	37	9.00%
域	1306		11	64	0.009646%	617088	93.10%	37	9.00%
援	1326		12	62	0.009345%	617150	93.29%	37	9.00%
儀	1404		15	55	0.00829%	617205	93.98%	37	9.00%
豪	1417		14	55	0.00829%	617260	94.08%	37	9.00%
扣	1448		6	52	0.007838%	617312	94.33%	37	9.00%
搭	1465		13	51	0.007687%	617363	94.46%	37	9.00%
恩	1477		10	50	0.007536%	617413	94.56%	37	9.00%
礙	1515		19	48	0.007235%	617461	94.84%	37	9.00%
潔	1527		15	47	0.007084%	617508	94.92%	37	9.00%
敬	1544		13	46	0.006933%	617554	95.04%	37	9.00%
輯	1558		16	45	0.006783%	617599	95.14%	37	9.00%
捨	1570		11	44	0.006632%	617643	95.22%	37	9.00%
媽	763		13	162	0.02442%	617805	84.49%	36	8.76%
幣	988		14	110	0.01658%	617915	89.05%	36	8.76%
夾	1200		7	76	0.01146%	617991	91.98%	36	8.76%
閃	1316		10	64	0.009646%	618055	93.19%	36	8.76%
潤	1372		15	58	0.008742%	618113	93.70%	36	8.76%
謀	1416		16	55	0.00829%	618168	94.07%	36	8.76%
袖	1430		10	54	0.008139%	618222	94.19%	36	8.76%
鼻	1458		14	52	0.007838%	618274	94.41%	36	8.76%
刀	1460		2	51	0.007687%	618325	94.43%	36	8.76%
惱	1464		12	51	0.007687%	618376	94.46%	36	8.76%
垂	1508		9	48	0.007235%	618424	94.79%	36	8.76%
惑	1585		12	43	0.006481%	618467	95.32%	36	8.76%
哈	1007		9	107	0.01613%	618574	89.36%	35	8.52%
桌	1172		10	79	0.01191%	618653	91.66%	35	8.52%
淨	1338		11	61	0.009194%	618714	93.40%	35	8.52%
謝	1350		17	60	0.009043%	618774	93.51%	35	8.52%
違	1418		12	55	0.00829%	618829	94.09%	35	8.52%
妥	1445		7	52	0.007838%	618881	94.31%	35	8.52%
慕	1446		15	52	0.007838%	618933	94.32%	35	8.52%
拾	1478		9	50	0.007536%	618983	94.56%	35	8.52%
誌	1499		14	49	0.007385%	619032	94.72%	35	8.52%
拜	1511		9	48	0.007235%	619080	94.81%	35	8.52%
敵	1513		15	48	0.007235%	619128	94.82%	35	8.52%
獻	1529		20	47	0.007084%	619175	94.94%	35	8.52%
毀	1545		13	46	0.006933%	619221	95.05%	35	8.52%
飽	1559		13	45	0.006783%	619266	95.14%	35	8.52%
滅	1573		13	44	0.006632%	619310	95.24%	35	8.52%
鄰	1595		14	43	0.006481%	619353	95.38%	35	8.52%
玉	1038		5	100	0.01507%	619453	89.85%	34	8.27%
赤	1148		7	83	0.01251%	619536	91.36%	34	8.27%
麥	1241		11	71	0.0107%	619607	92.44%	34	8.27%
帝	1277		9	67	0.0101%	619674	92.81%	34	8.27%
授	1357		11	59	0.008893%	619733	93.57%	34	8.27%
酸	1362		14	59	0.008893%	619792	93.61%	34	8.27%
陪	1363		10	59	0.008893%	619851	93.62%	34	8.27%
抹	1382		8	57	0.008591%	619908	93.79%	34	8.27%
焦	1384		12	57	0.008591%	619965	93.81%	34	8.27%
璃	1412		15	55	0.00829%	620020	94.04%	34	8.27%
敦	1450		12	52	0.007838%	620072	94.35%	34	8.27%
鞋	1457		15	52	0.007838%	620124	94.40%	34	8.27%
仰	1459		6	51	0.007687%	620175	94.42%	34	8.27%
怒	1463		9	51	0.007687%	620226	94.45%	34	8.27%
培	1489		11	49	0.007385%	620275	94.65%	34	8.27%
肩	1498		8	49	0.007385%	620324	94.71%	34	8.27%
滑	1514		13	48	0.007235%	620372	94.83%	34	8.27%
腰	1516		13	48	0.007235%	620420	94.84%	34	8.27%
伏	1520		6	47	0.007084%	620467	94.87%	34	8.27%
倦	1522		10	47	0.007084%	620514	94.89%	34	8.27%
串	1538		7	46	0.006933%	620560	95.00%	34	8.27%
嘆	1563		14	44	0.006632%	620604	95.17%	34	8.27%
搜	1571		12	44	0.006632%	620648	95.22%	34	8.27%
邦	1577		6	44	0.006632%	620692	95.26%	34	8.27%
輩	1594		15	43	0.006481%	620735	95.37%	34	8.27%
召	1599		5	42	0.00633%	620777	95.41%	34	8.27%
貫	1633		11	40	0.006029%	620817	95.62%	34	8.27%
憤	1643		15	39	0.005878%	620856	95.67%	34	8.27%
厲	1675		15	37	0.005577%	620893	95.86%	34	8.27%
繞	1682		18	37	0.005577%	620930	95.90%	34	8.27%
紫	704		12	185	0.02788%	621115	82.95%	33	8.03%
汽	1021		7	104	0.01568%	621219	89.59%	33	8.03%
婆	1096		11	90	0.01357%	621309	90.68%	33	8.03%
橋	1138		16	84	0.01266%	621393	91.24%	33	8.03%
雞	1149		18	83	0.01251%	621476	91.37%	33	8.03%
冬	1213		5	74	0.01115%	621550	92.13%	33	8.03%
攝	1236		21	71	0.0107%	621621	92.38%	33	8.03%
欄	1238		21	71	0.0107%	621692	92.40%	33	8.03%
荒	1311		10	64	0.009646%	621756	93.14%	33	8.03%
戴	1332		17	61	0.009194%	621817	93.34%	33	8.03%
醉	1375		15	58	0.008742%	621875	93.73%	33	8.03%
悶	1381		12	57	0.008591%	621932	93.78%	33	8.03%
炸	1383		9	57	0.008591%	621989	93.80%	33	8.03%
毒	1424		9	54	0.008139%	622043	94.14%	33	8.03%
吐	1471		6	50	0.007536%	622093	94.51%	33	8.03%
蒙	1484		14	50	0.007536%	622143	94.61%	33	8.03%
貧	1485		11	50	0.007536%	622193	94.62%	33	8.03%
托	1494		6	49	0.007385%	622242	94.68%	33	8.03%
嚇	1507		17	48	0.007235%	622290	94.78%	33	8.03%
忌	1509		7	48	0.007235%	622338	94.79%	33	8.03%
搬	1512		13	48	0.007235%	622386	94.81%	33	8.03%
淺	1526		11	47	0.007084%	622433	94.91%	33	8.03%
兄	1539		5	46	0.006933%	622479	95.01%	33	8.03%
嫌	1601		13	42	0.00633%	622521	95.42%	33	8.03%
截	1678		14	37	0.005577%	622558	95.88%	33	8.03%
澳	1044		16	99	0.01492%	622657	89.94%	32	7.79%
植	1072		12	95	0.01432%	622752	90.35%	32	7.79%
媒	1276		12	67	0.0101%	622819	92.80%	32	7.79%
污	1281		6	67	0.0101%	622886	92.85%	32	7.79%
津	1321		9	63	0.009496%	622949	93.24%	32	7.79%
旗	1327		14	62	0.009345%	623011	93.30%	32	7.79%
幽	1393		9	56	0.008441%	623067	93.88%	32	7.79%
褲	1431		15	54	0.008139%	623121	94.20%	32	7.79%
網	1453		14	52	0.007838%	623173	94.37%	32	7.79%
玻	1481		9	50	0.007536%	623223	94.59%	32	7.79%
肚	1483		7	50	0.007536%	623273	94.60%	32	7.79%
愁	1510		13	48	0.007235%	623321	94.80%	32	7.79%
鋪	1580		15	44	0.006632%	623365	95.28%	32	7.79%
昂	1604		8	42	0.00633%	623407	95.44%	32	7.79%
礎	1607		18	42	0.00633%	623449	95.46%	32	7.79%
痕	1620		11	41	0.00618%	623490	95.54%	32	7.79%
鎮	1655		18	39	0.005878%	623529	95.75%	32	7.79%
堪	1658		12	38	0.005728%	623567	95.76%	32	7.79%
奔	1709		8	35	0.005275%	623602	96.05%	32	7.79%
稅	703		12	185	0.02788%	623787	82.92%	31	7.54%
伯	1077		7	94	0.01417%	623881	90.42%	31	7.54%
薪	1112		17	89	0.01341%	623970	90.90%	31	7.54%
審	1223		15	73	0.011%	624043	92.24%	31	7.54%
氏	1244		4	70	0.01055%	624113	92.47%	31	7.54%
牆	1259		17	69	0.0104%	624182	92.62%	31	7.54%
濕	1270		17	68	0.01025%	624250	92.74%	31	7.54%
雪	1389		11	57	0.008591%	624307	93.85%	31	7.54%
魂	1468		14	51	0.007687%	624358	94.49%	31	7.54%
腿	1530		14	47	0.007084%	624405	94.94%	31	7.54%
卷	1551		8	45	0.006783%	624450	95.09%	31	7.54%
溝	1555		13	45	0.006783%	624495	95.12%	31	7.54%
采	1579		8	44	0.006632%	624539	95.28%	31	7.54%
壇	1584		16	43	0.006481%	624582	95.31%	31	7.54%
暖	1586		13	43	0.006481%	624625	95.32%	31	7.54%
脈	1589		10	43	0.006481%	624668	95.34%	31	7.54%
凝	1598		16	42	0.00633%	624710	95.40%	31	7.54%
捧	1628		11	40	0.006029%	624750	95.59%	31	7.54%
擾	1645		18	39	0.005878%	624789	95.69%	31	7.54%
艱	1654		17	39	0.005878%	624828	95.74%	31	7.54%
滴	1664		14	38	0.005728%	624866	95.80%	31	7.54%
拼	1695		9	36	0.005426%	624902	95.97%	31	7.54%
呈	1748		7	33	0.004974%	624935	96.25%	31	7.54%
迅	1766		6	33	0.004974%	624968	96.34%	31	7.54%
竹	1104		6	90	0.01357%	625058	90.79%	30	7.30%
填	1317		13	63	0.009496%	625121	93.20%	30	7.30%
劣	1378		6	57	0.008591%	625178	93.75%	30	7.30%
仁	1434		4	53	0.007988%	625231	94.22%	30	7.30%
遷	1456		14	52	0.007838%	625283	94.40%	30	7.30%
艷	1467		24	51	0.007687%	625334	94.48%	30	7.30%
壁	1472		16	50	0.007536%	625384	94.52%	30	7.30%
椅	1479		12	50	0.007536%	625434	94.57%	30	7.30%
嘩	1582		15	43	0.006481%	625477	95.30%	30	7.30%
捉	1614		10	41	0.00618%	625518	95.50%	30	7.30%
迴	1623		9	41	0.00618%	625559	95.56%	30	7.30%
拔	1694		8	36	0.005426%	625595	95.96%	30	7.30%
聊	1737		11	34	0.005125%	625629	96.19%	30	7.30%
鄧	845		14	141	0.02125%	625770	86.36%	29	7.06%
農	966		13	115	0.01733%	625885	88.68%	29	7.06%
楊	1012		13	106	0.01598%	625991	89.44%	29	7.06%
賽	1076		17	95	0.01432%	626086	90.40%	29	7.06%
泡	1320		8	63	0.009496%	626149	93.23%	29	7.06%
閱	1376		15	58	0.008742%	626207	93.74%	29	7.06%
娛	1524		10	47	0.007084%	626254	94.90%	29	7.06%
塗	1552		13	45	0.006783%	626299	95.10%	29	7.06%
抓	1554		7	45	0.006783%	626344	95.11%	29	7.06%
墨	1583		15	43	0.006481%	626387	95.30%	29	7.06%
暑	1605		12	42	0.00633%	626429	95.44%	29	7.06%
描	1616		12	41	0.00618%	626470	95.51%	29	7.06%
貢	1622		10	41	0.00618%	626511	95.55%	29	7.06%
哀	1625		9	40	0.006029%	626551	95.57%	29	7.06%
毋	1663		4	38	0.005728%	626589	95.79%	29	7.06%
崇	1692		11	36	0.005426%	626625	95.95%	29	7.06%
慶	1711		15	35	0.005275%	626660	96.06%	29	7.06%
吞	1747		7	33	0.004974%	626693	96.24%	29	7.06%
勉	1817		9	30	0.004522%	626723	96.58%	29	7.06%
脹	1249		12	70	0.01055%	626793	92.52%	28	6.81%
仙	1365		5	58	0.008742%	626851	93.64%	28	6.81%
宮	1407		10	55	0.00829%	626906	94.00%	28	6.81%
輛	1486		15	50	0.007536%	626956	94.62%	28	6.81%
註	1533		12	47	0.007084%	627003	94.96%	28	6.81%
嘛	1542		14	46	0.006933%	627049	95.03%	28	6.81%
侵	1560		9	44	0.006632%	627093	95.15%	28	6.81%
懶	1566		19	44	0.006632%	627137	95.19%	28	6.81%
朱	1572		6	44	0.006632%	627181	95.23%	28	6.81%
扎	1613		4	41	0.00618%	627222	95.49%	28	6.81%
症	1619		10	41	0.00618%	627263	95.53%	28	6.81%
廢	1626		15	40	0.006029%	627303	95.57%	28	6.81%
暢	1662		14	38	0.005728%	627341	95.79%	28	6.81%
週	1670		11	38	0.005728%	627379	95.83%	28	6.81%
逝	1687		10	37	0.005577%	627416	95.93%	28	6.81%
氛	1698		8	36	0.005426%	627452	95.99%	28	6.81%
凌	1705		10	35	0.005275%	627487	96.02%	28	6.81%
燃	1717		16	35	0.005275%	627522	96.09%	28	6.81%
衰	1720		10	35	0.005275%	627557	96.10%	28	6.81%
矣	1733		7	34	0.005125%	627591	96.17%	28	6.81%
赴	1765		9	33	0.004974%	627624	96.33%	28	6.81%
繫	1786		19	32	0.004823%	627656	96.43%	28	6.81%
脅	1832		10	30	0.004522%	627686	96.65%	28	6.81%
輝	1164		15	81	0.01221%	627767	91.56%	27	6.57%
租	1227		10	73	0.011%	627840	92.29%	27	6.57%
蛋	1240		11	71	0.0107%	627911	92.43%	27	6.57%
櫃	1319		18	63	0.009496%	627974	93.22%	27	6.57%
儲	1366		17	58	0.008742%	628032	93.65%	27	6.57%
貪	1432		11	54	0.008139%	628086	94.21%	27	6.57%
蕩	1454		16	52	0.007838%	628138	94.38%	27	6.57%
峰	1474		10	50	0.007536%	628188	94.53%	27	6.57%
糖	1497		16	49	0.007385%	628237	94.70%	27	6.57%
魯	1502		15	49	0.007385%	628286	94.74%	27	6.57%
酬	1519		13	48	0.007235%	628334	94.86%	27	6.57%
頻	1549		16	46	0.006933%	628380	95.08%	27	6.57%
冠	1550		9	45	0.006783%	628425	95.08%	27	6.57%
削	1561		9	44	0.006632%	628469	95.16%	27	6.57%
寞	1565		14	44	0.006632%	628513	95.18%	27	6.57%
浸	1587		10	43	0.006481%	628556	95.33%	27	6.57%
廉	1603		13	42	0.00633%	628598	95.43%	27	6.57%
朵	1606		6	42	0.00633%	628640	95.45%	27	6.57%
挺	1615		10	41	0.00618%	628681	95.51%	27	6.57%
斜	1629		11	40	0.006029%	628721	95.59%	27	6.57%
尺	1640		4	39	0.005878%	628760	95.66%	27	6.57%
掃	1659		11	38	0.005728%	628798	95.77%	27	6.57%
旋	1661		11	38	0.005728%	628836	95.78%	27	6.57%
憐	1693		15	36	0.005426%	628872	95.96%	27	6.57%
勤	1706		13	35	0.005275%	628907	96.03%	27	6.57%
奉	1708		8	35	0.005275%	628942	96.04%	27	6.57%
拋	1712		8	35	0.005275%	628977	96.06%	27	6.57%
唇	1721		10	34	0.005125%	629011	96.11%	27	6.57%
瓦	1730		5	34	0.005125%	629045	96.15%	27	6.57%
循	1844		12	29	0.004371%	629074	96.70%	27	6.57%
趁	1894		12	28	0.00422%	629102	96.91%	27	6.57%
韓	807		17	151	0.02276%	629253	85.53%	26	6.33%
煮	1153		12	82	0.01236%	629335	91.42%	26	6.33%
菲	1179		12	79	0.01191%	629414	91.74%	26	6.33%
諮	1288		16	66	0.009948%	629480	92.92%	26	6.33%
晶	1296		12	65	0.009797%	629545	93.00%	26	6.33%
娘	1307		10	64	0.009646%	629609	93.11%	26	6.33%
劉	1368		15	58	0.008742%	629667	93.67%	26	6.33%
洞	1398		9	56	0.008441%	629723	93.92%	26	6.33%
哲	1444		10	52	0.007838%	629775	94.30%	26	6.33%
駛	1487		15	50	0.007536%	629825	94.63%	26	6.33%
恒	1492		9	49	0.007385%	629874	94.67%	26	6.33%
瓶	1495		11	49	0.007385%	629923	94.69%	26	6.33%
貸	1535		12	47	0.007084%	629970	94.98%	26	6.33%
唉	1541		10	46	0.006933%	630016	95.02%	26	6.33%
縫	1653		17	39	0.005878%	630055	95.73%	26	6.33%
攻	1660		7	38	0.005728%	630093	95.77%	26	6.33%
佛	1672		7	37	0.005577%	630130	95.84%	26	6.33%
蒼	1700		14	36	0.005426%	630166	96.00%	26	6.33%
宿	1710		11	35	0.005275%	630201	96.05%	26	6.33%
緻	1735		15	34	0.005125%	630235	96.18%	26	6.33%
襲	1740		22	34	0.005125%	630269	96.21%	26	6.33%
恰	1752		9	33	0.004974%	630302	96.27%	26	6.33%
漏	1760		14	33	0.004974%	630335	96.31%	26	6.33%
遞	1767		13	33	0.004974%	630368	96.34%	26	6.33%
躺	1836		15	30	0.004522%	630398	96.66%	26	6.33%
奧	1215		13	74	0.01115%	630472	92.15%	25	6.08%
貿	1262		12	69	0.0104%	630541	92.66%	25	6.08%
伊	1264		6	68	0.01025%	630609	92.68%	25	6.08%
廈	1408		13	55	0.00829%	630664	94.01%	25	6.08%
劑	1436		16	53	0.007988%	630717	94.24%	25	6.08%
宇	1490		6	49	0.007385%	630766	94.65%	25	6.08%
駕	1501		15	49	0.007385%	630815	94.73%	25	6.08%
誕	1534		15	47	0.007084%	630862	94.97%	25	6.08%
呵	1540		8	46	0.006933%	630908	95.01%	25	6.08%
孫	1564		10	44	0.006632%	630952	95.18%	25	6.08%
澤	1574		16	44	0.006632%	630996	95.24%	25	6.08%
茫	1632		10	40	0.006029%	631036	95.61%	25	6.08%
顆	1636		17	40	0.006029%	631076	95.63%	25	6.08%
騙	1637		19	40	0.006029%	631116	95.64%	25	6.08%
洩	1648		9	39	0.005878%	631155	95.70%	25	6.08%
鑑	1656		22	39	0.005878%	631194	95.75%	25	6.08%
繪	1667		19	38	0.005728%	631232	95.81%	25	6.08%
喊	1677		12	37	0.005577%	631269	95.87%	25	6.08%
淋	1699		11	36	0.005426%	631305	95.99%	25	6.08%
撞	1724		15	34	0.005125%	631339	96.12%	25	6.08%
虎	1739		8	34	0.005125%	631373	96.20%	25	6.08%
譽	1764		21	33	0.004974%	631406	96.33%	25	6.08%
屈	1774		8	32	0.004823%	631438	96.38%	25	6.08%
慾	1776		15	32	0.004823%	631470	96.38%	25	6.08%
愚	1799		13	31	0.004672%	631501	96.49%	25	6.08%
盪	1804		17	31	0.004672%	631532	96.52%	25	6.08%
襯	1809		21	31	0.004672%	631563	96.54%	25	6.08%
擦	1825		17	30	0.004522%	631593	96.61%	25	6.08%
鍵	1837		17	30	0.004522%	631623	96.67%	25	6.08%
俱	1839		10	29	0.004371%	631652	96.68%	25	6.08%
吵	1842		7	29	0.004371%	631681	96.69%	25	6.08%
祝	1856		9	29	0.004371%	631710	96.75%	25	6.08%
筋	1890		12	28	0.00422%	631738	96.90%	25	6.08%
辨	1896		16	28	0.00422%	631766	96.92%	25	6.08%
慨	1946		12	26	0.003919%	631792	97.12%	25	6.08%
唐	936		10	120	0.01809%	631912	88.15%	24	5.84%
航	1131		10	85	0.01281%	631997	91.15%	24	5.84%
妹	1221		8	73	0.011%	632070	92.22%	24	5.84%
瓜	1322		5	63	0.009496%	632133	93.25%	24	5.84%
獎	1391		15	56	0.008441%	632189	93.87%	24	5.84%
盈	1399		9	56	0.008441%	632245	93.93%	24	5.84%
吳	1405		7	55	0.00829%	632300	93.98%	24	5.84%
池	1425		6	54	0.008139%	632354	94.15%	24	5.84%
冊	1470		5	50	0.007536%	632404	94.50%	24	5.84%
療	1496		17	49	0.007385%	632453	94.70%	24	5.84%
徐	1553		10	45	0.006783%	632498	95.10%	24	5.84%
籠	1621		22	41	0.00618%	632539	95.54%	24	5.84%
割	1624		12	40	0.006029%	632579	95.56%	24	5.84%
惠	1642		12	39	0.005878%	632618	95.67%	24	5.84%
泉	1647		9	39	0.005878%	632657	95.70%	24	5.84%
秩	1665		10	38	0.005728%	632695	95.80%	24	5.84%
撫	1697		15	36	0.005426%	632731	95.98%	24	5.84%
蓄	1719		14	35	0.005275%	632766	96.10%	24	5.84%
喪	1722		12	34	0.005125%	632800	96.11%	24	5.84%
抬	1723		8	34	0.005125%	632834	96.12%	24	5.84%
涯	1727		11	34	0.005125%	632868	96.14%	24	5.84%
肅	1738		12	34	0.005125%	632902	96.20%	24	5.84%
忠	1751		8	33	0.004974%	632935	96.26%	24	5.84%
悅	1753		10	33	0.004974%	632968	96.27%	24	5.84%
披	1778		8	32	0.004823%	633000	96.39%	24	5.84%
逢	1789		10	32	0.004823%	633032	96.45%	24	5.84%
牢	1801		7	31	0.004672%	633063	96.50%	24	5.84%
勿	1818		4	30	0.004522%	633093	96.58%	24	5.84%
咀	1820		8	30	0.004522%	633123	96.59%	24	5.84%
惹	1824		13	30	0.004522%	633153	96.61%	24	5.84%
沾	1827		8	30	0.004522%	633183	96.62%	24	5.84%
牲	1851		9	29	0.004371%	633212	96.73%	24	5.84%
疾	1853		10	29	0.004371%	633241	96.74%	24	5.84%
瘋	1854		14	29	0.004371%	633270	96.74%	24	5.84%
逸	1897		11	28	0.00422%	633298	96.93%	24	5.84%
驟	1930		24	27	0.00407%	633325	97.06%	24	5.84%
俊	1931		9	26	0.003919%	633351	97.07%	24	5.84%
淪	1948		11	26	0.003919%	633377	97.13%	24	5.84%
濫	1980		17	25	0.003768%	633402	97.25%	24	5.84%
琴	1155		12	82	0.01236%	633484	91.45%	23	5.60%
柱	1280		9	67	0.0101%	633551	92.84%	23	5.60%
債	1390		13	56	0.008441%	633607	93.86%	23	5.60%
嬰	1438		17	53	0.007988%	633660	94.25%	23	5.60%
殖	1480		12	50	0.007536%	633710	94.58%	23	5.60%
烏	1528		10	47	0.007084%	633757	94.93%	23	5.60%
炎	1588		8	43	0.006481%	633800	95.33%	23	5.60%
巡	1602		7	42	0.00633%	633842	95.42%	23	5.60%
災	1630		7	40	0.006029%	633882	95.60%	23	5.60%
云	1638		4	39	0.005878%	633921	95.65%	23	5.60%
呆	1639		7	39	0.005878%	633960	95.65%	23	5.60%
舖	1669		15	38	0.005728%	633998	95.83%	23	5.60%
醜	1671		17	38	0.005728%	634036	95.84%	23	5.60%
嘉	1691		14	36	0.005426%	634072	95.95%	23	5.60%
泊	1714		8	35	0.005275%	634107	96.07%	23	5.60%
漲	1715		14	35	0.005275%	634142	96.08%	23	5.60%
傑	1745		12	33	0.004974%	634175	96.23%	23	5.60%
拘	1754		8	33	0.004974%	634208	96.28%	23	5.60%
撲	1756		15	33	0.004974%	634241	96.29%	23	5.60%
虧	1762		17	33	0.004974%	634274	96.32%	23	5.60%
惟	1775		11	32	0.004823%	634306	96.38%	23	5.60%
抖	1777		7	32	0.004823%	634338	96.39%	23	5.60%
掙	1779		11	32	0.004823%	634370	96.40%	23	5.60%
彎	1797		22	31	0.004672%	634401	96.48%	23	5.60%
荷	1834		11	30	0.004522%	634431	96.65%	23	5.60%
愉	1845		12	29	0.004371%	634460	96.70%	23	5.60%
捱	1846		11	29	0.004371%	634489	96.71%	23	5.60%
摩	1847		15	29	0.004371%	634518	96.71%	23	5.60%
扭	1875		7	28	0.00422%	634546	96.83%	23	5.60%
猜	1887		11	28	0.00422%	634574	96.88%	23	5.60%
紐	1891		10	28	0.00422%	634602	96.90%	23	5.60%
倘	1903		10	27	0.00407%	634629	96.95%	23	5.60%
渴	1916		12	27	0.00407%	634656	97.00%	23	5.60%
窄	1918		10	27	0.00407%	634683	97.01%	23	5.60%
腸	1920		13	27	0.00407%	634710	97.02%	23	5.60%
踐	1928		15	27	0.00407%	634737	97.05%	23	5.60%
倚	1964		10	25	0.003768%	634762	97.19%	23	5.60%
撐	1977		15	25	0.003768%	634787	97.24%	23	5.60%
衷	1986		10	25	0.003768%	634812	97.28%	23	5.60%
姻	1265		9	68	0.01025%	634880	92.69%	22	5.35%
唔	1488		10	49	0.007385%	634929	94.64%	22	5.35%
鳥	1503		11	49	0.007385%	634978	94.75%	22	5.35%
匆	1523		5	47	0.007084%	635025	94.89%	22	5.35%
衫	1531		8	47	0.007084%	635072	94.95%	22	5.35%
覽	1532		21	47	0.007084%	635119	94.96%	22	5.35%
胞	1575		9	44	0.006632%	635163	95.25%	22	5.35%
臭	1590		10	43	0.006481%	635206	95.35%	22	5.35%
佩	1596		8	42	0.00633%	635248	95.39%	22	5.35%
漠	1680		14	37	0.005577%	635285	95.89%	22	5.35%
貝	1686		7	37	0.005577%	635322	95.92%	22	5.35%
捕	1696		10	36	0.005426%	635358	95.98%	22	5.35%
甲	1731		5	34	0.005125%	635392	96.16%	22	5.35%
郎	1742		8	34	0.005125%	635426	96.22%	22	5.35%
捲	1755		11	33	0.004974%	635459	96.28%	22	5.35%
夕	1771		3	32	0.004823%	635491	96.36%	22	5.35%
揭	1780		12	32	0.004823%	635523	96.40%	22	5.35%
瞪	1805		17	31	0.004672%	635554	96.52%	22	5.35%
餓	1814		15	31	0.004672%	635585	96.56%	22	5.35%
聰	1831		17	30	0.004522%	635615	96.64%	22	5.35%
喉	1843		12	29	0.004371%	635644	96.69%	22	5.35%
腐	1862		14	29	0.004371%	635673	96.78%	22	5.35%
鑽	1866		27	29	0.004371%	635702	96.80%	22	5.35%
歧	1881		8	28	0.00422%	635730	96.86%	22	5.35%
泰	1883		10	28	0.00422%	635758	96.87%	22	5.35%
罕	1893		7	28	0.00422%	635786	96.91%	22	5.35%
躲	1895		13	28	0.00422%	635814	96.92%	22	5.35%
跨	1927		13	27	0.00407%	635841	97.05%	22	5.35%
騷	1929		20	27	0.00407%	635868	97.06%	22	5.35%
爽	1949		11	26	0.003919%	635894	97.14%	22	5.35%
翼	1953		17	26	0.003919%	635920	97.15%	22	5.35%
龐	1962		19	26	0.003919%	635946	97.19%	22	5.35%
倡	1965		10	25	0.003768%	635971	97.20%	22	5.35%
恢	1971		9	25	0.003768%	635996	97.22%	22	5.35%
悔	1972		10	25	0.003768%	636021	97.22%	22	5.35%
盼	1983		9	25	0.003768%	636046	97.27%	22	5.35%
喚	1996		12	24	0.003617%	636070	97.31%	22	5.35%
鳴	2056		14	23	0.003467%	636093	97.53%	22	5.35%
脆	2080		10	22	0.003316%	636115	97.61%	22	5.35%
鵬	1211		19	75	0.0113%	636190	92.11%	21	5.11%
狗	1247		8	70	0.01055%	636260	92.50%	21	5.11%
憲	1318		16	63	0.009496%	636323	93.21%	21	5.11%
槍	1337		14	61	0.009194%	636384	93.39%	21	5.11%
振	1568		10	44	0.006632%	636428	95.20%	21	5.11%
梯	1617		11	41	0.00618%	636469	95.52%	21	5.11%
森	1646		12	39	0.005878%	636508	95.69%	21	5.11%
霧	1657		19	39	0.005878%	636547	95.76%	21	5.11%
罰	1668		14	38	0.005728%	636585	95.82%	21	5.11%
聘	1683		13	37	0.005577%	636622	95.90%	21	5.11%
鬱	1689		29	37	0.005577%	636659	95.94%	21	5.11%
灘	1716		22	35	0.005275%	636694	96.08%	21	5.11%
爬	1729		8	34	0.005125%	636728	96.15%	21	5.11%
紋	1734		10	34	0.005125%	636762	96.18%	21	5.11%
輔	1741		14	34	0.005125%	636796	96.21%	21	5.11%
勃	1746		9	33	0.004974%	636829	96.24%	21	5.11%
咬	1749		9	33	0.004974%	636862	96.25%	21	5.11%
裙	1763		12	33	0.004974%	636895	96.32%	21	5.11%
浴	1784		10	32	0.004823%	636927	96.42%	21	5.11%
剪	1792		11	31	0.004672%	636958	96.46%	21	5.11%
寸	1794		3	31	0.004672%	636989	96.47%	21	5.11%
鋒	1811		15	31	0.004672%	637020	96.55%	21	5.11%
顫	1813		22	31	0.004672%	637051	96.56%	21	5.11%
勸	1841		20	29	0.004371%	637080	96.69%	21	5.11%
捷	1877		11	28	0.00422%	637108	96.84%	21	5.11%
枯	1879		9	28	0.00422%	637136	96.85%	21	5.11%
漂	1884		14	28	0.00422%	637164	96.87%	21	5.11%
滲	1885		14	28	0.00422%	637192	96.88%	21	5.11%
駁	1899		14	28	0.00422%	637220	96.93%	21	5.11%
伙	1902		6	27	0.00407%	637247	96.95%	21	5.11%
欺	1912		12	27	0.00407%	637274	96.99%	21	5.11%
庸	1944		11	26	0.003919%	637300	97.12%	21	5.11%
逛	1955		10	26	0.003919%	637326	97.16%	21	5.11%
諒	1987		15	25	0.003768%	637351	97.28%	21	5.11%
遮	1988		14	25	0.003768%	637376	97.28%	21	5.11%
鍾	1989		17	25	0.003768%	637401	97.29%	21	5.11%
逆	2024		9	24	0.003617%	637425	97.42%	21	5.11%
腔	2081		12	22	0.003316%	637447	97.61%	21	5.11%
誇	2089		13	22	0.003316%	637469	97.64%	21	5.11%
廚	1475		15	50	0.007536%	637519	94.54%	20	4.87%
廊	1543		12	46	0.006933%	637565	95.03%	20	4.87%
僱	1597		14	42	0.00633%	637607	95.39%	20	4.87%
雷	1635		13	40	0.006029%	637647	95.63%	20	4.87%
滾	1649		14	39	0.005878%	637686	95.71%	20	4.87%
吊	1676		6	37	0.005577%	637723	95.87%	20	4.87%
豆	1685		7	37	0.005577%	637760	95.92%	20	4.87%
丁	1690		2	36	0.005426%	637796	95.94%	20	4.87%
蹈	1702		17	36	0.005426%	637832	96.01%	20	4.87%
杜	1713		7	35	0.005275%	637867	96.07%	20	4.87%
斑	1725		12	34	0.005125%	637901	96.13%	20	4.87%
液	1726		11	34	0.005125%	637935	96.13%	20	4.87%
炒	1728		8	34	0.005125%	637969	96.14%	20	4.87%
鋼	1743		16	34	0.005125%	638003	96.22%	20	4.87%
宵	1773		10	32	0.004823%	638035	96.37%	20	4.87%
賦	1788		15	32	0.004823%	638067	96.44%	20	4.87%
盆	1802		9	31	0.004672%	638098	96.51%	20	4.87%
伐	1816		6	30	0.004522%	638128	96.57%	20	4.87%
嫁	1822		13	30	0.004522%	638158	96.60%	20	4.87%
溜	1828		13	30	0.004522%	638188	96.63%	20	4.87%
籲	1859		32	29	0.004371%	638217	96.76%	20	4.87%
吟	1871		7	28	0.00422%	638245	96.82%	20	4.87%
綿	1892		14	28	0.00422%	638273	96.91%	20	4.87%
允	1905		4	27	0.00407%	638300	96.96%	20	4.87%
庫	1909		10	27	0.00407%	638327	96.98%	20	4.87%
舍	1921		8	27	0.00407%	638354	97.02%	20	4.87%
芳	1922		8	27	0.00407%	638381	97.03%	20	4.87%
賬	1925		15	27	0.00407%	638408	97.04%	20	4.87%
奢	1940		11	26	0.003919%	638434	97.10%	20	4.87%
盲	1951		8	26	0.003919%	638460	97.14%	20	4.87%
頁	1959		9	26	0.003919%	638486	97.17%	20	4.87%
慎	1973		13	25	0.003768%	638511	97.23%	20	4.87%
懸	1974		20	25	0.003768%	638536	97.23%	20	4.87%
丟	1992		6	24	0.003617%	638560	97.30%	20	4.87%
彌	2001		17	24	0.003617%	638584	97.33%	20	4.87%
悟	2002		10	24	0.003617%	638608	97.34%	20	4.87%
旨	2009		6	24	0.003617%	638632	97.36%	20	4.87%
陌	2027		8	24	0.003617%	638656	97.43%	20	4.87%
駐	2029		15	24	0.003617%	638680	97.43%	20	4.87%
勾	2032		4	23	0.003467%	638703	97.44%	20	4.87%
卸	2033		8	23	0.003467%	638726	97.45%	20	4.87%
擬	2040		17	23	0.003467%	638749	97.47%	20	4.87%
驅	2055		21	23	0.003467%	638772	97.52%	20	4.87%
腹	2082		13	22	0.003316%	638794	97.61%	20	4.87%
井	2096		4	21	0.003165%	638815	97.66%	20	4.87%
玲	717		9	181	0.02728%	638996	83.31%	19	4.62%
俄	960		9	115	0.01733%	639111	88.58%	19	4.62%
姑	1253		8	69	0.0104%	639180	92.56%	19	4.62%
脂	1374		10	58	0.008742%	639238	93.72%	19	4.62%
癌	1413		17	55	0.00829%	639293	94.05%	19	4.62%
偽	1420		11	54	0.008139%	639347	94.11%	19	4.62%
卓	1506		8	48	0.007235%	639395	94.77%	19	4.62%
搏	1525		13	47	0.007084%	639442	94.91%	19	4.62%
隆	1537		11	47	0.007084%	639489	94.99%	19	4.62%
戒	1567		7	44	0.006632%	639533	95.20%	19	4.62%
耶	1608		9	42	0.00633%	639575	95.46%	19	4.62%
疊	1681		22	37	0.005577%	639612	95.89%	19	4.62%
撒	1781		15	32	0.004823%	639644	96.41%	19	4.62%
償	1791		17	31	0.004672%	639675	96.46%	19	4.62%
盒	1803		11	31	0.004672%	639706	96.51%	19	4.62%
窩	1806		14	31	0.004672%	639737	96.53%	19	4.62%
閣	1812		14	31	0.004672%	639768	96.56%	19	4.62%
汁	1826		5	30	0.004522%	639798	96.62%	19	4.62%
漆	1829		14	30	0.004522%	639828	96.63%	19	4.62%
霸	1838		21	30	0.004522%	639858	96.67%	19	4.62%
爐	1850		20	29	0.004371%	639887	96.73%	19	4.62%
狠	1852		9	29	0.004371%	639916	96.73%	19	4.62%
皺	1855		15	29	0.004371%	639945	96.75%	19	4.62%
禍	1857		13	29	0.004371%	639974	96.76%	19	4.62%
胃	1861		9	29	0.004371%	640003	96.77%	19	4.62%
蹤	1865		18	29	0.004371%	640032	96.79%	19	4.62%
韻	1867		19	29	0.004371%	640061	96.80%	19	4.62%
丹	1868		4	28	0.00422%	640089	96.80%	19	4.62%
夥	1939		14	26	0.003919%	640115	97.10%	19	4.62%
慌	1947		13	26	0.003919%	640141	97.13%	19	4.62%
雀	1957		11	26	0.003919%	640167	97.17%	19	4.62%
帽	1969		12	25	0.003768%	640192	97.21%	19	4.62%
灑	1981		22	25	0.003768%	640217	97.26%	19	4.62%
莊	1985		11	25	0.003768%	640242	97.27%	19	4.62%
掀	2004		11	24	0.003617%	640266	97.34%	19	4.62%
擱	2006		17	24	0.003617%	640290	97.35%	19	4.62%
枕	2012		8	24	0.003617%	640314	97.37%	19	4.62%
舌	2019		6	24	0.003617%	640338	97.40%	19	4.62%
豬	2020		11	24	0.003617%	640362	97.40%	19	4.62%
懼	2037		21	23	0.003467%	640385	97.46%	19	4.62%
扶	2038		7	23	0.003467%	640408	97.46%	19	4.62%
妄	2065		6	22	0.003316%	640430	97.56%	19	4.62%
滯	2073		14	22	0.003316%	640452	97.58%	19	4.62%
羡	2078		12	22	0.003316%	640474	97.60%	19	4.62%
邁	2093		16	22	0.003316%	640496	97.65%	19	4.62%
煞	2113		13	21	0.003165%	640517	97.71%	19	4.62%
尬	2144		7	20	0.003014%	640537	97.81%	19	4.62%
尷	2145		17	20	0.003014%	640557	97.81%	19	4.62%
挽	2150		10	20	0.003014%	640577	97.83%	19	4.62%
碧	1163		14	81	0.01221%	640658	91.55%	18	4.38%
垃	1167		8	80	0.01206%	640738	91.60%	18	4.38%
泳	1186		8	78	0.01176%	640816	91.82%	18	4.38%
圾	1192		7	77	0.01161%	640893	91.89%	18	4.38%
劍	1369		15	58	0.008742%	640951	93.68%	18	4.38%
箱	1556		15	45	0.006783%	640996	95.12%	18	4.38%
慧	1627		15	40	0.006029%	641036	95.58%	18	4.38%
扇	1644		10	39	0.005878%	641075	95.68%	18	4.38%
傘	1673		12	37	0.005577%	641112	95.85%	18	4.38%
梁	1679		11	37	0.005577%	641149	95.88%	18	4.38%
賀	1701		12	36	0.005426%	641185	96.00%	18	4.38%
侶	1704		9	35	0.005275%	641220	96.02%	18	4.38%
棵	1758		12	33	0.004974%	641253	96.30%	18	4.38%
宅	1793		6	31	0.004672%	641284	96.47%	18	4.38%
敲	1848		14	29	0.004371%	641313	96.72%	18	4.38%
叢	1870		18	28	0.00422%	641341	96.81%	18	4.38%
埃	1872		10	28	0.00422%	641369	96.82%	18	4.38%
傻	1904		13	27	0.00407%	641396	96.96%	18	4.38%
涵	1914		11	27	0.00407%	641423	97.00%	18	4.38%
湯	1915		12	27	0.00407%	641450	97.00%	18	4.38%
剎	1934		9	26	0.003919%	641476	97.08%	18	4.38%
唸	1935		11	26	0.003919%	641502	97.08%	18	4.38%
伍	1963		6	25	0.003768%	641527	97.19%	18	4.38%
塔	1968		13	25	0.003768%	641552	97.21%	18	4.38%
摘	1976		14	25	0.003768%	641577	97.24%	18	4.38%
摺	2005		14	24	0.003617%	641601	97.35%	18	4.38%
攀	2007		19	24	0.003617%	641625	97.35%	18	4.38%
攤	2008		22	24	0.003617%	641649	97.36%	18	4.38%
纖	2017		23	24	0.003617%	641673	97.39%	18	4.38%
臂	2018		17	24	0.003617%	641697	97.39%	18	4.38%
鎖	2026		18	24	0.003617%	641721	97.42%	18	4.38%
齒	2030		15	24	0.003617%	641745	97.44%	18	4.38%
遂	2051		12	23	0.003467%	641768	97.51%	18	4.38%
傲	2059		13	22	0.003316%	641790	97.54%	18	4.38%
攜	2068		21	22	0.003316%	641812	97.57%	18	4.38%
榜	2072		14	22	0.003316%	641834	97.58%	18	4.38%
犧	2075		21	22	0.003316%	641856	97.59%	18	4.38%
闖	2095		18	22	0.003316%	641878	97.66%	18	4.38%
吉	2099		6	21	0.003165%	641899	97.67%	18	4.38%
瞭	2115		17	21	0.003165%	641920	97.72%	18	4.38%
脾	2119		12	21	0.003165%	641941	97.73%	18	4.38%
蓮	2120		15	21	0.003165%	641962	97.74%	18	4.38%
蓬	2121		15	21	0.003165%	641983	97.74%	18	4.38%
蠻	2124		25	21	0.003165%	642004	97.75%	18	4.38%
騰	2131		20	21	0.003165%	642025	97.77%	18	4.38%
哩	2136		10	20	0.003014%	642045	97.79%	18	4.38%
喧	2138		12	20	0.003014%	642065	97.79%	18	4.38%
拳	2178		10	19	0.002864%	642084	97.91%	18	4.38%
睹	2188		13	19	0.002864%	642103	97.94%	18	4.38%
糾	2190		8	19	0.002864%	642122	97.94%	18	4.38%
遜	2201		13	19	0.002864%	642141	97.98%	18	4.38%
販	1289		11	66	0.009948%	642207	92.93%	17	4.14%
郵	1387		11	57	0.008591%	642264	93.83%	17	4.14%
併	1521		8	47	0.007084%	642311	94.88%	17	4.14%
蒸	1591		14	43	0.006481%	642354	95.35%	17	4.14%
貓	1610		16	42	0.00633%	642396	95.47%	17	4.14%
屯	1612		4	41	0.00618%	642437	95.49%	17	4.14%
笨	1652		11	39	0.005878%	642476	95.73%	17	4.14%
催	1674		13	37	0.005577%	642513	95.85%	17	4.14%
譬	1684		20	37	0.005577%	642550	95.91%	17	4.14%
餅	1688		14	37	0.005577%	642587	95.93%	17	4.14%
黎	1703		15	36	0.005426%	642623	96.01%	17	4.14%
驕	1744		22	34	0.005125%	642657	96.23%	17	4.14%
錦	1770		16	33	0.004974%	642690	96.36%	17	4.14%
松	1800		8	31	0.004672%	642721	96.50%	17	4.14%
膝	1833		15	30	0.004522%	642751	96.65%	17	4.14%
翠	1860		14	29	0.004371%	642780	96.77%	17	4.14%
赫	1864		14	29	0.004371%	642809	96.79%	17	4.14%
乖	1869		8	28	0.00422%	642837	96.81%	17	4.14%
拆	1876		8	28	0.00422%	642865	96.84%	17	4.14%
撤	1878		14	28	0.00422%	642893	96.85%	17	4.14%
眠	1888		10	28	0.00422%	642921	96.89%	17	4.14%
釣	1898		11	28	0.00422%	642949	96.93%	17	4.14%
魔	1900		21	28	0.00422%	642977	96.94%	17	4.14%
棉	1911		12	27	0.00407%	643004	96.98%	17	4.14%
秒	1917		9	27	0.00407%	643031	97.01%	17	4.14%
胖	1919		9	27	0.00407%	643058	97.02%	17	4.14%
譯	1924		20	27	0.00407%	643085	97.04%	17	4.14%
賢	1926		15	27	0.00407%	643112	97.04%	17	4.14%
倆	1932		10	26	0.003919%	643138	97.07%	17	4.14%
征	1945		8	26	0.003919%	643164	97.12%	17	4.14%
綜	1952		14	26	0.003919%	643190	97.15%	17	4.14%
董	1954		13	26	0.003919%	643216	97.16%	17	4.14%
瘦	1982		14	25	0.003768%	643241	97.26%	17	4.14%
鼎	1990		13	25	0.003768%	643266	97.29%	17	4.14%
筒	2015		12	24	0.003617%	643290	97.38%	17	4.14%
川	2036		3	23	0.003467%	643313	97.46%	17	4.14%
羞	2046		11	23	0.003467%	643336	97.49%	17	4.14%
闆	2054		17	23	0.003467%	643359	97.52%	17	4.14%
裕	2087		12	22	0.003316%	643381	97.63%	17	4.14%
謹	2090		18	22	0.003316%	643403	97.64%	17	4.14%
逗	2092		10	22	0.003316%	643425	97.65%	17	4.14%
媚	2104		12	21	0.003165%	643446	97.69%	17	4.14%
柳	2108		9	21	0.003165%	643467	97.70%	17	4.14%
蜜	2123		14	21	0.003165%	643488	97.75%	17	4.14%
逾	2126		12	21	0.003165%	643509	97.75%	17	4.14%
銅	2128		14	21	0.003165%	643530	97.76%	17	4.14%
銳	2129		15	21	0.003165%	643551	97.76%	17	4.14%
仿	2132		6	20	0.003014%	643571	97.77%	17	4.14%
誘	2160		14	20	0.003014%	643591	97.86%	17	4.14%
炮	2186		9	19	0.002864%	643610	97.93%	17	4.14%
狹	2187		10	19	0.002864%	643629	97.94%	17	4.14%
俯	2205		10	18	0.002713%	643647	97.99%	17	4.14%
廂	2216		12	18	0.002713%	643665	98.02%	17	4.14%
擋	2221		16	18	0.002713%	643683	98.03%	17	4.14%
嚮	2250		18	17	0.002562%	643700	98.11%	17	4.14%
臣	2275		6	17	0.002562%	643717	98.17%	17	4.14%
曬	1152		23	82	0.01236%	643799	91.41%	16	3.89%
奶	1371		5	58	0.008742%	643857	93.69%	16	3.89%
獄	1440		14	53	0.007988%	643910	94.27%	16	3.89%
苗	1631		9	40	0.006029%	643950	95.60%	16	3.89%
耗	1736		10	34	0.005125%	643984	96.19%	16	3.89%
枚	1757		8	33	0.004974%	644017	96.29%	16	3.89%
尿	1795		7	31	0.004672%	644048	96.48%	16	3.89%
麵	1815		20	31	0.004672%	644079	96.57%	16	3.89%
蕭	1835		16	30	0.004522%	644109	96.66%	16	3.89%
蝕	1863		14	29	0.004371%	644138	96.78%	16	3.89%
悄	1910		10	27	0.00407%	644165	96.98%	16	3.89%
抄	1975		7	25	0.003768%	644190	97.24%	16	3.89%
簾	1984		19	25	0.003768%	644215	97.27%	16	3.89%
晃	2010		10	24	0.003617%	644239	97.36%	16	3.89%
瞧	2014		17	24	0.003617%	644263	97.38%	16	3.89%
糧	2016		18	24	0.003617%	644287	97.39%	16	3.89%
蹲	2021		19	24	0.003617%	644311	97.40%	16	3.89%
轟	2023		21	24	0.003617%	644335	97.41%	16	3.89%
膀	2048		14	23	0.003467%	644358	97.50%	16	3.89%
碗	2076		13	22	0.003316%	644380	97.59%	16	3.89%
剝	2097		10	21	0.003165%	644401	97.66%	16	3.89%
曰	2107		4	21	0.003165%	644422	97.69%	16	3.89%
檔	2110		17	21	0.003165%	644443	97.70%	16	3.89%
啞	2137		11	20	0.003014%	644463	97.79%	16	3.89%
妒	2140		7	20	0.003014%	644483	97.80%	16	3.89%
嬌	2141		15	20	0.003014%	644503	97.80%	16	3.89%
宏	2142		7	20	0.003014%	644523	97.80%	16	3.89%
潑	2153		15	20	0.003014%	644543	97.84%	16	3.89%
紮	2157		11	20	0.003014%	644563	97.85%	16	3.89%
臟	2158		22	20	0.003014%	644583	97.85%	16	3.89%
託	2159		10	20	0.003014%	644603	97.85%	16	3.89%
諷	2197		16	19	0.002864%	644622	97.96%	16	3.89%
辱	2200		10	19	0.002864%	644641	97.97%	16	3.89%
卑	2208		8	18	0.002713%	644659	98.00%	16	3.89%
旺	2223		8	18	0.002713%	644677	98.04%	16	3.89%
綴	2236		14	18	0.002713%	644695	98.07%	16	3.89%
翌	2238		11	18	0.002713%	644713	98.08%	16	3.89%
邏	2246		22	18	0.002713%	644731	98.10%	16	3.89%
斥	2263		5	17	0.002562%	644748	98.14%	16	3.89%
湊	2267		12	17	0.002562%	644765	98.15%	16	3.89%
魅	2282		15	17	0.002562%	644782	98.19%	16	3.89%
喻	2295		12	16	0.002412%	644798	98.22%	16	3.89%
斤	1395		4	56	0.008441%	644854	93.90%	15	3.65%
踢	1518		15	48	0.007235%	644902	94.86%	15	3.65%
谷	1548		7	46	0.006933%	644948	95.07%	15	3.65%
亭	1581		9	43	0.006481%	644991	95.29%	15	3.65%
柏	1782		9	32	0.004823%	645023	96.41%	15	3.65%
陶	1790		10	32	0.004823%	645055	96.45%	15	3.65%
怡	1798		8	31	0.004672%	645086	96.49%	15	3.65%
巾	1823		3	30	0.004522%	645116	96.61%	15	3.65%
漁	1830		14	30	0.004522%	645146	96.64%	15	3.65%
刑	1840		6	29	0.004371%	645175	96.68%	15	3.65%
塑	1873		13	28	0.00422%	645203	96.83%	15	3.65%
爸	1886		8	28	0.00422%	645231	96.88%	15	3.65%
欽	1913		12	27	0.00407%	645258	96.99%	15	3.65%
頸	1960		16	26	0.003919%	645284	97.18%	15	3.65%
殼	1978		12	25	0.003768%	645309	97.25%	15	3.65%
寡	1999		14	24	0.003617%	645333	97.32%	15	3.65%
証	2050		12	23	0.003467%	645356	97.51%	15	3.65%
鼠	2057		13	23	0.003467%	645379	97.53%	15	3.65%
肌	2079		6	22	0.003316%	645401	97.60%	15	3.65%
渾	2112		12	21	0.003165%	645422	97.71%	15	3.65%
辰	2125		7	21	0.003165%	645443	97.75%	15	3.65%
哄	2135		9	20	0.003014%	645463	97.78%	15	3.65%
糟	2156		17	20	0.003014%	645483	97.85%	15	3.65%
墜	2174		15	19	0.002864%	645502	97.90%	15	3.65%
渺	2184		12	19	0.002864%	645521	97.93%	15	3.65%
粒	2189		11	19	0.002864%	645540	97.94%	15	3.65%
蜂	2193		13	19	0.002864%	645559	97.95%	15	3.65%
誓	2196		14	19	0.002864%	645578	97.96%	15	3.65%
恭	2217		10	18	0.002713%	645596	98.02%	15	3.65%
洛	2227		9	18	0.002713%	645614	98.05%	15	3.65%
瑣	2231		14	18	0.002713%	645632	98.06%	15	3.65%
粹	2235		14	18	0.002713%	645650	98.07%	15	3.65%
遵	2245		15	18	0.002713%	645668	98.10%	15	3.65%
戚	2258		11	17	0.002562%	645685	98.13%	15	3.65%
仇	2285		4	16	0.002412%	645701	98.20%	15	3.65%
暈	2301		13	16	0.002412%	645717	98.24%	15	3.65%
闢	2331		21	16	0.002412%	645733	98.31%	15	3.65%
馳	2333		13	16	0.002412%	645749	98.31%	15	3.65%
魄	2334		15	16	0.002412%	645765	98.32%	15	3.65%
掠	2350		11	15	0.002261%	645780	98.35%	15	3.65%
罩	2369		13	15	0.002261%	645795	98.40%	15	3.65%
郭	1035		10	101	0.01522%	645896	89.80%	14	3.41%
圳	1204		6	75	0.0113%	645971	92.03%	14	3.41%
巳	1491		3	49	0.007385%	646020	94.66%	14	3.41%
趙	1634		14	40	0.006029%	646060	95.62%	14	3.41%
箭	1666		15	38	0.005728%	646098	95.81%	14	3.41%
孕	1750		5	33	0.004974%	646131	96.26%	14	3.41%
樁	1759		15	33	0.004974%	646164	96.30%	14	3.41%
灼	1761		7	33	0.004974%	646197	96.31%	14	3.41%
叔	1819		8	30	0.004522%	646227	96.59%	14	3.41%
祥	1889		10	28	0.00422%	646255	96.89%	14	3.41%
嗚	1936		13	26	0.003919%	646281	97.08%	14	3.41%
吻	1967		7	25	0.003768%	646306	97.21%	14	3.41%
廁	1970		12	25	0.003768%	646331	97.22%	14	3.41%
瑰	2013		14	24	0.003617%	646355	97.38%	14	3.41%
囉	2034		22	23	0.003467%	646378	97.45%	14	3.41%
粧	2045		12	23	0.003467%	646401	97.49%	14	3.41%
耕	2047		10	23	0.003467%	646424	97.50%	14	3.41%
伶	2058		7	22	0.003316%	646446	97.53%	14	3.41%
棋	2071		12	22	0.003316%	646468	97.58%	14	3.41%
辣	2091		14	22	0.003316%	646490	97.64%	14	3.41%
挖	2105		9	21	0.003165%	646511	97.69%	14	3.41%
碩	2116		14	21	0.003165%	646532	97.72%	14	3.41%
綱	2117		14	21	0.003165%	646553	97.73%	14	3.41%
址	2139		7	20	0.003014%	646573	97.79%	14	3.41%
疼	2154		10	20	0.003014%	646593	97.84%	14	3.41%
粵	2155		13	20	0.003014%	646613	97.84%	14	3.41%
勒	2168		11	19	0.002864%	646632	97.88%	14	3.41%
哼	2169		10	19	0.002864%	646651	97.88%	14	3.41%
挫	2179		10	19	0.002864%	646670	97.91%	14	3.41%
灌	2185		21	19	0.002864%	646689	97.93%	14	3.41%
衍	2194		9	19	0.002864%	646708	97.96%	14	3.41%
釘	2203		10	19	0.002864%	646727	97.98%	14	3.41%
哉	2210		9	18	0.002713%	646745	98.00%	14	3.41%
墮	2214		15	18	0.002713%	646763	98.01%	14	3.41%
婉	2215		11	18	0.002713%	646781	98.01%	14	3.41%
拓	2218		8	18	0.002713%	646799	98.02%	14	3.41%
浩	2228		10	18	0.002713%	646817	98.05%	14	3.41%
羊	2237		6	18	0.002713%	646835	98.07%	14	3.41%
蠢	2244		21	18	0.002713%	646853	98.09%	14	3.41%
兜	2248		11	17	0.002562%	646870	98.10%	14	3.41%
夷	2251		6	17	0.002562%	646887	98.11%	14	3.41%
慈	2256		13	17	0.002562%	646904	98.12%	14	3.41%
攏	2262		19	17	0.002562%	646921	98.14%	14	3.41%
朽	2302		6	16	0.002412%	646937	98.24%	14	3.41%
歇	2304		13	16	0.002412%	646953	98.24%	14	3.41%
燭	2311		17	16	0.002412%	646969	98.26%	14	3.41%
膊	2320		14	16	0.002412%	646985	98.28%	14	3.41%
謬	2324		18	16	0.002412%	647001	98.29%	14	3.41%
賜	2325		15	16	0.002412%	647017	98.29%	14	3.41%
趟	2326		15	16	0.002412%	647033	98.30%	14	3.41%
軀	2327		18	16	0.002412%	647049	98.30%	14	3.41%
恥	2349		10	15	0.002261%	647064	98.35%	14	3.41%
酷	2381		14	15	0.002261%	647079	98.42%	14	3.41%
凍	2390		10	14	0.00211%	647093	98.44%	14	3.41%
擲	2405		18	14	0.00211%	647107	98.47%	14	3.41%
棚	2408		12	14	0.00211%	647121	98.48%	14	3.41%
昇	1151		8	82	0.01236%	647203	91.40%	13	3.16%
兌	1190		7	77	0.01161%	647280	91.87%	13	3.16%
牠	1284		7	67	0.0101%	647347	92.88%	13	3.16%
鄭	1578		14	44	0.006632%	647391	95.27%	13	3.16%
癡	1651		19	39	0.005878%	647430	95.72%	13	3.16%
咕	1707		8	35	0.005275%	647465	96.03%	13	3.16%
蔬	1787		15	32	0.004823%	647497	96.44%	13	3.16%
埔	1821		10	30	0.004522%	647527	96.60%	13	3.16%
蟲	1923		18	27	0.00407%	647554	97.03%	13	3.16%
兮	1933		4	26	0.003919%	647580	97.07%	13	3.16%
墊	1938		14	26	0.003919%	647606	97.09%	13	3.16%
娜	1942		10	26	0.003919%	647632	97.11%	13	3.16%
僚	1993		14	24	0.003617%	647656	97.30%	13	3.16%
扯	2003		7	24	0.003617%	647680	97.34%	13	3.16%
押	2039		8	23	0.003467%	647703	97.47%	13	3.16%
玫	2044		8	23	0.003467%	647726	97.49%	13	3.16%
壽	2063		14	22	0.003316%	647748	97.55%	13	3.16%
奕	2064		9	22	0.003316%	647770	97.55%	13	3.16%
柴	2070		10	22	0.003316%	647792	97.57%	13	3.16%
蚊	2086		10	22	0.003316%	647814	97.63%	13	3.16%
覓	2088		11	22	0.003316%	647836	97.63%	13	3.16%
崩	2147		11	20	0.003014%	647856	97.82%	13	3.16%
軌	2161		9	20	0.003014%	647876	97.86%	13	3.16%
銘	2163		14	20	0.003014%	647896	97.87%	13	3.16%
喬	2171		12	19	0.002864%	647915	97.89%	13	3.16%
斗	2180		4	19	0.002864%	647934	97.92%	13	3.16%
襟	2195		18	19	0.002864%	647953	97.96%	13	3.16%
咪	2211		9	18	0.002713%	647971	98.00%	13	3.16%
燦	2229		17	18	0.002713%	647989	98.05%	13	3.16%
雕	2247		16	18	0.002713%	648007	98.10%	13	3.16%
枉	2265		8	17	0.002562%	648024	98.15%	13	3.16%
罐	2272		24	17	0.002562%	648041	98.17%	13	3.16%
臥	2276		8	17	0.002562%	648058	98.18%	13	3.16%
鵝	2283		18	17	0.002562%	648075	98.19%	13	3.16%
倉	2288		10	16	0.002412%	648091	98.21%	13	3.16%
爵	2312		17	16	0.002412%	648107	98.26%	13	3.16%
磚	2316		16	16	0.002412%	648123	98.27%	13	3.16%
喘	2340		12	15	0.002261%	648138	98.33%	13	3.16%
嘲	2341		15	15	0.002261%	648153	98.33%	13	3.16%
敷	2351		15	15	0.002261%	648168	98.36%	13	3.16%
澄	2359		15	15	0.002261%	648183	98.37%	13	3.16%
腕	2371		12	15	0.002261%	648198	98.40%	13	3.16%
誼	2378		15	15	0.002261%	648213	98.42%	13	3.16%
躁	2380		20	15	0.002261%	648228	98.42%	13	3.16%
僵	2388		15	14	0.00211%	648242	98.44%	13	3.16%
匿	2391		11	14	0.00211%	648256	98.44%	13	3.16%
啼	2393		12	14	0.00211%	648270	98.45%	13	3.16%
拙	2403		8	14	0.00211%	648284	98.47%	13	3.16%
燥	2416		17	14	0.00211%	648298	98.50%	13	3.16%
鴻	2439		17	14	0.00211%	648312	98.55%	13	3.16%
桃	1173		10	79	0.01191%	648391	91.67%	12	2.92%
烹	1618		11	41	0.00618%	648432	95.52%	12	2.92%
鈴	1769		13	33	0.004974%	648465	96.35%	12	2.92%
濤	1785		17	32	0.004823%	648497	96.43%	12	2.92%
帳	1796		11	31	0.004672%	648528	96.48%	12	2.92%
袍	1808		10	31	0.004672%	648559	96.54%	12	2.92%
洪	1882		9	28	0.00422%	648587	96.86%	12	2.92%
乳	1901		8	27	0.00407%	648614	96.94%	12	2.92%
巿	1908		4	27	0.00407%	648641	96.97%	12	2.92%
鴨	1961		16	26	0.003919%	648667	97.18%	12	2.92%
漿	1979		15	25	0.003768%	648692	97.25%	12	2.92%
堤	1997		12	24	0.003617%	648716	97.32%	12	2.92%
曼	2011		11	24	0.003617%	648740	97.37%	12	2.92%
株	2041		10	23	0.003467%	648763	97.48%	12	2.92%
銜	2053		14	23	0.003467%	648786	97.52%	12	2.92%
券	2060		8	22	0.003316%	648808	97.54%	12	2.92%
匪	2061		10	22	0.003316%	648830	97.54%	12	2.92%
捐	2067		10	22	0.003316%	648852	97.56%	12	2.92%
柄	2069		9	22	0.003316%	648874	97.57%	12	2.92%
煥	2074		13	22	0.003316%	648896	97.59%	12	2.92%
膜	2083		15	22	0.003316%	648918	97.62%	12	2.92%
膨	2084		16	22	0.003316%	648940	97.62%	12	2.92%
艾	2085		6	22	0.003316%	648962	97.62%	12	2.92%
呎	2100		7	21	0.003165%	648983	97.67%	12	2.92%
啤	2101		11	21	0.003165%	649004	97.68%	12	2.92%
盜	2114		12	21	0.003165%	649025	97.72%	12	2.92%
匹	2133		4	20	0.003014%	649045	97.78%	12	2.92%
咖	2134		8	20	0.003014%	649065	97.78%	12	2.92%
嶺	2149		17	20	0.003014%	649085	97.82%	12	2.92%
傭	2166		13	19	0.002864%	649104	97.88%	12	2.92%
啡	2170		11	19	0.002864%	649123	97.89%	12	2.92%
惶	2177		12	19	0.002864%	649142	97.91%	12	2.92%
昌	2181		8	19	0.002864%	649161	97.92%	12	2.92%
譚	2199		19	19	0.002864%	649180	97.97%	12	2.92%
郊	2202		8	19	0.002864%	649199	97.98%	12	2.92%
兇	2207		6	18	0.002713%	649217	97.99%	12	2.92%
斬	2222		11	18	0.002713%	649235	98.03%	12	2.92%
牧	2230		8	18	0.002713%	649253	98.06%	12	2.92%
稚	2234		13	18	0.002713%	649271	98.07%	12	2.92%
肝	2240		7	18	0.002713%	649289	98.08%	12	2.92%
芬	2241		8	18	0.002713%	649307	98.08%	12	2.92%
奴	2252		5	17	0.002562%	649324	98.11%	12	2.92%
弦	2255		8	17	0.002562%	649341	98.12%	12	2.92%
拱	2259		9	17	0.002562%	649358	98.13%	12	2.92%
撰	2261		15	17	0.002562%	649375	98.14%	12	2.92%
繳	2271		19	17	0.002562%	649392	98.16%	12	2.92%
傢	2289		12	16	0.002412%	649408	98.21%	12	2.92%
吾	2293		7	16	0.002412%	649424	98.22%	12	2.92%
梅	2303		11	16	0.002412%	649440	98.24%	12	2.92%
溢	2306		13	16	0.002412%	649456	98.25%	12	2.92%
瞥	2314		16	16	0.002412%	649472	98.27%	12	2.92%
肆	2319		13	16	0.002412%	649488	98.28%	12	2.92%
閑	2330		12	16	0.002412%	649504	98.31%	12	2.92%
契	2344		9	15	0.002261%	649519	98.34%	12	2.92%
屁	2346		7	15	0.002261%	649534	98.34%	12	2.92%
瀟	2360		19	15	0.002261%	649549	98.38%	12	2.92%
焉	2361		11	15	0.002261%	649564	98.38%	12	2.92%
爺	2362		13	15	0.002261%	649579	98.38%	12	2.92%
癮	2364		22	15	0.002261%	649594	98.38%	12	2.92%
矮	2365		13	15	0.002261%	649609	98.39%	12	2.92%
蘋	2376		20	15	0.002261%	649624	98.41%	12	2.92%
詠	2377		12	15	0.002261%	649639	98.41%	12	2.92%
侍	2386		8	14	0.00211%	649653	98.43%	12	2.92%
冤	2389		10	14	0.00211%	649667	98.44%	12	2.92%
囊	2394		22	14	0.00211%	649681	98.45%	12	2.92%
憾	2402		16	14	0.00211%	649695	98.47%	12	2.92%
歎	2410		15	14	0.00211%	649709	98.48%	12	2.92%
歪	2411		9	14	0.00211%	649723	98.49%	12	2.92%
瑞	2418		13	14	0.00211%	649737	98.50%	12	2.92%
臘	2425		19	14	0.00211%	649751	98.52%	12	2.92%
謙	2430		17	14	0.00211%	649765	98.53%	12	2.92%
頑	2436		13	14	0.00211%	649779	98.54%	12	2.92%
頰	2438		16	14	0.00211%	649793	98.54%	12	2.92%
黯	2440		21	14	0.00211%	649807	98.55%	12	2.92%
寓	2450		12	13	0.001959%	649820	98.57%	12	2.92%
屑	2451		10	13	0.001959%	649833	98.57%	12	2.92%
械	2457		11	13	0.001959%	649846	98.58%	12	2.92%
歉	2458		14	13	0.001959%	649859	98.58%	12	2.92%
宴	2495		10	12	0.001809%	649871	98.65%	12	2.92%
稽	2527		15	12	0.001809%	649883	98.71%	12	2.92%
蛇	2542		11	12	0.001809%	649895	98.74%	12	2.92%
隙	2554		13	12	0.001809%	649907	98.76%	12	2.92%
煲	983		13	111	0.01673%	650018	88.97%	11	2.68%
妝	1600		7	42	0.00633%	650060	95.41%	11	2.68%
您	1641		11	39	0.005878%	650099	95.66%	11	2.68%
紗	1718		10	35	0.005275%	650134	96.09%	11	2.68%
妳	1907		8	27	0.00407%	650161	96.97%	11	2.68%
堡	1937		12	26	0.003919%	650187	97.09%	11	2.68%
劫	2031		7	23	0.003467%	650210	97.44%	11	2.68%
溪	2043		13	23	0.003467%	650233	97.48%	11	2.68%
卜	2098		2	21	0.003165%	650254	97.67%	11	2.68%
栽	2109		10	21	0.003165%	650275	97.70%	11	2.68%
宙	2143		8	20	0.003014%	650295	97.81%	11	2.68%
嘻	2172		15	19	0.002864%	650314	97.89%	11	2.68%
幢	2176		15	19	0.002864%	650333	97.90%	11	2.68%
薩	2191		18	19	0.002864%	650352	97.95%	11	2.68%
謊	2198		17	19	0.002864%	650371	97.97%	11	2.68%
瓣	2232		19	18	0.002713%	650389	98.06%	11	2.68%
聳	2239		17	18	0.002713%	650407	98.08%	11	2.68%
寵	2253		19	17	0.002562%	650424	98.12%	11	2.68%
戈	2257		4	17	0.002562%	650441	98.13%	11	2.68%
煉	2268		13	17	0.002562%	650458	98.15%	11	2.68%
籤	2270		23	17	0.002562%	650475	98.16%	11	2.68%
聆	2273		11	17	0.002562%	650492	98.17%	11	2.68%
贏	2279		20	17	0.002562%	650509	98.18%	11	2.68%
黏	2284		17	17	0.002562%	650526	98.20%	11	2.68%
仗	2286		5	16	0.002412%	650542	98.20%	11	2.68%
叮	2292		5	16	0.002412%	650558	98.22%	11	2.68%
昧	2300		9	16	0.002412%	650574	98.23%	11	2.68%
汪	2305		7	16	0.002412%	650590	98.25%	11	2.68%
睜	2313		13	16	0.002412%	650606	98.27%	11	2.68%
蔽	2321		15	16	0.002412%	650622	98.29%	11	2.68%
佐	2336		7	15	0.002261%	650637	98.32%	11	2.68%
塘	2342		13	15	0.002261%	650652	98.33%	11	2.68%
樸	2355		16	15	0.002261%	650667	98.36%	11	2.68%
洽	2356		9	15	0.002261%	650682	98.37%	11	2.68%
溶	2358		13	15	0.002261%	650697	98.37%	11	2.68%
礦	2367		20	15	0.002261%	650712	98.39%	11	2.68%
萊	2373		12	15	0.002261%	650727	98.40%	11	2.68%
佬	2387		8	14	0.00211%	650741	98.44%	11	2.68%
卅	2392		4	14	0.00211%	650755	98.45%	11	2.68%
嬴	2398		16	14	0.00211%	650769	98.46%	11	2.68%
崗	2399		11	14	0.00211%	650783	98.46%	11	2.68%
怖	2401		8	14	0.00211%	650797	98.47%	11	2.68%
晰	2406		12	14	0.00211%	650811	98.48%	11	2.68%
淑	2412		11	14	0.00211%	650825	98.49%	11	2.68%
肺	2423		8	14	0.00211%	650839	98.51%	11	2.68%
腫	2424		13	14	0.00211%	650853	98.51%	11	2.68%
賊	2431		13	14	0.00211%	650867	98.53%	11	2.68%
頒	2437		13	14	0.00211%	650881	98.54%	11	2.68%
弊	2453		14	13	0.001959%	650894	98.57%	11	2.68%
昔	2456		8	13	0.001959%	650907	98.58%	11	2.68%
碌	2466		13	13	0.001959%	650920	98.60%	11	2.68%
繃	2467		17	13	0.001959%	650933	98.60%	11	2.68%
鞭	2480		18	13	0.001959%	650946	98.63%	11	2.68%
坊	2494		7	12	0.001809%	650958	98.65%	11	2.68%
愧	2499		13	12	0.001809%	650970	98.66%	11	2.68%
扔	2501		5	12	0.001809%	650982	98.66%	11	2.68%
掏	2504		11	12	0.001809%	650994	98.67%	11	2.68%
擅	2506		16	12	0.001809%	651006	98.67%	11	2.68%
暮	2509		15	12	0.001809%	651018	98.68%	11	2.68%
繽	2533		20	12	0.001809%	651030	98.72%	11	2.68%
葛	2540		13	12	0.001809%	651042	98.74%	11	2.68%
裹	2546		14	12	0.001809%	651054	98.75%	11	2.68%
輾	2548		17	12	0.001809%	651066	98.75%	11	2.68%
迂	2549		6	12	0.001809%	651078	98.75%	11	2.68%
遣	2550		13	12	0.001809%	651090	98.75%	11	2.68%
鍊	2552		17	12	0.001809%	651102	98.76%	11	2.68%
鍋	2553		17	12	0.001809%	651114	98.76%	11	2.68%
霉	2555		15	12	0.001809%	651126	98.76%	11	2.68%
仲	2559		6	11	0.001658%	651137	98.77%	11	2.68%
凸	2561		5	11	0.001658%	651148	98.77%	11	2.68%
嘔	2570		14	11	0.001658%	651159	98.79%	11	2.68%
履	2574		15	11	0.001658%	651170	98.79%	11	2.68%
禱	2598		18	11	0.001658%	651181	98.83%	11	2.68%
羽	2602		6	11	0.001658%	651192	98.84%	11	2.68%
翅	2603		10	11	0.001658%	651203	98.84%	11	2.68%
贈	2612		19	11	0.001658%	651214	98.86%	11	2.68%
輿	2614		17	11	0.001658%	651225	98.86%	11	2.68%
閘	2616		13	11	0.001658%	651236	98.86%	11	2.68%
鮑	1419		16	55	0.00829%	651291	94.10%	10	2.43%
桂	1783		10	32	0.004823%	651323	96.42%	10	2.43%
廟	1874		15	28	0.00422%	651351	96.83%	10	2.43%
榕	1880		14	28	0.00422%	651379	96.85%	10	2.43%
厘	1906		9	27	0.00407%	651406	96.96%	10	2.43%
靚	1958		15	26	0.003919%	651432	97.17%	10	2.43%
齣	1991		20	25	0.003768%	651457	97.30%	10	2.43%
沫	2042		8	23	0.003467%	651480	97.48%	10	2.43%
恤	2066		9	22	0.003316%	651502	97.56%	10	2.43%
捏	2106		10	21	0.003165%	651523	97.69%	10	2.43%
峽	2146		10	20	0.003014%	651543	97.82%	10	2.43%
噪	2173		16	19	0.002864%	651562	97.90%	10	2.43%
俠	2204		9	18	0.002713%	651580	97.98%	10	2.43%
咁	2209		8	18	0.002713%	651598	98.00%	10	2.43%
掣	2219		12	18	0.002713%	651616	98.03%	10	2.43%
搓	2220		13	18	0.002713%	651634	98.03%	10	2.43%
蝦	2243		15	18	0.002713%	651652	98.09%	10	2.43%
搵	2260		13	17	0.002562%	651669	98.13%	10	2.43%
籃	2269		20	17	0.002562%	651686	98.16%	10	2.43%
膏	2274		14	17	0.002562%	651703	98.17%	10	2.43%
裳	2278		14	17	0.002562%	651720	98.18%	10	2.43%
刮	2290		8	16	0.002412%	651736	98.21%	10	2.43%
磋	2315		15	16	0.002412%	651752	98.27%	10	2.43%
縣	2317		16	16	0.002412%	651768	98.28%	10	2.43%
蘆	2322		20	16	0.002412%	651784	98.29%	10	2.43%
役	2348		7	15	0.002261%	651799	98.35%	10	2.43%
晤	2353		11	15	0.002261%	651814	98.36%	10	2.43%
癢	2363		20	15	0.002261%	651829	98.38%	10	2.43%
賠	2379		15	15	0.002261%	651844	98.42%	10	2.43%
揣	2404		12	14	0.00211%	651858	98.47%	10	2.43%
框	2407		10	14	0.00211%	651872	98.48%	10	2.43%
熬	2415		15	14	0.00211%	651886	98.50%	10	2.43%
耍	2421		9	14	0.00211%	651900	98.51%	10	2.43%
霜	2435		17	14	0.00211%	651914	98.54%	10	2.43%
壹	2447		12	13	0.001959%	651927	98.56%	10	2.43%
屠	2452		11	13	0.001959%	651940	98.57%	10	2.43%
掘	2455		11	13	0.001959%	651953	98.58%	10	2.43%
畔	2463		10	13	0.001959%	651966	98.59%	10	2.43%
皂	2465		7	13	0.001959%	651979	98.60%	10	2.43%
翁	2468		10	13	0.001959%	651992	98.60%	10	2.43%
豎	2474		15	13	0.001959%	652005	98.61%	10	2.43%
賤	2475		15	13	0.001959%	652018	98.62%	10	2.43%
几	2486		2	12	0.001809%	652030	98.64%	10	2.43%
嚼	2492		20	12	0.001809%	652042	98.65%	10	2.43%
抨	2503		8	12	0.001809%	652054	98.67%	10	2.43%
撈	2505		15	12	0.001809%	652066	98.67%	10	2.43%
旬	2507		6	12	0.001809%	652078	98.68%	10	2.43%
獸	2519		19	12	0.001809%	652090	98.70%	10	2.43%
縛	2531		16	12	0.001809%	652102	98.72%	10	2.43%
縷	2532		17	12	0.001809%	652114	98.72%	10	2.43%
虞	2541		13	12	0.001809%	652126	98.74%	10	2.43%
顛	2556		19	12	0.001809%	652138	98.76%	10	2.43%
鳳	2557		14	12	0.001809%	652150	98.77%	10	2.43%
冀	2560		16	11	0.001658%	652161	98.77%	10	2.43%
匠	2564		6	11	0.001658%	652172	98.78%	10	2.43%
嗅	2569		13	11	0.001658%	652183	98.79%	10	2.43%
棒	2580		12	11	0.001658%	652194	98.80%	10	2.43%
洶	2582		9	11	0.001658%	652205	98.81%	10	2.43%
漓	2586		14	11	0.001658%	652216	98.81%	10	2.43%
澀	2588		17	11	0.001658%	652227	98.82%	10	2.43%
矚	2593		26	11	0.001658%	652238	98.83%	10	2.43%
竭	2599		14	11	0.001658%	652249	98.84%	10	2.43%
茂	2605		9	11	0.001658%	652260	98.85%	10	2.43%
蔭	2607		15	11	0.001658%	652271	98.85%	10	2.43%
俾	2623		10	10	0.001507%	652281	98.87%	10	2.43%
啥	2630		11	10	0.001507%	652291	98.89%	10	2.43%
撕	2646		15	10	0.001507%	652301	98.91%	10	2.43%
沸	2653		8	10	0.001507%	652311	98.92%	10	2.43%
淆	2654		11	10	0.001507%	652321	98.92%	10	2.43%
祈	2668		8	10	0.001507%	652331	98.94%	10	2.43%
竄	2671		18	10	0.001507%	652341	98.95%	10	2.43%
翹	2678		18	10	0.001507%	652351	98.96%	10	2.43%
肢	2680		8	10	0.001507%	652361	98.96%	10	2.43%
胎	2681		9	10	0.001507%	652371	98.96%	10	2.43%
虐	2685		9	10	0.001507%	652381	98.97%	10	2.43%
諱	2686		16	10	0.001507%	652391	98.97%	10	2.43%
迄	2690		6	10	0.001507%	652401	98.98%	10	2.43%
釀	2692		24	10	0.001507%	652411	98.98%	10	2.43%
陋	2695		8	10	0.001507%	652421	98.98%	10	2.43%
飢	2697		10	10	0.001507%	652431	98.99%	10	2.43%
柯	1849		9	29	0.004371%	652460	96.72%	9	2.19%
宋	1943		7	26	0.003919%	652486	97.11%	9	2.19%
咳	1994		9	24	0.003617%	652510	97.31%	9	2.19%
墓	1998		14	24	0.003617%	652534	97.32%	9	2.19%
崖	2000		11	24	0.003617%	652558	97.33%	9	2.19%
軒	2022		10	24	0.003617%	652582	97.41%	9	2.19%
嬸	2035		18	23	0.003467%	652605	97.45%	9	2.19%
嶼	2148		17	20	0.003014%	652625	97.82%	9	2.19%
沈	2183		7	19	0.002864%	652644	97.92%	9	2.19%
薦	2192		18	19	0.002864%	652663	97.95%	9	2.19%
桶	2226		11	18	0.002713%	652681	98.04%	9	2.19%
菊	2242		12	18	0.002713%	652699	98.09%	9	2.19%
后	2249		6	17	0.002562%	652716	98.11%	9	2.19%
迪	2280		8	17	0.002562%	652733	98.19%	9	2.19%
喃	2294		12	16	0.002412%	652749	98.22%	9	2.19%
廷	2298		7	16	0.002412%	652765	98.23%	9	2.19%
潰	2309		15	16	0.002412%	652781	98.26%	9	2.19%
燕	2310		16	16	0.002412%	652797	98.26%	9	2.19%
	2318		11	16	0.002412%	652813	98.28%	9	2.19%
蝶	2323		15	16	0.002412%	652829	98.29%	9	2.19%
轄	2328		17	16	0.002412%	652845	98.30%	9	2.19%
郤	2329		9	16	0.002412%	652861	98.30%	9	2.19%
墳	2343		15	15	0.002261%	652876	98.34%	9	2.19%
巷	2347		9	15	0.002261%	652891	98.35%	9	2.19%
淒	2357		11	15	0.002261%	652906	98.37%	9	2.19%
碑	2366		13	15	0.002261%	652921	98.39%	9	2.19%
羈	2370		24	15	0.002261%	652936	98.40%	9	2.19%
膩	2372		16	15	0.002261%	652951	98.40%	9	2.19%
霞	2383		17	15	0.002261%	652966	98.43%	9	2.19%
鬚	2384		22	15	0.002261%	652981	98.43%	9	2.19%
坪	2395		8	14	0.00211%	652995	98.45%	9	2.19%
奸	2396		6	14	0.00211%	653009	98.46%	9	2.19%
濾	2413		18	14	0.00211%	653023	98.49%	9	2.19%
秦	2420		10	14	0.00211%	653037	98.51%	9	2.19%
醬	2433		18	14	0.00211%	653051	98.53%	9	2.19%
咱	2443		9	13	0.001959%	653064	98.55%	9	2.19%
嚐	2444		17	13	0.001959%	653077	98.56%	9	2.19%
嚕	2445		18	13	0.001959%	653090	98.56%	9	2.19%
愕	2454		12	13	0.001959%	653103	98.58%	9	2.19%
氈	2459		17	13	0.001959%	653116	98.59%	9	2.19%
誦	2473		14	13	0.001959%	653129	98.61%	9	2.19%
錫	2477		16	13	0.001959%	653142	98.62%	9	2.19%
鬍	2481		19	13	0.001959%	653155	98.63%	9	2.19%
余	2483		7	12	0.001809%	653167	98.63%	9	2.19%
噴	2491		15	12	0.001809%	653179	98.65%	9	2.19%
悴	2497		11	12	0.001809%	653191	98.66%	9	2.19%
憔	2500		15	12	0.001809%	653203	98.66%	9	2.19%
桑	2511		10	12	0.001809%	653215	98.68%	9	2.19%
瀉	2516		18	12	0.001809%	653227	98.69%	9	2.19%
獃	2518		14	12	0.001809%	653239	98.70%	9	2.19%
祭	2525		11	12	0.001809%	653251	98.71%	9	2.19%
粥	2529		12	12	0.001809%	653263	98.72%	9	2.19%
芝	2535		8	12	0.001809%	653275	98.73%	9	2.19%
鈕	2551		12	12	0.001809%	653287	98.76%	9	2.19%
剔	2563		10	11	0.001658%	653298	98.78%	9	2.19%
挨	2576		10	11	0.001658%	653309	98.80%	9	2.19%
沮	2581		8	11	0.001658%	653320	98.81%	9	2.19%
淘	2584		11	11	0.001658%	653331	98.81%	9	2.19%
甦	2590		12	11	0.001658%	653342	98.82%	9	2.19%
碟	2597		14	11	0.001658%	653353	98.83%	9	2.19%
繩	2601		19	11	0.001658%	653364	98.84%	9	2.19%
嚨	2631		20	10	0.001507%	653374	98.89%	9	2.19%
恕	2637		10	10	0.001507%	653384	98.90%	9	2.19%
惕	2638		11	10	0.001507%	653394	98.90%	9	2.19%
扁	2639		9	10	0.001507%	653404	98.90%	9	2.19%
挾	2641		10	10	0.001507%	653414	98.90%	9	2.19%
挪	2642		10	10	0.001507%	653424	98.90%	9	2.19%
撇	2643		14	10	0.001507%	653434	98.90%	9	2.19%
摔	2644		14	10	0.001507%	653444	98.91%	9	2.19%
攬	2647		24	10	0.001507%	653454	98.91%	9	2.19%
梳	2649		10	10	0.001507%	653464	98.91%	9	2.19%
檯	2651		18	10	0.001507%	653474	98.92%	9	2.19%
眶	2665		11	10	0.001507%	653484	98.94%	9	2.19%
綻	2674		14	10	0.001507%	653494	98.95%	9	2.19%
繹	2676		19	10	0.001507%	653504	98.95%	9	2.19%
蘊	2684		20	10	0.001507%	653514	98.97%	9	2.19%
豫	2687		16	10	0.001507%	653524	98.97%	9	2.19%
踩	2689		15	10	0.001507%	653534	98.97%	9	2.19%
叉	2703		3	9	0.001357%	653543	98.99%	9	2.19%
囑	2711		24	9	0.001357%	653552	99.01%	9	2.19%
帥	2721		9	9	0.001357%	653561	99.02%	9	2.19%
悵	2723		11	9	0.001357%	653570	99.02%	9	2.19%
慚	2724		14	9	0.001357%	653579	99.02%	9	2.19%
憎	2725		15	9	0.001357%	653588	99.02%	9	2.19%
懇	2726		17	9	0.001357%	653597	99.03%	9	2.19%
拯	2728		9	9	0.001357%	653606	99.03%	9	2.19%
瀰	2741		20	9	0.001357%	653615	99.05%	9	2.19%
熒	2745		14	9	0.001357%	653624	99.05%	9	2.19%
狼	2747		10	9	0.001357%	653633	99.05%	9	2.19%
窺	2762		16	9	0.001357%	653642	99.07%	9	2.19%
竅	2763		18	9	0.001357%	653651	99.08%	9	2.19%
臻	2770		16	9	0.001357%	653660	99.09%	9	2.19%
訝	2777		11	9	0.001357%	653669	99.10%	9	2.19%
鄙	2781		13	9	0.001357%	653678	99.10%	9	2.19%
鑼	2786		27	9	0.001357%	653687	99.11%	9	2.19%
艇	1609		13	42	0.00633%	653729	95.47%	8	1.95%
疫	1732		9	34	0.005125%	653763	96.16%	8	1.95%
肪	1807		8	31	0.004672%	653794	96.53%	8	1.95%
娃	1941		9	26	0.003919%	653820	97.10%	8	1.95%
叛	1966		9	25	0.003768%	653845	97.20%	8	1.95%
葬	2049		13	23	0.003467%	653868	97.50%	8	1.95%
醇	2052		15	23	0.003467%	653891	97.51%	8	1.95%
穎	2077		16	22	0.003316%	653913	97.60%	8	1.95%
坤	2102		8	21	0.003165%	653934	97.68%	8	1.95%
壟	2103		19	21	0.003165%	653955	97.68%	8	1.95%
氧	2111		10	21	0.003165%	653976	97.71%	8	1.95%
曝	2151		19	20	0.003014%	653996	97.83%	8	1.95%
槽	2152		15	20	0.003014%	654016	97.83%	8	1.95%
昆	2224		8	18	0.002713%	654034	98.04%	8	1.95%
瓷	2233		11	18	0.002713%	654052	98.06%	8	1.95%
毅	2266		15	17	0.002562%	654069	98.15%	8	1.95%
冇	2337		4	15	0.002261%	654084	98.32%	8	1.95%
晉	2352		10	15	0.002261%	654099	98.36%	8	1.95%
杆	2354		7	15	0.002261%	654114	98.36%	8	1.95%
葵	2374		13	15	0.002261%	654129	98.41%	8	1.95%
乙	2385		1	14	0.00211%	654143	98.43%	8	1.95%
犬	2417		4	14	0.00211%	654157	98.50%	8	1.95%
葡	2428		13	14	0.00211%	654171	98.52%	8	1.95%
錶	2434		16	14	0.00211%	654185	98.54%	8	1.95%
傅	2442		12	13	0.001959%	654198	98.55%	8	1.95%
姬	2449		10	13	0.001959%	654211	98.57%	8	1.95%
畏	2462		9	13	0.001959%	654224	98.59%	8	1.95%
荃	2471		10	13	0.001959%	654237	98.61%	8	1.95%
凱	2487		12	12	0.001809%	654249	98.64%	8	1.95%
殷	2513		10	12	0.001809%	654261	98.69%	8	1.95%
烘	2517		10	12	0.001809%	654273	98.69%	8	1.95%
疚	2520		8	12	0.001809%	654285	98.70%	8	1.95%
盧	2522		16	12	0.001809%	654297	98.70%	8	1.95%
籮	2528		25	12	0.001809%	654309	98.71%	8	1.95%
翔	2534		12	12	0.001809%	654321	98.72%	8	1.95%
莉	2538		11	12	0.001809%	654333	98.73%	8	1.95%
裸	2545		13	12	0.001809%	654345	98.74%	8	1.95%
貯	2547		12	12	0.001809%	654357	98.75%	8	1.95%
函	2562		8	11	0.001658%	654368	98.77%	8	1.95%
吋	2565		6	11	0.001658%	654379	98.78%	8	1.95%
喂	2567		12	11	0.001658%	654390	98.78%	8	1.95%
嫩	2573		14	11	0.001658%	654401	98.79%	8	1.95%
濱	2587		17	11	0.001658%	654412	98.82%	8	1.95%
眷	2592		11	11	0.001658%	654423	98.82%	8	1.95%
矩	2594		10	11	0.001658%	654434	98.83%	8	1.95%
砌	2595		9	11	0.001658%	654445	98.83%	8	1.95%
聾	2604		22	11	0.001658%	654456	98.84%	8	1.95%
訣	2608		11	11	0.001658%	654467	98.85%	8	1.95%
譜	2610		19	11	0.001658%	654478	98.85%	8	1.95%
貶	2611		12	11	0.001658%	654489	98.86%	8	1.95%
蹟	2613		18	11	0.001658%	654500	98.86%	8	1.95%
頌	2617		13	11	0.001658%	654511	98.87%	8	1.95%
侮	2622		9	10	0.001507%	654521	98.87%	8	1.95%
咭	2628		9	10	0.001507%	654531	98.88%	8	1.95%
壘	2632		18	10	0.001507%	654541	98.89%	8	1.95%
恍	2635		9	10	0.001507%	654551	98.89%	8	1.95%
曳	2648		6	10	0.001507%	654561	98.91%	8	1.95%
獵	2661		18	10	0.001507%	654571	98.93%	8	1.95%
禿	2669		7	10	0.001507%	654581	98.94%	8	1.95%
肘	2679		7	10	0.001507%	654591	98.96%	8	1.95%
逍	2691		10	10	0.001507%	654601	98.98%	8	1.95%
鍛	2694		17	10	0.001507%	654611	98.98%	8	1.95%
隸	2696		17	10	0.001507%	654621	98.98%	8	1.95%
乍	2699		5	9	0.001357%	654630	98.99%	8	1.95%
刷	2701		8	9	0.001357%	654639	98.99%	8	1.95%
劈	2702		15	9	0.001357%	654648	98.99%	8	1.95%
塌	2715		13	9	0.001357%	654657	99.01%	8	1.95%
屏	2719		9	9	0.001357%	654666	99.02%	8	1.95%
摧	2730		14	9	0.001357%	654675	99.03%	8	1.95%
暇	2733		13	9	0.001357%	654684	99.04%	8	1.95%
樑	2737		15	9	0.001357%	654693	99.04%	8	1.95%
煎	2743		13	9	0.001357%	654702	99.05%	8	1.95%
瞄	2757		14	9	0.001357%	654711	99.07%	8	1.95%
瞬	2758		17	9	0.001357%	654720	99.07%	8	1.95%
禦	2760		16	9	0.001357%	654729	99.07%	8	1.95%
糙	2766		17	9	0.001357%	654738	99.08%	8	1.95%
苛	2771		9	9	0.001357%	654747	99.09%	8	1.95%
襪	2776		20	9	0.001357%	654756	99.09%	8	1.95%
逕	2779		10	9	0.001357%	654765	99.10%	8	1.95%
駭	2790		16	9	0.001357%	654774	99.11%	8	1.95%
騎	2791		18	9	0.001357%	654783	99.11%	8	1.95%
丸	2795		3	8	0.001206%	654791	99.12%	8	1.95%
傍	2797		12	8	0.001206%	654799	99.12%	8	1.95%
刪	2799		7	8	0.001206%	654807	99.12%	8	1.95%
噓	2808		15	8	0.001206%	654815	99.13%	8	1.95%
囂	2811		21	8	0.001206%	654823	99.14%	8	1.95%
嫵	2817		15	8	0.001206%	654831	99.15%	8	1.95%
峻	2818		10	8	0.001206%	654839	99.15%	8	1.95%
惆	2822		11	8	0.001206%	654847	99.15%	8	1.95%
晴	2830		12	8	0.001206%	654855	99.16%	8	1.95%
橘	2834		16	8	0.001206%	654863	99.17%	8	1.95%
汰	2836		7	8	0.001206%	654871	99.17%	8	1.95%
淵	2839		11	8	0.001206%	654879	99.17%	8	1.95%
瞻	2848		18	8	0.001206%	654887	99.18%	8	1.95%
蔓	2858		15	8	0.001206%	654895	99.20%	8	1.95%
袱	2864		11	8	0.001206%	654903	99.20%	8	1.95%
轍	2871		18	8	0.001206%	654911	99.21%	8	1.95%
鑒	2875		22	8	0.001206%	654919	99.22%	8	1.95%
囚	2062		5	22	0.003316%	654941	97.55%	7	1.70%
鎊	2130		18	21	0.003165%	654962	97.77%	7	1.70%
陵	2164		10	20	0.003014%	654982	97.87%	7	1.70%
兔	2167		8	19	0.002864%	655001	97.88%	7	1.70%
僑	2206		14	18	0.002713%	655019	97.99%	7	1.70%
噸	2212		16	18	0.002713%	655037	98.01%	7	1.70%
佢	2287		7	16	0.002412%	655053	98.20%	7	1.70%
懲	2299		19	16	0.002412%	655069	98.23%	7	1.70%
滔	2307		13	16	0.002412%	655085	98.25%	7	1.70%
剃	2339		9	15	0.002261%	655100	98.33%	7	1.70%
姆	2345		8	15	0.002261%	655115	98.34%	7	1.70%
穴	2368		5	15	0.002261%	655130	98.39%	7	1.70%
媳	2397		13	14	0.00211%	655144	98.46%	7	1.70%
茄	2427		9	14	0.00211%	655158	98.52%	7	1.70%
蔡	2429		15	14	0.00211%	655172	98.52%	7	1.70%
乞	2441		3	13	0.001959%	655185	98.55%	7	1.70%
坑	2446		7	13	0.001959%	655198	98.56%	7	1.70%
姨	2448		9	13	0.001959%	655211	98.56%	7	1.70%
疆	2464		19	13	0.001959%	655224	98.59%	7	1.70%
肖	2469		7	13	0.001959%	655237	98.60%	7	1.70%
賭	2476		15	13	0.001959%	655250	98.62%	7	1.70%
霍	2479		16	13	0.001959%	655263	98.62%	7	1.70%
偵	2484		11	12	0.001809%	655275	98.63%	7	1.70%
咽	2490		9	12	0.001809%	655287	98.64%	7	1.70%
朧	2510		20	12	0.001809%	655299	98.68%	7	1.70%
浦	2514		10	12	0.001809%	655311	98.69%	7	1.70%
濛	2515		17	12	0.001809%	655323	98.69%	7	1.70%
禪	2526		16	12	0.001809%	655335	98.71%	7	1.70%
絮	2530		12	12	0.001809%	655347	98.72%	7	1.70%
芽	2536		8	12	0.001809%	655359	98.73%	7	1.70%
螺	2543		17	12	0.001809%	655371	98.74%	7	1.70%
丘	2558		5	11	0.001658%	655382	98.77%	7	1.70%
噹	2571		16	11	0.001658%	655393	98.79%	7	1.70%
姊	2572		8	11	0.001658%	655404	98.79%	7	1.70%
朦	2579		18	11	0.001658%	655415	98.80%	7	1.70%
洒	2583		9	11	0.001658%	655426	98.81%	7	1.70%
渠	2585		12	11	0.001658%	655437	98.81%	7	1.70%
砰	2596		10	11	0.001658%	655448	98.83%	7	1.70%
絨	2600		12	11	0.001658%	655459	98.84%	7	1.70%
侈	2621		8	10	0.001507%	655469	98.87%	7	1.70%
凳	2624		14	10	0.001507%	655479	98.88%	7	1.70%
剖	2625		10	10	0.001507%	655489	98.88%	7	1.70%
怯	2634		8	10	0.001507%	655499	98.89%	7	1.70%
恆	2636		9	10	0.001507%	655509	98.89%	7	1.70%
棘	2650		12	10	0.001507%	655519	98.92%	7	1.70%
渣	2655		12	10	0.001507%	655529	98.92%	7	1.70%
炫	2656		9	10	0.001507%	655539	98.92%	7	1.70%
焗	2658		11	10	0.001507%	655549	98.93%	7	1.70%
眺	2666		11	10	0.001507%	655559	98.94%	7	1.70%
簿	2672		19	10	0.001507%	655569	98.95%	7	1.70%
蒂	2683		13	10	0.001507%	655579	98.97%	7	1.70%
叩	2704		5	9	0.001357%	655588	99.00%	7	1.70%
呷	2706		8	9	0.001357%	655597	99.00%	7	1.70%
咐	2707		8	9	0.001357%	655606	99.00%	7	1.70%
哎	2708		9	9	0.001357%	655615	99.00%	7	1.70%
埠	2714		11	9	0.001357%	655624	99.01%	7	1.70%
屢	2720		14	9	0.001357%	655633	99.02%	7	1.70%
忖	2722		6	9	0.001357%	655642	99.02%	7	1.70%
懦	2727		17	9	0.001357%	655651	99.03%	7	1.70%
棕	2734		12	9	0.001357%	655660	99.04%	7	1.70%
樽	2738		16	9	0.001357%	655669	99.04%	7	1.70%
溺	2740		13	9	0.001357%	655678	99.04%	7	1.70%
烤	2742		10	9	0.001357%	655687	99.05%	7	1.70%
爹	2746		10	9	0.001357%	655696	99.05%	7	1.70%
甩	2751		5	9	0.001357%	655705	99.06%	7	1.70%
盯	2753		7	9	0.001357%	655714	99.06%	7	1.70%
睇	2756		12	9	0.001357%	655723	99.07%	7	1.70%
羨	2767		13	9	0.001357%	655732	99.08%	7	1.70%
蕉	2773		16	9	0.001357%	655741	99.09%	7	1.70%
髦	2792		14	9	0.001357%	655750	99.12%	7	1.70%
倖	2796		10	8	0.001206%	655758	99.12%	7	1.70%
呻	2803		8	8	0.001206%	655766	99.13%	7	1.70%
嗜	2806		13	8	0.001206%	655774	99.13%	7	1.70%
嗽	2807		14	8	0.001206%	655782	99.13%	7	1.70%
噫	2810		16	8	0.001206%	655790	99.14%	7	1.70%
壤	2813		20	8	0.001206%	655798	99.14%	7	1.70%
嬉	2816		15	8	0.001206%	655806	99.14%	7	1.70%
廝	2819		15	8	0.001206%	655814	99.15%	7	1.70%
徊	2820		9	8	0.001206%	655822	99.15%	7	1.70%
徘	2821		11	8	0.001206%	655830	99.15%	7	1.70%
拗	2824		8	8	0.001206%	655838	99.15%	7	1.70%
摯	2825		15	8	0.001206%	655846	99.16%	7	1.70%
撓	2826		15	8	0.001206%	655854	99.16%	7	1.70%
撮	2827		15	8	0.001206%	655862	99.16%	7	1.70%
攪	2829		23	8	0.001206%	655870	99.16%	7	1.70%
桿	2832		11	8	0.001206%	655878	99.16%	7	1.70%
泣	2837		8	8	0.001206%	655886	99.17%	7	1.70%
爪	2842		4	8	0.001206%	655894	99.18%	7	1.70%
瑪	2845		14	8	0.001206%	655902	99.18%	7	1.70%
矜	2849		9	8	0.001206%	655910	99.18%	7	1.70%
蠟	2863		21	8	0.001206%	655918	99.20%	7	1.70%
褪	2865		15	8	0.001206%	655926	99.20%	7	1.70%
髒	2881		22	8	0.001206%	655934	99.22%	7	1.70%
佇	2887		7	7	0.001055%	655941	99.23%	7	1.70%
侯	2889		9	7	0.001055%	655948	99.23%	7	1.70%
倪	2891		10	7	0.001055%	655955	99.23%	7	1.70%
儉	2892		15	7	0.001055%	655962	99.24%	7	1.70%
卒	2898		8	7	0.001055%	655969	99.24%	7	1.70%
啃	2903		11	7	0.001055%	655976	99.25%	7	1.70%
坎	2910		7	7	0.001055%	655983	99.25%	7	1.70%
幟	2919		15	7	0.001055%	655990	99.26%	7	1.70%
懈	2927		16	7	0.001055%	655997	99.27%	7	1.70%
抉	2928		7	7	0.001055%	656004	99.27%	7	1.70%
敞	2934		12	7	0.001055%	656011	99.28%	7	1.70%
曠	2935		19	7	0.001055%	656018	99.28%	7	1.70%
棲	2942		12	7	0.001055%	656025	99.29%	7	1.70%
沐	2946		7	7	0.001055%	656032	99.29%	7	1.70%
滄	2951		13	7	0.001055%	656039	99.30%	7	1.70%
澆	2952		15	7	0.001055%	656046	99.30%	7	1.70%
澡	2953		16	7	0.001055%	656053	99.30%	7	1.70%
玄	2958		5	7	0.001055%	656060	99.30%	7	1.70%
穫	2966		19	7	0.001055%	656067	99.31%	7	1.70%
糕	2969		16	7	0.001055%	656074	99.32%	7	1.70%
羹	2972		19	7	0.001055%	656081	99.32%	7	1.70%
耘	2973		10	7	0.001055%	656088	99.32%	7	1.70%
腥	2974		13	7	0.001055%	656095	99.32%	7	1.70%
虔	2982		10	7	0.001055%	656102	99.33%	7	1.70%
蟬	2983		18	7	0.001055%	656109	99.33%	7	1.70%
詐	2988		12	7	0.001055%	656116	99.34%	7	1.70%
豁	2990		17	7	0.001055%	656123	99.34%	7	1.70%
迸	2994		9	7	0.001055%	656130	99.34%	7	1.70%
遑	2995		12	7	0.001055%	656137	99.34%	7	1.70%
頹	3000		16	7	0.001055%	656144	99.35%	7	1.70%
饒	3002		20	7	0.001055%	656151	99.35%	7	1.70%
鹽	3007		24	7	0.001055%	656158	99.36%	7	1.70%
彤	1476		7	50	0.007536%	656208	94.55%	6	1.46%
匈	1505		6	48	0.007235%	656256	94.76%	6	1.46%
痰	1650		13	39	0.005878%	656295	95.72%	6	1.46%
鉛	1768		13	33	0.004974%	656328	96.35%	6	1.46%
皿	1950		5	26	0.003919%	656354	97.14%	6	1.46%
啣	1995		11	24	0.003617%	656378	97.31%	6	1.46%
隧	2028		15	24	0.003617%	656402	97.43%	6	1.46%
繡	2118		18	21	0.003165%	656423	97.73%	6	1.46%
黛	2165		17	20	0.003014%	656443	97.87%	6	1.46%
姪	2175		9	19	0.002864%	656462	97.90%	6	1.46%
圃	2213		10	18	0.002713%	656480	98.01%	6	1.46%
岩	2254		8	17	0.002562%	656497	98.12%	6	1.46%
菌	2277		12	17	0.002562%	656514	98.18%	6	1.46%
妖	2296		7	16	0.002412%	656530	98.22%	6	1.46%
廖	2297		14	16	0.002412%	656546	98.23%	6	1.46%
頃	2332		11	16	0.002412%	656562	98.31%	6	1.46%
划	2338		6	15	0.002261%	656577	98.33%	6	1.46%
薰	2375		18	15	0.002261%	656592	98.41%	6	1.46%
鑊	2382		22	15	0.002261%	656607	98.43%	6	1.46%
耿	2422		10	14	0.00211%	656621	98.51%	6	1.46%
艘	2426		15	14	0.00211%	656635	98.52%	6	1.46%
吱	2489		7	12	0.001809%	656647	98.64%	6	1.46%
惘	2498		11	12	0.001809%	656659	98.66%	6	1.46%
拂	2502		8	12	0.001809%	656671	98.67%	6	1.46%
瞇	2523		15	12	0.001809%	656683	98.70%	6	1.46%
嗡	2568		13	11	0.001658%	656694	98.78%	6	1.46%
擰	2577		17	11	0.001658%	656705	98.80%	6	1.46%
莖	2606		11	11	0.001658%	656716	98.85%	6	1.46%
餵	2618		17	11	0.001658%	656727	98.87%	6	1.46%
鴿	2619		17	11	0.001658%	656738	98.87%	6	1.46%
咄	2627		8	10	0.001507%	656748	98.88%	6	1.46%
拭	2640		9	10	0.001507%	656758	98.90%	6	1.46%
炳	2657		9	10	0.001507%	656768	98.93%	6	1.46%
煽	2659		14	10	0.001507%	656778	98.93%	6	1.46%
甸	2663		7	10	0.001507%	656788	98.94%	6	1.46%
稜	2670		13	10	0.001507%	656798	98.95%	6	1.46%
緝	2675		15	10	0.001507%	656808	98.95%	6	1.46%
辮	2677		20	10	0.001507%	656818	98.96%	6	1.46%
鈔	2693		12	10	0.001507%	656828	98.98%	6	1.46%
垮	2712		9	9	0.001357%	656837	99.01%	6	1.46%
妓	2717		7	9	0.001357%	656846	99.01%	6	1.46%
孝	2718		7	9	0.001357%	656855	99.02%	6	1.46%
搽	2729		13	9	0.001357%	656864	99.03%	6	1.46%
敘	2732		11	9	0.001357%	656873	99.03%	6	1.46%
棍	2736		12	9	0.001357%	656882	99.04%	6	1.46%
痴	2752		13	9	0.001357%	656891	99.06%	6	1.46%
眩	2754		10	9	0.001357%	656900	99.06%	6	1.46%
眨	2755		10	9	0.001357%	656909	99.07%	6	1.46%
磁	2759		14	9	0.001357%	656918	99.07%	6	1.46%
窒	2761		11	9	0.001357%	656927	99.07%	6	1.46%
簇	2765		17	9	0.001357%	656936	99.08%	6	1.46%
詹	2778		13	9	0.001357%	656945	99.10%	6	1.46%
雁	2787		12	9	0.001357%	656954	99.11%	6	1.46%
飼	2789		13	9	0.001357%	656963	99.11%	6	1.46%
麟	2794		23	9	0.001357%	656972	99.12%	6	1.46%
喇	2804		12	8	0.001206%	656980	99.13%	6	1.46%
喳	2805		12	8	0.001206%	656988	99.13%	6	1.46%
嘰	2809		15	8	0.001206%	656996	99.14%	6	1.46%
娶	2814		11	8	0.001206%	657004	99.14%	6	1.46%
惰	2823		12	8	0.001206%	657012	99.15%	6	1.46%
撳	2828		15	8	0.001206%	657020	99.16%	6	1.46%
殉	2835		10	8	0.001206%	657028	99.17%	6	1.46%
淹	2838		11	8	0.001206%	657036	99.17%	6	1.46%
癟	2846		19	8	0.001206%	657044	99.18%	6	1.46%
眸	2847		11	8	0.001206%	657052	99.18%	6	1.46%
穀	2850		15	8	0.001206%	657060	99.19%	6	1.46%
茲	2854		10	8	0.001206%	657068	99.19%	6	1.46%
萄	2856		12	8	0.001206%	657076	99.19%	6	1.46%
葫	2857		13	8	0.001206%	657084	99.19%	6	1.46%
藻	2860		20	8	0.001206%	657092	99.20%	6	1.46%
螢	2862		16	8	0.001206%	657100	99.20%	6	1.46%
謠	2866		17	8	0.001206%	657108	99.20%	6	1.46%
踱	2870		16	8	0.001206%	657116	99.21%	6	1.46%
闡	2877		20	8	0.001206%	657124	99.22%	6	1.46%
馨	2880		20	8	0.001206%	657132	99.22%	6	1.46%
魏	2882		18	8	0.001206%	657140	99.22%	6	1.46%
亢	2886		4	7	0.001055%	657147	99.23%	6	1.46%
倔	2890		10	7	0.001055%	657154	99.23%	6	1.46%
吝	2900		7	7	0.001055%	657161	99.24%	6	1.46%
咒	2901		8	7	0.001055%	657168	99.24%	6	1.46%
嗇	2906		13	7	0.001055%	657175	99.25%	6	1.46%
堵	2911		11	7	0.001055%	657182	99.26%	6	1.46%
屍	2913		9	7	0.001055%	657189	99.26%	6	1.46%
岔	2914		7	7	0.001055%	657196	99.26%	6	1.46%
岳	2915		8	7	0.001055%	657203	99.26%	6	1.46%
崎	2916		11	7	0.001055%	657210	99.26%	6	1.46%
巔	2917		22	7	0.001055%	657217	99.26%	6	1.46%
彰	2922		14	7	0.001055%	657224	99.27%	6	1.46%
忿	2923		8	7	0.001055%	657231	99.27%	6	1.46%
悽	2924		11	7	0.001055%	657238	99.27%	6	1.46%
愴	2926		13	7	0.001055%	657245	99.27%	6	1.46%
拚	2929		8	7	0.001055%	657252	99.27%	6	1.46%
揀	2930		12	7	0.001055%	657259	99.28%	6	1.46%
揹	2931		12	7	0.001055%	657266	99.28%	6	1.46%
撩	2932		15	7	0.001055%	657273	99.28%	6	1.46%
撼	2933		16	7	0.001055%	657280	99.28%	6	1.46%
梨	2940		11	7	0.001055%	657287	99.29%	6	1.46%
棗	2941		12	7	0.001055%	657294	99.29%	6	1.46%
榻	2943		14	7	0.001055%	657301	99.29%	6	1.46%
檸	2944		18	7	0.001055%	657308	99.29%	6	1.46%
淤	2948		11	7	0.001055%	657315	99.29%	6	1.46%
淇	2949		11	7	0.001055%	657322	99.30%	6	1.46%
渲	2950		12	7	0.001055%	657329	99.30%	6	1.46%
熾	2956		16	7	0.001055%	657336	99.30%	6	1.46%
琳	2959		12	7	0.001055%	657343	99.31%	6	1.46%
瑩	2961		15	7	0.001055%	657350	99.31%	6	1.46%
秉	2965		8	7	0.001055%	657357	99.31%	6	1.46%
綑	2970		13	7	0.001055%	657364	99.32%	6	1.46%
臆	2975		17	7	0.001055%	657371	99.32%	6	1.46%
舟	2976		6	7	0.001055%	657378	99.32%	6	1.46%
萌	2979		12	7	0.001055%	657385	99.33%	6	1.46%
萎	2980		12	7	0.001055%	657392	99.33%	6	1.46%
蔣	2981		15	7	0.001055%	657399	99.33%	6	1.46%
訕	2987		10	7	0.001055%	657406	99.34%	6	1.46%
跪	2991		13	7	0.001055%	657413	99.34%	6	1.46%
迭	2993		8	7	0.001055%	657420	99.34%	6	1.46%
釐	2997		18	7	0.001055%	657427	99.35%	6	1.46%
顱	3001		25	7	0.001055%	657434	99.35%	6	1.46%
驀	3003		21	7	0.001055%	657441	99.35%	6	1.46%
鴦	3004		16	7	0.001055%	657448	99.35%	6	1.46%
鴛	3005		16	7	0.001055%	657455	99.35%	6	1.46%
亨	3009		7	6	0.0009043%	657461	99.36%	6	1.46%
凶	3013		4	6	0.0009043%	657467	99.36%	6	1.46%
凹	3014		5	6	0.0009043%	657473	99.36%	6	1.46%
咦	3020		9	6	0.0009043%	657479	99.37%	6	1.46%
唏	3022		10	6	0.0009043%	657485	99.37%	6	1.46%
嗓	3025		13	6	0.0009043%	657491	99.37%	6	1.46%
嗤	3026		13	6	0.0009043%	657497	99.37%	6	1.46%
寢	3037		14	6	0.0009043%	657503	99.38%	6	1.46%
嵌	3041		12	6	0.0009043%	657509	99.39%	6	1.46%
廓	3043		14	6	0.0009043%	657515	99.39%	6	1.46%
弛	3044		6	6	0.0009043%	657521	99.39%	6	1.46%
恃	3048		9	6	0.0009043%	657527	99.39%	6	1.46%
慷	3051		14	6	0.0009043%	657533	99.40%	6	1.46%
拈	3055		8	6	0.0009043%	657539	99.40%	6	1.46%
捺	3057		11	6	0.0009043%	657545	99.40%	6	1.46%
揉	3059		12	6	0.0009043%	657551	99.40%	6	1.46%
攔	3061		20	6	0.0009043%	657557	99.41%	6	1.46%
斟	3062		13	6	0.0009043%	657563	99.41%	6	1.46%
晒	3064		10	6	0.0009043%	657569	99.41%	6	1.46%
梢	3068		11	6	0.0009043%	657575	99.41%	6	1.46%
梭	3069		11	6	0.0009043%	657581	99.41%	6	1.46%
榴	3072		14	6	0.0009043%	657587	99.42%	6	1.46%
檬	3074		18	6	0.0009043%	657593	99.42%	6	1.46%
櫥	3075		19	6	0.0009043%	657599	99.42%	6	1.46%
淌	3079		11	6	0.0009043%	657605	99.42%	6	1.46%
澈	3080		14	6	0.0009043%	657611	99.42%	6	1.46%
潦	3081		15	6	0.0009043%	657617	99.42%	6	1.46%
濺	3083		18	6	0.0009043%	657623	99.43%	6	1.46%
炭	3084		9	6	0.0009043%	657629	99.43%	6	1.46%
煌	3085		13	6	0.0009043%	657635	99.43%	6	1.46%
甄	3091		14	6	0.0009043%	657641	99.43%	6	1.46%
盎	3092		10	6	0.0009043%	657647	99.43%	6	1.46%
荊	3107		10	6	0.0009043%	657653	99.45%	6	1.46%
茜	3108		10	6	0.0009043%	657659	99.45%	6	1.46%
蘿	3110		23	6	0.0009043%	657665	99.45%	6	1.46%
褸	3114		16	6	0.0009043%	657671	99.45%	6	1.46%
詫	3115		13	6	0.0009043%	657677	99.45%	6	1.46%
詭	3116		13	6	0.0009043%	657683	99.45%	6	1.46%
諧	3117		16	6	0.0009043%	657689	99.46%	6	1.46%
踞	3119		15	6	0.0009043%	657695	99.46%	6	1.46%
遁	3120		12	6	0.0009043%	657701	99.46%	6	1.46%
醞	3123		17	6	0.0009043%	657707	99.46%	6	1.46%
鉅	3124		13	6	0.0009043%	657713	99.46%	6	1.46%
闌	3127		17	6	0.0009043%	657719	99.46%	6	1.46%
隅	3128		11	6	0.0009043%	657725	99.47%	6	1.46%
靡	3131		19	6	0.0009043%	657731	99.47%	6	1.46%
靦	3132		16	6	0.0009043%	657737	99.47%	6	1.46%
鞏	3133		15	6	0.0009043%	657743	99.47%	6	1.46%
饑	3134		20	6	0.0009043%	657749	99.47%	6	1.46%
馮	3135		12	6	0.0009043%	657755	99.47%	6	1.46%
馴	3136		13	6	0.0009043%	657761	99.47%	6	1.46%
髓	3138		23	6	0.0009043%	657767	99.47%	6	1.46%
嫂	1772		12	32	0.004823%	657799	96.37%	5	1.22%
稻	1858		15	29	0.004371%	657828	96.76%	5	1.22%
郝	1956		9	26	0.003919%	657854	97.16%	5	1.22%
韋	2281		9	17	0.002562%	657871	98.19%	5	1.22%
怔	2400		8	14	0.00211%	657885	98.46%	5	1.22%
橡	2409		16	14	0.00211%	657899	98.48%	5	1.22%
煤	2414		13	14	0.00211%	657913	98.49%	5	1.22%
藤	2472		19	13	0.001959%	657926	98.61%	5	1.22%
呂	2488		7	12	0.001809%	657938	98.64%	5	1.22%
寨	2496		14	12	0.001809%	657950	98.66%	5	1.22%
旱	2508		7	12	0.001809%	657962	98.68%	5	1.22%
矇	2524		19	12	0.001809%	657974	98.71%	5	1.22%
喀	2566		12	11	0.001658%	657985	98.78%	5	1.22%
甫	2591		7	11	0.001658%	657996	98.82%	5	1.22%
謎	2609		17	11	0.001658%	658007	98.85%	5	1.22%
吠	2626		7	10	0.001507%	658017	98.88%	5	1.22%
寺	2633		6	10	0.001507%	658027	98.89%	5	1.22%
摟	2645		14	10	0.001507%	658037	98.91%	5	1.22%
殿	2652		13	10	0.001507%	658047	98.92%	5	1.22%
臺	2682		14	10	0.001507%	658057	98.96%	5	1.22%
俸	2700		10	9	0.001357%	658066	98.99%	5	1.22%
吁	2705		6	9	0.001357%	658075	99.00%	5	1.22%
唧	2709		10	9	0.001357%	658084	99.00%	5	1.22%
棟	2735		12	9	0.001357%	658093	99.04%	5	1.22%
獅	2749		13	9	0.001357%	658102	99.06%	5	1.22%
竊	2764		23	9	0.001357%	658111	99.08%	5	1.22%
翩	2768		15	9	0.001357%	658120	99.08%	5	1.22%
茸	2772		10	9	0.001357%	658129	99.09%	5	1.22%
螂	2774		15	9	0.001357%	658138	99.09%	5	1.22%
蟑	2775		17	9	0.001357%	658147	99.09%	5	1.22%
醋	2782		15	9	0.001357%	658156	99.10%	5	1.22%
鎔	2785		18	9	0.001357%	658165	99.11%	5	1.22%
颱	2788		14	9	0.001357%	658174	99.11%	5	1.22%
兆	2798		6	8	0.001206%	658182	99.12%	5	1.22%
匙	2800		11	8	0.001206%	658190	99.13%	5	1.22%
卿	2801		10	8	0.001206%	658198	99.13%	5	1.22%
吩	2802		7	8	0.001206%	658206	99.13%	5	1.22%
墅	2812		14	8	0.001206%	658214	99.14%	5	1.22%
婿	2815		12	8	0.001206%	658222	99.14%	5	1.22%
淫	2840		11	8	0.001206%	658230	99.17%	5	1.22%
萍	2855		12	8	0.001206%	658238	99.19%	5	1.22%
蛙	2861		12	8	0.001206%	658246	99.20%	5	1.22%
鑄	2874		22	8	0.001206%	658254	99.21%	5	1.22%
黝	2884		17	8	0.001206%	658262	99.23%	5	1.22%
凄	2894		10	7	0.001055%	658269	99.24%	5	1.22%
凜	2895		15	7	0.001055%	658276	99.24%	5	1.22%
剌	2896		9	7	0.001055%	658283	99.24%	5	1.22%
剿	2897		13	7	0.001055%	658290	99.24%	5	1.22%
咧	2902		9	7	0.001055%	658297	99.25%	5	1.22%
喲	2904		12	7	0.001055%	658304	99.25%	5	1.22%
噩	2908		16	7	0.001055%	658311	99.25%	5	1.22%
嚷	2909		20	7	0.001055%	658318	99.25%	5	1.22%
帆	2918		6	7	0.001055%	658325	99.26%	5	1.22%
杉	2936		7	7	0.001055%	658332	99.28%	5	1.22%
桐	2938		10	7	0.001055%	658339	99.28%	5	1.22%
梗	2939		11	7	0.001055%	658346	99.28%	5	1.22%
涌	2947		10	7	0.001055%	658353	99.29%	5	1.22%
濡	2954		17	7	0.001055%	658360	99.30%	5	1.22%
焚	2955		12	7	0.001055%	658367	99.30%	5	1.22%
瑟	2960		13	7	0.001055%	658374	99.31%	5	1.22%
畜	2962		10	7	0.001055%	658381	99.31%	5	1.22%
砂	2963		9	7	0.001055%	658388	99.31%	5	1.22%
罅	2971		17	7	0.001055%	658395	99.32%	5	1.22%
芒	2977		7	7	0.001055%	658402	99.32%	5	1.22%
邪	2996		6	7	0.001055%	658409	99.34%	5	1.22%
鏗	2998		19	7	0.001055%	658416	99.35%	5	1.22%
仆	3010		4	6	0.0009043%	658422	99.36%	5	1.22%
俏	3011		9	6	0.0009043%	658428	99.36%	5	1.22%
冥	3012		10	6	0.0009043%	658434	99.36%	5	1.22%
募	3016		13	6	0.0009043%	658440	99.36%	5	1.22%
勳	3017		16	6	0.0009043%	658446	99.37%	5	1.22%
哦	3021		10	6	0.0009043%	658452	99.37%	5	1.22%
嗯	3027		13	6	0.0009043%	658458	99.37%	5	1.22%
埸	3030		11	6	0.0009043%	658464	99.38%	5	1.22%
孟	3036		8	6	0.0009043%	658470	99.38%	5	1.22%
屜	3038		11	6	0.0009043%	658476	99.38%	5	1.22%
岑	3039		7	6	0.0009043%	658482	99.39%	5	1.22%
峭	3040		10	6	0.0009043%	658488	99.39%	5	1.22%
幌	3042		13	6	0.0009043%	658494	99.39%	5	1.22%
彥	3046		9	6	0.0009043%	658500	99.39%	5	1.22%
悸	3050		11	6	0.0009043%	658506	99.40%	5	1.22%
憧	3052		15	6	0.0009043%	658512	99.40%	5	1.22%
懵	3054		19	6	0.0009043%	658518	99.40%	5	1.22%
揩	3058		12	6	0.0009043%	658524	99.40%	5	1.22%
椒	3070		12	6	0.0009043%	658530	99.41%	5	1.22%
椰	3071		13	6	0.0009043%	658536	99.41%	5	1.22%
沛	3077		7	6	0.0009043%	658542	99.42%	5	1.22%
熄	3086		14	6	0.0009043%	658548	99.43%	5	1.22%
盞	3093		13	6	0.0009043%	658554	99.43%	5	1.22%
瞞	3095		16	6	0.0009043%	658560	99.44%	5	1.22%
簷	3099		19	6	0.0009043%	658566	99.44%	5	1.22%
粘	3101		11	6	0.0009043%	658572	99.44%	5	1.22%
綺	3102		14	6	0.0009043%	658578	99.44%	5	1.22%
蟻	3111		19	6	0.0009043%	658584	99.45%	5	1.22%
邑	3122		7	6	0.0009043%	658590	99.46%	5	1.22%
鋸	3125		16	6	0.0009043%	658596	99.46%	5	1.22%
鑿	3126		28	6	0.0009043%	658602	99.46%	5	1.22%
雌	3129		14	6	0.0009043%	658608	99.47%	5	1.22%
駱	3137		16	6	0.0009043%	658614	99.47%	5	1.22%
鴉	3140		15	6	0.0009043%	658620	99.48%	5	1.22%
丫	3142		3	5	0.0007536%	658625	99.48%	5	1.22%
俐	3144		9	5	0.0007536%	658630	99.48%	5	1.22%
僧	3148		14	5	0.0007536%	658635	99.48%	5	1.22%
僻	3149		15	5	0.0007536%	658640	99.48%	5	1.22%
儕	3150		16	5	0.0007536%	658645	99.48%	5	1.22%
凋	3152		10	5	0.0007536%	658650	99.49%	5	1.22%
厄	3155		4	5	0.0007536%	658655	99.49%	5	1.22%
吼	3156		7	5	0.0007536%	658660	99.49%	5	1.22%
唾	3159		12	5	0.0007536%	658665	99.49%	5	1.22%
嘈	3162		14	5	0.0007536%	658670	99.49%	5	1.22%
壺	3165		12	5	0.0007536%	658675	99.50%	5	1.22%
姦	3168		9	5	0.0007536%	658680	99.50%	5	1.22%
娑	3169		10	5	0.0007536%	658685	99.50%	5	1.22%
嫣	3170		14	5	0.0007536%	658690	99.50%	5	1.22%
弓	3174		3	5	0.0007536%	658695	99.50%	5	1.22%
御	3178		11	5	0.0007536%	658700	99.51%	5	1.22%
怠	3179		9	5	0.0007536%	658705	99.51%	5	1.22%
悍	3182		10	5	0.0007536%	658710	99.51%	5	1.22%
慄	3184		13	5	0.0007536%	658715	99.51%	5	1.22%
憊	3186		16	5	0.0007536%	658720	99.51%	5	1.22%
懾	3187		21	5	0.0007536%	658725	99.51%	5	1.22%
搔	3189		13	5	0.0007536%	658730	99.51%	5	1.22%
搧	3190		13	5	0.0007536%	658735	99.51%	5	1.22%
晝	3194		11	5	0.0007536%	658740	99.52%	5	1.22%
歛	3198		17	5	0.0007536%	658745	99.52%	5	1.22%
歹	3199		4	5	0.0007536%	658750	99.52%	5	1.22%
汲	3202		7	5	0.0007536%	658755	99.52%	5	1.22%
涕	3203		10	5	0.0007536%	658760	99.52%	5	1.22%
濁	3208		16	5	0.0007536%	658765	99.53%	5	1.22%
瀾	3210		20	5	0.0007536%	658770	99.53%	5	1.22%
燙	3211		16	5	0.0007536%	658775	99.53%	5	1.22%
珊	3213		9	5	0.0007536%	658780	99.53%	5	1.22%
琢	3215		12	5	0.0007536%	658785	99.53%	5	1.22%
癱	3220		24	5	0.0007536%	658790	99.54%	5	1.22%
矗	3224		24	5	0.0007536%	658795	99.54%	5	1.22%
砲	3225		10	5	0.0007536%	658800	99.54%	5	1.22%
箕	3234		14	5	0.0007536%	658805	99.55%	5	1.22%
篤	3235		16	5	0.0007536%	658810	99.55%	5	1.22%
胳	3243		10	5	0.0007536%	658815	99.55%	5	1.22%
腆	3246		12	5	0.0007536%	658820	99.56%	5	1.22%
膛	3247		15	5	0.0007536%	658825	99.56%	5	1.22%
苟	3250		9	5	0.0007536%	658830	99.56%	5	1.22%
莞	3251		11	5	0.0007536%	658835	99.56%	5	1.22%
蔑	3253		15	5	0.0007536%	658840	99.56%	5	1.22%
蜿	3256		14	5	0.0007536%	658845	99.56%	5	1.22%
蜒	3257		14	5	0.0007536%	658850	99.57%	5	1.22%
蝴	3258		15	5	0.0007536%	658855	99.57%	5	1.22%
裔	3261		13	5	0.0007536%	658860	99.57%	5	1.22%
譏	3264		19	5	0.0007536%	658865	99.57%	5	1.22%
赦	3265		11	5	0.0007536%	658870	99.57%	5	1.22%
躇	3266		19	5	0.0007536%	658875	99.57%	5	1.22%
躊	3268		21	5	0.0007536%	658880	99.57%	5	1.22%
輒	3270		14	5	0.0007536%	658885	99.57%	5	1.22%
辜	3273		12	5	0.0007536%	658890	99.58%	5	1.22%
邃	3275		17	5	0.0007536%	658895	99.58%	5	1.22%
郁	3276		8	5	0.0007536%	658900	99.58%	5	1.22%
闕	3280		18	5	0.0007536%	658905	99.58%	5	1.22%
雛	3282		18	5	0.0007536%	658910	99.58%	5	1.22%
鬢	3289		24	5	0.0007536%	658915	99.59%	5	1.22%
鹹	3290		20	5	0.0007536%	658920	99.59%	5	1.22%
梵	2182		11	19	0.002864%	658939	97.92%	4	0.97%
磅	2419		15	14	0.00211%	658953	98.50%	4	0.97%
鹿	2482		11	13	0.001959%	658966	98.63%	4	0.97%
儒	2485		16	12	0.001809%	658978	98.64%	4	0.97%
棠	2512		12	12	0.001809%	658990	98.68%	4	0.97%
荔	2537		10	12	0.001809%	659002	98.73%	4	0.97%
扒	2575		5	11	0.001658%	659013	98.80%	4	0.97%
唆	2629		10	10	0.001507%	659023	98.88%	4	0.97%
瘤	2664		15	10	0.001507%	659033	98.94%	4	0.97%
矢	2667		5	10	0.001507%	659043	98.94%	4	0.97%
紡	2673		10	10	0.001507%	659053	98.95%	4	0.97%
啪	2710		11	9	0.001357%	659062	99.00%	4	0.97%
撿	2731		16	9	0.001357%	659071	99.03%	4	0.97%
膳	2769		16	9	0.001357%	659080	99.08%	4	0.97%
遴	2780		15	9	0.001357%	659089	99.10%	4	0.97%
鈍	2783		12	9	0.001357%	659098	99.10%	4	0.97%
鷗	2793		22	9	0.001357%	659107	99.12%	4	0.97%
楓	2833		13	8	0.001206%	659115	99.17%	4	0.97%
淮	2841		11	8	0.001206%	659123	99.17%	4	0.97%
纍	2851		21	8	0.001206%	659131	99.19%	4	0.97%
范	2853		9	8	0.001206%	659139	99.19%	4	0.97%
賈	2869		13	8	0.001206%	659147	99.21%	4	0.97%
闔	2876		18	8	0.001206%	659155	99.22%	4	0.97%
侃	2888		8	7	0.001055%	659162	99.23%	4	0.97%
叨	2899		5	7	0.001055%	659169	99.24%	4	0.97%
孰	2912		11	7	0.001055%	659176	99.26%	4	0.97%
庇	2920		7	7	0.001055%	659183	99.26%	4	0.97%
氫	2945		11	7	0.001055%	659190	99.29%	4	0.97%
禽	2964		13	7	0.001055%	659197	99.31%	4	0.97%
笛	2967		11	7	0.001055%	659204	99.31%	4	0.97%
蠱	2984		23	7	0.001055%	659211	99.33%	4	0.97%
袁	2985		10	7	0.001055%	659218	99.33%	4	0.97%
謢	2989		17	7	0.001055%	659225	99.34%	4	0.97%
于	3008		3	6	0.0009043%	659231	99.36%	4	0.97%
啄	3023		11	6	0.0009043%	659237	99.37%	4	0.97%
墟	3031		15	6	0.0009043%	659243	99.38%	4	0.97%
姜	3034		9	6	0.0009043%	659249	99.38%	4	0.97%
徙	3047		11	6	0.0009043%	659255	99.39%	4	0.97%
懊	3053		16	6	0.0009043%	659261	99.40%	4	0.97%
拐	3056		8	6	0.0009043%	659267	99.40%	4	0.97%
摑	3060		14	6	0.0009043%	659273	99.40%	4	0.97%
晏	3063		10	6	0.0009043%	659279	99.41%	4	0.97%
晌	3065		10	6	0.0009043%	659285	99.41%	4	0.97%
曇	3066		16	6	0.0009043%	659291	99.41%	4	0.97%
桓	3067		10	6	0.0009043%	659297	99.41%	4	0.97%
橙	3073		16	6	0.0009043%	659303	99.42%	4	0.97%
櫻	3076		21	6	0.0009043%	659309	99.42%	4	0.97%
猝	3089		11	6	0.0009043%	659315	99.43%	4	0.97%
睦	3094		13	6	0.0009043%	659321	99.44%	4	0.97%
籽	3100		9	6	0.0009043%	659327	99.44%	4	0.97%
脖	3104		11	6	0.0009043%	659333	99.44%	4	0.97%
艦	3105		20	6	0.0009043%	659339	99.45%	4	0.97%
跛	3118		12	6	0.0009043%	659345	99.46%	4	0.97%
遢	3121		13	6	0.0009043%	659351	99.46%	4	0.97%
霖	3130		16	6	0.0009043%	659357	99.47%	4	0.97%
鶴	3141		21	6	0.0009043%	659363	99.48%	4	0.97%
偌	3145		11	5	0.0007536%	659368	99.48%	4	0.97%
偎	3146		11	5	0.0007536%	659373	99.48%	4	0.97%
倏	3147		11	5	0.0007536%	659378	99.48%	4	0.97%
儻	3151		22	5	0.0007536%	659383	99.49%	4	0.97%
啜	3158		11	5	0.0007536%	659388	99.49%	4	0.97%
嗦	3160		13	5	0.0007536%	659393	99.49%	4	0.97%
嘍	3161		14	5	0.0007536%	659398	99.49%	4	0.97%
圭	3164		6	5	0.0007536%	659403	99.49%	4	0.97%
巫	3172		7	5	0.0007536%	659408	99.50%	4	0.97%
弘	3175		5	5	0.0007536%	659413	99.50%	4	0.97%
弗	3176		5	5	0.0007536%	659418	99.50%	4	0.97%
悚	3181		10	5	0.0007536%	659423	99.51%	4	0.97%
惚	3183		11	5	0.0007536%	659428	99.51%	4	0.97%
拎	3188		8	5	0.0007536%	659433	99.51%	4	0.97%
撻	3191		16	5	0.0007536%	659438	99.52%	4	0.97%
攫	3193		23	5	0.0007536%	659443	99.52%	4	0.97%
曖	3195		17	5	0.0007536%	659448	99.52%	4	0.97%
檻	3197		18	5	0.0007536%	659453	99.52%	4	0.97%
毆	3200		15	5	0.0007536%	659458	99.52%	4	0.97%
湛	3206		12	5	0.0007536%	659463	99.53%	4	0.97%
狐	3212		8	5	0.0007536%	659468	99.53%	4	0.97%
琅	3214		11	5	0.0007536%	659473	99.53%	4	0.97%
瓏	3217		20	5	0.0007536%	659478	99.53%	4	0.97%
甭	3218		9	5	0.0007536%	659483	99.54%	4	0.97%
瞎	3222		15	5	0.0007536%	659488	99.54%	4	0.97%
瞌	3223		15	5	0.0007536%	659493	99.54%	4	0.97%
磯	3227		17	5	0.0007536%	659498	99.54%	4	0.97%
祉	3228		8	5	0.0007536%	659503	99.54%	4	0.97%
穆	3230		16	5	0.0007536%	659508	99.54%	4	0.97%
窘	3232		12	5	0.0007536%	659513	99.55%	4	0.97%
糞	3237		17	5	0.0007536%	659518	99.55%	4	0.97%
絆	3238		11	5	0.0007536%	659523	99.55%	4	0.97%
綵	3240		14	5	0.0007536%	659528	99.55%	4	0.97%
繆	3241		17	5	0.0007536%	659533	99.55%	4	0.97%
脊	3244		10	5	0.0007536%	659538	99.56%	4	0.97%
蕊	3254		16	5	0.0007536%	659543	99.56%	4	0.97%
螞	3259		16	5	0.0007536%	659548	99.57%	4	0.97%
褔	3262		14	5	0.0007536%	659553	99.57%	4	0.97%
診	3263		12	5	0.0007536%	659558	99.57%	4	0.97%
軸	3269		12	5	0.0007536%	659563	99.57%	4	0.97%
轇	3271		18	5	0.0007536%	659568	99.58%	4	0.97%
轕	3272		20	5	0.0007536%	659573	99.58%	4	0.97%
逮	3274		11	5	0.0007536%	659578	99.58%	4	0.97%
霎	3283		16	5	0.0007536%	659583	99.58%	4	0.97%
頷	3285		16	5	0.0007536%	659588	99.59%	4	0.97%
乜	3292		2	4	0.0006029%	659592	99.59%	4	0.97%
佑	3294		7	4	0.0006029%	659596	99.59%	4	0.97%
倩	3297		10	4	0.0006029%	659600	99.59%	4	0.97%
倜	3298		10	4	0.0006029%	659604	99.59%	4	0.97%
偕	3299		11	4	0.0006029%	659608	99.60%	4	0.97%
儼	3302		22	4	0.0006029%	659612	99.60%	4	0.97%
刃	3304		3	4	0.0006029%	659616	99.60%	4	0.97%
剷	3305		13	4	0.0006029%	659620	99.60%	4	0.97%
卦	3306		8	4	0.0006029%	659624	99.60%	4	0.97%
叱	3307		5	4	0.0006029%	659628	99.60%	4	0.97%
吶	3308		7	4	0.0006029%	659632	99.60%	4	0.97%
嘟	3316		13	4	0.0006029%	659636	99.61%	4	0.97%
嘿	3320		15	4	0.0006029%	659640	99.61%	4	0.97%
垢	3322		9	4	0.0006029%	659644	99.61%	4	0.97%
妮	3324		8	4	0.0006029%	659648	99.61%	4	0.97%
嫉	3326		13	4	0.0006029%	659652	99.61%	4	0.97%
徨	3336		12	4	0.0006029%	659656	99.62%	4	0.97%
恿	3340		11	4	0.0006029%	659660	99.62%	4	0.97%
惋	3341		11	4	0.0006029%	659664	99.62%	4	0.97%
愣	3342		12	4	0.0006029%	659668	99.62%	4	0.97%
慳	3343		14	4	0.0006029%	659672	99.62%	4	0.97%
憫	3344		15	4	0.0006029%	659676	99.62%	4	0.97%
憬	3345		15	4	0.0006029%	659680	99.62%	4	0.97%
扼	3347		7	4	0.0006029%	659684	99.62%	4	0.97%
抒	3349		7	4	0.0006029%	659688	99.63%	4	0.97%
摒	3350		12	4	0.0006029%	659692	99.63%	4	0.97%
擎	3352		17	4	0.0006029%	659696	99.63%	4	0.97%
攷	3353		7	4	0.0006029%	659700	99.63%	4	0.97%
曆	3355		16	4	0.0006029%	659704	99.63%	4	0.97%
柑	3359		9	4	0.0006029%	659708	99.63%	4	0.97%
棧	3361		12	4	0.0006029%	659712	99.63%	4	0.97%
榷	3364		14	4	0.0006029%	659716	99.63%	4	0.97%
殆	3366		9	4	0.0006029%	659720	99.64%	4	0.97%
毯	3367		12	4	0.0006029%	659724	99.64%	4	0.97%
汝	3368		6	4	0.0006029%	659728	99.64%	4	0.97%
漬	3372		14	4	0.0006029%	659732	99.64%	4	0.97%
漱	3373		14	4	0.0006029%	659736	99.64%	4	0.97%
滌	3374		14	4	0.0006029%	659740	99.64%	4	0.97%
澱	3377		16	4	0.0006029%	659744	99.64%	4	0.97%
疇	3382		19	4	0.0006029%	659748	99.65%	4	0.97%
瘓	3384		14	4	0.0006029%	659752	99.65%	4	0.97%
瘡	3386		15	4	0.0006029%	659756	99.65%	4	0.97%
睫	3387		13	4	0.0006029%	659760	99.65%	4	0.97%
砸	3391		10	4	0.0006029%	659764	99.65%	4	0.97%
硝	3392		12	4	0.0006029%	659768	99.65%	4	0.97%
碳	3394		14	4	0.0006029%	659772	99.65%	4	0.97%
磡	3395		16	4	0.0006029%	659776	99.65%	4	0.97%
竿	3398		9	4	0.0006029%	659780	99.65%	4	0.97%
筲	3399		13	4	0.0006029%	659784	99.66%	4	0.97%
箇	3400		14	4	0.0006029%	659788	99.66%	4	0.97%
紊	3403		10	4	0.0006029%	659792	99.66%	4	0.97%
紳	3406		11	4	0.0006029%	659796	99.66%	4	0.97%
絞	3407		12	4	0.0006029%	659800	99.66%	4	0.97%
綁	3408		13	4	0.0006029%	659804	99.66%	4	0.97%
綢	3409		14	4	0.0006029%	659808	99.66%	4	0.97%
緘	3411		15	4	0.0006029%	659812	99.66%	4	0.97%
縈	3412		16	4	0.0006029%	659816	99.66%	4	0.97%
翡	3414		14	4	0.0006029%	659820	99.66%	4	0.97%
翰	3415		16	4	0.0006029%	659824	99.67%	4	0.97%
耽	3416		10	4	0.0006029%	659828	99.67%	4	0.97%
聶	3417		18	4	0.0006029%	659832	99.67%	4	0.97%
胭	3418		10	4	0.0006029%	659836	99.67%	4	0.97%
苔	3421		9	4	0.0006029%	659840	99.67%	4	0.97%
莽	3423		11	4	0.0006029%	659844	99.67%	4	0.97%
蒞	3424		14	4	0.0006029%	659848	99.67%	4	0.97%
蒜	3426		14	4	0.0006029%	659852	99.67%	4	0.97%
蔔	3428		15	4	0.0006029%	659856	99.67%	4	0.97%
薯	3429		17	4	0.0006029%	659860	99.67%	4	0.97%
藹	3430		20	4	0.0006029%	659864	99.67%	4	0.97%
蘸	3431		23	4	0.0006029%	659868	99.67%	4	0.97%
蛛	3432		12	4	0.0006029%	659872	99.68%	4	0.97%
蠅	3433		19	4	0.0006029%	659876	99.68%	4	0.97%
褐	3437		14	4	0.0006029%	659880	99.68%	4	0.97%
詮	3439		13	4	0.0006029%	659884	99.68%	4	0.97%
諦	3441		16	4	0.0006029%	659888	99.68%	4	0.97%
跚	3445		12	4	0.0006029%	659892	99.68%	4	0.97%
躉	3450		20	4	0.0006029%	659896	99.69%	4	0.97%
躋	3451		21	4	0.0006029%	659900	99.69%	4	0.97%
躬	3452		10	4	0.0006029%	659904	99.69%	4	0.97%
邋	3454		18	4	0.0006029%	659908	99.69%	4	0.97%
郡	3455		9	4	0.0006029%	659912	99.69%	4	0.97%
酣	3456		12	4	0.0006029%	659916	99.69%	4	0.97%
釁	3458		25	4	0.0006029%	659920	99.69%	4	0.97%
鏈	3463		19	4	0.0006029%	659924	99.69%	4	0.97%
鑲	3464		25	4	0.0006029%	659928	99.69%	4	0.97%
隘	3468		12	4	0.0006029%	659932	99.70%	4	0.97%
顰	3472		24	4	0.0006029%	659936	99.70%	4	0.97%
馭	3473		12	4	0.0006029%	659940	99.70%	4	0.97%
齋	3481		17	4	0.0006029%	659944	99.71%	4	0.97%
柬	1297		9	65	0.009797%	660009	93.01%	3	0.73%
鈾	1611		13	42	0.00633%	660051	95.48%	3	0.73%
賄	1810		13	31	0.004672%	660082	96.55%	3	0.73%
蚤	2122		10	21	0.003165%	660103	97.74%	3	0.73%
苑	2470		9	13	0.001959%	660116	98.61%	3	0.73%
盅	2521		9	12	0.001809%	660128	98.70%	3	0.73%
菩	2539		12	12	0.001809%	660140	98.73%	3	0.73%
衹	2544		9	12	0.001809%	660152	98.74%	3	0.73%
貞	2688		9	10	0.001507%	660162	98.97%	3	0.73%
壩	2716		24	9	0.001357%	660171	99.01%	3	0.73%
湘	2739		12	9	0.001357%	660180	99.04%	3	0.73%
熙	2744		14	9	0.001357%	660189	99.05%	3	0.73%
鋅	2784		15	9	0.001357%	660198	99.10%	3	0.73%
猴	2843		12	8	0.001206%	660206	99.18%	3	0.73%
蔥	2859		15	8	0.001206%	660214	99.20%	3	0.73%
邱	2872		7	8	0.001206%	660222	99.21%	3	0.73%
陀	2879		7	8	0.001206%	660230	99.22%	3	0.73%
鹵	2883		11	8	0.001206%	660238	99.23%	3	0.73%
冶	2893		7	7	0.001055%	660245	99.24%	3	0.73%
嘶	2907		15	7	0.001055%	660252	99.25%	3	0.73%
彬	2921		11	7	0.001055%	660259	99.27%	3	0.73%
惺	2925		12	7	0.001055%	660266	99.27%	3	0.73%
迢	2992		8	7	0.001055%	660273	99.34%	3	0.73%
鷹	3006		24	7	0.001055%	660280	99.36%	3	0.73%
呱	3019		8	6	0.0009043%	660286	99.37%	3	0.73%
喋	3024		12	6	0.0009043%	660292	99.37%	3	0.73%
噗	3028		15	6	0.0009043%	660298	99.38%	3	0.73%
噥	3029		16	6	0.0009043%	660304	99.38%	3	0.73%
奚	3033		10	6	0.0009043%	660310	99.38%	3	0.73%
娓	3035		10	6	0.0009043%	660316	99.38%	3	0.73%
彙	3045		13	6	0.0009043%	660322	99.39%	3	0.73%
悻	3049		11	6	0.0009043%	660328	99.39%	3	0.73%
汨	3078		7	6	0.0009043%	660334	99.42%	3	0.73%
燻	3087		18	6	0.0009043%	660340	99.43%	3	0.73%
狄	3088		7	6	0.0009043%	660346	99.43%	3	0.73%
祟	3097		10	6	0.0009043%	660352	99.44%	3	0.73%
禾	3098		5	6	0.0009043%	660358	99.44%	3	0.73%
繭	3103		19	6	0.0009043%	660364	99.44%	3	0.73%
芸	3106		8	6	0.0009043%	660370	99.45%	3	0.73%
蟹	3112		19	6	0.0009043%	660376	99.45%	3	0.73%
裊	3113		13	6	0.0009043%	660382	99.45%	3	0.73%
魷	3139		15	6	0.0009043%	660388	99.48%	3	0.73%
佣	3143		7	5	0.0007536%	660393	99.48%	3	0.73%
凈	3153		10	5	0.0007536%	660398	99.49%	3	0.73%
咯	3157		9	5	0.0007536%	660403	99.49%	3	0.73%
夭	3166		4	5	0.0007536%	660408	99.50%	3	0.73%
岌	3171		7	5	0.0007536%	660413	99.50%	3	0.73%
帕	3173		8	5	0.0007536%	660418	99.50%	3	0.73%
弧	3177		8	5	0.0007536%	660423	99.50%	3	0.73%
恫	3180		9	5	0.0007536%	660428	99.51%	3	0.73%
慵	3185		14	5	0.0007536%	660433	99.51%	3	0.73%
攢	3192		22	5	0.0007536%	660438	99.52%	3	0.73%
楞	3196		13	5	0.0007536%	660443	99.52%	3	0.73%
涓	3204		10	5	0.0007536%	660448	99.53%	3	0.73%
涎	3205		11	5	0.0007536%	660453	99.53%	3	0.73%
漾	3207		14	5	0.0007536%	660458	99.53%	3	0.73%
瀑	3209		18	5	0.0007536%	660463	99.53%	3	0.73%
瑜	3216		13	5	0.0007536%	660468	99.53%	3	0.73%
癖	3219		18	5	0.0007536%	660473	99.54%	3	0.73%
皙	3221		13	5	0.0007536%	660478	99.54%	3	0.73%
磊	3226		15	5	0.0007536%	660483	99.54%	3	0.73%
穌	3231		16	5	0.0007536%	660488	99.55%	3	0.73%
綽	3239		14	5	0.0007536%	660493	99.55%	3	0.73%
罹	3242		16	5	0.0007536%	660498	99.55%	3	0.73%
腋	3245		12	5	0.0007536%	660503	99.56%	3	0.73%
芙	3249		8	5	0.0007536%	660508	99.56%	3	0.73%
蔚	3252		15	5	0.0007536%	660513	99.56%	3	0.73%
蹭	3267		19	5	0.0007536%	660518	99.57%	3	0.73%
錚	3279		16	5	0.0007536%	660523	99.58%	3	0.73%
颼	3286		18	5	0.0007536%	660528	99.59%	3	0.73%
餚	3287		16	5	0.0007536%	660533	99.59%	3	0.73%
駝	3288		15	5	0.0007536%	660538	99.59%	3	0.73%
丑	3291		4	4	0.0006029%	660542	99.59%	3	0.73%
伉	3293		6	4	0.0006029%	660546	99.59%	3	0.73%
俬	3296		9	4	0.0006029%	660550	99.59%	3	0.73%
僥	3300		14	4	0.0006029%	660554	99.60%	3	0.73%
儷	3301		21	4	0.0006029%	660558	99.60%	3	0.73%
咩	3310		9	4	0.0006029%	660562	99.60%	3	0.73%
喔	3312		12	4	0.0006029%	660566	99.60%	3	0.73%
嗔	3317		13	4	0.0006029%	660570	99.61%	3	0.73%
嘮	3319		15	4	0.0006029%	660574	99.61%	3	0.73%
妞	3323		7	4	0.0006029%	660578	99.61%	3	0.73%
嫻	3327		15	4	0.0006029%	660582	99.61%	3	0.73%
寥	3329		14	4	0.0006029%	660586	99.61%	3	0.73%
崛	3330		11	4	0.0006029%	660590	99.61%	3	0.73%
崙	3331		11	4	0.0006029%	660594	99.61%	3	0.73%
嶇	3332		14	4	0.0006029%	660598	99.62%	3	0.73%
巒	3333		22	4	0.0006029%	660602	99.62%	3	0.73%
弔	3335		4	4	0.0006029%	660606	99.62%	3	0.73%
恙	3338		10	4	0.0006029%	660610	99.62%	3	0.73%
恣	3339		10	4	0.0006029%	660614	99.62%	3	0.73%
扉	3346		12	4	0.0006029%	660618	99.62%	3	0.73%
扳	3348		7	4	0.0006029%	660622	99.62%	3	0.73%
搐	3351		13	4	0.0006029%	660626	99.63%	3	0.73%
斕	3354		21	4	0.0006029%	660630	99.63%	3	0.73%
曹	3356		11	4	0.0006029%	660634	99.63%	3	0.73%
札	3357		5	4	0.0006029%	660638	99.63%	3	0.73%
椏	3362		12	4	0.0006029%	660642	99.63%	3	0.73%
椿	3363		13	4	0.0006029%	660646	99.63%	3	0.73%
殃	3365		9	4	0.0006029%	660650	99.64%	3	0.73%
溉	3371		12	4	0.0006029%	660654	99.64%	3	0.73%
澗	3376		15	4	0.0006029%	660658	99.64%	3	0.73%
瀝	3378		19	4	0.0006029%	660662	99.64%	3	0.73%
牟	3380		6	4	0.0006029%	660666	99.64%	3	0.73%
痠	3383		12	4	0.0006029%	660670	99.65%	3	0.73%
瞠	3388		16	4	0.0006029%	660674	99.65%	3	0.73%
瞰	3389		17	4	0.0006029%	660678	99.65%	3	0.73%
砍	3390		9	4	0.0006029%	660682	99.65%	3	0.73%
硯	3393		12	4	0.0006029%	660686	99.65%	3	0.73%
祐	3396		9	4	0.0006029%	660690	99.65%	3	0.73%
穢	3397		18	4	0.0006029%	660694	99.65%	3	0.73%
篷	3401		17	4	0.0006029%	660698	99.66%	3	0.73%
紕	3404		10	4	0.0006029%	660702	99.66%	3	0.73%
紜	3405		10	4	0.0006029%	660706	99.66%	3	0.73%
舅	3419		13	4	0.0006029%	660710	99.67%	3	0.73%
茉	3420		9	4	0.0006029%	660714	99.67%	3	0.73%
蒐	3427		14	4	0.0006029%	660718	99.67%	3	0.73%
裾	3436		13	4	0.0006029%	660722	99.68%	3	0.73%
謐	3442		17	4	0.0006029%	660726	99.68%	3	0.73%
跎	3444		12	4	0.0006029%	660730	99.68%	3	0.73%
跤	3446		13	4	0.0006029%	660734	99.68%	3	0.73%
蹉	3447		17	4	0.0006029%	660738	99.68%	3	0.73%
蹬	3449		19	4	0.0006029%	660742	99.69%	3	0.73%
辟	3453		13	4	0.0006029%	660746	99.69%	3	0.73%
醺	3457		21	4	0.0006029%	660750	99.69%	3	0.73%
鈺	3460		13	4	0.0006029%	660754	99.69%	3	0.73%
鉸	3461		14	4	0.0006029%	660758	99.69%	3	0.73%
閤	3467		14	4	0.0006029%	660762	99.70%	3	0.73%
雯	3469		12	4	0.0006029%	660766	99.70%	3	0.73%
鞦	3470		18	4	0.0006029%	660770	99.70%	3	0.73%
韆	3471		24	4	0.0006029%	660774	99.70%	3	0.73%
髹	3477		16	4	0.0006029%	660778	99.70%	3	0.73%
鯉	3479		18	4	0.0006029%	660782	99.70%	3	0.73%
鱗	3480		23	4	0.0006029%	660786	99.70%	3	0.73%
丕	3482		5	3	0.0004522%	660789	99.71%	3	0.73%
乒	3483		6	3	0.0004522%	660792	99.71%	3	0.73%
乓	3484		6	3	0.0004522%	660795	99.71%	3	0.73%
亙	3485		6	3	0.0004522%	660798	99.71%	3	0.73%
仕	3486		5	3	0.0004522%	660801	99.71%	3	0.73%
伎	3487		6	3	0.0004522%	660804	99.71%	3	0.73%
伺	3488		7	3	0.0004522%	660807	99.71%	3	0.73%
佯	3489		8	3	0.0004522%	660810	99.71%	3	0.73%
佻	3490		8	3	0.0004522%	660813	99.71%	3	0.73%
俞	3491		9	3	0.0004522%	660816	99.71%	3	0.73%
倣	3492		10	3	0.0004522%	660819	99.71%	3	0.73%
僕	3493		14	3	0.0004522%	660822	99.71%	3	0.73%
冗	3494		4	3	0.0004522%	660825	99.71%	3	0.73%
冽	3495		8	3	0.0004522%	660828	99.71%	3	0.73%
凰	3496		11	3	0.0004522%	660831	99.71%	3	0.73%
劾	3497		8	3	0.0004522%	660834	99.71%	3	0.73%
勻	3498		4	3	0.0004522%	660837	99.71%	3	0.73%
呃	3499		7	3	0.0004522%	660840	99.71%	3	0.73%
呸	3500		8	3	0.0004522%	660843	99.71%	3	0.73%
咎	3501		8	3	0.0004522%	660846	99.71%	3	0.73%
哇	3503		9	3	0.0004522%	660849	99.71%	3	0.73%
唁	3504		10	3	0.0004522%	660852	99.72%	3	0.73%
哺	3505		10	3	0.0004522%	660855	99.72%	3	0.73%
哮	3506		10	3	0.0004522%	660858	99.72%	3	0.73%
哽	3507		10	3	0.0004522%	660861	99.72%	3	0.73%
喱	3508		12	3	0.0004522%	660864	99.72%	3	0.73%
嗟	3509		13	3	0.0004522%	660867	99.72%	3	0.73%
嚎	3510		17	3	0.0004522%	660870	99.72%	3	0.73%
囪	3511		7	3	0.0004522%	660873	99.72%	3	0.73%
囹	3512		8	3	0.0004522%	660876	99.72%	3	0.73%
囿	3513		9	3	0.0004522%	660879	99.72%	3	0.73%
圄	3514		10	3	0.0004522%	660882	99.72%	3	0.73%
圜	3515		16	3	0.0004522%	660885	99.72%	3	0.73%
坍	3516		7	3	0.0004522%	660888	99.72%	3	0.73%
坷	3517		8	3	0.0004522%	660891	99.72%	3	0.73%
垣	3518		9	3	0.0004522%	660894	99.72%	3	0.73%
壼	3519		13	3	0.0004522%	660897	99.72%	3	0.73%
妾	3521		8	3	0.0004522%	660900	99.72%	3	0.73%
婪	3522		11	3	0.0004522%	660903	99.72%	3	0.73%
嫖	3525		14	3	0.0004522%	660906	99.72%	3	0.73%
孀	3526		20	3	0.0004522%	660909	99.73%	3	0.73%
宛	3528		8	3	0.0004522%	660912	99.73%	3	0.73%
寐	3529		12	3	0.0004522%	660915	99.73%	3	0.73%
屎	3530		9	3	0.0004522%	660918	99.73%	3	0.73%
屹	3531		6	3	0.0004522%	660921	99.73%	3	0.73%
嶄	3532		14	3	0.0004522%	660924	99.73%	3	0.73%
巢	3534		11	3	0.0004522%	660927	99.73%	3	0.73%
庶	3535		11	3	0.0004522%	660930	99.73%	3	0.73%
彊	3536		16	3	0.0004522%	660933	99.73%	3	0.73%
彪	3538		11	3	0.0004522%	660936	99.73%	3	0.73%
徉	3539		9	3	0.0004522%	660939	99.73%	3	0.73%
徜	3540		11	3	0.0004522%	660942	99.73%	3	0.73%
徬	3541		13	3	0.0004522%	660945	99.73%	3	0.73%
忱	3542		7	3	0.0004522%	660948	99.73%	3	0.73%
忑	3543		7	3	0.0004522%	660951	99.73%	3	0.73%
惻	3544		12	3	0.0004522%	660954	99.73%	3	0.73%
慫	3545		15	3	0.0004522%	660957	99.73%	3	0.73%
憩	3546		16	3	0.0004522%	660960	99.73%	3	0.73%
捍	3550		10	3	0.0004522%	660963	99.74%	3	0.73%
揍	3551		12	3	0.0004522%	660966	99.74%	3	0.73%
搗	3552		13	3	0.0004522%	660969	99.74%	3	0.73%
搥	3553		13	3	0.0004522%	660972	99.74%	3	0.73%
斡	3554		14	3	0.0004522%	660975	99.74%	3	0.73%
斧	3555		8	3	0.0004522%	660978	99.74%	3	0.73%
昭	3556		9	3	0.0004522%	660981	99.74%	3	0.73%
暉	3557		13	3	0.0004522%	660984	99.74%	3	0.73%
暱	3558		15	3	0.0004522%	660987	99.74%	3	0.73%
杳	3560		8	3	0.0004522%	660990	99.74%	3	0.73%
槳	3563		15	3	0.0004522%	660993	99.74%	3	0.73%
欖	3564		25	3	0.0004522%	660996	99.74%	3	0.73%
氓	3568		8	3	0.0004522%	660999	99.74%	3	0.73%
沁	3569		7	3	0.0004522%	661002	99.74%	3	0.73%
沌	3570		7	3	0.0004522%	661005	99.75%	3	0.73%
沃	3571		7	3	0.0004522%	661008	99.75%	3	0.73%
沼	3572		8	3	0.0004522%	661011	99.75%	3	0.73%
泯	3573		8	3	0.0004522%	661014	99.75%	3	0.73%
浙	3574		10	3	0.0004522%	661017	99.75%	3	0.73%
渦	3575		12	3	0.0004522%	661020	99.75%	3	0.73%
溯	3576		13	3	0.0004522%	661023	99.75%	3	0.73%
滕	3578		15	3	0.0004522%	661026	99.75%	3	0.73%
瀚	3580		19	3	0.0004522%	661029	99.75%	3	0.73%
炆	3581		8	3	0.0004522%	661032	99.75%	3	0.73%
烽	3582		11	3	0.0004522%	661035	99.75%	3	0.73%
焰	3583		12	3	0.0004522%	661038	99.75%	3	0.73%
熊	3584		14	3	0.0004522%	661041	99.75%	3	0.73%
犁	3587		11	3	0.0004522%	661044	99.75%	3	0.73%
琉	3589		10	3	0.0004522%	661047	99.75%	3	0.73%
璧	3592		18	3	0.0004522%	661050	99.76%	3	0.73%
畝	3593		10	3	0.0004522%	661053	99.76%	3	0.73%
疤	3595		9	3	0.0004522%	661056	99.76%	3	0.73%
疵	3596		11	3	0.0004522%	661059	99.76%	3	0.73%
癒	3597		18	3	0.0004522%	661062	99.76%	3	0.73%
癥	3598		20	3	0.0004522%	661065	99.76%	3	0.73%
皓	3599		12	3	0.0004522%	661068	99.76%	3	0.73%
眯	3600		11	3	0.0004522%	661071	99.76%	3	0.73%
睞	3601		13	3	0.0004522%	661074	99.76%	3	0.73%
睬	3602		13	3	0.0004522%	661077	99.76%	3	0.73%
睨	3603		13	3	0.0004522%	661080	99.76%	3	0.73%
瞼	3605		18	3	0.0004522%	661083	99.76%	3	0.73%
矯	3606		17	3	0.0004522%	661086	99.76%	3	0.73%
砵	3607		10	3	0.0004522%	661089	99.76%	3	0.73%
礁	3610		17	3	0.0004522%	661092	99.76%	3	0.73%
祇	3611		8	3	0.0004522%	661095	99.76%	3	0.73%
稠	3613		13	3	0.0004522%	661098	99.76%	3	0.73%
稔	3614		13	3	0.0004522%	661101	99.77%	3	0.73%
笫	3620		11	3	0.0004522%	661104	99.77%	3	0.73%
箸	3623		14	3	0.0004522%	661107	99.77%	3	0.73%
篆	3624		15	3	0.0004522%	661110	99.77%	3	0.73%
紈	3626		9	3	0.0004522%	661113	99.77%	3	0.73%
紓	3627		10	3	0.0004522%	661116	99.77%	3	0.73%
締	3630		15	3	0.0004522%	661119	99.77%	3	0.73%
緬	3631		15	3	0.0004522%	661122	99.77%	3	0.73%
縝	3633		16	3	0.0004522%	661125	99.77%	3	0.73%
繚	3634		18	3	0.0004522%	661128	99.77%	3	0.73%
缸	3635		9	3	0.0004522%	661131	99.77%	3	0.73%
翳	3638		17	3	0.0004522%	661134	99.78%	3	0.73%
肋	3640		6	3	0.0004522%	661137	99.78%	3	0.73%
腎	3642		12	3	0.0004522%	661140	99.78%	3	0.73%
腮	3643		13	3	0.0004522%	661143	99.78%	3	0.73%
腩	3644		13	3	0.0004522%	661146	99.78%	3	0.73%
臀	3645		17	3	0.0004522%	661149	99.78%	3	0.73%
臾	3646		8	3	0.0004522%	661152	99.78%	3	0.73%
舵	3647		11	3	0.0004522%	661155	99.78%	3	0.73%
艙	3648		16	3	0.0004522%	661158	99.78%	3	0.73%
茁	3650		9	3	0.0004522%	661161	99.78%	3	0.73%
菠	3653		12	3	0.0004522%	661164	99.78%	3	0.73%
薛	3658		17	3	0.0004522%	661167	99.79%	3	0.73%
藩	3659		19	3	0.0004522%	661170	99.79%	3	0.73%
虹	3660		9	3	0.0004522%	661173	99.79%	3	0.73%
蜓	3661		13	3	0.0004522%	661176	99.79%	3	0.73%
蛻	3662		13	3	0.0004522%	661179	99.79%	3	0.73%
蜻	3663		14	3	0.0004522%	661182	99.79%	3	0.73%
蜘	3665		14	3	0.0004522%	661185	99.79%	3	0.73%
袒	3666		10	3	0.0004522%	661188	99.79%	3	0.73%
褓	3667		14	3	0.0004522%	661191	99.79%	3	0.73%
褥	3668		15	3	0.0004522%	661194	99.79%	3	0.73%
襤	3669		19	3	0.0004522%	661197	99.79%	3	0.73%
覷	3670		19	3	0.0004522%	661200	99.79%	3	0.73%
譭	3676		20	3	0.0004522%	661203	99.79%	3	0.73%
踵	3678		16	3	0.0004522%	661206	99.79%	3	0.73%
踰	3679		16	3	0.0004522%	661209	99.79%	3	0.73%
蹣	3681		18	3	0.0004522%	661212	99.80%	3	0.73%
軋	3683		8	3	0.0004522%	661215	99.80%	3	0.73%
逞	3684		10	3	0.0004522%	661218	99.80%	3	0.73%
逡	3685		10	3	0.0004522%	661221	99.80%	3	0.73%
遐	3686		12	3	0.0004522%	661224	99.80%	3	0.73%
遏	3687		12	3	0.0004522%	661227	99.80%	3	0.73%
遼	3688		15	3	0.0004522%	661230	99.80%	3	0.73%
酌	3689		10	3	0.0004522%	661233	99.80%	3	0.73%
酥	3690		12	3	0.0004522%	661236	99.80%	3	0.73%
酢	3691		12	3	0.0004522%	661239	99.80%	3	0.73%
釆	3692		7	3	0.0004522%	661242	99.80%	3	0.73%
鋤	3693		15	3	0.0004522%	661245	99.80%	3	0.73%
銹	3694		15	3	0.0004522%	661248	99.80%	3	0.73%
鍍	3695		17	3	0.0004522%	661251	99.80%	3	0.73%
鍥	3696		17	3	0.0004522%	661254	99.80%	3	0.73%
鏢	3697		19	3	0.0004522%	661257	99.80%	3	0.73%
鏘	3698		19	3	0.0004522%	661260	99.80%	3	0.73%
鐐	3699		20	3	0.0004522%	661263	99.80%	3	0.73%
阱	3700		6	3	0.0004522%	661266	99.80%	3	0.73%
陝	3701		9	3	0.0004522%	661269	99.80%	3	0.73%
雍	3702		13	3	0.0004522%	661272	99.80%	3	0.73%
韌	3706		12	3	0.0004522%	661275	99.81%	3	0.73%
飪	3709		12	3	0.0004522%	661278	99.81%	3	0.73%
飴	3710		13	3	0.0004522%	661281	99.81%	3	0.73%
骯	3714		14	3	0.0004522%	661284	99.81%	3	0.73%
鶩	3717		20	3	0.0004522%	661287	99.81%	3	0.73%
麾	3719		15	3	0.0004522%	661290	99.81%	3	0.73%
鼾	3720		17	3	0.0004522%	661293	99.81%	3	0.73%
龜	3721		16	3	0.0004522%	661296	99.81%	3	0.73%
鈽	2025		13	24	0.003617%	661320	97.42%	2	0.49%
枇	2225		8	18	0.002713%	661338	98.04%	2	0.49%
剁	2291		8	16	0.002412%	661354	98.21%	2	0.49%
鯊	2335		18	16	0.002412%	661370	98.32%	2	0.49%
阪	2478		6	13	0.001959%	661383	98.62%	2	0.49%
朔	2578		10	11	0.001658%	661394	98.80%	2	0.49%
璇	2589		15	11	0.001658%	661405	98.82%	2	0.49%
鏟	2615		19	11	0.001658%	661416	98.86%	2	0.49%
黐	2620		23	11	0.001658%	661427	98.87%	2	0.49%
燄	2660		16	10	0.001507%	661437	98.93%	2	0.49%
瑤	2662		14	10	0.001507%	661447	98.93%	2	0.49%
骸	2698		16	10	0.001507%	661457	98.99%	2	0.49%
肛	2852		7	8	0.001206%	661465	99.19%	2	0.49%
豚	2868		11	8	0.001206%	661473	99.21%	2	0.49%
阮	2878		6	8	0.001206%	661481	99.22%	2	0.49%
丙	2885		5	7	0.001055%	661488	99.23%	2	0.49%
喫	2905		12	7	0.001055%	661495	99.25%	2	0.49%
栗	2937		10	7	0.001055%	661502	99.28%	2	0.49%
狙	2957		8	7	0.001055%	661509	99.30%	2	0.49%
箏	2968		14	7	0.001055%	661516	99.32%	2	0.49%
荻	2978		11	7	0.001055%	661523	99.33%	2	0.49%
襖	2986		18	7	0.001055%	661530	99.33%	2	0.49%
勛	3015		12	6	0.0009043%	661536	99.36%	2	0.49%
卵	3018		7	6	0.0009043%	661542	99.37%	2	0.49%
矓	3096		21	6	0.0009043%	661548	99.44%	2	0.49%
刨	3154		7	5	0.0007536%	661553	99.49%	2	0.49%
嚀	3163		17	5	0.0007536%	661558	99.49%	2	0.49%
姚	3167		9	5	0.0007536%	661563	99.50%	2	0.49%
秤	3229		10	5	0.0007536%	661568	99.54%	2	0.49%
簸	3236		19	5	0.0007536%	661573	99.55%	2	0.49%
鉗	3278		13	5	0.0007536%	661578	99.58%	2	0.49%
鞍	3284		15	5	0.0007536%	661583	99.59%	2	0.49%
兢	3303		14	4	0.0006029%	661587	99.60%	2	0.49%
咚	3309		8	4	0.0006029%	661591	99.60%	2	0.49%
咿	3311		9	4	0.0006029%	661595	99.60%	2	0.49%
啾	3313		12	4	0.0006029%	661599	99.60%	2	0.49%
喁	3315		12	4	0.0006029%	661603	99.60%	2	0.49%
嘁	3318		14	4	0.0006029%	661607	99.61%	2	0.49%
噢	3321		16	4	0.0006029%	661611	99.61%	2	0.49%
娟	3325		10	4	0.0006029%	661615	99.61%	2	0.49%
幪	3334		17	4	0.0006029%	661619	99.62%	2	0.49%
恬	3337		9	4	0.0006029%	661623	99.62%	2	0.49%
杖	3358		7	4	0.0006029%	661627	99.63%	2	0.49%
栩	3360		10	4	0.0006029%	661631	99.63%	2	0.49%
汩	3369		7	4	0.0006029%	661635	99.64%	2	0.49%
涔	3370		10	4	0.0006029%	661639	99.64%	2	0.49%
潺	3375		15	4	0.0006029%	661643	99.64%	2	0.49%
焊	3379		11	4	0.0006029%	661647	99.64%	2	0.49%
牡	3381		7	4	0.0006029%	661651	99.64%	2	0.49%
瘟	3385		15	4	0.0006029%	661655	99.65%	2	0.49%
粼	3402		14	4	0.0006029%	661659	99.66%	2	0.49%
緯	3410		15	4	0.0006029%	661663	99.66%	2	0.49%
莎	3422		11	4	0.0006029%	661667	99.67%	2	0.49%
蒲	3425		14	4	0.0006029%	661671	99.67%	2	0.49%
褂	3435		13	4	0.0006029%	661675	99.68%	2	0.49%
誡	3440		14	4	0.0006029%	661679	99.68%	2	0.49%
譴	3443		21	4	0.0006029%	661683	99.68%	2	0.49%
蹋	3448		17	4	0.0006029%	661687	99.69%	2	0.49%
鈣	3459		12	4	0.0006029%	661691	99.69%	2	0.49%
閨	3465		14	4	0.0006029%	661695	99.70%	2	0.49%
骷	3474		15	4	0.0006029%	661699	99.70%	2	0.49%
髏	3476		21	4	0.0006029%	661703	99.70%	2	0.49%
魆	3478		15	4	0.0006029%	661707	99.70%	2	0.49%
咂	3502		8	3	0.0004522%	661710	99.71%	2	0.49%
娼	3523		11	3	0.0004522%	661713	99.72%	2	0.49%
婷	3524		12	3	0.0004522%	661716	99.72%	2	0.49%
孜	3527		7	3	0.0004522%	661719	99.73%	2	0.49%
巍	3533		21	3	0.0004522%	661722	99.73%	2	0.49%
戮	3548		15	3	0.0004522%	661725	99.74%	2	0.49%
戳	3549		18	3	0.0004522%	661728	99.74%	2	0.49%
槐	3562		14	3	0.0004522%	661731	99.74%	2	0.49%
毓	3567		13	3	0.0004522%	661734	99.74%	2	0.49%
滸	3577		14	3	0.0004522%	661737	99.75%	2	0.49%
瀏	3579		18	3	0.0004522%	661740	99.75%	2	0.49%
熨	3585		15	3	0.0004522%	661743	99.75%	2	0.49%
爿	3586		4	3	0.0004522%	661746	99.75%	2	0.49%
猿	3588		13	3	0.0004522%	661749	99.75%	2	0.49%
瑙	3590		13	3	0.0004522%	661752	99.75%	2	0.49%
畦	3594		11	3	0.0004522%	661755	99.76%	2	0.49%
瞟	3604		16	3	0.0004522%	661758	99.76%	2	0.49%
碘	3608		13	3	0.0004522%	661761	99.76%	2	0.49%
磕	3609		15	3	0.0004522%	661764	99.76%	2	0.49%
祗	3612		9	3	0.0004522%	661767	99.76%	2	0.49%
窟	3616		13	3	0.0004522%	661770	99.77%	2	0.49%
窣	3617		13	3	0.0004522%	661773	99.77%	2	0.49%
笈	3618		10	3	0.0004522%	661776	99.77%	2	0.49%
笠	3619		11	3	0.0004522%	661779	99.77%	2	0.49%
筐	3621		12	3	0.0004522%	661782	99.77%	2	0.49%
筍	3622		12	3	0.0004522%	661785	99.77%	2	0.49%
籟	3625		22	3	0.0004522%	661788	99.77%	2	0.49%
絳	3628		12	3	0.0004522%	661791	99.77%	2	0.49%
緋	3629		14	3	0.0004522%	661794	99.77%	2	0.49%
緞	3632		15	3	0.0004522%	661797	99.77%	2	0.49%
罄	3636		17	3	0.0004522%	661800	99.78%	2	0.49%
羔	3637		10	3	0.0004522%	661803	99.78%	2	0.49%
耆	3639		10	3	0.0004522%	661806	99.78%	2	0.49%
胱	3641		10	3	0.0004522%	661809	99.78%	2	0.49%
茅	3649		9	3	0.0004522%	661812	99.78%	2	0.49%
茹	3651		10	3	0.0004522%	661815	99.78%	2	0.49%
莠	3652		11	3	0.0004522%	661818	99.78%	2	0.49%
菇	3654		12	3	0.0004522%	661821	99.78%	2	0.49%
蔗	3655		15	3	0.0004522%	661824	99.78%	2	0.49%
蕾	3656		17	3	0.0004522%	661827	99.78%	2	0.49%
薑	3657		17	3	0.0004522%	661830	99.78%	2	0.49%
訛	3671		11	3	0.0004522%	661833	99.79%	2	0.49%
詛	3672		12	3	0.0004522%	661836	99.79%	2	0.49%
諂	3673		15	3	0.0004522%	661839	99.79%	2	0.49%
諫	3674		16	3	0.0004522%	661842	99.79%	2	0.49%
踹	3677		16	3	0.0004522%	661845	99.79%	2	0.49%
蹙	3680		18	3	0.0004522%	661848	99.80%	2	0.49%
蹺	3682		19	3	0.0004522%	661851	99.80%	2	0.49%
靖	3703		13	3	0.0004522%	661854	99.81%	2	0.49%
颯	3707		14	3	0.0004522%	661857	99.81%	2	0.49%
颳	3708		15	3	0.0004522%	661860	99.81%	2	0.49%
餒	3711		15	3	0.0004522%	661863	99.81%	2	0.49%
餡	3712		16	3	0.0004522%	661866	99.81%	2	0.49%
駿	3713		17	3	0.0004522%	661869	99.81%	2	0.49%
鳶	3716		14	3	0.0004522%	661872	99.81%	2	0.49%
鶯	3718		21	3	0.0004522%	661875	99.81%	2	0.49%
亟	3723		8	2	0.0003014%	661877	99.81%	2	0.49%
侷	3725		9	2	0.0003014%	661879	99.81%	2	0.49%
俺	3726		10	2	0.0003014%	661881	99.82%	2	0.49%
僂	3727		13	2	0.0003014%	661883	99.82%	2	0.49%
兀	3728		3	2	0.0003014%	661885	99.82%	2	0.49%
剋	3730		9	2	0.0003014%	661887	99.82%	2	0.49%
匡	3731		6	2	0.0003014%	661889	99.82%	2	0.49%
卉	3732		5	2	0.0003014%	661891	99.82%	2	0.49%
占	3733		5	2	0.0003014%	661893	99.82%	2	0.49%
叻	3734		5	2	0.0003014%	661895	99.82%	2	0.49%
吭	3735		7	2	0.0003014%	661897	99.82%	2	0.49%
吮	3736		7	2	0.0003014%	661899	99.82%	2	0.49%
呤	3738		8	2	0.0003014%	661901	99.82%	2	0.49%
咸	3739		9	2	0.0003014%	661903	99.82%	2	0.49%
唷	3740		10	2	0.0003014%	661905	99.82%	2	0.49%
啕	3741		11	2	0.0003014%	661907	99.82%	2	0.49%
	3744		12	2	0.0003014%	661909	99.82%	2	0.49%
喎	3746		12	2	0.0003014%	661911	99.82%	2	0.49%
嗨	3747		13	2	0.0003014%	661913	99.82%	2	0.49%
嗑	3748		13	2	0.0003014%	661915	99.82%	2	0.49%
噁	3752		15	2	0.0003014%	661917	99.82%	2	0.49%
噤	3753		16	2	0.0003014%	661919	99.82%	2	0.49%
嚶	3755		20	2	0.0003014%	661921	99.82%	2	0.49%
囫	3756		7	2	0.0003014%	661923	99.82%	2	0.49%
圇	3757		11	2	0.0003014%	661925	99.82%	2	0.49%
壅	3758		16	2	0.0003014%	661927	99.82%	2	0.49%
壑	3760		17	2	0.0003014%	661929	99.83%	2	0.49%
奎	3761		9	2	0.0003014%	661931	99.83%	2	0.49%
奠	3762		12	2	0.0003014%	661933	99.83%	2	0.49%
姘	3764		9	2	0.0003014%	661935	99.83%	2	0.49%
姣	3765		9	2	0.0003014%	661937	99.83%	2	0.49%
娥	3767		10	2	0.0003014%	661939	99.83%	2	0.49%
婀	3768		11	2	0.0003014%	661941	99.83%	2	0.49%
媲	3770		13	2	0.0003014%	661943	99.83%	2	0.49%
孑	3774		3	2	0.0003014%	661945	99.83%	2	0.49%
孽	3775		20	2	0.0003014%	661947	99.83%	2	0.49%
宰	3776		10	2	0.0003014%	661949	99.83%	2	0.49%
寇	3777		11	2	0.0003014%	661951	99.83%	2	0.49%
寮	3778		15	2	0.0003014%	661953	99.83%	2	0.49%
岐	3779		7	2	0.0003014%	661955	99.83%	2	0.49%
峙	3781		9	2	0.0003014%	661957	99.83%	2	0.49%
崔	3783		11	2	0.0003014%	661959	99.83%	2	0.49%
嶂	3784		14	2	0.0003014%	661961	99.83%	2	0.49%
帖	3785		8	2	0.0003014%	661963	99.83%	2	0.49%
帙	3786		8	2	0.0003014%	661965	99.83%	2	0.49%
幔	3787		14	2	0.0003014%	661967	99.83%	2	0.49%
廬	3788		19	2	0.0003014%	661969	99.83%	2	0.49%
徽	3789		17	2	0.0003014%	661971	99.83%	2	0.49%
怩	3791		8	2	0.0003014%	661973	99.83%	2	0.49%
恁	3793		10	2	0.0003014%	661975	99.84%	2	0.49%
惦	3794		11	2	0.0003014%	661977	99.84%	2	0.49%
悼	3795		11	2	0.0003014%	661979	99.84%	2	0.49%
愜	3796		12	2	0.0003014%	661981	99.84%	2	0.49%
慬	3798		14	2	0.0003014%	661983	99.84%	2	0.49%
憋	3799		15	2	0.0003014%	661985	99.84%	2	0.49%
懟	3801		18	2	0.0003014%	661987	99.84%	2	0.49%
戾	3803		8	2	0.0003014%	661989	99.84%	2	0.49%
拌	3804		8	2	0.0003014%	661991	99.84%	2	0.49%
拇	3806		8	2	0.0003014%	661993	99.84%	2	0.49%
捎	3808		10	2	0.0003014%	661995	99.84%	2	0.49%
捆	3809		10	2	0.0003014%	661997	99.84%	2	0.49%
掬	3810		11	2	0.0003014%	661999	99.84%	2	0.49%
掂	3811		11	2	0.0003014%	662001	99.84%	2	0.49%
掮	3812		11	2	0.0003014%	662003	99.84%	2	0.49%
掟	3813		11	2	0.0003014%	662005	99.84%	2	0.49%
揖	3814		12	2	0.0003014%	662007	99.84%	2	0.49%
搾	3815		13	2	0.0003014%	662009	99.84%	2	0.49%
搪	3816		13	2	0.0003014%	662011	99.84%	2	0.49%
撂	3817		14	2	0.0003014%	662013	99.84%	2	0.49%
摹	3818		15	2	0.0003014%	662015	99.84%	2	0.49%
撬	3819		15	2	0.0003014%	662017	99.84%	2	0.49%
攙	3821		20	2	0.0003014%	662019	99.84%	2	0.49%
攸	3823		7	2	0.0003014%	662021	99.84%	2	0.49%
敝	3824		11	2	0.0003014%	662023	99.84%	2	0.49%
斃	3825		17	2	0.0003014%	662025	99.84%	2	0.49%
旛	3826		18	2	0.0003014%	662027	99.85%	2	0.49%
旳	3828		7	2	0.0003014%	662029	99.85%	2	0.49%
晦	3830		11	2	0.0003014%	662031	99.85%	2	0.49%
曙	3831		17	2	0.0003014%	662033	99.85%	2	0.49%
杏	3832		7	2	0.0003014%	662035	99.85%	2	0.49%
杞	3833		7	2	0.0003014%	662037	99.85%	2	0.49%
杭	3834		8	2	0.0003014%	662039	99.85%	2	0.49%
枷	3836		9	2	0.0003014%	662041	99.85%	2	0.49%
栖	3837		10	2	0.0003014%	662043	99.85%	2	0.49%
桎	3838		10	2	0.0003014%	662045	99.85%	2	0.49%
梧	3839		11	2	0.0003014%	662047	99.85%	2	0.49%
梏	3841		11	2	0.0003014%	662049	99.85%	2	0.49%
棺	3842		12	2	0.0003014%	662051	99.85%	2	0.49%
榨	3844		14	2	0.0003014%	662053	99.85%	2	0.49%
樞	3845		15	2	0.0003014%	662055	99.85%	2	0.49%
橄	3846		16	2	0.0003014%	662057	99.85%	2	0.49%
樵	3847		16	2	0.0003014%	662059	99.85%	2	0.49%
檀	3848		17	2	0.0003014%	662061	99.85%	2	0.49%
檄	3849		17	2	0.0003014%	662063	99.85%	2	0.49%
櫛	3850		17	2	0.0003014%	662065	99.85%	2	0.49%
檳	3851		18	2	0.0003014%	662067	99.85%	2	0.49%
殄	3852		9	2	0.0003014%	662069	99.85%	2	0.49%
殯	3854		18	2	0.0003014%	662071	99.85%	2	0.49%
氨	3855		10	2	0.0003014%	662073	99.85%	2	0.49%
汀	3858		5	2	0.0003014%	662075	99.85%	2	0.49%
汔	3859		6	2	0.0003014%	662077	99.86%	2	0.49%
汶	3860		7	2	0.0003014%	662079	99.86%	2	0.49%
泌	3861		8	2	0.0003014%	662081	99.86%	2	0.49%
泄	3863		8	2	0.0003014%	662083	99.86%	2	0.49%
洱	3864		9	2	0.0003014%	662085	99.86%	2	0.49%
涸	3865		11	2	0.0003014%	662087	99.86%	2	0.49%
渤	3866		12	2	0.0003014%	662089	99.86%	2	0.49%
湮	3867		12	2	0.0003014%	662091	99.86%	2	0.49%
渭	3868		12	2	0.0003014%	662093	99.86%	2	0.49%
湃	3869		12	2	0.0003014%	662095	99.86%	2	0.49%
淼	3870		12	2	0.0003014%	662097	99.86%	2	0.49%
漩	3871		14	2	0.0003014%	662099	99.86%	2	0.49%
漣	3872		14	2	0.0003014%	662101	99.86%	2	0.49%
漪	3873		14	2	0.0003014%	662103	99.86%	2	0.49%
潘	3875		15	2	0.0003014%	662105	99.86%	2	0.49%
濘	3878		17	2	0.0003014%	662107	99.86%	2	0.49%
瀆	3879		18	2	0.0003014%	662109	99.86%	2	0.49%
瀕	3880		19	2	0.0003014%	662111	99.86%	2	0.49%
灶	3881		7	2	0.0003014%	662113	99.86%	2	0.49%
炊	3882		8	2	0.0003014%	662115	99.86%	2	0.49%
炙	3883		8	2	0.0003014%	662117	99.86%	2	0.49%
烙	3884		10	2	0.0003014%	662119	99.86%	2	0.49%
煦	3885		13	2	0.0003014%	662121	99.86%	2	0.49%
燉	3888		16	2	0.0003014%	662123	99.86%	2	0.49%
燎	3889		16	2	0.0003014%	662125	99.86%	2	0.49%
燠	3890		17	2	0.0003014%	662127	99.86%	2	0.49%
燼	3891		18	2	0.0003014%	662129	99.86%	2	0.49%
爍	3892		19	2	0.0003014%	662131	99.87%	2	0.49%
狡	3894		9	2	0.0003014%	662133	99.87%	2	0.49%
狽	3895		10	2	0.0003014%	662135	99.87%	2	0.49%
狷	3896		10	2	0.0003014%	662137	99.87%	2	0.49%
猖	3897		11	2	0.0003014%	662139	99.87%	2	0.49%
獗	3898		15	2	0.0003014%	662141	99.87%	2	0.49%
獷	3899		18	2	0.0003014%	662143	99.87%	2	0.49%
琪	3901		12	2	0.0003014%	662145	99.87%	2	0.49%
琵	3902		12	2	0.0003014%	662147	99.87%	2	0.49%
琶	3903		12	2	0.0003014%	662149	99.87%	2	0.49%
瑚	3906		13	2	0.0003014%	662151	99.87%	2	0.49%
璀	3907		15	2	0.0003014%	662153	99.87%	2	0.49%
璣	3908		16	2	0.0003014%	662155	99.87%	2	0.49%
璨	3909		17	2	0.0003014%	662157	99.87%	2	0.49%
瓊	3910		19	2	0.0003014%	662159	99.87%	2	0.49%
疹	3911		10	2	0.0003014%	662161	99.87%	2	0.49%
瘁	3913		13	2	0.0003014%	662163	99.87%	2	0.49%
痺	3914		13	2	0.0003014%	662165	99.87%	2	0.49%
瘍	3915		14	2	0.0003014%	662167	99.87%	2	0.49%
瘠	3917		15	2	0.0003014%	662169	99.87%	2	0.49%
瞽	3920		18	2	0.0003014%	662171	99.87%	2	0.49%
瞿	3921		18	2	0.0003014%	662173	99.87%	2	0.49%
砧	3922		10	2	0.0003014%	662175	99.87%	2	0.49%
礫	3925		20	2	0.0003014%	662177	99.88%	2	0.49%
竇	3926		20	2	0.0003014%	662179	99.88%	2	0.49%
竽	3927		9	2	0.0003014%	662181	99.88%	2	0.49%
笙	3928		11	2	0.0003014%	662183	99.88%	2	0.49%
筷	3929		13	2	0.0003014%	662185	99.88%	2	0.49%
箋	3930		14	2	0.0003014%	662187	99.88%	2	0.49%
篩	3931		16	2	0.0003014%	662189	99.88%	2	0.49%
簫	3932		18	2	0.0003014%	662191	99.88%	2	0.49%
籐	3933		21	2	0.0003014%	662193	99.88%	2	0.49%
籬	3934		25	2	0.0003014%	662195	99.88%	2	0.49%
粟	3935		12	2	0.0003014%	662197	99.88%	2	0.49%
紘	3936		10	2	0.0003014%	662199	99.88%	2	0.49%
絃	3937		11	2	0.0003014%	662201	99.88%	2	0.49%
絹	3939		13	2	0.0003014%	662203	99.88%	2	0.49%
綷	3941		14	2	0.0003014%	662205	99.88%	2	0.49%
縐	3942		16	2	0.0003014%	662207	99.88%	2	0.49%
纓	3943		23	2	0.0003014%	662209	99.88%	2	0.49%
罔	3944		8	2	0.0003014%	662211	99.88%	2	0.49%
胺	3945		10	2	0.0003014%	662213	99.88%	2	0.49%
脛	3946		11	2	0.0003014%	662215	99.88%	2	0.49%
腴	3947		12	2	0.0003014%	662217	99.88%	2	0.49%
膾	3948		17	2	0.0003014%	662219	99.88%	2	0.49%
芋	3951		7	2	0.0003014%	662221	99.88%	2	0.49%
芭	3952		8	2	0.0003014%	662223	99.88%	2	0.49%
苞	3954		9	2	0.0003014%	662225	99.88%	2	0.49%
荀	3955		10	2	0.0003014%	662227	99.88%	2	0.49%
荳	3957		11	2	0.0003014%	662229	99.88%	2	0.49%
薔	3958		17	2	0.0003014%	662231	99.88%	2	0.49%
薇	3959		17	2	0.0003014%	662233	99.89%	2	0.49%
蛀	3962		11	2	0.0003014%	662235	99.89%	2	0.49%
蜷	3964		14	2	0.0003014%	662237	99.89%	2	0.49%
蝠	3966		15	2	0.0003014%	662239	99.89%	2	0.49%
蝙	3968		15	2	0.0003014%	662241	99.89%	2	0.49%
蟒	3969		17	2	0.0003014%	662243	99.89%	2	0.49%
衢	3971		24	2	0.0003014%	662245	99.89%	2	0.49%
衾	3972		10	2	0.0003014%	662247	99.89%	2	0.49%
袛	3973		10	2	0.0003014%	662249	99.89%	2	0.49%
襁	3974		16	2	0.0003014%	662251	99.89%	2	0.49%
襄	3975		17	2	0.0003014%	662253	99.89%	2	0.49%
襬	3976		20	2	0.0003014%	662255	99.89%	2	0.49%
覦	3977		16	2	0.0003014%	662257	99.89%	2	0.49%
覬	3978		17	2	0.0003014%	662259	99.89%	2	0.49%
訥	3979		11	2	0.0003014%	662261	99.89%	2	0.49%
詆	3980		12	2	0.0003014%	662263	99.89%	2	0.49%
誅	3981		13	2	0.0003014%	662265	99.89%	2	0.49%
詬	3982		13	2	0.0003014%	662267	99.89%	2	0.49%
詡	3983		13	2	0.0003014%	662269	99.89%	2	0.49%
諜	3986		16	2	0.0003014%	662271	99.89%	2	0.49%
謔	3989		16	2	0.0003014%	662273	99.89%	2	0.49%
謗	3990		17	2	0.0003014%	662275	99.89%	2	0.49%
謓	3991		17	2	0.0003014%	662277	99.89%	2	0.49%
謳	3992		18	2	0.0003014%	662279	99.90%	2	0.49%
貳	3993		12	2	0.0003014%	662281	99.90%	2	0.49%
貽	3994		12	2	0.0003014%	662283	99.90%	2	0.49%
賃	3995		13	2	0.0003014%	662285	99.90%	2	0.49%
賸	3996		17	2	0.0003014%	662287	99.90%	2	0.49%
贖	3997		22	2	0.0003014%	662289	99.90%	2	0.49%
赭	3998		15	2	0.0003014%	662291	99.90%	2	0.49%
趿	3999		11	2	0.0003014%	662293	99.90%	2	0.49%
跋	4000		12	2	0.0003014%	662295	99.90%	2	0.49%
踝	4001		15	2	0.0003014%	662297	99.90%	2	0.49%
踟	4002		15	2	0.0003014%	662299	99.90%	2	0.49%
踴	4003		16	2	0.0003014%	662301	99.90%	2	0.49%
蹩	4005		18	2	0.0003014%	662303	99.90%	2	0.49%
躂	4006		20	2	0.0003014%	662305	99.90%	2	0.49%
躕	4007		22	2	0.0003014%	662307	99.90%	2	0.49%
輻	4008		16	2	0.0003014%	662309	99.90%	2	0.49%
迥	4009		8	2	0.0003014%	662311	99.90%	2	0.49%
遽	4010		16	2	0.0003014%	662313	99.90%	2	0.49%
邵	4011		7	2	0.0003014%	662315	99.90%	2	0.49%
酡	4013		12	2	0.0003014%	662317	99.90%	2	0.49%
酵	4014		14	2	0.0003014%	662319	99.90%	2	0.49%
釵	4015		11	2	0.0003014%	662321	99.90%	2	0.49%
鈞	4016		12	2	0.0003014%	662323	99.90%	2	0.49%
鏞	4017		19	2	0.0003014%	662325	99.90%	2	0.49%
鑰	4019		25	2	0.0003014%	662327	99.90%	2	0.49%
閥	4021		14	2	0.0003014%	662329	99.90%	2	0.49%
阡	4023		5	2	0.0003014%	662331	99.90%	2	0.49%
陡	4024		9	2	0.0003014%	662333	99.90%	2	0.49%
霑	4025		16	2	0.0003014%	662335	99.91%	2	0.49%
靴	4027		13	2	0.0003014%	662337	99.91%	2	0.49%
鞠	4028		17	2	0.0003014%	662339	99.91%	2	0.49%
顎	4029		18	2	0.0003014%	662341	99.91%	2	0.49%
餃	4030		14	2	0.0003014%	662343	99.91%	2	0.49%
饉	4032		19	2	0.0003014%	662345	99.91%	2	0.49%
饞	4033		25	2	0.0003014%	662347	99.91%	2	0.49%
騁	4034		17	2	0.0003014%	662349	99.91%	2	0.49%
驛	4035		23	2	0.0003014%	662351	99.91%	2	0.49%
骰	4036		14	2	0.0003014%	662353	99.91%	2	0.49%
髻	4037		16	2	0.0003014%	662355	99.91%	2	0.49%
鬃	4038		18	2	0.0003014%	662357	99.91%	2	0.49%
魁	4039		14	2	0.0003014%	662359	99.91%	2	0.49%
鯽	4041		18	2	0.0003014%	662361	99.91%	2	0.49%
鵑	4043		18	2	0.0003014%	662363	99.91%	2	0.49%
鸞	4046		30	2	0.0003014%	662365	99.91%	2	0.49%
鹼	4047		24	2	0.0003014%	662367	99.91%	2	0.49%
麓	4048		19	2	0.0003014%	662369	99.91%	2	0.49%
鎢	2094		18	22	0.003316%	662391	97.65%	1	0.24%
鈸	2127		13	21	0.003165%	662412	97.76%	1	0.24%
迦	2162		8	20	0.003014%	662432	97.86%	1	0.24%
杷	2264		8	17	0.002562%	662449	98.14%	1	0.24%
滬	2308		14	16	0.002412%	662465	98.25%	1	0.24%
賂	2432		13	14	0.00211%	662479	98.53%	1	0.24%
灕	2460		22	13	0.001959%	662492	98.59%	1	0.24%
熔	2461		14	13	0.001959%	662505	98.59%	1	0.24%
囡	2493		6	12	0.001809%	662517	98.65%	1	0.24%
垛	2713		9	9	0.001357%	662526	99.01%	1	0.24%
猢	2748		12	9	0.001357%	662535	99.06%	1	0.24%
猻	2750		13	9	0.001357%	662544	99.06%	1	0.24%
柿	2831		9	8	0.001206%	662552	99.16%	1	0.24%
瑋	2844		13	8	0.001206%	662560	99.18%	1	0.24%
謨	2867		18	8	0.001206%	662568	99.21%	1	0.24%
鄺	2873		17	8	0.001206%	662576	99.21%	1	0.24%
鐲	2999		21	7	0.001055%	662583	99.35%	1	0.24%
壬	3032		4	6	0.0009043%	662589	99.38%	1	0.24%
濂	3082		16	6	0.0009043%	662595	99.42%	1	0.24%
瑾	3090		15	6	0.0009043%	662601	99.43%	1	0.24%
蒨	3109		14	6	0.0009043%	662607	99.45%	1	0.24%
氘	3201		6	5	0.0007536%	662612	99.52%	1	0.24%
筏	3233		12	5	0.0007536%	662617	99.55%	1	0.24%
芃	3248		7	5	0.0007536%	662622	99.56%	1	0.24%
蜃	3255		13	5	0.0007536%	662627	99.56%	1	0.24%
螫	3260		17	5	0.0007536%	662632	99.57%	1	0.24%
酪	3277		13	5	0.0007536%	662637	99.58%	1	0.24%
隈	3281		11	5	0.0007536%	662642	99.58%	1	0.24%
侖	3295		8	4	0.0006029%	662646	99.59%	1	0.24%
啷	3314		12	4	0.0006029%	662650	99.60%	1	0.24%
孃	3328		20	4	0.0006029%	662654	99.61%	1	0.24%
纜	3413		27	4	0.0006029%	662658	99.66%	1	0.24%
袓	3434		10	4	0.0006029%	662662	99.68%	1	0.24%
訟	3438		11	4	0.0006029%	662666	99.68%	1	0.24%
鋰	3462		15	4	0.0006029%	662670	99.69%	1	0.24%
閩	3466		14	4	0.0006029%	662674	99.70%	1	0.24%
骼	3475		16	4	0.0006029%	662678	99.70%	1	0.24%
妃	3520		6	3	0.0004522%	662681	99.72%	1	0.24%
彝	3537		18	3	0.0004522%	662684	99.73%	1	0.24%
戌	3547		6	3	0.0004522%	662687	99.73%	1	0.24%
曦	3559		20	3	0.0004522%	662690	99.74%	1	0.24%
栓	3561		10	3	0.0004522%	662693	99.74%	1	0.24%
殛	3565		13	3	0.0004522%	662696	99.74%	1	0.24%
殤	3566		15	3	0.0004522%	662699	99.74%	1	0.24%
瑂	3591		13	3	0.0004522%	662702	99.75%	1	0.24%
稟	3615		13	3	0.0004522%	662705	99.77%	1	0.24%
蜥	3664		14	3	0.0004522%	662708	99.79%	1	0.24%
譟	3675		20	3	0.0004522%	662711	99.79%	1	0.24%
靼	3704		14	3	0.0004522%	662714	99.81%	1	0.24%
韃	3705		22	3	0.0004522%	662717	99.81%	1	0.24%
鰭	3715		21	3	0.0004522%	662720	99.81%	1	0.24%
丞	3722		6	2	0.0003014%	662722	99.81%	1	0.24%
俚	3724		9	2	0.0003014%	662724	99.81%	1	0.24%
冉	3729		5	2	0.0003014%	662726	99.82%	1	0.24%
呶	3737		8	2	0.0003014%	662728	99.82%	1	0.24%
唬	3742		11	2	0.0003014%	662730	99.82%	1	0.24%
啁	3743		11	2	0.0003014%	662732	99.82%	1	0.24%
喙	3745		12	2	0.0003014%	662734	99.82%	1	0.24%
嗆	3749		13	2	0.0003014%	662736	99.82%	1	0.24%
嗒	3750		13	2	0.0003014%	662738	99.82%	1	0.24%
噎	3751		15	2	0.0003014%	662740	99.82%	1	0.24%
噠	3754		16	2	0.0003014%	662742	99.82%	1	0.24%
壆	3759		16	2	0.0003014%	662744	99.83%	1	0.24%
姍	3763		8	2	0.0003014%	662746	99.83%	1	0.24%
姥	3766		9	2	0.0003014%	662748	99.83%	1	0.24%
婢	3769		11	2	0.0003014%	662750	99.83%	1	0.24%
嫋	3771		13	2	0.0003014%	662752	99.83%	1	0.24%
嬝	3772		16	2	0.0003014%	662754	99.83%	1	0.24%
嬤	3773		17	2	0.0003014%	662756	99.83%	1	0.24%
岱	3780		8	2	0.0003014%	662758	99.83%	1	0.24%
崑	3782		11	2	0.0003014%	662760	99.83%	1	0.24%
怏	3790		8	2	0.0003014%	662762	99.83%	1	0.24%
怦	3792		8	2	0.0003014%	662764	99.83%	1	0.24%
愍	3797		13	2	0.0003014%	662766	99.84%	1	0.24%
懨	3800		17	2	0.0003014%	662768	99.84%	1	0.24%
戊	3802		5	2	0.0003014%	662770	99.84%	1	0.24%
抿	3805		8	2	0.0003014%	662772	99.84%	1	0.24%
拷	3807		9	2	0.0003014%	662774	99.84%	1	0.24%
攘	3820		20	2	0.0003014%	662776	99.84%	1	0.24%
攣	3822		23	2	0.0003014%	662778	99.84%	1	0.24%
旭	3827		6	2	0.0003014%	662780	99.85%	1	0.24%
昵	3829		9	2	0.0003014%	662782	99.85%	1	0.24%
柵	3835		9	2	0.0003014%	662784	99.85%	1	0.24%
梆	3840		11	2	0.0003014%	662786	99.85%	1	0.24%
棱	3843		12	2	0.0003014%	662788	99.85%	1	0.24%
殞	3853		14	2	0.0003014%	662790	99.85%	1	0.24%
氤	3856		10	2	0.0003014%	662792	99.85%	1	0.24%
氳	3857		14	2	0.0003014%	662794	99.85%	1	0.24%
沽	3862		8	2	0.0003014%	662796	99.86%	1	0.24%
潭	3874		15	2	0.0003014%	662798	99.86%	1	0.24%
澇	3876		15	2	0.0003014%	662800	99.86%	1	0.24%
澍	3877		15	2	0.0003014%	662802	99.86%	1	0.24%
煸	3886		13	2	0.0003014%	662804	99.86%	1	0.24%
熠	3887		15	2	0.0003014%	662806	99.86%	1	0.24%
狒	3893		8	2	0.0003014%	662808	99.87%	1	0.24%
玖	3900		7	2	0.0003014%	662810	99.87%	1	0.24%
琛	3904		12	2	0.0003014%	662812	99.87%	1	0.24%
琦	3905		12	2	0.0003014%	662814	99.87%	1	0.24%
痙	3912		12	2	0.0003014%	662816	99.87%	1	0.24%
瘖	3916		14	2	0.0003014%	662818	99.87%	1	0.24%
癸	3918		9	2	0.0003014%	662820	99.87%	1	0.24%
睏	3919		12	2	0.0003014%	662822	99.87%	1	0.24%
砦	3923		11	2	0.0003014%	662824	99.87%	1	0.24%
硅	3924		11	2	0.0003014%	662826	99.87%	1	0.24%
絢	3938		12	2	0.0003014%	662828	99.88%	1	0.24%
綏	3940		13	2	0.0003014%	662830	99.88%	1	0.24%
舔	3949		14	2	0.0003014%	662832	99.88%	1	0.24%
舷	3950		11	2	0.0003014%	662834	99.88%	1	0.24%
芥	3953		8	2	0.0003014%	662836	99.88%	1	0.24%
莘	3956		11	2	0.0003014%	662838	99.88%	1	0.24%
藐	3960		18	2	0.0003014%	662840	99.89%	1	0.24%
蘑	3961		20	2	0.0003014%	662842	99.89%	1	0.24%
蜴	3963		14	2	0.0003014%	662844	99.89%	1	0.24%
蜮	3965		14	2	0.0003014%	662846	99.89%	1	0.24%
蝸	3967		15	2	0.0003014%	662848	99.89%	1	0.24%
蠔	3970		20	2	0.0003014%	662850	99.89%	1	0.24%
諉	3984		15	2	0.0003014%	662852	99.89%	1	0.24%
諛	3985		15	2	0.0003014%	662854	99.89%	1	0.24%
諳	3987		16	2	0.0003014%	662856	99.89%	1	0.24%
諶	3988		16	2	0.0003014%	662858	99.89%	1	0.24%
踽	4004		16	2	0.0003014%	662860	99.90%	1	0.24%
酉	4012		7	2	0.0003014%	662862	99.90%	1	0.24%
鏦	4018		19	2	0.0003014%	662864	99.90%	1	0.24%
閔	4020		12	2	0.0003014%	662866	99.90%	1	0.24%
闋	4022		17	2	0.0003014%	662868	99.90%	1	0.24%
霏	4026		16	2	0.0003014%	662870	99.91%	1	0.24%
饅	4031		19	2	0.0003014%	662872	99.91%	1	0.24%
魘	4040		24	2	0.0003014%	662874	99.91%	1	0.24%
鱷	4042		27	2	0.0003014%	662876	99.91%	1	0.24%
鵰	4044		19	2	0.0003014%	662878	99.91%	1	0.24%
鸕	4045		27	2	0.0003014%	662880	99.91%	1	0.24%
龔	4049		22	2	0.0003014%	662882	99.91%	1	0.24%
万	4050		3	1	0.0001507%	662883	99.91%	1	0.24%
丌	4051		3	1	0.0001507%	662884	99.91%	1	0.24%
丐	4052		4	1	0.0001507%	662885	99.91%	1	0.24%
丰	4053		4	1	0.0001507%	662886	99.91%	1	0.24%
亍	4054		3	1	0.0001507%	662887	99.91%	1	0.24%
仞	4055		5	1	0.0001507%	662888	99.91%	1	0.24%
伽	4056		7	1	0.0001507%	662889	99.91%	1	0.24%
佝	4057		7	1	0.0001507%	662890	99.91%	1	0.24%
佚	4058		7	1	0.0001507%	662891	99.91%	1	0.24%
佰	4059		8	1	0.0001507%	662892	99.91%	1	0.24%
侏	4060		8	1	0.0001507%	662893	99.91%	1	0.24%
侄	4061		8	1	0.0001507%	662894	99.91%	1	0.24%
佷	4062		8	1	0.0001507%	662895	99.91%	1	0.24%
侚	4063		8	1	0.0001507%	662896	99.91%	1	0.24%
俘	4064		9	1	0.0001507%	662897	99.91%	1	0.24%
倥	4065		10	1	0.0001507%	662898	99.91%	1	0.24%
偃	4066		11	1	0.0001507%	662899	99.91%	1	0.24%
偑	4067		11	1	0.0001507%	662900	99.92%	1	0.24%
傀	4068		12	1	0.0001507%	662901	99.92%	1	0.24%
傖	4069		12	1	0.0001507%	662902	99.92%	1	0.24%
傯	4070		13	1	0.0001507%	662903	99.92%	1	0.24%
儈	4071		15	1	0.0001507%	662904	99.92%	1	0.24%
儔	4072		16	1	0.0001507%	662905	99.92%	1	0.24%
儡	4073		17	1	0.0001507%	662906	99.92%	1	0.24%
儸	4074		21	1	0.0001507%	662907	99.92%	1	0.24%
冕	4075		11	1	0.0001507%	662908	99.92%	1	0.24%
刁	4076		2	1	0.0001507%	662909	99.92%	1	0.24%
劊	4077		15	1	0.0001507%	662910	99.92%	1	0.24%
勘	4078		11	1	0.0001507%	662911	99.92%	1	0.24%
勰	4079		15	1	0.0001507%	662912	99.92%	1	0.24%
匝	4080		5	1	0.0001507%	662913	99.92%	1	0.24%
卌	4081		5	1	0.0001507%	662914	99.92%	1	0.24%
卹	4082		8	1	0.0001507%	662915	99.92%	1	0.24%
叭	4083		5	1	0.0001507%	662916	99.92%	1	0.24%
吏	4084		6	1	0.0001507%	662917	99.92%	1	0.24%
吆	4085		6	1	0.0001507%	662918	99.92%	1	0.24%
咆	4086		8	1	0.0001507%	662919	99.92%	1	0.24%
呦	4087		8	1	0.0001507%	662920	99.92%	1	0.24%
哂	4088		9	1	0.0001507%	662921	99.92%	1	0.24%
咫	4089		9	1	0.0001507%	662922	99.92%	1	0.24%
哆	4090		9	1	0.0001507%	662923	99.92%	1	0.24%
呲	4091		9	1	0.0001507%	662924	99.92%	1	0.24%
哨	4092		10	1	0.0001507%	662925	99.92%	1	0.24%
啖	4093		11	1	0.0001507%	662926	99.92%	1	0.24%
啵	4094		11	1	0.0001507%	662927	99.92%	1	0.24%
啋	4095		11	1	0.0001507%	662928	99.92%	1	0.24%
啻	4096		12	1	0.0001507%	662929	99.92%	1	0.24%
喟	4097		12	1	0.0001507%	662930	99.92%	1	0.24%
喑	4098		12	1	0.0001507%	662931	99.92%	1	0.24%
嗣	4099		13	1	0.0001507%	662932	99.92%	1	0.24%
嗥	4100		13	1	0.0001507%	662933	99.92%	1	0.24%
嗐	4101		13	1	0.0001507%	662934	99.92%	1	0.24%
嘀	4102		14	1	0.0001507%	662935	99.92%	1	0.24%
嘜	4103		14	1	0.0001507%	662936	99.92%	1	0.24%
嘯	4104		15	1	0.0001507%	662937	99.92%	1	0.24%
噯	4105		16	1	0.0001507%	662938	99.92%	1	0.24%
噬	4106		16	1	0.0001507%	662939	99.92%	1	0.24%
嚅	4107		17	1	0.0001507%	662940	99.92%	1	0.24%
嚓	4108		17	1	0.0001507%	662941	99.92%	1	0.24%
嚙	4109		18	1	0.0001507%	662942	99.92%	1	0.24%
嚥	4110		19	1	0.0001507%	662943	99.92%	1	0.24%
囁	4111		21	1	0.0001507%	662944	99.92%	1	0.24%
囈	4112		22	1	0.0001507%	662945	99.92%	1	0.24%
囌	4113		23	1	0.0001507%	662946	99.92%	1	0.24%
囔	4114		25	1	0.0001507%	662947	99.92%	1	0.24%
囤	4115		7	1	0.0001507%	662948	99.92%	1	0.24%
坏	4116		7	1	0.0001507%	662949	99.92%	1	0.24%
坭	4117		8	1	0.0001507%	662950	99.92%	1	0.24%
坳	4118		8	1	0.0001507%	662951	99.92%	1	0.24%
垠	4119		9	1	0.0001507%	662952	99.92%	1	0.24%
	4120		10	1	0.0001507%	662953	99.92%	1	0.24%
堯	4121		12	1	0.0001507%	662954	99.92%	1	0.24%
塢	4122		13	1	0.0001507%	662955	99.92%	1	0.24%
墬	4123		15	1	0.0001507%	662956	99.92%	1	0.24%
墾	4124		16	1	0.0001507%	662957	99.92%	1	0.24%
夙	4125		6	1	0.0001507%	662958	99.92%	1	0.24%
夤	4126		14	1	0.0001507%	662959	99.92%	1	0.24%
夸	4127		6	1	0.0001507%	662960	99.92%	1	0.24%
妤	4128		7	1	0.0001507%	662961	99.92%	1	0.24%
姝	4129		9	1	0.0001507%	662962	99.92%	1	0.24%
娙	4130		10	1	0.0001507%	662963	99.92%	1	0.24%
媛	4131		12	1	0.0001507%	662964	99.92%	1	0.24%
媧	4132		12	1	0.0001507%	662965	99.92%	1	0.24%
媾	4133		13	1	0.0001507%	662966	99.93%	1	0.24%
嬈	4134		15	1	0.0001507%	662967	99.93%	1	0.24%
嬗	4135		16	1	0.0001507%	662968	99.93%	1	0.24%
嬲	4136		17	1	0.0001507%	662969	99.93%	1	0.24%
孖	4137		6	1	0.0001507%	662970	99.93%	1	0.24%
孚	4138		7	1	0.0001507%	662971	99.93%	1	0.24%
孱	4139		12	1	0.0001507%	662972	99.93%	1	0.24%
孺	4140		17	1	0.0001507%	662973	99.93%	1	0.24%
孿	4141		22	1	0.0001507%	662974	99.93%	1	0.24%
宥	4142		9	1	0.0001507%	662975	99.93%	1	0.24%
寖	4143		13	1	0.0001507%	662976	99.93%	1	0.24%
尃	4144		10	1	0.0001507%	662977	99.93%	1	0.24%
尢	4145		3	1	0.0001507%	662978	99.93%	1	0.24%
尸	4146		3	1	0.0001507%	662979	99.93%	1	0.24%
尹	4147		4	1	0.0001507%	662980	99.93%	1	0.24%
屐	4148		10	1	0.0001507%	662981	99.93%	1	0.24%
屨	4149		17	1	0.0001507%	662982	99.93%	1	0.24%
岡	4150		8	1	0.0001507%	662983	99.93%	1	0.24%
岫	4151		8	1	0.0001507%	662984	99.93%	1	0.24%
峋	4152		9	1	0.0001507%	662985	99.93%	1	0.24%
峨	4153		10	1	0.0001507%	662986	99.93%	1	0.24%
崠	4154		11	1	0.0001507%	662987	99.93%	1	0.24%
崍	4155		11	1	0.0001507%	662988	99.93%	1	0.24%
嵇	4156		12	1	0.0001507%	662989	99.93%	1	0.24%
嶙	4157		15	1	0.0001507%	662990	99.93%	1	0.24%
嶗	4158		15	1	0.0001507%	662991	99.93%	1	0.24%
巉	4159		20	1	0.0001507%	662992	99.93%	1	0.24%
巽	4160		12	1	0.0001507%	662993	99.93%	1	0.24%
帘	4161		8	1	0.0001507%	662994	99.93%	1	0.24%
帑	4162		8	1	0.0001507%	662995	99.93%	1	0.24%
幃	4163		12	1	0.0001507%	662996	99.93%	1	0.24%
幡	4164		15	1	0.0001507%	662997	99.93%	1	0.24%
庄	4165		6	1	0.0001507%	662998	99.93%	1	0.24%
庵	4166		11	1	0.0001507%	662999	99.93%	1	0.24%
廘	4167		14	1	0.0001507%	663000	99.93%	1	0.24%
廛	4168		15	1	0.0001507%	663001	99.93%	1	0.24%
弋	4169		3	1	0.0001507%	663002	99.93%	1	0.24%
弭	4170		9	1	0.0001507%	663003	99.93%	1	0.24%
彆	4171		14	1	0.0001507%	663004	99.93%	1	0.24%
彳	4172		3	1	0.0001507%	663005	99.93%	1	0.24%
徇	4173		9	1	0.0001507%	663006	99.93%	1	0.24%
徠	4174		11	1	0.0001507%	663007	99.93%	1	0.24%
忸	4175		7	1	0.0001507%	663008	99.93%	1	0.24%
忪	4176		7	1	0.0001507%	663009	99.93%	1	0.24%
忐	4177		7	1	0.0001507%	663010	99.93%	1	0.24%
忡	4178		7	1	0.0001507%	663011	99.93%	1	0.24%
忝	4179		8	1	0.0001507%	663012	99.93%	1	0.24%
恪	4180		9	1	0.0001507%	663013	99.93%	1	0.24%
悖	4181		10	1	0.0001507%	663014	99.93%	1	0.24%
惴	4182		12	1	0.0001507%	663015	99.93%	1	0.24%
慍	4183		13	1	0.0001507%	663016	99.93%	1	0.24%
愷	4184		13	1	0.0001507%	663017	99.93%	1	0.24%
愫	4185		13	1	0.0001507%	663018	99.93%	1	0.24%
慇	4186		14	1	0.0001507%	663019	99.93%	1	0.24%
慟	4187		14	1	0.0001507%	663020	99.93%	1	0.24%
憚	4188		15	1	0.0001507%	663021	99.93%	1	0.24%
懋	4189		17	1	0.0001507%	663022	99.93%	1	0.24%
懃	4190		17	1	0.0001507%	663023	99.93%	1	0.24%
懣	4191		18	1	0.0001507%	663024	99.93%	1	0.24%
懺	4192		20	1	0.0001507%	663025	99.93%	1	0.24%
戇	4193		28	1	0.0001507%	663026	99.93%	1	0.24%
戎	4194		6	1	0.0001507%	663027	99.93%	1	0.24%
戍	4195		6	1	0.0001507%	663028	99.93%	1	0.24%
戛	4196		11	1	0.0001507%	663029	99.93%	1	0.24%
戡	4197		13	1	0.0001507%	663030	99.93%	1	0.24%
戥	4198		13	1	0.0001507%	663031	99.93%	1	0.24%
扛	4199		6	1	0.0001507%	663032	99.94%	1	0.24%
扺	4200		7	1	0.0001507%	663033	99.94%	1	0.24%
拮	4201		9	1	0.0001507%	663034	99.94%	1	0.24%
拴	4202		9	1	0.0001507%	663035	99.94%	1	0.24%
挈	4203		10	1	0.0001507%	663036	99.94%	1	0.24%
捫	4204		11	1	0.0001507%	663037	99.94%	1	0.24%
掄	4205		11	1	0.0001507%	663038	99.94%	1	0.24%
捩	4206		11	1	0.0001507%	663039	99.94%	1	0.24%
据	4207		11	1	0.0001507%	663040	99.94%	1	0.24%
揆	4208		12	1	0.0001507%	663041	99.94%	1	0.24%
揪	4209		12	1	0.0001507%	663042	99.94%	1	0.24%
揎	4210		12	1	0.0001507%	663043	99.94%	1	0.24%
揶	4211		12	1	0.0001507%	663044	99.94%	1	0.24%
揄	4212		12	1	0.0001507%	663045	99.94%	1	0.24%
搆	4213		13	1	0.0001507%	663046	99.94%	1	0.24%
搯	4214		13	1	0.0001507%	663047	99.94%	1	0.24%
搡	4215		13	1	0.0001507%	663048	99.94%	1	0.24%
摻	4216		14	1	0.0001507%	663049	99.94%	1	0.24%
撘	4217		15	1	0.0001507%	663050	99.94%	1	0.24%
擂	4218		16	1	0.0001507%	663051	99.94%	1	0.24%
擒	4219		16	1	0.0001507%	663052	99.94%	1	0.24%
擢	4220		17	1	0.0001507%	663053	99.94%	1	0.24%
擤	4221		17	1	0.0001507%	663054	99.94%	1	0.24%
擻	4222		18	1	0.0001507%	663055	99.94%	1	0.24%
敊	4223		10	1	0.0001507%	663056	99.94%	1	0.24%
敻	4224		15	1	0.0001507%	663057	99.94%	1	0.24%
斛	4225		11	1	0.0001507%	663058	99.94%	1	0.24%
昊	4226		8	1	0.0001507%	663059	99.94%	1	0.24%
昃	4227		8	1	0.0001507%	663060	99.94%	1	0.24%
晁	4228		10	1	0.0001507%	663061	99.94%	1	0.24%
晢	4229		11	1	0.0001507%	663062	99.94%	1	0.24%
晾	4230		12	1	0.0001507%	663063	99.94%	1	0.24%
暹	4231		16	1	0.0001507%	663064	99.94%	1	0.24%
曚	4232		18	1	0.0001507%	663065	99.94%	1	0.24%
朴	4233		6	1	0.0001507%	663066	99.94%	1	0.24%
朿	4234		6	1	0.0001507%	663067	99.94%	1	0.24%
杰	4235		8	1	0.0001507%	663068	99.94%	1	0.24%
枒	4236		8	1	0.0001507%	663069	99.94%	1	0.24%
柚	4237		9	1	0.0001507%	663070	99.94%	1	0.24%
枸	4238		9	1	0.0001507%	663071	99.94%	1	0.24%
柙	4239		9	1	0.0001507%	663072	99.94%	1	0.24%
	4240		10	1	0.0001507%	663073	99.94%	1	0.24%
梓	4241		11	1	0.0001507%	663074	99.94%	1	0.24%
梱	4242		11	1	0.0001507%	663075	99.94%	1	0.24%
棣	4243		12	1	0.0001507%	663076	99.94%	1	0.24%
椎	4244		12	1	0.0001507%	663077	99.94%	1	0.24%
棎	4245		12	1	0.0001507%	663078	99.94%	1	0.24%
榆	4246		13	1	0.0001507%	663079	99.94%	1	0.24%
楝	4247		13	1	0.0001507%	663080	99.94%	1	0.24%
楣	4248		13	1	0.0001507%	663081	99.94%	1	0.24%
椽	4249		13	1	0.0001507%	663082	99.94%	1	0.24%
楜	4250		13	1	0.0001507%	663083	99.94%	1	0.24%
槁	4251		14	1	0.0001507%	663084	99.94%	1	0.24%
槓	4252		14	1	0.0001507%	663085	99.94%	1	0.24%
榭	4253		14	1	0.0001507%	663086	99.94%	1	0.24%
槌	4254		14	1	0.0001507%	663087	99.94%	1	0.24%
樊	4255		15	1	0.0001507%	663088	99.94%	1	0.24%
槭	4256		15	1	0.0001507%	663089	99.94%	1	0.24%
槤	4257		15	1	0.0001507%	663090	99.94%	1	0.24%
樨	4258		16	1	0.0001507%	663091	99.94%	1	0.24%
櫚	4259		19	1	0.0001507%	663092	99.94%	1	0.24%
欸	4260		11	1	0.0001507%	663093	99.94%	1	0.24%
欹	4261		12	1	0.0001507%	663094	99.94%	1	0.24%
殍	4262		11	1	0.0001507%	663095	99.94%	1	0.24%
殮	4263		17	1	0.0001507%	663096	99.94%	1	0.24%
毌	4264		4	1	0.0001507%	663097	99.94%	1	0.24%
毗	4265		9	1	0.0001507%	663098	99.94%	1	0.24%
毽	4266		13	1	0.0001507%	663099	99.95%	1	0.24%
氟	4267		9	1	0.0001507%	663100	99.95%	1	0.24%
氯	4268		12	1	0.0001507%	663101	99.95%	1	0.24%
氾	4269		5	1	0.0001507%	663102	99.95%	1	0.24%
汕	4270		6	1	0.0001507%	663103	99.95%	1	0.24%
泓	4271		8	1	0.0001507%	663104	99.95%	1	0.24%
泗	4272		8	1	0.0001507%	663105	99.95%	1	0.24%
泱	4273		8	1	0.0001507%	663106	99.95%	1	0.24%
沓	4274		8	1	0.0001507%	663107	99.95%	1	0.24%
泫	4275		8	1	0.0001507%	663108	99.95%	1	0.24%
泮	4276		8	1	0.0001507%	663109	99.95%	1	0.24%
涇	4277		10	1	0.0001507%	663110	99.95%	1	0.24%
浬	4278		10	1	0.0001507%	663111	99.95%	1	0.24%
浹	4279		10	1	0.0001507%	663112	99.95%	1	0.24%
涅	4280		10	1	0.0001507%	663113	99.95%	1	0.24%
浣	4281		10	1	0.0001507%	663114	99.95%	1	0.24%
涮	4282		11	1	0.0001507%	663115	99.95%	1	0.24%
淅	4283		11	1	0.0001507%	663116	99.95%	1	0.24%
渚	4284		11	1	0.0001507%	663117	99.95%	1	0.24%
淦	4285		11	1	0.0001507%	663118	99.95%	1	0.24%
淏	4286		11	1	0.0001507%	663119	99.95%	1	0.24%
渝	4287		12	1	0.0001507%	663120	99.95%	1	0.24%
渙	4288		12	1	0.0001507%	663121	99.95%	1	0.24%
湎	4289		12	1	0.0001507%	663122	99.95%	1	0.24%
湄	4290		12	1	0.0001507%	663123	99.95%	1	0.24%
湟	4291		12	1	0.0001507%	663124	99.95%	1	0.24%
滓	4292		13	1	0.0001507%	663125	99.95%	1	0.24%
溴	4293		13	1	0.0001507%	663126	99.95%	1	0.24%
溽	4294		13	1	0.0001507%	663127	99.95%	1	0.24%
溷	4295		13	1	0.0001507%	663128	99.95%	1	0.24%
漉	4296		14	1	0.0001507%	663129	99.95%	1	0.24%
漶	4297		14	1	0.0001507%	663130	99.95%	1	0.24%
潸	4298		15	1	0.0001507%	663131	99.95%	1	0.24%
澎	4299		15	1	0.0001507%	663132	99.95%	1	0.24%
潢	4300		15	1	0.0001507%	663133	99.95%	1	0.24%
澹	4301		16	1	0.0001507%	663134	99.95%	1	0.24%
濯	4302		17	1	0.0001507%	663135	99.95%	1	0.24%
灝	4303		24	1	0.0001507%	663136	99.95%	1	0.24%
炬	4304		9	1	0.0001507%	663137	99.95%	1	0.24%
烊	4305		10	1	0.0001507%	663138	99.95%	1	0.24%
烋	4306		10	1	0.0001507%	663139	99.95%	1	0.24%
焙	4307		12	1	0.0001507%	663140	99.95%	1	0.24%
焯	4308		12	1	0.0001507%	663141	99.95%	1	0.24%
煬	4309		13	1	0.0001507%	663142	99.95%	1	0.24%
煖	4310		13	1	0.0001507%	663143	99.95%	1	0.24%
煇	4311		13	1	0.0001507%	663144	99.95%	1	0.24%
熏	4312		14	1	0.0001507%	663145	99.95%	1	0.24%
燁	4313		16	1	0.0001507%	663146	99.95%	1	0.24%
牘	4314		19	1	0.0001507%	663147	99.95%	1	0.24%
牴	4315		9	1	0.0001507%	663148	99.95%	1	0.24%
猙	4316		11	1	0.0001507%	663149	99.95%	1	0.24%
猩	4317		12	1	0.0001507%	663150	99.95%	1	0.24%
猷	4318		13	1	0.0001507%	663151	99.95%	1	0.24%
獰	4319		17	1	0.0001507%	663152	99.95%	1	0.24%
玒	4320		7	1	0.0001507%	663153	99.95%	1	0.24%
玷	4321		9	1	0.0001507%	663154	99.95%	1	0.24%
玳	4322		9	1	0.0001507%	663155	99.95%	1	0.24%
琺	4323		12	1	0.0001507%	663156	99.95%	1	0.24%
琬	4324		12	1	0.0001507%	663157	99.95%	1	0.24%
琤	4325		12	1	0.0001507%	663158	99.95%	1	0.24%
瑕	4326		13	1	0.0001507%	663159	99.95%	1	0.24%
瑁	4327		13	1	0.0001507%	663160	99.95%	1	0.24%
瑛	4328		13	1	0.0001507%	663161	99.95%	1	0.24%
璜	4329		16	1	0.0001507%	663162	99.95%	1	0.24%
璫	4330		17	1	0.0001507%	663163	99.95%	1	0.24%
璿	4331		18	1	0.0001507%	663164	99.95%	1	0.24%
瓢	4332		16	1	0.0001507%	663165	99.96%	1	0.24%
瓴	4333		10	1	0.0001507%	663166	99.96%	1	0.24%
甕	4334		18	1	0.0001507%	663167	99.96%	1	0.24%
甬	4335		7	1	0.0001507%	663168	99.96%	1	0.24%
畸	4336		13	1	0.0001507%	663169	99.96%	1	0.24%
疋	4337		5	1	0.0001507%	663170	99.96%	1	0.24%
疪	4338		9	1	0.0001507%	663171	99.96%	1	0.24%
痊	4339		11	1	0.0001507%	663172	99.96%	1	0.24%
痣	4340		12	1	0.0001507%	663173	99.96%	1	0.24%
痞	4341		12	1	0.0001507%	663174	99.96%	1	0.24%
痱	4342		13	1	0.0001507%	663175	99.96%	1	0.24%
痳	4343		13	1	0.0001507%	663176	99.96%	1	0.24%
瘴	4344		16	1	0.0001507%	663177	99.96%	1	0.24%
瘸	4345		16	1	0.0001507%	663178	99.96%	1	0.24%
癬	4346		22	1	0.0001507%	663179	99.96%	1	0.24%
皖	4347		12	1	0.0001507%	663180	99.96%	1	0.24%
皚	4348		15	1	0.0001507%	663181	99.96%	1	0.24%
盂	4349		8	1	0.0001507%	663182	99.96%	1	0.24%
盥	4350		16	1	0.0001507%	663183	99.96%	1	0.24%
盱	4351		8	1	0.0001507%	663184	99.96%	1	0.24%
盹	4352		9	1	0.0001507%	663185	99.96%	1	0.24%
眛	4353		10	1	0.0001507%	663186	99.96%	1	0.24%
睥	4354		13	1	0.0001507%	663187	99.96%	1	0.24%
瞅	4355		14	1	0.0001507%	663188	99.96%	1	0.24%
瞋	4356		15	1	0.0001507%	663189	99.96%	1	0.24%
瞣	4357		16	1	0.0001507%	663190	99.96%	1	0.24%
瞳	4358		17	1	0.0001507%	663191	99.96%	1	0.24%
砭	4359		10	1	0.0001507%	663192	99.96%	1	0.24%
砣	4360		10	1	0.0001507%	663193	99.96%	1	0.24%
碾	4361		15	1	0.0001507%	663194	99.96%	1	0.24%
祕	4362		9	1	0.0001507%	663195	99.96%	1	0.24%
祠	4363		9	1	0.0001507%	663196	99.96%	1	0.24%
祺	4364		12	1	0.0001507%	663197	99.96%	1	0.24%
祿	4365		12	1	0.0001507%	663198	99.96%	1	0.24%
禹	4366		9	1	0.0001507%	663199	99.96%	1	0.24%
秏	4367		9	1	0.0001507%	663200	99.96%	1	0.24%
秣	4368		10	1	0.0001507%	663201	99.96%	1	0.24%
秧	4369		10	1	0.0001507%	663202	99.96%	1	0.24%
稈	4370		12	1	0.0001507%	663203	99.96%	1	0.24%
穗	4371		17	1	0.0001507%	663204	99.96%	1	0.24%
穰	4372		22	1	0.0001507%	663205	99.96%	1	0.24%
穹	4373		8	1	0.0001507%	663206	99.96%	1	0.24%
窠	4374		13	1	0.0001507%	663207	99.96%	1	0.24%
窪	4375		14	1	0.0001507%	663208	99.96%	1	0.24%
窸	4376		16	1	0.0001507%	663209	99.96%	1	0.24%
竣	4377		12	1	0.0001507%	663210	99.96%	1	0.24%
竺	4378		8	1	0.0001507%	663211	99.96%	1	0.24%
筠	4379		13	1	0.0001507%	663212	99.96%	1	0.24%
筵	4380		14	1	0.0001507%	663213	99.96%	1	0.24%
箝	4381		14	1	0.0001507%	663214	99.96%	1	0.24%
箔	4382		14	1	0.0001507%	663215	99.96%	1	0.24%
箍	4383		14	1	0.0001507%	663216	99.96%	1	0.24%
箴	4384		15	1	0.0001507%	663217	99.96%	1	0.24%
篙	4385		16	1	0.0001507%	663218	99.96%	1	0.24%
篡	4386		16	1	0.0001507%	663219	99.96%	1	0.24%
篝	4387		16	1	0.0001507%	663220	99.96%	1	0.24%
簍	4388		17	1	0.0001507%	663221	99.96%	1	0.24%
簃	4389		17	1	0.0001507%	663222	99.96%	1	0.24%
簣	4390		18	1	0.0001507%	663223	99.96%	1	0.24%
籣	4391		23	1	0.0001507%	663224	99.96%	1	0.24%
糜	4392		17	1	0.0001507%	663225	99.96%	1	0.24%
糯	4393		20	1	0.0001507%	663226	99.96%	1	0.24%
紂	4394		9	1	0.0001507%	663227	99.96%	1	0.24%
紆	4395		9	1	0.0001507%	663228	99.96%	1	0.24%
紵	4396		11	1	0.0001507%	663229	99.96%	1	0.24%
綃	4397		13	1	0.0001507%	663230	99.96%	1	0.24%
綪	4398		14	1	0.0001507%	663231	99.97%	1	0.24%
綹	4399		14	1	0.0001507%	663232	99.97%	1	0.24%
緲	4400		15	1	0.0001507%	663233	99.97%	1	0.24%
縑	4401		16	1	0.0001507%	663234	99.97%	1	0.24%
縟	4402		16	1	0.0001507%	663235	99.97%	1	0.24%
纔	4403		23	1	0.0001507%	663236	99.97%	1	0.24%
罟	4404		10	1	0.0001507%	663237	99.97%	1	0.24%
羚	4405		11	1	0.0001507%	663238	99.97%	1	0.24%
翟	4406		14	1	0.0001507%	663239	99.97%	1	0.24%
翱	4407		16	1	0.0001507%	663240	99.97%	1	0.24%
耙	4408		10	1	0.0001507%	663241	99.97%	1	0.24%
聿	4409		6	1	0.0001507%	663242	99.97%	1	0.24%
肇	4410		14	1	0.0001507%	663243	99.97%	1	0.24%
胚	4411		9	1	0.0001507%	663244	99.97%	1	0.24%
胛	4412		9	1	0.0001507%	663245	99.97%	1	0.24%
脯	4413		11	1	0.0001507%	663246	99.97%	1	0.24%
腑	4414		12	1	0.0001507%	663247	99.97%	1	0.24%
腱	4415		13	1	0.0001507%	663248	99.97%	1	0.24%
腺	4416		13	1	0.0001507%	663249	99.97%	1	0.24%
膈	4417		14	1	0.0001507%	663250	99.97%	1	0.24%
膞	4418		15	1	0.0001507%	663251	99.97%	1	0.24%
臃	4419		17	1	0.0001507%	663252	99.97%	1	0.24%
膺	4420		17	1	0.0001507%	663253	99.97%	1	0.24%
臊	4421		17	1	0.0001507%	663254	99.97%	1	0.24%
臍	4422		18	1	0.0001507%	663255	99.97%	1	0.24%
臠	4423		25	1	0.0001507%	663256	99.97%	1	0.24%
臼	4424		6	1	0.0001507%	663257	99.97%	1	0.24%
舄	4425		12	1	0.0001507%	663258	99.97%	1	0.24%
舐	4426		10	1	0.0001507%	663259	99.97%	1	0.24%
舛	4427		6	1	0.0001507%	663260	99.97%	1	0.24%
舜	4428		12	1	0.0001507%	663261	99.97%	1	0.24%
舶	4429		11	1	0.0001507%	663262	99.97%	1	0.24%
芹	4430		8	1	0.0001507%	663263	99.97%	1	0.24%
芯	4431		8	1	0.0001507%	663264	99.97%	1	0.24%
芾	4432		8	1	0.0001507%	663265	99.97%	1	0.24%
苒	4433		9	1	0.0001507%	663266	99.97%	1	0.24%
苫	4434		9	1	0.0001507%	663267	99.97%	1	0.24%
芻	4435		10	1	0.0001507%	663268	99.97%	1	0.24%
荐	4436		10	1	0.0001507%	663269	99.97%	1	0.24%
茵	4437		10	1	0.0001507%	663270	99.97%	1	0.24%
荏	4438		10	1	0.0001507%	663271	99.97%	1	0.24%
荸	4439		11	1	0.0001507%	663272	99.97%	1	0.24%
莓	4440		11	1	0.0001507%	663273	99.97%	1	0.24%
荼	4441		11	1	0.0001507%	663274	99.97%	1	0.24%
菁	4442		12	1	0.0001507%	663275	99.97%	1	0.24%
菱	4443		12	1	0.0001507%	663276	99.97%	1	0.24%
菡	4444		12	1	0.0001507%	663277	99.97%	1	0.24%
萏	4445		12	1	0.0001507%	663278	99.97%	1	0.24%
萛	4446		12	1	0.0001507%	663279	99.97%	1	0.24%
葷	4447		13	1	0.0001507%	663280	99.97%	1	0.24%
葦	4448		13	1	0.0001507%	663281	99.97%	1	0.24%
葭	4449		13	1	0.0001507%	663282	99.97%	1	0.24%
葽	4450		13	1	0.0001507%	663283	99.97%	1	0.24%
葺	4451		13	1	0.0001507%	663284	99.97%	1	0.24%
萩	4452		13	1	0.0001507%	663285	99.97%	1	0.24%
蓆	4453		14	1	0.0001507%	663286	99.97%	1	0.24%
蒹	4454		14	1	0.0001507%	663287	99.97%	1	0.24%
蔻	4455		15	1	0.0001507%	663288	99.97%	1	0.24%
蕙	4456		16	1	0.0001507%	663289	99.97%	1	0.24%
蕈	4457		16	1	0.0001507%	663290	99.97%	1	0.24%
蕨	4458		16	1	0.0001507%	663291	99.97%	1	0.24%
蕃	4459		16	1	0.0001507%	663292	99.97%	1	0.24%
蕪	4460		16	1	0.0001507%	663293	99.97%	1	0.24%
蕞	4461		16	1	0.0001507%	663294	99.97%	1	0.24%
蕻	4462		17	1	0.0001507%	663295	99.97%	1	0.24%
薈	4463		17	1	0.0001507%	663296	99.97%	1	0.24%
薺	4464		18	1	0.0001507%	663297	99.97%	1	0.24%
蘚	4465		21	1	0.0001507%	663298	99.98%	1	0.24%
蘴	4466		22	1	0.0001507%	663299	99.98%	1	0.24%
虜	4467		13	1	0.0001507%	663300	99.98%	1	0.24%
虫	4468		6	1	0.0001507%	663301	99.98%	1	0.24%
	4469		7	1	0.0001507%	663302	99.98%	1	0.24%
蚋	4470		10	1	0.0001507%	663303	99.98%	1	0.24%
蛾	4471		13	1	0.0001507%	663304	99.98%	1	0.24%
蜢	4472		14	1	0.0001507%	663305	99.98%	1	0.24%
蝎	4473		15	1	0.0001507%	663306	99.98%	1	0.24%
蝟	4474		15	1	0.0001507%	663307	99.98%	1	0.24%
螃	4475		16	1	0.0001507%	663308	99.98%	1	0.24%
蟀	4476		17	1	0.0001507%	663309	99.98%	1	0.24%
螯	4477		17	1	0.0001507%	663310	99.98%	1	0.24%
袂	4478		9	1	0.0001507%	663311	99.98%	1	0.24%
袪	4479		10	1	0.0001507%	663312	99.98%	1	0.24%
袤	4480		11	1	0.0001507%	663313	99.98%	1	0.24%
裘	4481		13	1	0.0001507%	663314	99.98%	1	0.24%
褒	4482		15	1	0.0001507%	663315	99.98%	1	0.24%
褶	4483		16	1	0.0001507%	663316	99.98%	1	0.24%
褻	4484		17	1	0.0001507%	663317	99.98%	1	0.24%
襠	4485		18	1	0.0001507%	663318	99.98%	1	0.24%
襾	4486		6	1	0.0001507%	663319	99.98%	1	0.24%
覲	4487		18	1	0.0001507%	663320	99.98%	1	0.24%
觴	4488		18	1	0.0001507%	663321	99.98%	1	0.24%
訃	4489		9	1	0.0001507%	663322	99.98%	1	0.24%
訢	4490		11	1	0.0001507%	663323	99.98%	1	0.24%
詁	4491		12	1	0.0001507%	663324	99.98%	1	0.24%
詑	4492		12	1	0.0001507%	663325	99.98%	1	0.24%
詰	4493		13	1	0.0001507%	663326	99.98%	1	0.24%
誣	4494		14	1	0.0001507%	663327	99.98%	1	0.24%
誥	4495		14	1	0.0001507%	663328	99.98%	1	0.24%
誑	4496		14	1	0.0001507%	663329	99.98%	1	0.24%
諗	4497		15	1	0.0001507%	663330	99.98%	1	0.24%
諺	4498		16	1	0.0001507%	663331	99.98%	1	0.24%
諭	4499		16	1	0.0001507%	663332	99.98%	1	0.24%
諤	4500		16	1	0.0001507%	663333	99.98%	1	0.24%
謫	4501		18	1	0.0001507%	663334	99.98%	1	0.24%
謾	4502		18	1	0.0001507%	663335	99.98%	1	0.24%
譎	4503		19	1	0.0001507%	663336	99.98%	1	0.24%
讒	4504		24	1	0.0001507%	663337	99.98%	1	0.24%
豉	4505		11	1	0.0001507%	663338	99.98%	1	0.24%
貲	4506		13	1	0.0001507%	663339	99.98%	1	0.24%
賡	4507		15	1	0.0001507%	663340	99.98%	1	0.24%
贅	4508		18	1	0.0001507%	663341	99.98%	1	0.24%
贍	4509		20	1	0.0001507%	663342	99.98%	1	0.24%
贓	4510		21	1	0.0001507%	663343	99.98%	1	0.24%
赽	4511		11	1	0.0001507%	663344	99.98%	1	0.24%
趴	4512		9	1	0.0001507%	663345	99.98%	1	0.24%
趾	4513		11	1	0.0001507%	663346	99.98%	1	0.24%
跏	4514		12	1	0.0001507%	663347	99.98%	1	0.24%
跼	4515		14	1	0.0001507%	663348	99.98%	1	0.24%
蹄	4516		16	1	0.0001507%	663349	99.98%	1	0.24%
蹂	4517		16	1	0.0001507%	663350	99.98%	1	0.24%
蹓	4518		17	1	0.0001507%	663351	99.98%	1	0.24%
蹐	4519		17	1	0.0001507%	663352	99.98%	1	0.24%
蹦	4520		18	1	0.0001507%	663353	99.98%	1	0.24%
蹶	4521		19	1	0.0001507%	663354	99.98%	1	0.24%
蹴	4522		19	1	0.0001507%	663355	99.98%	1	0.24%
躅	4523		20	1	0.0001507%	663356	99.98%	1	0.24%
躑	4524		22	1	0.0001507%	663357	99.98%	1	0.24%
躡	4525		25	1	0.0001507%	663358	99.98%	1	0.24%
躪	4526		27	1	0.0001507%	663359	99.98%	1	0.24%
軔	4527		10	1	0.0001507%	663360	99.98%	1	0.24%
軼	4528		12	1	0.0001507%	663361	99.98%	1	0.24%
輓	4529		14	1	0.0001507%	663362	99.98%	1	0.24%
輟	4530		15	1	0.0001507%	663363	99.98%	1	0.24%
輞	4531		15	1	0.0001507%	663364	99.99%	1	0.24%
轅	4532		17	1	0.0001507%	663365	99.99%	1	0.24%
轆	4533		18	1	0.0001507%	663366	99.99%	1	0.24%
轎	4534		19	1	0.0001507%	663367	99.99%	1	0.24%
迓	4535		7	1	0.0001507%	663368	99.99%	1	0.24%
迕	4536		7	1	0.0001507%	663369	99.99%	1	0.24%
迺	4537		9	1	0.0001507%	663370	99.99%	1	0.24%
逅	4538		9	1	0.0001507%	663371	99.99%	1	0.24%
遄	4539		12	1	0.0001507%	663372	99.99%	1	0.24%
遨	4540		14	1	0.0001507%	663373	99.99%	1	0.24%
邂	4541		16	1	0.0001507%	663374	99.99%	1	0.24%
邇	4542		17	1	0.0001507%	663375	99.99%	1	0.24%
邈	4543		17	1	0.0001507%	663376	99.99%	1	0.24%
鄂	4544		11	1	0.0001507%	663377	99.99%	1	0.24%
鄯	4545		14	1	0.0001507%	663378	99.99%	1	0.24%
酚	4546		11	1	0.0001507%	663379	99.99%	1	0.24%
醃	4547		15	1	0.0001507%	663380	99.99%	1	0.24%
釦	4548		11	1	0.0001507%	663381	99.99%	1	0.24%
釧	4549		11	1	0.0001507%	663382	99.99%	1	0.24%
	4550		12	1	0.0001507%	663383	99.99%	1	0.24%
鉏	4551		13	1	0.0001507%	663384	99.99%	1	0.24%
銬	4552		14	1	0.0001507%	663385	99.99%	1	0.24%
	4553		15	1	0.0001507%	663386	99.99%	1	0.24%
錐	4554		16	1	0.0001507%	663387	99.99%	1	0.24%
錮	4555		16	1	0.0001507%	663388	99.99%	1	0.24%
鎂	4556		17	1	0.0001507%	663389	99.99%	1	0.24%
錨	4557		17	1	0.0001507%	663390	99.99%	1	0.24%
鎚	4558		18	1	0.0001507%	663391	99.99%	1	0.24%
鎧	4559		18	1	0.0001507%	663392	99.99%	1	0.24%
鐮	4560		21	1	0.0001507%	663393	99.99%	1	0.24%
鐸	4561		21	1	0.0001507%	663394	99.99%	1	0.24%
鑣	4562		23	1	0.0001507%	663395	99.99%	1	0.24%
鑠	4563		23	1	0.0001507%	663396	99.99%	1	0.24%
閞	4564		13	1	0.0001507%	663397	99.99%	1	0.24%
閡	4565		14	1	0.0001507%	663398	99.99%	1	0.24%
闇	4566		17	1	0.0001507%	663399	99.99%	1	0.24%
闐	4567		18	1	0.0001507%	663400	99.99%	1	0.24%
阜	4568		8	1	0.0001507%	663401	99.99%	1	0.24%
陃	4569		8	1	0.0001507%	663402	99.99%	1	0.24%
陛	4570		9	1	0.0001507%	663403	99.99%	1	0.24%
陜	4571		9	1	0.0001507%	663404	99.99%	1	0.24%
隋	4572		11	1	0.0001507%	663405	99.99%	1	0.24%
隴	4573		18	1	0.0001507%	663406	99.99%	1	0.24%
雇	4574		12	1	0.0001507%	663407	99.99%	1	0.24%
雋	4575		13	1	0.0001507%	663408	99.99%	1	0.24%
霆	4576		15	1	0.0001507%	663409	99.99%	1	0.24%
霓	4577		16	1	0.0001507%	663410	99.99%	1	0.24%
霹	4578		21	1	0.0001507%	663411	99.99%	1	0.24%
霾	4579		22	1	0.0001507%	663412	99.99%	1	0.24%
靂	4580		24	1	0.0001507%	663413	99.99%	1	0.24%
靨	4581		23	1	0.0001507%	663414	99.99%	1	0.24%
韁	4582		22	1	0.0001507%	663415	99.99%	1	0.24%
韙	4583		18	1	0.0001507%	663416	99.99%	1	0.24%
韜	4584		19	1	0.0001507%	663417	99.99%	1	0.24%
頤	4585		16	1	0.0001507%	663418	99.99%	1	0.24%
顥	4586		21	1	0.0001507%	663419	99.99%	1	0.24%
顴	4587		26	1	0.0001507%	663420	99.99%	1	0.24%
颸	4588		18	1	0.0001507%	663421	99.99%	1	0.24%
飭	4589		12	1	0.0001507%	663422	99.99%	1	0.24%
餉	4590		14	1	0.0001507%	663423	99.99%	1	0.24%
餿	4591		17	1	0.0001507%	663424	99.99%	1	0.24%
餬	4592		17	1	0.0001507%	663425	99.99%	1	0.24%
饌	4593		20	1	0.0001507%	663426	99.99%	1	0.24%
饋	4594		20	1	0.0001507%	663427	99.99%	1	0.24%
饔	4595		22	1	0.0001507%	663428	99.99%	1	0.24%
馥	4596		18	1	0.0001507%	663429	99.99%	1	0.24%
駟	4597		15	1	0.0001507%	663430	99.9999999999%	1	0.24%
駒	4598		15	1	0.0001507%	663431	99.9999999999%	1	0.24%
駢	4599		16	1	0.0001507%	663432	99.9999999999%	1	0.24%
騮	4600		20	1	0.0001507%	663433	99.9999999999%	1	0.24%
驃	4601		21	1	0.0001507%	663434	99.9999999999%	1	0.24%
騾	4602		21	1	0.0001507%	663435	99.9999999999%	1	0.24%
驄	4603		21	1	0.0001507%	663436	99.9999999999%	1	0.24%
驍	4604		22	1	0.0001507%	663437	99.9999999999%	1	0.24%
驥	4605		26	1	0.0001507%	663438	99.9999999999%	1	0.24%
髭	4606		16	1	0.0001507%	663439	99.9999999999%	1	0.24%
鬈	4607		18	1	0.0001507%	663440	99.9999999999%	1	0.24%
鬨	4608		16	1	0.0001507%	663441	99.9999999999%	1	0.24%
鬩	4609		18	1	0.0001507%	663442	99.9999999999%	1	0.24%
鬯	4610		10	1	0.0001507%	663443	99.9999999999%	1	0.24%
鯨	4611		19	1	0.0001507%	663444	99.9999999999%	1	0.24%
鯛	4612		19	1	0.0001507%	663445	99.9999999999%	1	0.24%
鰲	4613		22	1	0.0001507%	663446	99.9999999999%	1	0.24%
鴕	4614		16	1	0.0001507%	663447	99.9999999999%	1	0.24%
鴞	4615		16	1	0.0001507%	663448	99.9999999999%	1	0.24%
鴐	4616		16	1	0.0001507%	663449	99.9999999999%	1	0.24%
鵠	4617		18	1	0.0001507%	663450	99.9999999999%	1	0.24%
鵡	4618		19	1	0.0001507%	663451	99.9999999999%	1	0.24%
鵲	4619		19	1	0.0001507%	663452	99.9999999999%	1	0.24%
鷁	4620		21	1	0.0001507%	663453	99.9999999999%	1	0.24%
鷺	4621		24	1	0.0001507%	663454	99.9999999999%	1	0.24%
鸁	4622		24	1	0.0001507%	663455	99.9999999999%	1	0.24%
鸚	4623		28	1	0.0001507%	663456	99.9999999999%	1	0.24%
麈	4624		16	1	0.0001507%	663457	99.9999999999%	1	0.24%
麇	4625		16	1	0.0001507%	663458	99.9999999999%	1	0.24%
黔	4626		16	1	0.0001507%	663459	99.9999999999%	1	0.24%
黜	4627		17	1	0.0001507%	663460	99.9999999999%	1	0.24%
齎	4628		21	1	0.0001507%	663461	99.9999999999%	1	0.24%
