單字	序號	部首	筆劃	頻次	頻率	累積頻次	累積頻率	見檔次	見檔率
的	1		8	29274	4.422%	29274	4.422%	467	97.70%
一	2		1	11235	1.697%	40509	6.119%	460	96.23%
是	3		9	9579	1.447%	50088	7.566%	441	92.26%
不	4		4	7637	1.154%	57725	8.719%	451	94.35%
有	5		6	7203	1.088%	64928	9.807%	447	93.51%
在	6		6	7026	1.061%	71954	10.87%	457	95.61%
人	7		2	6537	0.9874%	78491	11.86%	446	93.31%
我	8		7	6460	0.9758%	84951	12.83%	371	77.62%
了	9		2	6006	0.9072%	90957	13.74%	427	89.33%
這	10		10	4593	0.6938%	95550	14.43%	398	83.26%
之	11		4	4332	0.6543%	99882	15.09%	386	80.75%
大	12		3	3973	0.6001%	103855	15.69%	423	88.49%
為	13		9	3941	0.5953%	107796	16.28%	427	89.33%
以	14		5	3733	0.5639%	111529	16.85%	398	83.26%
上	15		3	3714	0.561%	115243	17.41%	430	89.96%
中	16		4	3663	0.5533%	118906	17.96%	421	88.08%
來	17		8	3462	0.5229%	122368	18.48%	421	88.08%
們	18		10	3430	0.5181%	125798	19.00%	382	79.92%
會	19		13	3364	0.5081%	129162	19.51%	398	83.26%
個	20		10	3350	0.506%	132512	20.02%	391	81.80%
地	21		6	3246	0.4903%	135758	20.51%	422	88.28%
時	22		10	3130	0.4728%	138888	20.98%	409	85.56%
年	23		6	3078	0.4649%	141966	21.44%	372	77.82%
他	24		5	3054	0.4613%	145020	21.90%	359	75.10%
到	25		8	3045	0.4599%	148065	22.36%	405	84.73%
而	26		6	2975	0.4494%	151040	22.81%	403	84.31%
國	27		11	2877	0.4346%	153917	23.25%	242	50.63%
生	28		5	2863	0.4324%	156780	23.68%	399	83.47%
可	29		5	2754	0.416%	159534	24.10%	404	84.52%
也	30		3	2486	0.3755%	162020	24.47%	366	76.57%
於	31		8	2431	0.3672%	164451	24.84%	390	81.59%
要	32		9	2408	0.3637%	166859	25.20%	389	81.38%
那	33		6	2377	0.359%	169236	25.56%	344	71.97%
多	34		6	2260	0.3414%	171496	25.90%	401	83.89%
和	35		8	2253	0.3403%	173749	26.24%	339	70.92%
得	36		11	2211	0.334%	175960	26.58%	395	82.64%
能	37		10	2210	0.3338%	178170	26.91%	368	76.99%
出	38		5	2145	0.324%	180315	27.24%	401	83.89%
所	39		8	2132	0.322%	182447	27.56%	362	75.73%
就	40		12	2129	0.3216%	184576	27.88%	352	73.64%
子	41		3	2109	0.3186%	186685	28.20%	313	65.48%
學	42		16	2086	0.3151%	188771	28.51%	231	48.33%
說	43		14	2045	0.3089%	190816	28.82%	332	69.46%
家	44		10	2024	0.3057%	192840	29.13%	326	68.20%
自	45		6	1997	0.3016%	194837	29.43%	363	75.94%
過	46		12	1990	0.3006%	196827	29.73%	397	83.05%
着	47		11	1965	0.2968%	198792	30.03%	285	59.62%
天	48		4	1962	0.2964%	200754	30.32%	366	76.57%
下	49		3	1950	0.2945%	202704	30.62%	386	80.75%
十	50		2	1948	0.2942%	204652	30.91%	329	68.83%
然	51		12	1900	0.287%	206552	31.20%	383	80.13%
對	52		14	1846	0.2788%	208398	31.48%	363	75.94%
港	53		12	1786	0.2698%	210184	31.75%	225	47.07%
如	54		6	1761	0.266%	211945	32.01%	379	79.29%
其	55		8	1754	0.2649%	213699	32.28%	331	69.25%
成	56		6	1734	0.2619%	215433	32.54%	374	78.24%
去	57		5	1708	0.258%	217141	32.80%	385	80.54%
工	58		3	1686	0.2547%	218827	33.05%	272	56.90%
方	59		4	1670	0.2522%	220497	33.31%	359	75.10%
但	60		7	1658	0.2504%	222155	33.56%	365	76.36%
發	61		12	1649	0.2491%	223804	33.80%	356	74.48%
作	62		7	1625	0.2455%	225429	34.05%	331	69.25%
心	63		4	1614	0.2438%	227043	34.29%	368	76.99%
你	64		7	1604	0.2423%	228647	34.54%	203	42.47%
後	65		9	1583	0.2391%	230230	34.78%	363	75.94%
民	66		5	1581	0.2388%	231811	35.01%	206	43.10%
種	67		14	1566	0.2365%	233377	35.25%	324	67.78%
都	68		9	1555	0.2349%	234932	35.49%	350	73.22%
行	69		6	1542	0.2329%	236474	35.72%	335	70.08%
用	70		5	1527	0.2306%	238001	35.95%	323	67.57%
經	71		13	1500	0.2266%	239501	36.18%	352	73.64%
面	72		9	1490	0.2251%	240991	36.40%	360	75.31%
無	73		12	1481	0.2237%	242472	36.62%	372	77.82%
教	74		11	1475	0.2228%	243947	36.85%	177	37.03%
現	75		11	1471	0.2222%	245418	37.07%	352	73.64%
本	76		5	1470	0.222%	246888	37.29%	296	61.92%
及	77		4	1469	0.2219%	248357	37.51%	298	62.34%
事	78		8	1464	0.2211%	249821	37.73%	343	71.76%
當	79		13	1462	0.2208%	251283	37.96%	354	74.06%
前	80		9	1445	0.2183%	252728	38.17%	377	78.87%
與	81		14	1438	0.2172%	254166	38.39%	297	62.13%
水	82		4	1423	0.2149%	255589	38.61%	253	52.93%
道	83		12	1423	0.2149%	257012	38.82%	329	68.83%
此	84		6	1417	0.214%	258429	39.03%	346	72.38%
因	85		6	1400	0.2115%	259829	39.25%	331	69.25%
三	86		3	1347	0.2035%	261176	39.45%	308	64.44%
日	87		4	1347	0.2035%	262523	39.65%	331	69.25%
小	88		3	1335	0.2016%	263858	39.85%	307	64.23%
由	89		5	1326	0.2003%	265184	40.06%	310	64.85%
二	90		2	1320	0.1994%	266504	40.25%	288	60.25%
些	91		8	1294	0.1955%	267798	40.45%	285	59.62%
起	92		10	1276	0.1927%	269074	40.64%	366	76.57%
動	93		11	1274	0.1924%	270348	40.84%	312	65.27%
外	94		5	1262	0.1906%	271610	41.03%	333	69.67%
實	95		14	1258	0.190%	272868	41.22%	328	68.62%
她	96		6	1253	0.1893%	274121	41.41%	127	26.57%
主	97		5	1250	0.1888%	275371	41.59%	257	53.77%
已	98		3	1250	0.1888%	276621	41.78%	369	77.20%
政	99		9	1232	0.1861%	277853	41.97%	176	36.82%
好	100		6	1231	0.1859%	279084	42.15%	313	65.48%
新	101		13	1228	0.1855%	280312	42.34%	274	57.32%
同	102		6	1223	0.1847%	281535	42.52%	321	67.15%
美	103		9	1208	0.1825%	282743	42.71%	264	55.23%
看	104		9	1191	0.1799%	283934	42.89%	307	64.23%
香	105		9	1189	0.1796%	285123	43.07%	224	46.86%
理	106		11	1174	0.1773%	286297	43.24%	275	57.53%
最	107		12	1166	0.1761%	287463	43.42%	321	67.15%
又	108		2	1157	0.1748%	288620	43.60%	339	70.92%
還	109		16	1150	0.1737%	289770	43.77%	302	63.18%
樣	110		15	1145	0.1729%	290915	43.94%	322	67.36%
山	111		3	1134	0.1713%	292049	44.11%	197	41.21%
公	112		4	1132	0.171%	293181	44.28%	232	48.54%
力	113		2	1130	0.1707%	294311	44.45%	284	59.41%
從	114		11	1115	0.1684%	295426	44.62%	326	68.20%
業	115		13	1114	0.1683%	296540	44.79%	207	43.31%
情	116		11	1113	0.1681%	297653	44.96%	338	70.71%
文	117		4	1112	0.168%	298765	45.13%	199	41.63%
意	118		13	1111	0.1678%	299876	45.30%	323	67.57%
麼	119		14	1110	0.1677%	300986	45.46%	272	56.90%
裏	120		13	1107	0.1672%	302093	45.63%	244	51.05%
五	121		4	1105	0.1669%	303198	45.80%	270	56.49%
者	122		8	1105	0.1669%	304303	45.96%	284	59.41%
使	123		8	1104	0.1668%	305407	46.13%	324	67.78%
加	124		5	1104	0.1668%	306511	46.30%	278	58.16%
想	125		13	1104	0.1668%	307615	46.46%	292	61.09%
海	126		10	1093	0.1651%	308708	46.63%	226	47.28%
開	127		12	1083	0.1636%	309791	46.79%	340	71.13%
法	128		8	1076	0.1625%	310867	46.96%	257	53.77%
進	129		11	1067	0.1612%	311934	47.12%	321	67.15%
沒	130		7	1064	0.1607%	312998	47.28%	293	61.30%
分	131		4	1056	0.1595%	314054	47.44%	289	60.46%
活	132		9	1055	0.1594%	315109	47.60%	264	55.23%
九	133		2	1053	0.1591%	316162	47.76%	208	43.51%
長	134		8	1037	0.1566%	317199	47.91%	318	66.53%
四	135		5	1026	0.155%	318225	48.07%	291	60.88%
間	136		12	1025	0.1548%	319250	48.22%	311	65.06%
更	137		7	1013	0.153%	320263	48.37%	319	66.74%
機	138		16	998	0.1507%	321261	48.53%	229	47.91%
風	139		9	996	0.1504%	322257	48.68%	251	52.51%
界	140		9	964	0.1456%	323221	48.82%	251	52.51%
只	141		5	963	0.1455%	324184	48.97%	282	59.00%
便	142		9	954	0.1441%	325138	49.11%	273	57.11%
將	143		11	950	0.1435%	326088	49.25%	278	58.16%
各	144		6	941	0.1421%	327029	49.40%	252	52.72%
重	145		9	941	0.1421%	327970	49.54%	288	60.25%
問	146		11	937	0.1415%	328907	49.68%	236	49.37%
很	147		9	928	0.1402%	329835	49.82%	274	57.32%
代	148		5	926	0.1399%	330761	49.96%	224	46.86%
應	149		17	921	0.1391%	331682	50.10%	273	57.11%
正	150		5	918	0.1387%	332600	50.24%	305	63.81%
月	151		4	915	0.1382%	333515	50.38%	250	52.30%
知	152		8	911	0.1376%	334426	50.51%	295	61.72%
高	153		10	906	0.1368%	335332	50.65%	285	59.62%
利	154		7	905	0.1367%	336237	50.79%	218	45.61%
見	155		7	904	0.1365%	337141	50.92%	308	64.44%
至	156		6	899	0.1358%	338040	51.06%	292	61.09%
等	157		12	897	0.1355%	338937	51.20%	271	56.69%
或	158		8	894	0.135%	339831	51.33%	277	57.95%
百	159		6	893	0.1349%	340724	51.47%	230	48.12%
社	160		7	882	0.1332%	341606	51.60%	165	34.52%
世	161		5	879	0.1328%	342485	51.73%	248	51.88%
物	162		8	873	0.1319%	343358	51.86%	240	50.21%
全	163		6	867	0.131%	344225	51.99%	282	59.00%
它	164		5	857	0.1294%	345082	52.12%	208	43.51%
少	165		4	854	0.129%	345936	52.25%	294	61.51%
光	166		6	850	0.1284%	346786	52.38%	237	49.58%
明	167		8	849	0.1282%	347635	52.51%	293	61.30%
定	168		8	844	0.1275%	348479	52.64%	272	56.90%
兒	169		8	840	0.1269%	349319	52.76%	187	39.12%
兩	170		8	838	0.1266%	350157	52.89%	269	56.28%
點	171		17	815	0.1231%	350972	53.01%	285	59.62%
頭	172		16	813	0.1228%	351785	53.14%	249	52.09%
化	173		4	802	0.1211%	352587	53.26%	191	39.96%
相	174		9	801	0.121%	353388	53.38%	289	60.46%
車	175		7	787	0.1189%	354175	53.50%	138	28.87%
常	176		11	785	0.1186%	354960	53.62%	262	54.81%
把	177		7	784	0.1184%	355744	53.73%	242	50.63%
每	178		7	772	0.1166%	356516	53.85%	281	58.79%
向	179		6	770	0.1163%	357286	53.97%	289	60.46%
市	180		5	769	0.1162%	358055	54.08%	167	34.94%
氣	181		10	764	0.1154%	358819	54.20%	239	50.00%
六	182		4	755	0.114%	359574	54.31%	213	44.56%
次	183		6	750	0.1133%	360324	54.43%	271	56.69%
度	184		9	748	0.113%	361072	54.54%	221	46.23%
像	185		14	744	0.1124%	361816	54.65%	249	52.09%
愛	186		13	740	0.1118%	362556	54.76%	212	44.35%
通	187		10	739	0.1116%	363295	54.87%	206	43.10%
建	188		9	737	0.1113%	364032	54.99%	184	38.49%
內	189		4	720	0.1088%	364752	55.09%	229	47.91%
何	190		7	719	0.1086%	365471	55.20%	257	53.77%
則	191		9	716	0.1081%	366187	55.31%	220	46.03%
並	192		8	715	0.108%	366902	55.42%	272	56.90%
萬	193		13	713	0.1077%	367615	55.53%	223	46.65%
受	194		8	712	0.1075%	368327	55.63%	258	53.97%
產	195		11	711	0.1074%	369038	55.74%	166	34.73%
青	196		8	706	0.1066%	369744	55.85%	189	39.54%
望	197		11	704	0.1063%	370448	55.95%	259	54.18%
西	198		6	699	0.1056%	371147	56.06%	196	41.00%
位	199		7	697	0.1053%	371844	56.17%	218	45.61%
立	200		5	696	0.1051%	372540	56.27%	242	50.63%
感	201		13	694	0.1048%	373234	56.38%	244	51.05%
計	202		9	690	0.1042%	373924	56.48%	164	34.31%
聲	203		17	686	0.1036%	374610	56.58%	220	46.03%
原	204		10	676	0.1021%	375286	56.69%	223	46.65%
關	205		19	676	0.1021%	375962	56.79%	222	46.44%
數	206		15	675	0.102%	376637	56.89%	240	50.21%
該	207		13	675	0.102%	377312	56.99%	228	47.70%
題	208		18	674	0.1018%	377986	57.09%	185	38.70%
處	209		11	672	0.1015%	378658	57.19%	270	56.49%
目	210		5	667	0.1007%	379325	57.30%	262	54.81%
身	211		7	667	0.1007%	379992	57.40%	279	58.37%
部	212		10	667	0.1007%	380659	57.50%	214	44.77%
府	213		8	663	0.1001%	381322	57.60%	144	30.13%
花	214		8	656	0.09909%	381978	57.70%	187	39.12%
士	215		3	651	0.09833%	382629	57.79%	182	38.08%
展	216		10	651	0.09833%	383280	57.89%	190	39.75%
真	217		10	651	0.09833%	383931	57.99%	226	47.28%
色	218		6	651	0.09833%	384582	58.09%	188	39.33%
許	219		11	649	0.09803%	385231	58.19%	242	50.63%
信	220		9	648	0.09788%	385879	58.29%	205	42.89%
交	221		6	647	0.09773%	386526	58.38%	182	38.08%
命	222		8	643	0.09712%	387169	58.48%	187	39.12%
女	223		3	640	0.09667%	387809	58.58%	178	37.24%
員	224		10	638	0.09637%	388447	58.67%	162	33.89%
果	225		8	636	0.09607%	389083	58.77%	252	52.72%
義	226		13	635	0.09591%	389718	58.87%	150	31.38%
今	227		4	631	0.09531%	390349	58.96%	246	51.46%
比	228		4	631	0.09531%	390980	59.06%	243	50.84%
難	229		19	630	0.09516%	391610	59.15%	249	52.09%
共	230		6	629	0.09501%	392239	59.25%	160	33.47%
表	231		8	627	0.09471%	392866	59.34%	228	47.70%
入	232		2	626	0.09456%	393492	59.44%	241	50.42%
別	233		7	626	0.09456%	394118	59.53%	274	57.32%
性	234		8	625	0.0944%	394743	59.62%	197	41.21%
合	235		6	618	0.09335%	395361	59.72%	243	50.84%
給	236		12	617	0.0932%	395978	59.81%	234	48.95%
平	237		5	616	0.09304%	396594	59.90%	231	48.33%
區	238		11	613	0.09259%	397207	60.00%	146	30.54%
路	239		13	611	0.09229%	397818	60.09%	199	41.63%
幾	240		12	609	0.09199%	398427	60.18%	235	49.16%
口	241		3	607	0.09169%	399034	60.27%	208	43.51%
第	242		11	607	0.09169%	399641	60.36%	201	42.05%
先	243		6	604	0.09123%	400245	60.46%	217	45.40%
走	244		7	604	0.09123%	400849	60.55%	207	43.31%
神	245		9	602	0.09093%	401451	60.64%	206	43.10%
七	246		2	600	0.09063%	402051	60.73%	212	44.35%
再	247		6	600	0.09063%	402651	60.82%	252	52.72%
遠	248		13	595	0.08987%	403246	60.91%	249	52.09%
己	249		3	591	0.08927%	403837	61.00%	194	40.59%
樂	250		15	588	0.08882%	404425	61.09%	189	39.54%
千	251		3	585	0.08836%	405010	61.18%	193	40.38%
老	252		6	583	0.08806%	405593	61.26%	173	36.19%
設	253		11	582	0.08791%	406175	61.35%	190	39.75%
八	254		2	580	0.08761%	406755	61.44%	207	43.31%
接	255		11	573	0.08655%	407328	61.53%	243	50.84%
名	256		6	571	0.08625%	407899	61.61%	210	43.93%
議	257		20	571	0.08625%	408470	61.70%	117	24.48%
必	258		5	569	0.08595%	409039	61.78%	209	43.72%
期	259		12	565	0.08534%	409604	61.87%	209	43.72%
親	260		16	562	0.08489%	410166	61.95%	140	29.29%
總	261		17	561	0.08474%	410727	62.04%	222	46.44%
東	262		8	560	0.08459%	411287	62.12%	195	40.79%
類	263		19	559	0.08443%	411846	62.21%	161	33.68%
才	264		3	554	0.08368%	412400	62.29%	227	47.49%
手	265		4	554	0.08368%	412954	62.38%	210	43.93%
白	266		5	553	0.08353%	413507	62.46%	202	42.26%
體	267		23	553	0.08353%	414060	62.54%	206	43.10%
空	268		8	552	0.08338%	414612	62.63%	211	44.14%
回	269		6	549	0.08292%	415161	62.71%	206	43.10%
書	270		10	548	0.08277%	415709	62.79%	168	35.15%
做	271		11	547	0.08262%	416256	62.87%	197	41.21%
任	272		6	545	0.08232%	416801	62.96%	203	42.47%
認	273		14	545	0.08232%	417346	63.04%	216	45.19%
英	274		9	542	0.08187%	417888	63.12%	152	31.80%
觀	275		25	541	0.08172%	418429	63.20%	197	41.21%
太	276		4	540	0.08157%	418969	63.28%	200	41.84%
著	277		12	540	0.08157%	419509	63.37%	181	37.87%
近	278		7	539	0.08141%	420048	63.45%	229	47.91%
亦	279		6	536	0.08096%	420584	63.53%	173	36.19%
打	280		5	534	0.08066%	421118	63.61%	191	39.96%
解	281		13	533	0.08051%	421651	63.69%	212	44.35%
鄉	282		11	529	0.0799%	422180	63.77%	112	23.43%
深	283		11	528	0.07975%	422708	63.85%	227	47.49%
影	284		15	522	0.07885%	423230	63.93%	203	42.47%
變	285		23	519	0.07839%	423749	64.01%	225	47.07%
流	286		9	518	0.07824%	424267	64.08%	216	45.19%
金	287		8	515	0.07779%	424782	64.16%	166	34.73%
未	288		5	512	0.07734%	425294	64.24%	223	46.65%
治	289		8	511	0.07718%	425805	64.32%	107	22.38%
非	290		8	511	0.07718%	426316	64.39%	215	44.98%
務	291		11	510	0.07703%	426826	64.47%	164	34.31%
即	292		7	510	0.07703%	427336	64.55%	197	41.21%
品	293		9	505	0.07628%	427841	64.62%	126	26.36%
增	294		15	505	0.07628%	428346	64.70%	177	37.03%
形	295		7	500	0.07552%	428846	64.78%	206	43.10%
論	296		15	500	0.07552%	429346	64.85%	193	40.38%
資	297		13	498	0.07522%	429844	64.93%	111	23.22%
清	298		11	496	0.07492%	430340	65.00%	194	40.59%
被	299		10	492	0.07431%	430832	65.08%	222	46.44%
特	300		10	490	0.07401%	431322	65.15%	214	44.77%
覺	301		20	490	0.07401%	431812	65.22%	195	40.79%
雖	302		17	490	0.07401%	432302	65.30%	243	50.84%
育	303		7	488	0.07371%	432790	65.37%	97	20.29%
求	304		7	485	0.07326%	433275	65.44%	185	38.70%
往	305		8	480	0.0725%	433755	65.52%	215	44.98%
需	306		14	479	0.07235%	434234	65.59%	189	39.54%
字	307		6	478	0.0722%	434712	65.66%	167	34.94%
居	308		8	478	0.0722%	435190	65.73%	163	34.10%
什	309		4	475	0.07175%	435665	65.81%	166	34.73%
安	310		6	473	0.07144%	436138	65.88%	207	43.31%
電	311		13	472	0.07129%	436610	65.95%	134	28.03%
提	312		12	470	0.07099%	437080	66.02%	209	43.72%
量	313		12	469	0.07084%	437549	66.09%	171	35.77%
候	314		10	467	0.07054%	438016	66.16%	201	42.05%
切	315		4	462	0.06978%	438478	66.23%	217	45.40%
南	316		9	462	0.06978%	438940	66.30%	131	27.41%
商	317		11	462	0.06978%	439402	66.37%	137	28.66%
條	318		11	461	0.06963%	439863	66.44%	192	40.17%
辦	319		16	461	0.06963%	440324	66.51%	157	32.85%
放	320		8	454	0.06858%	440778	66.58%	200	41.84%
甚	321		9	454	0.06858%	441232	66.65%	207	43.31%
收	322		6	453	0.06842%	441685	66.71%	183	38.28%
雨	323		8	453	0.06842%	442138	66.78%	122	25.52%
制	324		8	450	0.06797%	442588	66.85%	131	27.41%
星	325		9	450	0.06797%	443038	66.92%	127	26.57%
母	326		5	449	0.06782%	443487	66.99%	90	18.83%
滿	327		14	449	0.06782%	443936	67.05%	204	42.68%
程	328		12	448	0.06767%	444384	67.12%	164	34.31%
份	329		6	447	0.06752%	444831	67.19%	191	39.96%
失	330		5	446	0.06737%	445277	67.26%	192	40.17%
濟	331		17	446	0.06737%	445723	67.32%	113	23.64%
司	332		5	445	0.06722%	446168	67.39%	115	24.06%
土	333		3	445	0.06722%	446613	67.46%	115	24.06%
且	334		5	444	0.06706%	447057	67.53%	215	44.98%
元	335		4	443	0.06691%	447500	67.59%	111	23.22%
戰	336		16	442	0.06676%	447942	67.66%	114	23.85%
邊	337		18	440	0.06646%	448382	67.73%	165	34.52%
費	338		12	431	0.0651%	448813	67.79%	131	27.41%
步	339		7	430	0.06495%	449243	67.86%	197	41.21%
曾	340		12	429	0.0648%	449672	67.92%	206	43.10%
帶	341		11	428	0.06465%	450100	67.99%	187	39.12%
眼	342		11	428	0.06465%	450528	68.05%	200	41.84%
石	343		5	428	0.06465%	450956	68.12%	134	28.03%
黃	344		12	428	0.06465%	451384	68.18%	155	32.43%
話	345		13	426	0.06435%	451810	68.24%	178	37.24%
完	346		7	422	0.06374%	452232	68.31%	204	42.68%
局	347		7	422	0.06374%	452654	68.37%	118	24.69%
易	348		8	422	0.06374%	453076	68.44%	147	30.75%
言	349		7	420	0.06344%	453496	68.50%	167	34.94%
夜	350		8	419	0.06329%	453915	68.56%	152	31.80%
結	351		12	418	0.06314%	454333	68.63%	194	40.59%
音	352		9	418	0.06314%	454751	68.69%	146	30.54%
運	353		12	417	0.06299%	455168	68.75%	161	33.68%
落	354		13	415	0.06268%	455583	68.81%	196	41.00%
反	355		4	413	0.06238%	455996	68.88%	179	37.45%
統	356		11	413	0.06238%	456409	68.94%	124	25.94%
門	357		8	412	0.06223%	456821	69.00%	160	33.47%
除	358		9	407	0.06148%	457228	69.06%	201	42.05%
住	359		7	404	0.06102%	457632	69.12%	167	34.94%
精	360		14	404	0.06102%	458036	69.18%	157	32.85%
算	361		14	403	0.06087%	458439	69.25%	155	32.43%
改	362		7	401	0.06057%	458840	69.31%	170	35.56%
指	363		9	398	0.06012%	459238	69.37%	180	37.66%
舉	364		17	397	0.05997%	459635	69.43%	168	35.15%
聽	365		22	395	0.05966%	460030	69.49%	175	36.61%
故	366		9	389	0.05876%	460419	69.54%	175	36.61%
究	367		7	389	0.05876%	460808	69.60%	139	29.08%
直	368		8	388	0.05861%	461196	69.66%	201	42.05%
報	369		12	387	0.05845%	461583	69.72%	138	28.87%
樹	370		16	386	0.0583%	461969	69.78%	128	26.78%
達	371		12	384	0.058%	462353	69.84%	182	38.08%
項	372		12	383	0.05785%	462736	69.89%	122	25.52%
城	373		9	382	0.0577%	463118	69.95%	88	18.41%
思	374		9	382	0.0577%	463500	70.01%	158	33.05%
熱	375		15	380	0.0574%	463880	70.07%	166	34.73%
校	376		10	379	0.05725%	464259	70.12%	102	21.34%
興	377		16	379	0.05725%	464638	70.18%	183	38.28%
保	378		9	378	0.0571%	465016	70.24%	159	33.26%
極	379		13	378	0.0571%	465394	70.30%	181	37.87%
呢	380		8	376	0.05679%	465770	70.35%	160	33.47%
馬	381		10	375	0.05664%	466145	70.41%	157	32.85%
造	382		10	374	0.05649%	466519	70.47%	140	29.29%
河	383		8	371	0.05604%	466890	70.52%	89	18.62%
底	384		8	370	0.05589%	467260	70.58%	153	32.01%
記	385		10	370	0.05589%	467630	70.63%	164	34.31%
劃	386		14	366	0.05528%	467996	70.69%	110	23.01%
笑	387		10	365	0.05513%	468361	70.74%	124	25.94%
飛	388		9	365	0.05513%	468726	70.80%	130	27.20%
快	389		7	364	0.05498%	469090	70.85%	175	36.61%
客	390		9	363	0.05483%	469453	70.91%	128	26.78%
北	391		5	362	0.05468%	469815	70.96%	126	26.36%
約	392		9	362	0.05468%	470177	71.02%	148	30.96%
片	393		4	358	0.05407%	470535	71.07%	157	32.85%
助	394		7	357	0.05392%	470892	71.13%	153	32.01%
宗	395		8	357	0.05392%	471249	71.18%	62	12.97%
容	396		10	357	0.05392%	471606	71.23%	187	39.12%
却	397		7	356	0.05377%	471962	71.29%	137	28.66%
取	398		8	356	0.05377%	472318	71.34%	160	33.47%
足	399		7	355	0.05362%	472673	71.40%	187	39.12%
持	400		9	351	0.05302%	473024	71.45%	180	37.66%
苦	401		9	351	0.05302%	473375	71.50%	152	31.80%
始	402		8	349	0.05272%	473724	71.55%	188	39.33%
華	403		12	347	0.05241%	474071	71.61%	134	28.03%
友	404		4	346	0.05226%	474417	71.66%	144	30.13%
輕	405		14	345	0.05211%	474762	71.71%	154	32.22%
院	406		9	345	0.05211%	475107	71.76%	103	21.55%
象	407		12	344	0.05196%	475451	71.82%	159	33.26%
半	408		5	342	0.05166%	475793	71.87%	174	36.40%
德	409		15	342	0.05166%	476135	71.92%	111	23.22%
父	410		4	341	0.05151%	476476	71.97%	82	17.15%
術	411		11	341	0.05151%	476817	72.02%	108	22.59%
管	412		14	340	0.05136%	477157	72.07%	159	33.26%
似	413		7	339	0.0512%	477496	72.12%	157	32.85%
火	414		4	337	0.0509%	477833	72.17%	120	25.10%
境	415		14	336	0.05075%	478169	72.23%	164	34.31%
仍	416		4	335	0.0506%	478504	72.28%	173	36.19%
古	417		5	335	0.0506%	478839	72.33%	127	26.57%
節	418		13	335	0.0506%	479174	72.38%	131	27.41%
離	419		18	335	0.0506%	479509	72.43%	172	35.98%
叫	420		5	334	0.05045%	479843	72.48%	121	25.31%
視	421		12	334	0.05045%	480177	72.53%	179	37.45%
越	422		12	334	0.05045%	480511	72.58%	101	21.13%
連	423		10	332	0.05015%	480843	72.63%	166	34.73%
陽	424		11	331	0.050%	481174	72.68%	122	25.52%
識	425		19	330	0.04985%	481504	72.73%	143	29.92%
較	426		13	330	0.04985%	481834	72.78%	156	32.64%
供	427		8	327	0.04939%	482161	72.83%	131	27.41%
研	428		9	327	0.04939%	482488	72.88%	101	21.13%
草	429		10	327	0.04939%	482815	72.93%	119	24.90%
談	430		15	325	0.04909%	483140	72.98%	138	28.87%
環	431		17	323	0.04879%	483463	73.03%	137	28.66%
般	432		10	323	0.04879%	483786	73.07%	169	35.36%
靜	433		16	323	0.04879%	484109	73.12%	135	28.24%
件	434		6	322	0.04864%	484431	73.17%	157	32.85%
消	435		10	321	0.04849%	484752	73.22%	155	32.43%
早	436		6	319	0.04818%	485071	73.27%	166	34.73%
照	437		13	319	0.04818%	485390	73.32%	175	36.61%
價	438		15	318	0.04803%	485708	73.36%	117	24.48%
式	439		6	317	0.04788%	486025	73.41%	145	30.33%
爭	440		8	316	0.04773%	486341	73.46%	117	24.48%
紅	441		9	316	0.04773%	486657	73.51%	132	27.62%
質	442		15	316	0.04773%	486973	73.56%	108	22.59%
亞	443		8	315	0.04758%	487288	73.60%	83	17.36%
備	444		12	315	0.04758%	487603	73.65%	161	33.68%
傳	445		13	313	0.04728%	487916	73.70%	136	28.45%
死	446		6	313	0.04728%	488229	73.75%	122	25.52%
念	447		8	312	0.04713%	488541	73.79%	132	27.62%
福	448		13	312	0.04713%	488853	73.84%	132	27.62%
張	449		11	311	0.04698%	489164	73.89%	153	32.01%
基	450		11	310	0.04682%	489474	73.93%	110	23.01%
顯	451		23	310	0.04682%	489784	73.98%	151	31.59%
整	452		16	308	0.04652%	490092	74.03%	161	33.68%
須	453		12	308	0.04652%	490400	74.07%	142	29.71%
孩	454		9	304	0.04592%	490704	74.12%	102	21.34%
島	455		10	304	0.04592%	491008	74.17%	83	17.36%
村	456		7	301	0.04546%	491309	74.21%	82	17.15%
乎	457		5	300	0.04531%	491609	74.26%	152	31.80%
廣	458		15	300	0.04531%	491909	74.30%	150	31.38%
歷	459		16	300	0.04531%	492209	74.35%	121	25.31%
貨	460		11	300	0.04531%	492509	74.39%	67	14.02%
具	461		8	299	0.04516%	492808	74.44%	151	31.59%
史	462		5	298	0.04501%	493106	74.48%	105	21.97%
科	463		9	298	0.04501%	493404	74.53%	79	16.53%
遊	464		12	298	0.04501%	493702	74.57%	95	19.87%
軍	465		9	297	0.04486%	493999	74.62%	77	16.11%
病	466		10	296	0.04471%	494295	74.66%	92	19.25%
告	467		7	295	0.04456%	494590	74.71%	143	29.92%
善	468		12	294	0.04441%	494884	74.75%	127	26.57%
若	469		9	294	0.04441%	495178	74.79%	138	28.87%
夠	470		11	293	0.04426%	495471	74.84%	163	34.10%
歡	471		22	293	0.04426%	495764	74.88%	141	29.50%
庭	472		10	292	0.04411%	496056	74.93%	100	20.92%
景	473		12	292	0.04411%	496348	74.97%	128	26.78%
引	474		4	290	0.0438%	496638	75.02%	173	36.19%
限	475		8	290	0.0438%	496928	75.06%	139	29.08%
參	476		11	289	0.04365%	497217	75.10%	128	26.78%
木	477		4	289	0.04365%	497506	75.15%	121	25.31%
低	478		7	288	0.0435%	497794	75.19%	145	30.33%
秋	479		9	288	0.0435%	498082	75.23%	73	15.27%
集	480		12	288	0.0435%	498370	75.28%	126	26.36%
單	481		12	287	0.04335%	498657	75.32%	146	30.54%
童	482		12	287	0.04335%	498944	75.36%	70	14.64%
際	483		13	287	0.04335%	499231	75.41%	138	28.87%
寫	484		15	286	0.0432%	499517	75.45%	111	23.22%
歌	485		14	286	0.0432%	499803	75.49%	102	21.34%
場	486		12	285	0.04305%	500088	75.54%	114	23.85%
存	487		6	285	0.04305%	500373	75.58%	130	27.20%
盡	488		14	285	0.04305%	500658	75.62%	167	34.94%
希	489		7	284	0.0429%	500942	75.67%	156	32.64%
房	490		8	284	0.0429%	501226	75.71%	106	22.18%
眾	491		11	284	0.0429%	501510	75.75%	108	22.59%
巴	492		4	283	0.04275%	501793	75.79%	77	16.11%
權	493		22	283	0.04275%	502076	75.84%	86	17.99%
據	494		16	282	0.0426%	502358	75.88%	147	30.75%
織	495		18	280	0.04229%	502638	75.92%	102	21.34%
根	496		10	279	0.04214%	502917	75.96%	141	29.50%
黑	497		12	279	0.04214%	503196	76.01%	121	25.31%
服	498		8	278	0.04199%	503474	76.05%	138	28.87%
例	499		8	277	0.04184%	503751	76.09%	138	28.87%
調	500		15	277	0.04184%	504028	76.13%	140	29.29%
革	501		9	276	0.04169%	504304	76.17%	62	12.97%
洲	502		9	275	0.04154%	504579	76.21%	76	15.90%
組	503		11	275	0.04154%	504854	76.26%	110	23.01%
久	504		3	274	0.04139%	505128	76.30%	164	34.31%
阿	505		7	272	0.04108%	505400	76.34%	53	11.09%
酒	506		10	271	0.04093%	505671	76.38%	67	14.02%
林	507		8	269	0.04063%	505940	76.42%	111	23.22%
喜	508		12	267	0.04033%	506207	76.46%	129	26.99%
塲	509		14	267	0.04033%	506474	76.50%	78	16.32%
否	510		7	266	0.04018%	506740	76.54%	134	28.03%
聯	511		17	266	0.04018%	507006	76.58%	114	23.85%
值	512		10	265	0.04003%	507271	76.62%	137	28.66%
獨	513		16	265	0.04003%	507536	76.66%	135	28.24%
獲	514		17	265	0.04003%	507801	76.70%	139	29.08%
讀	515		22	265	0.04003%	508066	76.74%	121	25.31%
推	516		11	264	0.03988%	508330	76.78%	129	26.99%
另	517		5	263	0.03973%	508593	76.82%	181	37.87%
台	518		5	263	0.03973%	508856	76.86%	94	19.67%
包	519		5	262	0.03957%	509118	76.90%	137	28.66%
令	520		5	261	0.03942%	509379	76.94%	149	31.17%
怎	521		9	261	0.03942%	509640	76.98%	131	27.41%
斯	522		12	261	0.03942%	509901	77.02%	79	16.53%
製	523		14	261	0.03942%	510162	77.06%	78	16.32%
支	524		4	259	0.03912%	510421	77.10%	115	24.06%
屋	525		9	257	0.03882%	510678	77.14%	98	20.50%
施	526		9	257	0.03882%	510935	77.17%	107	22.38%
首	527		9	255	0.03852%	511190	77.21%	158	33.05%
係	528		9	253	0.03821%	511443	77.25%	112	23.43%
留	529		10	253	0.03821%	511696	77.29%	145	30.33%
領	530		14	252	0.03806%	511948	77.33%	125	26.15%
專	531		11	251	0.03791%	512199	77.37%	114	23.85%
印	532		6	249	0.03761%	512448	77.40%	109	22.80%
卻	533		9	249	0.03761%	512697	77.44%	102	21.34%
停	534		11	248	0.03746%	512945	77.48%	116	24.27%
導	535		16	248	0.03746%	513193	77.52%	123	25.73%
筆	536		12	248	0.03746%	513441	77.55%	80	16.74%
轉	537		18	248	0.03746%	513689	77.59%	145	30.33%
隨	538		15	248	0.03746%	513937	77.63%	155	32.43%
龍	539		16	248	0.03746%	514185	77.67%	99	20.71%
漸	540		14	246	0.03716%	514431	77.70%	116	24.27%
致	541		9	246	0.03716%	514677	77.74%	146	30.54%
讓	542		24	246	0.03716%	514923	77.78%	134	28.03%
勢	543		13	245	0.03701%	515168	77.81%	105	21.97%
春	544		9	245	0.03701%	515413	77.85%	107	22.38%
願	545		19	245	0.03701%	515658	77.89%	143	29.92%
食	546		9	245	0.03701%	515903	77.93%	97	20.29%
假	547		11	243	0.0367%	516146	77.96%	115	24.06%
晚	548		11	242	0.03655%	516388	78.00%	129	26.99%
沉	549		7	242	0.03655%	516630	78.04%	112	23.43%
習	550		11	242	0.03655%	516872	78.07%	100	20.92%
團	551		14	241	0.0364%	517113	78.11%	102	21.34%
裝	552		13	241	0.0364%	517354	78.14%	99	20.71%
屬	553		21	240	0.03625%	517594	78.18%	140	29.29%
確	554		15	240	0.03625%	517834	78.22%	142	29.71%
語	555		14	239	0.0361%	518073	78.25%	107	22.38%
均	556		7	238	0.03595%	518311	78.29%	114	23.85%
球	557		11	238	0.03595%	518549	78.32%	66	13.81%
示	558		5	238	0.03595%	518787	78.36%	135	28.24%
適	559		14	238	0.03595%	519025	78.40%	127	26.57%
刻	560		8	236	0.03565%	519261	78.43%	145	30.33%
師	561		10	236	0.03565%	519497	78.47%	97	20.29%
灣	562		25	236	0.03565%	519733	78.50%	77	16.11%
絕	563		12	236	0.03565%	519969	78.54%	147	30.75%
養	564		15	236	0.03565%	520205	78.58%	103	21.55%
歲	565		13	235	0.0355%	520440	78.61%	104	21.76%
料	566		10	234	0.03534%	520674	78.65%	113	23.64%
謂	567		16	234	0.03534%	520908	78.68%	106	22.18%
責	568		11	234	0.03534%	521142	78.72%	120	25.10%
舊	569		18	233	0.03519%	521375	78.75%	112	23.43%
葉	570		13	233	0.03519%	521608	78.79%	85	17.78%
負	571		9	233	0.03519%	521841	78.82%	122	25.52%
農	572		13	233	0.03519%	522074	78.86%	79	16.53%
夢	573		14	232	0.03504%	522306	78.89%	94	19.67%
餘	574		15	232	0.03504%	522538	78.93%	137	28.66%
決	575		7	231	0.03489%	522769	78.96%	98	20.50%
竟	576		11	231	0.03489%	523000	79.00%	127	26.57%
救	577		11	230	0.03474%	523230	79.03%	81	16.95%
息	578		10	229	0.03459%	523459	79.07%	143	29.92%
詩	579		13	229	0.03459%	523688	79.10%	80	16.74%
畫	580		12	228	0.03444%	523916	79.14%	68	14.23%
規	581		11	228	0.03444%	524144	79.17%	115	24.06%
良	582		7	227	0.03429%	524371	79.20%	119	24.90%
座	583		10	226	0.03414%	524597	79.24%	100	20.92%
斷	584		18	226	0.03414%	524823	79.27%	149	31.17%
免	585		7	225	0.03399%	525048	79.31%	132	27.62%
麗	586		19	225	0.03399%	525273	79.34%	104	21.76%
永	587		5	224	0.03383%	525497	79.37%	115	24.06%
危	588		6	222	0.03353%	525719	79.41%	58	12.13%
器	589		16	222	0.03353%	525941	79.44%	68	14.23%
藝	590		19	222	0.03353%	526163	79.48%	57	11.92%
街	591		12	222	0.03353%	526385	79.51%	72	15.06%
請	592		15	222	0.03353%	526607	79.54%	112	23.43%
速	593		10	222	0.03353%	526829	79.58%	91	19.04%
格	594		10	221	0.03338%	527050	79.61%	113	23.64%
準	595		13	221	0.03338%	527271	79.64%	110	23.01%
紀	596		9	221	0.03338%	527492	79.68%	108	22.59%
演	597		14	220	0.03323%	527712	79.71%	91	19.04%
船	598		11	219	0.03308%	527931	79.74%	63	13.18%
野	599		11	219	0.03308%	528150	79.78%	105	21.97%
吧	600		7	218	0.03293%	528368	79.81%	111	23.22%
洋	601		9	218	0.03293%	528586	79.84%	117	24.48%
續	602		21	218	0.03293%	528804	79.87%	133	27.82%
嚴	603		20	217	0.03278%	529021	79.91%	113	23.64%
級	604		10	217	0.03278%	529238	79.94%	82	17.15%
功	605		5	216	0.03263%	529454	79.97%	110	23.01%
角	606		7	216	0.03263%	529670	80.00%	120	25.10%
唱	607		11	215	0.03247%	529885	80.04%	80	16.74%
強	608		11	215	0.03247%	530100	80.07%	107	22.38%
段	609		9	214	0.03232%	530314	80.10%	121	25.31%
站	610		10	214	0.03232%	530528	80.13%	102	21.34%
破	611		10	213	0.03217%	530741	80.17%	123	25.73%
哥	612		10	212	0.03202%	530953	80.20%	47	9.83%
毛	613		4	212	0.03202%	531165	80.23%	69	14.44%
痛	614		12	212	0.03202%	531377	80.26%	103	21.55%
充	615		5	211	0.03187%	531588	80.29%	130	27.20%
廠	616		15	211	0.03187%	531799	80.33%	60	12.55%
置	617		13	211	0.03187%	532010	80.36%	109	22.80%
醫	618		18	211	0.03187%	532221	80.39%	60	12.55%
微	619		13	210	0.03172%	532431	80.42%	125	26.15%
惡	620		12	210	0.03172%	532641	80.45%	94	19.67%
技	621		7	210	0.03172%	532851	80.49%	76	15.90%
朋	622		8	209	0.03157%	533060	80.52%	90	18.83%
稱	623		14	209	0.03157%	533269	80.55%	117	24.48%
銀	624		14	209	0.03157%	533478	80.58%	66	13.81%
響	625		21	209	0.03157%	533687	80.61%	109	22.80%
靈	626		24	208	0.03142%	533895	80.64%	110	23.01%
考	627		6	207	0.03127%	534102	80.67%	105	21.97%
里	628		7	207	0.03127%	534309	80.71%	90	18.83%
困	629		7	206	0.03112%	534515	80.74%	115	24.06%
依	630		8	205	0.03096%	534720	80.77%	129	26.99%
初	631		7	205	0.03096%	534925	80.80%	131	27.41%
園	632		13	205	0.03096%	535130	80.83%	87	18.20%
吃	633		6	203	0.03066%	535333	80.86%	98	20.50%
拉	634		8	203	0.03066%	535536	80.89%	87	18.20%
趣	635		15	202	0.03051%	535738	80.92%	109	22.80%
跟	636		13	202	0.03051%	535940	80.95%	102	21.34%
選	637		15	202	0.03051%	536142	80.98%	91	19.04%
冷	638		7	201	0.03036%	536343	81.01%	102	21.34%
蘇	639		20	201	0.03036%	536544	81.04%	45	9.41%
黨	640		20	200	0.03021%	536744	81.07%	44	9.21%
味	641		8	199	0.03006%	536943	81.10%	99	20.71%
燈	642		16	199	0.03006%	537142	81.13%	76	15.90%
綠	643		14	199	0.03006%	537341	81.16%	84	17.57%
復	644		12	198	0.02991%	537539	81.19%	104	21.76%
緊	645		14	198	0.02991%	537737	81.22%	105	21.97%
衣	646		6	198	0.02991%	537935	81.25%	115	24.06%
輪	647		15	198	0.02991%	538133	81.28%	77	16.11%
待	648		9	197	0.02976%	538330	81.31%	130	27.20%
圍	649		12	196	0.02961%	538526	81.34%	104	21.76%
夫	650		4	196	0.02961%	538722	81.37%	93	19.46%
減	651		12	196	0.02961%	538918	81.40%	88	18.41%
禮	652		17	196	0.02961%	539114	81.43%	72	15.06%
富	653		12	195	0.02945%	539309	81.46%	112	23.43%
圖	654		14	194	0.0293%	539503	81.49%	106	22.18%
終	655		11	194	0.0293%	539697	81.52%	132	27.62%
驗	656		23	194	0.0293%	539891	81.55%	107	22.38%
旅	657		10	193	0.02915%	540084	81.58%	85	17.78%
繼	658		20	193	0.02915%	540277	81.61%	126	26.36%
找	659		7	192	0.029%	540469	81.64%	109	22.80%
標	660		15	192	0.029%	540661	81.66%	95	19.87%
溫	661		13	192	0.029%	540853	81.69%	95	19.87%
坐	662		7	191	0.02885%	541044	81.72%	102	21.34%
鳥	663		11	191	0.02885%	541235	81.75%	45	9.41%
啊	664		11	190	0.0287%	541425	81.78%	89	18.62%
魚	665		11	190	0.0287%	541615	81.81%	55	11.51%
怕	666		8	189	0.02855%	541804	81.84%	102	21.34%
止	667		4	189	0.02855%	541993	81.87%	117	24.48%
稅	668		12	189	0.02855%	542182	81.89%	36	7.53%
裡	669		12	189	0.02855%	542371	81.92%	53	11.09%
修	670		10	188	0.0284%	542559	81.95%	86	17.99%
嗎	671		13	188	0.0284%	542747	81.98%	82	17.15%
委	672		8	188	0.0284%	542935	82.01%	83	17.36%
忘	673		7	188	0.0284%	543123	82.04%	98	20.50%
既	674		9	188	0.0284%	543311	82.07%	112	23.43%
暴	675		15	188	0.0284%	543499	82.09%	75	15.69%
陣	676		9	188	0.0284%	543687	82.12%	86	17.99%
男	677		7	187	0.02825%	543874	82.15%	84	17.57%
階	678		11	187	0.02825%	544061	82.18%	76	15.90%
雲	679		12	187	0.02825%	544248	82.21%	109	22.80%
層	680		15	185	0.02794%	544433	82.23%	103	21.55%
露	681		21	185	0.02794%	544618	82.26%	99	20.71%
堂	682		11	184	0.02779%	544802	82.29%	76	15.90%
誰	683		15	183	0.02764%	544985	82.32%	94	19.67%
奇	684		8	182	0.02749%	545167	82.35%	115	24.06%
急	685		9	182	0.02749%	545349	82.37%	94	19.67%
席	686		10	181	0.02734%	545530	82.40%	64	13.39%
注	687		8	181	0.02734%	545711	82.43%	120	25.10%
陸	688		10	181	0.02734%	545892	82.46%	77	16.11%
樓	689		15	180	0.02719%	546072	82.48%	74	15.48%
密	690		11	179	0.02704%	546251	82.51%	112	23.43%
態	691		14	179	0.02704%	546430	82.54%	100	20.92%
决	692		6	178	0.02689%	546608	82.56%	72	15.06%
汽	693		7	177	0.02674%	546785	82.59%	60	12.55%
途	694		10	177	0.02674%	546962	82.62%	108	22.59%
予	695		4	176	0.02658%	547138	82.64%	103	21.55%
廟	696		15	176	0.02658%	547314	82.67%	20	4.18%
投	697		7	176	0.02658%	547490	82.70%	95	19.87%
職	698		18	176	0.02658%	547666	82.72%	95	19.87%
補	699		12	176	0.02658%	547842	82.75%	83	17.36%
族	700		11	175	0.02643%	548017	82.78%	64	13.39%
湖	701		12	175	0.02643%	548192	82.80%	42	8.79%
益	702		10	175	0.02643%	548367	82.83%	88	18.41%
官	703		8	173	0.02613%	548540	82.86%	74	15.48%
懷	704		19	173	0.02613%	548713	82.88%	103	21.55%
擴	705		18	173	0.02613%	548886	82.91%	73	15.27%
積	706		16	173	0.02613%	549059	82.93%	101	21.13%
缺	707		10	173	0.02613%	549232	82.96%	100	20.92%
型	708		9	172	0.02598%	549404	82.99%	70	14.64%
慢	709		14	172	0.02598%	549576	83.01%	69	14.44%
浪	710		10	172	0.02598%	549748	83.04%	87	18.20%
素	711		10	172	0.02598%	549920	83.06%	89	18.62%
臨	712		17	172	0.02598%	550092	83.09%	126	26.36%
茶	713		10	172	0.02598%	550264	83.12%	37	7.74%
尤	714		4	171	0.02583%	550435	83.14%	120	25.10%
腳	715		13	171	0.02583%	550606	83.17%	90	18.83%
仰	716		6	169	0.02553%	550775	83.19%	61	12.76%
效	717		10	169	0.02553%	550944	83.22%	97	20.29%
災	718		7	169	0.02553%	551113	83.24%	30	6.28%
烈	719		10	169	0.02553%	551282	83.27%	95	19.87%
創	720		12	168	0.02538%	551450	83.29%	92	19.25%
固	721		8	168	0.02538%	551618	83.32%	94	19.67%
爾	722		14	168	0.02538%	551786	83.35%	58	12.13%
異	723		11	168	0.02538%	551954	83.37%	108	22.59%
促	724		9	167	0.02522%	552121	83.40%	92	19.25%
派	725		9	167	0.02522%	552288	83.42%	78	16.32%
築	726		16	167	0.02522%	552455	83.45%	88	18.41%
系	727		7	167	0.02522%	552622	83.47%	62	12.97%
錢	728		16	167	0.02522%	552789	83.50%	92	19.25%
預	729		13	166	0.02507%	552955	83.52%	87	18.20%
弱	730		10	165	0.02492%	553120	83.55%	68	14.23%
營	731		17	165	0.02492%	553285	83.57%	79	16.53%
策	732		12	165	0.02492%	553450	83.60%	77	16.11%
彩	733		11	164	0.02477%	553614	83.62%	64	13.39%
旁	734		10	164	0.02477%	553778	83.65%	100	20.92%
號	735		13	164	0.02477%	553942	83.67%	79	16.53%
幣	736		14	163	0.02462%	554105	83.70%	28	5.86%
江	737		6	163	0.02462%	554268	83.72%	76	15.90%
細	738		11	163	0.02462%	554431	83.74%	107	22.38%
散	739		12	162	0.02447%	554593	83.77%	97	20.29%
窗	740		12	162	0.02447%	554755	83.79%	71	14.85%
送	741		9	161	0.02432%	554916	83.82%	89	18.62%
顧	742		21	161	0.02432%	555077	83.84%	114	23.85%
婦	743		11	160	0.02417%	555237	83.87%	51	10.67%
尋	744		12	160	0.02417%	555397	83.89%	107	22.38%
短	745		12	160	0.02417%	555557	83.91%	92	19.25%
迫	746		8	160	0.02417%	555717	83.94%	96	20.08%
勝	747		12	159	0.02402%	555876	83.96%	93	19.46%
呼	748		8	159	0.02402%	556035	83.99%	102	21.34%
採	749		11	159	0.02402%	556194	84.01%	100	20.92%
敬	750		13	159	0.02402%	556353	84.04%	47	9.83%
構	751		14	159	0.02402%	556512	84.06%	85	17.78%
款	752		12	159	0.02402%	556671	84.08%	65	13.60%
繁	753		17	159	0.02402%	556830	84.11%	104	21.76%
億	754		15	158	0.02387%	556988	84.13%	46	9.62%
帝	755		9	158	0.02387%	557146	84.15%	42	8.79%
牠	756		7	158	0.02387%	557304	84.18%	31	6.49%
鐵	757		21	158	0.02387%	557462	84.20%	72	15.06%
倒	758		10	157	0.02371%	557619	84.23%	90	18.83%
句	759		5	157	0.02371%	557776	84.25%	92	19.25%
述	760		8	157	0.02371%	557933	84.27%	100	20.92%
害	761		10	156	0.02356%	558089	84.30%	86	17.99%
擊	762		17	156	0.02356%	558245	84.32%	91	19.04%
暗	763		13	156	0.02356%	558401	84.34%	82	17.15%
講	764		17	156	0.02356%	558557	84.37%	85	17.78%
霧	765		19	156	0.02356%	558713	84.39%	44	9.21%
傷	766		13	155	0.02341%	558868	84.42%	94	19.67%
蘭	767		21	155	0.02341%	559023	84.44%	58	12.13%
宇	768		6	154	0.02326%	559177	84.46%	48	10.04%
財	769		10	154	0.02326%	559331	84.48%	62	12.97%
氏	770		4	153	0.02311%	559484	84.51%	59	12.34%
臉	771		17	153	0.02311%	559637	84.53%	84	17.57%
吸	772		7	152	0.02296%	559789	84.55%	94	19.67%
戲	773		17	152	0.02296%	559941	84.58%	68	14.23%
討	774		10	152	0.02296%	560093	84.60%	86	17.99%
試	775		13	152	0.02296%	560245	84.62%	78	16.32%
超	776		12	152	0.02296%	560397	84.65%	80	16.74%
列	777		6	151	0.02281%	560548	84.67%	93	19.46%
博	778		12	151	0.02281%	560699	84.69%	54	11.30%
普	779		12	151	0.02281%	560850	84.71%	72	15.06%
橋	780		16	151	0.02281%	561001	84.74%	48	10.04%
線	781		15	151	0.02281%	561152	84.76%	82	17.15%
背	782		9	151	0.02281%	561303	84.78%	80	16.74%
輸	783		16	151	0.02281%	561454	84.81%	58	12.13%
壞	784		19	150	0.02266%	561604	84.83%	87	18.20%
岸	785		8	150	0.02266%	561754	84.85%	60	12.55%
追	786		9	150	0.02266%	561904	84.87%	87	18.20%
俗	787		9	149	0.02251%	562053	84.90%	55	11.51%
悲	788		12	149	0.02251%	562202	84.92%	82	17.15%
源	789		13	149	0.02251%	562351	84.94%	73	15.27%
衛	790		15	149	0.02251%	562500	84.96%	81	16.95%
頂	791		11	149	0.02251%	562649	84.99%	68	14.23%
幼	792		5	148	0.02235%	562797	85.01%	50	10.46%
弟	793		7	148	0.02235%	562945	85.03%	49	10.25%
激	794		16	148	0.02235%	563093	85.05%	95	19.87%
簡	795		18	148	0.02235%	563241	85.08%	86	17.99%
隊	796		11	148	0.02235%	563389	85.10%	55	11.51%
勞	797		12	147	0.0222%	563536	85.12%	93	19.46%
响	798		9	147	0.0222%	563683	85.14%	75	15.69%
尚	799		8	147	0.0222%	563830	85.16%	94	19.67%
沙	800		7	147	0.0222%	563977	85.19%	76	15.90%
鬥	801		10	147	0.0222%	564124	85.21%	69	14.44%
亂	802		13	146	0.02205%	564270	85.23%	80	16.74%
徒	803		10	146	0.02205%	564416	85.25%	55	11.51%
涼	804		11	146	0.02205%	564562	85.28%	76	15.90%
買	805		12	146	0.02205%	564708	85.30%	72	15.06%
凡	806		3	145	0.0219%	564853	85.32%	80	16.74%
伯	807		7	145	0.0219%	564998	85.34%	38	7.95%
僅	808		13	145	0.0219%	565143	85.36%	88	18.41%
幸	809		8	145	0.0219%	565288	85.38%	90	18.83%
爸	810		8	145	0.0219%	565433	85.41%	16	3.35%
登	811		12	145	0.0219%	565578	85.43%	74	15.48%
祇	812		8	145	0.0219%	565723	85.45%	61	12.76%
亮	813		9	144	0.02175%	565867	85.47%	80	16.74%
佈	814		7	144	0.02175%	566011	85.49%	82	17.15%
協	815		8	144	0.02175%	566155	85.52%	86	17.99%
案	816		10	144	0.02175%	566299	85.54%	78	16.32%
油	817		8	144	0.02175%	566443	85.56%	68	14.23%
祖	818		9	144	0.02175%	566587	85.58%	57	11.92%
乃	819		2	143	0.0216%	566730	85.60%	64	13.39%
偉	820		11	143	0.0216%	566873	85.62%	65	13.60%
夏	821		10	143	0.0216%	567016	85.65%	79	16.53%
康	822		11	143	0.0216%	567159	85.67%	66	13.81%
維	823		14	143	0.0216%	567302	85.69%	81	16.95%
賞	824		15	143	0.0216%	567445	85.71%	68	14.23%
佔	825		7	141	0.0213%	567586	85.73%	77	16.11%
搖	826		13	141	0.0213%	567727	85.75%	82	17.15%
植	827		12	141	0.0213%	567868	85.77%	44	9.21%
歐	828		15	141	0.0213%	568009	85.80%	54	11.30%
午	829		4	140	0.02115%	568149	85.82%	81	16.95%
隻	830		10	140	0.02115%	568289	85.84%	69	14.44%
互	831		4	139	0.021%	568428	85.86%	72	15.06%
付	832		5	139	0.021%	568567	85.88%	86	17.99%
差	833		10	139	0.021%	568706	85.90%	91	19.04%
血	834		6	139	0.021%	568845	85.92%	77	16.11%
逐	835		10	139	0.021%	568984	85.94%	91	19.04%
防	836		6	139	0.021%	569123	85.96%	65	13.60%
俄	837		9	138	0.02084%	569261	85.98%	11	2.30%
堅	838		11	138	0.02084%	569399	86.01%	87	18.20%
田	839		5	138	0.02084%	569537	86.03%	72	15.06%
督	840		13	138	0.02084%	569675	86.05%	50	10.46%
答	841		12	138	0.02084%	569813	86.07%	76	15.90%
享	842		8	137	0.02069%	569950	86.09%	93	19.46%
括	843		9	137	0.02069%	570087	86.11%	87	18.20%
查	844		9	137	0.02069%	570224	86.13%	71	14.85%
盛	845		11	137	0.02069%	570361	86.15%	91	19.04%
紙	846		10	137	0.02069%	570498	86.17%	78	16.32%
聞	847		14	137	0.02069%	570635	86.19%	71	14.85%
季	848		8	136	0.02054%	570771	86.21%	67	14.02%
察	849		14	136	0.02054%	570907	86.23%	76	15.90%
換	850		12	136	0.02054%	571043	86.25%	83	17.36%
揚	851		12	136	0.02054%	571179	86.27%	70	14.64%
欣	852		8	136	0.02054%	571315	86.30%	69	14.44%
配	853		10	136	0.02054%	571451	86.32%	80	16.74%
怪	854		8	135	0.02039%	571586	86.34%	89	18.62%
榮	855		14	135	0.02039%	571721	86.36%	87	18.20%
羅	856		19	135	0.02039%	571856	86.38%	65	13.60%
舞	857		14	135	0.02039%	571991	86.40%	79	16.53%
迷	858		9	135	0.02039%	572126	86.42%	75	15.69%
克	859		7	134	0.02024%	572260	86.44%	68	14.23%
彼	860		8	134	0.02024%	572394	86.46%	67	14.02%
證	861		19	134	0.02024%	572528	86.48%	87	18.20%
雙	862		18	134	0.02024%	572662	86.50%	87	18.20%
于	863		3	133	0.02009%	572795	86.52%	34	7.11%
尼	864		5	133	0.02009%	572928	86.54%	49	10.25%
波	865		8	133	0.02009%	573061	86.56%	81	16.95%
省	866		9	133	0.02009%	573194	86.58%	58	12.13%
透	867		10	133	0.02009%	573327	86.60%	89	18.62%
驚	868		23	133	0.02009%	573460	86.62%	90	18.83%
壓	869		17	132	0.01994%	573592	86.64%	80	16.74%
志	870		7	132	0.01994%	573724	86.66%	72	15.06%
塊	871		13	131	0.01979%	573855	86.68%	64	13.39%
渡	872		12	131	0.01979%	573986	86.70%	59	12.34%
雜	873		18	131	0.01979%	574117	86.72%	83	17.36%
齒	874		15	131	0.01979%	574248	86.74%	21	4.39%
左	875		5	130	0.01964%	574378	86.76%	74	15.48%
排	876		11	130	0.01964%	574508	86.78%	83	17.36%
狀	877		8	130	0.01964%	574638	86.80%	72	15.06%
孤	878		8	129	0.01948%	574767	86.82%	61	12.76%
淡	879		11	129	0.01948%	574896	86.84%	69	14.44%
移	880		11	129	0.01948%	575025	86.86%	63	13.18%
隧	881		15	129	0.01948%	575154	86.87%	14	2.93%
載	882		13	128	0.01933%	575282	86.89%	80	16.74%
默	883		16	128	0.01933%	575410	86.91%	70	14.64%
熟	884		15	127	0.01918%	575537	86.93%	78	16.32%
况	885		7	126	0.01903%	575663	86.95%	70	14.64%
宣	886		9	126	0.01903%	575789	86.97%	70	14.64%
布	887		5	126	0.01903%	575915	86.99%	63	13.18%
戶	888		4	126	0.01903%	576041	87.01%	56	11.72%
狂	889		7	126	0.01903%	576167	87.03%	70	14.64%
突	890		9	126	0.01903%	576293	87.05%	83	17.36%
課	891		15	126	0.01903%	576419	87.07%	69	14.44%
麻	892		11	126	0.01903%	576545	87.09%	67	14.02%
威	893		9	125	0.01888%	576670	87.10%	69	14.44%
替	894		12	125	0.01888%	576795	87.12%	80	16.74%
訴	895		12	125	0.01888%	576920	87.14%	82	17.15%
避	896		16	125	0.01888%	577045	87.16%	88	18.41%
靠	897		15	125	0.01888%	577170	87.18%	83	17.36%
模	898		15	124	0.01873%	577294	87.20%	88	18.41%
歸	899		18	124	0.01873%	577418	87.22%	83	17.36%
略	900		11	124	0.01873%	577542	87.24%	74	15.48%
範	901		15	124	0.01873%	577666	87.25%	72	15.06%
綫	902		14	124	0.01873%	577790	87.27%	49	10.25%
縣	903		16	124	0.01873%	577914	87.29%	25	5.23%
護	904		21	124	0.01873%	578038	87.31%	75	15.69%
迎	905		7	124	0.01873%	578162	87.33%	89	18.62%
荒	906		10	123	0.01858%	578285	87.35%	72	15.06%
律	907		9	122	0.01843%	578407	87.37%	72	15.06%
敦	908		12	122	0.01843%	578529	87.38%	36	7.53%
訓	909		10	122	0.01843%	578651	87.40%	53	11.09%
雪	910		11	122	0.01843%	578773	87.42%	52	10.88%
飄	911		20	122	0.01843%	578895	87.44%	63	13.18%
媽	912		13	121	0.01828%	579016	87.46%	24	5.02%
店	913		8	121	0.01828%	579137	87.48%	54	11.30%
淚	914		11	121	0.01828%	579258	87.49%	56	11.72%
王	915		4	121	0.01828%	579379	87.51%	50	10.46%
練	916		15	121	0.01828%	579500	87.53%	53	11.09%
附	917		7	121	0.01828%	579621	87.55%	83	17.36%
優	918		17	120	0.01813%	579741	87.57%	79	16.53%
尺	919		4	120	0.01813%	579861	87.59%	46	9.62%
忽	920		8	120	0.01813%	579981	87.60%	79	16.53%
慮	921		15	120	0.01813%	580101	87.62%	75	15.69%
拿	922		10	120	0.01813%	580221	87.64%	80	16.74%
漢	923		14	120	0.01813%	580341	87.66%	36	7.53%
潮	924		15	120	0.01813%	580461	87.68%	71	14.85%
牌	925		12	120	0.01813%	580581	87.69%	45	9.41%
喝	926		12	119	0.01797%	580700	87.71%	32	6.70%
干	927		3	119	0.01797%	580819	87.73%	72	15.06%
玩	928		8	119	0.01797%	580938	87.75%	59	12.34%
紛	929		10	119	0.01797%	581057	87.77%	67	14.02%
誠	930		13	119	0.01797%	581176	87.78%	79	16.53%
倫	931		10	118	0.01782%	581294	87.80%	46	9.62%
廿	932		4	118	0.01782%	581412	87.82%	63	13.18%
承	933		8	118	0.01782%	581530	87.84%	75	15.69%
遍	934		12	118	0.01782%	581648	87.86%	76	15.90%
端	935		14	117	0.01767%	581765	87.87%	73	15.27%
險	936		15	117	0.01767%	581882	87.89%	69	14.44%
亡	937		3	116	0.01752%	581998	87.91%	55	11.51%
寶	938		20	116	0.01752%	582114	87.93%	65	13.60%
祗	939		9	116	0.01752%	582230	87.94%	51	10.67%
群	940		13	116	0.01752%	582346	87.96%	58	12.13%
遇	941		12	116	0.01752%	582462	87.98%	75	15.69%
髮	942		15	116	0.01752%	582578	88.00%	54	11.30%
守	943		6	115	0.01737%	582693	88.01%	63	13.18%
寂	944		11	115	0.01737%	582808	88.03%	69	14.44%
材	945		7	115	0.01737%	582923	88.05%	57	11.92%
零	946		13	115	0.01737%	583038	88.07%	72	15.06%
室	947		9	114	0.01722%	583152	88.08%	64	13.39%
睡	948		14	114	0.01722%	583266	88.10%	56	11.72%
聖	949		13	114	0.01722%	583380	88.12%	57	11.92%
乏	950		5	113	0.01707%	583493	88.13%	69	14.44%
乘	951		10	113	0.01707%	583606	88.15%	61	12.76%
塘	952		13	113	0.01707%	583719	88.17%	34	7.11%
巨	953		5	113	0.01707%	583832	88.19%	58	12.13%
藥	954		19	113	0.01707%	583945	88.20%	55	11.51%
錯	955		16	113	0.01707%	584058	88.22%	74	15.48%
厚	956		9	112	0.01692%	584170	88.24%	74	15.48%
寒	957		12	112	0.01692%	584282	88.25%	66	13.81%
射	958		10	112	0.01692%	584394	88.27%	52	10.88%
敢	959		12	112	0.01692%	584506	88.29%	80	16.74%
牙	960		4	112	0.01692%	584618	88.30%	37	7.74%
率	961		11	112	0.01692%	584730	88.32%	55	11.51%
股	962		8	112	0.01692%	584842	88.34%	47	9.83%
謝	963		17	112	0.01692%	584954	88.36%	48	10.04%
乾	964		11	111	0.01677%	585065	88.37%	69	14.44%
欲	965		11	111	0.01677%	585176	88.39%	66	13.81%
仙	966		5	110	0.01662%	585286	88.41%	37	7.74%
奔	967		8	110	0.01662%	585396	88.42%	69	14.44%
忙	968		6	110	0.01662%	585506	88.44%	66	13.81%
慈	969		13	110	0.01662%	585616	88.46%	38	7.95%
畢	970		11	110	0.01662%	585726	88.47%	65	13.60%
貴	971		12	110	0.01662%	585836	88.49%	85	17.78%
冬	972		5	109	0.01646%	585945	88.50%	55	11.51%
橫	973		16	109	0.01646%	586054	88.52%	73	15.27%
珠	974		10	109	0.01646%	586163	88.54%	59	12.34%
私	975		7	109	0.01646%	586272	88.55%	69	14.44%
穿	976		9	109	0.01646%	586381	88.57%	69	14.44%
健	977		11	108	0.01631%	586489	88.59%	60	12.55%
努	978		7	108	0.01631%	586597	88.60%	63	13.18%
周	979		8	108	0.01631%	586705	88.62%	70	14.64%
床	980		7	108	0.01631%	586813	88.64%	52	10.88%
授	981		11	108	0.01631%	586921	88.65%	47	9.83%
況	982		8	108	0.01631%	587029	88.67%	67	14.02%
衝	983		15	108	0.01631%	587137	88.68%	63	13.18%
降	984		8	108	0.01631%	587245	88.70%	62	12.97%
鼓	985		13	108	0.01631%	587353	88.72%	69	14.44%
徵	986		15	107	0.01616%	587460	88.73%	62	12.97%
李	987		7	107	0.01616%	587567	88.75%	50	10.46%
某	988		9	107	0.01616%	587674	88.77%	68	14.23%
銷	989		15	107	0.01616%	587781	88.78%	43	9.00%
屆	990		8	106	0.01601%	587887	88.80%	42	8.79%
崇	991		11	106	0.01601%	587993	88.81%	50	10.46%
滅	992		13	106	0.01601%	588099	88.83%	64	13.39%
納	993		10	106	0.01601%	588205	88.85%	72	15.06%
茫	994		10	106	0.01601%	588311	88.86%	50	10.46%
强	995		12	105	0.01586%	588416	88.88%	69	14.44%
擁	996		16	105	0.01586%	588521	88.89%	71	14.85%
陳	997		10	105	0.01586%	588626	88.91%	56	11.72%
館	998		16	105	0.01586%	588731	88.93%	47	9.83%
尊	999		12	104	0.01571%	588835	88.94%	59	12.34%
殘	1000		12	104	0.01571%	588939	88.96%	68	14.23%
疑	1001		14	104	0.01571%	589043	88.97%	74	15.48%
仔	1002		5	103	0.01556%	589146	88.99%	41	8.58%
孔	1003		4	103	0.01556%	589249	89.00%	57	11.92%
枝	1004		8	103	0.01556%	589352	89.02%	64	13.39%
架	1005		9	103	0.01556%	589455	89.04%	54	11.30%
毫	1006		11	103	0.01556%	589558	89.05%	77	16.11%
皆	1007		9	103	0.01556%	589661	89.07%	53	11.09%
耳	1008		6	103	0.01556%	589764	89.08%	74	15.48%
肯	1009		8	103	0.01556%	589867	89.10%	67	14.02%
遺	1010		15	103	0.01556%	589970	89.11%	74	15.48%
闊	1011		17	103	0.01556%	590073	89.13%	59	12.34%
劇	1012		15	102	0.01541%	590175	89.14%	59	12.34%
唯	1013		11	102	0.01541%	590277	89.16%	62	12.97%
壁	1014		16	102	0.01541%	590379	89.17%	42	8.79%
娛	1015		10	102	0.01541%	590481	89.19%	29	6.07%
州	1016		6	102	0.01541%	590583	89.21%	46	9.62%
批	1017		7	102	0.01541%	590685	89.22%	69	14.44%
洗	1018		9	102	0.01541%	590787	89.24%	51	10.67%
莫	1019		11	102	0.01541%	590889	89.25%	66	13.81%
跑	1020		12	102	0.01541%	590991	89.27%	53	11.09%
抗	1021		7	101	0.01526%	591092	89.28%	55	11.51%
概	1022		13	101	0.01526%	591193	89.30%	75	15.69%
牆	1023		17	101	0.01526%	591294	89.31%	43	9.00%
皇	1024		9	101	0.01526%	591395	89.33%	39	8.16%
鐘	1025		20	101	0.01526%	591496	89.34%	57	11.92%
惜	1026		11	100	0.0151%	591596	89.36%	75	15.69%
愈	1027		13	100	0.0151%	591696	89.37%	42	8.79%
班	1028		10	100	0.0151%	591796	89.39%	57	11.92%
豐	1029		18	100	0.0151%	591896	89.40%	70	14.64%
遷	1030		14	100	0.0151%	591996	89.42%	49	10.25%
額	1031		18	100	0.0151%	592096	89.43%	50	10.46%
右	1032		5	99	0.01495%	592195	89.45%	59	12.34%
昏	1033		8	99	0.01495%	592294	89.46%	64	13.39%
輛	1034		15	99	0.01495%	592393	89.48%	38	7.95%
吹	1035		7	98	0.0148%	592491	89.49%	66	13.81%
執	1036		11	98	0.0148%	592589	89.51%	60	12.55%
担	1037		8	98	0.0148%	592687	89.52%	54	11.30%
睛	1038		13	98	0.0148%	592785	89.54%	62	12.97%
警	1039		20	98	0.0148%	592883	89.55%	42	8.79%
伸	1040		7	97	0.01465%	592980	89.57%	70	14.64%
剛	1041		10	97	0.01465%	593077	89.58%	66	13.81%
婆	1042		11	97	0.01465%	593174	89.60%	29	6.07%
朝	1043		12	97	0.01465%	593271	89.61%	62	12.97%
狗	1044		8	97	0.01465%	593368	89.63%	33	6.90%
純	1045		10	97	0.01465%	593465	89.64%	64	13.39%
趨	1046		17	97	0.01465%	593562	89.66%	55	11.51%
隔	1047		12	97	0.01465%	593659	89.67%	65	13.60%
彷	1048		7	96	0.0145%	593755	89.68%	54	11.30%
彿	1049		8	96	0.0145%	593851	89.70%	54	11.30%
朵	1050		6	96	0.0145%	593947	89.71%	50	10.46%
楚	1051		13	96	0.0145%	594043	89.73%	63	13.18%
洞	1052		9	96	0.0145%	594139	89.74%	34	7.11%
混	1053		11	96	0.0145%	594235	89.76%	58	12.13%
趕	1054		14	96	0.0145%	594331	89.77%	60	12.55%
皮	1055		5	95	0.01435%	594426	89.79%	69	14.44%
章	1056		11	95	0.01435%	594521	89.80%	51	10.67%
鬧	1057		15	95	0.01435%	594616	89.81%	53	11.09%
智	1058		12	94	0.0142%	594710	89.83%	51	10.67%
貧	1059		11	94	0.0142%	594804	89.84%	60	12.55%
雄	1060		12	94	0.0142%	594898	89.86%	56	11.72%
齊	1061		14	94	0.0142%	594992	89.87%	59	12.34%
票	1062		11	93	0.01405%	595085	89.89%	44	9.21%
腦	1063		13	93	0.01405%	595178	89.90%	64	13.39%
跳	1064		13	93	0.01405%	595271	89.91%	61	12.76%
妳	1065		8	92	0.0139%	595363	89.93%	23	4.81%
封	1066		9	92	0.0139%	595455	89.94%	48	10.04%
廈	1067		13	92	0.0139%	595547	89.96%	46	9.62%
擠	1068		17	92	0.0139%	595639	89.97%	51	10.67%
昨	1069		9	92	0.0139%	595731	89.98%	67	14.02%
檢	1070		17	92	0.0139%	595823	90.00%	55	11.51%
沿	1071		8	92	0.0139%	595915	90.01%	54	11.30%
租	1072		10	92	0.0139%	596007	90.02%	38	7.95%
罷	1073		15	92	0.0139%	596099	90.04%	54	11.30%
觸	1074		20	92	0.0139%	596191	90.05%	65	13.60%
刊	1075		5	91	0.01375%	596282	90.07%	42	8.79%
岡	1076		8	91	0.01375%	596373	90.08%	17	3.56%
憶	1077		16	91	0.01375%	596464	90.09%	60	12.55%
晨	1078		11	91	0.01375%	596555	90.11%	69	14.44%
曲	1079		6	91	0.01375%	596646	90.12%	58	12.13%
潔	1080		15	91	0.01375%	596737	90.14%	57	11.92%
緩	1081		15	91	0.01375%	596828	90.15%	47	9.83%
羣	1082		13	91	0.01375%	596919	90.16%	54	11.30%
虛	1083		12	91	0.01375%	597010	90.18%	59	12.34%
針	1084		10	91	0.01375%	597101	90.19%	44	9.21%
儀	1085		15	90	0.01359%	597191	90.20%	33	6.90%
圓	1086		13	90	0.01359%	597281	90.22%	54	11.30%
寄	1087		11	90	0.01359%	597371	90.23%	48	10.04%
序	1088		7	90	0.01359%	597461	90.24%	56	11.72%
恐	1089		10	90	0.01359%	597551	90.26%	62	12.97%
拜	1090		9	90	0.01359%	597641	90.27%	38	7.95%
滑	1091		13	90	0.01359%	597731	90.29%	31	6.49%
烟	1092		10	90	0.01359%	597821	90.30%	43	9.00%
獻	1093		20	90	0.01359%	597911	90.31%	68	14.23%
盾	1094		9	90	0.01359%	598001	90.33%	29	6.07%
肉	1095		6	90	0.01359%	598091	90.34%	40	8.37%
退	1096		9	90	0.01359%	598181	90.35%	60	12.55%
醒	1097		16	90	0.01359%	598271	90.37%	65	13.60%
頓	1098		13	90	0.01359%	598361	90.38%	61	12.76%
升	1099		4	89	0.01344%	598450	90.39%	59	12.34%
濕	1100		17	89	0.01344%	598539	90.41%	34	7.11%
署	1101		13	89	0.01344%	598628	90.42%	35	7.32%
翻	1102		18	89	0.01344%	598717	90.43%	67	14.02%
遭	1103		14	89	0.01344%	598806	90.45%	63	13.18%
京	1104		8	88	0.01329%	598894	90.46%	30	6.28%
傾	1105		13	88	0.01329%	598982	90.47%	56	11.72%
抵	1106		8	88	0.01329%	599070	90.49%	66	13.81%
泥	1107		8	88	0.01329%	599158	90.50%	46	9.62%
牛	1108		4	88	0.01329%	599246	90.51%	48	10.04%
矛	1109		5	88	0.01329%	599334	90.53%	27	5.65%
週	1110		11	88	0.01329%	599422	90.54%	60	12.55%
宜	1111		8	87	0.01314%	599509	90.55%	57	11.92%
寬	1112		15	87	0.01314%	599596	90.57%	58	12.13%
尖	1113		6	87	0.01314%	599683	90.58%	46	9.62%
幕	1114		14	87	0.01314%	599770	90.59%	54	11.30%
慣	1115		14	87	0.01314%	599857	90.61%	57	11.92%
憂	1116		15	87	0.01314%	599944	90.62%	60	12.55%
措	1117		11	87	0.01314%	600031	90.63%	44	9.21%
揮	1118		12	87	0.01314%	600118	90.65%	58	12.13%
損	1119		13	87	0.01314%	600205	90.66%	51	10.67%
硬	1120		12	87	0.01314%	600292	90.67%	43	9.00%
窮	1121		15	87	0.01314%	600379	90.69%	57	11.92%
篇	1122		15	87	0.01314%	600466	90.70%	39	8.16%
逃	1123		9	87	0.01314%	600553	90.71%	55	11.51%
鋼	1124		16	87	0.01314%	600640	90.72%	28	5.86%
儘	1125		16	86	0.01299%	600726	90.74%	70	14.64%
副	1126		11	86	0.01299%	600812	90.75%	59	12.34%
幹	1127		13	86	0.01299%	600898	90.76%	56	11.72%
抱	1128		8	86	0.01299%	600984	90.78%	63	13.18%
毒	1129		9	86	0.01299%	601070	90.79%	28	5.86%
爬	1130		8	86	0.01299%	601156	90.80%	46	9.62%
盤	1131		15	86	0.01299%	601242	90.82%	49	10.25%
粉	1132		10	86	0.01299%	601328	90.83%	44	9.21%
胡	1133		9	86	0.01299%	601414	90.84%	29	6.07%
企	1134		6	85	0.01284%	601499	90.85%	33	6.90%
僑	1135		14	85	0.01284%	601584	90.87%	28	5.86%
啟	1136		11	85	0.01284%	601669	90.88%	48	10.04%
坡	1137		8	85	0.01284%	601754	90.89%	45	9.41%
寧	1138		14	85	0.01284%	601839	90.91%	63	13.18%
掉	1139		11	85	0.01284%	601924	90.92%	66	13.81%
板	1140		8	85	0.01284%	602009	90.93%	50	10.46%
蓋	1141		14	85	0.01284%	602094	90.94%	53	11.09%
諸	1142		15	85	0.01284%	602179	90.96%	52	10.88%
折	1143		7	84	0.01269%	602263	90.97%	59	12.34%
招	1144		8	84	0.01269%	602347	90.98%	64	13.39%
閃	1145		10	84	0.01269%	602431	91.00%	51	10.67%
駛	1146		15	84	0.01269%	602515	91.01%	35	7.32%
測	1147		12	83	0.01254%	602598	91.02%	42	8.79%
潤	1148		15	83	0.01254%	602681	91.03%	43	9.00%
禁	1149		13	83	0.01254%	602764	91.05%	66	13.81%
縮	1150		17	83	0.01254%	602847	91.06%	52	10.88%
頗	1151		14	83	0.01254%	602930	91.07%	64	13.39%
顆	1152		17	83	0.01254%	603013	91.08%	44	9.21%
飯	1153		12	83	0.01254%	603096	91.10%	52	10.88%
套	1154		10	82	0.01239%	603178	91.11%	50	10.46%
煩	1155		13	82	0.01239%	603260	91.12%	50	10.46%
訂	1156		9	82	0.01239%	603342	91.13%	47	9.83%
購	1157		17	82	0.01239%	603424	91.15%	44	9.21%
佛	1158		7	81	0.01223%	603505	91.16%	26	5.44%
戀	1159		23	81	0.01223%	603586	91.17%	42	8.79%
探	1160		11	81	0.01223%	603667	91.18%	52	10.88%
敗	1161		11	81	0.01223%	603748	91.19%	46	9.62%
斜	1162		11	81	0.01223%	603829	91.21%	46	9.62%
碎	1163		13	81	0.01223%	603910	91.22%	53	11.09%
域	1164		11	80	0.01208%	603990	91.23%	55	11.51%
嫂	1165		12	80	0.01208%	604070	91.24%	4	0.84%
漫	1166		14	80	0.01208%	604150	91.25%	58	12.13%
甘	1167		5	80	0.01208%	604230	91.27%	46	9.62%
碼	1168		15	80	0.01208%	604310	91.28%	34	7.11%
陰	1169		10	80	0.01208%	604390	91.29%	59	12.34%
偏	1170		11	79	0.01193%	604469	91.30%	43	9.00%
謀	1171		16	79	0.01193%	604548	91.31%	53	11.09%
貿	1172		12	79	0.01193%	604627	91.33%	27	5.65%
踏	1173		15	79	0.01193%	604706	91.34%	56	11.72%
休	1174		6	78	0.01178%	604784	91.35%	50	10.46%
勵	1175		17	78	0.01178%	604862	91.36%	59	12.34%
哲	1176		10	78	0.01178%	604940	91.37%	30	6.28%
峽	1177		10	78	0.01178%	605018	91.39%	14	2.93%
嶺	1178		17	78	0.01178%	605096	91.40%	34	7.11%
托	1179		6	78	0.01178%	605174	91.41%	28	5.86%
末	1180		5	78	0.01178%	605252	91.42%	57	11.92%
染	1181		9	78	0.01178%	605330	91.43%	54	11.30%
殺	1182		11	78	0.01178%	605408	91.44%	45	9.41%
燒	1183		16	78	0.01178%	605486	91.46%	33	6.90%
磨	1184		16	78	0.01178%	605564	91.47%	44	9.21%
竹	1185		6	78	0.01178%	605642	91.48%	41	8.58%
脫	1186		11	78	0.01178%	605720	91.49%	58	12.13%
阻	1187		7	78	0.01178%	605798	91.50%	62	12.97%
哀	1188		9	77	0.01163%	605875	91.52%	57	11.92%
孝	1189		7	77	0.01163%	605952	91.53%	18	3.77%
握	1190		12	77	0.01163%	606029	91.54%	52	10.88%
暖	1191		13	77	0.01163%	606106	91.55%	53	11.09%
森	1192		12	77	0.01163%	606183	91.56%	33	6.90%
蒼	1193		14	77	0.01163%	606260	91.57%	52	10.88%
埔	1194		10	76	0.01148%	606336	91.58%	15	3.14%
憑	1195		16	76	0.01148%	606412	91.60%	53	11.09%
杜	1196		7	76	0.01148%	606488	91.61%	26	5.44%
武	1197		8	76	0.01148%	606564	91.62%	40	8.37%
漁	1198		14	76	0.01148%	606640	91.63%	33	6.90%
爛	1199		21	76	0.01148%	606716	91.64%	58	12.13%
胞	1200		9	76	0.01148%	606792	91.65%	36	7.53%
航	1201		10	76	0.01148%	606868	91.67%	34	7.11%
藏	1202		18	76	0.01148%	606944	91.68%	53	11.09%
佳	1203		8	75	0.01133%	607019	91.69%	48	10.04%
偶	1204		11	75	0.01133%	607094	91.70%	63	13.18%
君	1205		7	75	0.01133%	607169	91.71%	51	10.67%
掌	1206		12	75	0.01133%	607244	91.72%	46	9.62%
濃	1207		16	75	0.01133%	607319	91.73%	56	11.72%
賣	1208		15	75	0.01133%	607394	91.74%	47	9.83%
釋	1209		20	75	0.01133%	607469	91.76%	50	10.46%
飲	1210		12	75	0.01133%	607544	91.77%	42	8.79%
餐	1211		16	75	0.01133%	607619	91.78%	46	9.62%
鮮	1212		17	75	0.01133%	607694	91.79%	58	12.13%
吾	1213		7	74	0.01118%	607768	91.80%	26	5.44%
呀	1214		7	74	0.01118%	607842	91.81%	37	7.74%
堆	1215		11	74	0.01118%	607916	91.82%	46	9.62%
姐	1216		8	74	0.01118%	607990	91.83%	27	5.65%
窰	1217		15	74	0.01118%	608064	91.85%	1	0.21%
游	1218		12	74	0.01118%	608138	91.86%	46	9.62%
罪	1219		13	74	0.01118%	608212	91.87%	33	6.90%
藍	1220		18	74	0.01118%	608286	91.88%	58	12.13%
閒	1221		12	74	0.01118%	608360	91.89%	41	8.58%
幫	1222		17	73	0.01103%	608433	91.90%	50	10.46%
糧	1223		18	73	0.01103%	608506	91.91%	28	5.86%
縱	1224		17	73	0.01103%	608579	91.92%	53	11.09%
菜	1225		12	73	0.01103%	608652	91.93%	40	8.37%
鎮	1226		18	73	0.01103%	608725	91.95%	39	8.16%
匆	1227		5	72	0.01088%	608797	91.96%	32	6.70%
按	1228		9	72	0.01088%	608869	91.97%	47	9.83%
控	1229		11	72	0.01088%	608941	91.98%	43	9.00%
搭	1230		13	72	0.01088%	609013	91.99%	36	7.53%
浮	1231		10	72	0.01088%	609085	92.00%	52	10.88%
盲	1232		8	72	0.01088%	609157	92.01%	20	4.18%
藉	1233		18	72	0.01088%	609229	92.02%	58	12.13%
訪	1234		11	72	0.01088%	609301	92.03%	45	9.41%
谷	1235		7	72	0.01088%	609373	92.04%	29	6.07%
賽	1236		17	72	0.01088%	609445	92.05%	35	7.32%
輝	1237		15	72	0.01088%	609517	92.07%	51	10.67%
鬼	1238		10	72	0.01088%	609589	92.08%	40	8.37%
估	1239		7	71	0.01072%	609660	92.09%	42	8.79%
典	1240		8	71	0.01072%	609731	92.10%	46	9.62%
壯	1241		7	71	0.01072%	609802	92.11%	57	11.92%
幅	1242		12	71	0.01072%	609873	92.12%	48	10.04%
幻	1243		4	71	0.01072%	609944	92.13%	50	10.46%
棄	1244		11	71	0.01072%	610015	92.14%	60	12.55%
炎	1245		8	71	0.01072%	610086	92.15%	31	6.49%
複	1246		14	71	0.01072%	610157	92.16%	49	10.25%
倍	1247		10	70	0.01057%	610227	92.17%	48	10.04%
勇	1248		9	70	0.01057%	610297	92.18%	51	10.67%
妙	1249		7	70	0.01057%	610367	92.19%	57	11.92%
束	1250		7	70	0.01057%	610437	92.20%	52	10.88%
梅	1251		11	70	0.01057%	610507	92.21%	24	5.02%
煙	1252		13	70	0.01057%	610577	92.23%	43	9.00%
秘	1253		10	70	0.01057%	610647	92.24%	45	9.41%
評	1254		12	70	0.01057%	610717	92.25%	41	8.58%
陷	1255		10	70	0.01057%	610787	92.26%	46	9.62%
障	1256		13	70	0.01057%	610857	92.27%	32	6.70%
刺	1257		8	69	0.01042%	610926	92.28%	50	10.46%
叢	1258		18	69	0.01042%	610995	92.29%	44	9.21%
培	1259		11	69	0.01042%	611064	92.30%	43	9.00%
朗	1260		10	69	0.01042%	611133	92.31%	50	10.46%
滴	1261		14	69	0.01042%	611202	92.32%	35	7.32%
澤	1262		16	69	0.01042%	611271	92.33%	32	6.70%
琴	1263		12	69	0.01042%	611340	92.34%	25	5.23%
鏡	1264		19	69	0.01042%	611409	92.35%	38	7.95%
伴	1265		7	68	0.01027%	611477	92.36%	40	8.37%
偷	1266		11	68	0.01027%	611545	92.37%	41	8.58%
婚	1267		11	68	0.01027%	611613	92.38%	35	7.32%
彈	1268		15	68	0.01027%	611681	92.39%	33	6.90%
悶	1269		12	68	0.01027%	611749	92.40%	45	9.41%
拍	1270		8	68	0.01027%	611817	92.41%	43	9.00%
晶	1271		12	68	0.01027%	611885	92.42%	25	5.23%
躍	1272		21	68	0.01027%	611953	92.43%	51	10.67%
迅	1273		6	68	0.01027%	612021	92.44%	49	10.25%
錄	1274		16	68	0.01027%	612089	92.45%	46	9.62%
隱	1275		16	68	0.01027%	612157	92.46%	48	10.04%
冰	1276		6	67	0.01012%	612224	92.47%	39	8.16%
夕	1277		3	67	0.01012%	612291	92.48%	40	8.37%
奮	1278		16	67	0.01012%	612358	92.49%	47	9.83%
悄	1279		10	67	0.01012%	612425	92.50%	28	5.86%
援	1280		12	67	0.01012%	612492	92.51%	31	6.49%
擔	1281		16	67	0.01012%	612559	92.52%	44	9.21%
旋	1282		11	67	0.01012%	612626	92.53%	49	10.25%
灘	1283		22	67	0.01012%	612693	92.55%	26	5.44%
疾	1284		10	67	0.01012%	612760	92.56%	46	9.62%
稍	1285		12	67	0.01012%	612827	92.57%	50	10.46%
遲	1286		15	67	0.01012%	612894	92.58%	51	10.67%
兄	1287		5	66	0.009969%	612960	92.59%	34	7.11%
巧	1288		5	66	0.009969%	613026	92.60%	54	11.30%
戴	1289		17	66	0.009969%	613092	92.61%	36	7.53%
擇	1290		16	66	0.009969%	613158	92.62%	46	9.62%
核	1291		10	66	0.009969%	613224	92.63%	29	6.07%
索	1292		10	66	0.009969%	613290	92.64%	53	11.09%
絲	1293		12	66	0.009969%	613356	92.65%	50	10.46%
跡	1294		13	66	0.009969%	613422	92.66%	53	11.09%
顏	1295		18	66	0.009969%	613488	92.67%	43	9.00%
介	1296		4	65	0.009818%	613553	92.68%	48	10.04%
娘	1297		10	65	0.009818%	613618	92.68%	29	6.07%
孟	1298		8	65	0.009818%	613683	92.69%	21	4.39%
慘	1299		14	65	0.009818%	613748	92.70%	41	8.58%
扶	1300		7	65	0.009818%	613813	92.71%	43	9.00%
擺	1301		18	65	0.009818%	613878	92.72%	49	10.25%
猛	1302		11	65	0.009818%	613943	92.73%	39	8.16%
疏	1303		11	65	0.009818%	614008	92.74%	48	10.04%
緣	1304		15	65	0.009818%	614073	92.75%	53	11.09%
陶	1305		10	65	0.009818%	614138	92.76%	39	8.16%
呎	1306		7	64	0.009667%	614202	92.77%	25	5.23%
含	1307		7	64	0.009667%	614266	92.78%	48	10.04%
忍	1308		7	64	0.009667%	614330	92.79%	51	10.67%
掛	1309		11	64	0.009667%	614394	92.80%	46	9.62%
播	1310		15	64	0.009667%	614458	92.81%	39	8.16%
獅	1311		13	64	0.009667%	614522	92.82%	13	2.72%
症	1312		10	64	0.009667%	614586	92.83%	23	4.81%
療	1313		17	64	0.009667%	614650	92.84%	20	4.18%
覆	1314		18	64	0.009667%	614714	92.85%	46	9.62%
誤	1315		14	64	0.009667%	614778	92.86%	45	9.41%
距	1316		12	64	0.009667%	614842	92.87%	47	9.83%
奏	1317		9	63	0.009516%	614905	92.88%	32	6.70%
懂	1318		17	63	0.009516%	614968	92.89%	47	9.83%
灰	1319		6	63	0.009516%	615031	92.90%	41	8.58%
遙	1320		13	63	0.009516%	615094	92.91%	47	9.83%
順	1321		12	63	0.009516%	615157	92.92%	46	9.62%
兵	1322		7	62	0.009365%	615219	92.93%	40	8.37%
妹	1323		8	62	0.009365%	615281	92.94%	31	6.49%
幽	1324		9	62	0.009365%	615343	92.95%	44	9.21%
彌	1325		17	62	0.009365%	615405	92.95%	26	5.44%
映	1326		9	62	0.009365%	615467	92.96%	54	11.30%
楊	1327		13	62	0.009365%	615529	92.97%	23	4.81%
洛	1328		9	62	0.009365%	615591	92.98%	15	3.14%
淨	1329		11	62	0.009365%	615653	92.99%	33	6.90%
玲	1330		9	62	0.009365%	615715	93.00%	12	2.51%
籠	1331		22	62	0.009365%	615777	93.01%	31	6.49%
莊	1332		11	62	0.009365%	615839	93.02%	34	7.11%
蛇	1333		11	62	0.009365%	615901	93.03%	17	3.56%
詞	1334		12	62	0.009365%	615963	93.04%	50	10.46%
龐	1335		19	62	0.009365%	616025	93.05%	40	8.37%
哈	1336		9	61	0.009214%	616086	93.06%	26	5.44%
寞	1337		14	61	0.009214%	616147	93.07%	41	8.58%
弄	1338		7	61	0.009214%	616208	93.08%	44	9.21%
徑	1339		10	61	0.009214%	616269	93.09%	44	9.21%
拖	1340		8	61	0.009214%	616330	93.09%	36	7.53%
烏	1341		10	61	0.009214%	616391	93.10%	39	8.16%
版	1342		8	61	0.009214%	616452	93.11%	24	5.02%
舍	1343		8	61	0.009214%	616513	93.12%	39	8.16%
舒	1344		12	61	0.009214%	616574	93.13%	44	9.21%
袖	1345		10	61	0.009214%	616635	93.14%	38	7.95%
覽	1346		21	61	0.009214%	616696	93.15%	28	5.86%
閉	1347		11	61	0.009214%	616757	93.16%	37	7.74%
凝	1348		16	60	0.009063%	616817	93.17%	38	7.95%
厭	1349		14	60	0.009063%	616877	93.18%	45	9.41%
哪	1350		10	60	0.009063%	616937	93.19%	39	8.16%
喉	1351		12	60	0.009063%	616997	93.20%	25	5.23%
慶	1352		15	60	0.009063%	617057	93.20%	29	6.07%
憐	1353		15	60	0.009063%	617117	93.21%	43	9.00%
毀	1354		13	60	0.009063%	617177	93.22%	38	7.95%
澳	1355		16	60	0.009063%	617237	93.23%	27	5.65%
競	1356		20	60	0.009063%	617297	93.24%	34	7.11%
符	1357		11	60	0.009063%	617357	93.25%	38	7.95%
繞	1358		18	60	0.009063%	617417	93.26%	39	8.16%
赤	1359		7	60	0.009063%	617477	93.27%	34	7.11%
仁	1360		4	59	0.008912%	617536	93.28%	32	6.70%
侵	1361		9	59	0.008912%	617595	93.29%	34	7.11%
召	1362		5	59	0.008912%	617654	93.29%	34	7.11%
填	1363		13	59	0.008912%	617713	93.30%	30	6.28%
悠	1364		11	59	0.008912%	617772	93.31%	47	9.83%
您	1365		11	59	0.008912%	617831	93.32%	4	0.84%
珍	1366		9	59	0.008912%	617890	93.33%	38	7.95%
籌	1367		20	59	0.008912%	617949	93.34%	36	7.53%
籍	1368		20	59	0.008912%	618008	93.35%	41	8.58%
薄	1369		17	59	0.008912%	618067	93.36%	47	9.83%
蟲	1370		18	59	0.008912%	618126	93.37%	29	6.07%
貼	1371		12	59	0.008912%	618185	93.37%	36	7.53%
辛	1372		7	59	0.008912%	618244	93.38%	42	8.79%
丁	1373		2	58	0.008761%	618302	93.39%	37	7.74%
哭	1374		10	58	0.008761%	618360	93.40%	29	6.07%
獎	1375		15	58	0.008761%	618418	93.41%	30	6.28%
孫	1376		10	58	0.008761%	618476	93.42%	28	5.86%
廳	1377		25	58	0.008761%	618534	93.43%	28	5.86%
患	1378		11	58	0.008761%	618592	93.44%	28	5.86%
抽	1379		8	58	0.008761%	618650	93.44%	43	9.00%
擬	1380		17	58	0.008761%	618708	93.45%	44	9.21%
杯	1381		8	58	0.008761%	618766	93.46%	28	5.86%
淺	1382		11	58	0.008761%	618824	93.47%	38	7.95%
牲	1383		9	58	0.008761%	618882	93.48%	25	5.23%
績	1384		17	58	0.008761%	618940	93.49%	40	8.37%
衰	1385		10	58	0.008761%	618998	93.50%	36	7.53%
輩	1386		15	58	0.008761%	619056	93.51%	33	6.90%
酸	1387		14	58	0.008761%	619114	93.51%	29	6.07%
醉	1388		15	58	0.008761%	619172	93.52%	43	9.00%
騰	1389		20	58	0.008761%	619230	93.53%	44	9.21%
鳴	1390		14	58	0.008761%	619288	93.54%	32	6.70%
央	1391		5	57	0.00861%	619345	93.55%	22	4.60%
姑	1392		8	57	0.00861%	619402	93.56%	30	6.28%
慰	1393		15	57	0.00861%	619459	93.57%	41	8.58%
拆	1394		8	57	0.00861%	619516	93.58%	25	5.23%
柔	1395		9	57	0.00861%	619573	93.58%	40	8.37%
殊	1396		10	57	0.00861%	619630	93.59%	43	9.00%
沖	1397		7	57	0.00861%	619687	93.60%	37	7.74%
豆	1398		7	57	0.00861%	619744	93.61%	16	3.35%
遜	1399		13	57	0.00861%	619801	93.62%	21	4.39%
姿	1400		9	56	0.008459%	619857	93.63%	35	7.32%
岩	1401		8	56	0.008459%	619913	93.64%	20	4.18%
峯	1402		10	56	0.008459%	619969	93.64%	21	4.39%
延	1403		8	56	0.008459%	620025	93.65%	44	9.21%
泊	1404		8	56	0.008459%	620081	93.66%	32	6.70%
蕩	1405		16	56	0.008459%	620137	93.67%	43	9.00%
雅	1406		12	56	0.008459%	620193	93.68%	33	6.90%
黎	1407		15	56	0.008459%	620249	93.69%	26	5.44%
借	1408		10	55	0.008308%	620304	93.69%	38	7.95%
劉	1409		15	55	0.008308%	620359	93.70%	18	3.77%
匯	1410		13	55	0.008308%	620414	93.71%	31	6.49%
塞	1411		13	55	0.008308%	620469	93.72%	39	8.16%
泛	1412		8	55	0.008308%	620524	93.73%	45	9.41%
溪	1413		13	55	0.008308%	620579	93.74%	29	6.07%
箱	1414		15	55	0.008308%	620634	93.74%	26	5.44%
粒	1415		11	55	0.008308%	620689	93.75%	24	5.02%
膠	1416		15	55	0.008308%	620744	93.76%	22	4.60%
薪	1417		17	55	0.008308%	620799	93.77%	24	5.02%
骨	1418		10	55	0.008308%	620854	93.78%	40	8.37%
喚	1419		12	54	0.008157%	620908	93.79%	45	9.41%
圈	1420		11	54	0.008157%	620962	93.79%	30	6.28%
垂	1421		9	54	0.008157%	621016	93.80%	39	8.16%
埋	1422		10	54	0.008157%	621070	93.81%	44	9.21%
奪	1423		14	54	0.008157%	621124	93.82%	34	7.11%
廢	1424		15	54	0.008157%	621178	93.83%	40	8.37%
拋	1425		8	54	0.008157%	621232	93.83%	42	8.79%
枯	1426		9	54	0.008157%	621286	93.84%	42	8.79%
瑞	1427		13	54	0.008157%	621340	93.85%	23	4.81%
米	1428		6	54	0.008157%	621394	93.86%	35	7.32%
詳	1429		13	54	0.008157%	621448	93.87%	40	8.37%
貢	1430		10	54	0.008157%	621502	93.88%	41	8.58%
倘	1431		10	53	0.008005%	621555	93.88%	33	6.90%
剩	1432		12	53	0.008005%	621608	93.89%	32	6.70%
妻	1433		8	53	0.008005%	621661	93.90%	24	5.02%
捐	1434		10	53	0.008005%	621714	93.91%	20	4.18%
聚	1435		14	53	0.008005%	621767	93.92%	39	8.16%
井	1436		4	52	0.007854%	621819	93.92%	20	4.18%
兼	1437		10	52	0.007854%	621871	93.93%	45	9.41%
哩	1438		10	52	0.007854%	621923	93.94%	30	6.28%
售	1439		11	52	0.007854%	621975	93.95%	38	7.95%
奉	1440		8	52	0.007854%	622027	93.95%	43	9.00%
徙	1441		11	52	0.007854%	622079	93.96%	19	3.98%
恨	1442		9	52	0.007854%	622131	93.97%	37	7.74%
摸	1443		14	52	0.007854%	622183	93.98%	36	7.53%
滾	1444		14	52	0.007854%	622235	93.99%	28	5.86%
犯	1445		5	52	0.007854%	622287	93.99%	30	6.28%
番	1446		12	52	0.007854%	622339	94.00%	43	9.00%
紹	1447		11	52	0.007854%	622391	94.01%	38	7.95%
賴	1448		16	52	0.007854%	622443	94.02%	37	7.74%
嘴	1449		15	51	0.007703%	622494	94.03%	37	7.74%
悉	1450		11	51	0.007703%	622545	94.03%	42	8.79%
愉	1451		12	51	0.007703%	622596	94.04%	39	8.16%
械	1452		11	51	0.007703%	622647	94.05%	35	7.32%
殖	1453		12	51	0.007703%	622698	94.06%	29	6.07%
燕	1454		16	51	0.007703%	622749	94.06%	25	5.23%
耶	1455		9	51	0.007703%	622800	94.07%	15	3.14%
蒙	1456		14	51	0.007703%	622851	94.08%	37	7.74%
融	1457		16	51	0.007703%	622902	94.09%	26	5.44%
讚	1458		26	51	0.007703%	622953	94.09%	38	7.95%
輔	1459		14	51	0.007703%	623004	94.10%	36	7.53%
郊	1460		8	51	0.007703%	623055	94.11%	34	7.11%
鍵	1461		17	51	0.007703%	623106	94.12%	10	2.09%
魂	1462		14	51	0.007703%	623157	94.13%	35	7.32%
坦	1463		8	50	0.007552%	623207	94.13%	36	7.53%
塵	1464		14	50	0.007552%	623257	94.14%	37	7.74%
媳	1465		13	50	0.007552%	623307	94.15%	7	1.46%
廁	1466		12	50	0.007552%	623357	94.16%	7	1.46%
怒	1467		9	50	0.007552%	623407	94.16%	34	7.11%
搶	1468		13	50	0.007552%	623457	94.17%	26	5.44%
撥	1469		15	50	0.007552%	623507	94.18%	37	7.74%
申	1470		5	50	0.007552%	623557	94.19%	31	6.49%
秦	1471		10	50	0.007552%	623607	94.19%	16	3.35%
逝	1472		10	50	0.007552%	623657	94.20%	42	8.79%
駕	1473		15	50	0.007552%	623707	94.21%	33	6.90%
騷	1474		20	50	0.007552%	623757	94.22%	22	4.60%
两	1475		7	49	0.007401%	623806	94.22%	30	6.28%
倦	1476		10	49	0.007401%	623855	94.23%	36	7.53%
嘗	1477		14	49	0.007401%	623904	94.24%	37	7.74%
慨	1478		12	49	0.007401%	623953	94.25%	35	7.32%
暫	1479		15	49	0.007401%	624002	94.25%	40	8.37%
柱	1480		9	49	0.007401%	624051	94.26%	25	5.23%
漲	1481		14	49	0.007401%	624100	94.27%	25	5.23%
燦	1482		17	49	0.007401%	624149	94.28%	39	8.16%
爆	1483		19	49	0.007401%	624198	94.28%	23	4.81%
甜	1484		11	49	0.007401%	624247	94.29%	36	7.53%
秀	1485		7	49	0.007401%	624296	94.30%	34	7.11%
穩	1486		19	49	0.007401%	624345	94.31%	29	6.07%
豪	1487		14	49	0.007401%	624394	94.31%	38	7.95%
魯	1488		15	49	0.007401%	624443	94.32%	26	5.44%
伏	1489		6	48	0.00725%	624491	94.33%	38	7.95%
壩	1490		24	48	0.00725%	624539	94.33%	7	1.46%
愁	1491		13	48	0.00725%	624587	94.34%	43	9.00%
掩	1492		11	48	0.00725%	624635	94.35%	38	7.95%
敲	1493		14	48	0.00725%	624683	94.36%	26	5.44%
涉	1494		10	48	0.00725%	624731	94.36%	34	7.11%
添	1495		11	48	0.00725%	624779	94.37%	40	8.37%
礎	1496		18	48	0.00725%	624827	94.38%	33	6.90%
網	1497		14	48	0.00725%	624875	94.39%	27	5.65%
編	1498		15	48	0.00725%	624923	94.39%	37	7.74%
耀	1499		20	48	0.00725%	624971	94.40%	40	8.37%
賭	1500		15	48	0.00725%	625019	94.41%	19	3.98%
闢	1501		21	48	0.00725%	625067	94.41%	31	6.49%
陌	1502		8	48	0.00725%	625115	94.42%	23	4.81%
割	1503		12	47	0.007099%	625162	94.43%	25	5.23%
咀	1504		8	47	0.007099%	625209	94.44%	26	5.44%
嘆	1505		14	47	0.007099%	625256	94.44%	39	8.16%
忠	1506		8	47	0.007099%	625303	94.45%	31	6.49%
戒	1507		7	47	0.007099%	625350	94.46%	20	4.18%
撫	1508		15	47	0.007099%	625397	94.46%	32	6.70%
疲	1509		10	47	0.007099%	625444	94.47%	39	8.16%
瞭	1510		17	47	0.007099%	625491	94.48%	30	6.28%
祝	1511		9	47	0.007099%	625538	94.49%	35	7.32%
耐	1512		9	47	0.007099%	625585	94.49%	32	6.70%
赫	1513		14	47	0.007099%	625632	94.50%	20	4.18%
釣	1514		11	47	0.007099%	625679	94.51%	12	2.51%
震	1515		15	47	0.007099%	625726	94.51%	32	6.70%
呈	1516		7	46	0.006948%	625772	94.52%	27	5.65%
宮	1517		10	46	0.006948%	625818	94.53%	23	4.81%
循	1518		12	46	0.006948%	625864	94.53%	31	6.49%
憤	1519		15	46	0.006948%	625910	94.54%	26	5.44%
拔	1520		8	46	0.006948%	625956	94.55%	31	6.49%
旦	1521		5	46	0.006948%	626002	94.56%	32	6.70%
曰	1522		4	46	0.006948%	626048	94.56%	19	3.98%
滋	1523		12	46	0.006948%	626094	94.57%	35	7.32%
灌	1524		21	46	0.006948%	626140	94.58%	33	6.90%
緻	1525		15	46	0.006948%	626186	94.58%	30	6.28%
繫	1526		19	46	0.006948%	626232	94.59%	34	7.11%
腐	1527		14	46	0.006948%	626278	94.60%	28	5.86%
袋	1528		11	46	0.006948%	626324	94.60%	28	5.86%
詢	1529		13	46	0.006948%	626370	94.61%	33	6.90%
贊	1530		19	46	0.006948%	626416	94.62%	32	6.70%
鄰	1531		14	46	0.006948%	626462	94.62%	39	8.16%
霜	1532		17	46	0.006948%	626508	94.63%	12	2.51%
唐	1533		10	45	0.006797%	626553	94.64%	23	4.81%
撲	1534		15	45	0.006797%	626598	94.65%	30	6.28%
析	1535		8	45	0.006797%	626643	94.65%	33	6.90%
池	1536		6	45	0.006797%	626688	94.66%	28	5.86%
溜	1537		13	45	0.006797%	626733	94.67%	20	4.18%
菲	1538		12	45	0.006797%	626778	94.67%	20	4.18%
裂	1539		12	45	0.006797%	626823	94.68%	27	5.65%
証	1540		12	45	0.006797%	626868	94.69%	29	6.07%
鬱	1541		29	45	0.006797%	626913	94.69%	35	7.32%
鵑	1542		18	45	0.006797%	626958	94.70%	8	1.67%
丈	1543		3	44	0.006646%	627002	94.71%	31	6.49%
亭	1544		9	44	0.006646%	627046	94.71%	28	5.86%
准	1545		10	44	0.006646%	627090	94.72%	30	6.28%
勉	1546		9	44	0.006646%	627134	94.73%	34	7.11%
呆	1547		7	44	0.006646%	627178	94.73%	33	6.90%
塔	1548		13	44	0.006646%	627222	94.74%	24	5.02%
寨	1549		14	44	0.006646%	627266	94.75%	6	1.25%
操	1550		16	44	0.006646%	627310	94.75%	32	6.70%
暑	1551		12	44	0.006646%	627354	94.76%	26	5.44%
桂	1552		10	44	0.006646%	627398	94.77%	16	3.35%
爺	1553		13	44	0.006646%	627442	94.77%	10	2.09%
璃	1554		15	44	0.006646%	627486	94.78%	21	4.39%
瓜	1555		5	44	0.006646%	627530	94.79%	24	5.02%
稀	1556		12	44	0.006646%	627574	94.79%	35	7.32%
舟	1557		6	44	0.006646%	627618	94.80%	33	6.90%
荷	1558		11	44	0.006646%	627662	94.81%	26	5.44%
違	1559		12	44	0.006646%	627706	94.81%	25	5.23%
冒	1560		9	43	0.006495%	627749	94.82%	36	7.53%
墨	1561		15	43	0.006495%	627792	94.83%	32	6.70%
宿	1562		11	43	0.006495%	627835	94.83%	29	6.07%
怨	1563		9	43	0.006495%	627878	94.84%	34	7.11%
抬	1564		8	43	0.006495%	627921	94.85%	31	6.49%
掃	1565		11	43	0.006495%	627964	94.85%	32	6.70%
湧	1566		12	43	0.006495%	628007	94.86%	37	7.74%
燃	1567		16	43	0.006495%	628050	94.86%	28	5.86%
猶	1568		12	43	0.006495%	628093	94.87%	32	6.70%
玻	1569		9	43	0.006495%	628136	94.88%	19	3.98%
翰	1570		16	43	0.006495%	628179	94.88%	11	2.30%
蒂	1571		13	43	0.006495%	628222	94.89%	14	2.93%
軌	1572		9	43	0.006495%	628265	94.90%	28	5.86%
迴	1573		9	43	0.006495%	628308	94.90%	35	7.32%
酷	1574		14	43	0.006495%	628351	94.91%	36	7.53%
鎖	1575		18	43	0.006495%	628394	94.92%	28	5.86%
齡	1576		20	43	0.006495%	628437	94.92%	32	6.70%
勤	1577		13	42	0.006344%	628479	94.93%	35	7.32%
勸	1578		20	42	0.006344%	628521	94.94%	26	5.44%
吐	1579		6	42	0.006344%	628563	94.94%	35	7.32%
吞	1580		7	42	0.006344%	628605	94.95%	29	6.07%
堪	1581		12	42	0.006344%	628647	94.95%	38	7.95%
抑	1582		7	42	0.006344%	628689	94.96%	35	7.32%
摩	1583		15	42	0.006344%	628731	94.97%	22	4.60%
撞	1584		15	42	0.006344%	628773	94.97%	16	3.35%
漠	1585		14	42	0.006344%	628815	94.98%	33	6.90%
潛	1586		15	42	0.006344%	628857	94.99%	24	5.02%
甲	1587		5	42	0.006344%	628899	94.99%	26	5.44%
眉	1588		9	42	0.006344%	628941	95.00%	26	5.44%
胸	1589		10	42	0.006344%	628983	95.01%	31	6.49%
衡	1590		16	42	0.006344%	629025	95.01%	30	6.28%
返	1591		7	42	0.006344%	629067	95.02%	27	5.65%
遂	1592		12	42	0.006344%	629109	95.02%	27	5.65%
邦	1593		6	42	0.006344%	629151	95.03%	24	5.02%
雀	1594		11	42	0.006344%	629193	95.04%	27	5.65%
鞋	1595		15	42	0.006344%	629235	95.04%	26	5.44%
云	1596		4	41	0.006193%	629276	95.05%	25	5.23%
倡	1597		10	41	0.006193%	629317	95.06%	18	3.77%
呵	1598		8	41	0.006193%	629358	95.06%	19	3.98%
尾	1599		7	41	0.006193%	629399	95.07%	36	7.53%
恩	1600		10	41	0.006193%	629440	95.07%	24	5.02%
慧	1601		15	41	0.006193%	629481	95.08%	29	6.07%
搬	1602		13	41	0.006193%	629522	95.09%	27	5.65%
攝	1603		21	41	0.006193%	629563	95.09%	20	4.18%
槍	1604		14	41	0.006193%	629604	95.10%	23	4.81%
獵	1605		18	41	0.006193%	629645	95.11%	15	3.14%
畔	1606		10	41	0.006193%	629686	95.11%	31	6.49%
粗	1607		11	41	0.006193%	629727	95.12%	36	7.53%
艱	1608		17	41	0.006193%	629768	95.12%	39	8.16%
襲	1609		22	41	0.006193%	629809	95.13%	31	6.49%
譬	1610		20	41	0.006193%	629850	95.14%	29	6.07%
辭	1611		19	41	0.006193%	629891	95.14%	35	7.32%
刷	1612		8	40	0.006042%	629931	95.15%	16	3.35%
吉	1613		6	40	0.006042%	629971	95.15%	28	5.86%
坊	1614		7	40	0.006042%	630011	95.16%	13	2.72%
惠	1615		12	40	0.006042%	630051	95.17%	26	5.44%
挺	1616		10	40	0.006042%	630091	95.17%	31	6.49%
汗	1617		6	40	0.006042%	630131	95.18%	35	7.32%
津	1618		9	40	0.006042%	630171	95.19%	21	4.39%
濤	1619		17	40	0.006042%	630211	95.19%	32	6.70%
犧	1620		21	40	0.006042%	630251	95.20%	20	4.18%
玉	1621		5	40	0.006042%	630291	95.20%	27	5.65%
痕	1622		11	40	0.006042%	630331	95.21%	27	5.65%
瘋	1623		14	40	0.006042%	630371	95.22%	26	5.44%
籃	1624		20	40	0.006042%	630411	95.22%	17	3.56%
翠	1625		14	40	0.006042%	630451	95.23%	32	6.70%
芝	1626		8	40	0.006042%	630491	95.23%	16	3.35%
蓮	1627		15	40	0.006042%	630531	95.24%	19	3.98%
誌	1628		14	40	0.006042%	630571	95.25%	28	5.86%
貌	1629		14	40	0.006042%	630611	95.25%	28	5.86%
逢	1630		10	40	0.006042%	630651	95.26%	27	5.65%
邑	1631		7	40	0.006042%	630691	95.26%	7	1.46%
魔	1632		21	40	0.006042%	630731	95.27%	30	6.28%
側	1633		11	39	0.005891%	630770	95.28%	26	5.44%
喪	1634		12	39	0.005891%	630809	95.28%	31	6.49%
姓	1635		8	39	0.005891%	630848	95.29%	19	3.98%
并	1636		6	39	0.005891%	630887	95.29%	22	4.60%
廉	1637		13	39	0.005891%	630926	95.30%	24	5.02%
惑	1638		12	39	0.005891%	630965	95.31%	25	5.23%
振	1639		10	39	0.005891%	631004	95.31%	33	6.90%
曉	1640		16	39	0.005891%	631043	95.32%	29	6.07%
柳	1641		9	39	0.005891%	631082	95.32%	20	4.18%
狹	1642		10	39	0.005891%	631121	95.33%	27	5.65%
盪	1643		17	39	0.005891%	631160	95.33%	31	6.49%
繳	1644		19	39	0.005891%	631199	95.34%	18	3.77%
茲	1645		10	39	0.005891%	631238	95.35%	30	6.28%
赴	1646		9	39	0.005891%	631277	95.35%	28	5.86%
鑽	1647		27	39	0.005891%	631316	95.36%	30	6.28%
隆	1648		11	39	0.005891%	631355	95.36%	27	5.65%
僱	1649		14	38	0.00574%	631393	95.37%	18	3.77%
卡	1650		5	38	0.00574%	631431	95.38%	14	2.93%
夾	1651		7	38	0.00574%	631469	95.38%	26	5.44%
姆	1652		8	38	0.00574%	631507	95.39%	11	2.30%
屈	1653		8	38	0.00574%	631545	95.39%	31	6.49%
恢	1654		9	38	0.00574%	631583	95.40%	28	5.86%
惟	1655		11	38	0.00574%	631621	95.40%	27	5.65%
惱	1656		12	38	0.00574%	631659	95.41%	24	5.02%
慕	1657		15	38	0.00574%	631697	95.42%	24	5.02%
攻	1658		7	38	0.00574%	631735	95.42%	30	6.28%
松	1659		8	38	0.00574%	631773	95.43%	25	5.23%
柴	1660		10	38	0.00574%	631811	95.43%	22	4.60%
癡	1661		19	38	0.00574%	631849	95.44%	18	3.77%
碍	1662		13	38	0.00574%	631887	95.44%	30	6.28%
碰	1663		13	38	0.00574%	631925	95.45%	26	5.44%
紐	1664		10	38	0.00574%	631963	95.46%	22	4.60%
繪	1665		19	38	0.00574%	632001	95.46%	20	4.18%
肩	1666		8	38	0.00574%	632039	95.47%	34	7.11%
誘	1667		14	38	0.00574%	632077	95.47%	21	4.39%
譽	1668		21	38	0.00574%	632115	95.48%	29	6.07%
郵	1669		11	38	0.00574%	632153	95.48%	9	1.88%
雞	1670		18	38	0.00574%	632191	95.49%	25	5.23%
雷	1671		13	38	0.00574%	632229	95.50%	26	5.44%
顛	1672		19	38	0.00574%	632267	95.50%	29	6.07%
飽	1673		13	38	0.00574%	632305	95.51%	30	6.28%
驅	1674		21	38	0.00574%	632343	95.51%	33	6.90%
串	1675		7	37	0.005589%	632380	95.52%	29	6.07%
余	1676		7	37	0.005589%	632417	95.52%	6	1.25%
判	1677		7	37	0.005589%	632454	95.53%	26	5.44%
削	1678		9	37	0.005589%	632491	95.54%	20	4.18%
喊	1679		12	37	0.005589%	632528	95.54%	25	5.23%
塑	1680		13	37	0.005589%	632565	95.55%	22	4.60%
宋	1681		7	37	0.005589%	632602	95.55%	17	3.56%
拾	1682		9	37	0.005589%	632639	95.56%	30	6.28%
挑	1683		9	37	0.005589%	632676	95.56%	26	5.44%
柬	1684		9	37	0.005589%	632713	95.57%	5	1.05%
桌	1685		10	37	0.005589%	632750	95.57%	25	5.23%
梵	1686		11	37	0.005589%	632787	95.58%	7	1.46%
棉	1687		12	37	0.005589%	632824	95.59%	17	3.56%
樸	1688		16	37	0.005589%	632861	95.59%	28	5.86%
歧	1689		8	37	0.005589%	632898	95.60%	22	4.60%
瓶	1690		11	37	0.005589%	632935	95.60%	7	1.46%
糊	1691		15	37	0.005589%	632972	95.61%	28	5.86%
緒	1692		14	37	0.005589%	633009	95.61%	26	5.44%
艷	1693		24	37	0.005589%	633046	95.62%	26	5.44%
訊	1694		10	37	0.005589%	633083	95.62%	24	5.02%
霞	1695		17	37	0.005589%	633120	95.63%	24	5.02%
儒	1696		16	36	0.005438%	633156	95.64%	19	3.98%
勁	1697		9	36	0.005438%	633192	95.64%	29	6.07%
啦	1698		11	36	0.005438%	633228	95.65%	13	2.72%
嘉	1699		14	36	0.005438%	633264	95.65%	20	4.18%
噸	1700		16	36	0.005438%	633300	95.66%	12	2.51%
寺	1701		6	36	0.005438%	633336	95.66%	9	1.88%
屯	1702		4	36	0.005438%	633372	95.67%	10	2.09%
峰	1703		10	36	0.005438%	633408	95.67%	17	3.56%
彎	1704		22	36	0.005438%	633444	95.68%	23	4.81%
恰	1705		9	36	0.005438%	633480	95.68%	29	6.07%
抓	1706		7	36	0.005438%	633516	95.69%	24	5.02%
敵	1707		15	36	0.005438%	633552	95.70%	26	5.44%
旗	1708		14	36	0.005438%	633588	95.70%	24	5.02%
溝	1709		13	36	0.005438%	633624	95.71%	22	4.60%
盈	1710		9	36	0.005438%	633660	95.71%	28	5.86%
矣	1711		7	36	0.005438%	633696	95.72%	17	3.56%
糾	1712		8	36	0.005438%	633732	95.72%	26	5.44%
耕	1713		10	36	0.005438%	633768	95.73%	19	3.98%
聰	1714		17	36	0.005438%	633804	95.73%	28	5.86%
臺	1715		14	36	0.005438%	633840	95.74%	10	2.09%
莎	1716		11	36	0.005438%	633876	95.74%	7	1.46%
蜜	1717		14	36	0.005438%	633912	95.75%	25	5.23%
註	1718		12	36	0.005438%	633948	95.76%	13	2.72%
誼	1719		15	36	0.005438%	633984	95.76%	26	5.44%
辯	1720		21	36	0.005438%	634020	95.77%	30	6.28%
駐	1721		15	36	0.005438%	634056	95.77%	22	4.60%
奶	1722		5	35	0.005287%	634091	95.78%	9	1.88%
娜	1723		10	35	0.005287%	634126	95.78%	8	1.67%
悅	1724		10	35	0.005287%	634161	95.79%	32	6.70%
懸	1725		20	35	0.005287%	634196	95.79%	25	5.23%
描	1726		12	35	0.005287%	634231	95.80%	24	5.02%
摘	1727		14	35	0.005287%	634266	95.80%	21	4.39%
柏	1728		9	35	0.005287%	634301	95.81%	21	4.39%
梯	1729		11	35	0.005287%	634336	95.81%	20	4.18%
棵	1730		12	35	0.005287%	634371	95.82%	17	3.56%
澈	1731		14	35	0.005287%	634406	95.82%	33	6.90%
濱	1732		17	35	0.005287%	634441	95.83%	22	4.60%
瓷	1733		11	35	0.005287%	634476	95.84%	6	1.25%
盆	1734		9	35	0.005287%	634511	95.84%	18	3.77%
磅	1735		15	35	0.005287%	634546	95.85%	20	4.18%
禍	1736		13	35	0.005287%	634581	95.85%	24	5.02%
脈	1737		10	35	0.005287%	634616	95.86%	21	4.39%
芳	1738		8	35	0.005287%	634651	95.86%	26	5.44%
葬	1739		13	35	0.005287%	634686	95.87%	21	4.39%
薩	1740		18	35	0.005287%	634721	95.87%	11	2.30%
誕	1741		15	35	0.005287%	634756	95.88%	24	5.02%
諾	1742		16	35	0.005287%	634791	95.88%	18	3.77%
貝	1743		7	35	0.005287%	634826	95.89%	22	4.60%
遮	1744		14	35	0.005287%	634861	95.89%	23	4.81%
刀	1745		2	34	0.005136%	634895	95.90%	30	6.28%
劣	1746		6	34	0.005136%	634929	95.90%	24	5.02%
卅	1747		4	34	0.005136%	634963	95.91%	19	3.98%
厲	1748		15	34	0.005136%	634997	95.91%	28	5.86%
叠	1749		13	34	0.005136%	635031	95.92%	23	4.81%
夷	1750		6	34	0.005136%	635065	95.92%	14	2.93%
廂	1751		12	34	0.005136%	635099	95.93%	12	2.51%
廷	1752		7	34	0.005136%	635133	95.93%	9	1.88%
徐	1753		10	34	0.005136%	635167	95.94%	16	3.35%
截	1754		14	34	0.005136%	635201	95.94%	23	4.81%
掠	1755		11	34	0.005136%	635235	95.95%	25	5.23%
捲	1756		11	34	0.005136%	635269	95.96%	27	5.65%
敷	1757		15	34	0.005136%	635303	95.96%	21	4.39%
斗	1758		4	34	0.005136%	635337	95.97%	27	5.65%
旺	1759		8	34	0.005136%	635371	95.97%	19	3.98%
晴	1760		12	34	0.005136%	635405	95.98%	28	5.86%
曆	1761		16	34	0.005136%	635439	95.98%	11	2.30%
淪	1762		11	34	0.005136%	635473	95.99%	17	3.56%
渴	1763		12	34	0.005136%	635507	95.99%	31	6.49%
炕	1764		8	34	0.005136%	635541	96.00%	5	1.05%
監	1765		14	34	0.005136%	635575	96.00%	25	5.23%
筋	1766		12	34	0.005136%	635609	96.01%	15	3.14%
綿	1767		14	34	0.005136%	635643	96.01%	26	5.44%
罵	1768		15	34	0.005136%	635677	96.02%	23	4.81%
驕	1769		22	34	0.005136%	635711	96.02%	31	6.49%
勿	1770		4	33	0.004985%	635744	96.03%	18	3.77%
吟	1771		7	33	0.004985%	635777	96.03%	26	5.44%
奧	1772		13	33	0.004985%	635810	96.04%	25	5.23%
宅	1773		6	33	0.004985%	635843	96.04%	22	4.60%
嶼	1774		17	33	0.004985%	635876	96.05%	15	3.14%
巿	1775		4	33	0.004985%	635909	96.05%	11	2.30%
慎	1776		13	33	0.004985%	635942	96.06%	23	4.81%
抹	1777		8	33	0.004985%	635975	96.06%	23	4.81%
拒	1778		8	33	0.004985%	636008	96.07%	26	5.44%
掙	1779		11	33	0.004985%	636041	96.07%	26	5.44%
桃	1780		10	33	0.004985%	636074	96.08%	29	6.07%
欄	1781		21	33	0.004985%	636107	96.08%	23	4.81%
毅	1782		15	33	0.004985%	636140	96.09%	28	5.86%
洪	1783		9	33	0.004985%	636173	96.09%	22	4.60%
燥	1784		17	33	0.004985%	636206	96.10%	26	5.44%
獸	1785		19	33	0.004985%	636239	96.10%	20	4.18%
瑰	1786		14	33	0.004985%	636272	96.11%	22	4.60%
窄	1787		10	33	0.004985%	636305	96.11%	22	4.60%
累	1788		11	33	0.004985%	636338	96.12%	27	5.65%
羊	1789		6	33	0.004985%	636371	96.12%	23	4.81%
蕭	1790		16	33	0.004985%	636404	96.13%	25	5.23%
詹	1791		13	33	0.004985%	636437	96.13%	7	1.46%
賢	1792		15	33	0.004985%	636470	96.14%	26	5.44%
躲	1793		13	33	0.004985%	636503	96.14%	27	5.65%
遣	1794		13	33	0.004985%	636536	96.15%	22	4.60%
銅	1795		14	33	0.004985%	636569	96.15%	24	5.02%
餓	1796		15	33	0.004985%	636602	96.16%	18	3.77%
鬆	1797		18	33	0.004985%	636635	96.16%	27	5.65%
鼻	1798		14	33	0.004985%	636668	96.17%	19	3.98%
塗	1799		13	32	0.004833%	636700	96.17%	24	5.02%
妨	1800		7	32	0.004833%	636732	96.18%	27	5.65%
姊	1801		8	32	0.004833%	636764	96.18%	22	4.60%
扇	1802		10	32	0.004833%	636796	96.19%	11	2.30%
插	1803		12	32	0.004833%	636828	96.19%	23	4.81%
旨	1804		6	32	0.004833%	636860	96.20%	21	4.39%
朱	1805		6	32	0.004833%	636892	96.20%	18	3.77%
桿	1806		11	32	0.004833%	636924	96.21%	9	1.88%
泉	1807		9	32	0.004833%	636956	96.21%	19	3.98%
泰	1808		10	32	0.004833%	636988	96.21%	18	3.77%
液	1809		11	32	0.004833%	637020	96.22%	13	2.72%
溶	1810		13	32	0.004833%	637052	96.22%	20	4.18%
牽	1811		11	32	0.004833%	637084	96.23%	27	5.65%
瓦	1812		5	32	0.004833%	637116	96.23%	16	3.35%
礦	1813		20	32	0.004833%	637148	96.24%	17	3.56%
稿	1814		15	32	0.004833%	637180	96.24%	13	2.72%
紫	1815		12	32	0.004833%	637212	96.25%	22	4.60%
罩	1816		13	32	0.004833%	637244	96.25%	29	6.07%
脅	1817		10	32	0.004833%	637276	96.26%	20	4.18%
腰	1818		13	32	0.004833%	637308	96.26%	27	5.65%
虎	1819		8	32	0.004833%	637340	96.27%	25	5.23%
躺	1820		15	32	0.004833%	637372	96.27%	24	5.02%
輯	1821		16	32	0.004833%	637404	96.28%	18	3.77%
辨	1822		16	32	0.004833%	637436	96.28%	22	4.60%
頌	1823		13	32	0.004833%	637468	96.29%	26	5.44%
俯	1824		10	31	0.004682%	637499	96.29%	20	4.18%
倚	1825		10	31	0.004682%	637530	96.30%	24	5.02%
俱	1826		10	31	0.004682%	637561	96.30%	21	4.39%
吵	1827		7	31	0.004682%	637592	96.31%	20	4.18%
堤	1828		12	31	0.004682%	637623	96.31%	14	2.93%
壽	1829		14	31	0.004682%	637654	96.32%	23	4.81%
奴	1830		5	31	0.004682%	637685	96.32%	21	4.39%
庫	1831		10	31	0.004682%	637716	96.32%	15	3.14%
扎	1832		4	31	0.004682%	637747	96.33%	25	5.23%
挽	1833		10	31	0.004682%	637778	96.33%	21	4.39%
攤	1834		22	31	0.004682%	637809	96.34%	20	4.18%
昔	1835		8	31	0.004682%	637840	96.34%	25	5.23%
昂	1836		8	31	0.004682%	637871	96.35%	22	4.60%
暢	1837		14	31	0.004682%	637902	96.35%	24	5.02%
濫	1838		17	31	0.004682%	637933	96.36%	23	4.81%
煤	1839		13	31	0.004682%	637964	96.36%	11	2.30%
砦	1840		11	31	0.004682%	637995	96.37%	1	0.21%
糖	1841		16	31	0.004682%	638026	96.37%	18	3.77%
艘	1842		15	31	0.004682%	638057	96.38%	10	2.09%
荃	1843		10	31	0.004682%	638088	96.38%	16	3.35%
邀	1844		16	31	0.004682%	638119	96.39%	23	4.81%
錫	1845		16	31	0.004682%	638150	96.39%	16	3.35%
頻	1846		16	31	0.004682%	638181	96.39%	21	4.39%
饑	1847		20	31	0.004682%	638212	96.40%	6	1.25%
乳	1848		8	30	0.004531%	638242	96.40%	9	1.88%
函	1849		8	30	0.004531%	638272	96.41%	21	4.39%
墓	1850		14	30	0.004531%	638302	96.41%	19	3.98%
壇	1851		16	30	0.004531%	638332	96.42%	12	2.51%
川	1852		3	30	0.004531%	638362	96.42%	20	4.18%
巷	1853		9	30	0.004531%	638392	96.43%	20	4.18%
庸	1854		11	30	0.004531%	638422	96.43%	20	4.18%
役	1855		7	30	0.004531%	638452	96.44%	24	5.02%
恆	1856		9	30	0.004531%	638482	96.44%	19	3.98%
憲	1857		16	30	0.004531%	638512	96.44%	10	2.09%
憾	1858		16	30	0.004531%	638542	96.45%	29	6.07%
懇	1859		17	30	0.004531%	638572	96.45%	25	5.23%
懼	1860		21	30	0.004531%	638602	96.46%	25	5.23%
搞	1861		13	30	0.004531%	638632	96.46%	13	2.72%
歇	1862		13	30	0.004531%	638662	96.47%	23	4.81%
氛	1863		8	30	0.004531%	638692	96.47%	27	5.65%
溴	1864		13	30	0.004531%	638722	96.48%	1	0.21%
漆	1865		14	30	0.004531%	638752	96.48%	26	5.44%
砂	1866		9	30	0.004531%	638782	96.49%	13	2.72%
籲	1867		32	30	0.004531%	638812	96.49%	20	4.18%
紡	1868		10	30	0.004531%	638842	96.49%	14	2.93%
絡	1869		12	30	0.004531%	638872	96.50%	25	5.23%
肌	1870		6	30	0.004531%	638902	96.50%	9	1.88%
臘	1871		19	30	0.004531%	638932	96.51%	11	2.30%
萎	1872		12	30	0.004531%	638962	96.51%	19	3.98%
衫	1873		8	30	0.004531%	638992	96.52%	16	3.35%
衷	1874		10	30	0.004531%	639022	96.52%	26	5.44%
誦	1875		14	30	0.004531%	639052	96.53%	13	2.72%
迄	1876		6	30	0.004531%	639082	96.53%	25	5.23%
閱	1877		15	30	0.004531%	639112	96.54%	22	4.60%
侖	1878		8	29	0.00438%	639141	96.54%	8	1.67%
傅	1879		12	29	0.00438%	639170	96.54%	5	1.05%
卷	1880		8	29	0.00438%	639199	96.55%	18	3.77%
咒	1881		8	29	0.00438%	639228	96.55%	14	2.93%
弓	1882		3	29	0.00438%	639257	96.56%	6	1.25%
徹	1883		14	29	0.00438%	639286	96.56%	20	4.18%
悟	1884		10	29	0.00438%	639315	96.57%	24	5.02%
捕	1885		10	29	0.00438%	639344	96.57%	21	4.39%
捨	1886		11	29	0.00438%	639373	96.58%	21	4.39%
撒	1887		15	29	0.00438%	639402	96.58%	22	4.60%
擾	1888		18	29	0.00438%	639431	96.58%	25	5.23%
渺	1889		12	29	0.00438%	639460	96.59%	22	4.60%
聊	1890		11	29	0.00438%	639489	96.59%	23	4.81%
蓄	1891		14	29	0.00438%	639518	96.60%	21	4.39%
蔡	1892		15	29	0.00438%	639547	96.60%	6	1.25%
颶	1893		17	29	0.00438%	639576	96.61%	8	1.67%
飾	1894		13	29	0.00438%	639605	96.61%	24	5.02%
騙	1895		19	29	0.00438%	639634	96.61%	19	3.98%
麥	1896		11	29	0.00438%	639663	96.62%	17	3.56%
冠	1897		9	28	0.004229%	639691	96.62%	19	3.98%
勃	1898		9	28	0.004229%	639719	96.63%	20	4.18%
勒	1899		11	28	0.004229%	639747	96.63%	15	3.14%
墮	1900		15	28	0.004229%	639775	96.64%	17	3.56%
奈	1901		8	28	0.004229%	639803	96.64%	24	5.02%
宙	1902		8	28	0.004229%	639831	96.64%	21	4.39%
帽	1903		12	28	0.004229%	639859	96.65%	13	2.72%
桑	1904		10	28	0.004229%	639887	96.65%	20	4.18%
椅	1905		12	28	0.004229%	639915	96.66%	21	4.39%
泳	1906		8	28	0.004229%	639943	96.66%	17	3.56%
浩	1907		10	28	0.004229%	639971	96.67%	22	4.60%
淵	1908		11	28	0.004229%	639999	96.67%	22	4.60%
溢	1909		13	28	0.004229%	640027	96.67%	23	4.81%
碧	1910		14	28	0.004229%	640055	96.68%	25	5.23%
羞	1911		11	28	0.004229%	640083	96.68%	22	4.60%
脹	1912		12	28	0.004229%	640111	96.69%	9	1.88%
舖	1913		15	28	0.004229%	640139	96.69%	16	3.35%
葡	1914		13	28	0.004229%	640167	96.69%	16	3.35%
謹	1915		18	28	0.004229%	640195	96.70%	22	4.60%
豈	1916		10	28	0.004229%	640223	96.70%	23	4.81%
貫	1917		11	28	0.004229%	640251	96.71%	20	4.18%
邪	1918		6	28	0.004229%	640279	96.71%	17	3.56%
醜	1919		17	28	0.004229%	640307	96.72%	21	4.39%
采	1920		8	28	0.004229%	640335	96.72%	20	4.18%
鑑	1921		22	28	0.004229%	640363	96.72%	17	3.56%
陀	1922		7	28	0.004229%	640391	96.73%	3	0.63%
鷹	1923		24	28	0.004229%	640419	96.73%	9	1.88%
伙	1924		6	27	0.004078%	640446	96.74%	19	3.98%
傲	1925		13	27	0.004078%	640473	96.74%	23	4.81%
兆	1926		6	27	0.004078%	640500	96.75%	11	2.30%
后	1927		6	27	0.004078%	640527	96.75%	20	4.18%
寡	1928		14	27	0.004078%	640554	96.75%	17	3.56%
審	1929		15	27	0.004078%	640581	96.76%	18	3.77%
崗	1930		11	27	0.004078%	640608	96.76%	14	2.93%
帮	1931		9	27	0.004078%	640635	96.77%	18	3.77%
幢	1932		15	27	0.004078%	640662	96.77%	10	2.09%
怡	1933		8	27	0.004078%	640689	96.77%	12	2.51%
恒	1934		9	27	0.004078%	640716	96.78%	15	3.14%
揭	1935		12	27	0.004078%	640743	96.78%	21	4.39%
敏	1936		11	27	0.004078%	640770	96.79%	24	5.02%
暮	1937		15	27	0.004078%	640797	96.79%	23	4.81%
曝	1938		19	27	0.004078%	640824	96.79%	2	0.42%
杉	1939		7	27	0.004078%	640851	96.80%	3	0.63%
梁	1940		11	27	0.004078%	640878	96.80%	15	3.14%
殷	1941		10	27	0.004078%	640905	96.81%	21	4.39%
污	1942		6	27	0.004078%	640932	96.81%	19	3.98%
泡	1943		8	27	0.004078%	640959	96.81%	16	3.35%
瑪	1944		14	27	0.004078%	640986	96.82%	13	2.72%
矢	1945		5	27	0.004078%	641013	96.82%	4	0.84%
碑	1946		13	27	0.004078%	641040	96.83%	14	2.93%
縫	1947		17	27	0.004078%	641067	96.83%	21	4.39%
繩	1948		19	27	0.004078%	641094	96.83%	14	2.93%
纏	1949		21	27	0.004078%	641121	96.84%	23	4.81%
耗	1950		10	27	0.004078%	641148	96.84%	16	3.35%
艇	1951		13	27	0.004078%	641175	96.85%	13	2.72%
菊	1952		12	27	0.004078%	641202	96.85%	10	2.09%
譯	1953		20	27	0.004078%	641229	96.86%	18	3.77%
貓	1954		16	27	0.004078%	641256	96.86%	7	1.46%
踪	1955		14	27	0.004078%	641283	96.86%	20	4.18%
錦	1956		16	27	0.004078%	641310	96.87%	20	4.18%
馳	1957		13	27	0.004078%	641337	96.87%	25	5.23%
麵	1958		20	27	0.004078%	641364	96.88%	18	3.77%
伍	1959		6	26	0.003927%	641390	96.88%	18	3.77%
侯	1960		9	26	0.003927%	641416	96.88%	9	1.88%
儲	1961		17	26	0.003927%	641442	96.89%	18	3.77%
冊	1962		5	26	0.003927%	641468	96.89%	17	3.56%
劑	1963		16	26	0.003927%	641494	96.90%	14	2.93%
劫	1964		7	26	0.003927%	641520	96.90%	19	3.98%
卑	1965		8	26	0.003927%	641546	96.90%	21	4.39%
噴	1966		15	26	0.003927%	641572	96.91%	18	3.77%
坪	1967		8	26	0.003927%	641598	96.91%	15	3.14%
墳	1968		15	26	0.003927%	641624	96.92%	20	4.18%
嫁	1969		13	26	0.003927%	641650	96.92%	9	1.88%
嫩	1970		14	26	0.003927%	641676	96.92%	21	4.39%
悔	1971		10	26	0.003927%	641702	96.93%	21	4.39%
愧	1972		13	26	0.003927%	641728	96.93%	21	4.39%
拂	1973		8	26	0.003927%	641754	96.93%	21	4.39%
攀	1974		19	26	0.003927%	641780	96.94%	19	3.98%
涯	1975		11	26	0.003927%	641806	96.94%	23	4.81%
燭	1976		17	26	0.003927%	641832	96.95%	13	2.72%
爽	1977		11	26	0.003927%	641858	96.95%	24	5.02%
玫	1978		8	26	0.003927%	641884	96.95%	17	3.56%
盼	1979		9	26	0.003927%	641910	96.96%	21	4.39%
祿	1980		12	26	0.003927%	641936	96.96%	10	2.09%
秩	1981		10	26	0.003927%	641962	96.97%	18	3.77%
綴	1982		14	26	0.003927%	641988	96.97%	23	4.81%
臣	1983		6	26	0.003927%	642014	96.97%	16	3.35%
蒸	1984		14	26	0.003927%	642040	96.98%	21	4.39%
託	1985		10	26	0.003927%	642066	96.98%	21	4.39%
賓	1986		14	26	0.003927%	642092	96.99%	19	3.98%
蹟	1987		18	26	0.003927%	642118	96.99%	19	3.98%
軟	1988		11	26	0.003927%	642144	96.99%	20	4.18%
鉛	1989		13	26	0.003927%	642170	97.00%	5	1.05%
陋	1990		8	26	0.003927%	642196	97.00%	19	3.98%
韋	1991		9	26	0.003927%	642222	97.01%	4	0.84%
丹	1992		4	25	0.003776%	642247	97.01%	18	3.77%
併	1993		8	25	0.003776%	642272	97.01%	16	3.35%
倉	1994		10	25	0.003776%	642297	97.02%	17	3.56%
吻	1995		7	25	0.003776%	642322	97.02%	19	3.98%
唸	1996		11	25	0.003776%	642347	97.02%	12	2.51%
圾	1997		7	25	0.003776%	642372	97.03%	11	2.30%
扯	1998		7	25	0.003776%	642397	97.03%	20	4.18%
掘	1999		11	25	0.003776%	642422	97.04%	16	3.35%
枚	2000		8	25	0.003776%	642447	97.04%	18	3.77%
株	2001		10	25	0.003776%	642472	97.04%	19	3.98%
洩	2002		9	25	0.003776%	642497	97.05%	18	3.77%
淋	2003		11	25	0.003776%	642522	97.05%	14	2.93%
炮	2004		9	25	0.003776%	642547	97.05%	16	3.35%
焉	2005		11	25	0.003776%	642572	97.06%	12	2.51%
焦	2006		12	25	0.003776%	642597	97.06%	19	3.98%
牧	2007		8	25	0.003776%	642622	97.07%	14	2.93%
甸	2008		7	25	0.003776%	642647	97.07%	16	3.35%
畝	2009		10	25	0.003776%	642672	97.07%	11	2.30%
瞬	2010		17	25	0.003776%	642697	97.08%	21	4.39%
祥	2011		10	25	0.003776%	642722	97.08%	20	4.18%
穌	2012		16	25	0.003776%	642747	97.08%	10	2.09%
膜	2013		15	25	0.003776%	642772	97.09%	15	3.14%
蚊	2014		10	25	0.003776%	642797	97.09%	7	1.46%
贈	2015		19	25	0.003776%	642822	97.10%	17	3.56%
辣	2016		14	25	0.003776%	642847	97.10%	12	2.51%
郎	2017		8	25	0.003776%	642872	97.10%	18	3.77%
銳	2018		15	25	0.003776%	642897	97.11%	20	4.18%
頁	2019		9	25	0.003776%	642922	97.11%	18	3.77%
鴨	2020		16	25	0.003776%	642947	97.11%	13	2.72%
剎	2021		9	24	0.003625%	642971	97.12%	19	3.98%
匹	2022		4	24	0.003625%	642995	97.12%	18	3.77%
垃	2023		8	24	0.003625%	643019	97.13%	11	2.30%
墜	2024		15	24	0.003625%	643043	97.13%	20	4.18%
妥	2025		7	24	0.003625%	643067	97.13%	20	4.18%
寸	2026		3	24	0.003625%	643091	97.14%	18	3.77%
屍	2027		9	24	0.003625%	643115	97.14%	12	2.51%
帆	2028		6	24	0.003625%	643139	97.14%	21	4.39%
擱	2029		17	24	0.003625%	643163	97.15%	15	3.14%
欠	2030		4	24	0.003625%	643187	97.15%	20	4.18%
欺	2031		12	24	0.003625%	643211	97.15%	18	3.77%
滲	2032		14	24	0.003625%	643235	97.16%	20	4.18%
爐	2033		20	24	0.003625%	643259	97.16%	19	3.98%
瘦	2034		14	24	0.003625%	643283	97.17%	18	3.77%
眠	2035		10	24	0.003625%	643307	97.17%	18	3.77%
磯	2036		17	24	0.003625%	643331	97.17%	1	0.21%
祠	2037		9	24	0.003625%	643355	97.18%	4	0.84%
纖	2038		23	24	0.003625%	643379	97.18%	12	2.51%
膨	2039		16	24	0.003625%	643403	97.18%	7	1.46%
臂	2040		17	24	0.003625%	643427	97.19%	17	3.56%
蔽	2041		15	24	0.003625%	643451	97.19%	17	3.56%
跨	2042		13	24	0.003625%	643475	97.19%	18	3.77%
鈔	2043		12	24	0.003625%	643499	97.20%	12	2.51%
陪	2044		10	24	0.003625%	643523	97.20%	19	3.98%
鴉	2045		15	24	0.003625%	643547	97.21%	14	2.93%
伐	2046		6	23	0.003474%	643570	97.21%	20	4.18%
剝	2047		10	23	0.003474%	643593	97.21%	20	4.18%
卿	2048		10	23	0.003474%	643616	97.22%	8	1.67%
坑	2049		7	23	0.003474%	643639	97.22%	14	2.93%
址	2050		7	23	0.003474%	643662	97.22%	18	3.77%
嬌	2051		15	23	0.003474%	643685	97.23%	21	4.39%
帳	2052		11	23	0.003474%	643708	97.23%	13	2.72%
征	2053		8	23	0.003474%	643731	97.23%	18	3.77%
抖	2054		7	23	0.003474%	643754	97.24%	20	4.18%
斥	2055		5	23	0.003474%	643777	97.24%	16	3.35%
曠	2056		19	23	0.003474%	643800	97.24%	20	4.18%
殿	2057		13	23	0.003474%	643823	97.25%	10	2.09%
滯	2058		14	23	0.003474%	643846	97.25%	19	3.98%
瀑	2059		18	23	0.003474%	643869	97.25%	6	1.25%
煌	2060		13	23	0.003474%	643892	97.26%	16	3.35%
牢	2061		7	23	0.003474%	643915	97.26%	16	3.35%
狠	2062		9	23	0.003474%	643938	97.26%	13	2.72%
矓	2063		21	23	0.003474%	643961	97.27%	17	3.56%
禱	2064		18	23	0.003474%	643984	97.27%	14	2.93%
窩	2065		14	23	0.003474%	644007	97.27%	18	3.77%
箭	2066		15	23	0.003474%	644030	97.28%	15	3.14%
聘	2067		13	23	0.003474%	644053	97.28%	13	2.72%
肚	2068		7	23	0.003474%	644076	97.29%	15	3.14%
脆	2069		10	23	0.003474%	644099	97.29%	19	3.98%
蔭	2070		15	23	0.003474%	644122	97.29%	19	3.98%
蝶	2071		15	23	0.003474%	644145	97.30%	13	2.72%
逆	2072		9	23	0.003474%	644168	97.30%	17	3.56%
鄭	2073		14	23	0.003474%	644191	97.30%	13	2.72%
鍋	2074		17	23	0.003474%	644214	97.31%	6	1.25%
驟	2075		24	23	0.003474%	644237	97.31%	19	3.98%
催	2076		13	22	0.003323%	644259	97.31%	12	2.51%
償	2077		17	22	0.003323%	644281	97.32%	18	3.77%
允	2078		4	22	0.003323%	644303	97.32%	17	3.56%
剪	2079		11	22	0.003323%	644325	97.32%	15	3.14%
唇	2080		10	22	0.003323%	644347	97.33%	17	3.56%
喧	2081		12	22	0.003323%	644369	97.33%	19	3.98%
嗅	2082		13	22	0.003323%	644391	97.33%	13	2.72%
契	2083		9	22	0.003323%	644413	97.34%	17	3.56%
嫌	2084		13	22	0.003323%	644435	97.34%	19	3.98%
宏	2085		7	22	0.003323%	644457	97.34%	16	3.35%
惶	2086		12	22	0.003323%	644479	97.35%	15	3.14%
撈	2087		15	22	0.003323%	644501	97.35%	10	2.09%
擦	2088		17	22	0.003323%	644523	97.35%	15	3.14%
旱	2089		7	22	0.003323%	644545	97.36%	12	2.51%
樽	2090		16	22	0.003323%	644567	97.36%	2	0.42%
殼	2091		12	22	0.003323%	644589	97.36%	16	3.35%
滔	2092		13	22	0.003323%	644611	97.37%	11	2.30%
畏	2093		9	22	0.003323%	644633	97.37%	20	4.18%
瞪	2094		17	22	0.003323%	644655	97.37%	12	2.51%
碗	2095		13	22	0.003323%	644677	97.38%	11	2.30%
秒	2096		9	22	0.003323%	644699	97.38%	9	1.88%
簽	2097		19	22	0.003323%	644721	97.38%	12	2.51%
紋	2098		10	22	0.003323%	644743	97.39%	15	3.14%
聳	2099		17	22	0.003323%	644765	97.39%	17	3.56%
肥	2100		8	22	0.003323%	644787	97.39%	16	3.35%
腔	2101		12	22	0.003323%	644809	97.40%	15	3.14%
膀	2102		14	22	0.003323%	644831	97.40%	15	3.14%
膝	2103		15	22	0.003323%	644853	97.40%	14	2.93%
膚	2104		15	22	0.003323%	644875	97.41%	18	3.77%
臥	2105		8	22	0.003323%	644897	97.41%	20	4.18%
芽	2106		8	22	0.003323%	644919	97.41%	20	4.18%
謙	2107		17	22	0.003323%	644941	97.42%	18	3.77%
販	2108		11	22	0.003323%	644963	97.42%	14	2.93%
跌	2109		12	22	0.003323%	644985	97.42%	14	2.93%
輾	2110		17	22	0.003323%	645007	97.43%	20	4.18%
俾	2111		10	21	0.003172%	645028	97.43%	16	3.35%
傍	2112		12	21	0.003172%	645049	97.43%	17	3.56%
債	2113		13	21	0.003172%	645070	97.44%	13	2.72%
哨	2114		10	21	0.003172%	645091	97.44%	15	3.14%
唉	2115		10	21	0.003172%	645112	97.44%	14	2.93%
嗚	2116		13	21	0.003172%	645133	97.45%	14	2.93%
囂	2117		21	21	0.003172%	645154	97.45%	19	3.98%
媚	2118		12	21	0.003172%	645175	97.45%	17	3.56%
巡	2119		7	21	0.003172%	645196	97.45%	12	2.51%
廊	2120		12	21	0.003172%	645217	97.46%	10	2.09%
徬	2121		13	21	0.003172%	645238	97.46%	16	3.35%
恥	2122		10	21	0.003172%	645259	97.46%	12	2.51%
慌	2123		13	21	0.003172%	645280	97.47%	18	3.77%
慾	2124		15	21	0.003172%	645301	97.47%	16	3.35%
扮	2125		7	21	0.003172%	645322	97.47%	15	3.14%
揉	2126		12	21	0.003172%	645343	97.48%	12	2.51%
携	2127		13	21	0.003172%	645364	97.48%	13	2.72%
樑	2128		15	21	0.003172%	645385	97.48%	18	3.77%
沾	2129		8	21	0.003172%	645406	97.49%	17	3.56%
浸	2130		10	21	0.003172%	645427	97.49%	15	3.14%
淫	2131		11	21	0.003172%	645448	97.49%	11	2.30%
湯	2132		12	21	0.003172%	645469	97.50%	13	2.72%
渾	2133		12	21	0.003172%	645490	97.50%	17	3.56%
潭	2134		15	21	0.003172%	645511	97.50%	13	2.72%
炸	2135		9	21	0.003172%	645532	97.51%	12	2.51%
狼	2136		10	21	0.003172%	645553	97.51%	17	3.56%
瓏	2137		20	21	0.003172%	645574	97.51%	9	1.88%
疼	2138		10	21	0.003172%	645595	97.51%	6	1.25%
盧	2139		16	21	0.003172%	645616	97.52%	14	2.93%
矇	2140		19	21	0.003172%	645637	97.52%	16	3.35%
祭	2141		11	21	0.003172%	645658	97.52%	14	2.93%
芒	2142		7	21	0.003172%	645679	97.53%	17	3.56%
茂	2143		9	21	0.003172%	645700	97.53%	20	4.18%
荊	2144		10	21	0.003172%	645721	97.53%	11	2.30%
虧	2145		17	21	0.003172%	645742	97.54%	16	3.35%
蛋	2146		11	21	0.003172%	645763	97.54%	14	2.93%
裁	2147		12	21	0.003172%	645784	97.54%	15	3.14%
豬	2148		11	21	0.003172%	645805	97.55%	16	3.35%
賺	2149		17	21	0.003172%	645826	97.55%	12	2.51%
贏	2150		20	21	0.003172%	645847	97.55%	12	2.51%
逼	2151		12	21	0.003172%	645868	97.56%	19	3.98%
鍾	2152		17	21	0.003172%	645889	97.56%	15	3.14%
鑼	2153		27	21	0.003172%	645910	97.56%	14	2.93%
隅	2154		11	21	0.003172%	645931	97.57%	16	3.35%
韻	2155		19	21	0.003172%	645952	97.57%	17	3.56%
頑	2156		13	21	0.003172%	645973	97.57%	18	3.77%
鹽	2157		24	21	0.003172%	645994	97.58%	14	2.93%
鼠	2158		13	21	0.003172%	646015	97.58%	10	2.09%
佩	2159		8	20	0.003021%	646035	97.58%	17	3.56%
倆	2160		10	20	0.003021%	646055	97.58%	16	3.35%
兇	2161		6	20	0.003021%	646075	97.59%	19	3.98%
匪	2162		10	20	0.003021%	646095	97.59%	12	2.51%
咳	2163		9	20	0.003021%	646115	97.59%	10	2.09%
嚼	2164		20	20	0.003021%	646135	97.60%	14	2.93%
妄	2165		6	20	0.003021%	646155	97.60%	15	3.14%
徊	2166		9	20	0.003021%	646175	97.60%	16	3.35%
憬	2167		15	20	0.003021%	646195	97.61%	18	3.77%
扣	2168		6	20	0.003021%	646215	97.61%	14	2.93%
挖	2169		9	20	0.003021%	646235	97.61%	16	3.35%
捉	2170		10	20	0.003021%	646255	97.61%	18	3.77%
挪	2171		10	20	0.003021%	646275	97.62%	9	1.88%
掀	2172		11	20	0.003021%	646295	97.62%	17	3.56%
撤	2173		14	20	0.003021%	646315	97.62%	15	3.14%
斑	2174		12	20	0.003021%	646335	97.63%	15	3.14%
斤	2175		4	20	0.003021%	646355	97.63%	14	2.93%
泣	2176		8	20	0.003021%	646375	97.63%	16	3.35%
沸	2177		8	20	0.003021%	646395	97.64%	18	3.77%
溉	2178		12	20	0.003021%	646415	97.64%	13	2.72%
濛	2179		17	20	0.003021%	646435	97.64%	12	2.51%
睹	2180		13	20	0.003021%	646455	97.64%	20	4.18%
矮	2181		13	20	0.003021%	646475	97.65%	14	2.93%
砍	2182		9	20	0.003021%	646495	97.65%	11	2.30%
碌	2183		13	20	0.003021%	646515	97.65%	16	3.35%
竭	2184		14	20	0.003021%	646535	97.66%	19	3.98%
竿	2185		9	20	0.003021%	646555	97.66%	11	2.30%
笨	2186		11	20	0.003021%	646575	97.66%	10	2.09%
纔	2187		23	20	0.003021%	646595	97.67%	12	2.51%
翅	2188		10	20	0.003021%	646615	97.67%	14	2.93%
舌	2189		6	20	0.003021%	646635	97.67%	16	3.35%
萌	2190		12	20	0.003021%	646655	97.67%	12	2.51%
萄	2191		12	20	0.003021%	646675	97.68%	12	2.51%
蝴	2192		15	20	0.003021%	646695	97.68%	11	2.30%
誇	2193		13	20	0.003021%	646715	97.68%	18	3.77%
趁	2194		12	20	0.003021%	646735	97.69%	19	3.98%
辰	2195		7	20	0.003021%	646755	97.69%	15	3.14%
鋪	2196		15	20	0.003021%	646775	97.69%	15	3.14%
隙	2197		13	20	0.003021%	646795	97.70%	17	3.56%
韓	2198		17	20	0.003021%	646815	97.70%	13	2.72%
魄	2199		15	20	0.003021%	646835	97.70%	16	3.35%
黛	2200		17	20	0.003021%	646855	97.71%	6	1.25%
丘	2201		5	19	0.00287%	646874	97.71%	12	2.51%
偽	2202		11	19	0.00287%	646893	97.71%	15	3.14%
凄	2203		10	19	0.00287%	646912	97.71%	18	3.77%
卸	2204		8	19	0.00287%	646931	97.72%	13	2.72%
吳	2205		7	19	0.00287%	646950	97.72%	14	2.93%
啞	2206		11	19	0.00287%	646969	97.72%	16	3.35%
壘	2207		18	19	0.00287%	646988	97.73%	10	2.09%
宰	2208		10	19	0.00287%	647007	97.73%	14	2.93%
愚	2209		13	19	0.00287%	647026	97.73%	18	3.77%
披	2210		8	19	0.00287%	647045	97.73%	18	3.77%
捧	2211		11	19	0.00287%	647064	97.74%	18	3.77%
敘	2212		11	19	0.00287%	647083	97.74%	17	3.56%
梨	2213		11	19	0.00287%	647102	97.74%	5	1.05%
潑	2214		15	19	0.00287%	647121	97.75%	15	3.14%
灼	2215		7	19	0.00287%	647140	97.75%	17	3.56%
犬	2216		4	19	0.00287%	647159	97.75%	14	2.93%
狐	2217		8	19	0.00287%	647178	97.75%	7	1.46%
瑣	2218		14	19	0.00287%	647197	97.76%	16	3.35%
畜	2219		10	19	0.00287%	647216	97.76%	5	1.05%
眺	2220		11	19	0.00287%	647235	97.76%	17	3.56%
磡	2221		16	19	0.00287%	647254	97.77%	9	1.88%
穴	2222		5	19	0.00287%	647273	97.77%	7	1.46%
綜	2223		14	19	0.00287%	647292	97.77%	18	3.77%
綱	2224		14	19	0.00287%	647311	97.77%	15	3.14%
縷	2225		17	19	0.00287%	647330	97.78%	11	2.30%
羨	2226		13	19	0.00287%	647349	97.78%	13	2.72%
翔	2227		12	19	0.00287%	647368	97.78%	14	2.93%
胎	2228		9	19	0.00287%	647387	97.79%	8	1.67%
脊	2229		10	19	0.00287%	647406	97.79%	13	2.72%
諮	2230		16	19	0.00287%	647425	97.79%	14	2.93%
譜	2231		19	19	0.00287%	647444	97.79%	15	3.14%
貪	2232		11	19	0.00287%	647463	97.80%	16	3.35%
貸	2233		12	19	0.00287%	647482	97.80%	9	1.88%
遞	2234		13	19	0.00287%	647501	97.80%	18	3.77%
鄧	2235		14	19	0.00287%	647520	97.81%	12	2.51%
釘	2236		10	19	0.00287%	647539	97.81%	15	3.14%
鍊	2237		17	19	0.00287%	647558	97.81%	16	3.35%
飢	2238		10	19	0.00287%	647577	97.81%	16	3.35%
鴻	2239		17	19	0.00287%	647596	97.82%	12	2.51%
仿	2240		6	18	0.002719%	647614	97.82%	12	2.51%
凍	2241		10	18	0.002719%	647632	97.82%	16	3.35%
匠	2242		6	18	0.002719%	647650	97.83%	12	2.51%
卜	2243		2	18	0.002719%	647668	97.83%	5	1.05%
喃	2244		12	18	0.002719%	647686	97.83%	9	1.88%
娶	2245		11	18	0.002719%	647704	97.83%	5	1.05%
宵	2246		10	18	0.002719%	647722	97.84%	11	2.30%
屠	2247		11	18	0.002719%	647740	97.84%	11	2.30%
崩	2248		11	18	0.002719%	647758	97.84%	16	3.35%
巒	2249		22	18	0.002719%	647776	97.84%	17	3.56%
徨	2250		12	18	0.002719%	647794	97.85%	14	2.93%
惹	2251		13	18	0.002719%	647812	97.85%	15	3.14%
憧	2252		15	18	0.002719%	647830	97.85%	16	3.35%
挫	2253		10	18	0.002719%	647848	97.86%	16	3.35%
擋	2254		16	18	0.002719%	647866	97.86%	16	3.35%
昇	2255		8	18	0.002719%	647884	97.86%	14	2.93%
暇	2256		13	18	0.002719%	647902	97.86%	16	3.35%
曼	2257		11	18	0.002719%	647920	97.87%	12	2.51%
柯	2258		9	18	0.002719%	647938	97.87%	10	2.09%
梢	2259		11	18	0.002719%	647956	97.87%	17	3.56%
楓	2260		13	18	0.002719%	647974	97.87%	6	1.25%
榴	2261		14	18	0.002719%	647992	97.88%	6	1.25%
澄	2262		15	18	0.002719%	648010	97.88%	13	2.72%
煮	2263		12	18	0.002719%	648028	97.88%	11	2.30%
盒	2264		11	18	0.002719%	648046	97.89%	8	1.67%
盟	2265		13	18	0.002719%	648064	97.89%	13	2.72%
穫	2266		19	18	0.002719%	648082	97.89%	16	3.35%
粵	2267		13	18	0.002719%	648100	97.89%	14	2.93%
羽	2268		6	18	0.002719%	648118	97.90%	9	1.88%
翁	2269		10	18	0.002719%	648136	97.90%	13	2.72%
肅	2270		12	18	0.002719%	648154	97.90%	14	2.93%
脾	2271		12	18	0.002719%	648172	97.90%	17	3.56%
臭	2272		10	18	0.002719%	648190	97.91%	14	2.93%
菌	2273		12	18	0.002719%	648208	97.91%	8	1.67%
蓬	2274		15	18	0.002719%	648226	97.91%	15	3.14%
蘆	2275		20	18	0.002719%	648244	97.91%	13	2.72%
裕	2276		12	18	0.002719%	648262	97.92%	15	3.14%
詛	2277		12	18	0.002719%	648280	97.92%	8	1.67%
賬	2278		15	18	0.002719%	648298	97.92%	10	2.09%
蹦	2279		18	18	0.002719%	648316	97.93%	10	2.09%
邏	2280		22	18	0.002719%	648334	97.93%	11	2.30%
鋁	2281		15	18	0.002719%	648352	97.93%	8	1.67%
鞭	2282		18	18	0.002719%	648370	97.93%	15	3.14%
頰	2283		16	18	0.002719%	648388	97.94%	15	3.14%
饒	2284		20	18	0.002719%	648406	97.94%	18	3.77%
騎	2285		18	18	0.002719%	648424	97.94%	13	2.72%
伊	2286		6	17	0.002568%	648441	97.94%	15	3.14%
嘻	2287		15	17	0.002568%	648458	97.95%	8	1.67%
埠	2288		11	17	0.002568%	648475	97.95%	13	2.72%
堡	2289		12	17	0.002568%	648492	97.95%	12	2.51%
墟	2290		15	17	0.002568%	648509	97.95%	10	2.09%
壺	2291		12	17	0.002568%	648526	97.96%	5	1.05%
徘	2292		11	17	0.002568%	648543	97.96%	14	2.93%
忌	2293		7	17	0.002568%	648560	97.96%	13	2.72%
悵	2294		11	17	0.002568%	648577	97.97%	15	3.14%
拓	2295		8	17	0.002568%	648594	97.97%	15	3.14%
曳	2296		6	17	0.002568%	648611	97.97%	16	3.35%
櫃	2297		18	17	0.002568%	648628	97.97%	11	2.30%
欽	2298		12	17	0.002568%	648645	97.98%	12	2.51%
歎	2299		15	17	0.002568%	648662	97.98%	13	2.72%
涵	2300		11	17	0.002568%	648679	97.98%	12	2.51%
淘	2301		11	17	0.002568%	648696	97.98%	16	3.35%
澀	2302		17	17	0.002568%	648713	97.99%	15	3.14%
瀾	2303		20	17	0.002568%	648730	97.99%	11	2.30%
瀰	2304		20	17	0.002568%	648747	97.99%	14	2.93%
熊	2305		14	17	0.002568%	648764	97.99%	10	2.09%
爵	2306		17	17	0.002568%	648781	98.00%	10	2.09%
硫	2307		11	17	0.002568%	648798	98.00%	3	0.63%
簇	2308		17	17	0.002568%	648815	98.00%	9	1.88%
緬	2309		15	17	0.002568%	648832	98.00%	11	2.30%
胃	2310		9	17	0.002568%	648849	98.01%	8	1.67%
腿	2311		14	17	0.002568%	648866	98.01%	11	2.30%
苟	2312		9	17	0.002568%	648883	98.01%	11	2.30%
董	2313		13	17	0.002568%	648900	98.01%	10	2.09%
蘊	2314		20	17	0.002568%	648917	98.02%	15	3.14%
蟬	2315		18	17	0.002568%	648934	98.02%	7	1.46%
襯	2316		21	17	0.002568%	648951	98.02%	15	3.14%
軀	2317		18	17	0.002568%	648968	98.02%	14	2.93%
轟	2318		21	17	0.002568%	648985	98.03%	8	1.67%
逗	2319		10	17	0.002568%	649002	98.03%	15	3.14%
逛	2320		10	17	0.002568%	649019	98.03%	12	2.51%
逾	2321		12	17	0.002568%	649036	98.03%	11	2.30%
遼	2322		15	17	0.002568%	649053	98.04%	15	3.14%
閡	2323		14	17	0.002568%	649070	98.04%	6	1.25%
霍	2324		16	17	0.002568%	649087	98.04%	12	2.51%
頹	2325		16	17	0.002568%	649104	98.04%	13	2.72%
鳳	2326		14	17	0.002568%	649121	98.05%	13	2.72%
麟	2327		23	17	0.002568%	649138	98.05%	9	1.88%
乖	2328		8	16	0.002417%	649154	98.05%	6	1.25%
乙	2329		1	16	0.002417%	649170	98.05%	10	2.09%
佐	2330		7	16	0.002417%	649186	98.06%	8	1.67%
儉	2331		15	16	0.002417%	649202	98.06%	13	2.72%
凌	2332		10	16	0.002417%	649218	98.06%	15	3.14%
卉	2333		5	16	0.002417%	649234	98.06%	6	1.25%
叛	2334		9	16	0.002417%	649250	98.07%	12	2.51%
吠	2335		7	16	0.002417%	649266	98.07%	14	2.93%
咖	2336		8	16	0.002417%	649282	98.07%	8	1.67%
呻	2337		8	16	0.002417%	649298	98.07%	16	3.35%
咬	2338		9	16	0.002417%	649314	98.08%	12	2.51%
哮	2339		10	16	0.002417%	649330	98.08%	10	2.09%
啡	2340		11	16	0.002417%	649346	98.08%	8	1.67%
喘	2341		12	16	0.002417%	649362	98.08%	14	2.93%
坎	2342		7	16	0.002417%	649378	98.09%	11	2.30%
嬰	2343		17	16	0.002417%	649394	98.09%	12	2.51%
峭	2344		10	16	0.002417%	649410	98.09%	8	1.67%
巍	2345		21	16	0.002417%	649426	98.09%	12	2.51%
怖	2346		8	16	0.002417%	649442	98.10%	12	2.51%
恭	2347		10	16	0.002417%	649458	98.10%	12	2.51%
憎	2348		15	16	0.002417%	649474	98.10%	9	1.88%
摧	2349		14	16	0.002417%	649490	98.10%	14	2.93%
攔	2350		20	16	0.002417%	649506	98.11%	8	1.67%
棕	2351		12	16	0.002417%	649522	98.11%	5	1.05%
檯	2352		18	16	0.002417%	649538	98.11%	11	2.30%
溺	2353		13	16	0.002417%	649554	98.11%	10	2.09%
潰	2354		15	16	0.002417%	649570	98.12%	14	2.93%
熄	2355		14	16	0.002417%	649586	98.12%	11	2.30%
猜	2356		11	16	0.002417%	649602	98.12%	16	3.35%
獄	2357		14	16	0.002417%	649618	98.12%	13	2.72%
盜	2358		12	16	0.002417%	649634	98.12%	13	2.72%
稚	2359		13	16	0.002417%	649650	98.13%	11	2.30%
翼	2360		17	16	0.002417%	649666	98.13%	9	1.88%
艾	2361		6	16	0.002417%	649682	98.13%	9	1.88%
芬	2362		8	16	0.002417%	649698	98.13%	13	2.72%
荔	2363		10	16	0.002417%	649714	98.14%	8	1.67%
虹	2364		9	16	0.002417%	649730	98.14%	10	2.09%
裹	2365		14	16	0.002417%	649746	98.14%	10	2.09%
褲	2366		15	16	0.002417%	649762	98.14%	12	2.51%
諒	2367		15	16	0.002417%	649778	98.15%	15	3.14%
賦	2368		15	16	0.002417%	649794	98.15%	15	3.14%
逸	2369		11	16	0.002417%	649810	98.15%	12	2.51%
鄙	2370		13	16	0.002417%	649826	98.15%	11	2.30%
酬	2371		13	16	0.002417%	649842	98.16%	15	3.14%
釀	2372		24	16	0.002417%	649858	98.16%	12	2.51%
鈴	2373		13	16	0.002417%	649874	98.16%	14	2.93%
鉅	2374		13	16	0.002417%	649890	98.16%	12	2.51%
銜	2375		14	16	0.002417%	649906	98.17%	14	2.93%
閑	2376		12	16	0.002417%	649922	98.17%	11	2.30%
陵	2377		10	16	0.002417%	649938	98.17%	9	1.88%
頒	2378		13	16	0.002417%	649954	98.17%	12	2.51%
駁	2379		14	16	0.002417%	649970	98.18%	12	2.51%
麓	2380		19	16	0.002417%	649986	98.18%	9	1.88%
黯	2381		21	16	0.002417%	650002	98.18%	14	2.93%
仇	2382		4	15	0.002266%	650017	98.18%	12	2.51%
傭	2383		13	15	0.002266%	650032	98.19%	8	1.67%
傻	2384		13	15	0.002266%	650047	98.19%	14	2.93%
兮	2385		4	15	0.002266%	650062	98.19%	7	1.46%
凋	2386		10	15	0.002266%	650077	98.19%	10	2.09%
卓	2387		8	15	0.002266%	650092	98.19%	12	2.51%
咸	2388		9	15	0.002266%	650107	98.20%	10	2.09%
唧	2389		10	15	0.002266%	650122	98.20%	7	1.46%
啤	2390		11	15	0.002266%	650137	98.20%	6	1.25%
囉	2391		22	15	0.002266%	650152	98.20%	7	1.46%
埃	2392		10	15	0.002266%	650167	98.21%	7	1.46%
奠	2393		12	15	0.002266%	650182	98.21%	10	2.09%
姪	2394		9	15	0.002266%	650197	98.21%	2	0.42%
屑	2395		10	15	0.002266%	650212	98.21%	10	2.09%
弦	2396		8	15	0.002266%	650227	98.21%	11	2.30%
慷	2397		14	15	0.002266%	650242	98.22%	12	2.51%
扉	2398		12	15	0.002266%	650257	98.22%	8	1.67%
拙	2399		8	15	0.002266%	650272	98.22%	10	2.09%
挨	2400		10	15	0.002266%	650287	98.22%	12	2.51%
掣	2401		12	15	0.002266%	650302	98.23%	6	1.25%
敞	2402		12	15	0.002266%	650317	98.23%	10	2.09%
昌	2403		8	15	0.002266%	650332	98.23%	9	1.88%
晝	2404		11	15	0.002266%	650347	98.23%	13	2.72%
晰	2405		12	15	0.002266%	650362	98.23%	14	2.93%
棒	2406		12	15	0.002266%	650377	98.24%	8	1.67%
棲	2407		12	15	0.002266%	650392	98.24%	13	2.72%
棚	2408		12	15	0.002266%	650407	98.24%	11	2.30%
汪	2409		7	15	0.002266%	650422	98.24%	9	1.88%
洒	2410		9	15	0.002266%	650437	98.25%	12	2.51%
浴	2411		10	15	0.002266%	650452	98.25%	8	1.67%
湊	2412		12	15	0.002266%	650467	98.25%	11	2.30%
渠	2413		12	15	0.002266%	650482	98.25%	11	2.30%
渣	2414		12	15	0.002266%	650497	98.26%	11	2.30%
澗	2415		15	15	0.002266%	650512	98.26%	11	2.30%
炙	2416		8	15	0.002266%	650527	98.26%	5	1.05%
眨	2417		10	15	0.002266%	650542	98.26%	10	2.09%
睦	2418		13	15	0.002266%	650557	98.26%	13	2.72%
礙	2419		19	15	0.002266%	650572	98.27%	15	3.14%
祈	2420		8	15	0.002266%	650587	98.27%	12	2.51%
禦	2421		16	15	0.002266%	650602	98.27%	10	2.09%
稼	2422		15	15	0.002266%	650617	98.27%	8	1.67%
纜	2423		27	15	0.002266%	650632	98.28%	5	1.05%
罰	2424		14	15	0.002266%	650647	98.28%	8	1.67%
萊	2425		12	15	0.002266%	650662	98.28%	11	2.30%
蝕	2426		14	15	0.002266%	650677	98.28%	14	2.93%
裙	2427		12	15	0.002266%	650692	98.28%	13	2.72%
裊	2428		13	15	0.002266%	650707	98.29%	6	1.25%
貯	2429		12	15	0.002266%	650722	98.29%	10	2.09%
迦	2430		8	15	0.002266%	650737	98.29%	3	0.63%
遵	2431		15	15	0.002266%	650752	98.29%	15	3.14%
鏢	2432		19	15	0.002266%	650767	98.30%	1	0.21%
闖	2433		18	15	0.002266%	650782	98.30%	12	2.51%
雕	2434		16	15	0.002266%	650797	98.30%	12	2.51%
顫	2435		22	15	0.002266%	650812	98.30%	12	2.51%
鶴	2436		21	15	0.002266%	650827	98.31%	12	2.51%
仲	2437		6	14	0.002115%	650841	98.31%	12	2.51%
傑	2438		12	14	0.002115%	650855	98.31%	14	2.93%
刮	2439		8	14	0.002115%	650869	98.31%	12	2.51%
勾	2440		4	14	0.002115%	650883	98.31%	10	2.09%
吊	2441		6	14	0.002115%	650897	98.32%	13	2.72%
咆	2442		8	14	0.002115%	650911	98.32%	8	1.67%
嘶	2443		15	14	0.002115%	650925	98.32%	12	2.51%
嚇	2444		17	14	0.002115%	650939	98.32%	14	2.93%
坭	2445		8	14	0.002115%	650953	98.32%	11	2.30%
媒	2446		12	14	0.002115%	650967	98.33%	5	1.05%
岳	2447		8	14	0.002115%	650981	98.33%	5	1.05%
峻	2448		10	14	0.002115%	650995	98.33%	8	1.67%
巢	2449		11	14	0.002115%	651009	98.33%	12	2.51%
弘	2450		5	14	0.002115%	651023	98.33%	3	0.63%
恤	2451		9	14	0.002115%	651037	98.34%	10	2.09%
憩	2452		16	14	0.002115%	651051	98.34%	11	2.30%
拘	2453		8	14	0.002115%	651065	98.34%	13	2.72%
攷	2454		7	14	0.002115%	651079	98.34%	9	1.88%
胆	2455		9	14	0.002115%	651093	98.35%	13	2.72%
棘	2456		12	14	0.002115%	651107	98.35%	10	2.09%
櫚	2457		19	14	0.002115%	651121	98.35%	3	0.63%
氧	2458		10	14	0.002115%	651135	98.35%	8	1.67%
沛	2459		7	14	0.002115%	651149	98.35%	12	2.51%
洽	2460		9	14	0.002115%	651163	98.36%	12	2.51%
浬	2461		10	14	0.002115%	651177	98.36%	1	0.21%
淹	2462		11	14	0.002115%	651191	98.36%	9	1.88%
漂	2463		14	14	0.002115%	651205	98.36%	13	2.72%
濁	2464		16	14	0.002115%	651219	98.36%	10	2.09%
煉	2465		13	14	0.002115%	651233	98.37%	11	2.30%
瑟	2466		13	14	0.002115%	651247	98.37%	14	2.93%
瑩	2467		15	14	0.002115%	651261	98.37%	10	2.09%
盞	2468		13	14	0.002115%	651275	98.37%	10	2.09%
瞧	2469		17	14	0.002115%	651289	98.37%	10	2.09%
磁	2470		14	14	0.002115%	651303	98.38%	5	1.05%
禿	2471		7	14	0.002115%	651317	98.38%	12	2.51%
秫	2472		10	14	0.002115%	651331	98.38%	3	0.63%
窒	2473		11	14	0.002115%	651345	98.38%	13	2.72%
窺	2474		16	14	0.002115%	651359	98.39%	13	2.72%
簾	2475		19	14	0.002115%	651373	98.39%	13	2.72%
籬	2476		25	14	0.002115%	651387	98.39%	10	2.09%
糕	2477		16	14	0.002115%	651401	98.39%	12	2.51%
糟	2478		17	14	0.002115%	651415	98.39%	11	2.30%
紗	2479		10	14	0.002115%	651429	98.40%	12	2.51%
聆	2480		11	14	0.002115%	651443	98.40%	12	2.51%
肇	2481		14	14	0.002115%	651457	98.40%	5	1.05%
腸	2482		13	14	0.002115%	651471	98.40%	13	2.72%
腹	2483		13	14	0.002115%	651485	98.40%	10	2.09%
茗	2484		10	14	0.002115%	651499	98.41%	9	1.88%
薛	2485		17	14	0.002115%	651513	98.41%	6	1.25%
薰	2486		18	14	0.002115%	651527	98.41%	14	2.93%
虫	2487		6	14	0.002115%	651541	98.41%	10	2.09%
襟	2488		18	14	0.002115%	651555	98.42%	12	2.51%
診	2489		12	14	0.002115%	651569	98.42%	12	2.51%
誨	2490		14	14	0.002115%	651583	98.42%	5	1.05%
跪	2491		13	14	0.002115%	651597	98.42%	11	2.30%
踐	2492		15	14	0.002115%	651611	98.42%	8	1.67%
躭	2493		11	14	0.002115%	651625	98.43%	13	2.72%
迪	2494		8	14	0.002115%	651639	98.43%	8	1.67%
銥	2495		14	14	0.002115%	651653	98.43%	1	0.21%
鶯	2496		21	14	0.002115%	651667	98.43%	7	1.46%
丙	2497		5	13	0.001964%	651680	98.43%	8	1.67%
侶	2498		9	13	0.001964%	651693	98.44%	10	2.09%
傘	2499		12	13	0.001964%	651706	98.44%	9	1.88%
僕	2500		14	13	0.001964%	651719	98.44%	7	1.46%
勻	2501		4	13	0.001964%	651732	98.44%	8	1.67%
叔	2502		8	13	0.001964%	651745	98.44%	8	1.67%
呃	2503		7	13	0.001964%	651758	98.45%	1	0.21%
啼	2504		12	13	0.001964%	651771	98.45%	11	2.30%
嗜	2505		13	13	0.001964%	651784	98.45%	7	1.46%
嘲	2506		15	13	0.001964%	651797	98.45%	10	2.09%
埧	2507		11	13	0.001964%	651810	98.45%	2	0.42%
壤	2508		20	13	0.001964%	651823	98.46%	11	2.30%
宴	2509		10	13	0.001964%	651836	98.46%	12	2.51%
寥	2510		14	13	0.001964%	651849	98.46%	10	2.09%
屢	2511		14	13	0.001964%	651862	98.46%	11	2.30%
履	2512		15	13	0.001964%	651875	98.46%	13	2.72%
峨	2513		10	13	0.001964%	651888	98.47%	10	2.09%
幌	2514		13	13	0.001964%	651901	98.47%	10	2.09%
廚	2515		15	13	0.001964%	651914	98.47%	13	2.72%
弭	2516		9	13	0.001964%	651927	98.47%	4	0.84%
惘	2517		11	13	0.001964%	651940	98.47%	11	2.30%
戚	2518		11	13	0.001964%	651953	98.48%	10	2.09%
扭	2519		7	13	0.001964%	651966	98.48%	11	2.30%
挾	2520		10	13	0.001964%	651979	98.48%	10	2.09%
搜	2521		12	13	0.001964%	651992	98.48%	10	2.09%
摯	2522		15	13	0.001964%	652005	98.48%	12	2.51%
撼	2523		16	13	0.001964%	652018	98.49%	11	2.30%
朽	2524		6	13	0.001964%	652031	98.49%	11	2.30%
棺	2525		12	13	0.001964%	652044	98.49%	4	0.84%
榜	2526		14	13	0.001964%	652057	98.49%	12	2.51%
檀	2527		17	13	0.001964%	652070	98.49%	3	0.63%
檔	2528		17	13	0.001964%	652083	98.49%	7	1.46%
毋	2529		4	13	0.001964%	652096	98.50%	9	1.88%
瀉	2530		18	13	0.001964%	652109	98.50%	11	2.30%
猴	2531		12	13	0.001964%	652122	98.50%	7	1.46%
玄	2532		5	13	0.001964%	652135	98.50%	11	2.30%
瑯	2533		13	13	0.001964%	652148	98.50%	4	0.84%
盯	2534		7	13	0.001964%	652161	98.51%	9	1.88%
睜	2535		13	13	0.001964%	652174	98.51%	10	2.09%
砰	2536		10	13	0.001964%	652187	98.51%	2	0.42%
磚	2537		16	13	0.001964%	652200	98.51%	8	1.67%
禪	2538		16	13	0.001964%	652213	98.51%	6	1.25%
禾	2539		5	13	0.001964%	652226	98.52%	10	2.09%
筒	2540		12	13	0.001964%	652239	98.52%	8	1.67%
絮	2541		12	13	0.001964%	652252	98.52%	10	2.09%
縛	2542		16	13	0.001964%	652265	98.52%	13	2.72%
纍	2543		21	13	0.001964%	652278	98.52%	5	1.05%
翩	2544		15	13	0.001964%	652291	98.53%	6	1.25%
肢	2545		8	13	0.001964%	652304	98.53%	8	1.67%
腫	2546		13	13	0.001964%	652317	98.53%	8	1.67%
臟	2547		22	13	0.001964%	652330	98.53%	13	2.72%
苔	2548		9	13	0.001964%	652343	98.53%	8	1.67%
蔣	2549		15	13	0.001964%	652356	98.54%	10	2.09%
蜂	2550		13	13	0.001964%	652369	98.54%	10	2.09%
螺	2551		17	13	0.001964%	652382	98.54%	9	1.88%
蠅	2552		19	13	0.001964%	652395	98.54%	7	1.46%
蠟	2553		21	13	0.001964%	652408	98.54%	4	0.84%
覓	2554		11	13	0.001964%	652421	98.55%	13	2.72%
訣	2555		11	13	0.001964%	652434	98.55%	5	1.05%
豎	2556		15	13	0.001964%	652447	98.55%	13	2.72%
邁	2557		16	13	0.001964%	652460	98.55%	11	2.30%
釉	2558		13	13	0.001964%	652473	98.55%	3	0.63%
鋒	2559		15	13	0.001964%	652486	98.56%	10	2.09%
鎊	2560		18	13	0.001964%	652499	98.56%	7	1.46%
閣	2561		14	13	0.001964%	652512	98.56%	10	2.09%
靡	2562		19	13	0.001964%	652525	98.56%	5	1.05%
鹿	2563		11	13	0.001964%	652538	98.56%	7	1.46%
乞	2564		3	12	0.001813%	652550	98.57%	8	1.67%
傀	2565		12	12	0.001813%	652562	98.57%	5	1.05%
儡	2566		17	12	0.001813%	652574	98.57%	5	1.05%
募	2567		13	12	0.001813%	652586	98.57%	6	1.25%
唔	2568		10	12	0.001813%	652598	98.57%	9	1.88%
嘯	2569		15	12	0.001813%	652610	98.57%	11	2.30%
嚮	2570		18	12	0.001813%	652622	98.58%	11	2.30%
塾	2571		14	12	0.001813%	652634	98.58%	4	0.84%
宛	2572		8	12	0.001813%	652646	98.58%	12	2.51%
屁	2573		7	12	0.001813%	652658	98.58%	9	1.88%
巾	2574		3	12	0.001813%	652670	98.58%	8	1.67%
廓	2575		14	12	0.001813%	652682	98.59%	11	2.30%
恍	2576		9	12	0.001813%	652694	98.59%	11	2.30%
悽	2577		11	12	0.001813%	652706	98.59%	10	2.09%
惆	2578		11	12	0.001813%	652718	98.59%	10	2.09%
拯	2579		9	12	0.001813%	652730	98.59%	8	1.67%
拳	2580		10	12	0.001813%	652742	98.59%	8	1.67%
撐	2581		15	12	0.001813%	652754	98.60%	10	2.09%
撕	2582		15	12	0.001813%	652766	98.60%	10	2.09%
斬	2583		11	12	0.001813%	652778	98.60%	10	2.09%
晉	2584		10	12	0.001813%	652790	98.60%	9	1.88%
晃	2585		10	12	0.001813%	652802	98.60%	7	1.46%
暈	2586		13	12	0.001813%	652814	98.61%	9	1.88%
曇	2587		16	12	0.001813%	652826	98.61%	3	0.63%
朦	2588		18	12	0.001813%	652838	98.61%	8	1.67%
樞	2589		15	12	0.001813%	652850	98.61%	8	1.67%
洶	2590		9	12	0.001813%	652862	98.61%	11	2.30%
湄	2591		12	12	0.001813%	652874	98.61%	4	0.84%
漓	2592		14	12	0.001813%	652886	98.62%	8	1.67%
漾	2593		14	12	0.001813%	652898	98.62%	11	2.30%
濘	2594		17	12	0.001813%	652910	98.62%	9	1.88%
烘	2595		10	12	0.001813%	652922	98.62%	9	1.88%
爍	2596		19	12	0.001813%	652934	98.62%	9	1.88%
瘡	2597		15	12	0.001813%	652946	98.63%	9	1.88%
癌	2598		17	12	0.001813%	652958	98.63%	7	1.46%
皺	2599		15	12	0.001813%	652970	98.63%	11	2.30%
碟	2600		14	12	0.001813%	652982	98.63%	8	1.67%
稠	2601		13	12	0.001813%	652994	98.63%	12	2.51%
稻	2602		15	12	0.001813%	653006	98.63%	10	2.09%
笛	2603		11	12	0.001813%	653018	98.64%	10	2.09%
箕	2604		14	12	0.001813%	653030	98.64%	11	2.30%
篤	2605		16	12	0.001813%	653042	98.64%	8	1.67%
簌	2606		17	12	0.001813%	653054	98.64%	5	1.05%
耍	2607		9	12	0.001813%	653066	98.64%	8	1.67%
膳	2608		16	12	0.001813%	653078	98.65%	4	0.84%
舜	2609		12	12	0.001813%	653090	98.65%	6	1.25%
葱	2610		13	12	0.001813%	653102	98.65%	10	2.09%
蔓	2611		15	12	0.001813%	653114	98.65%	12	2.51%
袍	2612		10	12	0.001813%	653126	98.65%	8	1.67%
訝	2613		11	12	0.001813%	653138	98.65%	11	2.30%
誓	2614		14	12	0.001813%	653150	98.66%	10	2.09%
謬	2615		18	12	0.001813%	653162	98.66%	6	1.25%
賀	2616		12	12	0.001813%	653174	98.66%	9	1.88%
貶	2617		12	12	0.001813%	653186	98.66%	7	1.46%
賊	2618		13	12	0.001813%	653198	98.66%	7	1.46%
賜	2619		15	12	0.001813%	653210	98.67%	12	2.51%
趙	2620		14	12	0.001813%	653222	98.67%	6	1.25%
趾	2621		11	12	0.001813%	653234	98.67%	6	1.25%
蹈	2622		17	12	0.001813%	653246	98.67%	12	2.51%
郁	2623		8	12	0.001813%	653258	98.67%	11	2.30%
錶	2624		16	12	0.001813%	653270	98.67%	9	1.88%
鑄	2625		22	12	0.001813%	653282	98.68%	6	1.25%
鑲	2626		25	12	0.001813%	653294	98.68%	11	2.30%
鞂	2627		14	12	0.001813%	653306	98.68%	2	0.42%
餅	2628		14	12	0.001813%	653318	98.68%	8	1.67%
馮	2629		12	12	0.001813%	653330	98.68%	8	1.67%
亟	2630		8	11	0.001662%	653341	98.68%	10	2.09%
亨	2631		7	11	0.001662%	653352	98.69%	4	0.84%
俠	2632		9	11	0.001662%	653363	98.69%	11	2.30%
倖	2633		10	11	0.001662%	653374	98.69%	7	1.46%
凱	2634		12	11	0.001662%	653385	98.69%	8	1.67%
刑	2635		6	11	0.001662%	653396	98.69%	4	0.84%
划	2636		6	11	0.001662%	653407	98.69%	6	1.25%
券	2637		8	11	0.001662%	653418	98.70%	9	1.88%
剌	2638		9	11	0.001662%	653429	98.70%	9	1.88%
匈	2639		6	11	0.001662%	653440	98.70%	4	0.84%
喬	2640		12	11	0.001662%	653451	98.70%	7	1.46%
嗽	2641		14	11	0.001662%	653462	98.70%	5	1.05%
圳	2642		6	11	0.001662%	653473	98.70%	5	1.05%
孕	2643		5	11	0.001662%	653484	98.71%	10	2.09%
崖	2644		11	11	0.001662%	653495	98.71%	7	1.46%
巖	2645		23	11	0.001662%	653506	98.71%	9	1.88%
庶	2646		11	11	0.001662%	653517	98.71%	6	1.25%
弊	2647		14	11	0.001662%	653528	98.71%	9	1.88%
怯	2648		8	11	0.001662%	653539	98.71%	10	2.09%
惕	2649		11	11	0.001662%	653550	98.72%	10	2.09%
懦	2650		17	11	0.001662%	653561	98.72%	10	2.09%
拼	2651		9	11	0.001662%	653572	98.72%	8	1.67%
摔	2652		14	11	0.001662%	653583	98.72%	11	2.30%
擎	2653		17	11	0.001662%	653594	98.72%	10	2.09%
曹	2654		11	11	0.001662%	653605	98.72%	8	1.67%
朿	2655		6	11	0.001662%	653616	98.73%	7	1.46%
杏	2656		7	11	0.001662%	653627	98.73%	4	0.84%
梳	2657		10	11	0.001662%	653638	98.73%	7	1.46%
栽	2658		10	11	0.001662%	653649	98.73%	9	1.88%
槳	2659		15	11	0.001662%	653660	98.73%	5	1.05%
歉	2660		14	11	0.001662%	653671	98.73%	9	1.88%
氫	2661		11	11	0.001662%	653682	98.74%	4	0.84%
淒	2662		11	11	0.001662%	653693	98.74%	8	1.67%
湛	2663		12	11	0.001662%	653704	98.74%	6	1.25%
漏	2664		14	11	0.001662%	653715	98.74%	9	1.88%
澡	2665		16	11	0.001662%	653726	98.74%	4	0.84%
濯	2666		17	11	0.001662%	653737	98.74%	8	1.67%
濺	2667		18	11	0.001662%	653748	98.75%	8	1.67%
炊	2668		8	11	0.001662%	653759	98.75%	10	2.09%
焰	2669		12	11	0.001662%	653770	98.75%	11	2.30%
煞	2670		13	11	0.001662%	653781	98.75%	11	2.30%
熙	2671		14	11	0.001662%	653792	98.75%	8	1.67%
爪	2672		4	11	0.001662%	653803	98.75%	10	2.09%
痺	2673		13	11	0.001662%	653814	98.76%	2	0.42%
碩	2674		14	11	0.001662%	653825	98.76%	8	1.67%
穀	2675		15	11	0.001662%	653836	98.76%	6	1.25%
稽	2676		15	11	0.001662%	653847	98.76%	10	2.09%
筲	2677		13	11	0.001662%	653858	98.76%	10	2.09%
紮	2678		11	11	0.001662%	653869	98.76%	9	1.88%
紳	2679		11	11	0.001662%	653880	98.77%	8	1.67%
締	2680		15	11	0.001662%	653891	98.77%	6	1.25%
繽	2681		20	11	0.001662%	653902	98.77%	9	1.88%
羈	2682		24	11	0.001662%	653913	98.77%	10	2.09%
脂	2683		10	11	0.001662%	653924	98.77%	9	1.88%
臼	2684		6	11	0.001662%	653935	98.77%	3	0.63%
茅	2685		9	11	0.001662%	653946	98.78%	10	2.09%
茸	2686		10	11	0.001662%	653957	98.78%	6	1.25%
莉	2687		11	11	0.001662%	653968	98.78%	8	1.67%
葵	2688		13	11	0.001662%	653979	98.78%	9	1.88%
蔚	2689		15	11	0.001662%	653990	98.78%	11	2.30%
蔑	2690		15	11	0.001662%	654001	98.78%	8	1.67%
裸	2691		13	11	0.001662%	654012	98.79%	7	1.46%
蹲	2692		19	11	0.001662%	654023	98.79%	9	1.88%
酌	2693		10	11	0.001662%	654034	98.79%	8	1.67%
酵	2694		14	11	0.001662%	654045	98.79%	6	1.25%
鈉	2695		12	11	0.001662%	654056	98.79%	3	0.63%
閩	2696		14	11	0.001662%	654067	98.79%	2	0.42%
闡	2697		20	11	0.001662%	654078	98.80%	9	1.88%
頸	2698		16	11	0.001662%	654089	98.80%	8	1.67%
髒	2699		22	11	0.001662%	654100	98.80%	6	1.25%
髓	2700		23	11	0.001662%	654111	98.80%	5	1.05%
鬚	2701		22	11	0.001662%	654122	98.80%	9	1.88%
侍	2702		8	10	0.00151%	654132	98.80%	10	2.09%
偎	2703		11	10	0.00151%	654142	98.81%	9	1.88%
僧	2704		14	10	0.00151%	654152	98.81%	6	1.25%
僚	2705		14	10	0.00151%	654162	98.81%	8	1.67%
僻	2706		15	10	0.00151%	654172	98.81%	10	2.09%
冶	2707		7	10	0.00151%	654182	98.81%	7	1.46%
刃	2708		3	10	0.00151%	654192	98.81%	9	1.88%
劍	2709		15	10	0.00151%	654202	98.81%	10	2.09%
叩	2710		5	10	0.00151%	654212	98.82%	6	1.25%
吏	2711		6	10	0.00151%	654222	98.82%	5	1.05%
吋	2712		6	10	0.00151%	654232	98.82%	7	1.46%
吝	2713		7	10	0.00151%	654242	98.82%	9	1.88%
吶	2714		7	10	0.00151%	654252	98.82%	6	1.25%
哦	2715		10	10	0.00151%	654262	98.82%	10	2.09%
喂	2716		12	10	0.00151%	654272	98.83%	8	1.67%
噬	2717		16	10	0.00151%	654282	98.83%	9	1.88%
圃	2718		10	10	0.00151%	654292	98.83%	8	1.67%
堵	2719		11	10	0.00151%	654302	98.83%	7	1.46%
埭	2720		11	10	0.00151%	654312	98.83%	1	0.21%
奢	2721		11	10	0.00151%	654322	98.83%	9	1.88%
嬉	2722		15	10	0.00151%	654332	98.83%	10	2.09%
屹	2723		6	10	0.00151%	654342	98.84%	10	2.09%
巔	2724		22	10	0.00151%	654352	98.84%	8	1.67%
庠	2725		9	10	0.00151%	654362	98.84%	1	0.21%
抨	2726		8	10	0.00151%	654372	98.84%	6	1.25%
旬	2727		6	10	0.00151%	654382	98.84%	8	1.67%
昆	2728		8	10	0.00151%	654392	98.84%	9	1.88%
榆	2729		13	10	0.00151%	654402	98.85%	3	0.63%
殉	2730		10	10	0.00151%	654412	98.85%	8	1.67%
汝	2731		6	10	0.00151%	654422	98.85%	6	1.25%
汲	2732		7	10	0.00151%	654432	98.85%	5	1.05%
溯	2733		13	10	0.00151%	654442	98.85%	10	2.09%
漣	2734		14	10	0.00151%	654452	98.85%	8	1.67%
澎	2735		15	10	0.00151%	654462	98.85%	10	2.09%
烤	2736		10	10	0.00151%	654472	98.86%	4	0.84%
熬	2737		15	10	0.00151%	654482	98.86%	8	1.67%
熾	2738		16	10	0.00151%	654492	98.86%	10	2.09%
璞	2739		16	10	0.00151%	654502	98.86%	3	0.63%
砌	2740		9	10	0.00151%	654512	98.86%	10	2.09%
砲	2741		10	10	0.00151%	654522	98.86%	6	1.25%
礫	2742		20	10	0.00151%	654532	98.86%	4	0.84%
禽	2743		13	10	0.00151%	654542	98.87%	5	1.05%
竄	2744		18	10	0.00151%	654552	98.87%	7	1.46%
簿	2745		19	10	0.00151%	654562	98.87%	8	1.67%
罕	2746		7	10	0.00151%	654572	98.87%	9	1.88%
翌	2747		11	10	0.00151%	654582	98.87%	8	1.67%
肝	2748		7	10	0.00151%	654592	98.87%	10	2.09%
苗	2749		9	10	0.00151%	654602	98.88%	10	2.09%
茁	2750		9	10	0.00151%	654612	98.88%	9	1.88%
菩	2751		12	10	0.00151%	654622	98.88%	3	0.63%
蔬	2752		15	10	0.00151%	654632	98.88%	9	1.88%
藤	2753		19	10	0.00151%	654642	98.88%	7	1.46%
蘋	2754		20	10	0.00151%	654652	98.88%	3	0.63%
虞	2755		13	10	0.00151%	654662	98.88%	10	2.09%
蛙	2756		12	10	0.00151%	654672	98.89%	6	1.25%
蜿	2757		14	10	0.00151%	654682	98.89%	8	1.67%
螢	2758		16	10	0.00151%	654692	98.89%	10	2.09%
衍	2759		9	10	0.00151%	654702	98.89%	9	1.88%
裔	2760		13	10	0.00151%	654712	98.89%	8	1.67%
詐	2761		12	10	0.00151%	654722	98.89%	9	1.88%
諭	2762		16	10	0.00151%	654732	98.89%	7	1.46%
辱	2763		10	10	0.00151%	654742	98.90%	10	2.09%
遏	2764		12	10	0.00151%	654752	98.90%	7	1.46%
醇	2765		15	10	0.00151%	654762	98.90%	4	0.84%
隸	2766		17	10	0.00151%	654772	98.90%	7	1.46%
餌	2767		14	10	0.00151%	654782	98.90%	4	0.84%
餉	2768		14	10	0.00151%	654792	98.90%	3	0.63%
馴	2769		13	10	0.00151%	654802	98.91%	7	1.46%
鬢	2770		24	10	0.00151%	654812	98.91%	9	1.88%
魏	2771		18	10	0.00151%	654822	98.91%	7	1.46%
亥	2772		6	9	0.001359%	654831	98.91%	6	1.25%
佇	2773		7	9	0.001359%	654840	98.91%	8	1.67%
倔	2774		10	9	0.001359%	654849	98.91%	5	1.05%
儼	2775		22	9	0.001359%	654858	98.91%	7	1.46%
凈	2776		10	9	0.001359%	654867	98.92%	8	1.67%
吱	2777		7	9	0.001359%	654876	98.92%	4	0.84%
咽	2778		9	9	0.001359%	654885	98.92%	8	1.67%
喫	2779		12	9	0.001359%	654894	98.92%	4	0.84%
嚷	2780		20	9	0.001359%	654903	98.92%	7	1.46%
壑	2781		17	9	0.001359%	654912	98.92%	8	1.67%
壟	2782		19	9	0.001359%	654921	98.92%	6	1.25%
夭	2783		4	9	0.001359%	654930	98.92%	5	1.05%
嫣	2784		14	9	0.001359%	654939	98.93%	6	1.25%
寓	2785		12	9	0.001359%	654948	98.93%	7	1.46%
寮	2786		15	9	0.001359%	654957	98.93%	5	1.05%
屏	2787		9	9	0.001359%	654966	98.93%	9	1.88%
庇	2788		7	9	0.001359%	654975	98.93%	9	1.88%
彭	2789		12	9	0.001359%	654984	98.93%	4	0.84%
悴	2790		11	9	0.001359%	654993	98.93%	9	1.88%
憊	2791		16	9	0.001359%	655002	98.94%	8	1.67%
懶	2792		19	9	0.001359%	655011	98.94%	9	1.88%
扁	2793		9	9	0.001359%	655020	98.94%	7	1.46%
抄	2794		7	9	0.001359%	655029	98.94%	7	1.46%
捷	2795		11	9	0.001359%	655038	98.94%	9	1.88%
揀	2796		12	9	0.001359%	655047	98.94%	8	1.67%
搗	2797		13	9	0.001359%	655056	98.94%	7	1.46%
撇	2798		14	9	0.001359%	655065	98.95%	9	1.88%
擲	2799		18	9	0.001359%	655074	98.95%	9	1.88%
晒	2800		10	9	0.001359%	655083	98.95%	8	1.67%
暨	2801		14	9	0.001359%	655092	98.95%	8	1.67%
朧	2802		20	9	0.001359%	655101	98.95%	7	1.46%
杆	2803		7	9	0.001359%	655110	98.95%	6	1.25%
柿	2804		9	9	0.001359%	655119	98.95%	3	0.63%
桐	2805		10	9	0.001359%	655128	98.95%	5	1.05%
桶	2806		11	9	0.001359%	655137	98.96%	7	1.46%
棋	2807		12	9	0.001359%	655146	98.96%	7	1.46%
棍	2808		12	9	0.001359%	655155	98.96%	8	1.67%
橡	2809		16	9	0.001359%	655164	98.96%	4	0.84%
歪	2810		9	9	0.001359%	655173	98.96%	7	1.46%
汰	2811		7	9	0.001359%	655182	98.96%	9	1.88%
沫	2812		8	9	0.001359%	655191	98.96%	9	1.88%
涌	2813		10	9	0.001359%	655200	98.97%	7	1.46%
湃	2814		12	9	0.001359%	655209	98.97%	9	1.88%
漪	2815		14	9	0.001359%	655218	98.97%	7	1.46%
灶	2816		7	9	0.001359%	655227	98.97%	6	1.25%
狄	2817		7	9	0.001359%	655236	98.97%	7	1.46%
瓣	2818		19	9	0.001359%	655245	98.97%	8	1.67%
甫	2819		7	9	0.001359%	655254	98.97%	7	1.46%
畸	2820		13	9	0.001359%	655263	98.98%	5	1.05%
疫	2821		9	9	0.001359%	655272	98.98%	8	1.67%
癮	2822		22	9	0.001359%	655281	98.98%	5	1.05%
眷	2823		11	9	0.001359%	655290	98.98%	8	1.67%
瞻	2824		18	9	0.001359%	655299	98.98%	9	1.88%
矩	2825		10	9	0.001359%	655308	98.98%	8	1.67%
矯	2826		17	9	0.001359%	655317	98.98%	5	1.05%
祺	2827		12	9	0.001359%	655326	98.98%	4	0.84%
穎	2828		16	9	0.001359%	655335	98.99%	5	1.05%
竊	2829		23	9	0.001359%	655344	98.99%	7	1.46%
簸	2830		19	9	0.001359%	655353	98.99%	7	1.46%
簷	2831		19	9	0.001359%	655362	98.99%	9	1.88%
缸	2832		9	9	0.001359%	655371	98.99%	5	1.05%
聾	2833		22	9	0.001359%	655380	98.99%	3	0.63%
肺	2834		8	9	0.001359%	655389	98.99%	7	1.46%
膽	2835		17	9	0.001359%	655398	99.00%	7	1.46%
舶	2836		11	9	0.001359%	655407	99.00%	6	1.25%
茵	2837		10	9	0.001359%	655416	99.00%	7	1.46%
萍	2838		12	9	0.001359%	655425	99.00%	5	1.05%
蕉	2839		16	9	0.001359%	655434	99.00%	8	1.67%
虔	2840		10	9	0.001359%	655443	99.00%	9	1.88%
蜒	2841		14	9	0.001359%	655452	99.00%	7	1.46%
蠶	2842		24	9	0.001359%	655461	99.01%	4	0.84%
裨	2843		13	9	0.001359%	655470	99.01%	8	1.67%
裳	2844		14	9	0.001359%	655479	99.01%	9	1.88%
諦	2845		16	9	0.001359%	655488	99.01%	6	1.25%
諧	2846		16	9	0.001359%	655497	99.01%	7	1.46%
譏	2847		19	9	0.001359%	655506	99.01%	7	1.46%
豫	2848		16	9	0.001359%	655515	99.01%	6	1.25%
賸	2849		17	9	0.001359%	655524	99.01%	9	1.88%
蹓	2850		17	9	0.001359%	655533	99.02%	6	1.25%
輿	2851		17	9	0.001359%	655542	99.02%	6	1.25%
郡	2852		9	9	0.001359%	655551	99.02%	5	1.05%
醬	2853		18	9	0.001359%	655560	99.02%	3	0.63%
鈾	2854		13	9	0.001359%	655569	99.02%	1	0.21%
鍛	2855		17	9	0.001359%	655578	99.02%	8	1.67%
閘	2856		13	9	0.001359%	655587	99.02%	5	1.05%
霖	2857		16	9	0.001359%	655596	99.03%	4	0.84%
頃	2858		11	9	0.001359%	655605	99.03%	7	1.46%
驀	2859		21	9	0.001359%	655614	99.03%	9	1.88%
骯	2860		14	9	0.001359%	655623	99.03%	5	1.05%
齲	2861		24	9	0.001359%	655632	99.03%	1	0.21%
龕	2862		22	9	0.001359%	655641	99.03%	4	0.84%
仗	2863		5	8	0.001208%	655649	99.03%	7	1.46%
倣	2864		10	8	0.001208%	655657	99.03%	7	1.46%
偵	2865		11	8	0.001208%	655665	99.04%	4	0.84%
僵	2866		15	8	0.001208%	655673	99.04%	8	1.67%
兌	2867		7	8	0.001208%	655681	99.04%	3	0.63%
兜	2868		11	8	0.001208%	655689	99.04%	6	1.25%
凹	2869		5	8	0.001208%	655697	99.04%	8	1.67%
厥	2870		12	8	0.001208%	655705	99.04%	8	1.67%
叮	2871		5	8	0.001208%	655713	99.04%	6	1.25%
叨	2872		5	8	0.001208%	655721	99.04%	5	1.05%
吁	2873		6	8	0.001208%	655729	99.05%	6	1.25%
咱	2874		9	8	0.001208%	655737	99.05%	2	0.42%
喔	2875		12	8	0.001208%	655745	99.05%	3	0.63%
喲	2876		12	8	0.001208%	655753	99.05%	7	1.46%
喻	2877		12	8	0.001208%	655761	99.05%	7	1.46%
啾	2878		12	8	0.001208%	655769	99.05%	4	0.84%
嗣	2879		13	8	0.001208%	655777	99.05%	6	1.25%
噢	2880		16	8	0.001208%	655785	99.05%	6	1.25%
垠	2881		9	8	0.001208%	655793	99.06%	8	1.67%
塌	2882		13	8	0.001208%	655801	99.06%	8	1.67%
妒	2883		7	8	0.001208%	655809	99.06%	8	1.67%
婉	2884		11	8	0.001208%	655817	99.06%	5	1.05%
寐	2885		12	8	0.001208%	655825	99.06%	6	1.25%
岑	2886		7	8	0.001208%	655833	99.06%	6	1.25%
巳	2887		3	8	0.001208%	655841	99.06%	4	0.84%
廬	2888		19	8	0.001208%	655849	99.06%	6	1.25%
弔	2889		4	8	0.001208%	655857	99.06%	7	1.46%
御	2890		11	8	0.001208%	655865	99.07%	4	0.84%
愴	2891		13	8	0.001208%	655873	99.07%	7	1.46%
慚	2892		14	8	0.001208%	655881	99.07%	8	1.67%
憔	2893		15	8	0.001208%	655889	99.07%	8	1.67%
扔	2894		5	8	0.001208%	655897	99.07%	3	0.63%
拐	2895		8	8	0.001208%	655905	99.07%	7	1.46%
昭	2896		9	8	0.001208%	655913	99.07%	8	1.67%
曙	2897		17	8	0.001208%	655921	99.07%	8	1.67%
杖	2898		7	8	0.001208%	655929	99.08%	5	1.05%
枉	2899		8	8	0.001208%	655937	99.08%	7	1.46%
棠	2900		12	8	0.001208%	655945	99.08%	2	0.42%
楷	2901		13	8	0.001208%	655953	99.08%	4	0.84%
榻	2902		14	8	0.001208%	655961	99.08%	6	1.25%
樁	2903		15	8	0.001208%	655969	99.08%	7	1.46%
涎	2904		11	8	0.001208%	655977	99.08%	7	1.46%
湘	2905		12	8	0.001208%	655985	99.08%	7	1.46%
滄	2906		13	8	0.001208%	655993	99.09%	7	1.46%
滌	2907		14	8	0.001208%	656001	99.09%	8	1.67%
漉	2908		14	8	0.001208%	656009	99.09%	4	0.84%
潺	2909		15	8	0.001208%	656017	99.09%	4	0.84%
濾	2910		18	8	0.001208%	656025	99.09%	5	1.05%
炫	2911		9	8	0.001208%	656033	99.09%	8	1.67%
烹	2912		11	8	0.001208%	656041	99.09%	8	1.67%
猖	2913		11	8	0.001208%	656049	99.09%	6	1.25%
琺	2914		12	8	0.001208%	656057	99.10%	1	0.21%
疇	2915		19	8	0.001208%	656065	99.10%	8	1.67%
疚	2916		8	8	0.001208%	656073	99.10%	7	1.46%
痴	2917		13	8	0.001208%	656081	99.10%	5	1.05%
瘤	2918		15	8	0.001208%	656089	99.10%	2	0.42%
眶	2919		11	8	0.001208%	656097	99.10%	8	1.67%
眸	2920		11	8	0.001208%	656105	99.10%	7	1.46%
瞥	2921		16	8	0.001208%	656113	99.10%	6	1.25%
瞰	2922		17	8	0.001208%	656121	99.10%	4	0.84%
磬	2923		16	8	0.001208%	656129	99.11%	1	0.21%
禹	2924		9	8	0.001208%	656137	99.11%	3	0.63%
窪	2925		14	8	0.001208%	656145	99.11%	6	1.25%
籐	2926		21	8	0.001208%	656153	99.11%	7	1.46%
粮	2927		13	8	0.001208%	656161	99.11%	4	0.84%
粱	2928		13	8	0.001208%	656169	99.11%	2	0.42%
綵	2929		14	8	0.001208%	656177	99.11%	5	1.05%
緯	2930		15	8	0.001208%	656185	99.11%	4	0.84%
罐	2931		24	8	0.001208%	656193	99.12%	6	1.25%
腥	2932		13	8	0.001208%	656201	99.12%	7	1.46%
膛	2933		15	8	0.001208%	656209	99.12%	8	1.67%
膩	2934		16	8	0.001208%	656217	99.12%	7	1.46%
苑	2935		9	8	0.001208%	656225	99.12%	5	1.05%
藩	2936		19	8	0.001208%	656233	99.12%	5	1.05%
虐	2937		9	8	0.001208%	656241	99.12%	8	1.67%
蝦	2938		15	8	0.001208%	656249	99.12%	7	1.46%
褔	2939		14	8	0.001208%	656257	99.13%	4	0.84%
詭	2940		13	8	0.001208%	656265	99.13%	6	1.25%
謎	2941		17	8	0.001208%	656273	99.13%	6	1.25%
賤	2942		15	8	0.001208%	656281	99.13%	6	1.25%
贅	2943		18	8	0.001208%	656289	99.13%	7	1.46%
躂	2944		20	8	0.001208%	656297	99.13%	5	1.05%
軒	2945		10	8	0.001208%	656305	99.13%	5	1.05%
轄	2946		17	8	0.001208%	656313	99.13%	5	1.05%
迂	2947		6	8	0.001208%	656321	99.13%	5	1.05%
迢	2948		8	8	0.001208%	656329	99.14%	5	1.05%
遐	2949		12	8	0.001208%	656337	99.14%	7	1.46%
遽	2950		16	8	0.001208%	656345	99.14%	7	1.46%
釬	2951		11	8	0.001208%	656353	99.14%	2	0.42%
鐳	2952		21	8	0.001208%	656361	99.14%	1	0.21%
鑿	2953		28	8	0.001208%	656369	99.14%	5	1.05%
閥	2954		14	8	0.001208%	656377	99.14%	4	0.84%
霸	2955		21	8	0.001208%	656385	99.14%	7	1.46%
餵	2956		17	8	0.001208%	656393	99.15%	6	1.25%
驢	2957		26	8	0.001208%	656401	99.15%	6	1.25%
鯉	2958		18	8	0.001208%	656409	99.15%	6	1.25%
鱷	2959		27	8	0.001208%	656417	99.15%	2	0.42%
鴿	2960		17	8	0.001208%	656425	99.15%	8	1.67%
鷗	2961		22	8	0.001208%	656433	99.15%	8	1.67%
佑	2962		7	7	0.001057%	656440	99.15%	6	1.25%
伶	2963		7	7	0.001057%	656447	99.15%	6	1.25%
佬	2964		8	7	0.001057%	656454	99.16%	5	1.05%
俟	2965		9	7	0.001057%	656461	99.16%	7	1.46%
侷	2966		9	7	0.001057%	656468	99.16%	6	1.25%
傢	2967		12	7	0.001057%	656475	99.16%	6	1.25%
冤	2968		10	7	0.001057%	656482	99.16%	5	1.05%
凰	2969		11	7	0.001057%	656489	99.16%	4	0.84%
剖	2970		10	7	0.001057%	656496	99.16%	6	1.25%
占	2971		5	7	0.001057%	656503	99.16%	4	0.84%
吼	2972		7	7	0.001057%	656510	99.16%	7	1.46%
哺	2973		10	7	0.001057%	656517	99.16%	7	1.46%
啄	2974		11	7	0.001057%	656524	99.17%	6	1.25%
啻	2975		12	7	0.001057%	656531	99.17%	6	1.25%
唾	2976		12	7	0.001057%	656538	99.17%	6	1.25%
嗟	2977		13	7	0.001057%	656545	99.17%	3	0.63%
嗇	2978		13	7	0.001057%	656552	99.17%	6	1.25%
嗡	2979		13	7	0.001057%	656559	99.17%	3	0.63%
嘛	2980		14	7	0.001057%	656566	99.17%	6	1.25%
嘔	2981		14	7	0.001057%	656573	99.17%	6	1.25%
噩	2982		16	7	0.001057%	656580	99.17%	5	1.05%
嚐	2983		17	7	0.001057%	656587	99.18%	5	1.05%
嚥	2984		19	7	0.001057%	656594	99.18%	5	1.05%
囑	2985		24	7	0.001057%	656601	99.18%	6	1.25%
垮	2986		9	7	0.001057%	656608	99.18%	5	1.05%
堯	2987		12	7	0.001057%	656615	99.18%	4	0.84%
墊	2988		14	7	0.001057%	656622	99.18%	6	1.25%
墾	2989		16	7	0.001057%	656629	99.18%	6	1.25%
夥	2990		14	7	0.001057%	656636	99.18%	6	1.25%
娑	2991		10	7	0.001057%	656643	99.18%	7	1.46%
嫉	2992		13	7	0.001057%	656650	99.18%	7	1.46%
孽	2993		20	7	0.001057%	656657	99.19%	4	0.84%
窃	2994		9	7	0.001057%	656664	99.19%	5	1.05%
寅	2995		11	7	0.001057%	656671	99.19%	4	0.84%
寰	2996		16	7	0.001057%	656678	99.19%	7	1.46%
尿	2997		7	7	0.001057%	656685	99.19%	4	0.84%
幟	2998		15	7	0.001057%	656692	99.19%	7	1.46%
彰	2999		14	7	0.001057%	656699	99.19%	6	1.25%
恕	3000		10	7	0.001057%	656706	99.19%	6	1.25%
悖	3001		10	7	0.001057%	656713	99.19%	2	0.42%
惋	3002		11	7	0.001057%	656720	99.20%	7	1.46%
慄	3003		13	7	0.001057%	656727	99.20%	7	1.46%
慫	3004		15	7	0.001057%	656734	99.20%	5	1.05%
懲	3005		19	7	0.001057%	656741	99.20%	3	0.63%
戾	3006		8	7	0.001057%	656748	99.20%	7	1.46%
拭	3007		9	7	0.001057%	656755	99.20%	6	1.25%
搓	3008		13	7	0.001057%	656762	99.20%	6	1.25%
摟	3009		14	7	0.001057%	656769	99.20%	4	0.84%
撓	3010		15	7	0.001057%	656776	99.20%	7	1.46%
撮	3011		15	7	0.001057%	656783	99.20%	6	1.25%
攘	3012		20	7	0.001057%	656790	99.21%	5	1.05%
攜	3013		21	7	0.001057%	656797	99.21%	6	1.25%
攣	3014		23	7	0.001057%	656804	99.21%	3	0.63%
攬	3015		24	7	0.001057%	656811	99.21%	4	0.84%
晤	3016		11	7	0.001057%	656818	99.21%	7	1.46%
晦	3017		11	7	0.001057%	656825	99.21%	6	1.25%
暉	3018		13	7	0.001057%	656832	99.21%	6	1.25%
梓	3019		11	7	0.001057%	656839	99.21%	7	1.46%
棟	3020		12	7	0.001057%	656846	99.21%	5	1.05%
椰	3021		13	7	0.001057%	656853	99.22%	4	0.84%
氬	3022		12	7	0.001057%	656860	99.22%	3	0.63%
沁	3023		7	7	0.001057%	656867	99.22%	6	1.25%
沃	3024		7	7	0.001057%	656874	99.22%	6	1.25%
涸	3025		11	7	0.001057%	656881	99.22%	6	1.25%
渲	3026		12	7	0.001057%	656888	99.22%	5	1.05%
渦	3027		12	7	0.001057%	656895	99.22%	5	1.05%
炭	3028		9	7	0.001057%	656902	99.22%	5	1.05%
焚	3029		12	7	0.001057%	656909	99.22%	7	1.46%
燙	3030		16	7	0.001057%	656916	99.22%	6	1.25%
狽	3031		10	7	0.001057%	656923	99.23%	7	1.46%
琳	3032		12	7	0.001057%	656930	99.23%	5	1.05%
琵	3033		12	7	0.001057%	656937	99.23%	2	0.42%
琶	3034		12	7	0.001057%	656944	99.23%	2	0.42%
甥	3035		12	7	0.001057%	656951	99.23%	1	0.21%
痙	3036		12	7	0.001057%	656958	99.23%	4	0.84%
癢	3037		20	7	0.001057%	656965	99.23%	3	0.63%
癱	3038		24	7	0.001057%	656972	99.23%	5	1.05%
皎	3039		11	7	0.001057%	656979	99.23%	6	1.25%
矜	3040		9	7	0.001057%	656986	99.24%	6	1.25%
碳	3041		14	7	0.001057%	656993	99.24%	4	0.84%
穆	3042		16	7	0.001057%	657000	99.24%	7	1.46%
竇	3043		20	7	0.001057%	657007	99.24%	1	0.21%
粹	3044		14	7	0.001057%	657014	99.24%	7	1.46%
絃	3045		11	7	0.001057%	657021	99.24%	7	1.46%
絞	3046		12	7	0.001057%	657028	99.24%	6	1.25%
縈	3047		16	7	0.001057%	657035	99.24%	7	1.46%
辮	3048		20	7	0.001057%	657042	99.24%	7	1.46%
肖	3049		7	7	0.001057%	657049	99.24%	6	1.25%
艦	3050		20	7	0.001057%	657056	99.25%	3	0.63%
芙	3051		8	7	0.001057%	657063	99.25%	6	1.25%
芭	3052		8	7	0.001057%	657070	99.25%	6	1.25%
芯	3053		8	7	0.001057%	657077	99.25%	2	0.42%
芻	3054		10	7	0.001057%	657084	99.25%	5	1.05%
葦	3055		13	7	0.001057%	657091	99.25%	5	1.05%
蕪	3056		16	7	0.001057%	657098	99.25%	7	1.46%
蛻	3057		13	7	0.001057%	657105	99.25%	2	0.42%
蠻	3058		25	7	0.001057%	657112	99.25%	5	1.05%
訶	3059		12	7	0.001057%	657119	99.26%	5	1.05%
豁	3060		17	7	0.001057%	657126	99.26%	5	1.05%
貞	3061		9	7	0.001057%	657133	99.26%	6	1.25%
賈	3062		13	7	0.001057%	657140	99.26%	4	0.84%
踵	3063		16	7	0.001057%	657147	99.26%	6	1.25%
躅	3064		20	7	0.001057%	657154	99.26%	6	1.25%
輻	3065		16	7	0.001057%	657161	99.26%	4	0.84%
辜	3066		12	7	0.001057%	657168	99.26%	6	1.25%
辟	3067		13	7	0.001057%	657175	99.26%	5	1.05%
迺	3068		9	7	0.001057%	657182	99.27%	2	0.42%
酣	3069		12	7	0.001057%	657189	99.27%	7	1.46%
釗	3070		10	7	0.001057%	657196	99.27%	5	1.05%
鈎	3071		12	7	0.001057%	657203	99.27%	4	0.84%
鍚	3072		17	7	0.001057%	657210	99.27%	5	1.05%
闌	3073		17	7	0.001057%	657217	99.27%	7	1.46%
霉	3074		15	7	0.001057%	657224	99.27%	6	1.25%
頤	3075		16	7	0.001057%	657231	99.27%	6	1.25%
颱	3076		14	7	0.001057%	657238	99.27%	3	0.63%
飼	3077		13	7	0.001057%	657245	99.27%	6	1.25%
鯨	3078		19	7	0.001057%	657252	99.28%	1	0.21%
黝	3079		17	7	0.001057%	657259	99.28%	5	1.05%
齣	3080		20	7	0.001057%	657266	99.28%	5	1.05%
丟	3081		6	6	0.0009063%	657272	99.28%	5	1.05%
伺	3082		7	6	0.0009063%	657278	99.28%	5	1.05%
俊	3083		9	6	0.0009063%	657284	99.28%	6	1.25%
俐	3084		9	6	0.0009063%	657290	99.28%	5	1.05%
僥	3085		14	6	0.0009063%	657296	99.28%	3	0.63%
兢	3086		14	6	0.0009063%	657302	99.28%	3	0.63%
冗	3087		4	6	0.0009063%	657308	99.28%	5	1.05%
冥	3088		10	6	0.0009063%	657314	99.28%	4	0.84%
匿	3089		11	6	0.0009063%	657320	99.29%	6	1.25%
卒	3090		8	6	0.0009063%	657326	99.29%	6	1.25%
咨	3091		9	6	0.0009063%	657332	99.29%	2	0.42%
哉	3092		9	6	0.0009063%	657338	99.29%	5	1.05%
咪	3093		9	6	0.0009063%	657344	99.29%	4	0.84%
喀	3094		12	6	0.0009063%	657350	99.29%	2	0.42%
喁	3095		12	6	0.0009063%	657356	99.29%	3	0.63%
嗆	3096		13	6	0.0009063%	657362	99.29%	5	1.05%
噓	3097		15	6	0.0009063%	657368	99.29%	5	1.05%
㘭	3098		7	6	0.0009063%	657374	99.29%	2	0.42%
墅	3099		14	6	0.0009063%	657380	99.29%	5	1.05%
墻	3100		16	6	0.0009063%	657386	99.30%	6	1.25%
妃	3101		6	6	0.0009063%	657392	99.30%	4	0.84%
姻	3102		9	6	0.0009063%	657398	99.30%	4	0.84%
娓	3103		10	6	0.0009063%	657404	99.30%	3	0.63%
娩	3104		10	6	0.0009063%	657410	99.30%	1	0.21%
孃	3105		20	6	0.0009063%	657416	99.30%	2	0.42%
寇	3106		11	6	0.0009063%	657422	99.30%	5	1.05%
寵	3107		19	6	0.0009063%	657428	99.30%	6	1.25%
屐	3108		10	6	0.0009063%	657434	99.30%	6	1.25%
峙	3109		9	6	0.0009063%	657440	99.30%	5	1.05%
嶄	3110		14	6	0.0009063%	657446	99.30%	6	1.25%
帕	3111		8	6	0.0009063%	657452	99.31%	5	1.05%
庄	3112		6	6	0.0009063%	657458	99.31%	4	0.84%
廸	3113		8	6	0.0009063%	657464	99.31%	4	0.84%
彙	3114		13	6	0.0009063%	657470	99.31%	6	1.25%
彤	3115		7	6	0.0009063%	657476	99.31%	1	0.21%
怔	3116		8	6	0.0009063%	657482	99.31%	4	0.84%
恬	3117		9	6	0.0009063%	657488	99.31%	6	1.25%
恙	3118		10	6	0.0009063%	657494	99.31%	5	1.05%
悌	3119		10	6	0.0009063%	657500	99.31%	4	0.84%
恿	3120		11	6	0.0009063%	657506	99.31%	4	0.84%
惦	3121		11	6	0.0009063%	657512	99.31%	5	1.05%
悻	3122		11	6	0.0009063%	657518	99.32%	3	0.63%
悸	3123		11	6	0.0009063%	657524	99.32%	6	1.25%
惚	3124		11	6	0.0009063%	657530	99.32%	5	1.05%
憫	3125		15	6	0.0009063%	657536	99.32%	5	1.05%
懊	3126		16	6	0.0009063%	657542	99.32%	6	1.25%
扼	3127		7	6	0.0009063%	657548	99.32%	6	1.25%
拱	3128		9	6	0.0009063%	657554	99.32%	5	1.05%
捱	3129		11	6	0.0009063%	657560	99.32%	6	1.25%
摒	3130		12	6	0.0009063%	657566	99.32%	6	1.25%
搾	3131		13	6	0.0009063%	657572	99.32%	5	1.05%
撰	3132		15	6	0.0009063%	657578	99.32%	6	1.25%
攏	3133		19	6	0.0009063%	657584	99.33%	6	1.25%
斧	3134		8	6	0.0009063%	657590	99.33%	4	0.84%
旭	3135		6	6	0.0009063%	657596	99.33%	6	1.25%
旳	3136		7	6	0.0009063%	657602	99.33%	5	1.05%
昧	3137		9	6	0.0009063%	657608	99.33%	6	1.25%
暹	3138		16	6	0.0009063%	657614	99.33%	1	0.21%
杞	3139		7	6	0.0009063%	657620	99.33%	2	0.42%
杭	3140		8	6	0.0009063%	657626	99.33%	3	0.63%
框	3141		10	6	0.0009063%	657632	99.33%	4	0.84%
梧	3142		11	6	0.0009063%	657638	99.33%	3	0.63%
梭	3143		11	6	0.0009063%	657644	99.33%	5	1.05%
棗	3144		12	6	0.0009063%	657650	99.34%	4	0.84%
棧	3145		12	6	0.0009063%	657656	99.34%	2	0.42%
檻	3146		18	6	0.0009063%	657662	99.34%	5	1.05%
櫥	3147		19	6	0.0009063%	657668	99.34%	6	1.25%
汀	3148		5	6	0.0009063%	657674	99.34%	4	0.84%
沈	3149		7	6	0.0009063%	657680	99.34%	5	1.05%
洵	3150		9	6	0.0009063%	657686	99.34%	3	0.63%
浙	3151		10	6	0.0009063%	657692	99.34%	6	1.25%
淳	3152		11	6	0.0009063%	657698	99.34%	4	0.84%
淌	3153		11	6	0.0009063%	657704	99.34%	6	1.25%
淑	3154		11	6	0.0009063%	657710	99.34%	5	1.05%
淅	3155		11	6	0.0009063%	657716	99.35%	4	0.84%
淆	3156		11	6	0.0009063%	657722	99.35%	6	1.25%
漩	3157		14	6	0.0009063%	657728	99.35%	4	0.84%
漬	3158		14	6	0.0009063%	657734	99.35%	5	1.05%
瀕	3159		19	6	0.0009063%	657740	99.35%	6	1.25%
灑	3160		22	6	0.0009063%	657746	99.35%	6	1.25%
灕	3161		22	6	0.0009063%	657752	99.35%	1	0.21%
灸	3162		7	6	0.0009063%	657758	99.35%	2	0.42%
炳	3163		9	6	0.0009063%	657764	99.35%	5	1.05%
炯	3164		9	6	0.0009063%	657770	99.35%	2	0.42%
煎	3165		13	6	0.0009063%	657776	99.35%	5	1.05%
煽	3166		14	6	0.0009063%	657782	99.36%	6	1.25%
牟	3167		6	6	0.0009063%	657788	99.36%	6	1.25%
牡	3168		7	6	0.0009063%	657794	99.36%	5	1.05%
犖	3169		14	6	0.0009063%	657800	99.36%	3	0.63%
獗	3170		15	6	0.0009063%	657806	99.36%	5	1.05%
珊	3171		9	6	0.0009063%	657812	99.36%	5	1.05%
甩	3172		5	6	0.0009063%	657818	99.36%	4	0.84%
瘓	3173		14	6	0.0009063%	657824	99.36%	4	0.84%
癖	3174		18	6	0.0009063%	657830	99.36%	5	1.05%
癥	3175		20	6	0.0009063%	657836	99.36%	6	1.25%
皓	3176		12	6	0.0009063%	657842	99.36%	4	0.84%
盅	3177		9	6	0.0009063%	657848	99.37%	4	0.84%
磋	3178		15	6	0.0009063%	657854	99.37%	6	1.25%
礡	3179		19	6	0.0009063%	657860	99.37%	6	1.25%
秧	3180		10	6	0.0009063%	657866	99.37%	6	1.25%
穗	3181		17	6	0.0009063%	657872	99.37%	4	0.84%
窘	3182		12	6	0.0009063%	657878	99.37%	6	1.25%
窖	3183		12	6	0.0009063%	657884	99.37%	3	0.63%
窟	3184		13	6	0.0009063%	657890	99.37%	5	1.05%
筐	3185		12	6	0.0009063%	657896	99.37%	4	0.84%
箋	3186		14	6	0.0009063%	657902	99.37%	5	1.05%
糞	3187		17	6	0.0009063%	657908	99.37%	5	1.05%
糢	3188		17	6	0.0009063%	657914	99.38%	4	0.84%
紊	3189		10	6	0.0009063%	657920	99.38%	3	0.63%
絨	3190		12	6	0.0009063%	657926	99.38%	5	1.05%
緘	3191		15	6	0.0009063%	657932	99.38%	2	0.42%
胖	3192		9	6	0.0009063%	657938	99.38%	5	1.05%
脯	3193		11	6	0.0009063%	657944	99.38%	5	1.05%
脖	3194		11	6	0.0009063%	657950	99.38%	6	1.25%
膊	3195		14	6	0.0009063%	657956	99.38%	6	1.25%
膺	3196		17	6	0.0009063%	657962	99.38%	5	1.05%
芸	3197		8	6	0.0009063%	657968	99.38%	2	0.42%
茄	3198		9	6	0.0009063%	657974	99.38%	6	1.25%
菁	3199		12	6	0.0009063%	657980	99.39%	1	0.21%
葛	3200		13	6	0.0009063%	657986	99.39%	5	1.05%
蓉	3201		14	6	0.0009063%	657992	99.39%	6	1.25%
蒞	3202		14	6	0.0009063%	657998	99.39%	6	1.25%
薯	3203		17	6	0.0009063%	658004	99.39%	6	1.25%
虢	3204		15	6	0.0009063%	658010	99.39%	1	0.21%
蟻	3205		19	6	0.0009063%	658016	99.39%	6	1.25%
蟹	3206		19	6	0.0009063%	658022	99.39%	5	1.05%
蠢	3207		21	6	0.0009063%	658028	99.39%	6	1.25%
諺	3208		16	6	0.0009063%	658034	99.39%	6	1.25%
諷	3209		16	6	0.0009063%	658040	99.39%	6	1.25%
謊	3210		17	6	0.0009063%	658046	99.40%	5	1.05%
賑	3211		14	6	0.0009063%	658052	99.40%	3	0.63%
跋	3212		12	6	0.0009063%	658058	99.40%	5	1.05%
踢	3213		15	6	0.0009063%	658064	99.40%	5	1.05%
踱	3214		16	6	0.0009063%	658070	99.40%	3	0.63%
踽	3215		16	6	0.0009063%	658076	99.40%	4	0.84%
蹤	3216		18	6	0.0009063%	658082	99.40%	6	1.25%
躁	3217		20	6	0.0009063%	658088	99.40%	5	1.05%
軋	3218		8	6	0.0009063%	658094	99.40%	4	0.84%
輓	3219		14	6	0.0009063%	658100	99.40%	3	0.63%
迭	3220		8	6	0.0009063%	658106	99.40%	5	1.05%
迨	3221		8	6	0.0009063%	658112	99.41%	5	1.05%
迸	3222		9	6	0.0009063%	658118	99.41%	2	0.42%
逍	3223		10	6	0.0009063%	658124	99.41%	6	1.25%
遑	3224		12	6	0.0009063%	658130	99.41%	6	1.25%
鈽	3225		13	6	0.0009063%	658136	99.41%	1	0.21%
銘	3226		14	6	0.0009063%	658142	99.41%	5	1.05%
鋤	3227		15	6	0.0009063%	658148	99.41%	6	1.25%
錚	3228		16	6	0.0009063%	658154	99.41%	2	0.42%
鍍	3229		17	6	0.0009063%	658160	99.41%	3	0.63%
鑒	3230		22	6	0.0009063%	658166	99.41%	6	1.25%
阜	3231		8	6	0.0009063%	658172	99.41%	2	0.42%
陡	3232		9	6	0.0009063%	658178	99.42%	6	1.25%
駭	3233		16	6	0.0009063%	658184	99.42%	6	1.25%
髦	3234		14	6	0.0009063%	658190	99.42%	6	1.25%
魅	3235		15	6	0.0009063%	658196	99.42%	4	0.84%
鵡	3236		19	6	0.0009063%	658202	99.42%	3	0.63%
鸚	3237		28	6	0.0009063%	658208	99.42%	3	0.63%
黏	3238		17	6	0.0009063%	658214	99.42%	6	1.25%
齋	3239		17	6	0.0009063%	658220	99.42%	6	1.25%
亙	3240		6	5	0.0007552%	658225	99.42%	5	1.05%
佣	3241		7	5	0.0007552%	658230	99.42%	4	0.84%
侈	3242		8	5	0.0007552%	658235	99.42%	5	1.05%
儈	3243		15	5	0.0007552%	658240	99.42%	3	0.63%
儕	3244		16	5	0.0007552%	658245	99.43%	4	0.84%
冕	3245		11	5	0.0007552%	658250	99.43%	4	0.84%
凳	3246		14	5	0.0007552%	658255	99.43%	4	0.84%
凶	3247		4	5	0.0007552%	658260	99.43%	4	0.84%
刨	3248		7	5	0.0007552%	658265	99.43%	4	0.84%
剔	3249		10	5	0.0007552%	658270	99.43%	5	1.05%
勳	3250		16	5	0.0007552%	658275	99.43%	4	0.84%
匣	3251		7	5	0.0007552%	658280	99.43%	2	0.42%
匾	3252		11	5	0.0007552%	658285	99.43%	3	0.63%
卵	3253		7	5	0.0007552%	658290	99.43%	5	1.05%
厄	3254		4	5	0.0007552%	658295	99.43%	3	0.63%
吆	3255		6	5	0.0007552%	658300	99.43%	5	1.05%
咕	3256		8	5	0.0007552%	658305	99.43%	3	0.63%
哄	3257		9	5	0.0007552%	658310	99.44%	4	0.84%
哼	3258		10	5	0.0007552%	658315	99.44%	5	1.05%
喟	3259		12	5	0.0007552%	658320	99.44%	4	0.84%
嗥	3260		13	5	0.0007552%	658325	99.44%	2	0.42%
嘩	3261		15	5	0.0007552%	658330	99.44%	4	0.84%
噪	3262		16	5	0.0007552%	658335	99.44%	5	1.05%
囌	3263		23	5	0.0007552%	658340	99.44%	5	1.05%
囱	3264		7	5	0.0007552%	658345	99.44%	2	0.42%
坷	3265		8	5	0.0007552%	658350	99.44%	5	1.05%
坳	3266		8	5	0.0007552%	658355	99.44%	4	0.84%
垢	3267		9	5	0.0007552%	658360	99.44%	5	1.05%
埗	3268		10	5	0.0007552%	658365	99.44%	5	1.05%
奸	3269		6	5	0.0007552%	658370	99.44%	5	1.05%
妖	3270		7	5	0.0007552%	658375	99.45%	5	1.05%
妍	3271		7	5	0.0007552%	658380	99.45%	5	1.05%
婀	3272		11	5	0.0007552%	658385	99.45%	4	0.84%
嫻	3273		15	5	0.0007552%	658390	99.45%	4	0.84%
孺	3274		17	5	0.0007552%	658395	99.45%	3	0.63%
屎	3275		9	5	0.0007552%	658400	99.45%	4	0.84%
崎	3276		11	5	0.0007552%	658405	99.45%	5	1.05%
嶇	3277		14	5	0.0007552%	658410	99.45%	5	1.05%
廖	3278		14	5	0.0007552%	658415	99.45%	5	1.05%
彫	3279		11	5	0.0007552%	658420	99.45%	2	0.42%
慟	3280		14	5	0.0007552%	658425	99.45%	4	0.84%
戈	3281		4	5	0.0007552%	658430	99.45%	5	1.05%
抒	3282		7	5	0.0007552%	658435	99.45%	5	1.05%
押	3283		8	5	0.0007552%	658440	99.46%	2	0.42%
捏	3284		10	5	0.0007552%	658445	99.46%	4	0.84%
搏	3285		13	5	0.0007552%	658450	99.46%	5	1.05%
撳	3286		15	5	0.0007552%	658455	99.46%	1	0.21%
斛	3287		11	5	0.0007552%	658460	99.46%	4	0.84%
晌	3288		10	5	0.0007552%	658465	99.46%	4	0.84%
曬	3289		23	5	0.0007552%	658470	99.46%	5	1.05%
枕	3290		8	5	0.0007552%	658475	99.46%	5	1.05%
栗	3291		10	5	0.0007552%	658480	99.46%	5	1.05%
椏	3292		12	5	0.0007552%	658485	99.46%	4	0.84%
橙	3293		16	5	0.0007552%	658490	99.46%	5	1.05%
橘	3294		16	5	0.0007552%	658495	99.46%	3	0.63%
橢	3295		16	5	0.0007552%	658500	99.46%	5	1.05%
櫈	3296		17	5	0.0007552%	658505	99.46%	5	1.05%
歛	3297		17	5	0.0007552%	658510	99.47%	4	0.84%
歹	3298		4	5	0.0007552%	658515	99.47%	3	0.63%
氟	3299		9	5	0.0007552%	658520	99.47%	3	0.63%
氦	3300		10	5	0.0007552%	658525	99.47%	2	0.42%
汁	3301		5	5	0.0007552%	658530	99.47%	4	0.84%
汶	3302		7	5	0.0007552%	658535	99.47%	4	0.84%
沼	3303		8	5	0.0007552%	658540	99.47%	2	0.42%
泠	3304		8	5	0.0007552%	658545	99.47%	4	0.84%
沓	3305		8	5	0.0007552%	658550	99.47%	3	0.63%
涓	3306		10	5	0.0007552%	658555	99.47%	3	0.63%
淤	3307		11	5	0.0007552%	658560	99.47%	3	0.63%
渚	3308		11	5	0.0007552%	658565	99.47%	1	0.21%
淖	3309		11	5	0.0007552%	658570	99.47%	4	0.84%
潘	3310		15	5	0.0007552%	658575	99.48%	4	0.84%
瀚	3311		19	5	0.0007552%	658580	99.48%	4	0.84%
瀝	3312		19	5	0.0007552%	658585	99.48%	3	0.63%
燄	3313		16	5	0.0007552%	658590	99.48%	5	1.05%
狡	3314		9	5	0.0007552%	658595	99.48%	3	0.63%
琪	3315		12	5	0.0007552%	658600	99.48%	2	0.42%
瑚	3316		13	5	0.0007552%	658605	99.48%	3	0.63%
瑾	3317		15	5	0.0007552%	658610	99.48%	5	1.05%
疆	3318		19	5	0.0007552%	658615	99.48%	5	1.05%
疊	3319		22	5	0.0007552%	658620	99.48%	5	1.05%
疤	3320		9	5	0.0007552%	658625	99.48%	3	0.63%
痍	3321		11	5	0.0007552%	658630	99.48%	4	0.84%
瘟	3322		15	5	0.0007552%	658635	99.48%	4	0.84%
癒	3323		18	5	0.0007552%	658640	99.49%	4	0.84%
皚	3324		15	5	0.0007552%	658645	99.49%	3	0.63%
盎	3325		10	5	0.0007552%	658650	99.49%	5	1.05%
眩	3326		10	5	0.0007552%	658655	99.49%	5	1.05%
睫	3327		13	5	0.0007552%	658660	99.49%	5	1.05%
瞞	3328		16	5	0.0007552%	658665	99.49%	4	0.84%
瞳	3329		17	5	0.0007552%	658670	99.49%	4	0.84%
砵	3330		10	5	0.0007552%	658675	99.49%	4	0.84%
礁	3331		17	5	0.0007552%	658680	99.49%	4	0.84%
秉	3332		8	5	0.0007552%	658685	99.49%	5	1.05%
稜	3333		13	5	0.0007552%	658690	99.49%	4	0.84%
穢	3334		18	5	0.0007552%	658695	99.49%	4	0.84%
簍	3335		17	5	0.0007552%	658700	99.49%	4	0.84%
籟	3336		22	5	0.0007552%	658705	99.50%	5	1.05%
籮	3337		25	5	0.0007552%	658710	99.50%	4	0.84%
粟	3338		12	5	0.0007552%	658715	99.50%	4	0.84%
糙	3339		17	5	0.0007552%	658720	99.50%	5	1.05%
絢	3340		12	5	0.0007552%	658725	99.50%	4	0.84%
綻	3341		14	5	0.0007552%	658730	99.50%	4	0.84%
綺	3342		14	5	0.0007552%	658735	99.50%	5	1.05%
縹	3343		17	5	0.0007552%	658740	99.50%	5	1.05%
繡	3344		18	5	0.0007552%	658745	99.50%	5	1.05%
繹	3345		19	5	0.0007552%	658750	99.50%	4	0.84%
缽	3346		11	5	0.0007552%	658755	99.50%	4	0.84%
肆	3347		13	5	0.0007552%	658760	99.50%	5	1.05%
肴	3348		8	5	0.0007552%	658765	99.50%	4	0.84%
舂	3349		11	5	0.0007552%	658770	99.50%	1	0.21%
舐	3350		10	5	0.0007552%	658775	99.51%	4	0.84%
舵	3351		11	5	0.0007552%	658780	99.51%	4	0.84%
苛	3352		9	5	0.0007552%	658785	99.51%	4	0.84%
茉	3353		9	5	0.0007552%	658790	99.51%	5	1.05%
莽	3354		11	5	0.0007552%	658795	99.51%	4	0.84%
葫	3355		13	5	0.0007552%	658800	99.51%	4	0.84%
蔗	3356		15	5	0.0007552%	658805	99.51%	4	0.84%
蕃	3357		16	5	0.0007552%	658810	99.51%	4	0.84%
蚓	3358		10	5	0.0007552%	658815	99.51%	3	0.63%
蛀	3359		11	5	0.0007552%	658820	99.51%	4	0.84%
蜀	3360		13	5	0.0007552%	658825	99.51%	3	0.63%
蟀	3361		17	5	0.0007552%	658830	99.51%	3	0.63%
蟑	3362		17	5	0.0007552%	658835	99.51%	2	0.42%
衹	3363		9	5	0.0007552%	658840	99.52%	3	0.63%
褪	3364		15	5	0.0007552%	658845	99.52%	5	1.05%
襄	3365		17	5	0.0007552%	658850	99.52%	4	0.84%
詔	3366		12	5	0.0007552%	658855	99.52%	3	0.63%
詫	3367		13	5	0.0007552%	658860	99.52%	5	1.05%
諂	3368		15	5	0.0007552%	658865	99.52%	3	0.63%
諱	3369		16	5	0.0007552%	658870	99.52%	5	1.05%
謐	3370		17	5	0.0007552%	658875	99.52%	4	0.84%
謨	3371		18	5	0.0007552%	658880	99.52%	5	1.05%
踞	3372		15	5	0.0007552%	658885	99.52%	4	0.84%
躑	3373		22	5	0.0007552%	658890	99.52%	4	0.84%
躬	3374		10	5	0.0007552%	658895	99.52%	5	1.05%
軸	3375		12	5	0.0007552%	658900	99.52%	4	0.84%
迥	3376		8	5	0.0007552%	658905	99.53%	5	1.05%
逅	3377		9	5	0.0007552%	658910	99.53%	4	0.84%
邂	3378		16	5	0.0007552%	658915	99.53%	4	0.84%
邇	3379		17	5	0.0007552%	658920	99.53%	5	1.05%
鄔	3380		12	5	0.0007552%	658925	99.53%	2	0.42%
鄺	3381		17	5	0.0007552%	658930	99.53%	1	0.21%
醞	3382		17	5	0.0007552%	658935	99.53%	5	1.05%
鈕	3383		12	5	0.0007552%	658940	99.53%	5	1.05%
鈞	3384		12	5	0.0007552%	658945	99.53%	4	0.84%
鈍	3385		12	5	0.0007552%	658950	99.53%	5	1.05%
鈷	3386		13	5	0.0007552%	658955	99.53%	3	0.63%
鎦	3387		18	5	0.0007552%	658960	99.53%	2	0.42%
隼	3388		10	5	0.0007552%	658965	99.53%	3	0.63%
雁	3389		12	5	0.0007552%	658970	99.54%	3	0.63%
雌	3390		14	5	0.0007552%	658975	99.54%	4	0.84%
雛	3391		18	5	0.0007552%	658980	99.54%	5	1.05%
霎	3392		16	5	0.0007552%	658985	99.54%	5	1.05%
霓	3393		16	5	0.0007552%	658990	99.54%	5	1.05%
鞏	3394		15	5	0.0007552%	658995	99.54%	5	1.05%
韌	3395		12	5	0.0007552%	659000	99.54%	2	0.42%
顰	3396		24	5	0.0007552%	659005	99.54%	5	1.05%
馨	3397		20	5	0.0007552%	659010	99.54%	5	1.05%
驊	3398		22	5	0.0007552%	659015	99.54%	4	0.84%
髣	3399		14	5	0.0007552%	659020	99.54%	4	0.84%
鵝	3400		18	5	0.0007552%	659025	99.54%	5	1.05%
鹵	3401		11	5	0.0007552%	659030	99.54%	1	0.21%
鹹	3402		20	5	0.0007552%	659035	99.54%	4	0.84%
黿	3403		17	5	0.0007552%	659040	99.55%	1	0.21%
齦	3404		21	5	0.0007552%	659045	99.55%	2	0.42%
龜	3405		16	5	0.0007552%	659050	99.55%	5	1.05%
丐	3406		4	4	0.0006042%	659054	99.55%	1	0.21%
丸	3407		3	4	0.0006042%	659058	99.55%	4	0.84%
乍	3408		5	4	0.0006042%	659062	99.55%	4	0.84%
亢	3409		4	4	0.0006042%	659066	99.55%	4	0.84%
伽	3410		7	4	0.0006042%	659070	99.55%	4	0.84%
倩	3411		10	4	0.0006042%	659074	99.55%	4	0.84%
兔	3412		8	4	0.0006042%	659078	99.55%	3	0.63%
冀	3413		16	4	0.0006042%	659082	99.55%	4	0.84%
凭	3414		8	4	0.0006042%	659086	99.55%	3	0.63%
凸	3415		5	4	0.0006042%	659090	99.55%	4	0.84%
剷	3416		13	4	0.0006042%	659094	99.55%	4	0.84%
劈	3417		15	4	0.0006042%	659098	99.55%	3	0.63%
匡	3418		6	4	0.0006042%	659102	99.56%	4	0.84%
卦	3419		8	4	0.0006042%	659106	99.56%	4	0.84%
厘	3420		9	4	0.0006042%	659110	99.56%	4	0.84%
叭	3421		5	4	0.0006042%	659114	99.56%	4	0.84%
吭	3422		7	4	0.0006042%	659118	99.56%	4	0.84%
呂	3423		7	4	0.0006042%	659122	99.56%	3	0.63%
咄	3424		8	4	0.0006042%	659126	99.56%	2	0.42%
咐	3425		8	4	0.0006042%	659130	99.56%	2	0.42%
呱	3426		8	4	0.0006042%	659134	99.56%	2	0.42%
咯	3427		9	4	0.0006042%	659138	99.56%	2	0.42%
啜	3428		11	4	0.0006042%	659142	99.56%	4	0.84%
喇	3429		12	4	0.0006042%	659146	99.56%	4	0.84%
喳	3430		12	4	0.0006042%	659150	99.56%	2	0.42%
嗓	3431		13	4	0.0006042%	659154	99.56%	4	0.84%
嘖	3432		14	4	0.0006042%	659158	99.56%	2	0.42%
嘈	3433		14	4	0.0006042%	659162	99.56%	4	0.84%
嘮	3434		15	4	0.0006042%	659166	99.56%	2	0.42%
噹	3435		16	4	0.0006042%	659170	99.57%	2	0.42%
噶	3436		16	4	0.0006042%	659174	99.57%	1	0.21%
嚙	3437		18	4	0.0006042%	659178	99.57%	4	0.84%
囊	3438		22	4	0.0006042%	659182	99.57%	3	0.63%
囚	3439		5	4	0.0006042%	659186	99.57%	4	0.84%
圭	3440		6	4	0.0006042%	659190	99.57%	1	0.21%
坤	3441		8	4	0.0006042%	659194	99.57%	4	0.84%
埸	3442		11	4	0.0006042%	659198	99.57%	3	0.63%
塢	3443		13	4	0.0006042%	659202	99.57%	3	0.63%
奚	3444		10	4	0.0006042%	659206	99.57%	4	0.84%
妮	3445		8	4	0.0006042%	659210	99.57%	3	0.63%
姥	3446		9	4	0.0006042%	659214	99.57%	2	0.42%
嫵	3447		15	4	0.0006042%	659218	99.57%	4	0.84%
嬸	3448		18	4	0.0006042%	659222	99.57%	3	0.63%
孜	3449		7	4	0.0006042%	659226	99.57%	2	0.42%
宥	3450		9	4	0.0006042%	659230	99.57%	3	0.63%
屜	3451		11	4	0.0006042%	659234	99.57%	4	0.84%
岐	3452		7	4	0.0006042%	659238	99.58%	4	0.84%
崙	3453		11	4	0.0006042%	659242	99.58%	3	0.63%
帛	3454		8	4	0.0006042%	659246	99.58%	4	0.84%
帷	3455		11	4	0.0006042%	659250	99.58%	4	0.84%
廝	3456		15	4	0.0006042%	659254	99.58%	3	0.63%
弍	3457		5	4	0.0006042%	659258	99.58%	3	0.63%
弗	3458		5	4	0.0006042%	659262	99.58%	3	0.63%
彥	3459		9	4	0.0006042%	659266	99.58%	4	0.84%
徜	3460		11	4	0.0006042%	659270	99.58%	4	0.84%
忱	3461		7	4	0.0006042%	659274	99.58%	4	0.84%
忪	3462		7	4	0.0006042%	659278	99.58%	4	0.84%
怱	3463		9	4	0.0006042%	659282	99.58%	1	0.21%
惺	3464		12	4	0.0006042%	659286	99.58%	4	0.84%
慬	3465		14	4	0.0006042%	659290	99.58%	3	0.63%
懈	3466		16	4	0.0006042%	659294	99.58%	4	0.84%
懣	3467		18	4	0.0006042%	659298	99.58%	4	0.84%
戕	3468		8	4	0.0006042%	659302	99.59%	2	0.42%
戛	3469		11	4	0.0006042%	659306	99.59%	3	0.63%
扒	3470		5	4	0.0006042%	659310	99.59%	3	0.63%
抉	3471		7	4	0.0006042%	659314	99.59%	3	0.63%
拚	3472		8	4	0.0006042%	659318	99.59%	4	0.84%
搵	3473		13	4	0.0006042%	659322	99.59%	3	0.63%
摺	3474		14	4	0.0006042%	659326	99.59%	3	0.63%
擰	3475		17	4	0.0006042%	659330	99.59%	2	0.42%
攸	3476		7	4	0.0006042%	659334	99.59%	4	0.84%
敖	3477		11	4	0.0006042%	659338	99.59%	2	0.42%
斃	3478		17	4	0.0006042%	659342	99.59%	4	0.84%
斐	3479		12	4	0.0006042%	659346	99.59%	3	0.63%
晏	3480		10	4	0.0006042%	659350	99.59%	2	0.42%
朔	3481		10	4	0.0006042%	659354	99.59%	4	0.84%
杳	3482		8	4	0.0006042%	659358	99.59%	2	0.42%
柵	3483		9	4	0.0006042%	659362	99.59%	3	0.63%
梗	3484		11	4	0.0006042%	659366	99.59%	4	0.84%
楞	3485		13	4	0.0006042%	659370	99.60%	4	0.84%
欖	3486		25	4	0.0006042%	659374	99.60%	4	0.84%
毆	3487		15	4	0.0006042%	659378	99.60%	2	0.42%
毗	3488		9	4	0.0006042%	659382	99.60%	4	0.84%
氘	3489		6	4	0.0006042%	659386	99.60%	1	0.21%
氾	3490		5	4	0.0006042%	659390	99.60%	4	0.84%
汹	3491		7	4	0.0006042%	659394	99.60%	3	0.63%
沌	3492		7	4	0.0006042%	659398	99.60%	4	0.84%
汨	3493		7	4	0.0006042%	659402	99.60%	2	0.42%
沽	3494		8	4	0.0006042%	659406	99.60%	4	0.84%
泵	3495		9	4	0.0006042%	659410	99.60%	2	0.42%
涅	3496		10	4	0.0006042%	659414	99.60%	1	0.21%
淙	3497		11	4	0.0006042%	659418	99.60%	2	0.42%
湍	3498		12	4	0.0006042%	659422	99.60%	3	0.63%
澆	3499		15	4	0.0006042%	659426	99.60%	4	0.84%
澹	3500		16	4	0.0006042%	659430	99.60%	4	0.84%
濡	3501		17	4	0.0006042%	659434	99.61%	2	0.42%
炒	3502		8	4	0.0006042%	659438	99.61%	4	0.84%
烙	3503		10	4	0.0006042%	659442	99.61%	4	0.84%
煥	3504		13	4	0.0006042%	659446	99.61%	4	0.84%
熔	3505		14	4	0.0006042%	659450	99.61%	3	0.63%
燎	3506		16	4	0.0006042%	659454	99.61%	4	0.84%
牘	3507		19	4	0.0006042%	659458	99.61%	4	0.84%
犀	3508		12	4	0.0006042%	659462	99.61%	3	0.63%
狩	3509		9	4	0.0006042%	659466	99.61%	2	0.42%
狸	3510		10	4	0.0006042%	659470	99.61%	3	0.63%
狺	3511		10	4	0.0006042%	659474	99.61%	2	0.42%
猝	3512		11	4	0.0006042%	659478	99.61%	4	0.84%
琉	3513		10	4	0.0006042%	659482	99.61%	3	0.63%
璋	3514		15	4	0.0006042%	659486	99.61%	3	0.63%
璀	3515		15	4	0.0006042%	659490	99.61%	4	0.84%
璣	3516		16	4	0.0006042%	659494	99.61%	2	0.42%
瘀	3517		13	4	0.0006042%	659498	99.61%	2	0.42%
癟	3518		19	4	0.0006042%	659502	99.62%	4	0.84%
盹	3519		9	4	0.0006042%	659506	99.62%	3	0.63%
睨	3520		13	4	0.0006042%	659510	99.62%	4	0.84%
瞇	3521		15	4	0.0006042%	659514	99.62%	3	0.63%
瞼	3522		18	4	0.0006042%	659518	99.62%	3	0.63%
矗	3523		24	4	0.0006042%	659522	99.62%	4	0.84%
硼	3524		13	4	0.0006042%	659526	99.62%	2	0.42%
磷	3525		17	4	0.0006042%	659530	99.62%	2	0.42%
祟	3526		10	4	0.0006042%	659534	99.62%	3	0.63%
稷	3527		15	4	0.0006042%	659538	99.62%	2	0.42%
竣	3528		12	4	0.0006042%	659542	99.62%	4	0.84%
笆	3529		10	4	0.0006042%	659546	99.62%	2	0.42%
笠	3530		11	4	0.0006042%	659550	99.62%	4	0.84%
筵	3531		14	4	0.0006042%	659554	99.62%	3	0.63%
箍	3532		14	4	0.0006042%	659558	99.62%	4	0.84%
籽	3533		9	4	0.0006042%	659562	99.62%	3	0.63%
紜	3534		10	4	0.0006042%	659566	99.63%	4	0.84%
絆	3535		11	4	0.0006042%	659570	99.63%	4	0.84%
綽	3536		14	4	0.0006042%	659574	99.63%	4	0.84%
綬	3537		14	4	0.0006042%	659578	99.63%	1	0.21%
緋	3538		14	4	0.0006042%	659582	99.63%	3	0.63%
繚	3539		18	4	0.0006042%	659586	99.63%	4	0.84%
繙	3540		18	4	0.0006042%	659590	99.63%	2	0.42%
纛	3541		25	4	0.0006042%	659594	99.63%	4	0.84%
羔	3542		10	4	0.0006042%	659598	99.63%	4	0.84%
羡	3543		12	4	0.0006042%	659602	99.63%	3	0.63%
翡	3544		14	4	0.0006042%	659606	99.63%	4	0.84%
翹	3545		18	4	0.0006042%	659610	99.63%	4	0.84%
耆	3546		10	4	0.0006042%	659614	99.63%	2	0.42%
耙	3547		10	4	0.0006042%	659618	99.63%	3	0.63%
耽	3548		10	4	0.0006042%	659622	99.63%	4	0.84%
胳	3549		10	4	0.0006042%	659626	99.63%	4	0.84%
膏	3550		14	4	0.0006042%	659630	99.63%	4	0.84%
芍	3551		7	4	0.0006042%	659634	99.64%	2	0.42%
芹	3552		8	4	0.0006042%	659638	99.64%	4	0.84%
范	3553		9	4	0.0006042%	659642	99.64%	4	0.84%
茱	3554		10	4	0.0006042%	659646	99.64%	1	0.21%
萃	3555		12	4	0.0006042%	659650	99.64%	3	0.63%
萸	3556		12	4	0.0006042%	659654	99.64%	1	0.21%
蒿	3557		14	4	0.0006042%	659658	99.64%	3	0.63%
蓆	3558		14	4	0.0006042%	659662	99.64%	4	0.84%
蕾	3559		17	4	0.0006042%	659666	99.64%	4	0.84%
薔	3560		17	4	0.0006042%	659670	99.64%	2	0.42%
薇	3561		17	4	0.0006042%	659674	99.64%	2	0.42%
藐	3562		18	4	0.0006042%	659678	99.64%	3	0.63%
藹	3563		20	4	0.0006042%	659682	99.64%	4	0.84%
蘚	3564		21	4	0.0006042%	659686	99.64%	3	0.63%
蚋	3565		10	4	0.0006042%	659690	99.64%	1	0.21%
蚯	3566		11	4	0.0006042%	659694	99.64%	3	0.63%
蜇	3567		13	4	0.0006042%	659698	99.65%	2	0.42%
蜆	3568		13	4	0.0006042%	659702	99.65%	3	0.63%
蜢	3569		14	4	0.0006042%	659706	99.65%	1	0.21%
蜴	3570		14	4	0.0006042%	659710	99.65%	2	0.42%
蜷	3571		14	4	0.0006042%	659714	99.65%	4	0.84%
螂	3572		15	4	0.0006042%	659718	99.65%	2	0.42%
螞	3573		16	4	0.0006042%	659722	99.65%	4	0.84%
蟋	3574		17	4	0.0006042%	659726	99.65%	3	0.63%
蠕	3575		20	4	0.0006042%	659730	99.65%	3	0.63%
袁	3576		10	4	0.0006042%	659734	99.65%	1	0.21%
袓	3577		10	4	0.0006042%	659738	99.65%	2	0.42%
袱	3578		11	4	0.0006042%	659742	99.65%	3	0.63%
裘	3579		13	4	0.0006042%	659746	99.65%	4	0.84%
褐	3580		14	4	0.0006042%	659750	99.65%	4	0.84%
襪	3581		20	4	0.0006042%	659754	99.65%	3	0.63%
詠	3582		12	4	0.0006042%	659758	99.65%	4	0.84%
詣	3583		13	4	0.0006042%	659762	99.65%	4	0.84%
諄	3584		15	4	0.0006042%	659766	99.66%	2	0.42%
諍	3585		15	4	0.0006042%	659770	99.66%	1	0.21%
謠	3586		17	4	0.0006042%	659774	99.66%	4	0.84%
譴	3587		21	4	0.0006042%	659778	99.66%	3	0.63%
貽	3588		12	4	0.0006042%	659782	99.66%	4	0.84%
賃	3589		13	4	0.0006042%	659786	99.66%	4	0.84%
踴	3590		16	4	0.0006042%	659790	99.66%	3	0.63%
輒	3591		14	4	0.0006042%	659794	99.66%	4	0.84%
輟	3592		15	4	0.0006042%	659798	99.66%	4	0.84%
轍	3593		18	4	0.0006042%	659802	99.66%	4	0.84%
轆	3594		18	4	0.0006042%	659806	99.66%	3	0.63%
遁	3595		12	4	0.0006042%	659810	99.66%	4	0.84%
邃	3596		17	4	0.0006042%	659814	99.66%	4	0.84%
邱	3597		7	4	0.0006042%	659818	99.66%	4	0.84%
郭	3598		10	4	0.0006042%	659822	99.66%	4	0.84%
酪	3599		13	4	0.0006042%	659826	99.66%	3	0.63%
醋	3600		15	4	0.0006042%	659830	99.66%	4	0.84%
釐	3601		18	4	0.0006042%	659834	99.67%	4	0.84%
鈣	3602		12	4	0.0006042%	659838	99.67%	4	0.84%
鉀	3603		13	4	0.0006042%	659842	99.67%	3	0.63%
鋅	3604		15	4	0.0006042%	659846	99.67%	2	0.42%
錘	3605		17	4	0.0006042%	659850	99.67%	4	0.84%
鐸	3606		21	4	0.0006042%	659854	99.67%	2	0.42%
鑰	3607		25	4	0.0006042%	659858	99.67%	4	0.84%
閨	3608		14	4	0.0006042%	659862	99.67%	4	0.84%
閽	3609		16	4	0.0006042%	659866	99.67%	2	0.42%
阡	3610		5	4	0.0006042%	659870	99.67%	4	0.84%
阮	3611		6	4	0.0006042%	659874	99.67%	3	0.63%
隋	3612		11	4	0.0006042%	659878	99.67%	3	0.63%
隘	3613		12	4	0.0006042%	659882	99.67%	3	0.63%
雍	3614		13	4	0.0006042%	659886	99.67%	4	0.84%
霄	3615		15	4	0.0006042%	659890	99.67%	4	0.84%
霹	3616		21	4	0.0006042%	659894	99.67%	3	0.63%
靨	3617		23	4	0.0006042%	659898	99.68%	4	0.84%
鞍	3618		15	4	0.0006042%	659902	99.68%	4	0.84%
飪	3619		12	4	0.0006042%	659906	99.68%	4	0.84%
餞	3620		16	4	0.0006042%	659910	99.68%	4	0.84%
駝	3621		15	4	0.0006042%	659914	99.68%	4	0.84%
駒	3622		15	4	0.0006042%	659918	99.68%	3	0.63%
鬍	3623		19	4	0.0006042%	659922	99.68%	4	0.84%
鱗	3624		23	4	0.0006042%	659926	99.68%	4	0.84%
鵬	3625		19	4	0.0006042%	659930	99.68%	2	0.42%
丫	3626		3	3	0.0004531%	659933	99.68%	2	0.42%
丰	3627		4	3	0.0004531%	659936	99.68%	1	0.21%
乒	3628		6	3	0.0004531%	659939	99.68%	2	0.42%
乓	3629		6	3	0.0004531%	659942	99.68%	2	0.42%
仕	3630		5	3	0.0004531%	659945	99.68%	3	0.63%
仵	3631		6	3	0.0004531%	659948	99.68%	3	0.63%
佚	3632		7	3	0.0004531%	659951	99.68%	1	0.21%
俏	3633		9	3	0.0004531%	659954	99.68%	3	0.63%
俸	3634		10	3	0.0004531%	659957	99.68%	3	0.63%
偌	3635		11	3	0.0004531%	659960	99.68%	3	0.63%
傖	3636		12	3	0.0004531%	659963	99.69%	3	0.63%
减	3637		11	3	0.0004531%	659966	99.69%	1	0.21%
凜	3638		15	3	0.0004531%	659969	99.69%	3	0.63%
刁	3639		2	3	0.0004531%	659972	99.69%	3	0.63%
卹	3640		8	3	0.0004531%	659975	99.69%	1	0.21%
叡	3641		16	3	0.0004531%	659978	99.69%	1	0.21%
叱	3642		5	3	0.0004531%	659981	99.69%	3	0.63%
叻	3643		5	3	0.0004531%	659984	99.69%	2	0.42%
吩	3644		7	3	0.0004531%	659987	99.69%	2	0.42%
咏	3645		8	3	0.0004531%	659990	99.69%	2	0.42%
咋	3646		8	3	0.0004531%	659993	99.69%	2	0.42%
咎	3647		8	3	0.0004531%	659996	99.69%	3	0.63%
哎	3648		9	3	0.0004531%	659999	99.69%	3	0.63%
哇	3649		9	3	0.0004531%	660002	99.69%	2	0.42%
咧	3650		9	3	0.0004531%	660005	99.69%	2	0.42%
唷	3651		10	3	0.0004531%	660008	99.69%	3	0.63%
啣	3652		11	3	0.0004531%	660011	99.69%	2	0.42%
嚕	3653		18	3	0.0004531%	660014	99.69%	3	0.63%
囿	3654		9	3	0.0004531%	660017	99.69%	3	0.63%
塚	3655		13	3	0.0004531%	660020	99.69%	3	0.63%
塋	3656		13	3	0.0004531%	660023	99.69%	3	0.63%
壅	3657		16	3	0.0004531%	660026	99.69%	2	0.42%
壳	3658		7	3	0.0004531%	660029	99.70%	3	0.63%
壹	3659		12	3	0.0004531%	660032	99.70%	2	0.42%
奕	3660		9	3	0.0004531%	660035	99.70%	2	0.42%
奐	3661		9	3	0.0004531%	660038	99.70%	3	0.63%
姦	3662		9	3	0.0004531%	660041	99.70%	3	0.63%
娟	3663		10	3	0.0004531%	660044	99.70%	3	0.63%
娥	3664		10	3	0.0004531%	660047	99.70%	3	0.63%
婪	3665		11	3	0.0004531%	660050	99.70%	3	0.63%
娼	3666		11	3	0.0004531%	660053	99.70%	3	0.63%
婢	3667		11	3	0.0004531%	660056	99.70%	2	0.42%
嬴	3668		16	3	0.0004531%	660059	99.70%	3	0.63%
孚	3669		7	3	0.0004531%	660062	99.70%	3	0.63%
孿	3670		22	3	0.0004531%	660065	99.70%	3	0.63%
岔	3671		7	3	0.0004531%	660068	99.70%	3	0.63%
嶂	3672		14	3	0.0004531%	660071	99.70%	2	0.42%
帚	3673		8	3	0.0004531%	660074	99.70%	2	0.42%
帑	3674		8	3	0.0004531%	660077	99.70%	3	0.63%
幄	3675		12	3	0.0004531%	660080	99.70%	3	0.63%
廼	3676		9	3	0.0004531%	660083	99.70%	3	0.63%
彝	3677		18	3	0.0004531%	660086	99.70%	3	0.63%
徉	3678		9	3	0.0004531%	660089	99.70%	3	0.63%
忿	3679		8	3	0.0004531%	660092	99.70%	3	0.63%
悼	3680		11	3	0.0004531%	660095	99.71%	3	0.63%
愕	3681		12	3	0.0004531%	660098	99.71%	2	0.42%
惰	3682		12	3	0.0004531%	660101	99.71%	3	0.63%
惻	3683		12	3	0.0004531%	660104	99.71%	3	0.63%
愨	3684		14	3	0.0004531%	660107	99.71%	2	0.42%
憨	3685		16	3	0.0004531%	660110	99.71%	3	0.63%
懺	3686		20	3	0.0004531%	660113	99.71%	3	0.63%
戊	3687		5	3	0.0004531%	660116	99.71%	3	0.63%
戢	3688		13	3	0.0004531%	660119	99.71%	3	0.63%
扳	3689		7	3	0.0004531%	660122	99.71%	2	0.42%
捎	3690		10	3	0.0004531%	660125	99.71%	2	0.42%
捆	3691		10	3	0.0004531%	660128	99.71%	2	0.42%
掏	3692		11	3	0.0004531%	660131	99.71%	3	0.63%
捻	3693		11	3	0.0004531%	660134	99.71%	3	0.63%
据	3694		11	3	0.0004531%	660137	99.71%	2	0.42%
揑	3695		12	3	0.0004531%	660140	99.71%	2	0.42%
搔	3696		13	3	0.0004531%	660143	99.71%	3	0.63%
搐	3697		13	3	0.0004531%	660146	99.71%	3	0.63%
摹	3698		15	3	0.0004531%	660149	99.71%	3	0.63%
撩	3699		15	3	0.0004531%	660152	99.71%	3	0.63%
撬	3700		15	3	0.0004531%	660155	99.71%	2	0.42%
擅	3701		16	3	0.0004531%	660158	99.71%	3	0.63%
撿	3702		16	3	0.0004531%	660161	99.71%	2	0.42%
擸	3703		18	3	0.0004531%	660164	99.72%	2	0.42%
攪	3704		23	3	0.0004531%	660167	99.72%	3	0.63%
斟	3705		13	3	0.0004531%	660170	99.72%	3	0.63%
暸	3706		16	3	0.0004531%	660173	99.72%	2	0.42%
曦	3707		20	3	0.0004531%	660176	99.72%	3	0.63%
杵	3708		8	3	0.0004531%	660179	99.72%	3	0.63%
桓	3709		10	3	0.0004531%	660182	99.72%	3	0.63%
桎	3710		10	3	0.0004531%	660185	99.72%	3	0.63%
梏	3711		11	3	0.0004531%	660188	99.72%	3	0.63%
椒	3712		12	3	0.0004531%	660191	99.72%	2	0.42%
椿	3713		13	3	0.0004531%	660194	99.72%	3	0.63%
榕	3714		14	3	0.0004531%	660197	99.72%	3	0.63%
樊	3715		15	3	0.0004531%	660200	99.72%	3	0.63%
槿	3716		15	3	0.0004531%	660203	99.72%	1	0.21%
橄	3717		16	3	0.0004531%	660206	99.72%	3	0.63%
檐	3718		17	3	0.0004531%	660209	99.72%	2	0.42%
櫝	3719		19	3	0.0004531%	660212	99.72%	2	0.42%
櫻	3720		21	3	0.0004531%	660215	99.72%	3	0.63%
櫺	3721		21	3	0.0004531%	660218	99.72%	2	0.42%
欉	3722		22	3	0.0004531%	660221	99.72%	1	0.21%
殃	3723		9	3	0.0004531%	660224	99.72%	3	0.63%
氮	3724		12	3	0.0004531%	660227	99.72%	1	0.21%
汎	3725		6	3	0.0004531%	660230	99.73%	2	0.42%
沐	3726		7	3	0.0004531%	660233	99.73%	3	0.63%
沱	3727		8	3	0.0004531%	660236	99.73%	3	0.63%
沮	3728		8	3	0.0004531%	660239	99.73%	3	0.63%
泯	3729		8	3	0.0004531%	660242	99.73%	2	0.42%
涕	3730		10	3	0.0004531%	660245	99.73%	3	0.63%
浦	3731		10	3	0.0004531%	660248	99.73%	3	0.63%
渥	3732		12	3	0.0004531%	660251	99.73%	3	0.63%
湮	3733		12	3	0.0004531%	660254	99.73%	3	0.63%
渙	3734		12	3	0.0004531%	660257	99.73%	3	0.63%
滂	3735		13	3	0.0004531%	660260	99.73%	3	0.63%
滬	3736		14	3	0.0004531%	660263	99.73%	2	0.42%
濬	3737		17	3	0.0004531%	660266	99.73%	3	0.63%
焊	3738		11	3	0.0004531%	660269	99.73%	2	0.42%
煦	3739		13	3	0.0004531%	660272	99.73%	3	0.63%
燐	3740		16	3	0.0004531%	660275	99.73%	3	0.63%
燬	3741		17	3	0.0004531%	660278	99.73%	3	0.63%
爹	3742		10	3	0.0004531%	660281	99.73%	2	0.42%
犁	3743		11	3	0.0004531%	660284	99.73%	2	0.42%
猥	3744		12	3	0.0004531%	660287	99.73%	3	0.63%
猿	3745		13	3	0.0004531%	660290	99.73%	2	0.42%
獃	3746		14	3	0.0004531%	660293	99.73%	3	0.63%
獰	3747		17	3	0.0004531%	660296	99.74%	2	0.42%
獷	3748		18	3	0.0004531%	660299	99.74%	3	0.63%
珀	3749		9	3	0.0004531%	660302	99.74%	3	0.63%
琢	3750		12	3	0.0004531%	660305	99.74%	3	0.63%
琥	3751		12	3	0.0004531%	660308	99.74%	3	0.63%
瓢	3752		16	3	0.0004531%	660311	99.74%	3	0.63%
甦	3753		12	3	0.0004531%	660314	99.74%	3	0.63%
疋	3754		5	3	0.0004531%	660317	99.74%	3	0.63%
痊	3755		11	3	0.0004531%	660320	99.74%	2	0.42%
痰	3756		13	3	0.0004531%	660323	99.74%	3	0.63%
瘁	3757		13	3	0.0004531%	660326	99.74%	3	0.63%
瘴	3758		16	3	0.0004531%	660329	99.74%	2	0.42%
皈	3759		9	3	0.0004531%	660332	99.74%	3	0.63%
盃	3760		9	3	0.0004531%	660335	99.74%	2	0.42%
盖	3761		11	3	0.0004531%	660338	99.74%	3	0.63%
瞎	3762		15	3	0.0004531%	660341	99.74%	3	0.63%
瞌	3763		15	3	0.0004531%	660344	99.74%	3	0.63%
瞿	3764		18	3	0.0004531%	660347	99.74%	2	0.42%
矽	3765		8	3	0.0004531%	660350	99.74%	2	0.42%
硃	3766		11	3	0.0004531%	660353	99.74%	2	0.42%
碘	3767		13	3	0.0004531%	660356	99.74%	2	0.42%
磊	3768		15	3	0.0004531%	660359	99.74%	3	0.63%
磐	3769		15	3	0.0004531%	660362	99.75%	2	0.42%
禧	3770		16	3	0.0004531%	660365	99.75%	3	0.63%
穹	3771		8	3	0.0004531%	660368	99.75%	3	0.63%
箴	3772		15	3	0.0004531%	660371	99.75%	2	0.42%
簫	3773		18	3	0.0004531%	660374	99.75%	3	0.63%
粧	3774		12	3	0.0004531%	660377	99.75%	2	0.42%
紆	3775		9	3	0.0004531%	660380	99.75%	3	0.63%
綁	3776		13	3	0.0004531%	660383	99.75%	3	0.63%
綢	3777		14	3	0.0004531%	660386	99.75%	3	0.63%
緞	3778		15	3	0.0004531%	660389	99.75%	2	0.42%
縝	3779		16	3	0.0004531%	660392	99.75%	3	0.63%
縐	3780		16	3	0.0004531%	660395	99.75%	2	0.42%
纘	3781		25	3	0.0004531%	660398	99.75%	1	0.21%
罅	3782		17	3	0.0004531%	660401	99.75%	3	0.63%
羚	3783		11	3	0.0004531%	660404	99.75%	1	0.21%
翱	3784		16	3	0.0004531%	660407	99.75%	3	0.63%
耘	3785		10	3	0.0004531%	660410	99.75%	3	0.63%
耻	3786		10	3	0.0004531%	660413	99.75%	3	0.63%
肄	3787		13	3	0.0004531%	660416	99.75%	3	0.63%
肋	3788		6	3	0.0004531%	660419	99.75%	2	0.42%
肘	3789		7	3	0.0004531%	660422	99.75%	3	0.63%
肪	3790		8	3	0.0004531%	660425	99.75%	2	0.42%
腎	3791		12	3	0.0004531%	660428	99.76%	2	0.42%
臆	3792		17	3	0.0004531%	660431	99.76%	3	0.63%
臻	3793		16	3	0.0004531%	660434	99.76%	3	0.63%
舅	3794		13	3	0.0004531%	660437	99.76%	2	0.42%
荀	3795		10	3	0.0004531%	660440	99.76%	3	0.63%
葺	3796		13	3	0.0004531%	660443	99.76%	1	0.21%
蓓	3797		14	3	0.0004531%	660446	99.76%	3	0.63%
蒔	3798		14	3	0.0004531%	660449	99.76%	2	0.42%
薈	3799		17	3	0.0004531%	660452	99.76%	2	0.42%
藪	3800		19	3	0.0004531%	660455	99.76%	3	0.63%
蘢	3801		20	3	0.0004531%	660458	99.76%	3	0.63%
蘸	3802		23	3	0.0004531%	660461	99.76%	3	0.63%
蘿	3803		23	3	0.0004531%	660464	99.76%	3	0.63%
虱	3804		8	3	0.0004531%	660467	99.76%	1	0.21%
蚣	3805		10	3	0.0004531%	660470	99.76%	1	0.21%
蛛	3806		12	3	0.0004531%	660473	99.76%	3	0.63%
蜈	3807		13	3	0.0004531%	660476	99.76%	1	0.21%
蜉	3808		13	3	0.0004531%	660479	99.76%	1	0.21%
蜘	3809		14	3	0.0004531%	660482	99.76%	3	0.63%
蝣	3810		15	3	0.0004531%	660485	99.76%	1	0.21%
蟒	3811		17	3	0.0004531%	660488	99.76%	3	0.63%
衊	3812		21	3	0.0004531%	660491	99.76%	2	0.42%
衢	3813		24	3	0.0004531%	660494	99.77%	2	0.42%
袂	3814		9	3	0.0004531%	660497	99.77%	3	0.63%
褂	3815		13	3	0.0004531%	660500	99.77%	3	0.63%
褒	3816		15	3	0.0004531%	660503	99.77%	3	0.63%
褸	3817		16	3	0.0004531%	660506	99.77%	3	0.63%
誡	3818		14	3	0.0004531%	660509	99.77%	3	0.63%
諜	3819		16	3	0.0004531%	660512	99.77%	2	0.42%
謔	3820		16	3	0.0004531%	660515	99.77%	3	0.63%
谿	3821		17	3	0.0004531%	660518	99.77%	3	0.63%
賠	3822		15	3	0.0004531%	660521	99.77%	3	0.63%
跛	3823		12	3	0.0004531%	660524	99.77%	2	0.42%
踉	3824		14	3	0.0004531%	660527	99.77%	2	0.42%
踩	3825		15	3	0.0004531%	660530	99.77%	3	0.63%
蹄	3826		16	3	0.0004531%	660533	99.77%	3	0.63%
蹌	3827		17	3	0.0004531%	660536	99.77%	2	0.42%
躇	3828		19	3	0.0004531%	660539	99.77%	3	0.63%
躊	3829		21	3	0.0004531%	660542	99.77%	3	0.63%
輋	3830		13	3	0.0004531%	660545	99.77%	2	0.42%
轔	3831		19	3	0.0004531%	660548	99.77%	1	0.21%
邵	3832		7	3	0.0004531%	660551	99.77%	2	0.42%
酗	3833		11	3	0.0004531%	660554	99.77%	2	0.42%
釜	3834		10	3	0.0004531%	660557	99.77%	3	0.63%
鉗	3835		13	3	0.0004531%	660560	99.78%	2	0.42%
銹	3836		15	3	0.0004531%	660563	99.78%	3	0.63%
鋸	3837		16	3	0.0004531%	660566	99.78%	3	0.63%
錮	3838		16	3	0.0004531%	660569	99.78%	2	0.42%
鑣	3839		23	3	0.0004531%	660572	99.78%	3	0.63%
閂	3840		9	3	0.0004531%	660575	99.78%	2	0.42%
阱	3841		6	3	0.0004531%	660578	99.78%	3	0.63%
隕	3842		12	3	0.0004531%	660581	99.78%	3	0.63%
雇	3843		12	3	0.0004531%	660584	99.78%	2	0.42%
雋	3844		13	3	0.0004531%	660587	99.78%	3	0.63%
霾	3845		22	3	0.0004531%	660590	99.78%	3	0.63%
靦	3846		16	3	0.0004531%	660593	99.78%	3	0.63%
鞠	3847		17	3	0.0004531%	660596	99.78%	3	0.63%
韁	3848		22	3	0.0004531%	660599	99.78%	3	0.63%
顱	3849		25	3	0.0004531%	660602	99.78%	3	0.63%
颯	3850		14	3	0.0004531%	660605	99.78%	2	0.42%
颺	3851		18	3	0.0004531%	660608	99.78%	3	0.63%
飆	3852		21	3	0.0004531%	660611	99.78%	3	0.63%
飩	3853		12	3	0.0004531%	660614	99.78%	1	0.21%
餒	3854		15	3	0.0004531%	660617	99.78%	3	0.63%
餛	3855		16	3	0.0004531%	660620	99.78%	1	0.21%
饞	3856		25	3	0.0004531%	660623	99.78%	3	0.63%
駱	3857		16	3	0.0004531%	660626	99.79%	3	0.63%
騁	3858		17	3	0.0004531%	660629	99.79%	3	0.63%
駿	3859		17	3	0.0004531%	660632	99.79%	3	0.63%
鰥	3860		21	3	0.0004531%	660635	99.79%	2	0.42%
鵠	3861		18	3	0.0004531%	660638	99.79%	3	0.63%
黍	3862		12	3	0.0004531%	660641	99.79%	2	0.42%
黔	3863		16	3	0.0004531%	660644	99.79%	1	0.21%
黠	3864		18	3	0.0004531%	660647	99.79%	1	0.21%
鼎	3865		13	3	0.0004531%	660650	99.79%	3	0.63%
鼾	3866		17	3	0.0004531%	660653	99.79%	3	0.63%
丑	3867		4	2	0.0003021%	660655	99.79%	2	0.42%
义	3868		3	2	0.0003021%	660657	99.79%	2	0.42%
氹	3869		5	2	0.0003021%	660659	99.79%	2	0.42%
亍	3870		3	2	0.0003021%	660661	99.79%	2	0.42%
亳	3871		10	2	0.0003021%	660663	99.79%	1	0.21%
仆	3872		4	2	0.0003021%	660665	99.79%	2	0.42%
佰	3873		8	2	0.0003021%	660667	99.79%	1	0.21%
偕	3874		11	2	0.0003021%	660669	99.79%	2	0.42%
僭	3875		14	2	0.0003021%	660671	99.79%	2	0.42%
兀	3876		3	2	0.0003021%	660673	99.79%	2	0.42%
冉	3877		5	2	0.0003021%	660675	99.79%	1	0.21%
冽	3878		8	2	0.0003021%	660677	99.79%	2	0.42%
冼	3879		8	2	0.0003021%	660679	99.79%	1	0.21%
刦	3880		7	2	0.0003021%	660681	99.79%	2	0.42%
効	3881		8	2	0.0003021%	660683	99.79%	2	0.42%
勘	3882		11	2	0.0003021%	660685	99.79%	2	0.42%
勦	3883		13	2	0.0003021%	660687	99.79%	2	0.42%
匙	3884		11	2	0.0003021%	660689	99.79%	2	0.42%
匱	3885		14	2	0.0003021%	660691	99.80%	2	0.42%
呸	3886		8	2	0.0003021%	660693	99.80%	2	0.42%
呷	3887		8	2	0.0003021%	660695	99.80%	2	0.42%
咫	3888		9	2	0.0003021%	660697	99.80%	2	0.42%
咿	3889		9	2	0.0003021%	660699	99.80%	2	0.42%
咭	3890		9	2	0.0003021%	660701	99.80%	2	0.42%
唅	3891		10	2	0.0003021%	660703	99.80%	1	0.21%
啪	3892		11	2	0.0003021%	660705	99.80%	1	0.21%
啃	3893		11	2	0.0003021%	660707	99.80%	2	0.42%
啕	3894		11	2	0.0003021%	660709	99.80%	2	0.42%
唬	3895		11	2	0.0003021%	660711	99.80%	1	0.21%
嗤	3896		13	2	0.0003021%	660713	99.80%	2	0.42%
嗯	3897		13	2	0.0003021%	660715	99.80%	2	0.42%
嘟	3898		13	2	0.0003021%	660717	99.80%	1	0.21%
嗔	3899		13	2	0.0003021%	660719	99.80%	2	0.42%
嗬	3900		14	2	0.0003021%	660721	99.80%	1	0.21%
嘍	3901		14	2	0.0003021%	660723	99.80%	2	0.42%
嗷	3902		14	2	0.0003021%	660725	99.80%	1	0.21%
嘿	3903		15	2	0.0003021%	660727	99.80%	1	0.21%
噎	3904		15	2	0.0003021%	660729	99.80%	2	0.42%
嘰	3905		15	2	0.0003021%	660731	99.80%	2	0.42%
噤	3906		16	2	0.0003021%	660733	99.80%	2	0.42%
噥	3907		16	2	0.0003021%	660735	99.80%	1	0.21%
嚶	3908		20	2	0.0003021%	660737	99.80%	1	0.21%
囡	3909		6	2	0.0003021%	660739	99.80%	1	0.21%
囤	3910		7	2	0.0003021%	660741	99.80%	1	0.21%
垛	3911		9	2	0.0003021%	660743	99.80%	2	0.42%
夔	3912		21	2	0.0003021%	660745	99.80%	2	0.42%
奄	3913		8	2	0.0003021%	660747	99.80%	2	0.42%
奎	3914		9	2	0.0003021%	660749	99.80%	2	0.42%
妓	3915		7	2	0.0003021%	660751	99.80%	2	0.42%
姜	3916		9	2	0.0003021%	660753	99.80%	2	0.42%
婿	3917		12	2	0.0003021%	660755	99.80%	2	0.42%
嬗	3918		16	2	0.0003021%	660757	99.80%	1	0.21%
孑	3919		3	2	0.0003021%	660759	99.81%	2	0.42%
孖	3920		6	2	0.0003021%	660761	99.81%	2	0.42%
孢	3921		8	2	0.0003021%	660763	99.81%	1	0.21%
孰	3922		11	2	0.0003021%	660765	99.81%	2	0.42%
尢	3923		3	2	0.0003021%	660767	99.81%	2	0.42%
尬	3924		7	2	0.0003021%	660769	99.81%	2	0.42%
尷	3925		17	2	0.0003021%	660771	99.81%	2	0.42%
尹	3926		4	2	0.0003021%	660773	99.81%	2	0.42%
崛	3927		11	2	0.0003021%	660775	99.81%	2	0.42%
崤	3928		11	2	0.0003021%	660777	99.81%	1	0.21%
嵯	3929		13	2	0.0003021%	660779	99.81%	1	0.21%
嶽	3930		17	2	0.0003021%	660781	99.81%	2	0.42%
巉	3931		20	2	0.0003021%	660783	99.81%	2	0.42%
巫	3932		7	2	0.0003021%	660785	99.81%	1	0.21%
帖	3933		8	2	0.0003021%	660787	99.81%	2	0.42%
帥	3934		9	2	0.0003021%	660789	99.81%	2	0.42%
幀	3935		12	2	0.0003021%	660791	99.81%	2	0.42%
庵	3936		11	2	0.0003021%	660793	99.81%	2	0.42%
弛	3937		6	2	0.0003021%	660795	99.81%	2	0.42%
弧	3938		8	2	0.0003021%	660797	99.81%	2	0.42%
彬	3939		11	2	0.0003021%	660799	99.81%	2	0.42%
彪	3940		11	2	0.0003021%	660801	99.81%	2	0.42%
彳	3941		3	2	0.0003021%	660803	99.81%	2	0.42%
徽	3942		17	2	0.0003021%	660805	99.81%	2	0.42%
忒	3943		7	2	0.0003021%	660807	99.81%	1	0.21%
忡	3944		7	2	0.0003021%	660809	99.81%	1	0.21%
忤	3945		7	2	0.0003021%	660811	99.81%	2	0.42%
怏	3946		8	2	0.0003021%	660813	99.81%	1	0.21%
怵	3947		8	2	0.0003021%	660815	99.81%	2	0.42%
怦	3948		8	2	0.0003021%	660817	99.81%	2	0.42%
怠	3949		9	2	0.0003021%	660819	99.81%	2	0.42%
恃	3950		9	2	0.0003021%	660821	99.81%	2	0.42%
恪	3951		9	2	0.0003021%	660823	99.81%	1	0.21%
恣	3952		10	2	0.0003021%	660825	99.82%	2	0.42%
悚	3953		10	2	0.0003021%	660827	99.82%	2	0.42%
悍	3954		10	2	0.0003021%	660829	99.82%	2	0.42%
悒	3955		10	2	0.0003021%	660831	99.82%	2	0.42%
惴	3956		12	2	0.0003021%	660833	99.82%	1	0.21%
惸	3957		12	2	0.0003021%	660835	99.82%	1	0.21%
愷	3958		13	2	0.0003021%	660837	99.82%	2	0.42%
愿	3959		14	2	0.0003021%	660839	99.82%	1	0.21%
慵	3960		14	2	0.0003021%	660841	99.82%	2	0.42%
懟	3961		18	2	0.0003021%	660843	99.82%	2	0.42%
懿	3962		22	2	0.0003021%	660845	99.82%	2	0.42%
戔	3963		8	2	0.0003021%	660847	99.82%	1	0.21%
戳	3964		18	2	0.0003021%	660849	99.82%	2	0.42%
扑	3965		5	2	0.0003021%	660851	99.82%	2	0.42%
扛	3966		6	2	0.0003021%	660853	99.82%	2	0.42%
拊	3967		8	2	0.0003021%	660855	99.82%	1	0.21%
拷	3968		9	2	0.0003021%	660857	99.82%	2	0.42%
挈	3969		10	2	0.0003021%	660859	99.82%	2	0.42%
捍	3970		10	2	0.0003021%	660861	99.82%	2	0.42%
掖	3971		11	2	0.0003021%	660863	99.82%	2	0.42%
掬	3972		11	2	0.0003021%	660865	99.82%	2	0.42%
掇	3973		11	2	0.0003021%	660867	99.82%	2	0.42%
揩	3974		12	2	0.0003021%	660869	99.82%	2	0.42%
揣	3975		12	2	0.0003021%	660871	99.82%	2	0.42%
揖	3976		12	2	0.0003021%	660873	99.82%	2	0.42%
捶	3977		12	2	0.0003021%	660875	99.82%	2	0.42%
揪	3978		12	2	0.0003021%	660877	99.82%	2	0.42%
揄	3979		12	2	0.0003021%	660879	99.82%	2	0.42%
搪	3980		13	2	0.0003021%	660881	99.82%	2	0.42%
摶	3981		14	2	0.0003021%	660883	99.82%	2	0.42%
摰	3982		15	2	0.0003021%	660885	99.82%	2	0.42%
㩗	3983		16	2	0.0003021%	660887	99.82%	2	0.42%
撾	3984		16	2	0.0003021%	660889	99.82%	2	0.42%
攆	3985		18	2	0.0003021%	660891	99.83%	1	0.21%
擻	3986		18	2	0.0003021%	660893	99.83%	2	0.42%
擷	3987		18	2	0.0003021%	660895	99.83%	2	0.42%
攫	3988		23	2	0.0003021%	660897	99.83%	2	0.42%
敝	3989		11	2	0.0003021%	660899	99.83%	2	0.42%
札	3990		5	2	0.0003021%	660901	99.83%	2	0.42%
枇	3991		8	2	0.0003021%	660903	99.83%	2	0.42%
柄	3992		9	2	0.0003021%	660905	99.83%	2	0.42%
柚	3993		9	2	0.0003021%	660907	99.83%	2	0.42%
枷	3994		9	2	0.0003021%	660909	99.83%	2	0.42%
栩	3995		10	2	0.0003021%	660911	99.83%	1	0.21%
梟	3996		11	2	0.0003021%	660913	99.83%	2	0.42%
棱	3997		12	2	0.0003021%	660915	99.83%	1	0.21%
楫	3998		13	2	0.0003021%	660917	99.83%	2	0.42%
榨	3999		14	2	0.0003021%	660919	99.83%	2	0.42%
槁	4000		14	2	0.0003021%	660921	99.83%	2	0.42%
榷	4001		14	2	0.0003021%	660923	99.83%	2	0.42%
槐	4002		14	2	0.0003021%	660925	99.83%	2	0.42%
榭	4003		14	2	0.0003021%	660927	99.83%	2	0.42%
榦	4004		14	2	0.0003021%	660929	99.83%	2	0.42%
榖	4005		14	2	0.0003021%	660931	99.83%	2	0.42%
樟	4006		15	2	0.0003021%	660933	99.83%	1	0.21%
槽	4007		15	2	0.0003021%	660935	99.83%	2	0.42%
槤	4008		15	2	0.0003021%	660937	99.83%	1	0.21%
檜	4009		17	2	0.0003021%	660939	99.83%	1	0.21%
櫛	4010		17	2	0.0003021%	660941	99.83%	2	0.42%
檣	4011		17	2	0.0003021%	660943	99.83%	2	0.42%
橾	4012		17	2	0.0003021%	660945	99.83%	2	0.42%
檬	4013		18	2	0.0003021%	660947	99.83%	2	0.42%
檸	4014		18	2	0.0003021%	660949	99.83%	2	0.42%
殆	4015		9	2	0.0003021%	660951	99.83%	2	0.42%
毡	4016		9	2	0.0003021%	660953	99.83%	1	0.21%
毯	4017		12	2	0.0003021%	660955	99.83%	1	0.21%
氈	4018		17	2	0.0003021%	660957	99.84%	2	0.42%
氓	4019		8	2	0.0003021%	660959	99.84%	2	0.42%
氚	4020		7	2	0.0003021%	660961	99.84%	1	0.21%
氪	4021		11	2	0.0003021%	660963	99.84%	1	0.21%
氯	4022		12	2	0.0003021%	660965	99.84%	1	0.21%
汙	4023		6	2	0.0003021%	660967	99.84%	1	0.21%
汐	4024		6	2	0.0003021%	660969	99.84%	2	0.42%
泗	4025		8	2	0.0003021%	660971	99.84%	2	0.42%
泱	4026		8	2	0.0003021%	660973	99.84%	1	0.21%
沬	4027		8	2	0.0003021%	660975	99.84%	2	0.42%
泫	4028		8	2	0.0003021%	660977	99.84%	2	0.42%
洌	4029		9	2	0.0003021%	660979	99.84%	2	0.42%
淇	4030		11	2	0.0003021%	660981	99.84%	2	0.42%
淮	4031		11	2	0.0003021%	660983	99.84%	2	0.42%
淼	4032		12	2	0.0003021%	660985	99.84%	2	0.42%
滓	4033		13	2	0.0003021%	660987	99.84%	2	0.42%
漿	4034		15	2	0.0003021%	660989	99.84%	2	0.42%
潦	4035		15	2	0.0003021%	660991	99.84%	2	0.42%
瀆	4036		18	2	0.0003021%	660993	99.84%	2	0.42%
瀛	4037		19	2	0.0003021%	660995	99.84%	2	0.42%
瀟	4038		19	2	0.0003021%	660997	99.84%	2	0.42%
炬	4039		9	2	0.0003021%	660999	99.84%	2	0.42%
焙	4040		12	2	0.0003021%	661001	99.84%	2	0.42%
熏	4041		14	2	0.0003021%	661003	99.84%	2	0.42%
熨	4042		15	2	0.0003021%	661005	99.84%	2	0.42%
熹	4043		16	2	0.0003021%	661007	99.84%	2	0.42%
燼	4044		18	2	0.0003021%	661009	99.84%	2	0.42%
猺	4045		13	2	0.0003021%	661011	99.84%	1	0.21%
瑙	4046		13	2	0.0003021%	661013	99.84%	2	0.42%
瑤	4047		14	2	0.0003021%	661015	99.84%	2	0.42%
璜	4048		16	2	0.0003021%	661017	99.84%	1	0.21%
璠	4049		16	2	0.0003021%	661019	99.84%	1	0.21%
瓊	4050		19	2	0.0003021%	661021	99.84%	2	0.42%
畦	4051		11	2	0.0003021%	661023	99.85%	2	0.42%
疙	4052		8	2	0.0003021%	661025	99.85%	2	0.42%
痣	4053		12	2	0.0003021%	661027	99.85%	1	0.21%
痼	4054		13	2	0.0003021%	661029	99.85%	2	0.42%
瘠	4055		15	2	0.0003021%	661031	99.85%	2	0.42%
瘩	4056		15	2	0.0003021%	661033	99.85%	2	0.42%
癃	4057		17	2	0.0003021%	661035	99.85%	1	0.21%
癲	4058		24	2	0.0003021%	661037	99.85%	1	0.21%
皂	4059		7	2	0.0003021%	661039	99.85%	2	0.42%
皋	4060		10	2	0.0003021%	661041	99.85%	2	0.42%
皿	4061		5	2	0.0003021%	661043	99.85%	2	0.42%
盥	4062		16	2	0.0003021%	661045	99.85%	1	0.21%
睏	4063		12	2	0.0003021%	661047	99.85%	2	0.42%
睞	4064		13	2	0.0003021%	661049	99.85%	2	0.42%
睬	4065		13	2	0.0003021%	661051	99.85%	2	0.42%
睥	4066		13	2	0.0003021%	661053	99.85%	2	0.42%
瞅	4067		14	2	0.0003021%	661055	99.85%	2	0.42%
瞟	4068		16	2	0.0003021%	661057	99.85%	2	0.42%
瞶	4069		17	2	0.0003021%	661059	99.85%	2	0.42%
瞽	4070		18	2	0.0003021%	661061	99.85%	1	0.21%
矚	4071		26	2	0.0003021%	661063	99.85%	2	0.42%
矻	4072		8	2	0.0003021%	661065	99.85%	1	0.21%
砉	4073		9	2	0.0003021%	661067	99.85%	1	0.21%
砝	4074		10	2	0.0003021%	661069	99.85%	1	0.21%
硝	4075		12	2	0.0003021%	661071	99.85%	2	0.42%
碇	4076		13	2	0.0003021%	661073	99.85%	2	0.42%
磺	4077		17	2	0.0003021%	661075	99.85%	2	0.42%
祀	4078		7	2	0.0003021%	661077	99.85%	2	0.42%
祁	4079		7	2	0.0003021%	661079	99.85%	2	0.42%
祂	4080		7	2	0.0003021%	661081	99.85%	1	0.21%
祢	4081		9	2	0.0003021%	661083	99.85%	1	0.21%
祐	4082		9	2	0.0003021%	661085	99.85%	1	0.21%
稔	4083		13	2	0.0003021%	661087	99.85%	2	0.42%
穰	4084		22	2	0.0003021%	661089	99.86%	1	0.21%
窈	4085		10	2	0.0003021%	661091	99.86%	2	0.42%
窕	4086		11	2	0.0003021%	661093	99.86%	2	0.42%
窳	4087		15	2	0.0003021%	661095	99.86%	2	0.42%
窿	4088		17	2	0.0003021%	661097	99.86%	1	0.21%
笋	4089		10	2	0.0003021%	661099	99.86%	2	0.42%
筷	4090		13	2	0.0003021%	661101	99.86%	2	0.42%
箏	4091		14	2	0.0003021%	661103	99.86%	2	0.42%
箇	4092		14	2	0.0003021%	661105	99.86%	2	0.42%
劄	4093		14	2	0.0003021%	661107	99.86%	2	0.42%
篩	4094		16	2	0.0003021%	661109	99.86%	2	0.42%
篷	4095		17	2	0.0003021%	661111	99.86%	2	0.42%
粕	4096		11	2	0.0003021%	661113	99.86%	2	0.42%
粼	4097		14	2	0.0003021%	661115	99.86%	1	0.21%
紏	4098		10	2	0.0003021%	661117	99.86%	1	0.21%
綑	4099		13	2	0.0003021%	661119	99.86%	2	0.42%
綞	4100		15	2	0.0003021%	661121	99.86%	2	0.42%
緲	4101		15	2	0.0003021%	661123	99.86%	2	0.42%
繆	4102		17	2	0.0003021%	661125	99.86%	2	0.42%
縵	4103		17	2	0.0003021%	661127	99.86%	1	0.21%
繭	4104		19	2	0.0003021%	661129	99.86%	2	0.42%
罄	4105		17	2	0.0003021%	661131	99.86%	2	0.42%
罌	4106		20	2	0.0003021%	661133	99.86%	1	0.21%
罔	4107		8	2	0.0003021%	661135	99.86%	2	0.42%
羲	4108		16	2	0.0003021%	661137	99.86%	1	0.21%
羹	4109		19	2	0.0003021%	661139	99.86%	1	0.21%
脣	4110		11	2	0.0003021%	661141	99.86%	2	0.42%
脩	4111		11	2	0.0003021%	661143	99.86%	2	0.42%
腕	4112		12	2	0.0003021%	661145	99.86%	2	0.42%
腋	4113		12	2	0.0003021%	661147	99.86%	2	0.42%
腑	4114		12	2	0.0003021%	661149	99.86%	2	0.42%
腊	4115		12	2	0.0003021%	661151	99.86%	2	0.42%
臀	4116		17	2	0.0003021%	661153	99.86%	1	0.21%
舢	4117		9	2	0.0003021%	661155	99.87%	1	0.21%
舨	4118		10	2	0.0003021%	661157	99.87%	1	0.21%
舲	4119		11	2	0.0003021%	661159	99.87%	2	0.42%
艸	4120		6	2	0.0003021%	661161	99.87%	1	0.21%
芷	4121		8	2	0.0003021%	661163	99.87%	2	0.42%
芮	4122		8	2	0.0003021%	661165	99.87%	2	0.42%
苞	4123		9	2	0.0003021%	661167	99.87%	2	0.42%
荐	4124		10	2	0.0003021%	661169	99.87%	2	0.42%
茹	4125		10	2	0.0003021%	661171	99.87%	2	0.42%
莞	4126		11	2	0.0003021%	661173	99.87%	2	0.42%
莘	4127		11	2	0.0003021%	661175	99.87%	2	0.42%
莠	4128		11	2	0.0003021%	661177	99.87%	2	0.42%
菱	4129		12	2	0.0003021%	661179	99.87%	2	0.42%
菇	4130		12	2	0.0003021%	661181	99.87%	1	0.21%
蒲	4131		14	2	0.0003021%	661183	99.87%	2	0.42%
蒜	4132		14	2	0.0003021%	661185	99.87%	1	0.21%
蓐	4133		14	2	0.0003021%	661187	99.87%	2	0.42%
蕊	4134		16	2	0.0003021%	661189	99.87%	2	0.42%
藻	4135		20	2	0.0003021%	661191	99.87%	2	0.42%
蘑	4136		20	2	0.0003021%	661193	99.87%	1	0.21%
虜	4137		13	2	0.0003021%	661195	99.87%	2	0.42%
蛾	4138		13	2	0.0003021%	661197	99.87%	2	0.42%
蜡	4139		14	2	0.0003021%	661199	99.87%	2	0.42%
蝎	4140		15	2	0.0003021%	661201	99.87%	1	0.21%
蟆	4141		17	2	0.0003021%	661203	99.87%	1	0.21%
蠹	4142		24	2	0.0003021%	661205	99.87%	2	0.42%
衙	4143		13	2	0.0003021%	661207	99.87%	2	0.42%
衾	4144		10	2	0.0003021%	661209	99.87%	2	0.42%
袈	4145		11	2	0.0003021%	661211	99.87%	2	0.42%
袤	4146		11	2	0.0003021%	661213	99.87%	2	0.42%
裟	4147		13	2	0.0003021%	661215	99.87%	2	0.42%
裴	4148		13	2	0.0003021%	661217	99.87%	1	0.21%
裾	4149		13	2	0.0003021%	661219	99.87%	2	0.42%
褥	4150		15	2	0.0003021%	661221	99.88%	2	0.42%
襤	4151		19	2	0.0003021%	661223	99.88%	2	0.42%
覦	4152		16	2	0.0003021%	661225	99.88%	2	0.42%
覬	4153		17	2	0.0003021%	661227	99.88%	2	0.42%
觴	4154		18	2	0.0003021%	661229	99.88%	2	0.42%
訕	4155		10	2	0.0003021%	661231	99.88%	2	0.42%
訛	4156		11	2	0.0003021%	661233	99.88%	1	0.21%
訢	4157		11	2	0.0003021%	661235	99.88%	2	0.42%
諫	4158		16	2	0.0003021%	661237	99.88%	2	0.42%
謅	4159		17	2	0.0003021%	661239	99.88%	1	0.21%
謢	4160		17	2	0.0003021%	661241	99.88%	2	0.42%
謳	4161		18	2	0.0003021%	661243	99.88%	2	0.42%
譁	4162		19	2	0.0003021%	661245	99.88%	2	0.42%
豹	4163		10	2	0.0003021%	661247	99.88%	2	0.42%
貂	4164		12	2	0.0003021%	661249	99.88%	2	0.42%
賒	4165		14	2	0.0003021%	661251	99.88%	1	0.21%
賙	4166		15	2	0.0003021%	661253	99.88%	1	0.21%
贓	4167		21	2	0.0003021%	661255	99.88%	2	0.42%
贖	4168		22	2	0.0003021%	661257	99.88%	2	0.42%
贛	4169		24	2	0.0003021%	661259	99.88%	2	0.42%
赳	4170		9	2	0.0003021%	661261	99.88%	1	0.21%
趺	4171		11	2	0.0003021%	661263	99.88%	2	0.42%
跎	4172		12	2	0.0003021%	661265	99.88%	2	0.42%
跚	4173		12	2	0.0003021%	661267	99.88%	2	0.42%
蹉	4174		17	2	0.0003021%	661269	99.88%	2	0.42%
蹙	4175		18	2	0.0003021%	661271	99.88%	2	0.42%
蹣	4176		18	2	0.0003021%	661273	99.88%	2	0.42%
蹬	4177		19	2	0.0003021%	661275	99.88%	2	0.42%
蹺	4178		19	2	0.0003021%	661277	99.88%	2	0.42%
躡	4179		25	2	0.0003021%	661279	99.88%	2	0.42%
軔	4180		10	2	0.0003021%	661281	99.88%	2	0.42%
轤	4181		23	2	0.0003021%	661283	99.88%	2	0.42%
逞	4182		10	2	0.0003021%	661285	99.88%	2	0.42%
逮	4183		11	2	0.0003021%	661287	99.89%	1	0.21%
遯	4184		14	2	0.0003021%	661289	99.89%	1	0.21%
邸	4185		7	2	0.0003021%	661291	99.89%	2	0.42%
郤	4186		9	2	0.0003021%	661293	99.89%	2	0.42%
酉	4187		7	2	0.0003021%	661295	99.89%	2	0.42%
醪	4188		18	2	0.0003021%	661297	99.89%	1	0.21%
醺	4189		21	2	0.0003021%	661299	99.89%	1	0.21%
釆	4190		7	2	0.0003021%	661301	99.89%	2	0.42%
鈸	4191		13	2	0.0003021%	661303	99.89%	2	0.42%
鈹	4192		13	2	0.0003021%	661305	99.89%	1	0.21%
鉆	4193		13	2	0.0003021%	661307	99.89%	1	0.21%
鉻	4194		14	2	0.0003021%	661309	99.89%	1	0.21%
鋇	4195		15	2	0.0003021%	661311	99.89%	1	0.21%
鋰	4196		15	2	0.0003021%	661313	99.89%	1	0.21%
鋂	4197		15	2	0.0003021%	661315	99.89%	1	0.21%
鋦	4198		15	2	0.0003021%	661317	99.89%	1	0.21%
鎘	4199		18	2	0.0003021%	661319	99.89%	1	0.21%
鏈	4200		19	2	0.0003021%	661321	99.89%	2	0.42%
鐮	4201		21	2	0.0003021%	661323	99.89%	2	0.42%
鑊	4202		22	2	0.0003021%	661325	99.89%	2	0.42%
閎	4203		12	2	0.0003021%	661327	99.89%	2	0.42%
闃	4204		17	2	0.0003021%	661329	99.89%	2	0.42%
闕	4205		18	2	0.0003021%	661331	99.89%	2	0.42%
阪	4206		6	2	0.0003021%	661333	99.89%	2	0.42%
陝	4207		9	2	0.0003021%	661335	99.89%	2	0.42%
陲	4208		11	2	0.0003021%	661337	99.89%	2	0.42%
隴	4209		18	2	0.0003021%	661339	99.89%	2	0.42%
靂	4210		24	2	0.0003021%	661341	99.89%	2	0.42%
靄	4211		24	2	0.0003021%	661343	99.89%	2	0.42%
靚	4212		15	2	0.0003021%	661345	99.89%	2	0.42%
靴	4213		13	2	0.0003021%	661347	99.89%	2	0.42%
韜	4214		19	2	0.0003021%	661349	99.89%	1	0.21%
韶	4215		14	2	0.0003021%	661351	99.89%	2	0.42%
顎	4216		18	2	0.0003021%	661353	99.90%	2	0.42%
颼	4217		18	2	0.0003021%	661355	99.90%	1	0.21%
飭	4218		12	2	0.0003021%	661357	99.90%	2	0.42%
餚	4219		16	2	0.0003021%	661359	99.90%	2	0.42%
餸	4220		18	2	0.0003021%	661361	99.90%	2	0.42%
餽	4221		18	2	0.0003021%	661363	99.90%	1	0.21%
饉	4222		19	2	0.0003021%	661365	99.90%	1	0.21%
饌	4223		20	2	0.0003021%	661367	99.90%	2	0.42%
騮	4224		20	2	0.0003021%	661369	99.90%	2	0.42%
騾	4225		21	2	0.0003021%	661371	99.90%	2	0.42%
驛	4226		23	2	0.0003021%	661373	99.90%	1	0.21%
骸	4227		16	2	0.0003021%	661375	99.90%	2	0.42%
髻	4228		16	2	0.0003021%	661377	99.90%	2	0.42%
鳶	4229		14	2	0.0003021%	661379	99.90%	2	0.42%
鶩	4230		20	2	0.0003021%	661381	99.90%	2	0.42%
鸛	4231		29	2	0.0003021%	661383	99.90%	1	0.21%
亘	4232		6	1	0.000151%	661384	99.90%	1	0.21%
仟	4233		5	1	0.000151%	661385	99.90%	1	0.21%
伎	4234		6	1	0.000151%	661386	99.90%	1	0.21%
佃	4235		7	1	0.000151%	661387	99.90%	1	0.21%
佘	4236		7	1	0.000151%	661388	99.90%	1	0.21%
佯	4237		8	1	0.000151%	661389	99.90%	1	0.21%
佻	4238		8	1	0.000151%	661390	99.90%	1	0.21%
侄	4239		8	1	0.000151%	661391	99.90%	1	0.21%
佫	4240		8	1	0.000151%	661392	99.90%	1	0.21%
俘	4241		9	1	0.000151%	661393	99.90%	1	0.21%
俚	4242		9	1	0.000151%	661394	99.90%	1	0.21%
俎	4243		9	1	0.000151%	661395	99.90%	1	0.21%
俛	4244		9	1	0.000151%	661396	99.90%	1	0.21%
俬	4245		9	1	0.000151%	661397	99.90%	1	0.21%
倌	4246		10	1	0.000151%	661398	99.90%	1	0.21%
俺	4247		10	1	0.000151%	661399	99.90%	1	0.21%
偃	4248		11	1	0.000151%	661400	99.90%	1	0.21%
倏	4249		11	1	0.000151%	661401	99.90%	1	0.21%
偪	4250		11	1	0.000151%	661402	99.90%	1	0.21%
傚	4251		12	1	0.000151%	661403	99.90%	1	0.21%
僉	4252		13	1	0.000151%	661404	99.90%	1	0.21%
僮	4253		14	1	0.000151%	661405	99.90%	1	0.21%
僨	4254		14	1	0.000151%	661406	99.90%	1	0.21%
儔	4255		16	1	0.000151%	661407	99.90%	1	0.21%
儷	4256		21	1	0.000151%	661408	99.90%	1	0.21%
冇	4257		4	1	0.000151%	661409	99.90%	1	0.21%
冑	4258		9	1	0.000151%	661410	99.90%	1	0.21%
几	4259		2	1	0.000151%	661411	99.90%	1	0.21%
刱	4260		8	1	0.000151%	661412	99.90%	1	0.21%
剃	4261		9	1	0.000151%	661413	99.90%	1	0.21%
剋	4262		9	1	0.000151%	661414	99.90%	1	0.21%
劏	4263		15	1	0.000151%	661415	99.90%	1	0.21%
劊	4264		15	1	0.000151%	661416	99.90%	1	0.21%
劬	4265		7	1	0.000151%	661417	99.90%	1	0.21%
勛	4266		12	1	0.000151%	661418	99.90%	1	0.21%
勰	4267		15	1	0.000151%	661419	99.90%	1	0.21%
勷	4268		19	1	0.000151%	661420	99.91%	1	0.21%
勺	4269		3	1	0.000151%	661421	99.91%	1	0.21%
匍	4270		9	1	0.000151%	661422	99.91%	1	0.21%
匐	4271		11	1	0.000151%	661423	99.91%	1	0.21%
卯	4272		5	1	0.000151%	661424	99.91%	1	0.21%
厝	4273		10	1	0.000151%	661425	99.91%	1	0.21%
叉	4274		3	1	0.000151%	661426	99.91%	1	0.21%
叟	4275		9	1	0.000151%	661427	99.91%	1	0.21%
吓	4276		6	1	0.000151%	661428	99.91%	1	0.21%
吒	4277		6	1	0.000151%	661429	99.91%	1	0.21%
吮	4278		7	1	0.000151%	661430	99.91%	1	0.21%
吥	4279		7	1	0.000151%	661431	99.91%	1	0.21%
咚	4280		8	1	0.000151%	661432	99.91%	1	0.21%
呤	4281		8	1	0.000151%	661433	99.91%	1	0.21%
哐	4282		9	1	0.000151%	661434	99.91%	1	0.21%
咤	4283		9	1	0.000151%	661435	99.91%	1	0.21%
咦	4284		9	1	0.000151%	661436	99.91%	1	0.21%
唁	4285		10	1	0.000151%	661437	99.91%	1	0.21%
唆	4286		10	1	0.000151%	661438	99.91%	1	0.21%
哽	4287		10	1	0.000151%	661439	99.91%	1	0.21%
唏	4288		10	1	0.000151%	661440	99.91%	1	0.21%
啖	4289		11	1	0.000151%	661441	99.91%	1	0.21%
啁	4290		11	1	0.000151%	661442	99.91%	1	0.21%
喼	4291		12	1	0.000151%	661443	99.91%	1	0.21%
喑	4292		12	1	0.000151%	661444	99.91%	1	0.21%
嗦	4293		13	1	0.000151%	661445	99.91%	1	0.21%
嗒	4294		13	1	0.000151%	661446	99.91%	1	0.21%
嘢	4295		14	1	0.000151%	661447	99.91%	1	0.21%
嘀	4296		14	1	0.000151%	661448	99.91%	1	0.21%
嘹	4297		15	1	0.000151%	661449	99.91%	1	0.21%
噙	4298		16	1	0.000151%	661450	99.91%	1	0.21%
噫	4299		16	1	0.000151%	661451	99.91%	1	0.21%
噱	4300		16	1	0.000151%	661452	99.91%	1	0.21%
嚎	4301		17	1	0.000151%	661453	99.91%	1	0.21%
嚀	4302		17	1	0.000151%	661454	99.91%	1	0.21%
嚨	4303		20	1	0.000151%	661455	99.91%	1	0.21%
囈	4304		22	1	0.000151%	661456	99.91%	1	0.21%
囫	4305		7	1	0.000151%	661457	99.91%	1	0.21%
圇	4306		11	1	0.000151%	661458	99.91%	1	0.21%
坍	4307		7	1	0.000151%	661459	99.91%	1	0.21%
坯	4308		8	1	0.000151%	661460	99.91%	1	0.21%
坵	4309		8	1	0.000151%	661461	99.91%	1	0.21%
垣	4310		9	1	0.000151%	661462	99.91%	1	0.21%
堊	4311		11	1	0.000151%	661463	99.91%	1	0.21%
堰	4312		12	1	0.000151%	661464	99.91%	1	0.21%
塱	4313		13	1	0.000151%	661465	99.91%	1	0.21%
墩	4314		15	1	0.000151%	661466	99.91%	1	0.21%
壬	4315		4	1	0.000151%	661467	99.91%	1	0.21%
夙	4316		6	1	0.000151%	661468	99.91%	1	0.21%
妝	4317		7	1	0.000151%	661469	99.91%	1	0.21%
妞	4318		7	1	0.000151%	661470	99.91%	1	0.21%
妾	4319		8	1	0.000151%	661471	99.91%	1	0.21%
姨	4320		9	1	0.000151%	661472	99.91%	1	0.21%
姚	4321		9	1	0.000151%	661473	99.91%	1	0.21%
姝	4322		9	1	0.000151%	661474	99.91%	1	0.21%
婁	4323		11	1	0.000151%	661475	99.91%	1	0.21%
媧	4324		12	1	0.000151%	661476	99.91%	1	0.21%
媮	4325		12	1	0.000151%	661477	99.91%	1	0.21%
嫡	4326		14	1	0.000151%	661478	99.91%	1	0.21%
嫦	4327		14	1	0.000151%	661479	99.91%	1	0.21%
嬋	4328		15	1	0.000151%	661480	99.91%	1	0.21%
嬈	4329		15	1	0.000151%	661481	99.91%	1	0.21%
嬪	4330		17	1	0.000151%	661482	99.91%	1	0.21%
孀	4331		20	1	0.000151%	661483	99.91%	1	0.21%
孱	4332		12	1	0.000151%	661484	99.91%	1	0.21%
孵	4333		14	1	0.000151%	661485	99.91%	1	0.21%
宕	4334		8	1	0.000151%	661486	99.92%	1	0.21%
宦	4335		9	1	0.000151%	661487	99.92%	1	0.21%
宸	4336		10	1	0.000151%	661488	99.92%	1	0.21%
寢	4337		14	1	0.000151%	661489	99.92%	1	0.21%
尸	4338		3	1	0.000151%	661490	99.92%	1	0.21%
屺	4339		6	1	0.000151%	661491	99.92%	1	0.21%
岷	4340		8	1	0.000151%	661492	99.92%	1	0.21%
岬	4341		8	1	0.000151%	661493	99.92%	1	0.21%
峋	4342		9	1	0.000151%	661494	99.92%	1	0.21%
峪	4343		10	1	0.000151%	661495	99.92%	1	0.21%
崢	4344		11	1	0.000151%	661496	99.92%	1	0.21%
崑	4345		11	1	0.000151%	661497	99.92%	1	0.21%
嵌	4346		12	1	0.000151%	661498	99.92%	1	0.21%
嵐	4347		12	1	0.000151%	661499	99.92%	1	0.21%
嶙	4348		15	1	0.000151%	661500	99.92%	1	0.21%
嶸	4349		17	1	0.000151%	661501	99.92%	1	0.21%
巽	4350		12	1	0.000151%	661502	99.92%	1	0.21%
帘	4351		8	1	0.000151%	661503	99.92%	1	0.21%
幃	4352		12	1	0.000151%	661504	99.92%	1	0.21%
幗	4353		14	1	0.000151%	661505	99.92%	1	0.21%
幔	4354		14	1	0.000151%	661506	99.92%	1	0.21%
幘	4355		14	1	0.000151%	661507	99.92%	1	0.21%
幡	4356		15	1	0.000151%	661508	99.92%	1	0.21%
庚	4357		8	1	0.000151%	661509	99.92%	1	0.21%
庥	4358		9	1	0.000151%	661510	99.92%	1	0.21%
廐	4359		14	1	0.000151%	661511	99.92%	1	0.21%
廡	4360		15	1	0.000151%	661512	99.92%	1	0.21%
廩	4361		16	1	0.000151%	661513	99.92%	1	0.21%
廾	4362		3	1	0.000151%	661514	99.92%	1	0.21%
弁	4363		5	1	0.000151%	661515	99.92%	1	0.21%
弩	4364		8	1	0.000151%	661516	99.92%	1	0.21%
弼	4365		12	1	0.000151%	661517	99.92%	1	0.21%
徇	4366		9	1	0.000151%	661518	99.92%	1	0.21%
徠	4367		11	1	0.000151%	661519	99.92%	1	0.21%
忖	4368		6	1	0.000151%	661520	99.92%	1	0.21%
忻	4369		7	1	0.000151%	661521	99.92%	1	0.21%
忝	4370		8	1	0.000151%	661522	99.92%	1	0.21%
怛	4371		8	1	0.000151%	661523	99.92%	1	0.21%
恫	4372		9	1	0.000151%	661524	99.92%	1	0.21%
惓	4373		11	1	0.000151%	661525	99.92%	1	0.21%
愜	4374		12	1	0.000151%	661526	99.92%	1	0.21%
慍	4375		13	1	0.000151%	661527	99.92%	1	0.21%
愫	4376		13	1	0.000151%	661528	99.92%	1	0.21%
慇	4377		14	1	0.000151%	661529	99.92%	1	0.21%
慳	4378		14	1	0.000151%	661530	99.92%	1	0.21%
慝	4379		15	1	0.000151%	661531	99.92%	1	0.21%
慼	4380		15	1	0.000151%	661532	99.92%	1	0.21%
憋	4381		15	1	0.000151%	661533	99.92%	1	0.21%
憒	4382		15	1	0.000151%	661534	99.92%	1	0.21%
懍	4383		16	1	0.000151%	661535	99.92%	1	0.21%
懃	4384		17	1	0.000151%	661536	99.92%	1	0.21%
懾	4385		21	1	0.000151%	661537	99.92%	1	0.21%
戎	4386		6	1	0.000151%	661538	99.92%	1	0.21%
戟	4387		12	1	0.000151%	661539	99.92%	1	0.21%
戡	4388		13	1	0.000151%	661540	99.92%	1	0.21%
戮	4389		15	1	0.000151%	661541	99.92%	1	0.21%
戽	4390		8	1	0.000151%	661542	99.92%	1	0.21%
泪	4391		8	1	0.000151%	661543	99.92%	1	0.21%
拌	4392		8	1	0.000151%	661544	99.92%	1	0.21%
拈	4393		8	1	0.000151%	661545	99.92%	1	0.21%
拇	4394		8	1	0.000151%	661546	99.92%	1	0.21%
拗	4395		8	1	0.000151%	661547	99.92%	1	0.21%
拑	4396		8	1	0.000151%	661548	99.92%	1	0.21%
拽	4397		9	1	0.000151%	661549	99.92%	1	0.21%
拴	4398		9	1	0.000151%	661550	99.92%	1	0.21%
拏	4399		9	1	0.000151%	661551	99.92%	1	0.21%
挹	4400		10	1	0.000151%	661552	99.93%	1	0.21%
捺	4401		11	1	0.000151%	661553	99.93%	1	0.21%
掂	4402		11	1	0.000151%	661554	99.93%	1	0.21%
揍	4403		12	1	0.000151%	661555	99.93%	1	0.21%
揹	4404		12	1	0.000151%	661556	99.93%	1	0.21%
揶	4405		12	1	0.000151%	661557	99.93%	1	0.21%
搆	4406		13	1	0.000151%	661558	99.93%	1	0.21%
搦	4407		13	1	0.000151%	661559	99.93%	1	0.21%
搥	4408		13	1	0.000151%	661560	99.93%	1	0.21%
摻	4409		14	1	0.000151%	661561	99.93%	1	0.21%
撅	4410		15	1	0.000151%	661562	99.93%	1	0.21%
撟	4411		15	1	0.000151%	661563	99.93%	1	0.21%
撘	4412		15	1	0.000151%	661564	99.93%	1	0.21%
撻	4413		16	1	0.000151%	661565	99.93%	1	0.21%
擒	4414		16	1	0.000151%	661566	99.93%	1	0.21%
擘	4415		17	1	0.000151%	661567	99.93%	1	0.21%
擯	4416		17	1	0.000151%	661568	99.93%	1	0.21%
攞	4417		22	1	0.000151%	661569	99.93%	1	0.21%
攢	4418		22	1	0.000151%	661570	99.93%	1	0.21%
敕	4419		11	1	0.000151%	661571	99.93%	1	0.21%
斂	4420		17	1	0.000151%	661572	99.93%	1	0.21%
斲	4421		15	1	0.000151%	661573	99.93%	1	0.21%
旂	4422		10	1	0.000151%	661574	99.93%	1	0.21%
旌	4423		11	1	0.000151%	661575	99.93%	1	0.21%
旎	4424		11	1	0.000151%	661576	99.93%	1	0.21%
旖	4425		14	1	0.000151%	661577	99.93%	1	0.21%
旛	4426		18	1	0.000151%	661578	99.93%	1	0.21%
旰	4427		7	1	0.000151%	661579	99.93%	1	0.21%
昊	4428		8	1	0.000151%	661580	99.93%	1	0.21%
昉	4429		8	1	0.000151%	661581	99.93%	1	0.21%
昺	4430		9	1	0.000151%	661582	99.93%	1	0.21%
晁	4431		10	1	0.000151%	661583	99.93%	1	0.21%
晗	4432		11	1	0.000151%	661584	99.93%	1	0.21%
晾	4433		12	1	0.000151%	661585	99.93%	1	0.21%
暄	4434		13	1	0.000151%	661586	99.93%	1	0.21%
曖	4435		17	1	0.000151%	661587	99.93%	1	0.21%
曚	4436		18	1	0.000151%	661588	99.93%	1	0.21%
曣	4437		20	1	0.000151%	661589	99.93%	1	0.21%
脉	4438		9	1	0.000151%	661590	99.93%	1	0.21%
朕	4439		10	1	0.000151%	661591	99.93%	1	0.21%
朓	4440		10	1	0.000151%	661592	99.93%	1	0.21%
脷	4441		11	1	0.000151%	661593	99.93%	1	0.21%
杇	4442		7	1	0.000151%	661594	99.93%	1	0.21%
杈	4443		7	1	0.000151%	661595	99.93%	1	0.21%
杷	4444		8	1	0.000151%	661596	99.93%	1	0.21%
杼	4445		8	1	0.000151%	661597	99.93%	1	0.21%
杪	4446		8	1	0.000151%	661598	99.93%	1	0.21%
枒	4447		8	1	0.000151%	661599	99.93%	1	0.21%
柩	4448		9	1	0.000151%	661600	99.93%	1	0.21%
柑	4449		9	1	0.000151%	661601	99.93%	1	0.21%
柞	4450		9	1	0.000151%	661602	99.93%	1	0.21%
栢	4451		10	1	0.000151%	661603	99.93%	1	0.21%
桅	4452		10	1	0.000151%	661604	99.93%	1	0.21%
梆	4453		11	1	0.000151%	661605	99.93%	1	0.21%
梔	4454		11	1	0.000151%	661606	99.93%	1	0.21%
椎	4455		12	1	0.000151%	661607	99.93%	1	0.21%
棎	4456		12	1	0.000151%	661608	99.93%	1	0.21%
楨	4457		13	1	0.000151%	661609	99.93%	1	0.21%
楝	4458		13	1	0.000151%	661610	99.93%	1	0.21%
楣	4459		13	1	0.000151%	661611	99.93%	1	0.21%
椽	4460		13	1	0.000151%	661612	99.93%	1	0.21%
榛	4461		14	1	0.000151%	661613	99.93%	1	0.21%
槃	4462		14	1	0.000151%	661614	99.93%	1	0.21%
樅	4463		15	1	0.000151%	661615	99.93%	1	0.21%
樺	4464		16	1	0.000151%	661616	99.93%	1	0.21%
樵	4465		16	1	0.000151%	661617	99.93%	1	0.21%
檄	4466		17	1	0.000151%	661618	99.94%	1	0.21%
櫓	4467		19	1	0.000151%	661619	99.94%	1	0.21%
櫫	4468		19	1	0.000151%	661620	99.94%	1	0.21%
櫪	4469		20	1	0.000151%	661621	99.94%	1	0.21%
櫸	4470		21	1	0.000151%	661622	99.94%	1	0.21%
欬	4471		10	1	0.000151%	661623	99.94%	1	0.21%
欹	4472		12	1	0.000151%	661624	99.94%	1	0.21%
歙	4473		16	1	0.000151%	661625	99.94%	1	0.21%
歟	4474		18	1	0.000151%	661626	99.94%	1	0.21%
歿	4475		8	1	0.000151%	661627	99.94%	1	0.21%
殍	4476		11	1	0.000151%	661628	99.94%	1	0.21%
殞	4477		14	1	0.000151%	661629	99.94%	1	0.21%
殯	4478		18	1	0.000151%	661630	99.94%	1	0.21%
殽	4479		12	1	0.000151%	661631	99.94%	1	0.21%
毘	4480		9	1	0.000151%	661632	99.94%	1	0.21%
毬	4481		11	1	0.000151%	661633	99.94%	1	0.21%
毽	4482		13	1	0.000151%	661634	99.94%	1	0.21%
氖	4483		6	1	0.000151%	661635	99.94%	1	0.21%
氡	4484		9	1	0.000151%	661636	99.94%	1	0.21%
氤	4485		10	1	0.000151%	661637	99.94%	1	0.21%
汛	4486		6	1	0.000151%	661638	99.94%	1	0.21%
汔	4487		6	1	0.000151%	661639	99.94%	1	0.21%
汞	4488		7	1	0.000151%	661640	99.94%	1	0.21%
汾	4489		7	1	0.000151%	661641	99.94%	1	0.21%
沆	4490		7	1	0.000151%	661642	99.94%	1	0.21%
泌	4491		8	1	0.000151%	661643	99.94%	1	0.21%
泓	4492		8	1	0.000151%	661644	99.94%	1	0.21%
泄	4493		8	1	0.000151%	661645	99.94%	1	0.21%
泅	4494		8	1	0.000151%	661646	99.94%	1	0.21%
泮	4495		8	1	0.000151%	661647	99.94%	1	0.21%
浹	4496		10	1	0.000151%	661648	99.94%	1	0.21%
浣	4497		10	1	0.000151%	661649	99.94%	1	0.21%
淞	4498		11	1	0.000151%	661650	99.94%	1	0.21%
淀	4499		11	1	0.000151%	661651	99.94%	1	0.21%
淩	4500		11	1	0.000151%	661652	99.94%	1	0.21%
渝	4501		12	1	0.000151%	661653	99.94%	1	0.21%
湎	4502		12	1	0.000151%	661654	99.94%	1	0.21%
湫	4503		12	1	0.000151%	661655	99.94%	1	0.21%
湤	4504		12	1	0.000151%	661656	99.94%	1	0.21%
溲	4505		12	1	0.000151%	661657	99.94%	1	0.21%
溛	4506		13	1	0.000151%	661658	99.94%	1	0.21%
溏	4507		13	1	0.000151%	661659	99.94%	1	0.21%
漥	4508		14	1	0.000151%	661660	99.94%	1	0.21%
滸	4509		14	1	0.000151%	661661	99.94%	1	0.21%
滻	4510		14	1	0.000151%	661662	99.94%	1	0.21%
潸	4511		15	1	0.000151%	661663	99.94%	1	0.21%
滕	4512		15	1	0.000151%	661664	99.94%	1	0.21%
潯	4513		15	1	0.000151%	661665	99.94%	1	0.21%
濂	4514		16	1	0.000151%	661666	99.94%	1	0.21%
澱	4515		16	1	0.000151%	661667	99.94%	1	0.21%
潞	4516		16	1	0.000151%	661668	99.94%	1	0.21%
瀣	4517		19	1	0.000151%	661669	99.94%	1	0.21%
瀹	4518		20	1	0.000151%	661670	99.94%	1	0.21%
灯	4519		6	1	0.000151%	661671	99.94%	1	0.21%
炓	4520		8	1	0.000151%	661672	99.94%	1	0.21%
烽	4521		11	1	0.000151%	661673	99.94%	1	0.21%
焗	4522		11	1	0.000151%	661674	99.94%	1	0.21%
煊	4523		13	1	0.000151%	661675	99.94%	1	0.21%
煢	4524		13	1	0.000151%	661676	99.94%	1	0.21%
煲	4525		13	1	0.000151%	661677	99.94%	1	0.21%
燊	4526		16	1	0.000151%	661678	99.94%	1	0.21%
燴	4527		17	1	0.000151%	661679	99.94%	1	0.21%
燻	4528		18	1	0.000151%	661680	99.94%	1	0.21%
牴	4529		9	1	0.000151%	661681	99.94%	1	0.21%
犄	4530		12	1	0.000151%	661682	99.94%	1	0.21%
狙	4531		8	1	0.000151%	661683	99.94%	1	0.21%
猙	4532		11	1	0.000151%	661684	99.95%	1	0.21%
猊	4533		11	1	0.000151%	661685	99.95%	1	0.21%
獒	4534		15	1	0.000151%	661686	99.95%	1	0.21%
獠	4535		15	1	0.000151%	661687	99.95%	1	0.21%
獾	4536		21	1	0.000151%	661688	99.95%	1	0.21%
珥	4537		10	1	0.000151%	661689	99.95%	1	0.21%
琅	4538		11	1	0.000151%	661690	99.95%	1	0.21%
琼	4539		12	1	0.000151%	661691	99.95%	1	0.21%
琛	4540		12	1	0.000151%	661692	99.95%	1	0.21%
琬	4541		12	1	0.000151%	661693	99.95%	1	0.21%
瑕	4542		13	1	0.000151%	661694	99.95%	1	0.21%
瑜	4543		13	1	0.000151%	661695	99.95%	1	0.21%
甄	4544		14	1	0.000151%	661696	99.95%	1	0.21%
甌	4545		16	1	0.000151%	661697	99.95%	1	0.21%
甍	4546		16	1	0.000151%	661698	99.95%	1	0.21%
甑	4547		17	1	0.000151%	661699	99.95%	1	0.21%
甬	4548		7	1	0.000151%	661700	99.95%	1	0.21%
疣	4549		9	1	0.000151%	661701	99.95%	1	0.21%
疹	4550		10	1	0.000151%	661702	99.95%	1	0.21%
疵	4551		11	1	0.000151%	661703	99.95%	1	0.21%
痞	4552		12	1	0.000151%	661704	99.95%	1	0.21%
痠	4553		12	1	0.000151%	661705	99.95%	1	0.21%
瘧	4554		14	1	0.000151%	661706	99.95%	1	0.21%
瘖	4555		14	1	0.000151%	661707	99.95%	1	0.21%
瘼	4556		16	1	0.000151%	661708	99.95%	1	0.21%
癆	4557		17	1	0.000151%	661709	99.95%	1	0.21%
癇	4558		17	1	0.000151%	661710	99.95%	1	0.21%
盔	4559		11	1	0.000151%	661711	99.95%	1	0.21%
盱	4560		8	1	0.000151%	661712	99.95%	1	0.21%
眯	4561		11	1	0.000151%	661713	99.95%	1	0.21%
睇	4562		12	1	0.000151%	661714	99.95%	1	0.21%
睢	4563		13	1	0.000151%	661715	99.95%	1	0.21%
瞄	4564		14	1	0.000151%	661716	99.95%	1	0.21%
睿	4565		14	1	0.000151%	661717	99.95%	1	0.21%
瞑	4566		15	1	0.000151%	661718	99.95%	1	0.21%
瞠	4567		16	1	0.000151%	661719	99.95%	1	0.21%
矼	4568		8	1	0.000151%	661720	99.95%	1	0.21%
砑	4569		9	1	0.000151%	661721	99.95%	1	0.21%
砸	4570		10	1	0.000151%	661722	99.95%	1	0.21%
砥	4571		10	1	0.000151%	661723	99.95%	1	0.21%
砭	4572		10	1	0.000151%	661724	99.95%	1	0.21%
硅	4573		11	1	0.000151%	661725	99.95%	1	0.21%
硯	4574		12	1	0.000151%	661726	99.95%	1	0.21%
硤	4575		12	1	0.000151%	661727	99.95%	1	0.21%
硨	4576		12	1	0.000151%	661728	99.95%	1	0.21%
碓	4577		13	1	0.000151%	661729	99.95%	1	0.21%
碁	4578		13	1	0.000151%	661730	99.95%	1	0.21%
碣	4579		14	1	0.000151%	661731	99.95%	1	0.21%
碾	4580		15	1	0.000151%	661732	99.95%	1	0.21%
磕	4581		15	1	0.000151%	661733	99.95%	1	0.21%
磲	4582		17	1	0.000151%	661734	99.95%	1	0.21%
祉	4583		8	1	0.000151%	661735	99.95%	1	0.21%
祕	4584		9	1	0.000151%	661736	99.95%	1	0.21%
祛	4585		9	1	0.000151%	661737	99.95%	1	0.21%
禎	4586		13	1	0.000151%	661738	99.95%	1	0.21%
禊	4587		13	1	0.000151%	661739	99.95%	1	0.21%
秣	4588		10	1	0.000151%	661740	99.95%	1	0.21%
稈	4589		12	1	0.000151%	661741	99.95%	1	0.21%
稟	4590		13	1	0.000151%	661742	99.95%	1	0.21%
竅	4591		18	1	0.000151%	661743	99.95%	1	0.21%
竺	4592		8	1	0.000151%	661744	99.95%	1	0.21%
竽	4593		9	1	0.000151%	661745	99.95%	1	0.21%
笈	4594		10	1	0.000151%	661746	99.95%	1	0.21%
笳	4595		11	1	0.000151%	661747	99.95%	1	0.21%
筍	4596		12	1	0.000151%	661748	99.95%	1	0.21%
筏	4597		12	1	0.000151%	661749	99.95%	1	0.21%
筱	4598		13	1	0.000151%	661750	99.95%	1	0.21%
箔	4599		14	1	0.000151%	661751	99.96%	1	0.21%
篆	4600		15	1	0.000151%	661752	99.96%	1	0.21%
簑	4601		16	1	0.000151%	661753	99.96%	1	0.21%
篾	4602		17	1	0.000151%	661754	99.96%	1	0.21%
簧	4603		18	1	0.000151%	661755	99.96%	1	0.21%
簪	4604		18	1	0.000151%	661756	99.96%	1	0.21%
簟	4605		18	1	0.000151%	661757	99.96%	1	0.21%
籤	4606		23	1	0.000151%	661758	99.96%	1	0.21%
籣	4607		23	1	0.000151%	661759	99.96%	1	0.21%
粥	4608		12	1	0.000151%	661760	99.96%	1	0.21%
粳	4609		13	1	0.000151%	661761	99.96%	1	0.21%
糈	4610		15	1	0.000151%	661762	99.96%	1	0.21%
糠	4611		17	1	0.000151%	661763	99.96%	1	0.21%
糜	4612		17	1	0.000151%	661764	99.96%	1	0.21%
紉	4613		9	1	0.000151%	661765	99.96%	1	0.21%
紇	4614		9	1	0.000151%	661766	99.96%	1	0.21%
紝	4615		10	1	0.000151%	661767	99.96%	1	0.21%
絀	4616		11	1	0.000151%	661768	99.96%	1	0.21%
綉	4617		13	1	0.000151%	661769	99.96%	1	0.21%
絹	4618		13	1	0.000151%	661770	99.96%	1	0.21%
綸	4619		14	1	0.000151%	661771	99.96%	1	0.21%
綹	4620		14	1	0.000151%	661772	99.96%	1	0.21%
綦	4621		14	1	0.000151%	661773	99.96%	1	0.21%
縊	4622		16	1	0.000151%	661774	99.96%	1	0.21%
縟	4623		16	1	0.000151%	661775	99.96%	1	0.21%
縲	4624		17	1	0.000151%	661776	99.96%	1	0.21%
繅	4625		17	1	0.000151%	661777	99.96%	1	0.21%
縴	4626		17	1	0.000151%	661778	99.96%	1	0.21%
縳	4627		17	1	0.000151%	661779	99.96%	1	0.21%
繕	4628		18	1	0.000151%	661780	99.96%	1	0.21%
纂	4629		20	1	0.000151%	661781	99.96%	1	0.21%
纙	4630		25	1	0.000151%	661782	99.96%	1	0.21%
罝	4631		10	1	0.000151%	661783	99.96%	1	0.21%
罹	4632		16	1	0.000151%	661784	99.96%	1	0.21%
罻	4633		16	1	0.000151%	661785	99.96%	1	0.21%
羌	4634		8	1	0.000151%	661786	99.96%	1	0.21%
聒	4635		12	1	0.000151%	661787	99.96%	1	0.21%
聶	4636		18	1	0.000151%	661788	99.96%	1	0.21%
聿	4637		6	1	0.000151%	661789	99.96%	1	0.21%
肓	4638		7	1	0.000151%	661790	99.96%	1	0.21%
胄	4639		9	1	0.000151%	661791	99.96%	1	0.21%
胭	4640		10	1	0.000151%	661792	99.96%	1	0.21%
腮	4641		13	1	0.000151%	661793	99.96%	1	0.21%
腺	4642		13	1	0.000151%	661794	99.96%	1	0.21%
腩	4643		13	1	0.000151%	661795	99.96%	1	0.21%
膞	4644		15	1	0.000151%	661796	99.96%	1	0.21%
臃	4645		17	1	0.000151%	661797	99.96%	1	0.21%
膾	4646		17	1	0.000151%	661798	99.96%	1	0.21%
臚	4647		20	1	0.000151%	661799	99.96%	1	0.21%
臧	4648		14	1	0.000151%	661800	99.96%	1	0.21%
臾	4649		8	1	0.000151%	661801	99.96%	1	0.21%
舛	4650		6	1	0.000151%	661802	99.96%	1	0.21%
舫	4651		10	1	0.000151%	661803	99.96%	1	0.21%
舷	4652		11	1	0.000151%	661804	99.96%	1	0.21%
艙	4653		16	1	0.000151%	661805	99.96%	1	0.21%
艟	4654		18	1	0.000151%	661806	99.96%	1	0.21%
艨	4655		20	1	0.000151%	661807	99.96%	1	0.21%
芋	4656		7	1	0.000151%	661808	99.96%	1	0.21%
芎	4657		7	1	0.000151%	661809	99.96%	1	0.21%
芃	4658		7	1	0.000151%	661810	99.96%	1	0.21%
芪	4659		8	1	0.000151%	661811	99.96%	1	0.21%
芥	4660		8	1	0.000151%	661812	99.96%	1	0.21%
芾	4661		8	1	0.000151%	661813	99.96%	1	0.21%
苧	4662		9	1	0.000151%	661814	99.96%	1	0.21%
苣	4663		9	1	0.000151%	661815	99.96%	1	0.21%
茍	4664		9	1	0.000151%	661816	99.96%	1	0.21%
茜	4665		10	1	0.000151%	661817	99.97%	1	0.21%
莒	4666		11	1	0.000151%	661818	99.97%	1	0.21%
荻	4667		11	1	0.000151%	661819	99.97%	1	0.21%
荼	4668		11	1	0.000151%	661820	99.97%	1	0.21%
莨	4669		11	1	0.000151%	661821	99.97%	1	0.21%
荳	4670		11	1	0.000151%	661822	99.97%	1	0.21%
菸	4671		12	1	0.000151%	661823	99.97%	1	0.21%
菠	4672		12	1	0.000151%	661824	99.97%	1	0.21%
萋	4673		12	1	0.000151%	661825	99.97%	1	0.21%
萵	4674		13	1	0.000151%	661826	99.97%	1	0.21%
葸	4675		13	1	0.000151%	661827	99.97%	1	0.21%
蓁	4676		14	1	0.000151%	661828	99.97%	1	0.21%
蔔	4677		15	1	0.000151%	661829	99.97%	1	0.21%
蔻	4678		15	1	0.000151%	661830	99.97%	1	0.21%
蔞	4679		15	1	0.000151%	661831	99.97%	1	0.21%
蕈	4680		16	1	0.000151%	661832	99.97%	1	0.21%
蕨	4681		16	1	0.000151%	661833	99.97%	1	0.21%
蕘	4682		16	1	0.000151%	661834	99.97%	1	0.21%
薑	4683		17	1	0.000151%	661835	99.97%	1	0.21%
薀	4684		17	1	0.000151%	661836	99.97%	1	0.21%
薤	4685		17	1	0.000151%	661837	99.97%	1	0.21%
薦	4686		18	1	0.000151%	661838	99.97%	1	0.21%
藜	4687		19	1	0.000151%	661839	99.97%	1	0.21%
蚌	4688		10	1	0.000151%	661840	99.97%	1	0.21%
蚧	4689		10	1	0.000151%	661841	99.97%	1	0.21%
蚱	4690		11	1	0.000151%	661842	99.97%	1	0.21%
蛩	4691		12	1	0.000151%	661843	99.97%	1	0.21%
蜓	4692		13	1	0.000151%	661844	99.97%	1	0.21%
蜃	4693		13	1	0.000151%	661845	99.97%	1	0.21%
蜥	4694		14	1	0.000151%	661846	99.97%	1	0.21%
蜮	4695		14	1	0.000151%	661847	99.97%	1	0.21%
蜚	4696		14	1	0.000151%	661848	99.97%	1	0.21%
蝠	4697		15	1	0.000151%	661849	99.97%	1	0.21%
蝸	4698		15	1	0.000151%	661850	99.97%	1	0.21%
蝙	4699		15	1	0.000151%	661851	99.97%	1	0.21%
螃	4700		16	1	0.000151%	661852	99.97%	1	0.21%
蟄	4701		17	1	0.000151%	661853	99.97%	1	0.21%
螽	4702		17	1	0.000151%	661854	99.97%	1	0.21%
蟾	4703		19	1	0.000151%	661855	99.97%	1	0.21%
衲	4704		9	1	0.000151%	661856	99.97%	1	0.21%
袒	4705		10	1	0.000151%	661857	99.97%	1	0.21%
褓	4706		14	1	0.000151%	661858	99.97%	1	0.21%
褟	4707		15	1	0.000151%	661859	99.97%	1	0.21%
襁	4708		16	1	0.000151%	661860	99.97%	1	0.21%
褻	4709		17	1	0.000151%	661861	99.97%	1	0.21%
襌	4710		17	1	0.000151%	661862	99.97%	1	0.21%
襖	4711		18	1	0.000151%	661863	99.97%	1	0.21%
襾	4712		6	1	0.000151%	661864	99.97%	1	0.21%
覈	4713		19	1	0.000151%	661865	99.97%	1	0.21%
覯	4714		17	1	0.000151%	661866	99.97%	1	0.21%
覷	4715		19	1	0.000151%	661867	99.97%	1	0.21%
訃	4716		9	1	0.000151%	661868	99.97%	1	0.21%
訏	4717		10	1	0.000151%	661869	99.97%	1	0.21%
訟	4718		11	1	0.000151%	661870	99.97%	1	0.21%
訧	4719		11	1	0.000151%	661871	99.97%	1	0.21%
詁	4720		12	1	0.000151%	661872	99.97%	1	0.21%
詆	4721		12	1	0.000151%	661873	99.97%	1	0.21%
詖	4722		12	1	0.000151%	661874	99.97%	1	0.21%
詘	4723		12	1	0.000151%	661875	99.97%	1	0.21%
詮	4724		13	1	0.000151%	661876	99.97%	1	0.21%
詡	4725		13	1	0.000151%	661877	99.97%	1	0.21%
誣	4726		14	1	0.000151%	661878	99.97%	1	0.21%
諉	4727		15	1	0.000151%	661879	99.97%	1	0.21%
誹	4728		15	1	0.000151%	661880	99.97%	1	0.21%
謁	4729		16	1	0.000151%	661881	99.97%	1	0.21%
謗	4730		17	1	0.000151%	661882	99.97%	1	0.21%
謄	4731		17	1	0.000151%	661883	99.98%	1	0.21%
謦	4732		18	1	0.000151%	661884	99.98%	1	0.21%
譚	4733		19	1	0.000151%	661885	99.98%	1	0.21%
譎	4734		19	1	0.000151%	661886	99.98%	1	0.21%
譭	4735		20	1	0.000151%	661887	99.98%	1	0.21%
譅	4736		21	1	0.000151%	661888	99.98%	1	0.21%
譾	4737		22	1	0.000151%	661889	99.98%	1	0.21%
讕	4738		24	1	0.000151%	661890	99.98%	1	0.21%
豉	4739		11	1	0.000151%	661891	99.98%	1	0.21%
豕	4740		7	1	0.000151%	661892	99.98%	1	0.21%
豚	4741		11	1	0.000151%	661893	99.98%	1	0.21%
豳	4742		17	1	0.000151%	661894	99.98%	1	0.21%
豺	4743		10	1	0.000151%	661895	99.98%	1	0.21%
賁	4744		12	1	0.000151%	661896	99.98%	1	0.21%
賻	4745		17	1	0.000151%	661897	99.98%	1	0.21%
趟	4746		15	1	0.000151%	661898	99.98%	1	0.21%
趴	4747		9	1	0.000151%	661899	99.98%	1	0.21%
跣	4748		13	1	0.000151%	661900	99.98%	1	0.21%
跫	4749		13	1	0.000151%	661901	99.98%	1	0.21%
踟	4750		15	1	0.000151%	661902	99.98%	1	0.21%
踮	4751		15	1	0.000151%	661903	99.98%	1	0.21%
蹂	4752		16	1	0.000151%	661904	99.98%	1	0.21%
蹊	4753		17	1	0.000151%	661905	99.98%	1	0.21%
蹚	4754		18	1	0.000151%	661906	99.98%	1	0.21%
蹩	4755		18	1	0.000151%	661907	99.98%	1	0.21%
蹼	4756		19	1	0.000151%	661908	99.98%	1	0.21%
躋	4757		21	1	0.000151%	661909	99.98%	1	0.21%
躕	4758		22	1	0.000151%	661910	99.98%	1	0.21%
躪	4759		27	1	0.000151%	661911	99.98%	1	0.21%
軏	4760		10	1	0.000151%	661912	99.98%	1	0.21%
軼	4761		12	1	0.000151%	661913	99.98%	1	0.21%
輊	4762		13	1	0.000151%	661914	99.98%	1	0.21%
轂	4763		17	1	0.000151%	661915	99.98%	1	0.21%
轎	4764		19	1	0.000151%	661916	99.98%	1	0.21%
迤	4765		8	1	0.000151%	661917	99.98%	1	0.21%
逑	4766		10	1	0.000151%	661918	99.98%	1	0.21%
遴	4767		15	1	0.000151%	661919	99.98%	1	0.21%
邈	4768		17	1	0.000151%	661920	99.98%	1	0.21%
邐	4769		22	1	0.000151%	661921	99.98%	1	0.21%
邯	4770		7	1	0.000151%	661922	99.98%	1	0.21%
郅	4771		8	1	0.000151%	661923	99.98%	1	0.21%
鄱	4772		14	1	0.000151%	661924	99.98%	1	0.21%
鄲	4773		14	1	0.000151%	661925	99.98%	1	0.21%
酥	4774		12	1	0.000151%	661926	99.98%	1	0.21%
酢	4775		12	1	0.000151%	661927	99.98%	1	0.21%
醃	4776		15	1	0.000151%	661928	99.98%	1	0.21%
醐	4777		16	1	0.000151%	661929	99.98%	1	0.21%
醍	4778		16	1	0.000151%	661930	99.98%	1	0.21%
醣	4779		17	1	0.000151%	661931	99.98%	1	0.21%
醱	4780		19	1	0.000151%	661932	99.98%	1	0.21%
醮	4781		19	1	0.000151%	661933	99.98%	1	0.21%
釵	4782		11	1	0.000151%	661934	99.98%	1	0.21%
釷	4783		11	1	0.000151%	661935	99.98%	1	0.21%
鈦	4784		12	1	0.000151%	661936	99.98%	1	0.21%
鉄	4785		13	1	0.000151%	661937	99.98%	1	0.21%
鈳	4786		13	1	0.000151%	661938	99.98%	1	0.21%
鉧	4787		13	1	0.000151%	661939	99.98%	1	0.21%
鉲	4788		13	1	0.000151%	661940	99.98%	1	0.21%
銹	4789		15	1	0.000151%	661941	99.98%	1	0.21%
錠	4790		16	1	0.000151%	661942	99.98%	1	0.21%
鍺	4791		16	1	0.000151%	661943	99.98%	1	0.21%
錼	4792		16	1	0.000151%	661944	99.98%	1	0.21%
錩	4793		16	1	0.000151%	661945	99.98%	1	0.21%
錨	4794		17	1	0.000151%	661946	99.98%	1	0.21%
鍬	4795		17	1	0.000151%	661947	99.98%	1	0.21%
鍼	4796		17	1	0.000151%	661948	99.98%	1	0.21%
鎬	4797		18	1	0.000151%	661949	99.99%	1	0.21%
鎗	4798		18	1	0.000151%	661950	99.99%	1	0.21%
鏟	4799		19	1	0.000151%	661951	99.99%	1	0.21%
鏃	4800		19	1	0.000151%	661952	99.99%	1	0.21%
鏘	4801		19	1	0.000151%	661953	99.99%	1	0.21%
鏤	4802		19	1	0.000151%	661954	99.99%	1	0.21%
鐃	4803		20	1	0.000151%	661955	99.99%	1	0.21%
閔	4804		12	1	0.000151%	661956	99.99%	1	0.21%
閏	4805		12	1	0.000151%	661957	99.99%	1	0.21%
閞	4806		13	1	0.000151%	661958	99.99%	1	0.21%
閭	4807		15	1	0.000151%	661959	99.99%	1	0.21%
閻	4808		16	1	0.000151%	661960	99.99%	1	0.21%
闍	4809		16	1	0.000151%	661961	99.99%	1	0.21%
闋	4810		17	1	0.000151%	661962	99.99%	1	0.21%
闔	4811		18	1	0.000151%	661963	99.99%	1	0.21%
闐	4812		18	1	0.000151%	661964	99.99%	1	0.21%
陂	4813		7	1	0.000151%	661965	99.99%	1	0.21%
陞	4814		9	1	0.000151%	661966	99.99%	1	0.21%
陜	4815		9	1	0.000151%	661967	99.99%	1	0.21%
陟	4816		9	1	0.000151%	661968	99.99%	1	0.21%
隍	4817		11	1	0.000151%	661969	99.99%	1	0.21%
雹	4818		13	1	0.000151%	661970	99.99%	1	0.21%
霽	4819		22	1	0.000151%	661971	99.99%	1	0.21%
靭	4820		12	1	0.000151%	661972	99.99%	1	0.21%
靶	4821		13	1	0.000151%	661973	99.99%	1	0.21%
鞘	4822		16	1	0.000151%	661974	99.99%	1	0.21%
韃	4823		22	1	0.000151%	661975	99.99%	1	0.21%
頡	4824		15	1	0.000151%	661976	99.99%	1	0.21%
顴	4825		26	1	0.000151%	661977	99.99%	1	0.21%
餔	4826		15	1	0.000151%	661978	99.99%	1	0.21%
餡	4827		16	1	0.000151%	661979	99.99%	1	0.21%
餾	4828		18	1	0.000151%	661980	99.99%	1	0.21%
餼	4829		18	1	0.000151%	661981	99.99%	1	0.21%
饅	4830		19	1	0.000151%	661982	99.99%	1	0.21%
饈	4831		19	1	0.000151%	661983	99.99%	1	0.21%
饃	4832		19	1	0.000151%	661984	99.99%	1	0.21%
饋	4833		20	1	0.000151%	661985	99.99%	1	0.21%
饜	4834		23	1	0.000151%	661986	99.99%	1	0.21%
馥	4835		18	1	0.000151%	661987	99.99%	1	0.21%
馭	4836		12	1	0.000151%	661988	99.99%	1	0.21%
馱	4837		13	1	0.000151%	661989	99.99%	1	0.21%
骶	4838		15	1	0.000151%	661990	99.99%	1	0.21%
骷	4839		15	1	0.000151%	661991	99.99%	1	0.21%
骼	4840		16	1	0.000151%	661992	99.99%	1	0.21%
髀	4841		18	1	0.000151%	661993	99.99%	1	0.21%
髏	4842		21	1	0.000151%	661994	99.99%	1	0.21%
髯	4843		15	1	0.000151%	661995	99.99%	1	0.21%
髲	4844		15	1	0.000151%	661996	99.99%	1	0.21%
髭	4845		16	1	0.000151%	661997	99.99%	1	0.21%
髹	4846		16	1	0.000151%	661998	99.99%	1	0.21%
鬈	4847		18	1	0.000151%	661999	99.99%	1	0.21%
鬞	4848		22	1	0.000151%	662000	99.99%	1	0.21%
魁	4849		14	1	0.000151%	662001	99.99%	1	0.21%
魘	4850		24	1	0.000151%	662002	99.99%	1	0.21%
鯽	4851		18	1	0.000151%	662003	99.99%	1	0.21%
鯁	4852		18	1	0.000151%	662004	99.99%	1	0.21%
鯪	4853		19	1	0.000151%	662005	99.99%	1	0.21%
鰂	4854		20	1	0.000151%	662006	99.99%	1	0.21%
鱈	4855		22	1	0.000151%	662007	99.99%	1	0.21%
鳩	4856		13	1	0.000151%	662008	99.99%	1	0.21%
鴕	4857		16	1	0.000151%	662009	99.99%	1	0.21%
鴣	4858		16	1	0.000151%	662010	99.99%	1	0.21%
鴦	4859		16	1	0.000151%	662011	99.99%	1	0.21%
鴛	4860		16	1	0.000151%	662012	99.99%	1	0.21%
鶿	4861		20	1	0.000151%	662013	99.99%	1	0.21%
鷓	4862		22	1	0.000151%	662014	99.99%	1	0.21%
鷺	4863		24	1	0.000151%	662015	99.9999999999%	1	0.21%
鹼	4864		24	1	0.000151%	662016	99.9999999999%	1	0.21%
麇	4865		16	1	0.000151%	662017	99.9999999999%	1	0.21%
麋	4866		17	1	0.000151%	662018	99.9999999999%	1	0.21%
麴	4867		19	1	0.000151%	662019	99.9999999999%	1	0.21%
黌	4868		25	1	0.000151%	662020	99.9999999999%	1	0.21%
黜	4869		17	1	0.000151%	662021	99.9999999999%	1	0.21%
黴	4870		23	1	0.000151%	662022	99.9999999999%	1	0.21%
黽	4871		13	1	0.000151%	662023	99.9999999999%	1	0.21%
鼙	4872		21	1	0.000151%	662024	99.9999999999%	1	0.21%
齎	4873		21	1	0.000151%	662025	99.9999999999%	1	0.21%
齧	4874		21	1	0.000151%	662026	99.9999999999%	1	0.21%
齪	4875		22	1	0.000151%	662027	99.9999999999%	1	0.21%
齷	4876		24	1	0.000151%	662028	99.9999999999%	1	0.21%
