單字	序號	部首	筆劃	頻次	頻率	累積頻次	累積頻率	見檔次	見檔率
的	1		8	29274	4.422%	29274	4.422%	467	97.70%
一	2		1	11235	1.697%	40509	6.119%	460	96.23%
在	6		6	7026	1.061%	47535	10.87%	457	95.61%
不	4		4	7637	1.154%	55172	8.719%	451	94.35%
有	5		6	7203	1.088%	62375	9.807%	447	93.51%
人	7		2	6537	0.9874%	68912	11.86%	446	93.31%
是	3		9	9579	1.447%	78491	7.566%	441	92.26%
上	15		3	3714	0.561%	82205	17.41%	430	89.96%
了	9		2	6006	0.9072%	88211	13.74%	427	89.33%
為	13		9	3941	0.5953%	92152	16.28%	427	89.33%
大	12		3	3973	0.6001%	96125	15.69%	423	88.49%
地	21		6	3246	0.4903%	99371	20.51%	422	88.28%
中	16		4	3663	0.5533%	103034	17.96%	421	88.08%
來	17		8	3462	0.5229%	106496	18.48%	421	88.08%
時	22		10	3130	0.4728%	109626	20.98%	409	85.56%
到	25		8	3045	0.4599%	112671	22.36%	405	84.73%
可	29		5	2754	0.416%	115425	24.10%	404	84.52%
而	26		6	2975	0.4494%	118400	22.81%	403	84.31%
多	34		6	2260	0.3414%	120660	25.90%	401	83.89%
出	38		5	2145	0.324%	122805	27.24%	401	83.89%
生	28		5	2863	0.4324%	125668	23.68%	399	83.47%
這	10		10	4593	0.6938%	130261	14.43%	398	83.26%
以	14		5	3733	0.5639%	133994	16.85%	398	83.26%
會	19		13	3364	0.5081%	137358	19.51%	398	83.26%
過	46		12	1990	0.3006%	139348	29.73%	397	83.05%
得	36		11	2211	0.334%	141559	26.58%	395	82.64%
個	20		10	3350	0.506%	144909	20.02%	391	81.80%
於	31		8	2431	0.3672%	147340	24.84%	390	81.59%
要	32		9	2408	0.3637%	149748	25.20%	389	81.38%
之	11		4	4332	0.6543%	154080	15.09%	386	80.75%
下	49		3	1950	0.2945%	156030	30.62%	386	80.75%
去	57		5	1708	0.258%	157738	32.80%	385	80.54%
然	51		12	1900	0.287%	159638	31.20%	383	80.13%
們	18		10	3430	0.5181%	163068	19.00%	382	79.92%
如	54		6	1761	0.266%	164829	32.01%	379	79.29%
前	80		9	1445	0.2183%	166274	38.17%	377	78.87%
成	56		6	1734	0.2619%	168008	32.54%	374	78.24%
年	23		6	3078	0.4649%	171086	21.44%	372	77.82%
無	73		12	1481	0.2237%	172567	36.62%	372	77.82%
我	8		7	6460	0.9758%	179027	12.83%	371	77.62%
已	98		3	1250	0.1888%	180277	41.78%	369	77.20%
能	37		10	2210	0.3338%	182487	26.91%	368	76.99%
心	63		4	1614	0.2438%	184101	34.29%	368	76.99%
也	30		3	2486	0.3755%	186587	24.47%	366	76.57%
天	48		4	1962	0.2964%	188549	30.32%	366	76.57%
起	92		10	1276	0.1927%	189825	40.64%	366	76.57%
但	60		7	1658	0.2504%	191483	33.56%	365	76.36%
自	45		6	1997	0.3016%	193480	29.43%	363	75.94%
對	52		14	1846	0.2788%	195326	31.48%	363	75.94%
後	65		9	1583	0.2391%	196909	34.78%	363	75.94%
所	39		8	2132	0.322%	199041	27.56%	362	75.73%
面	72		9	1490	0.2251%	200531	36.40%	360	75.31%
他	24		5	3054	0.4613%	203585	21.90%	359	75.10%
方	59		4	1670	0.2522%	205255	33.31%	359	75.10%
發	61		12	1649	0.2491%	206904	33.80%	356	74.48%
當	79		13	1462	0.2208%	208366	37.96%	354	74.06%
就	40		12	2129	0.3216%	210495	27.88%	352	73.64%
經	71		13	1500	0.2266%	211995	36.18%	352	73.64%
現	75		11	1471	0.2222%	213466	37.07%	352	73.64%
都	68		9	1555	0.2349%	215021	35.49%	350	73.22%
此	84		6	1417	0.214%	216438	39.03%	346	72.38%
那	33		6	2377	0.359%	218815	25.56%	344	71.97%
事	78		8	1464	0.2211%	220279	37.73%	343	71.76%
開	127		12	1083	0.1636%	221362	46.79%	340	71.13%
和	35		8	2253	0.3403%	223615	26.24%	339	70.92%
又	108		2	1157	0.1748%	224772	43.60%	339	70.92%
情	116		11	1113	0.1681%	225885	44.96%	338	70.71%
行	69		6	1542	0.2329%	227427	35.72%	335	70.08%
外	94		5	1262	0.1906%	228689	41.03%	333	69.67%
說	43		14	2045	0.3089%	230734	28.82%	332	69.46%
其	55		8	1754	0.2649%	232488	32.28%	331	69.25%
作	62		7	1625	0.2455%	234113	34.05%	331	69.25%
因	85		6	1400	0.2115%	235513	39.25%	331	69.25%
日	87		4	1347	0.2035%	236860	39.65%	331	69.25%
十	50		2	1948	0.2942%	238808	30.91%	329	68.83%
道	83		12	1423	0.2149%	240231	38.82%	329	68.83%
實	95		14	1258	0.190%	241489	41.22%	328	68.62%
家	44		10	2024	0.3057%	243513	29.13%	326	68.20%
從	114		11	1115	0.1684%	244628	44.62%	326	68.20%
種	67		14	1566	0.2365%	246194	35.25%	324	67.78%
使	123		8	1104	0.1668%	247298	46.13%	324	67.78%
用	70		5	1527	0.2306%	248825	35.95%	323	67.57%
意	118		13	1111	0.1678%	249936	45.30%	323	67.57%
樣	110		15	1145	0.1729%	251081	43.94%	322	67.36%
同	102		6	1223	0.1847%	252304	42.52%	321	67.15%
最	107		12	1166	0.1761%	253470	43.42%	321	67.15%
進	129		11	1067	0.1612%	254537	47.12%	321	67.15%
更	137		7	1013	0.153%	255550	48.37%	319	66.74%
長	134		8	1037	0.1566%	256587	47.91%	318	66.53%
子	41		3	2109	0.3186%	258696	28.20%	313	65.48%
好	100		6	1231	0.1859%	259927	42.15%	313	65.48%
動	93		11	1274	0.1924%	261201	40.84%	312	65.27%
間	136		12	1025	0.1548%	262226	48.22%	311	65.06%
由	89		5	1326	0.2003%	263552	40.06%	310	64.85%
三	86		3	1347	0.2035%	264899	39.45%	308	64.44%
見	155		7	904	0.1365%	265803	50.92%	308	64.44%
小	88		3	1335	0.2016%	267138	39.85%	307	64.23%
看	104		9	1191	0.1799%	268329	42.89%	307	64.23%
正	150		5	918	0.1387%	269247	50.24%	305	63.81%
還	109		16	1150	0.1737%	270397	43.77%	302	63.18%
及	77		4	1469	0.2219%	271866	37.51%	298	62.34%
與	81		14	1438	0.2172%	273304	38.39%	297	62.13%
本	76		5	1470	0.222%	274774	37.29%	296	61.92%
知	152		8	911	0.1376%	275685	50.51%	295	61.72%
少	165		4	854	0.129%	276539	52.25%	294	61.51%
沒	130		7	1064	0.1607%	277603	47.28%	293	61.30%
明	167		8	849	0.1282%	278452	52.51%	293	61.30%
想	125		13	1104	0.1668%	279556	46.46%	292	61.09%
至	156		6	899	0.1358%	280455	51.06%	292	61.09%
四	135		5	1026	0.155%	281481	48.07%	291	60.88%
分	131		4	1056	0.1595%	282537	47.44%	289	60.46%
相	174		9	801	0.121%	283338	53.38%	289	60.46%
向	179		6	770	0.1163%	284108	53.97%	289	60.46%
二	90		2	1320	0.1994%	285428	40.25%	288	60.25%
重	145		9	941	0.1421%	286369	49.54%	288	60.25%
	47		11	1965	0.2968%	288334	30.03%	285	59.62%
些	91		8	1294	0.1955%	289628	40.45%	285	59.62%
高	153		10	906	0.1368%	290534	50.65%	285	59.62%
點	171		17	815	0.1231%	291349	53.01%	285	59.62%
力	113		2	1130	0.1707%	292479	44.45%	284	59.41%
者	122		8	1105	0.1669%	293584	45.96%	284	59.41%
只	141		5	963	0.1455%	294547	48.97%	282	59.00%
全	163		6	867	0.131%	295414	51.99%	282	59.00%
每	178		7	772	0.1166%	296186	53.85%	281	58.79%
身	211		7	667	0.1007%	296853	57.40%	279	58.37%
加	124		5	1104	0.1668%	297957	46.30%	278	58.16%
將	143		11	950	0.1435%	298907	49.25%	278	58.16%
或	158		8	894	0.135%	299801	51.33%	277	57.95%
理	106		11	1174	0.1773%	300975	43.24%	275	57.53%
新	101		13	1228	0.1855%	302203	42.34%	274	57.32%
很	147		9	928	0.1402%	303131	49.82%	274	57.32%
別	233		7	626	0.09456%	303757	59.53%	274	57.32%
便	142		9	954	0.1441%	304711	49.11%	273	57.11%
應	149		17	921	0.1391%	305632	50.10%	273	57.11%
工	58		3	1686	0.2547%	307318	33.05%	272	56.90%
麼	119		14	1110	0.1677%	308428	45.46%	272	56.90%
定	168		8	844	0.1275%	309272	52.64%	272	56.90%
並	192		8	715	0.108%	309987	55.42%	272	56.90%
等	157		12	897	0.1355%	310884	51.20%	271	56.69%
次	183		6	750	0.1133%	311634	54.43%	271	56.69%
五	121		4	1105	0.1669%	312739	45.80%	270	56.49%
處	209		11	672	0.1015%	313411	57.19%	270	56.49%
兩	170		8	838	0.1266%	314249	52.89%	269	56.28%
美	103		9	1208	0.1825%	315457	42.71%	264	55.23%
活	132		9	1055	0.1594%	316512	47.60%	264	55.23%
常	176		11	785	0.1186%	317297	53.62%	262	54.81%
目	210		5	667	0.1007%	317964	57.30%	262	54.81%
望	197		11	704	0.1063%	318668	55.95%	259	54.18%
受	194		8	712	0.1075%	319380	55.63%	258	53.97%
主	97		5	1250	0.1888%	320630	41.59%	257	53.77%
法	128		8	1076	0.1625%	321706	46.96%	257	53.77%
何	190		7	719	0.1086%	322425	55.20%	257	53.77%
水	82		4	1423	0.2149%	323848	38.61%	253	52.93%
各	144		6	941	0.1421%	324789	49.40%	252	52.72%
果	225		8	636	0.09607%	325425	58.77%	252	52.72%
再	247		6	600	0.09063%	326025	60.82%	252	52.72%
風	139		9	996	0.1504%	327021	48.68%	251	52.51%
界	140		9	964	0.1456%	327985	48.82%	251	52.51%
月	151		4	915	0.1382%	328900	50.38%	250	52.30%
頭	172		16	813	0.1228%	329713	53.14%	249	52.09%
像	185		14	744	0.1124%	330457	54.65%	249	52.09%
難	229		19	630	0.09516%	331087	59.15%	249	52.09%
遠	248		13	595	0.08987%	331682	60.91%	249	52.09%
世	161		5	879	0.1328%	332561	51.73%	248	51.88%
今	227		4	631	0.09531%	333192	58.96%	246	51.46%
裏	120		13	1107	0.1672%	334299	45.63%	244	51.05%
感	201		13	694	0.1048%	334993	56.38%	244	51.05%
比	228		4	631	0.09531%	335624	59.06%	243	50.84%
合	235		6	618	0.09335%	336242	59.72%	243	50.84%
接	255		11	573	0.08655%	336815	61.53%	243	50.84%
雖	302		17	490	0.07401%	337305	65.30%	243	50.84%
國	27		11	2877	0.4346%	340182	23.25%	242	50.63%
把	177		7	784	0.1184%	340966	53.73%	242	50.63%
立	200		5	696	0.1051%	341662	56.27%	242	50.63%
許	219		11	649	0.09803%	342311	58.19%	242	50.63%
入	232		2	626	0.09456%	342937	59.44%	241	50.42%
物	162		8	873	0.1319%	343810	51.86%	240	50.21%
數	206		15	675	0.102%	344485	56.89%	240	50.21%
氣	181		10	764	0.1154%	345249	54.20%	239	50.00%
光	166		6	850	0.1284%	346099	52.38%	237	49.58%
問	146		11	937	0.1415%	347036	49.68%	236	49.37%
幾	240		12	609	0.09199%	347645	60.18%	235	49.16%
給	236		12	617	0.0932%	348262	59.81%	234	48.95%
公	112		4	1132	0.171%	349394	44.28%	232	48.54%
學	42		16	2086	0.3151%	351480	28.51%	231	48.33%
平	237		5	616	0.09304%	352096	59.90%	231	48.33%
百	159		6	893	0.1349%	352989	51.47%	230	48.12%
機	138		16	998	0.1507%	353987	48.53%	229	47.91%
內	189		4	720	0.1088%	354707	55.09%	229	47.91%
近	278		7	539	0.08141%	355246	63.45%	229	47.91%
該	207		13	675	0.102%	355921	56.99%	228	47.70%
表	231		8	627	0.09471%	356548	59.34%	228	47.70%
才	264		3	554	0.08368%	357102	62.29%	227	47.49%
深	283		11	528	0.07975%	357630	63.85%	227	47.49%
海	126		10	1093	0.1651%	358723	46.63%	226	47.28%
真	217		10	651	0.09833%	359374	57.99%	226	47.28%
港	53		12	1786	0.2698%	361160	31.75%	225	47.07%
變	285		23	519	0.07839%	361679	64.01%	225	47.07%
香	105		9	1189	0.1796%	362868	43.07%	224	46.86%
代	148		5	926	0.1399%	363794	49.96%	224	46.86%
萬	193		13	713	0.1077%	364507	55.53%	223	46.65%
原	204		10	676	0.1021%	365183	56.69%	223	46.65%
未	288		5	512	0.07734%	365695	64.24%	223	46.65%
關	205		19	676	0.1021%	366371	56.79%	222	46.44%
總	261		17	561	0.08474%	366932	62.04%	222	46.44%
被	299		10	492	0.07431%	367424	65.08%	222	46.44%
度	184		9	748	0.113%	368172	54.54%	221	46.23%
則	191		9	716	0.1081%	368888	55.31%	220	46.03%
聲	203		17	686	0.1036%	369574	56.58%	220	46.03%
利	154		7	905	0.1367%	370479	50.79%	218	45.61%
位	199		7	697	0.1053%	371176	56.17%	218	45.61%
先	243		6	604	0.09123%	371780	60.46%	217	45.40%
切	315		4	462	0.06978%	372242	66.23%	217	45.40%
認	273		14	545	0.08232%	372787	63.04%	216	45.19%
流	286		9	518	0.07824%	373305	64.08%	216	45.19%
非	290		8	511	0.07718%	373816	64.39%	215	44.98%
往	305		8	480	0.0725%	374296	65.52%	215	44.98%
且	334		5	444	0.06706%	374740	67.53%	215	44.98%
部	212		10	667	0.1007%	375407	57.50%	214	44.77%
特	300		10	490	0.07401%	375897	65.15%	214	44.77%
六	182		4	755	0.114%	376652	54.31%	213	44.56%
愛	186		13	740	0.1118%	377392	54.76%	212	44.35%
七	246		2	600	0.09063%	377992	60.73%	212	44.35%
解	281		13	533	0.08051%	378525	63.69%	212	44.35%
空	268		8	552	0.08338%	379077	62.63%	211	44.14%
名	256		6	571	0.08625%	379648	61.61%	210	43.93%
手	265		4	554	0.08368%	380202	62.38%	210	43.93%
必	258		5	569	0.08595%	380771	61.78%	209	43.72%
期	259		12	565	0.08534%	381336	61.87%	209	43.72%
提	312		12	470	0.07099%	381806	66.02%	209	43.72%
九	133		2	1053	0.1591%	382859	47.76%	208	43.51%
它	164		5	857	0.1294%	383716	52.12%	208	43.51%
口	241		3	607	0.09169%	384323	60.27%	208	43.51%
業	115		13	1114	0.1683%	385437	44.79%	207	43.31%
走	244		7	604	0.09123%	386041	60.55%	207	43.31%
八	254		2	580	0.08761%	386621	61.44%	207	43.31%
安	310		6	473	0.07144%	387094	65.88%	207	43.31%
甚	321		9	454	0.06858%	387548	66.65%	207	43.31%
民	66		5	1581	0.2388%	389129	35.01%	206	43.10%
通	187		10	739	0.1116%	389868	54.87%	206	43.10%
神	245		9	602	0.09093%	390470	60.64%	206	43.10%
體	267		23	553	0.08353%	391023	62.54%	206	43.10%
回	269		6	549	0.08292%	391572	62.71%	206	43.10%
形	295		7	500	0.07552%	392072	64.78%	206	43.10%
曾	340		12	429	0.0648%	392501	67.92%	206	43.10%
信	220		9	648	0.09788%	393149	58.29%	205	42.89%
滿	327		14	449	0.06782%	393598	67.05%	204	42.68%
完	346		7	422	0.06374%	394020	68.31%	204	42.68%
你	64		7	1604	0.2423%	395624	34.54%	203	42.47%
任	272		6	545	0.08232%	396169	62.96%	203	42.47%
影	284		15	522	0.07885%	396691	63.93%	203	42.47%
白	266		5	553	0.08353%	397244	62.46%	202	42.26%
第	242		11	607	0.09169%	397851	60.36%	201	42.05%
候	314		10	467	0.07054%	398318	66.16%	201	42.05%
除	358		9	407	0.06148%	398725	69.06%	201	42.05%
直	368		8	388	0.05861%	399113	69.66%	201	42.05%
太	276		4	540	0.08157%	399653	63.28%	200	41.84%
放	320		8	454	0.06858%	400107	66.58%	200	41.84%
眼	342		11	428	0.06465%	400535	68.05%	200	41.84%
文	117		4	1112	0.168%	401647	45.13%	199	41.63%
路	239		13	611	0.09229%	402258	60.09%	199	41.63%
山	111		3	1134	0.1713%	403392	44.11%	197	41.21%
性	234		8	625	0.0944%	404017	59.62%	197	41.21%
做	271		11	547	0.08262%	404564	62.87%	197	41.21%
觀	275		25	541	0.08172%	405105	63.20%	197	41.21%
即	292		7	510	0.07703%	405615	64.55%	197	41.21%
步	339		7	430	0.06495%	406045	67.86%	197	41.21%
西	198		6	699	0.1056%	406744	56.06%	196	41.00%
落	354		13	415	0.06268%	407159	68.81%	196	41.00%
東	262		8	560	0.08459%	407719	62.12%	195	40.79%
覺	301		20	490	0.07401%	408209	65.22%	195	40.79%
己	249		3	591	0.08927%	408800	61.00%	194	40.59%
清	298		11	496	0.07492%	409296	65.00%	194	40.59%
結	351		12	418	0.06314%	409714	68.63%	194	40.59%
千	251		3	585	0.08836%	410299	61.18%	193	40.38%
論	296		15	500	0.07552%	410799	64.85%	193	40.38%
條	318		11	461	0.06963%	411260	66.44%	192	40.17%
失	330		5	446	0.06737%	411706	67.26%	192	40.17%
化	173		4	802	0.1211%	412508	53.26%	191	39.96%
打	280		5	534	0.08066%	413042	63.61%	191	39.96%
份	329		6	447	0.06752%	413489	67.19%	191	39.96%
展	216		10	651	0.09833%	414140	57.89%	190	39.75%
設	253		11	582	0.08791%	414722	61.35%	190	39.75%
青	196		8	706	0.1066%	415428	55.85%	189	39.54%
樂	250		15	588	0.08882%	416016	61.09%	189	39.54%
需	306		14	479	0.07235%	416495	65.59%	189	39.54%
色	218		6	651	0.09833%	417146	58.09%	188	39.33%
始	402		8	349	0.05272%	417495	71.55%	188	39.33%
兒	169		8	840	0.1269%	418335	52.76%	187	39.12%
花	214		8	656	0.09909%	418991	57.70%	187	39.12%
命	222		8	643	0.09712%	419634	58.48%	187	39.12%
帶	341		11	428	0.06465%	420062	67.99%	187	39.12%
容	396		10	357	0.05392%	420419	71.23%	187	39.12%
足	399		7	355	0.05362%	420774	71.40%	187	39.12%
題	208		18	674	0.1018%	421448	57.09%	185	38.70%
求	304		7	485	0.07326%	421933	65.44%	185	38.70%
建	188		9	737	0.1113%	422670	54.99%	184	38.49%
收	322		6	453	0.06842%	423123	66.71%	183	38.28%
興	377		16	379	0.05725%	423502	70.18%	183	38.28%
士	215		3	651	0.09833%	424153	57.79%	182	38.08%
交	221		6	647	0.09773%	424800	58.38%	182	38.08%
達	371		12	384	0.058%	425184	69.84%	182	38.08%
著	277		12	540	0.08157%	425724	63.37%	181	37.87%
極	379		13	378	0.0571%	426102	70.30%	181	37.87%
另	517		5	263	0.03973%	426365	76.82%	181	37.87%
指	363		9	398	0.06012%	426763	69.37%	180	37.66%
持	400		9	351	0.05302%	427114	71.45%	180	37.66%
反	355		4	413	0.06238%	427527	68.88%	179	37.45%
視	421		12	334	0.05045%	427861	72.53%	179	37.45%
女	223		3	640	0.09667%	428501	58.58%	178	37.24%
話	345		13	426	0.06435%	428927	68.24%	178	37.24%
教	74		11	1475	0.2228%	430402	36.85%	177	37.03%
增	294		15	505	0.07628%	430907	64.70%	177	37.03%
政	99		9	1232	0.1861%	432139	41.97%	176	36.82%
聽	365		22	395	0.05966%	432534	69.49%	175	36.61%
故	366		9	389	0.05876%	432923	69.54%	175	36.61%
快	389		7	364	0.05498%	433287	70.85%	175	36.61%
照	437		13	319	0.04818%	433606	73.32%	175	36.61%
半	408		5	342	0.05166%	433948	71.87%	174	36.40%
老	252		6	583	0.08806%	434531	61.26%	173	36.19%
亦	279		6	536	0.08096%	435067	63.53%	173	36.19%
仍	416		4	335	0.0506%	435402	72.28%	173	36.19%
引	474		4	290	0.0438%	435692	75.02%	173	36.19%
離	419		18	335	0.0506%	436027	72.43%	172	35.98%
量	313		12	469	0.07084%	436496	66.09%	171	35.77%
改	362		7	401	0.06057%	436897	69.31%	170	35.56%
般	432		10	323	0.04879%	437220	73.07%	169	35.36%
書	270		10	548	0.08277%	437768	62.79%	168	35.15%
舉	364		17	397	0.05997%	438165	69.43%	168	35.15%
市	180		5	769	0.1162%	438934	54.08%	167	34.94%
字	307		6	478	0.0722%	439412	65.66%	167	34.94%
言	349		7	420	0.06344%	439832	68.50%	167	34.94%
住	359		7	404	0.06102%	440236	69.12%	167	34.94%
盡	488		14	285	0.04305%	440521	75.62%	167	34.94%
產	195		11	711	0.1074%	441232	55.74%	166	34.73%
金	287		8	515	0.07779%	441747	64.16%	166	34.73%
什	309		4	475	0.07175%	442222	65.81%	166	34.73%
熱	375		15	380	0.0574%	442602	70.07%	166	34.73%
連	423		10	332	0.05015%	442934	72.63%	166	34.73%
早	436		6	319	0.04818%	443253	73.27%	166	34.73%
社	160		7	882	0.1332%	444135	51.60%	165	34.52%
邊	337		18	440	0.06646%	444575	67.73%	165	34.52%
計	202		9	690	0.1042%	445265	56.48%	164	34.31%
務	291		11	510	0.07703%	445775	64.47%	164	34.31%
程	328		12	448	0.06767%	446223	67.12%	164	34.31%
記	385		10	370	0.05589%	446593	70.63%	164	34.31%
境	415		14	336	0.05075%	446929	72.23%	164	34.31%
久	504		3	274	0.04139%	447203	76.30%	164	34.31%
居	308		8	478	0.0722%	447681	65.73%	163	34.10%
夠	470		11	293	0.04426%	447974	74.84%	163	34.10%
員	224		10	638	0.09637%	448612	58.67%	162	33.89%
類	263		19	559	0.08443%	449171	62.21%	161	33.68%
運	353		12	417	0.06299%	449588	68.75%	161	33.68%
備	444		12	315	0.04758%	449903	73.65%	161	33.68%
整	452		16	308	0.04652%	450211	74.03%	161	33.68%
共	230		6	629	0.09501%	450840	59.25%	160	33.47%
門	357		8	412	0.06223%	451252	69.00%	160	33.47%
呢	380		8	376	0.05679%	451628	70.35%	160	33.47%
取	398		8	356	0.05377%	451984	71.34%	160	33.47%
保	378		9	378	0.0571%	452362	70.24%	159	33.26%
象	407		12	344	0.05196%	452706	71.82%	159	33.26%
管	412		14	340	0.05136%	453046	72.07%	159	33.26%
思	374		9	382	0.0577%	453428	70.01%	158	33.05%
首	527		9	255	0.03852%	453683	77.21%	158	33.05%
辦	319		16	461	0.06963%	454144	66.51%	157	32.85%
精	360		14	404	0.06102%	454548	69.18%	157	32.85%
馬	381		10	375	0.05664%	454923	70.41%	157	32.85%
片	393		4	358	0.05407%	455281	71.07%	157	32.85%
似	413		7	339	0.0512%	455620	72.12%	157	32.85%
件	434		6	322	0.04864%	455942	73.17%	157	32.85%
較	426		13	330	0.04985%	456272	72.78%	156	32.64%
希	489		7	284	0.0429%	456556	75.67%	156	32.64%
黃	344		12	428	0.06465%	456984	68.18%	155	32.43%
算	361		14	403	0.06087%	457387	69.25%	155	32.43%
消	435		10	321	0.04849%	457708	73.22%	155	32.43%
隨	538		15	248	0.03746%	457956	77.63%	155	32.43%
輕	405		14	345	0.05211%	458301	71.71%	154	32.22%
底	384		8	370	0.05589%	458671	70.58%	153	32.01%
助	394		7	357	0.05392%	459028	71.13%	153	32.01%
張	449		11	311	0.04698%	459339	73.89%	153	32.01%
英	274		9	542	0.08187%	459881	63.12%	152	31.80%
夜	350		8	419	0.06329%	460300	68.56%	152	31.80%
苦	401		9	351	0.05302%	460651	71.50%	152	31.80%
乎	457		5	300	0.04531%	460951	74.26%	152	31.80%
顯	451		23	310	0.04682%	461261	73.98%	151	31.59%
具	461		8	299	0.04516%	461560	74.44%	151	31.59%
義	226		13	635	0.09591%	462195	58.87%	150	31.38%
廣	458		15	300	0.04531%	462495	74.30%	150	31.38%
令	520		5	261	0.03942%	462756	76.94%	149	31.17%
斷	584		18	226	0.03414%	462982	79.27%	149	31.17%
約	392		9	362	0.05468%	463344	71.02%	148	30.96%
易	348		8	422	0.06374%	463766	68.44%	147	30.75%
據	494		16	282	0.0426%	464048	75.88%	147	30.75%
絕	563		12	236	0.03565%	464284	78.54%	147	30.75%
區	238		11	613	0.09259%	464897	60.00%	146	30.54%
音	352		9	418	0.06314%	465315	68.69%	146	30.54%
單	481		12	287	0.04335%	465602	75.32%	146	30.54%
致	541		9	246	0.03716%	465848	77.74%	146	30.54%
式	439		6	317	0.04788%	466165	73.41%	145	30.33%
低	478		7	288	0.0435%	466453	75.19%	145	30.33%
留	529		10	253	0.03821%	466706	77.29%	145	30.33%
轉	537		18	248	0.03746%	466954	77.59%	145	30.33%
刻	560		8	236	0.03565%	467190	78.43%	145	30.33%
府	213		8	663	0.1001%	467853	57.60%	144	30.13%
友	404		4	346	0.05226%	468199	71.66%	144	30.13%
識	425		19	330	0.04985%	468529	72.73%	143	29.92%
告	467		7	295	0.04456%	468824	74.71%	143	29.92%
願	545		19	245	0.03701%	469069	77.89%	143	29.92%
息	578		10	229	0.03459%	469298	79.07%	143	29.92%
須	453		12	308	0.04652%	469606	74.07%	142	29.71%
確	554		15	240	0.03625%	469846	78.22%	142	29.71%
歡	471		22	293	0.04426%	470139	74.88%	141	29.50%
根	496		10	279	0.04214%	470418	75.96%	141	29.50%
親	260		16	562	0.08489%	470980	61.95%	140	29.29%
造	382		10	374	0.05649%	471354	70.47%	140	29.29%
調	500		15	277	0.04184%	471631	76.13%	140	29.29%
屬	553		21	240	0.03625%	471871	78.18%	140	29.29%
究	367		7	389	0.05876%	472260	69.60%	139	29.08%
限	475		8	290	0.0438%	472550	75.06%	139	29.08%
獲	514		17	265	0.04003%	472815	76.70%	139	29.08%
車	175		7	787	0.1189%	473602	53.50%	138	28.87%
報	369		12	387	0.05845%	473989	69.72%	138	28.87%
談	430		15	325	0.04909%	474314	72.98%	138	28.87%
若	469		9	294	0.04441%	474608	74.79%	138	28.87%
際	483		13	287	0.04335%	474895	75.41%	138	28.87%
服	498		8	278	0.04199%	475173	76.05%	138	28.87%
例	499		8	277	0.04184%	475450	76.09%	138	28.87%
商	317		11	462	0.06978%	475912	66.37%	137	28.66%
	397		7	356	0.05377%	476268	71.29%	137	28.66%
環	431		17	323	0.04879%	476591	73.03%	137	28.66%
值	512		10	265	0.04003%	476856	76.62%	137	28.66%
包	519		5	262	0.03957%	477118	76.90%	137	28.66%
餘	574		15	232	0.03504%	477350	78.93%	137	28.66%
傳	445		13	313	0.04728%	477663	73.70%	136	28.45%
靜	433		16	323	0.04879%	477986	73.12%	135	28.24%
獨	513		16	265	0.04003%	478251	76.66%	135	28.24%
示	558		5	238	0.03595%	478489	78.36%	135	28.24%
電	311		13	472	0.07129%	478961	65.95%	134	28.03%
石	343		5	428	0.06465%	479389	68.12%	134	28.03%
華	403		12	347	0.05241%	479736	71.61%	134	28.03%
否	510		7	266	0.04018%	480002	76.54%	134	28.03%
讓	542		24	246	0.03716%	480248	77.78%	134	28.03%
續	602		21	218	0.03293%	480466	79.87%	133	27.82%
紅	441		9	316	0.04773%	480782	73.51%	132	27.62%
念	447		8	312	0.04713%	481094	73.79%	132	27.62%
福	448		13	312	0.04713%	481406	73.84%	132	27.62%
免	585		7	225	0.03399%	481631	79.31%	132	27.62%
終	655		11	194	0.0293%	481825	81.52%	132	27.62%
南	316		9	462	0.06978%	482287	66.30%	131	27.41%
制	324		8	450	0.06797%	482737	66.85%	131	27.41%
費	338		12	431	0.0651%	483168	67.79%	131	27.41%
節	418		13	335	0.0506%	483503	72.38%	131	27.41%
供	427		8	327	0.04939%	483830	72.83%	131	27.41%
怎	521		9	261	0.03942%	484091	76.98%	131	27.41%
初	631		7	205	0.03096%	484296	80.80%	131	27.41%
飛	388		9	365	0.05513%	484661	70.80%	130	27.20%
存	487		6	285	0.04305%	484946	75.58%	130	27.20%
充	615		5	211	0.03187%	485157	80.29%	130	27.20%
待	648		9	197	0.02976%	485354	81.31%	130	27.20%
喜	508		12	267	0.04033%	485621	76.46%	129	26.99%
推	516		11	264	0.03988%	485885	76.78%	129	26.99%
晚	548		11	242	0.03655%	486127	78.00%	129	26.99%
依	630		8	205	0.03096%	486332	80.77%	129	26.99%
樹	370		16	386	0.0583%	486718	69.78%	128	26.78%
客	390		9	363	0.05483%	487081	70.91%	128	26.78%
景	473		12	292	0.04411%	487373	74.97%	128	26.78%
參	476		11	289	0.04365%	487662	75.10%	128	26.78%
她	96		6	1253	0.1893%	488915	41.41%	127	26.57%
星	325		9	450	0.06797%	489365	66.92%	127	26.57%
古	417		5	335	0.0506%	489700	72.33%	127	26.57%
善	468		12	294	0.04441%	489994	74.75%	127	26.57%
適	559		14	238	0.03595%	490232	78.40%	127	26.57%
竟	576		11	231	0.03489%	490463	79.00%	127	26.57%
品	293		9	505	0.07628%	490968	64.62%	126	26.36%
北	391		5	362	0.05468%	491330	70.96%	126	26.36%
集	480		12	288	0.0435%	491618	75.28%	126	26.36%
繼	658		20	193	0.02915%	491811	81.61%	126	26.36%
臨	712		17	172	0.02598%	491983	83.09%	126	26.36%
領	530		14	252	0.03806%	492235	77.33%	125	26.15%
微	619		13	210	0.03172%	492445	80.42%	125	26.15%
統	356		11	413	0.06238%	492858	68.94%	124	25.94%
笑	387		10	365	0.05513%	493223	70.74%	124	25.94%
導	535		16	248	0.03746%	493471	77.52%	123	25.73%
破	611		10	213	0.03217%	493684	80.17%	123	25.73%
雨	323		8	453	0.06842%	494137	66.78%	122	25.52%
項	372		12	383	0.05785%	494520	69.89%	122	25.52%
陽	424		11	331	0.050%	494851	72.68%	122	25.52%
死	446		6	313	0.04728%	495164	73.75%	122	25.52%
負	571		9	233	0.03519%	495397	78.82%	122	25.52%
叫	420		5	334	0.05045%	495731	72.48%	121	25.31%
歷	459		16	300	0.04531%	496031	74.35%	121	25.31%
木	477		4	289	0.04365%	496320	75.15%	121	25.31%
黑	497		12	279	0.04214%	496599	76.01%	121	25.31%
讀	515		22	265	0.04003%	496864	76.74%	121	25.31%
段	609		9	214	0.03232%	497078	80.10%	121	25.31%
火	414		4	337	0.0509%	497415	72.17%	120	25.10%
責	568		11	234	0.03534%	497649	78.72%	120	25.10%
角	606		7	216	0.03263%	497865	80.00%	120	25.10%
注	687		8	181	0.02734%	498046	82.43%	120	25.10%
尤	714		4	171	0.02583%	498217	83.14%	120	25.10%
草	429		10	327	0.04939%	498544	72.93%	119	24.90%
良	582		7	227	0.03429%	498771	79.20%	119	24.90%
局	347		7	422	0.06374%	499193	68.37%	118	24.69%
議	257		20	571	0.08625%	499764	61.70%	117	24.48%
價	438		15	318	0.04803%	500082	73.36%	117	24.48%
爭	440		8	316	0.04773%	500398	73.46%	117	24.48%
洋	601		9	218	0.03293%	500616	79.84%	117	24.48%
稱	623		14	209	0.03157%	500825	80.55%	117	24.48%
止	667		4	189	0.02855%	501014	81.87%	117	24.48%
停	534		11	248	0.03746%	501262	77.48%	116	24.27%
漸	540		14	246	0.03716%	501508	77.70%	116	24.27%
司	332		5	445	0.06722%	501953	67.39%	115	24.06%
土	333		3	445	0.06722%	502398	67.46%	115	24.06%
支	524		4	259	0.03912%	502657	77.10%	115	24.06%
假	547		11	243	0.0367%	502900	77.96%	115	24.06%
規	581		11	228	0.03444%	503128	79.17%	115	24.06%
永	587		5	224	0.03383%	503352	79.37%	115	24.06%
困	629		7	206	0.03112%	503558	80.74%	115	24.06%
衣	646		6	198	0.02991%	503756	81.25%	115	24.06%
奇	684		8	182	0.02749%	503938	82.35%	115	24.06%
戰	336		16	442	0.06676%	504380	67.66%	114	23.85%
場	486		12	285	0.04305%	504665	75.54%	114	23.85%
聯	511		17	266	0.04018%	504931	76.58%	114	23.85%
專	531		11	251	0.03791%	505182	77.37%	114	23.85%
均	556		7	238	0.03595%	505420	78.29%	114	23.85%
顧	742		21	161	0.02432%	505581	83.84%	114	23.85%
濟	331		17	446	0.06737%	506027	67.32%	113	23.64%
料	566		10	234	0.03534%	506261	78.65%	113	23.64%
格	594		10	221	0.03338%	506482	79.61%	113	23.64%
嚴	603		20	217	0.03278%	506699	79.91%	113	23.64%
鄉	282		11	529	0.0799%	507228	63.77%	112	23.43%
係	528		9	253	0.03821%	507481	77.25%	112	23.43%
沉	549		7	242	0.03655%	507723	78.04%	112	23.43%
舊	569		18	233	0.03519%	507956	78.75%	112	23.43%
請	592		15	222	0.03353%	508178	79.54%	112	23.43%
富	653		12	195	0.02945%	508373	81.46%	112	23.43%
既	674		9	188	0.0284%	508561	82.07%	112	23.43%
密	690		11	179	0.02704%	508740	82.51%	112	23.43%
資	297		13	498	0.07522%	509238	64.93%	111	23.22%
元	335		4	443	0.06691%	509681	67.59%	111	23.22%
德	409		15	342	0.05166%	510023	71.92%	111	23.22%
寫	484		15	286	0.0432%	510309	75.45%	111	23.22%
林	507		8	269	0.04063%	510578	76.42%	111	23.22%
吧	600		7	218	0.03293%	510796	79.81%	111	23.22%
劃	386		14	366	0.05528%	511162	70.69%	110	23.01%
基	450		11	310	0.04682%	511472	73.93%	110	23.01%
組	503		11	275	0.04154%	511747	76.26%	110	23.01%
準	595		13	221	0.03338%	511968	79.64%	110	23.01%
功	605		5	216	0.03263%	512184	79.97%	110	23.01%
靈	626		24	208	0.03142%	512392	80.64%	110	23.01%
印	532		6	249	0.03761%	512641	77.40%	109	22.80%
置	617		13	211	0.03187%	512852	80.36%	109	22.80%
響	625		21	209	0.03157%	513061	80.61%	109	22.80%
趣	635		15	202	0.03051%	513263	80.92%	109	22.80%
找	659		7	192	0.029%	513455	81.64%	109	22.80%
雲	679		12	187	0.02825%	513642	82.21%	109	22.80%
術	411		11	341	0.05151%	513983	72.02%	108	22.59%
質	442		15	316	0.04773%	514299	73.56%	108	22.59%
眾	491		11	284	0.0429%	514583	75.75%	108	22.59%
紀	596		9	221	0.03338%	514804	79.68%	108	22.59%
途	694		10	177	0.02674%	514981	82.62%	108	22.59%
異	723		11	168	0.02538%	515149	83.37%	108	22.59%
治	289		8	511	0.07718%	515660	64.32%	107	22.38%
施	526		9	257	0.03882%	515917	77.17%	107	22.38%
春	544		9	245	0.03701%	516162	77.85%	107	22.38%
語	555		14	239	0.0361%	516401	78.25%	107	22.38%
強	608		11	215	0.03247%	516616	80.07%	107	22.38%
驗	656		23	194	0.0293%	516810	81.55%	107	22.38%
細	738		11	163	0.02462%	516973	83.74%	107	22.38%
尋	744		12	160	0.02417%	517133	83.89%	107	22.38%
房	490		8	284	0.0429%	517417	75.71%	106	22.18%
謂	567		16	234	0.03534%	517651	78.68%	106	22.18%
圖	654		14	194	0.0293%	517845	81.49%	106	22.18%
史	462		5	298	0.04501%	518143	74.48%	105	21.97%
勢	543		13	245	0.03701%	518388	77.81%	105	21.97%
野	599		11	219	0.03308%	518607	79.78%	105	21.97%
考	627		6	207	0.03127%	518814	80.67%	105	21.97%
緊	645		14	198	0.02991%	519012	81.22%	105	21.97%
歲	565		13	235	0.0355%	519247	78.61%	104	21.76%
麗	586		19	225	0.03399%	519472	79.34%	104	21.76%
復	644		12	198	0.02991%	519670	81.19%	104	21.76%
圍	649		12	196	0.02961%	519866	81.34%	104	21.76%
繁	753		17	159	0.02402%	520025	84.11%	104	21.76%
院	406		9	345	0.05211%	520370	71.76%	103	21.55%
養	564		15	236	0.03565%	520606	78.58%	103	21.55%
痛	614		12	212	0.03202%	520818	80.26%	103	21.55%
層	680		15	185	0.02794%	521003	82.23%	103	21.55%
予	695		4	176	0.02658%	521179	82.64%	103	21.55%
懷	704		19	173	0.02613%	521352	82.88%	103	21.55%
校	376		10	379	0.05725%	521731	70.12%	102	21.34%
孩	454		9	304	0.04592%	522035	74.12%	102	21.34%
歌	485		14	286	0.0432%	522321	75.49%	102	21.34%
織	495		18	280	0.04229%	522601	75.92%	102	21.34%
卻	533		9	249	0.03761%	522850	77.44%	102	21.34%
團	551		14	241	0.0364%	523091	78.11%	102	21.34%
站	610		10	214	0.03232%	523305	80.13%	102	21.34%
跟	636		13	202	0.03051%	523507	80.95%	102	21.34%
冷	638		7	201	0.03036%	523708	81.01%	102	21.34%
坐	662		7	191	0.02885%	523899	81.72%	102	21.34%
怕	666		8	189	0.02855%	524088	81.84%	102	21.34%
呼	748		8	159	0.02402%	524247	83.99%	102	21.34%
越	422		12	334	0.05045%	524581	72.58%	101	21.13%
研	428		9	327	0.04939%	524908	72.88%	101	21.13%
積	706		16	173	0.02613%	525081	82.93%	101	21.13%
庭	472		10	292	0.04411%	525373	74.93%	100	20.92%
習	550		11	242	0.03655%	525615	78.07%	100	20.92%
座	583		10	226	0.03414%	525841	79.24%	100	20.92%
態	691		14	179	0.02704%	526020	82.54%	100	20.92%
缺	707		10	173	0.02613%	526193	82.96%	100	20.92%
旁	734		10	164	0.02477%	526357	83.65%	100	20.92%
採	749		11	159	0.02402%	526516	84.01%	100	20.92%
述	760		8	157	0.02371%	526673	84.27%	100	20.92%
龍	539		16	248	0.03746%	526921	77.67%	99	20.71%
裝	552		13	241	0.0364%	527162	78.14%	99	20.71%
味	641		8	199	0.03006%	527361	81.10%	99	20.71%
露	681		21	185	0.02794%	527546	82.26%	99	20.71%
屋	525		9	257	0.03882%	527803	77.14%	98	20.50%
決	575		7	231	0.03489%	528034	78.96%	98	20.50%
吃	633		6	203	0.03066%	528237	80.86%	98	20.50%
忘	673		7	188	0.0284%	528425	82.04%	98	20.50%
育	303		7	488	0.07371%	528913	65.37%	97	20.29%
食	546		9	245	0.03701%	529158	77.93%	97	20.29%
師	561		10	236	0.03565%	529394	78.47%	97	20.29%
效	717		10	169	0.02553%	529563	83.22%	97	20.29%
散	739		12	162	0.02447%	529725	83.77%	97	20.29%
迫	746		8	160	0.02417%	529885	83.94%	96	20.08%
遊	464		12	298	0.04501%	530183	74.57%	95	19.87%
標	660		15	192	0.029%	530375	81.66%	95	19.87%
溫	661		13	192	0.029%	530567	81.69%	95	19.87%
投	697		7	176	0.02658%	530743	82.70%	95	19.87%
職	698		18	176	0.02658%	530919	82.72%	95	19.87%
烈	719		10	169	0.02553%	531088	83.27%	95	19.87%
激	794		16	148	0.02235%	531236	85.05%	95	19.87%
台	518		5	263	0.03973%	531499	76.86%	94	19.67%
夢	573		14	232	0.03504%	531731	78.89%	94	19.67%
惡	620		12	210	0.03172%	531941	80.45%	94	19.67%
誰	683		15	183	0.02764%	532124	82.32%	94	19.67%
急	685		9	182	0.02749%	532306	82.37%	94	19.67%
固	721		8	168	0.02538%	532474	83.32%	94	19.67%
傷	766		13	155	0.02341%	532629	84.42%	94	19.67%
吸	772		7	152	0.02296%	532781	84.55%	94	19.67%
尚	799		8	147	0.0222%	532928	85.16%	94	19.67%
夫	650		4	196	0.02961%	533124	81.37%	93	19.46%
勝	747		12	159	0.02402%	533283	83.96%	93	19.46%
列	777		6	151	0.02281%	533434	84.67%	93	19.46%
勞	797		12	147	0.0222%	533581	85.12%	93	19.46%
享	842		8	137	0.02069%	533718	86.09%	93	19.46%
病	466		10	296	0.04471%	534014	74.66%	92	19.25%
創	720		12	168	0.02538%	534182	83.29%	92	19.25%
促	724		9	167	0.02522%	534349	83.40%	92	19.25%
錢	728		16	167	0.02522%	534516	83.50%	92	19.25%
短	745		12	160	0.02417%	534676	83.91%	92	19.25%
句	759		5	157	0.02371%	534833	84.25%	92	19.25%
速	593		10	222	0.03353%	535055	79.58%	91	19.04%
演	597		14	220	0.03323%	535275	79.71%	91	19.04%
選	637		15	202	0.03051%	535477	80.98%	91	19.04%
擊	762		17	156	0.02356%	535633	84.32%	91	19.04%
差	833		10	139	0.021%	535772	85.90%	91	19.04%
逐	835		10	139	0.021%	535911	85.94%	91	19.04%
盛	845		11	137	0.02069%	536048	86.15%	91	19.04%
母	326		5	449	0.06782%	536497	66.99%	90	18.83%
朋	622		8	209	0.03157%	536706	80.52%	90	18.83%
里	628		7	207	0.03127%	536913	80.71%	90	18.83%
腳	715		13	171	0.02583%	537084	83.17%	90	18.83%
倒	758		10	157	0.02371%	537241	84.23%	90	18.83%
幸	809		8	145	0.0219%	537386	85.38%	90	18.83%
驚	868		23	133	0.02009%	537519	86.62%	90	18.83%
河	383		8	371	0.05604%	537890	70.52%	89	18.62%
啊	664		11	190	0.0287%	538080	81.78%	89	18.62%
素	711		10	172	0.02598%	538252	83.06%	89	18.62%
送	741		9	161	0.02432%	538413	83.82%	89	18.62%
怪	854		8	135	0.02039%	538548	86.34%	89	18.62%
透	867		10	133	0.02009%	538681	86.60%	89	18.62%
迎	905		7	124	0.01873%	538805	87.33%	89	18.62%
城	373		9	382	0.0577%	539187	69.95%	88	18.41%
減	651		12	196	0.02961%	539383	81.40%	88	18.41%
益	702		10	175	0.02643%	539558	82.83%	88	18.41%
築	726		16	167	0.02522%	539725	83.45%	88	18.41%
僅	808		13	145	0.0219%	539870	85.36%	88	18.41%
避	896		16	125	0.01888%	539995	87.16%	88	18.41%
模	898		15	124	0.01873%	540119	87.20%	88	18.41%
園	632		13	205	0.03096%	540324	80.83%	87	18.20%
拉	634		8	203	0.03066%	540527	80.89%	87	18.20%
浪	710		10	172	0.02598%	540699	83.04%	87	18.20%
預	729		13	166	0.02507%	540865	83.52%	87	18.20%
壞	784		19	150	0.02266%	541015	84.83%	87	18.20%
追	786		9	150	0.02266%	541165	84.87%	87	18.20%
堅	838		11	138	0.02084%	541303	86.01%	87	18.20%
括	843		9	137	0.02069%	541440	86.11%	87	18.20%
榮	855		14	135	0.02039%	541575	86.36%	87	18.20%
證	861		19	134	0.02024%	541709	86.48%	87	18.20%
雙	862		18	134	0.02024%	541843	86.50%	87	18.20%
權	493		22	283	0.04275%	542126	75.84%	86	17.99%
修	670		10	188	0.0284%	542314	81.95%	86	17.99%
陣	676		9	188	0.0284%	542502	82.12%	86	17.99%
害	761		10	156	0.02356%	542658	84.30%	86	17.99%
討	774		10	152	0.02296%	542810	84.60%	86	17.99%
簡	795		18	148	0.02235%	542958	85.08%	86	17.99%
協	815		8	144	0.02175%	543102	85.52%	86	17.99%
付	832		5	139	0.021%	543241	85.88%	86	17.99%
葉	570		13	233	0.03519%	543474	78.79%	85	17.78%
旅	657		10	193	0.02915%	543667	81.58%	85	17.78%
構	751		14	159	0.02402%	543826	84.06%	85	17.78%
講	764		17	156	0.02356%	543982	84.37%	85	17.78%
貴	971		12	110	0.01662%	544092	88.49%	85	17.78%
綠	643		14	199	0.03006%	544291	81.16%	84	17.57%
男	677		7	187	0.02825%	544478	82.15%	84	17.57%
臉	771		17	153	0.02311%	544631	84.53%	84	17.57%
亞	443		8	315	0.04758%	544946	73.60%	83	17.36%
島	455		10	304	0.04592%	545250	74.17%	83	17.36%
委	672		8	188	0.0284%	545438	82.01%	83	17.36%
補	699		12	176	0.02658%	545614	82.75%	83	17.36%
換	850		12	136	0.02054%	545750	86.25%	83	17.36%
雜	873		18	131	0.01979%	545881	86.72%	83	17.36%
排	876		11	130	0.01964%	546011	86.78%	83	17.36%
突	890		9	126	0.01903%	546137	87.05%	83	17.36%
靠	897		15	125	0.01888%	546262	87.18%	83	17.36%
歸	899		18	124	0.01873%	546386	87.22%	83	17.36%
附	917		7	121	0.01828%	546507	87.55%	83	17.36%
父	410		4	341	0.05151%	546848	71.97%	82	17.15%
村	456		7	301	0.04546%	547149	74.21%	82	17.15%
級	604		10	217	0.03278%	547366	79.94%	82	17.15%
嗎	671		13	188	0.0284%	547554	81.98%	82	17.15%
暗	763		13	156	0.02356%	547710	84.34%	82	17.15%
線	781		15	151	0.02281%	547861	84.76%	82	17.15%
悲	788		12	149	0.02251%	548010	84.92%	82	17.15%
佈	814		7	144	0.02175%	548154	85.49%	82	17.15%
搖	826		13	141	0.0213%	548295	85.75%	82	17.15%
訴	895		12	125	0.01888%	548420	87.14%	82	17.15%
救	577		11	230	0.03474%	548650	79.03%	81	16.95%
衛	790		15	149	0.02251%	548799	84.96%	81	16.95%
維	823		14	143	0.0216%	548942	85.69%	81	16.95%
午	829		4	140	0.02115%	549082	85.82%	81	16.95%
波	865		8	133	0.02009%	549215	86.56%	81	16.95%
筆	536		12	248	0.03746%	549463	77.55%	80	16.74%
詩	579		13	229	0.03459%	549692	79.10%	80	16.74%
唱	607		11	215	0.03247%	549907	80.04%	80	16.74%
超	776		12	152	0.02296%	550059	84.65%	80	16.74%
背	782		9	151	0.02281%	550210	84.78%	80	16.74%
亂	802		13	146	0.02205%	550356	85.23%	80	16.74%
凡	806		3	145	0.0219%	550501	85.32%	80	16.74%
亮	813		9	144	0.02175%	550645	85.47%	80	16.74%
配	853		10	136	0.02054%	550781	86.32%	80	16.74%
壓	869		17	132	0.01994%	550913	86.64%	80	16.74%
載	882		13	128	0.01933%	551041	86.89%	80	16.74%
替	894		12	125	0.01888%	551166	87.12%	80	16.74%
拿	922		10	120	0.01813%	551286	87.64%	80	16.74%
敢	959		12	112	0.01692%	551398	88.29%	80	16.74%
科	463		9	298	0.04501%	551696	74.53%	79	16.53%
斯	522		12	261	0.03942%	551957	77.02%	79	16.53%
農	572		13	233	0.03519%	552190	78.86%	79	16.53%
營	731		17	165	0.02492%	552355	83.57%	79	16.53%
號	735		13	164	0.02477%	552519	83.67%	79	16.53%
夏	821		10	143	0.0216%	552662	85.65%	79	16.53%
舞	857		14	135	0.02039%	552797	86.40%	79	16.53%
優	918		17	120	0.01813%	552917	87.57%	79	16.53%
忽	920		8	120	0.01813%	553037	87.60%	79	16.53%
誠	930		13	119	0.01797%	553156	87.78%	79	16.53%
	509		14	267	0.04033%	553423	76.50%	78	16.32%
製	523		14	261	0.03942%	553684	77.06%	78	16.32%
派	725		9	167	0.02522%	553851	83.42%	78	16.32%
試	775		13	152	0.02296%	554003	84.62%	78	16.32%
案	816		10	144	0.02175%	554147	85.54%	78	16.32%
紙	846		10	137	0.02069%	554284	86.17%	78	16.32%
熟	884		15	127	0.01918%	554411	86.93%	78	16.32%
軍	465		9	297	0.04486%	554708	74.62%	77	16.11%
巴	492		4	283	0.04275%	554991	75.79%	77	16.11%
灣	562		25	236	0.03565%	555227	78.50%	77	16.11%
輪	647		15	198	0.02991%	555425	81.28%	77	16.11%
陸	688		10	181	0.02734%	555606	82.46%	77	16.11%
策	732		12	165	0.02492%	555771	83.60%	77	16.11%
佔	825		7	141	0.0213%	555912	85.73%	77	16.11%
血	834		6	139	0.021%	556051	85.92%	77	16.11%
毫	1006		11	103	0.01556%	556154	89.05%	77	16.11%
洲	502		9	275	0.04154%	556429	76.21%	76	15.90%
技	621		7	210	0.03172%	556639	80.49%	76	15.90%
燈	642		16	199	0.03006%	556838	81.13%	76	15.90%
階	678		11	187	0.02825%	557025	82.18%	76	15.90%
堂	682		11	184	0.02779%	557209	82.29%	76	15.90%
江	737		6	163	0.02462%	557372	83.72%	76	15.90%
沙	800		7	147	0.0222%	557519	85.19%	76	15.90%
涼	804		11	146	0.02205%	557665	85.28%	76	15.90%
答	841		12	138	0.02084%	557803	86.07%	76	15.90%
察	849		14	136	0.02054%	557939	86.23%	76	15.90%
遍	934		12	118	0.01782%	558057	87.86%	76	15.90%
暴	675		15	188	0.0284%	558245	82.09%	75	15.69%
	798		9	147	0.0222%	558392	85.14%	75	15.69%
迷	858		9	135	0.02039%	558527	86.42%	75	15.69%
護	904		21	124	0.01873%	558651	87.31%	75	15.69%
慮	921		15	120	0.01813%	558771	87.62%	75	15.69%
承	933		8	118	0.01782%	558889	87.84%	75	15.69%
遇	941		12	116	0.01752%	559005	87.98%	75	15.69%
概	1022		13	101	0.01526%	559106	89.30%	75	15.69%
惜	1026		11	100	0.0151%	559206	89.36%	75	15.69%
樓	689		15	180	0.02719%	559386	82.48%	74	15.48%
官	703		8	173	0.02613%	559559	82.86%	74	15.48%
登	811		12	145	0.0219%	559704	85.43%	74	15.48%
左	875		5	130	0.01964%	559834	86.76%	74	15.48%
略	900		11	124	0.01873%	559958	87.24%	74	15.48%
錯	955		16	113	0.01707%	560071	88.22%	74	15.48%
厚	956		9	112	0.01692%	560183	88.24%	74	15.48%
疑	1001		14	104	0.01571%	560287	88.97%	74	15.48%
耳	1008		6	103	0.01556%	560390	89.08%	74	15.48%
遺	1010		15	103	0.01556%	560493	89.11%	74	15.48%
秋	479		9	288	0.0435%	560781	75.23%	73	15.27%
擴	705		18	173	0.02613%	560954	82.91%	73	15.27%
源	789		13	149	0.02251%	561103	84.94%	73	15.27%
端	935		14	117	0.01767%	561220	87.87%	73	15.27%
橫	973		16	109	0.01646%	561329	88.52%	73	15.27%
街	591		12	222	0.03353%	561551	79.51%	72	15.06%
禮	652		17	196	0.02961%	561747	81.43%	72	15.06%
	692		6	178	0.02689%	561925	82.56%	72	15.06%
鐵	757		21	158	0.02387%	562083	84.20%	72	15.06%
普	779		12	151	0.02281%	562234	84.71%	72	15.06%
買	805		12	146	0.02205%	562380	85.30%	72	15.06%
互	831		4	139	0.021%	562519	85.86%	72	15.06%
田	839		5	138	0.02084%	562657	86.03%	72	15.06%
志	870		7	132	0.01994%	562789	86.66%	72	15.06%
狀	877		8	130	0.01964%	562919	86.80%	72	15.06%
範	901		15	124	0.01873%	563043	87.25%	72	15.06%
荒	906		10	123	0.01858%	563166	87.35%	72	15.06%
律	907		9	122	0.01843%	563288	87.37%	72	15.06%
干	927		3	119	0.01797%	563407	87.73%	72	15.06%
零	946		13	115	0.01737%	563522	88.07%	72	15.06%
納	993		10	106	0.01601%	563628	88.85%	72	15.06%
窗	740		12	162	0.02447%	563790	83.79%	71	14.85%
查	844		9	137	0.02069%	563927	86.13%	71	14.85%
聞	847		14	137	0.02069%	564064	86.19%	71	14.85%
潮	924		15	120	0.01813%	564184	87.68%	71	14.85%
擁	996		16	105	0.01586%	564289	88.89%	71	14.85%
童	482		12	287	0.04335%	564576	75.36%	70	14.64%
型	708		9	172	0.02598%	564748	82.99%	70	14.64%
揚	851		12	136	0.02054%	564884	86.27%	70	14.64%
默	883		16	128	0.01933%	565012	86.91%	70	14.64%
	885		7	126	0.01903%	565138	86.95%	70	14.64%
宣	886		9	126	0.01903%	565264	86.97%	70	14.64%
狂	889		7	126	0.01903%	565390	87.03%	70	14.64%
周	979		8	108	0.01631%	565498	88.62%	70	14.64%
豐	1029		18	100	0.0151%	565598	89.40%	70	14.64%
伸	1040		7	97	0.01465%	565695	89.57%	70	14.64%
儘	1125		16	86	0.01299%	565781	90.74%	70	14.64%
毛	613		4	212	0.03202%	565993	80.23%	69	14.44%
慢	709		14	172	0.02598%	566165	83.01%	69	14.44%
鬥	801		10	147	0.0222%	566312	85.21%	69	14.44%
隻	830		10	140	0.02115%	566452	85.84%	69	14.44%
欣	852		8	136	0.02054%	566588	86.30%	69	14.44%
淡	879		11	129	0.01948%	566717	86.84%	69	14.44%
課	891		15	126	0.01903%	566843	87.07%	69	14.44%
威	893		9	125	0.01888%	566968	87.10%	69	14.44%
險	936		15	117	0.01767%	567085	87.89%	69	14.44%
寂	944		11	115	0.01737%	567200	88.03%	69	14.44%
乏	950		5	113	0.01707%	567313	88.13%	69	14.44%
乾	964		11	111	0.01677%	567424	88.37%	69	14.44%
奔	967		8	110	0.01662%	567534	88.42%	69	14.44%
私	975		7	109	0.01646%	567643	88.55%	69	14.44%
穿	976		9	109	0.01646%	567752	88.57%	69	14.44%
鼓	985		13	108	0.01631%	567860	88.72%	69	14.44%
	995		12	105	0.01586%	567965	88.88%	69	14.44%
批	1017		7	102	0.01541%	568067	89.22%	69	14.44%
皮	1055		5	95	0.01435%	568162	89.79%	69	14.44%
晨	1078		11	91	0.01375%	568253	90.11%	69	14.44%
畫	580		12	228	0.03444%	568481	79.14%	68	14.23%
器	589		16	222	0.03353%	568703	79.44%	68	14.23%
弱	730		10	165	0.02492%	568868	83.55%	68	14.23%
戲	773		17	152	0.02296%	569020	84.58%	68	14.23%
頂	791		11	149	0.02251%	569169	84.99%	68	14.23%
油	817		8	144	0.02175%	569313	85.56%	68	14.23%
賞	824		15	143	0.0216%	569456	85.71%	68	14.23%
克	859		7	134	0.02024%	569590	86.44%	68	14.23%
某	988		9	107	0.01616%	569697	88.77%	68	14.23%
殘	1000		12	104	0.01571%	569801	88.96%	68	14.23%
獻	1093		20	90	0.01359%	569891	90.31%	68	14.23%
貨	460		11	300	0.04531%	570191	74.39%	67	14.02%
酒	506		10	271	0.04093%	570462	76.38%	67	14.02%
季	848		8	136	0.02054%	570598	86.21%	67	14.02%
彼	860		8	134	0.02024%	570732	86.46%	67	14.02%
麻	892		11	126	0.01903%	570858	87.09%	67	14.02%
紛	929		10	119	0.01797%	570977	87.77%	67	14.02%
況	982		8	108	0.01631%	571085	88.67%	67	14.02%
肯	1009		8	103	0.01556%	571188	89.10%	67	14.02%
昨	1069		9	92	0.0139%	571280	89.98%	67	14.02%
翻	1102		18	89	0.01344%	571369	90.43%	67	14.02%
球	557		11	238	0.03595%	571607	78.32%	66	13.81%
銀	624		14	209	0.03157%	571816	80.58%	66	13.81%
康	822		11	143	0.0216%	571959	85.67%	66	13.81%
寒	957		12	112	0.01692%	572071	88.25%	66	13.81%
欲	965		11	111	0.01677%	572182	88.39%	66	13.81%
忙	968		6	110	0.01662%	572292	88.44%	66	13.81%
莫	1019		11	102	0.01541%	572394	89.25%	66	13.81%
吹	1035		7	98	0.0148%	572492	89.49%	66	13.81%
剛	1041		10	97	0.01465%	572589	89.58%	66	13.81%
抵	1106		8	88	0.01329%	572677	90.49%	66	13.81%
掉	1139		11	85	0.01284%	572762	90.92%	66	13.81%
禁	1149		13	83	0.01254%	572845	91.05%	66	13.81%
款	752		12	159	0.02402%	573004	84.08%	65	13.60%
偉	820		11	143	0.0216%	573147	85.62%	65	13.60%
防	836		6	139	0.021%	573286	85.96%	65	13.60%
羅	856		19	135	0.02039%	573421	86.38%	65	13.60%
寶	938		20	116	0.01752%	573537	87.93%	65	13.60%
畢	970		11	110	0.01662%	573647	88.47%	65	13.60%
隔	1047		12	97	0.01465%	573744	89.67%	65	13.60%
觸	1074		20	92	0.0139%	573836	90.05%	65	13.60%
醒	1097		16	90	0.01359%	573926	90.37%	65	13.60%
席	686		10	181	0.02734%	574107	82.40%	64	13.39%
族	700		11	175	0.02643%	574282	82.78%	64	13.39%
彩	733		11	164	0.02477%	574446	83.62%	64	13.39%
乃	819		2	143	0.0216%	574589	85.60%	64	13.39%
塊	871		13	131	0.01979%	574720	86.68%	64	13.39%
室	947		9	114	0.01722%	574834	88.08%	64	13.39%
滅	992		13	106	0.01601%	574940	88.83%	64	13.39%
枝	1004		8	103	0.01556%	575043	89.02%	64	13.39%
昏	1033		8	99	0.01495%	575142	89.46%	64	13.39%
純	1045		10	97	0.01465%	575239	89.64%	64	13.39%
腦	1063		13	93	0.01405%	575332	89.90%	64	13.39%
招	1144		8	84	0.01269%	575416	90.98%	64	13.39%
頗	1151		14	83	0.01254%	575499	91.07%	64	13.39%
船	598		11	219	0.03308%	575718	79.74%	63	13.18%
移	880		11	129	0.01948%	575847	86.86%	63	13.18%
布	887		5	126	0.01903%	575973	86.99%	63	13.18%
飄	911		20	122	0.01843%	576095	87.44%	63	13.18%
廿	932		4	118	0.01782%	576213	87.82%	63	13.18%
守	943		6	115	0.01737%	576328	88.01%	63	13.18%
努	978		7	108	0.01631%	576436	88.60%	63	13.18%
衝	983		15	108	0.01631%	576544	88.68%	63	13.18%
楚	1051		13	96	0.0145%	576640	89.73%	63	13.18%
遭	1103		14	89	0.01344%	576729	90.45%	63	13.18%
抱	1128		8	86	0.01299%	576815	90.78%	63	13.18%
寧	1138		14	85	0.01284%	576900	90.91%	63	13.18%
偶	1204		11	75	0.01133%	576975	91.70%	63	13.18%
宗	395		8	357	0.05392%	577332	71.18%	62	12.97%
革	501		9	276	0.04169%	577608	76.17%	62	12.97%
系	727		7	167	0.02522%	577775	83.47%	62	12.97%
財	769		10	154	0.02326%	577929	84.48%	62	12.97%
降	984		8	108	0.01631%	578037	88.70%	62	12.97%
徵	986		15	107	0.01616%	578144	88.73%	62	12.97%
唯	1013		11	102	0.01541%	578246	89.16%	62	12.97%
睛	1038		13	98	0.0148%	578344	89.54%	62	12.97%
朝	1043		12	97	0.01465%	578441	89.61%	62	12.97%
恐	1089		10	90	0.01359%	578531	90.26%	62	12.97%
阻	1187		7	78	0.01178%	578609	91.50%	62	12.97%
仰	716		6	169	0.02553%	578778	83.19%	61	12.76%
祇	812		8	145	0.0219%	578923	85.45%	61	12.76%
孤	878		8	129	0.01948%	579052	86.82%	61	12.76%
乘	951		10	113	0.01707%	579165	88.15%	61	12.76%
跳	1064		13	93	0.01405%	579258	89.91%	61	12.76%
頓	1098		13	90	0.01359%	579348	90.38%	61	12.76%
廠	616		15	211	0.03187%	579559	80.33%	60	12.55%
醫	618		18	211	0.03187%	579770	80.39%	60	12.55%
汽	693		7	177	0.02674%	579947	82.59%	60	12.55%
岸	785		8	150	0.02266%	580097	84.85%	60	12.55%
健	977		11	108	0.01631%	580205	88.59%	60	12.55%
執	1036		11	98	0.0148%	580303	89.51%	60	12.55%
趕	1054		14	96	0.0145%	580399	89.77%	60	12.55%
貧	1059		11	94	0.0142%	580493	89.84%	60	12.55%
憶	1077		16	91	0.01375%	580584	90.09%	60	12.55%
退	1096		9	90	0.01359%	580674	90.35%	60	12.55%
週	1110		11	88	0.01329%	580762	90.54%	60	12.55%
憂	1116		15	87	0.01314%	580849	90.62%	60	12.55%
棄	1244		11	71	0.01072%	580920	92.14%	60	12.55%
氏	770		4	153	0.02311%	581073	84.51%	59	12.34%
渡	872		12	131	0.01979%	581204	86.70%	59	12.34%
玩	928		8	119	0.01797%	581323	87.75%	59	12.34%
珠	974		10	109	0.01646%	581432	88.54%	59	12.34%
尊	999		12	104	0.01571%	581536	88.94%	59	12.34%
闊	1011		17	103	0.01556%	581639	89.13%	59	12.34%
劇	1012		15	102	0.01541%	581741	89.14%	59	12.34%
右	1032		5	99	0.01495%	581840	89.45%	59	12.34%
齊	1061		14	94	0.0142%	581934	89.87%	59	12.34%
虛	1083		12	91	0.01375%	582025	90.18%	59	12.34%
升	1099		4	89	0.01344%	582114	90.39%	59	12.34%
副	1126		11	86	0.01299%	582200	90.75%	59	12.34%
折	1143		7	84	0.01269%	582284	90.97%	59	12.34%
陰	1169		10	80	0.01208%	582364	91.29%	59	12.34%
勵	1175		17	78	0.01178%	582442	91.36%	59	12.34%
危	588		6	222	0.03353%	582664	79.41%	58	12.13%
爾	722		14	168	0.02538%	582832	83.35%	58	12.13%
蘭	767		21	155	0.02341%	582987	84.44%	58	12.13%
輸	783		16	151	0.02281%	583138	84.81%	58	12.13%
省	866		9	133	0.02009%	583271	86.58%	58	12.13%
群	940		13	116	0.01752%	583387	87.96%	58	12.13%
巨	953		5	113	0.01707%	583500	88.19%	58	12.13%
混	1053		11	96	0.0145%	583596	89.76%	58	12.13%
曲	1079		6	91	0.01375%	583687	90.12%	58	12.13%
寬	1112		15	87	0.01314%	583774	90.57%	58	12.13%
揮	1118		12	87	0.01314%	583861	90.65%	58	12.13%
漫	1166		14	80	0.01208%	583941	91.25%	58	12.13%
脫	1186		11	78	0.01178%	584019	91.49%	58	12.13%
爛	1199		21	76	0.01148%	584095	91.64%	58	12.13%
鮮	1212		17	75	0.01133%	584170	91.79%	58	12.13%
藍	1220		18	74	0.01118%	584244	91.88%	58	12.13%
藉	1233		18	72	0.01088%	584316	92.02%	58	12.13%
藝	590		19	222	0.03353%	584538	79.48%	57	11.92%
祖	818		9	144	0.02175%	584682	85.58%	57	11.92%
材	945		7	115	0.01737%	584797	88.05%	57	11.92%
聖	949		13	114	0.01722%	584911	88.12%	57	11.92%
孔	1003		4	103	0.01556%	585014	89.00%	57	11.92%
鐘	1025		20	101	0.01526%	585115	89.34%	57	11.92%
班	1028		10	100	0.0151%	585215	89.39%	57	11.92%
潔	1080		15	91	0.01375%	585306	90.14%	57	11.92%
宜	1111		8	87	0.01314%	585393	90.55%	57	11.92%
慣	1115		14	87	0.01314%	585480	90.61%	57	11.92%
窮	1121		15	87	0.01314%	585567	90.69%	57	11.92%
末	1180		5	78	0.01178%	585645	91.42%	57	11.92%
哀	1188		9	77	0.01163%	585722	91.52%	57	11.92%
壯	1241		7	71	0.01072%	585793	92.11%	57	11.92%
妙	1249		7	70	0.01057%	585863	92.19%	57	11.92%
戶	888		4	126	0.01903%	585989	87.01%	56	11.72%
淚	914		11	121	0.01828%	586110	87.49%	56	11.72%
睡	948		14	114	0.01722%	586224	88.10%	56	11.72%
陳	997		10	105	0.01586%	586329	88.91%	56	11.72%
雄	1060		12	94	0.0142%	586423	89.86%	56	11.72%
序	1088		7	90	0.01359%	586513	90.24%	56	11.72%
傾	1105		13	88	0.01329%	586601	90.47%	56	11.72%
幹	1127		13	86	0.01299%	586687	90.76%	56	11.72%
踏	1173		15	79	0.01193%	586766	91.34%	56	11.72%
濃	1207		16	75	0.01133%	586841	91.73%	56	11.72%
魚	665		11	190	0.0287%	587031	81.81%	55	11.51%
俗	787		9	149	0.02251%	587180	84.90%	55	11.51%
隊	796		11	148	0.02235%	587328	85.10%	55	11.51%
徒	803		10	146	0.02205%	587474	85.25%	55	11.51%
亡	937		3	116	0.01752%	587590	87.91%	55	11.51%
藥	954		19	113	0.01707%	587703	88.20%	55	11.51%
率	961		11	112	0.01692%	587815	88.32%	55	11.51%
冬	972		5	109	0.01646%	587924	88.50%	55	11.51%
抗	1021		7	101	0.01526%	588025	89.28%	55	11.51%
趨	1046		17	97	0.01465%	588122	89.66%	55	11.51%
檢	1070		17	92	0.0139%	588214	90.00%	55	11.51%
逃	1123		9	87	0.01314%	588301	90.71%	55	11.51%
域	1164		11	80	0.01208%	588381	91.23%	55	11.51%
博	778		12	151	0.02281%	588532	84.69%	54	11.30%
歐	828		15	141	0.0213%	588673	85.80%	54	11.30%
店	913		8	121	0.01828%	588794	87.48%	54	11.30%
髮	942		15	116	0.01752%	588910	88.00%	54	11.30%
架	1005		9	103	0.01556%	589013	89.04%	54	11.30%
	1037		8	98	0.0148%	589111	89.52%	54	11.30%
彷	1048		7	96	0.0145%	589207	89.68%	54	11.30%
彿	1049		8	96	0.0145%	589303	89.70%	54	11.30%
沿	1071		8	92	0.0139%	589395	90.01%	54	11.30%
罷	1073		15	92	0.0139%	589487	90.04%	54	11.30%
	1082		13	91	0.01375%	589578	90.16%	54	11.30%
圓	1086		13	90	0.01359%	589668	90.22%	54	11.30%
幕	1114		14	87	0.01314%	589755	90.59%	54	11.30%
染	1181		9	78	0.01178%	589833	91.43%	54	11.30%
巧	1288		5	66	0.009969%	589899	92.60%	54	11.30%
映	1326		9	62	0.009365%	589961	92.96%	54	11.30%
阿	505		7	272	0.04108%	590233	76.34%	53	11.09%
裡	669		12	189	0.02855%	590422	81.92%	53	11.09%
訓	909		10	122	0.01843%	590544	87.40%	53	11.09%
練	916		15	121	0.01828%	590665	87.53%	53	11.09%
皆	1007		9	103	0.01556%	590768	89.07%	53	11.09%
跑	1020		12	102	0.01541%	590870	89.27%	53	11.09%
鬧	1057		15	95	0.01435%	590965	89.81%	53	11.09%
蓋	1141		14	85	0.01284%	591050	90.94%	53	11.09%
碎	1163		13	81	0.01223%	591131	91.22%	53	11.09%
謀	1171		16	79	0.01193%	591210	91.31%	53	11.09%
暖	1191		13	77	0.01163%	591287	91.55%	53	11.09%
憑	1195		16	76	0.01148%	591363	91.60%	53	11.09%
藏	1202		18	76	0.01148%	591439	91.68%	53	11.09%
縱	1224		17	73	0.01103%	591512	91.92%	53	11.09%
索	1292		10	66	0.009969%	591578	92.64%	53	11.09%
跡	1294		13	66	0.009969%	591644	92.66%	53	11.09%
緣	1304		15	65	0.009818%	591709	92.75%	53	11.09%
雪	910		11	122	0.01843%	591831	87.42%	52	10.88%
射	958		10	112	0.01692%	591943	88.27%	52	10.88%
床	980		7	108	0.01631%	592051	88.64%	52	10.88%
諸	1142		15	85	0.01284%	592136	90.96%	52	10.88%
縮	1150		17	83	0.01254%	592219	91.06%	52	10.88%
飯	1153		12	83	0.01254%	592302	91.10%	52	10.88%
探	1160		11	81	0.01223%	592383	91.18%	52	10.88%
握	1190		12	77	0.01163%	592460	91.54%	52	10.88%
蒼	1193		14	77	0.01163%	592537	91.57%	52	10.88%
浮	1231		10	72	0.01088%	592609	92.00%	52	10.88%
束	1250		7	70	0.01057%	592679	92.20%	52	10.88%
婦	743		11	160	0.02417%	592839	83.87%	51	10.67%
祗	939		9	116	0.01752%	592955	87.94%	51	10.67%
洗	1018		9	102	0.01541%	593057	89.24%	51	10.67%
章	1056		11	95	0.01435%	593152	89.80%	51	10.67%
智	1058		12	94	0.0142%	593246	89.83%	51	10.67%
擠	1068		17	92	0.0139%	593338	89.97%	51	10.67%
損	1119		13	87	0.01314%	593425	90.66%	51	10.67%
閃	1145		10	84	0.01269%	593509	91.00%	51	10.67%
君	1205		7	75	0.01133%	593584	91.71%	51	10.67%
輝	1237		15	72	0.01088%	593656	92.07%	51	10.67%
勇	1248		9	70	0.01057%	593726	92.18%	51	10.67%
躍	1272		21	68	0.01027%	593794	92.43%	51	10.67%
遲	1286		15	67	0.01012%	593861	92.58%	51	10.67%
忍	1308		7	64	0.009667%	593925	92.79%	51	10.67%
幼	792		5	148	0.02235%	594073	85.01%	50	10.46%
督	840		13	138	0.02084%	594211	86.05%	50	10.46%
王	915		4	121	0.01828%	594332	87.51%	50	10.46%
李	987		7	107	0.01616%	594439	88.75%	50	10.46%
崇	991		11	106	0.01601%	594545	88.81%	50	10.46%
茫	994		10	106	0.01601%	594651	88.86%	50	10.46%
額	1031		18	100	0.0151%	594751	89.43%	50	10.46%
朵	1050		6	96	0.0145%	594847	89.71%	50	10.46%
板	1140		8	85	0.01284%	594932	90.93%	50	10.46%
套	1154		10	82	0.01239%	595014	91.11%	50	10.46%
煩	1155		13	82	0.01239%	595096	91.12%	50	10.46%
休	1174		6	78	0.01178%	595174	91.35%	50	10.46%
釋	1209		20	75	0.01133%	595249	91.76%	50	10.46%
幫	1222		17	73	0.01103%	595322	91.90%	50	10.46%
幻	1243		4	71	0.01072%	595393	92.13%	50	10.46%
刺	1257		8	69	0.01042%	595462	92.28%	50	10.46%
朗	1260		10	69	0.01042%	595531	92.31%	50	10.46%
稍	1285		12	67	0.01012%	595598	92.57%	50	10.46%
絲	1293		12	66	0.009969%	595664	92.65%	50	10.46%
詞	1334		12	62	0.009365%	595726	93.04%	50	10.46%
弟	793		7	148	0.02235%	595874	85.03%	49	10.25%
尼	864		5	133	0.02009%	596007	86.54%	49	10.25%
	902		14	124	0.01873%	596131	87.27%	49	10.25%
遷	1030		14	100	0.0151%	596231	89.42%	49	10.25%
盤	1131		15	86	0.01299%	596317	90.82%	49	10.25%
複	1246		14	71	0.01072%	596388	92.16%	49	10.25%
迅	1273		6	68	0.01027%	596456	92.44%	49	10.25%
旋	1282		11	67	0.01012%	596523	92.53%	49	10.25%
擺	1301		18	65	0.009818%	596588	92.72%	49	10.25%
宇	768		6	154	0.02326%	596742	84.46%	48	10.04%
橋	780		16	151	0.02281%	596893	84.74%	48	10.04%
謝	963		17	112	0.01692%	597005	88.36%	48	10.04%
封	1066		9	92	0.0139%	597097	89.94%	48	10.04%
寄	1087		11	90	0.01359%	597187	90.23%	48	10.04%
牛	1108		4	88	0.01329%	597275	90.51%	48	10.04%
啟	1136		11	85	0.01284%	597360	90.88%	48	10.04%
佳	1203		8	75	0.01133%	597435	91.69%	48	10.04%
幅	1242		12	71	0.01072%	597506	92.12%	48	10.04%
倍	1247		10	70	0.01057%	597576	92.17%	48	10.04%
隱	1275		16	68	0.01027%	597644	92.46%	48	10.04%
介	1296		4	65	0.009818%	597709	92.68%	48	10.04%
疏	1303		11	65	0.009818%	597774	92.74%	48	10.04%
含	1307		7	64	0.009667%	597838	92.78%	48	10.04%
哥	612		10	212	0.03202%	598050	80.20%	47	9.83%
敬	750		13	159	0.02402%	598209	84.04%	47	9.83%
股	962		8	112	0.01692%	598321	88.34%	47	9.83%
授	981		11	108	0.01631%	598429	88.65%	47	9.83%
館	998		16	105	0.01586%	598534	88.93%	47	9.83%
緩	1081		15	91	0.01375%	598625	90.15%	47	9.83%
訂	1156		9	82	0.01239%	598707	91.13%	47	9.83%
賣	1208		15	75	0.01133%	598782	91.74%	47	9.83%
按	1228		9	72	0.01088%	598854	91.97%	47	9.83%
奮	1278		16	67	0.01012%	598921	92.49%	47	9.83%
距	1316		12	64	0.009667%	598985	92.87%	47	9.83%
懂	1318		17	63	0.009516%	599048	92.89%	47	9.83%
遙	1320		13	63	0.009516%	599111	92.91%	47	9.83%
悠	1364		11	59	0.008912%	599170	93.31%	47	9.83%
薄	1369		17	59	0.008912%	599229	93.36%	47	9.83%
億	754		15	158	0.02387%	599387	84.13%	46	9.62%
尺	919		4	120	0.01813%	599507	87.59%	46	9.62%
倫	931		10	118	0.01782%	599625	87.80%	46	9.62%
州	1016		6	102	0.01541%	599727	89.21%	46	9.62%
廈	1067		13	92	0.0139%	599819	89.96%	46	9.62%
泥	1107		8	88	0.01329%	599907	90.50%	46	9.62%
尖	1113		6	87	0.01314%	599994	90.58%	46	9.62%
爬	1130		8	86	0.01299%	600080	90.80%	46	9.62%
敗	1161		11	81	0.01223%	600161	91.19%	46	9.62%
斜	1162		11	81	0.01223%	600242	91.21%	46	9.62%
甘	1167		5	80	0.01208%	600322	91.27%	46	9.62%
掌	1206		12	75	0.01133%	600397	91.72%	46	9.62%
餐	1211		16	75	0.01133%	600472	91.78%	46	9.62%
堆	1215		11	74	0.01118%	600546	91.82%	46	9.62%
游	1218		12	74	0.01118%	600620	91.86%	46	9.62%
典	1240		8	71	0.01072%	600691	92.10%	46	9.62%
陷	1255		10	70	0.01057%	600761	92.26%	46	9.62%
錄	1274		16	68	0.01027%	600829	92.45%	46	9.62%
疾	1284		10	67	0.01012%	600896	92.56%	46	9.62%
擇	1290		16	66	0.009969%	600962	92.62%	46	9.62%
掛	1309		11	64	0.009667%	601026	92.80%	46	9.62%
覆	1314		18	64	0.009667%	601090	92.85%	46	9.62%
順	1321		12	63	0.009516%	601153	92.92%	46	9.62%
蘇	639		20	201	0.03036%	601354	81.04%	45	9.41%
鳥	663		11	191	0.02885%	601545	81.75%	45	9.41%
牌	925		12	120	0.01813%	601665	87.69%	45	9.41%
坡	1137		8	85	0.01284%	601750	90.89%	45	9.41%
殺	1182		11	78	0.01178%	601828	91.44%	45	9.41%
訪	1234		11	72	0.01088%	601900	92.03%	45	9.41%
秘	1253		10	70	0.01057%	601970	92.24%	45	9.41%
悶	1269		12	68	0.01027%	602038	92.40%	45	9.41%
誤	1315		14	64	0.009667%	602102	92.86%	45	9.41%
厭	1349		14	60	0.009063%	602162	93.18%	45	9.41%
泛	1412		8	55	0.008308%	602217	93.73%	45	9.41%
喚	1419		12	54	0.008157%	602271	93.79%	45	9.41%
兼	1437		10	52	0.007854%	602323	93.93%	45	9.41%
黨	640		20	200	0.03021%	602523	81.07%	44	9.21%
霧	765		19	156	0.02356%	602679	84.39%	44	9.21%
植	827		12	141	0.0213%	602820	85.77%	44	9.21%
票	1062		11	93	0.01405%	602913	89.89%	44	9.21%
針	1084		10	91	0.01375%	603004	90.19%	44	9.21%
措	1117		11	87	0.01314%	603091	90.63%	44	9.21%
粉	1132		10	86	0.01299%	603177	90.83%	44	9.21%
顆	1152		17	83	0.01254%	603260	91.08%	44	9.21%
購	1157		17	82	0.01239%	603342	91.15%	44	9.21%
磨	1184		16	78	0.01178%	603420	91.47%	44	9.21%
叢	1258		18	69	0.01042%	603489	92.29%	44	9.21%
擔	1281		16	67	0.01012%	603556	92.52%	44	9.21%
幽	1324		9	62	0.009365%	603618	92.95%	44	9.21%
弄	1338		7	61	0.009214%	603679	93.08%	44	9.21%
徑	1339		10	61	0.009214%	603740	93.09%	44	9.21%
舒	1344		12	61	0.009214%	603801	93.13%	44	9.21%
擬	1380		17	58	0.008761%	603859	93.45%	44	9.21%
騰	1389		20	58	0.008761%	603917	93.53%	44	9.21%
延	1403		8	56	0.008459%	603973	93.65%	44	9.21%
埋	1422		10	54	0.008157%	604027	93.81%	44	9.21%
銷	989		15	107	0.01616%	604134	88.78%	43	9.00%
牆	1023		17	101	0.01526%	604235	89.31%	43	9.00%
	1092		10	90	0.01359%	604325	90.30%	43	9.00%
硬	1120		12	87	0.01314%	604412	90.67%	43	9.00%
潤	1148		15	83	0.01254%	604495	91.03%	43	9.00%
偏	1170		11	79	0.01193%	604574	91.30%	43	9.00%
控	1229		11	72	0.01088%	604646	91.98%	43	9.00%
煙	1252		13	70	0.01057%	604716	92.23%	43	9.00%
培	1259		11	69	0.01042%	604785	92.30%	43	9.00%
拍	1270		8	68	0.01027%	604853	92.41%	43	9.00%
顏	1295		18	66	0.009969%	604919	92.67%	43	9.00%
扶	1300		7	65	0.009818%	604984	92.71%	43	9.00%
憐	1353		15	60	0.009063%	605044	93.21%	43	9.00%
抽	1379		8	58	0.008761%	605102	93.44%	43	9.00%
醉	1388		15	58	0.008761%	605160	93.52%	43	9.00%
殊	1396		10	57	0.00861%	605217	93.59%	43	9.00%
蕩	1405		16	56	0.008459%	605273	93.67%	43	9.00%
奉	1440		8	52	0.007854%	605325	93.95%	43	9.00%
番	1446		12	52	0.007854%	605377	94.00%	43	9.00%
愁	1491		13	48	0.00725%	605425	94.34%	43	9.00%
湖	701		12	175	0.02643%	605600	82.80%	42	8.79%
帝	755		9	158	0.02387%	605758	84.15%	42	8.79%
屆	990		8	106	0.01601%	605864	88.80%	42	8.79%
壁	1014		16	102	0.01541%	605966	89.17%	42	8.79%
愈	1027		13	100	0.0151%	606066	89.37%	42	8.79%
警	1039		20	98	0.0148%	606164	89.55%	42	8.79%
刊	1075		5	91	0.01375%	606255	90.07%	42	8.79%
測	1147		12	83	0.01254%	606338	91.02%	42	8.79%
戀	1159		23	81	0.01223%	606419	91.17%	42	8.79%
飲	1210		12	75	0.01133%	606494	91.77%	42	8.79%
估	1239		7	71	0.01072%	606565	92.09%	42	8.79%
辛	1372		7	59	0.008912%	606624	93.38%	42	8.79%
拋	1425		8	54	0.008157%	606678	93.83%	42	8.79%
枯	1426		9	54	0.008157%	606732	93.84%	42	8.79%
悉	1450		11	51	0.007703%	606783	94.03%	42	8.79%
逝	1472		10	50	0.007552%	606833	94.20%	42	8.79%
仔	1002		5	103	0.01556%	606936	88.99%	41	8.58%
竹	1185		6	78	0.01178%	607014	91.48%	41	8.58%
閒	1221		12	74	0.01118%	607088	91.89%	41	8.58%
評	1254		12	70	0.01057%	607158	92.25%	41	8.58%
偷	1266		11	68	0.01027%	607226	92.37%	41	8.58%
慘	1299		14	65	0.009818%	607291	92.70%	41	8.58%
灰	1319		6	63	0.009516%	607354	92.90%	41	8.58%
寞	1337		14	61	0.009214%	607415	93.07%	41	8.58%
籍	1368		20	59	0.008912%	607474	93.35%	41	8.58%
慰	1393		15	57	0.00861%	607531	93.57%	41	8.58%
貢	1430		10	54	0.008157%	607585	93.88%	41	8.58%
肉	1095		6	90	0.01359%	607675	90.34%	40	8.37%
武	1197		8	76	0.01148%	607751	91.62%	40	8.37%
菜	1225		12	73	0.01103%	607824	91.93%	40	8.37%
鬼	1238		10	72	0.01088%	607896	92.08%	40	8.37%
伴	1265		7	68	0.01027%	607964	92.36%	40	8.37%
夕	1277		3	67	0.01012%	608031	92.48%	40	8.37%
兵	1322		7	62	0.009365%	608093	92.93%	40	8.37%
龐	1335		19	62	0.009365%	608155	93.05%	40	8.37%
績	1384		17	58	0.008761%	608213	93.49%	40	8.37%
柔	1395		9	57	0.00861%	608270	93.58%	40	8.37%
骨	1418		10	55	0.008308%	608325	93.78%	40	8.37%
廢	1424		15	54	0.008157%	608379	93.83%	40	8.37%
詳	1429		13	54	0.008157%	608433	93.87%	40	8.37%
暫	1479		15	49	0.007401%	608482	94.25%	40	8.37%
添	1495		11	48	0.00725%	608530	94.37%	40	8.37%
耀	1499		20	48	0.00725%	608578	94.40%	40	8.37%
皇	1024		9	101	0.01526%	608679	89.33%	39	8.16%
篇	1122		15	87	0.01314%	608766	90.70%	39	8.16%
鎮	1226		18	73	0.01103%	608839	91.95%	39	8.16%
冰	1276		6	67	0.01012%	608906	92.47%	39	8.16%
猛	1302		11	65	0.009818%	608971	92.73%	39	8.16%
陶	1305		10	65	0.009818%	609036	92.76%	39	8.16%
播	1310		15	64	0.009667%	609100	92.81%	39	8.16%
烏	1341		10	61	0.009214%	609161	93.10%	39	8.16%
舍	1343		8	61	0.009214%	609222	93.12%	39	8.16%
哪	1350		10	60	0.009063%	609282	93.19%	39	8.16%
繞	1358		18	60	0.009063%	609342	93.26%	39	8.16%
塞	1411		13	55	0.008308%	609397	93.72%	39	8.16%
垂	1421		9	54	0.008157%	609451	93.80%	39	8.16%
聚	1435		14	53	0.008005%	609504	93.92%	39	8.16%
愉	1451		12	51	0.007703%	609555	94.04%	39	8.16%
燦	1482		17	49	0.007401%	609604	94.28%	39	8.16%
嘆	1505		14	47	0.007099%	609651	94.44%	39	8.16%
疲	1509		10	47	0.007099%	609698	94.47%	39	8.16%
鄰	1531		14	46	0.006948%	609744	94.62%	39	8.16%
艱	1608		17	41	0.006193%	609785	95.12%	39	8.16%
伯	807		7	145	0.0219%	609930	85.34%	38	7.95%
慈	969		13	110	0.01662%	610040	88.46%	38	7.95%
輛	1034		15	99	0.01495%	610139	89.48%	38	7.95%
租	1072		10	92	0.0139%	610231	90.02%	38	7.95%
拜	1090		9	90	0.01359%	610321	90.27%	38	7.95%
鏡	1264		19	69	0.01042%	610390	92.35%	38	7.95%
袖	1345		10	61	0.009214%	610451	93.14%	38	7.95%
凝	1348		16	60	0.009063%	610511	93.17%	38	7.95%
毀	1354		13	60	0.009063%	610571	93.22%	38	7.95%
符	1357		11	60	0.009063%	610631	93.25%	38	7.95%
珍	1366		9	59	0.008912%	610690	93.33%	38	7.95%
淺	1382		11	58	0.008761%	610748	93.47%	38	7.95%
借	1408		10	55	0.008308%	610803	93.69%	38	7.95%
售	1439		11	52	0.007854%	610855	93.95%	38	7.95%
紹	1447		11	52	0.007854%	610907	94.01%	38	7.95%
讚	1458		26	51	0.007703%	610958	94.09%	38	7.95%
豪	1487		14	49	0.007401%	611007	94.31%	38	7.95%
伏	1489		6	48	0.00725%	611055	94.33%	38	7.95%
掩	1492		11	48	0.00725%	611103	94.35%	38	7.95%
堪	1581		12	42	0.006344%	611145	94.95%	38	7.95%
茶	713		10	172	0.02598%	611317	83.12%	37	7.74%
牙	960		4	112	0.01692%	611429	88.30%	37	7.74%
仙	966		5	110	0.01662%	611539	88.41%	37	7.74%
呀	1214		7	74	0.01118%	611613	91.81%	37	7.74%
閉	1347		11	61	0.009214%	611674	93.16%	37	7.74%
丁	1373		2	58	0.008761%	611732	93.39%	37	7.74%
沖	1397		7	57	0.00861%	611789	93.60%	37	7.74%
恨	1442		9	52	0.007854%	611841	93.97%	37	7.74%
賴	1448		16	52	0.007854%	611893	94.02%	37	7.74%
嘴	1449		15	51	0.007703%	611944	94.03%	37	7.74%
蒙	1456		14	51	0.007703%	611995	94.08%	37	7.74%
塵	1464		14	50	0.007552%	612045	94.14%	37	7.74%
撥	1469		15	50	0.007552%	612095	94.18%	37	7.74%
嘗	1477		14	49	0.007401%	612144	94.24%	37	7.74%
編	1498		15	48	0.00725%	612192	94.39%	37	7.74%
湧	1566		12	43	0.006495%	612235	94.86%	37	7.74%
稅	668		12	189	0.02855%	612424	81.89%	36	7.53%
敦	908		12	122	0.01843%	612546	87.38%	36	7.53%
漢	923		14	120	0.01813%	612666	87.66%	36	7.53%
胞	1200		9	76	0.01148%	612742	91.65%	36	7.53%
搭	1230		13	72	0.01088%	612814	91.99%	36	7.53%
戴	1289		17	66	0.009969%	612880	92.61%	36	7.53%
拖	1340		8	61	0.009214%	612941	93.09%	36	7.53%
籌	1367		20	59	0.008912%	613000	93.34%	36	7.53%
貼	1371		12	59	0.008912%	613059	93.37%	36	7.53%
衰	1385		10	58	0.008761%	613117	93.50%	36	7.53%
摸	1443		14	52	0.007854%	613169	93.98%	36	7.53%
輔	1459		14	51	0.007703%	613220	94.10%	36	7.53%
坦	1463		8	50	0.007552%	613270	94.13%	36	7.53%
倦	1476		10	49	0.007401%	613319	94.23%	36	7.53%
甜	1484		11	49	0.007401%	613368	94.29%	36	7.53%
冒	1560		9	43	0.006495%	613411	94.82%	36	7.53%
酷	1574		14	43	0.006495%	613454	94.91%	36	7.53%
尾	1599		7	41	0.006193%	613495	95.07%	36	7.53%
粗	1607		11	41	0.006193%	613536	95.12%	36	7.53%
署	1101		13	89	0.01344%	613625	90.42%	35	7.32%
駛	1146		15	84	0.01269%	613709	91.01%	35	7.32%
賽	1236		17	72	0.01088%	613781	92.05%	35	7.32%
滴	1261		14	69	0.01042%	613850	92.32%	35	7.32%
婚	1267		11	68	0.01027%	613918	92.38%	35	7.32%
姿	1400		9	56	0.008459%	613974	93.63%	35	7.32%
米	1428		6	54	0.008157%	614028	93.86%	35	7.32%
械	1452		11	51	0.007703%	614079	94.05%	35	7.32%
魂	1462		14	51	0.007703%	614130	94.13%	35	7.32%
慨	1478		12	49	0.007401%	614179	94.25%	35	7.32%
祝	1511		9	47	0.007099%	614226	94.49%	35	7.32%
滋	1523		12	46	0.006948%	614272	94.57%	35	7.32%
鬱	1541		29	45	0.006797%	614317	94.69%	35	7.32%
稀	1556		12	44	0.006646%	614361	94.79%	35	7.32%
迴	1573		9	43	0.006495%	614404	94.90%	35	7.32%
勤	1577		13	42	0.006344%	614446	94.93%	35	7.32%
吐	1579		6	42	0.006344%	614488	94.94%	35	7.32%
抑	1582		7	42	0.006344%	614530	94.96%	35	7.32%
辭	1611		19	41	0.006193%	614571	95.14%	35	7.32%
汗	1617		6	40	0.006042%	614611	95.18%	35	7.32%
于	863		3	133	0.02009%	614744	86.52%	34	7.11%
塘	952		13	113	0.01707%	614857	88.17%	34	7.11%
洞	1052		9	96	0.0145%	614953	89.74%	34	7.11%
濕	1100		17	89	0.01344%	615042	90.41%	34	7.11%
碼	1168		15	80	0.01208%	615122	91.28%	34	7.11%
嶺	1178		17	78	0.01178%	615200	91.40%	34	7.11%
航	1201		10	76	0.01148%	615276	91.67%	34	7.11%
兄	1287		5	66	0.009969%	615342	92.59%	34	7.11%
莊	1332		11	62	0.009365%	615404	93.02%	34	7.11%
競	1356		20	60	0.009063%	615464	93.24%	34	7.11%
赤	1359		7	60	0.009063%	615524	93.27%	34	7.11%
侵	1361		9	59	0.008912%	615583	93.29%	34	7.11%
召	1362		5	59	0.008912%	615642	93.29%	34	7.11%
奪	1423		14	54	0.008157%	615696	93.82%	34	7.11%
郊	1460		8	51	0.007703%	615747	94.11%	34	7.11%
怒	1467		9	50	0.007552%	615797	94.16%	34	7.11%
秀	1485		7	49	0.007401%	615846	94.30%	34	7.11%
涉	1494		10	48	0.00725%	615894	94.36%	34	7.11%
繫	1526		19	46	0.006948%	615940	94.59%	34	7.11%
勉	1546		9	44	0.006646%	615984	94.73%	34	7.11%
怨	1563		9	43	0.006495%	616027	94.84%	34	7.11%
肩	1666		8	38	0.00574%	616065	95.47%	34	7.11%
狗	1044		8	97	0.01465%	616162	89.63%	33	6.90%
儀	1085		15	90	0.01359%	616252	90.20%	33	6.90%
企	1134		6	85	0.01284%	616337	90.85%	33	6.90%
燒	1183		16	78	0.01178%	616415	91.46%	33	6.90%
森	1192		12	77	0.01163%	616492	91.56%	33	6.90%
漁	1198		14	76	0.01148%	616568	91.63%	33	6.90%
罪	1219		13	74	0.01118%	616642	91.87%	33	6.90%
彈	1268		15	68	0.01027%	616710	92.39%	33	6.90%
淨	1329		11	62	0.009365%	616772	92.99%	33	6.90%
輩	1386		15	58	0.008761%	616830	93.51%	33	6.90%
雅	1406		12	56	0.008459%	616886	93.68%	33	6.90%
倘	1431		10	53	0.008005%	616939	93.88%	33	6.90%
駕	1473		15	50	0.007552%	616989	94.21%	33	6.90%
礎	1496		18	48	0.00725%	617037	94.38%	33	6.90%
灌	1524		21	46	0.006948%	617083	94.58%	33	6.90%
詢	1529		13	46	0.006948%	617129	94.61%	33	6.90%
析	1535		8	45	0.006797%	617174	94.65%	33	6.90%
呆	1547		7	44	0.006646%	617218	94.73%	33	6.90%
舟	1557		6	44	0.006646%	617262	94.80%	33	6.90%
漠	1585		14	42	0.006344%	617304	94.98%	33	6.90%
振	1639		10	39	0.005891%	617343	95.31%	33	6.90%
驅	1674		21	38	0.00574%	617381	95.51%	33	6.90%
澈	1731		14	35	0.005287%	617416	95.82%	33	6.90%
喝	926		12	119	0.01797%	617535	87.71%	32	6.70%
匆	1227		5	72	0.01088%	617607	91.96%	32	6.70%
障	1256		13	70	0.01057%	617677	92.27%	32	6.70%
澤	1262		16	69	0.01042%	617746	92.33%	32	6.70%
奏	1317		9	63	0.009516%	617809	92.88%	32	6.70%
仁	1360		4	59	0.008912%	617868	93.28%	32	6.70%
鳴	1390		14	58	0.008761%	617926	93.54%	32	6.70%
泊	1404		8	56	0.008459%	617982	93.66%	32	6.70%
剩	1432		12	53	0.008005%	618035	93.89%	32	6.70%
撫	1508		15	47	0.007099%	618082	94.46%	32	6.70%
耐	1512		9	47	0.007099%	618129	94.49%	32	6.70%
震	1515		15	47	0.007099%	618176	94.51%	32	6.70%
旦	1521		5	46	0.006948%	618222	94.56%	32	6.70%
贊	1530		19	46	0.006948%	618268	94.62%	32	6.70%
操	1550		16	44	0.006646%	618312	94.75%	32	6.70%
墨	1561		15	43	0.006495%	618355	94.83%	32	6.70%
掃	1565		11	43	0.006495%	618398	94.85%	32	6.70%
猶	1568		12	43	0.006495%	618441	94.87%	32	6.70%
齡	1576		20	43	0.006495%	618484	94.92%	32	6.70%
濤	1619		17	40	0.006042%	618524	95.19%	32	6.70%
翠	1625		14	40	0.006042%	618564	95.23%	32	6.70%
悅	1724		10	35	0.005287%	618599	95.79%	32	6.70%
牠	756		7	158	0.02387%	618757	84.18%	31	6.49%
滑	1091		13	90	0.01359%	618847	90.29%	31	6.49%
炎	1245		8	71	0.01072%	618918	92.15%	31	6.49%
援	1280		12	67	0.01012%	618985	92.51%	31	6.49%
妹	1323		8	62	0.009365%	619047	92.94%	31	6.49%
籠	1331		22	62	0.009365%	619109	93.01%	31	6.49%
匯	1410		13	55	0.008308%	619164	93.71%	31	6.49%
申	1470		5	50	0.007552%	619214	94.19%	31	6.49%
闢	1501		21	48	0.00725%	619262	94.41%	31	6.49%
忠	1506		8	47	0.007099%	619309	94.45%	31	6.49%
循	1518		12	46	0.006948%	619355	94.53%	31	6.49%
拔	1520		8	46	0.006948%	619401	94.55%	31	6.49%
丈	1543		3	44	0.006646%	619445	94.71%	31	6.49%
抬	1564		8	43	0.006495%	619488	94.85%	31	6.49%
胸	1589		10	42	0.006344%	619530	95.01%	31	6.49%
畔	1606		10	41	0.006193%	619571	95.11%	31	6.49%
襲	1609		22	41	0.006193%	619612	95.13%	31	6.49%
挺	1616		10	40	0.006042%	619652	95.17%	31	6.49%
喪	1634		12	39	0.005891%	619691	95.28%	31	6.49%
盪	1643		17	39	0.005891%	619730	95.33%	31	6.49%
屈	1653		8	38	0.00574%	619768	95.39%	31	6.49%
渴	1763		12	34	0.005136%	619802	95.99%	31	6.49%
驕	1769		22	34	0.005136%	619836	96.02%	31	6.49%
災	718		7	169	0.02553%	620005	83.24%	30	6.28%
京	1104		8	88	0.01329%	620093	90.46%	30	6.28%
哲	1176		10	78	0.01178%	620171	91.37%	30	6.28%
填	1363		13	59	0.008912%	620230	93.30%	30	6.28%
獎	1375		15	58	0.008761%	620288	93.41%	30	6.28%
姑	1392		8	57	0.00861%	620345	93.56%	30	6.28%
圈	1420		11	54	0.008157%	620399	93.79%	30	6.28%
哩	1438		10	52	0.007854%	620451	93.94%	30	6.28%
犯	1445		5	52	0.007854%	620503	93.99%	30	6.28%
	1475		7	49	0.007401%	620552	94.22%	30	6.28%
瞭	1510		17	47	0.007099%	620599	94.48%	30	6.28%
緻	1525		15	46	0.006948%	620645	94.58%	30	6.28%
撲	1534		15	45	0.006797%	620690	94.65%	30	6.28%
准	1545		10	44	0.006646%	620734	94.72%	30	6.28%
衡	1590		16	42	0.006344%	620776	95.01%	30	6.28%
魔	1632		21	40	0.006042%	620816	95.27%	30	6.28%
茲	1645		10	39	0.005891%	620855	95.35%	30	6.28%
鑽	1647		27	39	0.005891%	620894	95.36%	30	6.28%
攻	1658		7	38	0.00574%	620932	95.42%	30	6.28%
	1662		13	38	0.00574%	620970	95.44%	30	6.28%
飽	1673		13	38	0.00574%	621008	95.51%	30	6.28%
拾	1682		9	37	0.005589%	621045	95.56%	30	6.28%
辯	1720		21	36	0.005438%	621081	95.77%	30	6.28%
刀	1745		2	34	0.005136%	621115	95.90%	30	6.28%
娛	1015		10	102	0.01541%	621217	89.19%	29	6.07%
婆	1042		11	97	0.01465%	621314	89.60%	29	6.07%
盾	1094		9	90	0.01359%	621404	90.33%	29	6.07%
胡	1133		9	86	0.01299%	621490	90.84%	29	6.07%
谷	1235		7	72	0.01088%	621562	92.04%	29	6.07%
核	1291		10	66	0.009969%	621628	92.63%	29	6.07%
娘	1297		10	65	0.009818%	621693	92.68%	29	6.07%
慶	1352		15	60	0.009063%	621753	93.20%	29	6.07%
蟲	1370		18	59	0.008912%	621812	93.37%	29	6.07%
哭	1374		10	58	0.008761%	621870	93.40%	29	6.07%
酸	1387		14	58	0.008761%	621928	93.51%	29	6.07%
溪	1413		13	55	0.008308%	621983	93.74%	29	6.07%
殖	1453		12	51	0.007703%	622034	94.06%	29	6.07%
穩	1486		19	49	0.007401%	622083	94.31%	29	6.07%
証	1540		12	45	0.006797%	622128	94.69%	29	6.07%
宿	1562		11	43	0.006495%	622171	94.83%	29	6.07%
吞	1580		7	42	0.006344%	622213	94.95%	29	6.07%
慧	1601		15	41	0.006193%	622254	95.08%	29	6.07%
譬	1610		20	41	0.006193%	622295	95.14%	29	6.07%
曉	1640		16	39	0.005891%	622334	95.32%	29	6.07%
譽	1668		21	38	0.00574%	622372	95.48%	29	6.07%
顛	1672		19	38	0.00574%	622410	95.50%	29	6.07%
串	1675		7	37	0.005589%	622447	95.52%	29	6.07%
勁	1697		9	36	0.005438%	622483	95.64%	29	6.07%
恰	1705		9	36	0.005438%	622519	95.68%	29	6.07%
桃	1780		10	33	0.004985%	622552	96.08%	29	6.07%
罩	1816		13	32	0.004833%	622584	96.25%	29	6.07%
憾	1858		16	30	0.004531%	622614	96.45%	29	6.07%
幣	736		14	163	0.02462%	622777	83.70%	28	5.86%
鋼	1124		16	87	0.01314%	622864	90.72%	28	5.86%
毒	1129		9	86	0.01299%	622950	90.79%	28	5.86%
僑	1135		14	85	0.01284%	623035	90.87%	28	5.86%
托	1179		6	78	0.01178%	623113	91.41%	28	5.86%
糧	1223		18	73	0.01103%	623186	91.91%	28	5.86%
悄	1279		10	67	0.01012%	623253	92.50%	28	5.86%
覽	1346		21	61	0.009214%	623314	93.15%	28	5.86%
孫	1376		10	58	0.008761%	623372	93.42%	28	5.86%
廳	1377		25	58	0.008761%	623430	93.43%	28	5.86%
患	1378		11	58	0.008761%	623488	93.44%	28	5.86%
杯	1381		8	58	0.008761%	623546	93.46%	28	5.86%
滾	1444		14	52	0.007854%	623598	93.99%	28	5.86%
腐	1527		14	46	0.006948%	623644	94.60%	28	5.86%
袋	1528		11	46	0.006948%	623690	94.60%	28	5.86%
池	1536		6	45	0.006797%	623735	94.66%	28	5.86%
亭	1544		9	44	0.006646%	623779	94.71%	28	5.86%
燃	1567		16	43	0.006495%	623822	94.86%	28	5.86%
軌	1572		9	43	0.006495%	623865	94.90%	28	5.86%
鎖	1575		18	43	0.006495%	623908	94.92%	28	5.86%
吉	1613		6	40	0.006042%	623948	95.15%	28	5.86%
誌	1628		14	40	0.006042%	623988	95.25%	28	5.86%
貌	1629		14	40	0.006042%	624028	95.25%	28	5.86%
赴	1646		9	39	0.005891%	624067	95.35%	28	5.86%
恢	1654		9	38	0.00574%	624105	95.40%	28	5.86%
樸	1688		16	37	0.005589%	624142	95.59%	28	5.86%
糊	1691		15	37	0.005589%	624179	95.61%	28	5.86%
盈	1710		9	36	0.005438%	624215	95.71%	28	5.86%
聰	1714		17	36	0.005438%	624251	95.73%	28	5.86%
厲	1748		15	34	0.005136%	624285	95.91%	28	5.86%
晴	1760		12	34	0.005136%	624319	95.98%	28	5.86%
毅	1782		15	33	0.004985%	624352	96.09%	28	5.86%
矛	1109		5	88	0.01329%	624440	90.53%	27	5.65%
貿	1172		12	79	0.01193%	624519	91.33%	27	5.65%
姐	1216		8	74	0.01118%	624593	91.83%	27	5.65%
澳	1355		16	60	0.009063%	624653	93.23%	27	5.65%
網	1497		14	48	0.00725%	624701	94.39%	27	5.65%
呈	1516		7	46	0.006948%	624747	94.52%	27	5.65%
裂	1539		12	45	0.006797%	624792	94.68%	27	5.65%
返	1591		7	42	0.006344%	624834	95.02%	27	5.65%
遂	1592		12	42	0.006344%	624876	95.02%	27	5.65%
雀	1594		11	42	0.006344%	624918	95.04%	27	5.65%
搬	1602		13	41	0.006193%	624959	95.09%	27	5.65%
玉	1621		5	40	0.006042%	624999	95.20%	27	5.65%
痕	1622		11	40	0.006042%	625039	95.21%	27	5.65%
逢	1630		10	40	0.006042%	625079	95.26%	27	5.65%
狹	1642		10	39	0.005891%	625118	95.33%	27	5.65%
隆	1648		11	39	0.005891%	625157	95.36%	27	5.65%
惟	1655		11	38	0.00574%	625195	95.40%	27	5.65%
捲	1756		11	34	0.005136%	625229	95.96%	27	5.65%
斗	1758		4	34	0.005136%	625263	95.97%	27	5.65%
累	1788		11	33	0.004985%	625296	96.12%	27	5.65%
躲	1793		13	33	0.004985%	625329	96.14%	27	5.65%
鬆	1797		18	33	0.004985%	625362	96.16%	27	5.65%
妨	1800		7	32	0.004833%	625394	96.18%	27	5.65%
牽	1811		11	32	0.004833%	625426	96.23%	27	5.65%
腰	1818		13	32	0.004833%	625458	96.26%	27	5.65%
氛	1863		8	30	0.004531%	625488	96.47%	27	5.65%
佛	1158		7	81	0.01223%	625569	91.16%	26	5.44%
杜	1196		7	76	0.01148%	625645	91.61%	26	5.44%
吾	1213		7	74	0.01118%	625719	91.80%	26	5.44%
灘	1283		22	67	0.01012%	625786	92.55%	26	5.44%
彌	1325		17	62	0.009365%	625848	92.95%	26	5.44%
哈	1336		9	61	0.009214%	625909	93.06%	26	5.44%
黎	1407		15	56	0.008459%	625965	93.69%	26	5.44%
箱	1414		15	55	0.008308%	626020	93.74%	26	5.44%
融	1457		16	51	0.007703%	626071	94.09%	26	5.44%
搶	1468		13	50	0.007552%	626121	94.17%	26	5.44%
魯	1488		15	49	0.007401%	626170	94.32%	26	5.44%
敲	1493		14	48	0.00725%	626218	94.36%	26	5.44%
咀	1504		8	47	0.007099%	626265	94.44%	26	5.44%
憤	1519		15	46	0.006948%	626311	94.54%	26	5.44%
暑	1551		12	44	0.006646%	626355	94.76%	26	5.44%
荷	1558		11	44	0.006646%	626399	94.81%	26	5.44%
勸	1578		20	42	0.006344%	626441	94.94%	26	5.44%
甲	1587		5	42	0.006344%	626483	94.99%	26	5.44%
眉	1588		9	42	0.006344%	626525	95.00%	26	5.44%
鞋	1595		15	42	0.006344%	626567	95.04%	26	5.44%
惠	1615		12	40	0.006042%	626607	95.17%	26	5.44%
瘋	1623		14	40	0.006042%	626647	95.22%	26	5.44%
側	1633		11	39	0.005891%	626686	95.28%	26	5.44%
夾	1651		7	38	0.00574%	626724	95.38%	26	5.44%
碰	1663		13	38	0.00574%	626762	95.45%	26	5.44%
雷	1671		13	38	0.00574%	626800	95.50%	26	5.44%
判	1677		7	37	0.005589%	626837	95.53%	26	5.44%
挑	1683		9	37	0.005589%	626874	95.56%	26	5.44%
緒	1692		14	37	0.005589%	626911	95.61%	26	5.44%
艷	1693		24	37	0.005589%	626948	95.62%	26	5.44%
敵	1707		15	36	0.005438%	626984	95.70%	26	5.44%
糾	1712		8	36	0.005438%	627020	95.72%	26	5.44%
誼	1719		15	36	0.005438%	627056	95.76%	26	5.44%
芳	1738		8	35	0.005287%	627091	95.86%	26	5.44%
綿	1767		14	34	0.005136%	627125	96.01%	26	5.44%
吟	1771		7	33	0.004985%	627158	96.03%	26	5.44%
拒	1778		8	33	0.004985%	627191	96.07%	26	5.44%
掙	1779		11	33	0.004985%	627224	96.07%	26	5.44%
燥	1784		17	33	0.004985%	627257	96.10%	26	5.44%
賢	1792		15	33	0.004985%	627290	96.14%	26	5.44%
頌	1823		13	32	0.004833%	627322	96.29%	26	5.44%
漆	1865		14	30	0.004531%	627352	96.48%	26	5.44%
衷	1874		10	30	0.004531%	627382	96.52%	26	5.44%
縣	903		16	124	0.01873%	627506	87.29%	25	5.23%
琴	1263		12	69	0.01042%	627575	92.34%	25	5.23%
晶	1271		12	68	0.01027%	627643	92.42%	25	5.23%
呎	1306		7	64	0.009667%	627707	92.77%	25	5.23%
喉	1351		12	60	0.009063%	627767	93.20%	25	5.23%
牲	1383		9	58	0.008761%	627825	93.48%	25	5.23%
拆	1394		8	57	0.00861%	627882	93.58%	25	5.23%
燕	1454		16	51	0.007703%	627933	94.06%	25	5.23%
柱	1480		9	49	0.007401%	627982	94.26%	25	5.23%
漲	1481		14	49	0.007401%	628031	94.27%	25	5.23%
割	1503		12	47	0.007099%	628078	94.43%	25	5.23%
違	1559		12	44	0.006646%	628122	94.81%	25	5.23%
云	1596		4	41	0.006193%	628163	95.05%	25	5.23%
惑	1638		12	39	0.005891%	628202	95.31%	25	5.23%
松	1659		8	38	0.00574%	628240	95.43%	25	5.23%
雞	1670		18	38	0.00574%	628278	95.49%	25	5.23%
喊	1679		12	37	0.005589%	628315	95.54%	25	5.23%
桌	1685		10	37	0.005589%	628352	95.57%	25	5.23%
蜜	1717		14	36	0.005438%	628388	95.75%	25	5.23%
懸	1725		20	35	0.005287%	628423	95.79%	25	5.23%
掠	1755		11	34	0.005136%	628457	95.95%	25	5.23%
監	1765		14	34	0.005136%	628491	96.00%	25	5.23%
奧	1772		13	33	0.004985%	628524	96.04%	25	5.23%
蕭	1790		16	33	0.004985%	628557	96.13%	25	5.23%
虎	1819		8	32	0.004833%	628589	96.27%	25	5.23%
扎	1832		4	31	0.004682%	628620	96.33%	25	5.23%
昔	1835		8	31	0.004682%	628651	96.34%	25	5.23%
懇	1859		17	30	0.004531%	628681	96.45%	25	5.23%
懼	1860		21	30	0.004531%	628711	96.46%	25	5.23%
絡	1869		12	30	0.004531%	628741	96.50%	25	5.23%
迄	1876		6	30	0.004531%	628771	96.53%	25	5.23%
擾	1888		18	29	0.00438%	628800	96.58%	25	5.23%
碧	1910		14	28	0.004229%	628828	96.68%	25	5.23%
馳	1957		13	27	0.004078%	628855	96.87%	25	5.23%
媽	912		13	121	0.01828%	628976	87.46%	24	5.02%
梅	1251		11	70	0.01057%	629046	92.21%	24	5.02%
版	1342		8	61	0.009214%	629107	93.11%	24	5.02%
粒	1415		11	55	0.008308%	629162	93.75%	24	5.02%
薪	1417		17	55	0.008308%	629217	93.77%	24	5.02%
妻	1433		8	53	0.008005%	629270	93.90%	24	5.02%
塔	1548		13	44	0.006646%	629314	94.74%	24	5.02%
瓜	1555		5	44	0.006646%	629358	94.79%	24	5.02%
潛	1586		15	42	0.006344%	629400	94.99%	24	5.02%
邦	1593		6	42	0.006344%	629442	95.03%	24	5.02%
恩	1600		10	41	0.006193%	629483	95.07%	24	5.02%
廉	1637		13	39	0.005891%	629522	95.30%	24	5.02%
惱	1656		12	38	0.00574%	629560	95.41%	24	5.02%
慕	1657		15	38	0.00574%	629598	95.42%	24	5.02%
訊	1694		10	37	0.005589%	629635	95.62%	24	5.02%
霞	1695		17	37	0.005589%	629672	95.63%	24	5.02%
抓	1706		7	36	0.005438%	629708	95.69%	24	5.02%
旗	1708		14	36	0.005438%	629744	95.70%	24	5.02%
描	1726		12	35	0.005287%	629779	95.80%	24	5.02%
禍	1736		13	35	0.005287%	629814	95.85%	24	5.02%
誕	1741		15	35	0.005287%	629849	95.88%	24	5.02%
劣	1746		6	34	0.005136%	629883	95.90%	24	5.02%
銅	1795		14	33	0.004985%	629916	96.15%	24	5.02%
塗	1799		13	32	0.004833%	629948	96.17%	24	5.02%
躺	1820		15	32	0.004833%	629980	96.27%	24	5.02%
倚	1825		10	31	0.004682%	630011	96.30%	24	5.02%
暢	1837		14	31	0.004682%	630042	96.35%	24	5.02%
役	1855		7	30	0.004531%	630072	96.44%	24	5.02%
悟	1884		10	29	0.00438%	630101	96.57%	24	5.02%
飾	1894		13	29	0.00438%	630130	96.61%	24	5.02%
奈	1901		8	28	0.004229%	630158	96.64%	24	5.02%
敏	1936		11	27	0.004078%	630185	96.79%	24	5.02%
爽	1977		11	26	0.003927%	630211	96.95%	24	5.02%
妳	1065		8	92	0.0139%	630303	89.93%	23	4.81%
症	1312		10	64	0.009667%	630367	92.83%	23	4.81%
楊	1327		13	62	0.009365%	630429	92.97%	23	4.81%
瑞	1427		13	54	0.008157%	630483	93.85%	23	4.81%
爆	1483		19	49	0.007401%	630532	94.28%	23	4.81%
陌	1502		8	48	0.00725%	630580	94.42%	23	4.81%
宮	1517		10	46	0.006948%	630626	94.53%	23	4.81%
唐	1533		10	45	0.006797%	630671	94.64%	23	4.81%
槍	1604		14	41	0.006193%	630712	95.10%	23	4.81%
彎	1704		22	36	0.005438%	630748	95.68%	23	4.81%
遮	1744		14	35	0.005287%	630783	95.89%	23	4.81%
	1749		13	34	0.005136%	630817	95.92%	23	4.81%
截	1754		14	34	0.005136%	630851	95.94%	23	4.81%
罵	1768		15	34	0.005136%	630885	96.02%	23	4.81%
慎	1776		13	33	0.004985%	630918	96.06%	23	4.81%
抹	1777		8	33	0.004985%	630951	96.06%	23	4.81%
欄	1781		21	33	0.004985%	630984	96.08%	23	4.81%
羊	1789		6	33	0.004985%	631017	96.12%	23	4.81%
插	1803		12	32	0.004833%	631049	96.19%	23	4.81%
壽	1829		14	31	0.004682%	631080	96.32%	23	4.81%
濫	1838		17	31	0.004682%	631111	96.36%	23	4.81%
邀	1844		16	31	0.004682%	631142	96.39%	23	4.81%
歇	1862		13	30	0.004531%	631172	96.47%	23	4.81%
聊	1890		11	29	0.00438%	631201	96.59%	23	4.81%
溢	1909		13	28	0.004229%	631229	96.67%	23	4.81%
豈	1916		10	28	0.004229%	631257	96.70%	23	4.81%
傲	1925		13	27	0.004078%	631284	96.74%	23	4.81%
暮	1937		15	27	0.004078%	631311	96.79%	23	4.81%
纏	1949		21	27	0.004078%	631338	96.84%	23	4.81%
涯	1975		11	26	0.003927%	631364	96.94%	23	4.81%
綴	1982		14	26	0.003927%	631390	96.97%	23	4.81%
央	1391		5	57	0.00861%	631447	93.55%	22	4.60%
膠	1416		15	55	0.008308%	631502	93.76%	22	4.60%
騷	1474		20	50	0.007552%	631552	94.22%	22	4.60%
摩	1583		15	42	0.006344%	631594	94.97%	22	4.60%
并	1636		6	39	0.005891%	631633	95.29%	22	4.60%
柴	1660		10	38	0.00574%	631671	95.43%	22	4.60%
紐	1664		10	38	0.00574%	631709	95.46%	22	4.60%
塑	1680		13	37	0.005589%	631746	95.55%	22	4.60%
歧	1689		8	37	0.005589%	631783	95.60%	22	4.60%
溝	1709		13	36	0.005438%	631819	95.71%	22	4.60%
駐	1721		15	36	0.005438%	631855	95.77%	22	4.60%
濱	1732		17	35	0.005287%	631890	95.83%	22	4.60%
貝	1743		7	35	0.005287%	631925	95.89%	22	4.60%
宅	1773		6	33	0.004985%	631958	96.04%	22	4.60%
洪	1783		9	33	0.004985%	631991	96.09%	22	4.60%
瑰	1786		14	33	0.004985%	632024	96.11%	22	4.60%
窄	1787		10	33	0.004985%	632057	96.11%	22	4.60%
遣	1794		13	33	0.004985%	632090	96.15%	22	4.60%
姊	1801		8	32	0.004833%	632122	96.18%	22	4.60%
紫	1815		12	32	0.004833%	632154	96.25%	22	4.60%
辨	1822		16	32	0.004833%	632186	96.28%	22	4.60%
昂	1836		8	31	0.004682%	632217	96.35%	22	4.60%
閱	1877		15	30	0.004531%	632247	96.54%	22	4.60%
撒	1887		15	29	0.00438%	632276	96.58%	22	4.60%
渺	1889		12	29	0.00438%	632305	96.59%	22	4.60%
浩	1907		10	28	0.004229%	632333	96.67%	22	4.60%
淵	1908		11	28	0.004229%	632361	96.67%	22	4.60%
羞	1911		11	28	0.004229%	632389	96.68%	22	4.60%
謹	1915		18	28	0.004229%	632417	96.70%	22	4.60%
齒	874		15	131	0.01979%	632548	86.74%	21	4.39%
孟	1298		8	65	0.009818%	632613	92.69%	21	4.39%
遜	1399		13	57	0.00861%	632670	93.62%	21	4.39%
	1402		10	56	0.008459%	632726	93.64%	21	4.39%
璃	1554		15	44	0.006646%	632770	94.78%	21	4.39%
津	1618		9	40	0.006042%	632810	95.19%	21	4.39%
誘	1667		14	38	0.00574%	632848	95.47%	21	4.39%
摘	1727		14	35	0.005287%	632883	95.80%	21	4.39%
柏	1728		9	35	0.005287%	632918	95.81%	21	4.39%
脈	1737		10	35	0.005287%	632953	95.86%	21	4.39%
葬	1739		13	35	0.005287%	632988	95.87%	21	4.39%
敷	1757		15	34	0.005136%	633022	95.96%	21	4.39%
旨	1804		6	32	0.004833%	633054	96.20%	21	4.39%
俱	1826		10	31	0.004682%	633085	96.30%	21	4.39%
奴	1830		5	31	0.004682%	633116	96.32%	21	4.39%
挽	1833		10	31	0.004682%	633147	96.33%	21	4.39%
頻	1846		16	31	0.004682%	633178	96.39%	21	4.39%
函	1849		8	30	0.004531%	633208	96.41%	21	4.39%
捕	1885		10	29	0.00438%	633237	96.57%	21	4.39%
捨	1886		11	29	0.00438%	633266	96.58%	21	4.39%
蓄	1891		14	29	0.00438%	633295	96.60%	21	4.39%
宙	1902		8	28	0.004229%	633323	96.64%	21	4.39%
椅	1905		12	28	0.004229%	633351	96.66%	21	4.39%
醜	1919		17	28	0.004229%	633379	96.72%	21	4.39%
揭	1935		12	27	0.004078%	633406	96.78%	21	4.39%
殷	1941		10	27	0.004078%	633433	96.81%	21	4.39%
縫	1947		17	27	0.004078%	633460	96.83%	21	4.39%
卑	1965		8	26	0.003927%	633486	96.90%	21	4.39%
嫩	1970		14	26	0.003927%	633512	96.92%	21	4.39%
悔	1971		10	26	0.003927%	633538	96.93%	21	4.39%
愧	1972		13	26	0.003927%	633564	96.93%	21	4.39%
拂	1973		8	26	0.003927%	633590	96.93%	21	4.39%
盼	1979		9	26	0.003927%	633616	96.96%	21	4.39%
蒸	1984		14	26	0.003927%	633642	96.98%	21	4.39%
託	1985		10	26	0.003927%	633668	96.98%	21	4.39%
瞬	2010		17	25	0.003776%	633693	97.08%	21	4.39%
帆	2028		6	24	0.003625%	633717	97.14%	21	4.39%
嬌	2051		15	23	0.003474%	633740	97.23%	21	4.39%
廟	696		15	176	0.02658%	633916	82.67%	20	4.18%
盲	1232		8	72	0.01088%	633988	92.01%	20	4.18%
療	1313		17	64	0.009667%	634052	92.84%	20	4.18%
岩	1401		8	56	0.008459%	634108	93.64%	20	4.18%
捐	1434		10	53	0.008005%	634161	93.91%	20	4.18%
井	1436		4	52	0.007854%	634213	93.92%	20	4.18%
戒	1507		7	47	0.007099%	634260	94.46%	20	4.18%
赫	1513		14	47	0.007099%	634307	94.50%	20	4.18%
溜	1537		13	45	0.006797%	634352	94.67%	20	4.18%
菲	1538		12	45	0.006797%	634397	94.67%	20	4.18%
攝	1603		21	41	0.006193%	634438	95.09%	20	4.18%
犧	1620		21	40	0.006042%	634478	95.20%	20	4.18%
柳	1641		9	39	0.005891%	634517	95.32%	20	4.18%
繪	1665		19	38	0.00574%	634555	95.46%	20	4.18%
削	1678		9	37	0.005589%	634592	95.54%	20	4.18%
嘉	1699		14	36	0.005438%	634628	95.65%	20	4.18%
梯	1729		11	35	0.005287%	634663	95.81%	20	4.18%
磅	1735		15	35	0.005287%	634698	95.85%	20	4.18%
獸	1785		19	33	0.004985%	634731	96.10%	20	4.18%
溶	1810		13	32	0.004833%	634763	96.22%	20	4.18%
脅	1817		10	32	0.004833%	634795	96.26%	20	4.18%
俯	1824		10	31	0.004682%	634826	96.29%	20	4.18%
吵	1827		7	31	0.004682%	634857	96.31%	20	4.18%
攤	1834		22	31	0.004682%	634888	96.34%	20	4.18%
川	1852		3	30	0.004531%	634918	96.42%	20	4.18%
巷	1853		9	30	0.004531%	634948	96.43%	20	4.18%
庸	1854		11	30	0.004531%	634978	96.43%	20	4.18%
籲	1867		32	30	0.004531%	635008	96.49%	20	4.18%
徹	1883		14	29	0.00438%	635037	96.56%	20	4.18%
勃	1898		9	28	0.004229%	635065	96.63%	20	4.18%
桑	1904		10	28	0.004229%	635093	96.65%	20	4.18%
貫	1917		11	28	0.004229%	635121	96.71%	20	4.18%
采	1920		8	28	0.004229%	635149	96.72%	20	4.18%
后	1927		6	27	0.004078%	635176	96.75%	20	4.18%
	1955		14	27	0.004078%	635203	96.86%	20	4.18%
錦	1956		16	27	0.004078%	635230	96.87%	20	4.18%
墳	1968		15	26	0.003927%	635256	96.92%	20	4.18%
軟	1988		11	26	0.003927%	635282	96.99%	20	4.18%
扯	1998		7	25	0.003776%	635307	97.03%	20	4.18%
祥	2011		10	25	0.003776%	635332	97.08%	20	4.18%
銳	2018		15	25	0.003776%	635357	97.11%	20	4.18%
墜	2024		15	24	0.003625%	635381	97.13%	20	4.18%
妥	2025		7	24	0.003625%	635405	97.13%	20	4.18%
欠	2030		4	24	0.003625%	635429	97.15%	20	4.18%
滲	2032		14	24	0.003625%	635453	97.16%	20	4.18%
伐	2046		6	23	0.003474%	635476	97.21%	20	4.18%
剝	2047		10	23	0.003474%	635499	97.21%	20	4.18%
抖	2054		7	23	0.003474%	635522	97.24%	20	4.18%
曠	2056		19	23	0.003474%	635545	97.24%	20	4.18%
畏	2093		9	22	0.003323%	635567	97.37%	20	4.18%
臥	2105		8	22	0.003323%	635589	97.41%	20	4.18%
芽	2106		8	22	0.003323%	635611	97.41%	20	4.18%
輾	2110		17	22	0.003323%	635633	97.43%	20	4.18%
茂	2143		9	21	0.003172%	635654	97.53%	20	4.18%
睹	2180		13	20	0.003021%	635674	97.64%	20	4.18%
徙	1441		11	52	0.007854%	635726	93.96%	19	3.98%
賭	1500		15	48	0.00725%	635774	94.41%	19	3.98%
曰	1522		4	46	0.006948%	635820	94.56%	19	3.98%
玻	1569		9	43	0.006495%	635863	94.88%	19	3.98%
呵	1598		8	41	0.006193%	635904	95.06%	19	3.98%
蓮	1627		15	40	0.006042%	635944	95.24%	19	3.98%
姓	1635		8	39	0.005891%	635983	95.29%	19	3.98%
儒	1696		16	36	0.005438%	636019	95.64%	19	3.98%
耕	1713		10	36	0.005438%	636055	95.73%	19	3.98%
卅	1747		4	34	0.005136%	636089	95.91%	19	3.98%
旺	1759		8	34	0.005136%	636123	95.97%	19	3.98%
鼻	1798		14	33	0.004985%	636156	96.17%	19	3.98%
泉	1807		9	32	0.004833%	636188	96.21%	19	3.98%
墓	1850		14	30	0.004531%	636218	96.41%	19	3.98%
恆	1856		9	30	0.004531%	636248	96.44%	19	3.98%
萎	1872		12	30	0.004531%	636278	96.51%	19	3.98%
騙	1895		19	29	0.00438%	636307	96.61%	19	3.98%
冠	1897		9	28	0.004229%	636335	96.62%	19	3.98%
伙	1924		6	27	0.004078%	636362	96.74%	19	3.98%
污	1942		6	27	0.004078%	636389	96.81%	19	3.98%
劫	1964		7	26	0.003927%	636415	96.90%	19	3.98%
攀	1974		19	26	0.003927%	636441	96.94%	19	3.98%
賓	1986		14	26	0.003927%	636467	96.99%	19	3.98%
蹟	1987		18	26	0.003927%	636493	96.99%	19	3.98%
陋	1990		8	26	0.003927%	636519	97.00%	19	3.98%
吻	1995		7	25	0.003776%	636544	97.02%	19	3.98%
株	2001		10	25	0.003776%	636569	97.04%	19	3.98%
焦	2006		12	25	0.003776%	636594	97.06%	19	3.98%
剎	2021		9	24	0.003625%	636618	97.12%	19	3.98%
爐	2033		20	24	0.003625%	636642	97.16%	19	3.98%
陪	2044		10	24	0.003625%	636666	97.20%	19	3.98%
滯	2058		14	23	0.003474%	636689	97.25%	19	3.98%
脆	2069		10	23	0.003474%	636712	97.29%	19	3.98%
蔭	2070		15	23	0.003474%	636735	97.29%	19	3.98%
驟	2075		24	23	0.003474%	636758	97.31%	19	3.98%
喧	2081		12	22	0.003323%	636780	97.33%	19	3.98%
嫌	2084		13	22	0.003323%	636802	97.34%	19	3.98%
囂	2117		21	21	0.003172%	636823	97.45%	19	3.98%
逼	2151		12	21	0.003172%	636844	97.56%	19	3.98%
兇	2161		6	20	0.003021%	636864	97.59%	19	3.98%
竭	2184		14	20	0.003021%	636884	97.66%	19	3.98%
趁	2194		12	20	0.003021%	636904	97.69%	19	3.98%
孝	1189		7	77	0.01163%	636981	91.53%	18	3.77%
劉	1409		15	55	0.008308%	637036	93.70%	18	3.77%
倡	1597		10	41	0.006193%	637077	95.06%	18	3.77%
繳	1644		19	39	0.005891%	637116	95.34%	18	3.77%
僱	1649		14	38	0.00574%	637154	95.37%	18	3.77%
癡	1661		19	38	0.00574%	637192	95.44%	18	3.77%
盆	1734		9	35	0.005287%	637227	95.84%	18	3.77%
諾	1742		16	35	0.005287%	637262	95.88%	18	3.77%
勿	1770		4	33	0.004985%	637295	96.03%	18	3.77%
餓	1796		15	33	0.004985%	637328	96.16%	18	3.77%
朱	1805		6	32	0.004833%	637360	96.20%	18	3.77%
泰	1808		10	32	0.004833%	637392	96.21%	18	3.77%
輯	1821		16	32	0.004833%	637424	96.28%	18	3.77%
糖	1841		16	31	0.004682%	637455	96.37%	18	3.77%
卷	1880		8	29	0.00438%	637484	96.55%	18	3.77%
審	1929		15	27	0.004078%	637511	96.76%	18	3.77%
	1931		9	27	0.004078%	637538	96.77%	18	3.77%
譯	1953		20	27	0.004078%	637565	96.86%	18	3.77%
麵	1958		20	27	0.004078%	637592	96.88%	18	3.77%
伍	1959		6	26	0.003927%	637618	96.88%	18	3.77%
儲	1961		17	26	0.003927%	637644	96.89%	18	3.77%
噴	1966		15	26	0.003927%	637670	96.91%	18	3.77%
秩	1981		10	26	0.003927%	637696	96.97%	18	3.77%
丹	1992		4	25	0.003776%	637721	97.01%	18	3.77%
枚	2000		8	25	0.003776%	637746	97.04%	18	3.77%
洩	2002		9	25	0.003776%	637771	97.05%	18	3.77%
郎	2017		8	25	0.003776%	637796	97.10%	18	3.77%
頁	2019		9	25	0.003776%	637821	97.11%	18	3.77%
匹	2022		4	24	0.003625%	637845	97.12%	18	3.77%
寸	2026		3	24	0.003625%	637869	97.14%	18	3.77%
欺	2031		12	24	0.003625%	637893	97.15%	18	3.77%
瘦	2034		14	24	0.003625%	637917	97.17%	18	3.77%
眠	2035		10	24	0.003625%	637941	97.17%	18	3.77%
跨	2042		13	24	0.003625%	637965	97.19%	18	3.77%
址	2050		7	23	0.003474%	637988	97.22%	18	3.77%
征	2053		8	23	0.003474%	638011	97.23%	18	3.77%
窩	2065		14	23	0.003474%	638034	97.27%	18	3.77%
償	2077		17	22	0.003323%	638056	97.32%	18	3.77%
膚	2104		15	22	0.003323%	638078	97.41%	18	3.77%
謙	2107		17	22	0.003323%	638100	97.42%	18	3.77%
慌	2123		13	21	0.003172%	638121	97.47%	18	3.77%
樑	2128		15	21	0.003172%	638142	97.48%	18	3.77%
頑	2156		13	21	0.003172%	638163	97.57%	18	3.77%
憬	2167		15	20	0.003021%	638183	97.61%	18	3.77%
捉	2170		10	20	0.003021%	638203	97.61%	18	3.77%
沸	2177		8	20	0.003021%	638223	97.64%	18	3.77%
誇	2193		13	20	0.003021%	638243	97.68%	18	3.77%
凄	2203		10	19	0.00287%	638262	97.71%	18	3.77%
愚	2209		13	19	0.00287%	638281	97.73%	18	3.77%
披	2210		8	19	0.00287%	638300	97.73%	18	3.77%
捧	2211		11	19	0.00287%	638319	97.74%	18	3.77%
綜	2223		14	19	0.00287%	638338	97.77%	18	3.77%
遞	2234		13	19	0.00287%	638357	97.80%	18	3.77%
饒	2284		20	18	0.002719%	638375	97.94%	18	3.77%
岡	1076		8	91	0.01375%	638466	90.08%	17	3.56%
蛇	1333		11	62	0.009365%	638528	93.03%	17	3.56%
籃	1624		20	40	0.006042%	638568	95.22%	17	3.56%
宋	1681		7	37	0.005589%	638605	95.55%	17	3.56%
棉	1687		12	37	0.005589%	638642	95.59%	17	3.56%
峰	1703		10	36	0.005438%	638678	95.67%	17	3.56%
矣	1711		7	36	0.005438%	638714	95.72%	17	3.56%
棵	1730		12	35	0.005287%	638749	95.82%	17	3.56%
淪	1762		11	34	0.005136%	638783	95.99%	17	3.56%
礦	1813		20	32	0.004833%	638815	96.24%	17	3.56%
麥	1896		11	29	0.00438%	638844	96.62%	17	3.56%
墮	1900		15	28	0.004229%	638872	96.64%	17	3.56%
泳	1906		8	28	0.004229%	638900	96.66%	17	3.56%
邪	1918		6	28	0.004229%	638928	96.71%	17	3.56%
鑑	1921		22	28	0.004229%	638956	96.72%	17	3.56%
寡	1928		14	27	0.004078%	638983	96.75%	17	3.56%
冊	1962		5	26	0.003927%	639009	96.89%	17	3.56%
玫	1978		8	26	0.003927%	639035	96.95%	17	3.56%
倉	1994		10	25	0.003776%	639060	97.02%	17	3.56%
贈	2015		19	25	0.003776%	639085	97.10%	17	3.56%
臂	2040		17	24	0.003625%	639109	97.19%	17	3.56%
蔽	2041		15	24	0.003625%	639133	97.19%	17	3.56%
矓	2063		21	23	0.003474%	639156	97.27%	17	3.56%
逆	2072		9	23	0.003474%	639179	97.30%	17	3.56%
允	2078		4	22	0.003323%	639201	97.32%	17	3.56%
唇	2080		10	22	0.003323%	639223	97.33%	17	3.56%
契	2083		9	22	0.003323%	639245	97.34%	17	3.56%
聳	2099		17	22	0.003323%	639267	97.39%	17	3.56%
傍	2112		12	21	0.003172%	639288	97.43%	17	3.56%
媚	2118		12	21	0.003172%	639309	97.45%	17	3.56%
沾	2129		8	21	0.003172%	639330	97.49%	17	3.56%
渾	2133		12	21	0.003172%	639351	97.50%	17	3.56%
狼	2136		10	21	0.003172%	639372	97.51%	17	3.56%
芒	2142		7	21	0.003172%	639393	97.53%	17	3.56%
韻	2155		19	21	0.003172%	639414	97.57%	17	3.56%
佩	2159		8	20	0.003021%	639434	97.58%	17	3.56%
掀	2172		11	20	0.003021%	639454	97.62%	17	3.56%
隙	2197		13	20	0.003021%	639474	97.70%	17	3.56%
敘	2212		11	19	0.00287%	639493	97.74%	17	3.56%
灼	2215		7	19	0.00287%	639512	97.75%	17	3.56%
眺	2220		11	19	0.00287%	639531	97.76%	17	3.56%
巒	2249		22	18	0.002719%	639549	97.84%	17	3.56%
梢	2259		11	18	0.002719%	639567	97.87%	17	3.56%
脾	2271		12	18	0.002719%	639585	97.90%	17	3.56%
爸	810		8	145	0.0219%	639730	85.41%	16	3.35%
豆	1398		7	57	0.00861%	639787	93.61%	16	3.35%
秦	1471		10	50	0.007552%	639837	94.19%	16	3.35%
桂	1552		10	44	0.006646%	639881	94.77%	16	3.35%
撞	1584		15	42	0.006344%	639923	94.97%	16	3.35%
刷	1612		8	40	0.006042%	639963	95.15%	16	3.35%
芝	1626		8	40	0.006042%	640003	95.23%	16	3.35%
徐	1753		10	34	0.005136%	640037	95.94%	16	3.35%
瓦	1812		5	32	0.004833%	640069	96.23%	16	3.35%
荃	1843		10	31	0.004682%	640100	96.38%	16	3.35%
錫	1845		16	31	0.004682%	640131	96.39%	16	3.35%
衫	1873		8	30	0.004531%	640161	96.52%	16	3.35%
舖	1913		15	28	0.004229%	640189	96.69%	16	3.35%
葡	1914		13	28	0.004229%	640217	96.69%	16	3.35%
泡	1943		8	27	0.004078%	640244	96.81%	16	3.35%
耗	1950		10	27	0.004078%	640271	96.84%	16	3.35%
臣	1983		6	26	0.003927%	640297	96.97%	16	3.35%
併	1993		8	25	0.003776%	640322	97.01%	16	3.35%
掘	1999		11	25	0.003776%	640347	97.04%	16	3.35%
炮	2004		9	25	0.003776%	640372	97.05%	16	3.35%
甸	2008		7	25	0.003776%	640397	97.07%	16	3.35%
斥	2055		5	23	0.003474%	640420	97.24%	16	3.35%
煌	2060		13	23	0.003474%	640443	97.26%	16	3.35%
牢	2061		7	23	0.003474%	640466	97.26%	16	3.35%
宏	2085		7	22	0.003323%	640488	97.34%	16	3.35%
殼	2091		12	22	0.003323%	640510	97.36%	16	3.35%
肥	2100		8	22	0.003323%	640532	97.39%	16	3.35%
俾	2111		10	21	0.003172%	640553	97.43%	16	3.35%
徬	2121		13	21	0.003172%	640574	97.46%	16	3.35%
慾	2124		15	21	0.003172%	640595	97.47%	16	3.35%
矇	2140		19	21	0.003172%	640616	97.52%	16	3.35%
虧	2145		17	21	0.003172%	640637	97.54%	16	3.35%
豬	2148		11	21	0.003172%	640658	97.55%	16	3.35%
隅	2154		11	21	0.003172%	640679	97.57%	16	3.35%
倆	2160		10	20	0.003021%	640699	97.58%	16	3.35%
徊	2166		9	20	0.003021%	640719	97.60%	16	3.35%
挖	2169		9	20	0.003021%	640739	97.61%	16	3.35%
泣	2176		8	20	0.003021%	640759	97.63%	16	3.35%
碌	2183		13	20	0.003021%	640779	97.65%	16	3.35%
舌	2189		6	20	0.003021%	640799	97.67%	16	3.35%
魄	2199		15	20	0.003021%	640819	97.70%	16	3.35%
啞	2206		11	19	0.00287%	640838	97.72%	16	3.35%
瑣	2218		14	19	0.00287%	640857	97.76%	16	3.35%
貪	2232		11	19	0.00287%	640876	97.80%	16	3.35%
鍊	2237		17	19	0.00287%	640895	97.81%	16	3.35%
飢	2238		10	19	0.00287%	640914	97.81%	16	3.35%
凍	2241		10	18	0.002719%	640932	97.82%	16	3.35%
崩	2248		11	18	0.002719%	640950	97.84%	16	3.35%
憧	2252		15	18	0.002719%	640968	97.85%	16	3.35%
挫	2253		10	18	0.002719%	640986	97.86%	16	3.35%
擋	2254		16	18	0.002719%	641004	97.86%	16	3.35%
暇	2256		13	18	0.002719%	641022	97.86%	16	3.35%
穫	2266		19	18	0.002719%	641040	97.89%	16	3.35%
曳	2296		6	17	0.002568%	641057	97.97%	16	3.35%
淘	2301		11	17	0.002568%	641074	97.98%	16	3.35%
呻	2337		8	16	0.002417%	641090	98.07%	16	3.35%
猜	2356		11	16	0.002417%	641106	98.12%	16	3.35%
埔	1194		10	76	0.01148%	641182	91.58%	15	3.14%
洛	1328		9	62	0.009365%	641244	92.98%	15	3.14%
耶	1455		9	51	0.007703%	641295	94.07%	15	3.14%
獵	1605		18	41	0.006193%	641336	95.11%	15	3.14%
筋	1766		12	34	0.005136%	641370	96.01%	15	3.14%
嶼	1774		17	33	0.004985%	641403	96.05%	15	3.14%
庫	1831		10	31	0.004682%	641434	96.32%	15	3.14%
勒	1899		11	28	0.004229%	641462	96.63%	15	3.14%
恒	1934		9	27	0.004078%	641489	96.78%	15	3.14%
梁	1940		11	27	0.004078%	641516	96.80%	15	3.14%
坪	1967		8	26	0.003927%	641542	96.91%	15	3.14%
膜	2013		15	25	0.003776%	641567	97.09%	15	3.14%
擱	2029		17	24	0.003625%	641591	97.15%	15	3.14%
箭	2066		15	23	0.003474%	641614	97.28%	15	3.14%
肚	2068		7	23	0.003474%	641637	97.29%	15	3.14%
剪	2079		11	22	0.003323%	641659	97.32%	15	3.14%
惶	2086		12	22	0.003323%	641681	97.35%	15	3.14%
擦	2088		17	22	0.003323%	641703	97.35%	15	3.14%
紋	2098		10	22	0.003323%	641725	97.39%	15	3.14%
腔	2101		12	22	0.003323%	641747	97.40%	15	3.14%
膀	2102		14	22	0.003323%	641769	97.40%	15	3.14%
哨	2114		10	21	0.003172%	641790	97.44%	15	3.14%
扮	2125		7	21	0.003172%	641811	97.47%	15	3.14%
浸	2130		10	21	0.003172%	641832	97.49%	15	3.14%
裁	2147		12	21	0.003172%	641853	97.54%	15	3.14%
鍾	2152		17	21	0.003172%	641874	97.56%	15	3.14%
妄	2165		6	20	0.003021%	641894	97.60%	15	3.14%
撤	2173		14	20	0.003021%	641914	97.62%	15	3.14%
斑	2174		12	20	0.003021%	641934	97.63%	15	3.14%
辰	2195		7	20	0.003021%	641954	97.69%	15	3.14%
鋪	2196		15	20	0.003021%	641974	97.69%	15	3.14%
偽	2202		11	19	0.00287%	641993	97.71%	15	3.14%
潑	2214		15	19	0.00287%	642012	97.75%	15	3.14%
綱	2224		14	19	0.00287%	642031	97.77%	15	3.14%
譜	2231		19	19	0.00287%	642050	97.79%	15	3.14%
釘	2236		10	19	0.00287%	642069	97.81%	15	3.14%
惹	2251		13	18	0.002719%	642087	97.85%	15	3.14%
蓬	2274		15	18	0.002719%	642105	97.91%	15	3.14%
裕	2276		12	18	0.002719%	642123	97.92%	15	3.14%
鞭	2282		18	18	0.002719%	642141	97.93%	15	3.14%
頰	2283		16	18	0.002719%	642159	97.94%	15	3.14%
伊	2286		6	17	0.002568%	642176	97.94%	15	3.14%
悵	2294		11	17	0.002568%	642193	97.97%	15	3.14%
拓	2295		8	17	0.002568%	642210	97.97%	15	3.14%
澀	2302		17	17	0.002568%	642227	97.99%	15	3.14%
蘊	2314		20	17	0.002568%	642244	98.02%	15	3.14%
襯	2316		21	17	0.002568%	642261	98.02%	15	3.14%
逗	2319		10	17	0.002568%	642278	98.03%	15	3.14%
遼	2322		15	17	0.002568%	642295	98.04%	15	3.14%
凌	2332		10	16	0.002417%	642311	98.06%	15	3.14%
諒	2367		15	16	0.002417%	642327	98.15%	15	3.14%
賦	2368		15	16	0.002417%	642343	98.15%	15	3.14%
酬	2371		13	16	0.002417%	642359	98.16%	15	3.14%
礙	2419		19	15	0.002266%	642374	98.27%	15	3.14%
遵	2431		15	15	0.002266%	642389	98.29%	15	3.14%
隧	881		15	129	0.01948%	642518	86.87%	14	2.93%
峽	1177		10	78	0.01178%	642596	91.39%	14	2.93%
蒂	1571		13	43	0.006495%	642639	94.89%	14	2.93%
卡	1650		5	38	0.00574%	642677	95.38%	14	2.93%
夷	1750		6	34	0.005136%	642711	95.92%	14	2.93%
堤	1828		12	31	0.004682%	642742	96.31%	14	2.93%
紡	1868		10	30	0.004531%	642772	96.49%	14	2.93%
咒	1881		8	29	0.00438%	642801	96.55%	14	2.93%
崗	1930		11	27	0.004078%	642828	96.76%	14	2.93%
碑	1946		13	27	0.004078%	642855	96.83%	14	2.93%
繩	1948		19	27	0.004078%	642882	96.83%	14	2.93%
劑	1963		16	26	0.003927%	642908	96.90%	14	2.93%
淋	2003		11	25	0.003776%	642933	97.05%	14	2.93%
牧	2007		8	25	0.003776%	642958	97.07%	14	2.93%
鴉	2045		15	24	0.003625%	642982	97.21%	14	2.93%
坑	2049		7	23	0.003474%	643005	97.22%	14	2.93%
禱	2064		18	23	0.003474%	643028	97.27%	14	2.93%
膝	2103		15	22	0.003323%	643050	97.40%	14	2.93%
販	2108		11	22	0.003323%	643072	97.42%	14	2.93%
跌	2109		12	22	0.003323%	643094	97.42%	14	2.93%
唉	2115		10	21	0.003172%	643115	97.44%	14	2.93%
嗚	2116		13	21	0.003172%	643136	97.45%	14	2.93%
盧	2139		16	21	0.003172%	643157	97.52%	14	2.93%
祭	2141		11	21	0.003172%	643178	97.52%	14	2.93%
蛋	2146		11	21	0.003172%	643199	97.54%	14	2.93%
鑼	2153		27	21	0.003172%	643220	97.56%	14	2.93%
鹽	2157		24	21	0.003172%	643241	97.58%	14	2.93%
嚼	2164		20	20	0.003021%	643261	97.60%	14	2.93%
扣	2168		6	20	0.003021%	643281	97.61%	14	2.93%
斤	2175		4	20	0.003021%	643301	97.63%	14	2.93%
矮	2181		13	20	0.003021%	643321	97.65%	14	2.93%
翅	2188		10	20	0.003021%	643341	97.67%	14	2.93%
吳	2205		7	19	0.00287%	643360	97.72%	14	2.93%
宰	2208		10	19	0.00287%	643379	97.73%	14	2.93%
犬	2216		4	19	0.00287%	643398	97.75%	14	2.93%
翔	2227		12	19	0.00287%	643417	97.78%	14	2.93%
諮	2230		16	19	0.00287%	643436	97.79%	14	2.93%
徨	2250		12	18	0.002719%	643454	97.85%	14	2.93%
昇	2255		8	18	0.002719%	643472	97.86%	14	2.93%
粵	2267		13	18	0.002719%	643490	97.89%	14	2.93%
肅	2270		12	18	0.002719%	643508	97.90%	14	2.93%
臭	2272		10	18	0.002719%	643526	97.91%	14	2.93%
徘	2292		11	17	0.002568%	643543	97.96%	14	2.93%
瀰	2304		20	17	0.002568%	643560	97.99%	14	2.93%
軀	2317		18	17	0.002568%	643577	98.02%	14	2.93%
吠	2335		7	16	0.002417%	643593	98.07%	14	2.93%
喘	2341		12	16	0.002417%	643609	98.08%	14	2.93%
摧	2349		14	16	0.002417%	643625	98.10%	14	2.93%
潰	2354		15	16	0.002417%	643641	98.12%	14	2.93%
鈴	2373		13	16	0.002417%	643657	98.16%	14	2.93%
銜	2375		14	16	0.002417%	643673	98.17%	14	2.93%
黯	2381		21	16	0.002417%	643689	98.18%	14	2.93%
傻	2384		13	15	0.002266%	643704	98.19%	14	2.93%
晰	2405		12	15	0.002266%	643719	98.23%	14	2.93%
蝕	2426		14	15	0.002266%	643734	98.28%	14	2.93%
傑	2438		12	14	0.002115%	643748	98.31%	14	2.93%
嚇	2444		17	14	0.002115%	643762	98.32%	14	2.93%
瑟	2466		13	14	0.002115%	643776	98.37%	14	2.93%
薰	2486		18	14	0.002115%	643790	98.41%	14	2.93%
獅	1311		13	64	0.009667%	643854	92.82%	13	2.72%
坊	1614		7	40	0.006042%	643894	95.16%	13	2.72%
啦	1698		11	36	0.005438%	643930	95.65%	13	2.72%
註	1718		12	36	0.005438%	643966	95.76%	13	2.72%
液	1809		11	32	0.004833%	643998	96.22%	13	2.72%
稿	1814		15	32	0.004833%	644030	96.24%	13	2.72%
搞	1861		13	30	0.004531%	644060	96.46%	13	2.72%
砂	1866		9	30	0.004531%	644090	96.49%	13	2.72%
誦	1875		14	30	0.004531%	644120	96.53%	13	2.72%
帽	1903		12	28	0.004229%	644148	96.65%	13	2.72%
瑪	1944		14	27	0.004078%	644175	96.82%	13	2.72%
艇	1951		13	27	0.004078%	644202	96.85%	13	2.72%
燭	1976		17	26	0.003927%	644228	96.95%	13	2.72%
鴨	2020		16	25	0.003776%	644253	97.11%	13	2.72%
帳	2052		11	23	0.003474%	644276	97.23%	13	2.72%
狠	2062		9	23	0.003474%	644299	97.26%	13	2.72%
聘	2067		13	23	0.003474%	644322	97.28%	13	2.72%
蝶	2071		15	23	0.003474%	644345	97.30%	13	2.72%
鄭	2073		14	23	0.003474%	644368	97.30%	13	2.72%
嗅	2082		13	22	0.003323%	644390	97.33%	13	2.72%
債	2113		13	21	0.003172%	644411	97.44%	13	2.72%
	2127		13	21	0.003172%	644432	97.48%	13	2.72%
湯	2132		12	21	0.003172%	644453	97.50%	13	2.72%
潭	2134		15	21	0.003172%	644474	97.50%	13	2.72%
溉	2178		12	20	0.003021%	644494	97.64%	13	2.72%
韓	2198		17	20	0.003021%	644514	97.70%	13	2.72%
卸	2204		8	19	0.00287%	644533	97.72%	13	2.72%
羨	2226		13	19	0.00287%	644552	97.78%	13	2.72%
脊	2229		10	19	0.00287%	644571	97.79%	13	2.72%
澄	2262		15	18	0.002719%	644589	97.88%	13	2.72%
盟	2265		13	18	0.002719%	644607	97.89%	13	2.72%
翁	2269		10	18	0.002719%	644625	97.90%	13	2.72%
蘆	2275		20	18	0.002719%	644643	97.91%	13	2.72%
騎	2285		18	18	0.002719%	644661	97.94%	13	2.72%
埠	2288		11	17	0.002568%	644678	97.95%	13	2.72%
忌	2293		7	17	0.002568%	644695	97.96%	13	2.72%
歎	2299		15	17	0.002568%	644712	97.98%	13	2.72%
頹	2325		16	17	0.002568%	644729	98.04%	13	2.72%
鳳	2326		14	17	0.002568%	644746	98.05%	13	2.72%
儉	2331		15	16	0.002417%	644762	98.06%	13	2.72%
獄	2357		14	16	0.002417%	644778	98.12%	13	2.72%
盜	2358		12	16	0.002417%	644794	98.12%	13	2.72%
芬	2362		8	16	0.002417%	644810	98.13%	13	2.72%
晝	2404		11	15	0.002266%	644825	98.23%	13	2.72%
棲	2407		12	15	0.002266%	644840	98.24%	13	2.72%
睦	2418		13	15	0.002266%	644855	98.26%	13	2.72%
裙	2427		12	15	0.002266%	644870	98.28%	13	2.72%
吊	2441		6	14	0.002115%	644884	98.32%	13	2.72%
拘	2453		8	14	0.002115%	644898	98.34%	13	2.72%
	2455		9	14	0.002115%	644912	98.35%	13	2.72%
漂	2463		14	14	0.002115%	644926	98.36%	13	2.72%
窒	2473		11	14	0.002115%	644940	98.38%	13	2.72%
窺	2474		16	14	0.002115%	644954	98.39%	13	2.72%
簾	2475		19	14	0.002115%	644968	98.39%	13	2.72%
腸	2482		13	14	0.002115%	644982	98.40%	13	2.72%
	2493		11	14	0.002115%	644996	98.43%	13	2.72%
履	2512		15	13	0.001964%	645009	98.46%	13	2.72%
廚	2515		15	13	0.001964%	645022	98.47%	13	2.72%
縛	2542		16	13	0.001964%	645035	98.52%	13	2.72%
臟	2547		22	13	0.001964%	645048	98.53%	13	2.72%
覓	2554		11	13	0.001964%	645061	98.55%	13	2.72%
豎	2556		15	13	0.001964%	645074	98.55%	13	2.72%
玲	1330		9	62	0.009365%	645136	93.00%	12	2.51%
釣	1514		11	47	0.007099%	645183	94.51%	12	2.51%
霜	1532		17	46	0.006948%	645229	94.63%	12	2.51%
噸	1700		16	36	0.005438%	645265	95.66%	12	2.51%
廂	1751		12	34	0.005136%	645299	95.93%	12	2.51%
壇	1851		16	30	0.004531%	645329	96.42%	12	2.51%
怡	1933		8	27	0.004078%	645356	96.77%	12	2.51%
唸	1996		11	25	0.003776%	645381	97.02%	12	2.51%
焉	2005		11	25	0.003776%	645406	97.06%	12	2.51%
辣	2016		14	25	0.003776%	645431	97.10%	12	2.51%
屍	2027		9	24	0.003625%	645455	97.14%	12	2.51%
纖	2038		23	24	0.003625%	645479	97.18%	12	2.51%
鈔	2043		12	24	0.003625%	645503	97.20%	12	2.51%
催	2076		13	22	0.003323%	645525	97.31%	12	2.51%
旱	2089		7	22	0.003323%	645547	97.36%	12	2.51%
瞪	2094		17	22	0.003323%	645569	97.37%	12	2.51%
簽	2097		19	22	0.003323%	645591	97.38%	12	2.51%
巡	2119		7	21	0.003172%	645612	97.45%	12	2.51%
恥	2122		10	21	0.003172%	645633	97.46%	12	2.51%
揉	2126		12	21	0.003172%	645654	97.48%	12	2.51%
炸	2135		9	21	0.003172%	645675	97.51%	12	2.51%
賺	2149		17	21	0.003172%	645696	97.55%	12	2.51%
贏	2150		20	21	0.003172%	645717	97.55%	12	2.51%
匪	2162		10	20	0.003021%	645737	97.59%	12	2.51%
濛	2179		17	20	0.003021%	645757	97.64%	12	2.51%
纔	2187		23	20	0.003021%	645777	97.67%	12	2.51%
萌	2190		12	20	0.003021%	645797	97.67%	12	2.51%
萄	2191		12	20	0.003021%	645817	97.68%	12	2.51%
丘	2201		5	19	0.00287%	645836	97.71%	12	2.51%
鄧	2235		14	19	0.00287%	645855	97.81%	12	2.51%
鴻	2239		17	19	0.00287%	645874	97.82%	12	2.51%
仿	2240		6	18	0.002719%	645892	97.82%	12	2.51%
匠	2242		6	18	0.002719%	645910	97.83%	12	2.51%
曼	2257		11	18	0.002719%	645928	97.87%	12	2.51%
堡	2289		12	17	0.002568%	645945	97.95%	12	2.51%
欽	2298		12	17	0.002568%	645962	97.98%	12	2.51%
涵	2300		11	17	0.002568%	645979	97.98%	12	2.51%
逛	2320		10	17	0.002568%	645996	98.03%	12	2.51%
霍	2324		16	17	0.002568%	646013	98.04%	12	2.51%
叛	2334		9	16	0.002417%	646029	98.07%	12	2.51%
咬	2338		9	16	0.002417%	646045	98.08%	12	2.51%
嬰	2343		17	16	0.002417%	646061	98.09%	12	2.51%
巍	2345		21	16	0.002417%	646077	98.09%	12	2.51%
怖	2346		8	16	0.002417%	646093	98.10%	12	2.51%
恭	2347		10	16	0.002417%	646109	98.10%	12	2.51%
褲	2366		15	16	0.002417%	646125	98.14%	12	2.51%
逸	2369		11	16	0.002417%	646141	98.15%	12	2.51%
釀	2372		24	16	0.002417%	646157	98.16%	12	2.51%
鉅	2374		13	16	0.002417%	646173	98.16%	12	2.51%
頒	2378		13	16	0.002417%	646189	98.17%	12	2.51%
駁	2379		14	16	0.002417%	646205	98.18%	12	2.51%
仇	2382		4	15	0.002266%	646220	98.18%	12	2.51%
卓	2387		8	15	0.002266%	646235	98.19%	12	2.51%
慷	2397		14	15	0.002266%	646250	98.22%	12	2.51%
挨	2400		10	15	0.002266%	646265	98.22%	12	2.51%
洒	2410		9	15	0.002266%	646280	98.25%	12	2.51%
祈	2420		8	15	0.002266%	646295	98.27%	12	2.51%
闖	2433		18	15	0.002266%	646310	98.30%	12	2.51%
雕	2434		16	15	0.002266%	646325	98.30%	12	2.51%
顫	2435		22	15	0.002266%	646340	98.30%	12	2.51%
鶴	2436		21	15	0.002266%	646355	98.31%	12	2.51%
仲	2437		6	14	0.002115%	646369	98.31%	12	2.51%
刮	2439		8	14	0.002115%	646383	98.31%	12	2.51%
嘶	2443		15	14	0.002115%	646397	98.32%	12	2.51%
巢	2449		11	14	0.002115%	646411	98.33%	12	2.51%
沛	2459		7	14	0.002115%	646425	98.35%	12	2.51%
洽	2460		9	14	0.002115%	646439	98.36%	12	2.51%
禿	2471		7	14	0.002115%	646453	98.38%	12	2.51%
糕	2477		16	14	0.002115%	646467	98.39%	12	2.51%
紗	2479		10	14	0.002115%	646481	98.40%	12	2.51%
聆	2480		11	14	0.002115%	646495	98.40%	12	2.51%
襟	2488		18	14	0.002115%	646509	98.42%	12	2.51%
診	2489		12	14	0.002115%	646523	98.42%	12	2.51%
宴	2509		10	13	0.001964%	646536	98.46%	12	2.51%
摯	2522		15	13	0.001964%	646549	98.48%	12	2.51%
榜	2526		14	13	0.001964%	646562	98.49%	12	2.51%
宛	2572		8	12	0.001813%	646574	98.58%	12	2.51%
稠	2601		13	12	0.001813%	646586	98.63%	12	2.51%
蔓	2611		15	12	0.001813%	646598	98.65%	12	2.51%
賜	2619		15	12	0.001813%	646610	98.67%	12	2.51%
蹈	2622		17	12	0.001813%	646622	98.67%	12	2.51%
俄	837		9	138	0.02084%	646760	85.98%	11	2.30%
翰	1570		16	43	0.006495%	646803	94.88%	11	2.30%
姆	1652		8	38	0.00574%	646841	95.39%	11	2.30%
薩	1740		18	35	0.005287%	646876	95.87%	11	2.30%
曆	1761		16	34	0.005136%	646910	95.98%	11	2.30%
巿	1775		4	33	0.004985%	646943	96.05%	11	2.30%
扇	1802		10	32	0.004833%	646975	96.19%	11	2.30%
煤	1839		13	31	0.004682%	647006	96.36%	11	2.30%
臘	1871		19	30	0.004531%	647036	96.51%	11	2.30%
兆	1926		6	27	0.004078%	647063	96.75%	11	2.30%
圾	1997		7	25	0.003776%	647088	97.03%	11	2.30%
畝	2009		10	25	0.003776%	647113	97.07%	11	2.30%
垃	2023		8	24	0.003625%	647137	97.13%	11	2.30%
滔	2092		13	22	0.003323%	647159	97.37%	11	2.30%
碗	2095		13	22	0.003323%	647181	97.38%	11	2.30%
淫	2131		11	21	0.003172%	647202	97.49%	11	2.30%
荊	2144		10	21	0.003172%	647223	97.53%	11	2.30%
砍	2182		9	20	0.003021%	647243	97.65%	11	2.30%
竿	2185		9	20	0.003021%	647263	97.66%	11	2.30%
蝴	2192		15	20	0.003021%	647283	97.68%	11	2.30%
縷	2225		17	19	0.00287%	647302	97.78%	11	2.30%
宵	2246		10	18	0.002719%	647320	97.84%	11	2.30%
屠	2247		11	18	0.002719%	647338	97.84%	11	2.30%
煮	2263		12	18	0.002719%	647356	97.88%	11	2.30%
邏	2280		22	18	0.002719%	647374	97.93%	11	2.30%
櫃	2297		18	17	0.002568%	647391	97.97%	11	2.30%
瀾	2303		20	17	0.002568%	647408	97.99%	11	2.30%
緬	2309		15	17	0.002568%	647425	98.00%	11	2.30%
腿	2311		14	17	0.002568%	647442	98.01%	11	2.30%
苟	2312		9	17	0.002568%	647459	98.01%	11	2.30%
逾	2321		12	17	0.002568%	647476	98.03%	11	2.30%
坎	2342		7	16	0.002417%	647492	98.09%	11	2.30%
檯	2352		18	16	0.002417%	647508	98.11%	11	2.30%
熄	2355		14	16	0.002417%	647524	98.12%	11	2.30%
稚	2359		13	16	0.002417%	647540	98.13%	11	2.30%
鄙	2370		13	16	0.002417%	647556	98.15%	11	2.30%
閑	2376		12	16	0.002417%	647572	98.17%	11	2.30%
弦	2396		8	15	0.002266%	647587	98.21%	11	2.30%
棚	2408		12	15	0.002266%	647602	98.24%	11	2.30%
湊	2412		12	15	0.002266%	647617	98.25%	11	2.30%
渠	2413		12	15	0.002266%	647632	98.25%	11	2.30%
渣	2414		12	15	0.002266%	647647	98.26%	11	2.30%
澗	2415		15	15	0.002266%	647662	98.26%	11	2.30%
萊	2425		12	15	0.002266%	647677	98.28%	11	2.30%
坭	2445		8	14	0.002115%	647691	98.32%	11	2.30%
憩	2452		16	14	0.002115%	647705	98.34%	11	2.30%
煉	2465		13	14	0.002115%	647719	98.37%	11	2.30%
糟	2478		17	14	0.002115%	647733	98.39%	11	2.30%
跪	2491		13	14	0.002115%	647747	98.42%	11	2.30%
啼	2504		12	13	0.001964%	647760	98.45%	11	2.30%
壤	2508		20	13	0.001964%	647773	98.46%	11	2.30%
屢	2511		14	13	0.001964%	647786	98.46%	11	2.30%
惘	2517		11	13	0.001964%	647799	98.47%	11	2.30%
扭	2519		7	13	0.001964%	647812	98.48%	11	2.30%
撼	2523		16	13	0.001964%	647825	98.49%	11	2.30%
朽	2524		6	13	0.001964%	647838	98.49%	11	2.30%
瀉	2530		18	13	0.001964%	647851	98.50%	11	2.30%
玄	2532		5	13	0.001964%	647864	98.50%	11	2.30%
邁	2557		16	13	0.001964%	647877	98.55%	11	2.30%
嘯	2569		15	12	0.001813%	647889	98.57%	11	2.30%
嚮	2570		18	12	0.001813%	647901	98.58%	11	2.30%
廓	2575		14	12	0.001813%	647913	98.59%	11	2.30%
恍	2576		9	12	0.001813%	647925	98.59%	11	2.30%
洶	2590		9	12	0.001813%	647937	98.61%	11	2.30%
漾	2593		14	12	0.001813%	647949	98.62%	11	2.30%
皺	2599		15	12	0.001813%	647961	98.63%	11	2.30%
箕	2604		14	12	0.001813%	647973	98.64%	11	2.30%
訝	2613		11	12	0.001813%	647985	98.65%	11	2.30%
郁	2623		8	12	0.001813%	647997	98.67%	11	2.30%
鑲	2626		25	12	0.001813%	648009	98.68%	11	2.30%
俠	2632		9	11	0.001662%	648020	98.69%	11	2.30%
摔	2652		14	11	0.001662%	648031	98.72%	11	2.30%
焰	2669		12	11	0.001662%	648042	98.75%	11	2.30%
煞	2670		13	11	0.001662%	648053	98.75%	11	2.30%
蔚	2689		15	11	0.001662%	648064	98.78%	11	2.30%
鍵	1461		17	51	0.007703%	648115	94.12%	10	2.09%
爺	1553		13	44	0.006646%	648159	94.77%	10	2.09%
屯	1702		4	36	0.005438%	648195	95.67%	10	2.09%
臺	1715		14	36	0.005438%	648231	95.74%	10	2.09%
艘	1842		15	31	0.004682%	648262	96.38%	10	2.09%
憲	1857		16	30	0.004531%	648292	96.44%	10	2.09%
幢	1932		15	27	0.004078%	648319	96.77%	10	2.09%
菊	1952		12	27	0.004078%	648346	96.85%	10	2.09%
祿	1980		12	26	0.003927%	648372	96.96%	10	2.09%
穌	2012		16	25	0.003776%	648397	97.08%	10	2.09%
殿	2057		13	23	0.003474%	648420	97.25%	10	2.09%
撈	2087		15	22	0.003323%	648442	97.35%	10	2.09%
廊	2120		12	21	0.003172%	648463	97.46%	10	2.09%
鼠	2158		13	21	0.003172%	648484	97.58%	10	2.09%
咳	2163		9	20	0.003021%	648504	97.59%	10	2.09%
笨	2186		11	20	0.003021%	648524	97.66%	10	2.09%
壘	2207		18	19	0.00287%	648543	97.73%	10	2.09%
柯	2258		9	18	0.002719%	648561	97.87%	10	2.09%
賬	2278		15	18	0.002719%	648579	97.92%	10	2.09%
蹦	2279		18	18	0.002719%	648597	97.93%	10	2.09%
墟	2290		15	17	0.002568%	648614	97.95%	10	2.09%
熊	2305		14	17	0.002568%	648631	97.99%	10	2.09%
爵	2306		17	17	0.002568%	648648	98.00%	10	2.09%
董	2313		13	17	0.002568%	648665	98.01%	10	2.09%
乙	2329		1	16	0.002417%	648681	98.05%	10	2.09%
哮	2339		10	16	0.002417%	648697	98.08%	10	2.09%
溺	2353		13	16	0.002417%	648713	98.11%	10	2.09%
虹	2364		9	16	0.002417%	648729	98.14%	10	2.09%
裹	2365		14	16	0.002417%	648745	98.14%	10	2.09%
凋	2386		10	15	0.002266%	648760	98.19%	10	2.09%
咸	2388		9	15	0.002266%	648775	98.20%	10	2.09%
奠	2393		12	15	0.002266%	648790	98.21%	10	2.09%
屑	2395		10	15	0.002266%	648805	98.21%	10	2.09%
拙	2399		8	15	0.002266%	648820	98.22%	10	2.09%
敞	2402		12	15	0.002266%	648835	98.23%	10	2.09%
眨	2417		10	15	0.002266%	648850	98.26%	10	2.09%
禦	2421		16	15	0.002266%	648865	98.27%	10	2.09%
貯	2429		12	15	0.002266%	648880	98.29%	10	2.09%
勾	2440		4	14	0.002115%	648894	98.31%	10	2.09%
恤	2451		9	14	0.002115%	648908	98.34%	10	2.09%
棘	2456		12	14	0.002115%	648922	98.35%	10	2.09%
濁	2464		16	14	0.002115%	648936	98.36%	10	2.09%
瑩	2467		15	14	0.002115%	648950	98.37%	10	2.09%
盞	2468		13	14	0.002115%	648964	98.37%	10	2.09%
瞧	2469		17	14	0.002115%	648978	98.37%	10	2.09%
籬	2476		25	14	0.002115%	648992	98.39%	10	2.09%
腹	2483		13	14	0.002115%	649006	98.40%	10	2.09%
虫	2487		6	14	0.002115%	649020	98.41%	10	2.09%
侶	2498		9	13	0.001964%	649033	98.44%	10	2.09%
嘲	2506		15	13	0.001964%	649046	98.45%	10	2.09%
寥	2510		14	13	0.001964%	649059	98.46%	10	2.09%
峨	2513		10	13	0.001964%	649072	98.47%	10	2.09%
幌	2514		13	13	0.001964%	649085	98.47%	10	2.09%
戚	2518		11	13	0.001964%	649098	98.48%	10	2.09%
挾	2520		10	13	0.001964%	649111	98.48%	10	2.09%
搜	2521		12	13	0.001964%	649124	98.48%	10	2.09%
睜	2535		13	13	0.001964%	649137	98.51%	10	2.09%
禾	2539		5	13	0.001964%	649150	98.52%	10	2.09%
絮	2541		12	13	0.001964%	649163	98.52%	10	2.09%
蔣	2549		15	13	0.001964%	649176	98.54%	10	2.09%
蜂	2550		13	13	0.001964%	649189	98.54%	10	2.09%
鋒	2559		15	13	0.001964%	649202	98.56%	10	2.09%
閣	2561		14	13	0.001964%	649215	98.56%	10	2.09%
悽	2577		11	12	0.001813%	649227	98.59%	10	2.09%
惆	2578		11	12	0.001813%	649239	98.59%	10	2.09%
撐	2581		15	12	0.001813%	649251	98.60%	10	2.09%
撕	2582		15	12	0.001813%	649263	98.60%	10	2.09%
斬	2583		11	12	0.001813%	649275	98.60%	10	2.09%
稻	2602		15	12	0.001813%	649287	98.63%	10	2.09%
笛	2603		11	12	0.001813%	649299	98.64%	10	2.09%
	2610		13	12	0.001813%	649311	98.65%	10	2.09%
誓	2614		14	12	0.001813%	649323	98.66%	10	2.09%
亟	2630		8	11	0.001662%	649334	98.68%	10	2.09%
孕	2643		5	11	0.001662%	649345	98.71%	10	2.09%
怯	2648		8	11	0.001662%	649356	98.71%	10	2.09%
惕	2649		11	11	0.001662%	649367	98.72%	10	2.09%
懦	2650		17	11	0.001662%	649378	98.72%	10	2.09%
擎	2653		17	11	0.001662%	649389	98.72%	10	2.09%
炊	2668		8	11	0.001662%	649400	98.75%	10	2.09%
爪	2672		4	11	0.001662%	649411	98.75%	10	2.09%
稽	2676		15	11	0.001662%	649422	98.76%	10	2.09%
筲	2677		13	11	0.001662%	649433	98.76%	10	2.09%
羈	2682		24	11	0.001662%	649444	98.77%	10	2.09%
茅	2685		9	11	0.001662%	649455	98.78%	10	2.09%
侍	2702		8	10	0.00151%	649465	98.80%	10	2.09%
僻	2706		15	10	0.00151%	649475	98.81%	10	2.09%
劍	2709		15	10	0.00151%	649485	98.81%	10	2.09%
哦	2715		10	10	0.00151%	649495	98.82%	10	2.09%
嬉	2722		15	10	0.00151%	649505	98.83%	10	2.09%
屹	2723		6	10	0.00151%	649515	98.84%	10	2.09%
溯	2733		13	10	0.00151%	649525	98.85%	10	2.09%
澎	2735		15	10	0.00151%	649535	98.85%	10	2.09%
熾	2738		16	10	0.00151%	649545	98.86%	10	2.09%
砌	2740		9	10	0.00151%	649555	98.86%	10	2.09%
肝	2748		7	10	0.00151%	649565	98.87%	10	2.09%
苗	2749		9	10	0.00151%	649575	98.88%	10	2.09%
虞	2755		13	10	0.00151%	649585	98.88%	10	2.09%
螢	2758		16	10	0.00151%	649595	98.89%	10	2.09%
辱	2763		10	10	0.00151%	649605	98.90%	10	2.09%
郵	1669		11	38	0.00574%	649643	95.48%	9	1.88%
寺	1701		6	36	0.005438%	649679	95.66%	9	1.88%
奶	1722		5	35	0.005287%	649714	95.78%	9	1.88%
廷	1752		7	34	0.005136%	649748	95.93%	9	1.88%
桿	1806		11	32	0.004833%	649780	96.21%	9	1.88%
乳	1848		8	30	0.004531%	649810	96.40%	9	1.88%
肌	1870		6	30	0.004531%	649840	96.50%	9	1.88%
脹	1912		12	28	0.004229%	649868	96.69%	9	1.88%
鷹	1923		24	28	0.004229%	649896	96.73%	9	1.88%
侯	1960		9	26	0.003927%	649922	96.88%	9	1.88%
嫁	1969		13	26	0.003927%	649948	96.92%	9	1.88%
秒	2096		9	22	0.003323%	649970	97.38%	9	1.88%
瓏	2137		20	21	0.003172%	649991	97.51%	9	1.88%
挪	2171		10	20	0.003021%	650011	97.62%	9	1.88%
磡	2221		16	19	0.00287%	650030	97.77%	9	1.88%
貸	2233		12	19	0.00287%	650049	97.80%	9	1.88%
喃	2244		12	18	0.002719%	650067	97.83%	9	1.88%
羽	2268		6	18	0.002719%	650085	97.90%	9	1.88%
簇	2308		17	17	0.002568%	650102	98.00%	9	1.88%
麟	2327		23	17	0.002568%	650119	98.05%	9	1.88%
憎	2348		15	16	0.002417%	650135	98.10%	9	1.88%
翼	2360		17	16	0.002417%	650151	98.13%	9	1.88%
艾	2361		6	16	0.002417%	650167	98.13%	9	1.88%
陵	2377		10	16	0.002417%	650183	98.17%	9	1.88%
麓	2380		19	16	0.002417%	650199	98.18%	9	1.88%
昌	2403		8	15	0.002266%	650214	98.23%	9	1.88%
汪	2409		7	15	0.002266%	650229	98.24%	9	1.88%
攷	2454		7	14	0.002115%	650243	98.34%	9	1.88%
淹	2462		11	14	0.002115%	650257	98.36%	9	1.88%
茗	2484		10	14	0.002115%	650271	98.41%	9	1.88%
傘	2499		12	13	0.001964%	650284	98.44%	9	1.88%
毋	2529		4	13	0.001964%	650297	98.50%	9	1.88%
盯	2534		7	13	0.001964%	650310	98.51%	9	1.88%
螺	2551		17	13	0.001964%	650323	98.54%	9	1.88%
唔	2568		10	12	0.001813%	650335	98.57%	9	1.88%
屁	2573		7	12	0.001813%	650347	98.58%	9	1.88%
晉	2584		10	12	0.001813%	650359	98.60%	9	1.88%
暈	2586		13	12	0.001813%	650371	98.61%	9	1.88%
濘	2594		17	12	0.001813%	650383	98.62%	9	1.88%
烘	2595		10	12	0.001813%	650395	98.62%	9	1.88%
爍	2596		19	12	0.001813%	650407	98.62%	9	1.88%
瘡	2597		15	12	0.001813%	650419	98.63%	9	1.88%
賀	2616		12	12	0.001813%	650431	98.66%	9	1.88%
錶	2624		16	12	0.001813%	650443	98.67%	9	1.88%
券	2637		8	11	0.001662%	650454	98.70%	9	1.88%
剌	2638		9	11	0.001662%	650465	98.70%	9	1.88%
巖	2645		23	11	0.001662%	650476	98.71%	9	1.88%
弊	2647		14	11	0.001662%	650487	98.71%	9	1.88%
栽	2658		10	11	0.001662%	650498	98.73%	9	1.88%
歉	2660		14	11	0.001662%	650509	98.73%	9	1.88%
漏	2664		14	11	0.001662%	650520	98.74%	9	1.88%
紮	2678		11	11	0.001662%	650531	98.76%	9	1.88%
繽	2681		20	11	0.001662%	650542	98.77%	9	1.88%
脂	2683		10	11	0.001662%	650553	98.77%	9	1.88%
葵	2688		13	11	0.001662%	650564	98.78%	9	1.88%
蹲	2692		19	11	0.001662%	650575	98.79%	9	1.88%
闡	2697		20	11	0.001662%	650586	98.80%	9	1.88%
鬚	2701		22	11	0.001662%	650597	98.80%	9	1.88%
偎	2703		11	10	0.00151%	650607	98.81%	9	1.88%
刃	2708		3	10	0.00151%	650617	98.81%	9	1.88%
吝	2713		7	10	0.00151%	650627	98.82%	9	1.88%
噬	2717		16	10	0.00151%	650637	98.83%	9	1.88%
奢	2721		11	10	0.00151%	650647	98.83%	9	1.88%
昆	2728		8	10	0.00151%	650657	98.84%	9	1.88%
罕	2746		7	10	0.00151%	650667	98.87%	9	1.88%
茁	2750		9	10	0.00151%	650677	98.88%	9	1.88%
蔬	2752		15	10	0.00151%	650687	98.88%	9	1.88%
衍	2759		9	10	0.00151%	650697	98.89%	9	1.88%
詐	2761		12	10	0.00151%	650707	98.89%	9	1.88%
鬢	2770		24	10	0.00151%	650717	98.91%	9	1.88%
屏	2787		9	9	0.001359%	650726	98.93%	9	1.88%
庇	2788		7	9	0.001359%	650735	98.93%	9	1.88%
悴	2790		11	9	0.001359%	650744	98.93%	9	1.88%
懶	2792		19	9	0.001359%	650753	98.94%	9	1.88%
捷	2795		11	9	0.001359%	650762	98.94%	9	1.88%
撇	2798		14	9	0.001359%	650771	98.95%	9	1.88%
擲	2799		18	9	0.001359%	650780	98.95%	9	1.88%
汰	2811		7	9	0.001359%	650789	98.96%	9	1.88%
沫	2812		8	9	0.001359%	650798	98.96%	9	1.88%
湃	2814		12	9	0.001359%	650807	98.97%	9	1.88%
瞻	2824		18	9	0.001359%	650816	98.98%	9	1.88%
簷	2831		19	9	0.001359%	650825	98.99%	9	1.88%
虔	2840		10	9	0.001359%	650834	99.00%	9	1.88%
裳	2844		14	9	0.001359%	650843	99.01%	9	1.88%
賸	2849		17	9	0.001359%	650852	99.01%	9	1.88%
驀	2859		21	9	0.001359%	650861	99.03%	9	1.88%
鵑	1542		18	45	0.006797%	650906	94.70%	8	1.67%
娜	1723		10	35	0.005287%	650941	95.78%	8	1.67%
侖	1878		8	29	0.00438%	650970	96.54%	8	1.67%
颶	1893		17	29	0.00438%	650999	96.61%	8	1.67%
卿	2048		10	23	0.003474%	651022	97.22%	8	1.67%
胎	2228		9	19	0.00287%	651041	97.79%	8	1.67%
盒	2264		11	18	0.002719%	651059	97.89%	8	1.67%
菌	2273		12	18	0.002719%	651077	97.91%	8	1.67%
詛	2277		12	18	0.002719%	651095	97.92%	8	1.67%
鋁	2281		15	18	0.002719%	651113	97.93%	8	1.67%
嘻	2287		15	17	0.002568%	651130	97.95%	8	1.67%
胃	2310		9	17	0.002568%	651147	98.01%	8	1.67%
轟	2318		21	17	0.002568%	651164	98.03%	8	1.67%
佐	2330		7	16	0.002417%	651180	98.06%	8	1.67%
咖	2336		8	16	0.002417%	651196	98.07%	8	1.67%
啡	2340		11	16	0.002417%	651212	98.08%	8	1.67%
峭	2344		10	16	0.002417%	651228	98.09%	8	1.67%
攔	2350		20	16	0.002417%	651244	98.11%	8	1.67%
荔	2363		10	16	0.002417%	651260	98.14%	8	1.67%
傭	2383		13	15	0.002266%	651275	98.19%	8	1.67%
扉	2398		12	15	0.002266%	651290	98.22%	8	1.67%
棒	2406		12	15	0.002266%	651305	98.24%	8	1.67%
浴	2411		10	15	0.002266%	651320	98.25%	8	1.67%
稼	2422		15	15	0.002266%	651335	98.27%	8	1.67%
罰	2424		14	15	0.002266%	651350	98.28%	8	1.67%
咆	2442		8	14	0.002115%	651364	98.32%	8	1.67%
峻	2448		10	14	0.002115%	651378	98.33%	8	1.67%
氧	2458		10	14	0.002115%	651392	98.35%	8	1.67%
踐	2492		15	14	0.002115%	651406	98.42%	8	1.67%
迪	2494		8	14	0.002115%	651420	98.43%	8	1.67%
丙	2497		5	13	0.001964%	651433	98.43%	8	1.67%
勻	2501		4	13	0.001964%	651446	98.44%	8	1.67%
叔	2502		8	13	0.001964%	651459	98.44%	8	1.67%
磚	2537		16	13	0.001964%	651472	98.51%	8	1.67%
筒	2540		12	13	0.001964%	651485	98.52%	8	1.67%
肢	2545		8	13	0.001964%	651498	98.53%	8	1.67%
腫	2546		13	13	0.001964%	651511	98.53%	8	1.67%
苔	2548		9	13	0.001964%	651524	98.53%	8	1.67%
乞	2564		3	12	0.001813%	651536	98.57%	8	1.67%
巾	2574		3	12	0.001813%	651548	98.58%	8	1.67%
拯	2579		9	12	0.001813%	651560	98.59%	8	1.67%
拳	2580		10	12	0.001813%	651572	98.59%	8	1.67%
朦	2588		18	12	0.001813%	651584	98.61%	8	1.67%
樞	2589		15	12	0.001813%	651596	98.61%	8	1.67%
漓	2592		14	12	0.001813%	651608	98.62%	8	1.67%
碟	2600		14	12	0.001813%	651620	98.63%	8	1.67%
篤	2605		16	12	0.001813%	651632	98.64%	8	1.67%
耍	2607		9	12	0.001813%	651644	98.64%	8	1.67%
袍	2612		10	12	0.001813%	651656	98.65%	8	1.67%
餅	2628		14	12	0.001813%	651668	98.68%	8	1.67%
馮	2629		12	12	0.001813%	651680	98.68%	8	1.67%
凱	2634		12	11	0.001662%	651691	98.69%	8	1.67%
拼	2651		9	11	0.001662%	651702	98.72%	8	1.67%
曹	2654		11	11	0.001662%	651713	98.72%	8	1.67%
淒	2662		11	11	0.001662%	651724	98.74%	8	1.67%
濯	2666		17	11	0.001662%	651735	98.74%	8	1.67%
濺	2667		18	11	0.001662%	651746	98.75%	8	1.67%
熙	2671		14	11	0.001662%	651757	98.75%	8	1.67%
碩	2674		14	11	0.001662%	651768	98.76%	8	1.67%
紳	2679		11	11	0.001662%	651779	98.77%	8	1.67%
莉	2687		11	11	0.001662%	651790	98.78%	8	1.67%
蔑	2690		15	11	0.001662%	651801	98.78%	8	1.67%
酌	2693		10	11	0.001662%	651812	98.79%	8	1.67%
頸	2698		16	11	0.001662%	651823	98.80%	8	1.67%
僚	2705		14	10	0.00151%	651833	98.81%	8	1.67%
喂	2716		12	10	0.00151%	651843	98.83%	8	1.67%
圃	2718		10	10	0.00151%	651853	98.83%	8	1.67%
巔	2724		22	10	0.00151%	651863	98.84%	8	1.67%
旬	2727		6	10	0.00151%	651873	98.84%	8	1.67%
殉	2730		10	10	0.00151%	651883	98.85%	8	1.67%
漣	2734		14	10	0.00151%	651893	98.85%	8	1.67%
熬	2737		15	10	0.00151%	651903	98.86%	8	1.67%
簿	2745		19	10	0.00151%	651913	98.87%	8	1.67%
翌	2747		11	10	0.00151%	651923	98.87%	8	1.67%
蜿	2757		14	10	0.00151%	651933	98.89%	8	1.67%
裔	2760		13	10	0.00151%	651943	98.89%	8	1.67%
佇	2773		7	9	0.001359%	651952	98.91%	8	1.67%
凈	2776		10	9	0.001359%	651961	98.92%	8	1.67%
咽	2778		9	9	0.001359%	651970	98.92%	8	1.67%
壑	2781		17	9	0.001359%	651979	98.92%	8	1.67%
憊	2791		16	9	0.001359%	651988	98.94%	8	1.67%
揀	2796		12	9	0.001359%	651997	98.94%	8	1.67%
晒	2800		10	9	0.001359%	652006	98.95%	8	1.67%
暨	2801		14	9	0.001359%	652015	98.95%	8	1.67%
棍	2808		12	9	0.001359%	652024	98.96%	8	1.67%
瓣	2818		19	9	0.001359%	652033	98.97%	8	1.67%
疫	2821		9	9	0.001359%	652042	98.98%	8	1.67%
眷	2823		11	9	0.001359%	652051	98.98%	8	1.67%
矩	2825		10	9	0.001359%	652060	98.98%	8	1.67%
蕉	2839		16	9	0.001359%	652069	99.00%	8	1.67%
裨	2843		13	9	0.001359%	652078	99.01%	8	1.67%
鍛	2855		17	9	0.001359%	652087	99.02%	8	1.67%
僵	2866		15	8	0.001208%	652095	99.04%	8	1.67%
凹	2869		5	8	0.001208%	652103	99.04%	8	1.67%
厥	2870		12	8	0.001208%	652111	99.04%	8	1.67%
垠	2881		9	8	0.001208%	652119	99.06%	8	1.67%
塌	2882		13	8	0.001208%	652127	99.06%	8	1.67%
妒	2883		7	8	0.001208%	652135	99.06%	8	1.67%
慚	2892		14	8	0.001208%	652143	99.07%	8	1.67%
憔	2893		15	8	0.001208%	652151	99.07%	8	1.67%
昭	2896		9	8	0.001208%	652159	99.07%	8	1.67%
曙	2897		17	8	0.001208%	652167	99.07%	8	1.67%
滌	2907		14	8	0.001208%	652175	99.09%	8	1.67%
炫	2911		9	8	0.001208%	652183	99.09%	8	1.67%
烹	2912		11	8	0.001208%	652191	99.09%	8	1.67%
疇	2915		19	8	0.001208%	652199	99.10%	8	1.67%
眶	2919		11	8	0.001208%	652207	99.10%	8	1.67%
膛	2933		15	8	0.001208%	652215	99.12%	8	1.67%
虐	2937		9	8	0.001208%	652223	99.12%	8	1.67%
鴿	2960		17	8	0.001208%	652231	99.15%	8	1.67%
鷗	2961		22	8	0.001208%	652239	99.15%	8	1.67%
媳	1465		13	50	0.007552%	652289	94.15%	7	1.46%
廁	1466		12	50	0.007552%	652339	94.16%	7	1.46%
壩	1490		24	48	0.00725%	652387	94.33%	7	1.46%
邑	1631		7	40	0.006042%	652427	95.26%	7	1.46%
梵	1686		11	37	0.005589%	652464	95.58%	7	1.46%
瓶	1690		11	37	0.005589%	652501	95.60%	7	1.46%
莎	1716		11	36	0.005438%	652537	95.74%	7	1.46%
詹	1791		13	33	0.004985%	652570	96.13%	7	1.46%
貓	1954		16	27	0.004078%	652597	96.86%	7	1.46%
蚊	2014		10	25	0.003776%	652622	97.09%	7	1.46%
膨	2039		16	24	0.003625%	652646	97.18%	7	1.46%
狐	2217		8	19	0.00287%	652665	97.75%	7	1.46%
穴	2222		5	19	0.00287%	652684	97.77%	7	1.46%
蟬	2315		18	17	0.002568%	652701	98.02%	7	1.46%
兮	2385		4	15	0.002266%	652716	98.19%	7	1.46%
唧	2389		10	15	0.002266%	652731	98.20%	7	1.46%
囉	2391		22	15	0.002266%	652746	98.20%	7	1.46%
埃	2392		10	15	0.002266%	652761	98.21%	7	1.46%
鶯	2496		21	14	0.002115%	652775	98.43%	7	1.46%
僕	2500		14	13	0.001964%	652788	98.44%	7	1.46%
嗜	2505		13	13	0.001964%	652801	98.45%	7	1.46%
檔	2528		17	13	0.001964%	652814	98.49%	7	1.46%
猴	2531		12	13	0.001964%	652827	98.50%	7	1.46%
蠅	2552		19	13	0.001964%	652840	98.54%	7	1.46%
鎊	2560		18	13	0.001964%	652853	98.56%	7	1.46%
鹿	2563		11	13	0.001964%	652866	98.56%	7	1.46%
晃	2585		10	12	0.001813%	652878	98.60%	7	1.46%
癌	2598		17	12	0.001813%	652890	98.63%	7	1.46%
貶	2617		12	12	0.001813%	652902	98.66%	7	1.46%
賊	2618		13	12	0.001813%	652914	98.66%	7	1.46%
倖	2633		10	11	0.001662%	652925	98.69%	7	1.46%
喬	2640		12	11	0.001662%	652936	98.70%	7	1.46%
崖	2644		11	11	0.001662%	652947	98.71%	7	1.46%
朿	2655		6	11	0.001662%	652958	98.73%	7	1.46%
梳	2657		10	11	0.001662%	652969	98.73%	7	1.46%
裸	2691		13	11	0.001662%	652980	98.79%	7	1.46%
冶	2707		7	10	0.00151%	652990	98.81%	7	1.46%
吋	2712		6	10	0.00151%	653000	98.82%	7	1.46%
堵	2719		11	10	0.00151%	653010	98.83%	7	1.46%
竄	2744		18	10	0.00151%	653020	98.87%	7	1.46%
藤	2753		19	10	0.00151%	653030	98.88%	7	1.46%
諭	2762		16	10	0.00151%	653040	98.89%	7	1.46%
遏	2764		12	10	0.00151%	653050	98.90%	7	1.46%
隸	2766		17	10	0.00151%	653060	98.90%	7	1.46%
馴	2769		13	10	0.00151%	653070	98.91%	7	1.46%
魏	2771		18	10	0.00151%	653080	98.91%	7	1.46%
儼	2775		22	9	0.001359%	653089	98.91%	7	1.46%
嚷	2780		20	9	0.001359%	653098	98.92%	7	1.46%
寓	2785		12	9	0.001359%	653107	98.93%	7	1.46%
扁	2793		9	9	0.001359%	653116	98.94%	7	1.46%
抄	2794		7	9	0.001359%	653125	98.94%	7	1.46%
搗	2797		13	9	0.001359%	653134	98.94%	7	1.46%
朧	2802		20	9	0.001359%	653143	98.95%	7	1.46%
桶	2806		11	9	0.001359%	653152	98.96%	7	1.46%
棋	2807		12	9	0.001359%	653161	98.96%	7	1.46%
歪	2810		9	9	0.001359%	653170	98.96%	7	1.46%
涌	2813		10	9	0.001359%	653179	98.97%	7	1.46%
漪	2815		14	9	0.001359%	653188	98.97%	7	1.46%
狄	2817		7	9	0.001359%	653197	98.97%	7	1.46%
甫	2819		7	9	0.001359%	653206	98.97%	7	1.46%
竊	2829		23	9	0.001359%	653215	98.99%	7	1.46%
簸	2830		19	9	0.001359%	653224	98.99%	7	1.46%
肺	2834		8	9	0.001359%	653233	98.99%	7	1.46%
膽	2835		17	9	0.001359%	653242	99.00%	7	1.46%
茵	2837		10	9	0.001359%	653251	99.00%	7	1.46%
蜒	2841		14	9	0.001359%	653260	99.00%	7	1.46%
諧	2846		16	9	0.001359%	653269	99.01%	7	1.46%
譏	2847		19	9	0.001359%	653278	99.01%	7	1.46%
頃	2858		11	9	0.001359%	653287	99.03%	7	1.46%
仗	2863		5	8	0.001208%	653295	99.03%	7	1.46%
倣	2864		10	8	0.001208%	653303	99.03%	7	1.46%
喲	2876		12	8	0.001208%	653311	99.05%	7	1.46%
喻	2877		12	8	0.001208%	653319	99.05%	7	1.46%
弔	2889		4	8	0.001208%	653327	99.06%	7	1.46%
愴	2891		13	8	0.001208%	653335	99.07%	7	1.46%
拐	2895		8	8	0.001208%	653343	99.07%	7	1.46%
枉	2899		8	8	0.001208%	653351	99.08%	7	1.46%
樁	2903		15	8	0.001208%	653359	99.08%	7	1.46%
涎	2904		11	8	0.001208%	653367	99.08%	7	1.46%
湘	2905		12	8	0.001208%	653375	99.08%	7	1.46%
滄	2906		13	8	0.001208%	653383	99.09%	7	1.46%
疚	2916		8	8	0.001208%	653391	99.10%	7	1.46%
眸	2920		11	8	0.001208%	653399	99.10%	7	1.46%
籐	2926		21	8	0.001208%	653407	99.11%	7	1.46%
腥	2932		13	8	0.001208%	653415	99.12%	7	1.46%
膩	2934		16	8	0.001208%	653423	99.12%	7	1.46%
蝦	2938		15	8	0.001208%	653431	99.12%	7	1.46%
贅	2943		18	8	0.001208%	653439	99.13%	7	1.46%
遐	2949		12	8	0.001208%	653447	99.14%	7	1.46%
遽	2950		16	8	0.001208%	653455	99.14%	7	1.46%
霸	2955		21	8	0.001208%	653463	99.14%	7	1.46%
俟	2965		9	7	0.001057%	653470	99.16%	7	1.46%
吼	2972		7	7	0.001057%	653477	99.16%	7	1.46%
哺	2973		10	7	0.001057%	653484	99.16%	7	1.46%
娑	2991		10	7	0.001057%	653491	99.18%	7	1.46%
嫉	2992		13	7	0.001057%	653498	99.18%	7	1.46%
寰	2996		16	7	0.001057%	653505	99.19%	7	1.46%
幟	2998		15	7	0.001057%	653512	99.19%	7	1.46%
惋	3002		11	7	0.001057%	653519	99.20%	7	1.46%
慄	3003		13	7	0.001057%	653526	99.20%	7	1.46%
戾	3006		8	7	0.001057%	653533	99.20%	7	1.46%
撓	3010		15	7	0.001057%	653540	99.20%	7	1.46%
晤	3016		11	7	0.001057%	653547	99.21%	7	1.46%
梓	3019		11	7	0.001057%	653554	99.21%	7	1.46%
焚	3029		12	7	0.001057%	653561	99.22%	7	1.46%
狽	3031		10	7	0.001057%	653568	99.23%	7	1.46%
穆	3042		16	7	0.001057%	653575	99.24%	7	1.46%
粹	3044		14	7	0.001057%	653582	99.24%	7	1.46%
絃	3045		11	7	0.001057%	653589	99.24%	7	1.46%
縈	3047		16	7	0.001057%	653596	99.24%	7	1.46%
辮	3048		20	7	0.001057%	653603	99.24%	7	1.46%
蕪	3056		16	7	0.001057%	653610	99.25%	7	1.46%
酣	3069		12	7	0.001057%	653617	99.27%	7	1.46%
闌	3073		17	7	0.001057%	653624	99.27%	7	1.46%
寨	1549		14	44	0.006646%	653668	94.75%	6	1.25%
余	1676		7	37	0.005589%	653705	95.52%	6	1.25%
瓷	1733		11	35	0.005287%	653740	95.84%	6	1.25%
饑	1847		20	31	0.004682%	653771	96.40%	6	1.25%
弓	1882		3	29	0.00438%	653800	96.56%	6	1.25%
蔡	1892		15	29	0.00438%	653829	96.60%	6	1.25%
瀑	2059		18	23	0.003474%	653852	97.25%	6	1.25%
鍋	2074		17	23	0.003474%	653875	97.31%	6	1.25%
疼	2138		10	21	0.003172%	653896	97.51%	6	1.25%
黛	2200		17	20	0.003021%	653916	97.71%	6	1.25%
楓	2260		13	18	0.002719%	653934	97.87%	6	1.25%
榴	2261		14	18	0.002719%	653952	97.88%	6	1.25%
閡	2323		14	17	0.002568%	653969	98.04%	6	1.25%
乖	2328		8	16	0.002417%	653985	98.05%	6	1.25%
卉	2333		5	16	0.002417%	654001	98.06%	6	1.25%
啤	2390		11	15	0.002266%	654016	98.20%	6	1.25%
掣	2401		12	15	0.002266%	654031	98.23%	6	1.25%
裊	2428		13	15	0.002266%	654046	98.29%	6	1.25%
薛	2485		17	14	0.002115%	654060	98.41%	6	1.25%
禪	2538		16	13	0.001964%	654073	98.51%	6	1.25%
翩	2544		15	13	0.001964%	654086	98.53%	6	1.25%
募	2567		13	12	0.001813%	654098	98.57%	6	1.25%
舜	2609		12	12	0.001813%	654110	98.65%	6	1.25%
謬	2615		18	12	0.001813%	654122	98.66%	6	1.25%
趙	2620		14	12	0.001813%	654134	98.67%	6	1.25%
趾	2621		11	12	0.001813%	654146	98.67%	6	1.25%
鑄	2625		22	12	0.001813%	654158	98.68%	6	1.25%
划	2636		6	11	0.001662%	654169	98.69%	6	1.25%
庶	2646		11	11	0.001662%	654180	98.71%	6	1.25%
湛	2663		12	11	0.001662%	654191	98.74%	6	1.25%
穀	2675		15	11	0.001662%	654202	98.76%	6	1.25%
締	2680		15	11	0.001662%	654213	98.77%	6	1.25%
茸	2686		10	11	0.001662%	654224	98.78%	6	1.25%
酵	2694		14	11	0.001662%	654235	98.79%	6	1.25%
髒	2699		22	11	0.001662%	654246	98.80%	6	1.25%
僧	2704		14	10	0.00151%	654256	98.81%	6	1.25%
叩	2710		5	10	0.00151%	654266	98.82%	6	1.25%
吶	2714		7	10	0.00151%	654276	98.82%	6	1.25%
抨	2726		8	10	0.00151%	654286	98.84%	6	1.25%
汝	2731		6	10	0.00151%	654296	98.85%	6	1.25%
砲	2741		10	10	0.00151%	654306	98.86%	6	1.25%
蛙	2756		12	10	0.00151%	654316	98.89%	6	1.25%
亥	2772		6	9	0.001359%	654325	98.91%	6	1.25%
壟	2782		19	9	0.001359%	654334	98.92%	6	1.25%
嫣	2784		14	9	0.001359%	654343	98.93%	6	1.25%
杆	2803		7	9	0.001359%	654352	98.95%	6	1.25%
灶	2816		7	9	0.001359%	654361	98.97%	6	1.25%
舶	2836		11	9	0.001359%	654370	99.00%	6	1.25%
諦	2845		16	9	0.001359%	654379	99.01%	6	1.25%
豫	2848		16	9	0.001359%	654388	99.01%	6	1.25%
蹓	2850		17	9	0.001359%	654397	99.02%	6	1.25%
輿	2851		17	9	0.001359%	654406	99.02%	6	1.25%
兜	2868		11	8	0.001208%	654414	99.04%	6	1.25%
叮	2871		5	8	0.001208%	654422	99.04%	6	1.25%
吁	2873		6	8	0.001208%	654430	99.05%	6	1.25%
嗣	2879		13	8	0.001208%	654438	99.05%	6	1.25%
噢	2880		16	8	0.001208%	654446	99.05%	6	1.25%
寐	2885		12	8	0.001208%	654454	99.06%	6	1.25%
岑	2886		7	8	0.001208%	654462	99.06%	6	1.25%
廬	2888		19	8	0.001208%	654470	99.06%	6	1.25%
榻	2902		14	8	0.001208%	654478	99.08%	6	1.25%
猖	2913		11	8	0.001208%	654486	99.09%	6	1.25%
瞥	2921		16	8	0.001208%	654494	99.10%	6	1.25%
窪	2925		14	8	0.001208%	654502	99.11%	6	1.25%
罐	2931		24	8	0.001208%	654510	99.12%	6	1.25%
詭	2940		13	8	0.001208%	654518	99.13%	6	1.25%
謎	2941		17	8	0.001208%	654526	99.13%	6	1.25%
賤	2942		15	8	0.001208%	654534	99.13%	6	1.25%
餵	2956		17	8	0.001208%	654542	99.15%	6	1.25%
驢	2957		26	8	0.001208%	654550	99.15%	6	1.25%
鯉	2958		18	8	0.001208%	654558	99.15%	6	1.25%
佑	2962		7	7	0.001057%	654565	99.15%	6	1.25%
伶	2963		7	7	0.001057%	654572	99.15%	6	1.25%
侷	2966		9	7	0.001057%	654579	99.16%	6	1.25%
傢	2967		12	7	0.001057%	654586	99.16%	6	1.25%
剖	2970		10	7	0.001057%	654593	99.16%	6	1.25%
啄	2974		11	7	0.001057%	654600	99.17%	6	1.25%
啻	2975		12	7	0.001057%	654607	99.17%	6	1.25%
唾	2976		12	7	0.001057%	654614	99.17%	6	1.25%
嗇	2978		13	7	0.001057%	654621	99.17%	6	1.25%
嘛	2980		14	7	0.001057%	654628	99.17%	6	1.25%
嘔	2981		14	7	0.001057%	654635	99.17%	6	1.25%
囑	2985		24	7	0.001057%	654642	99.18%	6	1.25%
墊	2988		14	7	0.001057%	654649	99.18%	6	1.25%
墾	2989		16	7	0.001057%	654656	99.18%	6	1.25%
夥	2990		14	7	0.001057%	654663	99.18%	6	1.25%
彰	2999		14	7	0.001057%	654670	99.19%	6	1.25%
恕	3000		10	7	0.001057%	654677	99.19%	6	1.25%
拭	3007		9	7	0.001057%	654684	99.20%	6	1.25%
搓	3008		13	7	0.001057%	654691	99.20%	6	1.25%
撮	3011		15	7	0.001057%	654698	99.20%	6	1.25%
攜	3013		21	7	0.001057%	654705	99.21%	6	1.25%
晦	3017		11	7	0.001057%	654712	99.21%	6	1.25%
暉	3018		13	7	0.001057%	654719	99.21%	6	1.25%
沁	3023		7	7	0.001057%	654726	99.22%	6	1.25%
沃	3024		7	7	0.001057%	654733	99.22%	6	1.25%
涸	3025		11	7	0.001057%	654740	99.22%	6	1.25%
燙	3030		16	7	0.001057%	654747	99.22%	6	1.25%
皎	3039		11	7	0.001057%	654754	99.23%	6	1.25%
矜	3040		9	7	0.001057%	654761	99.24%	6	1.25%
絞	3046		12	7	0.001057%	654768	99.24%	6	1.25%
肖	3049		7	7	0.001057%	654775	99.24%	6	1.25%
芙	3051		8	7	0.001057%	654782	99.25%	6	1.25%
芭	3052		8	7	0.001057%	654789	99.25%	6	1.25%
貞	3061		9	7	0.001057%	654796	99.26%	6	1.25%
踵	3063		16	7	0.001057%	654803	99.26%	6	1.25%
躅	3064		20	7	0.001057%	654810	99.26%	6	1.25%
辜	3066		12	7	0.001057%	654817	99.26%	6	1.25%
霉	3074		15	7	0.001057%	654824	99.27%	6	1.25%
頤	3075		16	7	0.001057%	654831	99.27%	6	1.25%
飼	3077		13	7	0.001057%	654838	99.27%	6	1.25%
俊	3083		9	6	0.0009063%	654844	99.28%	6	1.25%
匿	3089		11	6	0.0009063%	654850	99.29%	6	1.25%
卒	3090		8	6	0.0009063%	654856	99.29%	6	1.25%
墻	3100		16	6	0.0009063%	654862	99.30%	6	1.25%
寵	3107		19	6	0.0009063%	654868	99.30%	6	1.25%
屐	3108		10	6	0.0009063%	654874	99.30%	6	1.25%
嶄	3110		14	6	0.0009063%	654880	99.30%	6	1.25%
彙	3114		13	6	0.0009063%	654886	99.31%	6	1.25%
恬	3117		9	6	0.0009063%	654892	99.31%	6	1.25%
悸	3123		11	6	0.0009063%	654898	99.32%	6	1.25%
懊	3126		16	6	0.0009063%	654904	99.32%	6	1.25%
扼	3127		7	6	0.0009063%	654910	99.32%	6	1.25%
捱	3129		11	6	0.0009063%	654916	99.32%	6	1.25%
摒	3130		12	6	0.0009063%	654922	99.32%	6	1.25%
撰	3132		15	6	0.0009063%	654928	99.32%	6	1.25%
攏	3133		19	6	0.0009063%	654934	99.33%	6	1.25%
旭	3135		6	6	0.0009063%	654940	99.33%	6	1.25%
昧	3137		9	6	0.0009063%	654946	99.33%	6	1.25%
櫥	3147		19	6	0.0009063%	654952	99.34%	6	1.25%
浙	3151		10	6	0.0009063%	654958	99.34%	6	1.25%
淌	3153		11	6	0.0009063%	654964	99.34%	6	1.25%
淆	3156		11	6	0.0009063%	654970	99.35%	6	1.25%
瀕	3159		19	6	0.0009063%	654976	99.35%	6	1.25%
灑	3160		22	6	0.0009063%	654982	99.35%	6	1.25%
煽	3166		14	6	0.0009063%	654988	99.36%	6	1.25%
牟	3167		6	6	0.0009063%	654994	99.36%	6	1.25%
癥	3175		20	6	0.0009063%	655000	99.36%	6	1.25%
磋	3178		15	6	0.0009063%	655006	99.37%	6	1.25%
礡	3179		19	6	0.0009063%	655012	99.37%	6	1.25%
秧	3180		10	6	0.0009063%	655018	99.37%	6	1.25%
窘	3182		12	6	0.0009063%	655024	99.37%	6	1.25%
脖	3194		11	6	0.0009063%	655030	99.38%	6	1.25%
膊	3195		14	6	0.0009063%	655036	99.38%	6	1.25%
茄	3198		9	6	0.0009063%	655042	99.38%	6	1.25%
蓉	3201		14	6	0.0009063%	655048	99.39%	6	1.25%
蒞	3202		14	6	0.0009063%	655054	99.39%	6	1.25%
薯	3203		17	6	0.0009063%	655060	99.39%	6	1.25%
蟻	3205		19	6	0.0009063%	655066	99.39%	6	1.25%
蠢	3207		21	6	0.0009063%	655072	99.39%	6	1.25%
諺	3208		16	6	0.0009063%	655078	99.39%	6	1.25%
諷	3209		16	6	0.0009063%	655084	99.39%	6	1.25%
蹤	3216		18	6	0.0009063%	655090	99.40%	6	1.25%
逍	3223		10	6	0.0009063%	655096	99.41%	6	1.25%
遑	3224		12	6	0.0009063%	655102	99.41%	6	1.25%
鋤	3227		15	6	0.0009063%	655108	99.41%	6	1.25%
鑒	3230		22	6	0.0009063%	655114	99.41%	6	1.25%
陡	3232		9	6	0.0009063%	655120	99.42%	6	1.25%
駭	3233		16	6	0.0009063%	655126	99.42%	6	1.25%
髦	3234		14	6	0.0009063%	655132	99.42%	6	1.25%
黏	3238		17	6	0.0009063%	655138	99.42%	6	1.25%
齋	3239		17	6	0.0009063%	655144	99.42%	6	1.25%
柬	1684		9	37	0.005589%	655181	95.57%	5	1.05%
炕	1764		8	34	0.005136%	655215	96.00%	5	1.05%
傅	1879		12	29	0.00438%	655244	96.54%	5	1.05%
鉛	1989		13	26	0.003927%	655270	97.00%	5	1.05%
梨	2213		11	19	0.00287%	655289	97.74%	5	1.05%
畜	2219		10	19	0.00287%	655308	97.76%	5	1.05%
卜	2243		2	18	0.002719%	655326	97.83%	5	1.05%
娶	2245		11	18	0.002719%	655344	97.83%	5	1.05%
壺	2291		12	17	0.002568%	655361	97.96%	5	1.05%
棕	2351		12	16	0.002417%	655377	98.11%	5	1.05%
炙	2416		8	15	0.002266%	655392	98.26%	5	1.05%
纜	2423		27	15	0.002266%	655407	98.28%	5	1.05%
媒	2446		12	14	0.002115%	655421	98.33%	5	1.05%
岳	2447		8	14	0.002115%	655435	98.33%	5	1.05%
磁	2470		14	14	0.002115%	655449	98.38%	5	1.05%
肇	2481		14	14	0.002115%	655463	98.40%	5	1.05%
誨	2490		14	14	0.002115%	655477	98.42%	5	1.05%
纍	2543		21	13	0.001964%	655490	98.52%	5	1.05%
訣	2555		11	13	0.001964%	655503	98.55%	5	1.05%
靡	2562		19	13	0.001964%	655516	98.56%	5	1.05%
傀	2565		12	12	0.001813%	655528	98.57%	5	1.05%
儡	2566		17	12	0.001813%	655540	98.57%	5	1.05%
簌	2606		17	12	0.001813%	655552	98.64%	5	1.05%
嗽	2641		14	11	0.001662%	655563	98.70%	5	1.05%
圳	2642		6	11	0.001662%	655574	98.70%	5	1.05%
槳	2659		15	11	0.001662%	655585	98.73%	5	1.05%
髓	2700		23	11	0.001662%	655596	98.80%	5	1.05%
吏	2711		6	10	0.00151%	655606	98.82%	5	1.05%
汲	2732		7	10	0.00151%	655616	98.85%	5	1.05%
禽	2743		13	10	0.00151%	655626	98.87%	5	1.05%
倔	2774		10	9	0.001359%	655635	98.91%	5	1.05%
夭	2783		4	9	0.001359%	655644	98.92%	5	1.05%
寮	2786		15	9	0.001359%	655653	98.93%	5	1.05%
桐	2805		10	9	0.001359%	655662	98.95%	5	1.05%
畸	2820		13	9	0.001359%	655671	98.98%	5	1.05%
癮	2822		22	9	0.001359%	655680	98.98%	5	1.05%
矯	2826		17	9	0.001359%	655689	98.98%	5	1.05%
穎	2828		16	9	0.001359%	655698	98.99%	5	1.05%
缸	2832		9	9	0.001359%	655707	98.99%	5	1.05%
萍	2838		12	9	0.001359%	655716	99.00%	5	1.05%
郡	2852		9	9	0.001359%	655725	99.02%	5	1.05%
閘	2856		13	9	0.001359%	655734	99.02%	5	1.05%
骯	2860		14	9	0.001359%	655743	99.03%	5	1.05%
叨	2872		5	8	0.001208%	655751	99.04%	5	1.05%
婉	2884		11	8	0.001208%	655759	99.06%	5	1.05%
杖	2898		7	8	0.001208%	655767	99.08%	5	1.05%
濾	2910		18	8	0.001208%	655775	99.09%	5	1.05%
痴	2917		13	8	0.001208%	655783	99.10%	5	1.05%
綵	2929		14	8	0.001208%	655791	99.11%	5	1.05%
苑	2935		9	8	0.001208%	655799	99.12%	5	1.05%
藩	2936		19	8	0.001208%	655807	99.12%	5	1.05%
躂	2944		20	8	0.001208%	655815	99.13%	5	1.05%
軒	2945		10	8	0.001208%	655823	99.13%	5	1.05%
轄	2946		17	8	0.001208%	655831	99.13%	5	1.05%
迂	2947		6	8	0.001208%	655839	99.13%	5	1.05%
迢	2948		8	8	0.001208%	655847	99.14%	5	1.05%
鑿	2953		28	8	0.001208%	655855	99.14%	5	1.05%
佬	2964		8	7	0.001057%	655862	99.16%	5	1.05%
冤	2968		10	7	0.001057%	655869	99.16%	5	1.05%
噩	2982		16	7	0.001057%	655876	99.17%	5	1.05%
嚐	2983		17	7	0.001057%	655883	99.18%	5	1.05%
嚥	2984		19	7	0.001057%	655890	99.18%	5	1.05%
垮	2986		9	7	0.001057%	655897	99.18%	5	1.05%
	2994		9	7	0.001057%	655904	99.19%	5	1.05%
慫	3004		15	7	0.001057%	655911	99.20%	5	1.05%
攘	3012		20	7	0.001057%	655918	99.21%	5	1.05%
棟	3020		12	7	0.001057%	655925	99.21%	5	1.05%
渲	3026		12	7	0.001057%	655932	99.22%	5	1.05%
渦	3027		12	7	0.001057%	655939	99.22%	5	1.05%
炭	3028		9	7	0.001057%	655946	99.22%	5	1.05%
琳	3032		12	7	0.001057%	655953	99.23%	5	1.05%
癱	3038		24	7	0.001057%	655960	99.23%	5	1.05%
芻	3054		10	7	0.001057%	655967	99.25%	5	1.05%
葦	3055		13	7	0.001057%	655974	99.25%	5	1.05%
蠻	3058		25	7	0.001057%	655981	99.25%	5	1.05%
訶	3059		12	7	0.001057%	655988	99.26%	5	1.05%
豁	3060		17	7	0.001057%	655995	99.26%	5	1.05%
辟	3067		13	7	0.001057%	656002	99.26%	5	1.05%
釗	3070		10	7	0.001057%	656009	99.27%	5	1.05%
鍚	3072		17	7	0.001057%	656016	99.27%	5	1.05%
黝	3079		17	7	0.001057%	656023	99.28%	5	1.05%
齣	3080		20	7	0.001057%	656030	99.28%	5	1.05%
丟	3081		6	6	0.0009063%	656036	99.28%	5	1.05%
伺	3082		7	6	0.0009063%	656042	99.28%	5	1.05%
俐	3084		9	6	0.0009063%	656048	99.28%	5	1.05%
冗	3087		4	6	0.0009063%	656054	99.28%	5	1.05%
哉	3092		9	6	0.0009063%	656060	99.29%	5	1.05%
嗆	3096		13	6	0.0009063%	656066	99.29%	5	1.05%
噓	3097		15	6	0.0009063%	656072	99.29%	5	1.05%
墅	3099		14	6	0.0009063%	656078	99.29%	5	1.05%
寇	3106		11	6	0.0009063%	656084	99.30%	5	1.05%
峙	3109		9	6	0.0009063%	656090	99.30%	5	1.05%
帕	3111		8	6	0.0009063%	656096	99.31%	5	1.05%
恙	3118		10	6	0.0009063%	656102	99.31%	5	1.05%
惦	3121		11	6	0.0009063%	656108	99.31%	5	1.05%
惚	3124		11	6	0.0009063%	656114	99.32%	5	1.05%
憫	3125		15	6	0.0009063%	656120	99.32%	5	1.05%
拱	3128		9	6	0.0009063%	656126	99.32%	5	1.05%
搾	3131		13	6	0.0009063%	656132	99.32%	5	1.05%
旳	3136		7	6	0.0009063%	656138	99.33%	5	1.05%
梭	3143		11	6	0.0009063%	656144	99.33%	5	1.05%
檻	3146		18	6	0.0009063%	656150	99.34%	5	1.05%
沈	3149		7	6	0.0009063%	656156	99.34%	5	1.05%
淑	3154		11	6	0.0009063%	656162	99.34%	5	1.05%
漬	3158		14	6	0.0009063%	656168	99.35%	5	1.05%
炳	3163		9	6	0.0009063%	656174	99.35%	5	1.05%
煎	3165		13	6	0.0009063%	656180	99.35%	5	1.05%
牡	3168		7	6	0.0009063%	656186	99.36%	5	1.05%
獗	3170		15	6	0.0009063%	656192	99.36%	5	1.05%
珊	3171		9	6	0.0009063%	656198	99.36%	5	1.05%
癖	3174		18	6	0.0009063%	656204	99.36%	5	1.05%
窟	3184		13	6	0.0009063%	656210	99.37%	5	1.05%
箋	3186		14	6	0.0009063%	656216	99.37%	5	1.05%
糞	3187		17	6	0.0009063%	656222	99.37%	5	1.05%
絨	3190		12	6	0.0009063%	656228	99.38%	5	1.05%
胖	3192		9	6	0.0009063%	656234	99.38%	5	1.05%
脯	3193		11	6	0.0009063%	656240	99.38%	5	1.05%
膺	3196		17	6	0.0009063%	656246	99.38%	5	1.05%
葛	3200		13	6	0.0009063%	656252	99.39%	5	1.05%
蟹	3206		19	6	0.0009063%	656258	99.39%	5	1.05%
謊	3210		17	6	0.0009063%	656264	99.40%	5	1.05%
跋	3212		12	6	0.0009063%	656270	99.40%	5	1.05%
踢	3213		15	6	0.0009063%	656276	99.40%	5	1.05%
躁	3217		20	6	0.0009063%	656282	99.40%	5	1.05%
迭	3220		8	6	0.0009063%	656288	99.40%	5	1.05%
迨	3221		8	6	0.0009063%	656294	99.41%	5	1.05%
銘	3226		14	6	0.0009063%	656300	99.41%	5	1.05%
亙	3240		6	5	0.0007552%	656305	99.42%	5	1.05%
侈	3242		8	5	0.0007552%	656310	99.42%	5	1.05%
剔	3249		10	5	0.0007552%	656315	99.43%	5	1.05%
卵	3253		7	5	0.0007552%	656320	99.43%	5	1.05%
吆	3255		6	5	0.0007552%	656325	99.43%	5	1.05%
哼	3258		10	5	0.0007552%	656330	99.44%	5	1.05%
噪	3262		16	5	0.0007552%	656335	99.44%	5	1.05%
囌	3263		23	5	0.0007552%	656340	99.44%	5	1.05%
坷	3265		8	5	0.0007552%	656345	99.44%	5	1.05%
垢	3267		9	5	0.0007552%	656350	99.44%	5	1.05%
	3268		10	5	0.0007552%	656355	99.44%	5	1.05%
奸	3269		6	5	0.0007552%	656360	99.44%	5	1.05%
妖	3270		7	5	0.0007552%	656365	99.45%	5	1.05%
妍	3271		7	5	0.0007552%	656370	99.45%	5	1.05%
崎	3276		11	5	0.0007552%	656375	99.45%	5	1.05%
嶇	3277		14	5	0.0007552%	656380	99.45%	5	1.05%
廖	3278		14	5	0.0007552%	656385	99.45%	5	1.05%
戈	3281		4	5	0.0007552%	656390	99.45%	5	1.05%
抒	3282		7	5	0.0007552%	656395	99.45%	5	1.05%
搏	3285		13	5	0.0007552%	656400	99.46%	5	1.05%
曬	3289		23	5	0.0007552%	656405	99.46%	5	1.05%
枕	3290		8	5	0.0007552%	656410	99.46%	5	1.05%
栗	3291		10	5	0.0007552%	656415	99.46%	5	1.05%
橙	3293		16	5	0.0007552%	656420	99.46%	5	1.05%
橢	3295		16	5	0.0007552%	656425	99.46%	5	1.05%
	3296		17	5	0.0007552%	656430	99.46%	5	1.05%
燄	3313		16	5	0.0007552%	656435	99.48%	5	1.05%
瑾	3317		15	5	0.0007552%	656440	99.48%	5	1.05%
疆	3318		19	5	0.0007552%	656445	99.48%	5	1.05%
疊	3319		22	5	0.0007552%	656450	99.48%	5	1.05%
盎	3325		10	5	0.0007552%	656455	99.49%	5	1.05%
眩	3326		10	5	0.0007552%	656460	99.49%	5	1.05%
睫	3327		13	5	0.0007552%	656465	99.49%	5	1.05%
秉	3332		8	5	0.0007552%	656470	99.49%	5	1.05%
籟	3336		22	5	0.0007552%	656475	99.50%	5	1.05%
糙	3339		17	5	0.0007552%	656480	99.50%	5	1.05%
綺	3342		14	5	0.0007552%	656485	99.50%	5	1.05%
縹	3343		17	5	0.0007552%	656490	99.50%	5	1.05%
繡	3344		18	5	0.0007552%	656495	99.50%	5	1.05%
肆	3347		13	5	0.0007552%	656500	99.50%	5	1.05%
茉	3353		9	5	0.0007552%	656505	99.51%	5	1.05%
褪	3364		15	5	0.0007552%	656510	99.52%	5	1.05%
詫	3367		13	5	0.0007552%	656515	99.52%	5	1.05%
諱	3369		16	5	0.0007552%	656520	99.52%	5	1.05%
謨	3371		18	5	0.0007552%	656525	99.52%	5	1.05%
躬	3374		10	5	0.0007552%	656530	99.52%	5	1.05%
迥	3376		8	5	0.0007552%	656535	99.53%	5	1.05%
邇	3379		17	5	0.0007552%	656540	99.53%	5	1.05%
醞	3382		17	5	0.0007552%	656545	99.53%	5	1.05%
鈕	3383		12	5	0.0007552%	656550	99.53%	5	1.05%
鈍	3385		12	5	0.0007552%	656555	99.53%	5	1.05%
雛	3391		18	5	0.0007552%	656560	99.54%	5	1.05%
霎	3392		16	5	0.0007552%	656565	99.54%	5	1.05%
霓	3393		16	5	0.0007552%	656570	99.54%	5	1.05%
鞏	3394		15	5	0.0007552%	656575	99.54%	5	1.05%
顰	3396		24	5	0.0007552%	656580	99.54%	5	1.05%
馨	3397		20	5	0.0007552%	656585	99.54%	5	1.05%
鵝	3400		18	5	0.0007552%	656590	99.54%	5	1.05%
龜	3405		16	5	0.0007552%	656595	99.55%	5	1.05%
嫂	1165		12	80	0.01208%	656675	91.24%	4	0.84%
您	1365		11	59	0.008912%	656734	93.32%	4	0.84%
矢	1945		5	27	0.004078%	656761	96.82%	4	0.84%
韋	1991		9	26	0.003927%	656787	97.01%	4	0.84%
祠	2037		9	24	0.003625%	656811	97.18%	4	0.84%
弭	2516		9	13	0.001964%	656824	98.47%	4	0.84%
棺	2525		12	13	0.001964%	656837	98.49%	4	0.84%
瑯	2533		13	13	0.001964%	656850	98.50%	4	0.84%
蠟	2553		21	13	0.001964%	656863	98.54%	4	0.84%
塾	2571		14	12	0.001813%	656875	98.58%	4	0.84%
湄	2591		12	12	0.001813%	656887	98.61%	4	0.84%
膳	2608		16	12	0.001813%	656899	98.65%	4	0.84%
亨	2631		7	11	0.001662%	656910	98.69%	4	0.84%
刑	2635		6	11	0.001662%	656921	98.69%	4	0.84%
匈	2639		6	11	0.001662%	656932	98.70%	4	0.84%
杏	2656		7	11	0.001662%	656943	98.73%	4	0.84%
氫	2661		11	11	0.001662%	656954	98.74%	4	0.84%
澡	2665		16	11	0.001662%	656965	98.74%	4	0.84%
烤	2736		10	10	0.00151%	656975	98.86%	4	0.84%
礫	2742		20	10	0.00151%	656985	98.86%	4	0.84%
醇	2765		15	10	0.00151%	656995	98.90%	4	0.84%
餌	2767		14	10	0.00151%	657005	98.90%	4	0.84%
吱	2777		7	9	0.001359%	657014	98.92%	4	0.84%
喫	2779		12	9	0.001359%	657023	98.92%	4	0.84%
彭	2789		12	9	0.001359%	657032	98.93%	4	0.84%
橡	2809		16	9	0.001359%	657041	98.96%	4	0.84%
祺	2827		12	9	0.001359%	657050	98.98%	4	0.84%
蠶	2842		24	9	0.001359%	657059	99.01%	4	0.84%
霖	2857		16	9	0.001359%	657068	99.03%	4	0.84%
龕	2862		22	9	0.001359%	657077	99.03%	4	0.84%
偵	2865		11	8	0.001208%	657085	99.04%	4	0.84%
啾	2878		12	8	0.001208%	657093	99.05%	4	0.84%
巳	2887		3	8	0.001208%	657101	99.06%	4	0.84%
御	2890		11	8	0.001208%	657109	99.07%	4	0.84%
楷	2901		13	8	0.001208%	657117	99.08%	4	0.84%
漉	2908		14	8	0.001208%	657125	99.09%	4	0.84%
潺	2909		15	8	0.001208%	657133	99.09%	4	0.84%
瞰	2922		17	8	0.001208%	657141	99.10%	4	0.84%
	2927		13	8	0.001208%	657149	99.11%	4	0.84%
緯	2930		15	8	0.001208%	657157	99.11%	4	0.84%
褔	2939		14	8	0.001208%	657165	99.13%	4	0.84%
閥	2954		14	8	0.001208%	657173	99.14%	4	0.84%
凰	2969		11	7	0.001057%	657180	99.16%	4	0.84%
占	2971		5	7	0.001057%	657187	99.16%	4	0.84%
堯	2987		12	7	0.001057%	657194	99.18%	4	0.84%
孽	2993		20	7	0.001057%	657201	99.19%	4	0.84%
寅	2995		11	7	0.001057%	657208	99.19%	4	0.84%
尿	2997		7	7	0.001057%	657215	99.19%	4	0.84%
摟	3009		14	7	0.001057%	657222	99.20%	4	0.84%
攬	3015		24	7	0.001057%	657229	99.21%	4	0.84%
椰	3021		13	7	0.001057%	657236	99.22%	4	0.84%
痙	3036		12	7	0.001057%	657243	99.23%	4	0.84%
碳	3041		14	7	0.001057%	657250	99.24%	4	0.84%
賈	3062		13	7	0.001057%	657257	99.26%	4	0.84%
輻	3065		16	7	0.001057%	657264	99.26%	4	0.84%
	3071		12	7	0.001057%	657271	99.27%	4	0.84%
冥	3088		10	6	0.0009063%	657277	99.28%	4	0.84%
咪	3093		9	6	0.0009063%	657283	99.29%	4	0.84%
妃	3101		6	6	0.0009063%	657289	99.30%	4	0.84%
姻	3102		9	6	0.0009063%	657295	99.30%	4	0.84%
庄	3112		6	6	0.0009063%	657301	99.31%	4	0.84%
	3113		8	6	0.0009063%	657307	99.31%	4	0.84%
怔	3116		8	6	0.0009063%	657313	99.31%	4	0.84%
悌	3119		10	6	0.0009063%	657319	99.31%	4	0.84%
恿	3120		11	6	0.0009063%	657325	99.31%	4	0.84%
斧	3134		8	6	0.0009063%	657331	99.33%	4	0.84%
框	3141		10	6	0.0009063%	657337	99.33%	4	0.84%
棗	3144		12	6	0.0009063%	657343	99.34%	4	0.84%
汀	3148		5	6	0.0009063%	657349	99.34%	4	0.84%
淳	3152		11	6	0.0009063%	657355	99.34%	4	0.84%
淅	3155		11	6	0.0009063%	657361	99.35%	4	0.84%
漩	3157		14	6	0.0009063%	657367	99.35%	4	0.84%
甩	3172		5	6	0.0009063%	657373	99.36%	4	0.84%
瘓	3173		14	6	0.0009063%	657379	99.36%	4	0.84%
皓	3176		12	6	0.0009063%	657385	99.36%	4	0.84%
盅	3177		9	6	0.0009063%	657391	99.37%	4	0.84%
穗	3181		17	6	0.0009063%	657397	99.37%	4	0.84%
筐	3185		12	6	0.0009063%	657403	99.37%	4	0.84%
糢	3188		17	6	0.0009063%	657409	99.38%	4	0.84%
踽	3215		16	6	0.0009063%	657415	99.40%	4	0.84%
軋	3218		8	6	0.0009063%	657421	99.40%	4	0.84%
魅	3235		15	6	0.0009063%	657427	99.42%	4	0.84%
佣	3241		7	5	0.0007552%	657432	99.42%	4	0.84%
儕	3244		16	5	0.0007552%	657437	99.43%	4	0.84%
冕	3245		11	5	0.0007552%	657442	99.43%	4	0.84%
凳	3246		14	5	0.0007552%	657447	99.43%	4	0.84%
凶	3247		4	5	0.0007552%	657452	99.43%	4	0.84%
刨	3248		7	5	0.0007552%	657457	99.43%	4	0.84%
勳	3250		16	5	0.0007552%	657462	99.43%	4	0.84%
哄	3257		9	5	0.0007552%	657467	99.44%	4	0.84%
喟	3259		12	5	0.0007552%	657472	99.44%	4	0.84%
嘩	3261		15	5	0.0007552%	657477	99.44%	4	0.84%
坳	3266		8	5	0.0007552%	657482	99.44%	4	0.84%
婀	3272		11	5	0.0007552%	657487	99.45%	4	0.84%
嫻	3273		15	5	0.0007552%	657492	99.45%	4	0.84%
屎	3275		9	5	0.0007552%	657497	99.45%	4	0.84%
慟	3280		14	5	0.0007552%	657502	99.45%	4	0.84%
捏	3284		10	5	0.0007552%	657507	99.46%	4	0.84%
斛	3287		11	5	0.0007552%	657512	99.46%	4	0.84%
晌	3288		10	5	0.0007552%	657517	99.46%	4	0.84%
椏	3292		12	5	0.0007552%	657522	99.46%	4	0.84%
歛	3297		17	5	0.0007552%	657527	99.47%	4	0.84%
汁	3301		5	5	0.0007552%	657532	99.47%	4	0.84%
汶	3302		7	5	0.0007552%	657537	99.47%	4	0.84%
泠	3304		8	5	0.0007552%	657542	99.47%	4	0.84%
淖	3309		11	5	0.0007552%	657547	99.47%	4	0.84%
潘	3310		15	5	0.0007552%	657552	99.48%	4	0.84%
瀚	3311		19	5	0.0007552%	657557	99.48%	4	0.84%
痍	3321		11	5	0.0007552%	657562	99.48%	4	0.84%
瘟	3322		15	5	0.0007552%	657567	99.48%	4	0.84%
癒	3323		18	5	0.0007552%	657572	99.49%	4	0.84%
瞞	3328		16	5	0.0007552%	657577	99.49%	4	0.84%
瞳	3329		17	5	0.0007552%	657582	99.49%	4	0.84%
砵	3330		10	5	0.0007552%	657587	99.49%	4	0.84%
礁	3331		17	5	0.0007552%	657592	99.49%	4	0.84%
稜	3333		13	5	0.0007552%	657597	99.49%	4	0.84%
穢	3334		18	5	0.0007552%	657602	99.49%	4	0.84%
簍	3335		17	5	0.0007552%	657607	99.49%	4	0.84%
籮	3337		25	5	0.0007552%	657612	99.50%	4	0.84%
粟	3338		12	5	0.0007552%	657617	99.50%	4	0.84%
絢	3340		12	5	0.0007552%	657622	99.50%	4	0.84%
綻	3341		14	5	0.0007552%	657627	99.50%	4	0.84%
繹	3345		19	5	0.0007552%	657632	99.50%	4	0.84%
缽	3346		11	5	0.0007552%	657637	99.50%	4	0.84%
肴	3348		8	5	0.0007552%	657642	99.50%	4	0.84%
舐	3350		10	5	0.0007552%	657647	99.51%	4	0.84%
舵	3351		11	5	0.0007552%	657652	99.51%	4	0.84%
苛	3352		9	5	0.0007552%	657657	99.51%	4	0.84%
莽	3354		11	5	0.0007552%	657662	99.51%	4	0.84%
葫	3355		13	5	0.0007552%	657667	99.51%	4	0.84%
蔗	3356		15	5	0.0007552%	657672	99.51%	4	0.84%
蕃	3357		16	5	0.0007552%	657677	99.51%	4	0.84%
蛀	3359		11	5	0.0007552%	657682	99.51%	4	0.84%
襄	3365		17	5	0.0007552%	657687	99.52%	4	0.84%
謐	3370		17	5	0.0007552%	657692	99.52%	4	0.84%
踞	3372		15	5	0.0007552%	657697	99.52%	4	0.84%
躑	3373		22	5	0.0007552%	657702	99.52%	4	0.84%
軸	3375		12	5	0.0007552%	657707	99.52%	4	0.84%
逅	3377		9	5	0.0007552%	657712	99.53%	4	0.84%
邂	3378		16	5	0.0007552%	657717	99.53%	4	0.84%
鈞	3384		12	5	0.0007552%	657722	99.53%	4	0.84%
雌	3390		14	5	0.0007552%	657727	99.54%	4	0.84%
驊	3398		22	5	0.0007552%	657732	99.54%	4	0.84%
髣	3399		14	5	0.0007552%	657737	99.54%	4	0.84%
鹹	3402		20	5	0.0007552%	657742	99.54%	4	0.84%
丸	3407		3	4	0.0006042%	657746	99.55%	4	0.84%
乍	3408		5	4	0.0006042%	657750	99.55%	4	0.84%
亢	3409		4	4	0.0006042%	657754	99.55%	4	0.84%
伽	3410		7	4	0.0006042%	657758	99.55%	4	0.84%
倩	3411		10	4	0.0006042%	657762	99.55%	4	0.84%
冀	3413		16	4	0.0006042%	657766	99.55%	4	0.84%
凸	3415		5	4	0.0006042%	657770	99.55%	4	0.84%
剷	3416		13	4	0.0006042%	657774	99.55%	4	0.84%
匡	3418		6	4	0.0006042%	657778	99.56%	4	0.84%
卦	3419		8	4	0.0006042%	657782	99.56%	4	0.84%
厘	3420		9	4	0.0006042%	657786	99.56%	4	0.84%
叭	3421		5	4	0.0006042%	657790	99.56%	4	0.84%
吭	3422		7	4	0.0006042%	657794	99.56%	4	0.84%
啜	3428		11	4	0.0006042%	657798	99.56%	4	0.84%
喇	3429		12	4	0.0006042%	657802	99.56%	4	0.84%
嗓	3431		13	4	0.0006042%	657806	99.56%	4	0.84%
嘈	3433		14	4	0.0006042%	657810	99.56%	4	0.84%
嚙	3437		18	4	0.0006042%	657814	99.57%	4	0.84%
囚	3439		5	4	0.0006042%	657818	99.57%	4	0.84%
坤	3441		8	4	0.0006042%	657822	99.57%	4	0.84%
奚	3444		10	4	0.0006042%	657826	99.57%	4	0.84%
嫵	3447		15	4	0.0006042%	657830	99.57%	4	0.84%
屜	3451		11	4	0.0006042%	657834	99.57%	4	0.84%
岐	3452		7	4	0.0006042%	657838	99.58%	4	0.84%
帛	3454		8	4	0.0006042%	657842	99.58%	4	0.84%
帷	3455		11	4	0.0006042%	657846	99.58%	4	0.84%
彥	3459		9	4	0.0006042%	657850	99.58%	4	0.84%
徜	3460		11	4	0.0006042%	657854	99.58%	4	0.84%
忱	3461		7	4	0.0006042%	657858	99.58%	4	0.84%
忪	3462		7	4	0.0006042%	657862	99.58%	4	0.84%
惺	3464		12	4	0.0006042%	657866	99.58%	4	0.84%
懈	3466		16	4	0.0006042%	657870	99.58%	4	0.84%
懣	3467		18	4	0.0006042%	657874	99.58%	4	0.84%
拚	3472		8	4	0.0006042%	657878	99.59%	4	0.84%
攸	3476		7	4	0.0006042%	657882	99.59%	4	0.84%
斃	3478		17	4	0.0006042%	657886	99.59%	4	0.84%
朔	3481		10	4	0.0006042%	657890	99.59%	4	0.84%
梗	3484		11	4	0.0006042%	657894	99.59%	4	0.84%
楞	3485		13	4	0.0006042%	657898	99.60%	4	0.84%
欖	3486		25	4	0.0006042%	657902	99.60%	4	0.84%
毗	3488		9	4	0.0006042%	657906	99.60%	4	0.84%
氾	3490		5	4	0.0006042%	657910	99.60%	4	0.84%
沌	3492		7	4	0.0006042%	657914	99.60%	4	0.84%
沽	3494		8	4	0.0006042%	657918	99.60%	4	0.84%
澆	3499		15	4	0.0006042%	657922	99.60%	4	0.84%
澹	3500		16	4	0.0006042%	657926	99.60%	4	0.84%
炒	3502		8	4	0.0006042%	657930	99.61%	4	0.84%
烙	3503		10	4	0.0006042%	657934	99.61%	4	0.84%
煥	3504		13	4	0.0006042%	657938	99.61%	4	0.84%
燎	3506		16	4	0.0006042%	657942	99.61%	4	0.84%
牘	3507		19	4	0.0006042%	657946	99.61%	4	0.84%
猝	3512		11	4	0.0006042%	657950	99.61%	4	0.84%
璀	3515		15	4	0.0006042%	657954	99.61%	4	0.84%
癟	3518		19	4	0.0006042%	657958	99.62%	4	0.84%
睨	3520		13	4	0.0006042%	657962	99.62%	4	0.84%
矗	3523		24	4	0.0006042%	657966	99.62%	4	0.84%
竣	3528		12	4	0.0006042%	657970	99.62%	4	0.84%
笠	3530		11	4	0.0006042%	657974	99.62%	4	0.84%
箍	3532		14	4	0.0006042%	657978	99.62%	4	0.84%
紜	3534		10	4	0.0006042%	657982	99.63%	4	0.84%
絆	3535		11	4	0.0006042%	657986	99.63%	4	0.84%
綽	3536		14	4	0.0006042%	657990	99.63%	4	0.84%
繚	3539		18	4	0.0006042%	657994	99.63%	4	0.84%
纛	3541		25	4	0.0006042%	657998	99.63%	4	0.84%
羔	3542		10	4	0.0006042%	658002	99.63%	4	0.84%
翡	3544		14	4	0.0006042%	658006	99.63%	4	0.84%
翹	3545		18	4	0.0006042%	658010	99.63%	4	0.84%
耽	3548		10	4	0.0006042%	658014	99.63%	4	0.84%
胳	3549		10	4	0.0006042%	658018	99.63%	4	0.84%
膏	3550		14	4	0.0006042%	658022	99.63%	4	0.84%
芹	3552		8	4	0.0006042%	658026	99.64%	4	0.84%
范	3553		9	4	0.0006042%	658030	99.64%	4	0.84%
蓆	3558		14	4	0.0006042%	658034	99.64%	4	0.84%
蕾	3559		17	4	0.0006042%	658038	99.64%	4	0.84%
藹	3563		20	4	0.0006042%	658042	99.64%	4	0.84%
蜷	3571		14	4	0.0006042%	658046	99.65%	4	0.84%
螞	3573		16	4	0.0006042%	658050	99.65%	4	0.84%
裘	3579		13	4	0.0006042%	658054	99.65%	4	0.84%
褐	3580		14	4	0.0006042%	658058	99.65%	4	0.84%
詠	3582		12	4	0.0006042%	658062	99.65%	4	0.84%
詣	3583		13	4	0.0006042%	658066	99.65%	4	0.84%
謠	3586		17	4	0.0006042%	658070	99.66%	4	0.84%
貽	3588		12	4	0.0006042%	658074	99.66%	4	0.84%
賃	3589		13	4	0.0006042%	658078	99.66%	4	0.84%
輒	3591		14	4	0.0006042%	658082	99.66%	4	0.84%
輟	3592		15	4	0.0006042%	658086	99.66%	4	0.84%
轍	3593		18	4	0.0006042%	658090	99.66%	4	0.84%
遁	3595		12	4	0.0006042%	658094	99.66%	4	0.84%
邃	3596		17	4	0.0006042%	658098	99.66%	4	0.84%
邱	3597		7	4	0.0006042%	658102	99.66%	4	0.84%
郭	3598		10	4	0.0006042%	658106	99.66%	4	0.84%
醋	3600		15	4	0.0006042%	658110	99.66%	4	0.84%
釐	3601		18	4	0.0006042%	658114	99.67%	4	0.84%
鈣	3602		12	4	0.0006042%	658118	99.67%	4	0.84%
錘	3605		17	4	0.0006042%	658122	99.67%	4	0.84%
鑰	3607		25	4	0.0006042%	658126	99.67%	4	0.84%
閨	3608		14	4	0.0006042%	658130	99.67%	4	0.84%
阡	3610		5	4	0.0006042%	658134	99.67%	4	0.84%
雍	3614		13	4	0.0006042%	658138	99.67%	4	0.84%
霄	3615		15	4	0.0006042%	658142	99.67%	4	0.84%
靨	3617		23	4	0.0006042%	658146	99.68%	4	0.84%
鞍	3618		15	4	0.0006042%	658150	99.68%	4	0.84%
飪	3619		12	4	0.0006042%	658154	99.68%	4	0.84%
餞	3620		16	4	0.0006042%	658158	99.68%	4	0.84%
駝	3621		15	4	0.0006042%	658162	99.68%	4	0.84%
鬍	3623		19	4	0.0006042%	658166	99.68%	4	0.84%
鱗	3624		23	4	0.0006042%	658170	99.68%	4	0.84%
陀	1922		7	28	0.004229%	658198	96.73%	3	0.63%
杉	1939		7	27	0.004078%	658225	96.80%	3	0.63%
硫	2307		11	17	0.002568%	658242	98.00%	3	0.63%
迦	2430		8	15	0.002266%	658257	98.29%	3	0.63%
弘	2450		5	14	0.002115%	658271	98.33%	3	0.63%
櫚	2457		19	14	0.002115%	658285	98.35%	3	0.63%
秫	2472		10	14	0.002115%	658299	98.38%	3	0.63%
檀	2527		17	13	0.001964%	658312	98.49%	3	0.63%
釉	2558		13	13	0.001964%	658325	98.55%	3	0.63%
曇	2587		16	12	0.001813%	658337	98.61%	3	0.63%
臼	2684		6	11	0.001662%	658348	98.77%	3	0.63%
鈉	2695		12	11	0.001662%	658359	98.79%	3	0.63%
榆	2729		13	10	0.00151%	658369	98.85%	3	0.63%
璞	2739		16	10	0.00151%	658379	98.86%	3	0.63%
菩	2751		12	10	0.00151%	658389	98.88%	3	0.63%
蘋	2754		20	10	0.00151%	658399	98.88%	3	0.63%
餉	2768		14	10	0.00151%	658409	98.90%	3	0.63%
柿	2804		9	9	0.001359%	658418	98.95%	3	0.63%
聾	2833		22	9	0.001359%	658427	98.99%	3	0.63%
醬	2853		18	9	0.001359%	658436	99.02%	3	0.63%
兌	2867		7	8	0.001208%	658444	99.04%	3	0.63%
喔	2875		12	8	0.001208%	658452	99.05%	3	0.63%
扔	2894		5	8	0.001208%	658460	99.07%	3	0.63%
禹	2924		9	8	0.001208%	658468	99.11%	3	0.63%
嗟	2977		13	7	0.001057%	658475	99.17%	3	0.63%
嗡	2979		13	7	0.001057%	658482	99.17%	3	0.63%
懲	3005		19	7	0.001057%	658489	99.20%	3	0.63%
攣	3014		23	7	0.001057%	658496	99.21%	3	0.63%
氬	3022		12	7	0.001057%	658503	99.22%	3	0.63%
癢	3037		20	7	0.001057%	658510	99.23%	3	0.63%
艦	3050		20	7	0.001057%	658517	99.25%	3	0.63%
颱	3076		14	7	0.001057%	658524	99.27%	3	0.63%
僥	3085		14	6	0.0009063%	658530	99.28%	3	0.63%
兢	3086		14	6	0.0009063%	658536	99.28%	3	0.63%
喁	3095		12	6	0.0009063%	658542	99.29%	3	0.63%
娓	3103		10	6	0.0009063%	658548	99.30%	3	0.63%
悻	3122		11	6	0.0009063%	658554	99.32%	3	0.63%
杭	3140		8	6	0.0009063%	658560	99.33%	3	0.63%
梧	3142		11	6	0.0009063%	658566	99.33%	3	0.63%
洵	3150		9	6	0.0009063%	658572	99.34%	3	0.63%
犖	3169		14	6	0.0009063%	658578	99.36%	3	0.63%
窖	3183		12	6	0.0009063%	658584	99.37%	3	0.63%
紊	3189		10	6	0.0009063%	658590	99.38%	3	0.63%
賑	3211		14	6	0.0009063%	658596	99.40%	3	0.63%
踱	3214		16	6	0.0009063%	658602	99.40%	3	0.63%
輓	3219		14	6	0.0009063%	658608	99.40%	3	0.63%
鍍	3229		17	6	0.0009063%	658614	99.41%	3	0.63%
鵡	3236		19	6	0.0009063%	658620	99.42%	3	0.63%
鸚	3237		28	6	0.0009063%	658626	99.42%	3	0.63%
儈	3243		15	5	0.0007552%	658631	99.42%	3	0.63%
匾	3252		11	5	0.0007552%	658636	99.43%	3	0.63%
厄	3254		4	5	0.0007552%	658641	99.43%	3	0.63%
咕	3256		8	5	0.0007552%	658646	99.43%	3	0.63%
孺	3274		17	5	0.0007552%	658651	99.45%	3	0.63%
橘	3294		16	5	0.0007552%	658656	99.46%	3	0.63%
歹	3298		4	5	0.0007552%	658661	99.47%	3	0.63%
氟	3299		9	5	0.0007552%	658666	99.47%	3	0.63%
沓	3305		8	5	0.0007552%	658671	99.47%	3	0.63%
涓	3306		10	5	0.0007552%	658676	99.47%	3	0.63%
淤	3307		11	5	0.0007552%	658681	99.47%	3	0.63%
瀝	3312		19	5	0.0007552%	658686	99.48%	3	0.63%
狡	3314		9	5	0.0007552%	658691	99.48%	3	0.63%
瑚	3316		13	5	0.0007552%	658696	99.48%	3	0.63%
疤	3320		9	5	0.0007552%	658701	99.48%	3	0.63%
皚	3324		15	5	0.0007552%	658706	99.49%	3	0.63%
蚓	3358		10	5	0.0007552%	658711	99.51%	3	0.63%
蜀	3360		13	5	0.0007552%	658716	99.51%	3	0.63%
蟀	3361		17	5	0.0007552%	658721	99.51%	3	0.63%
衹	3363		9	5	0.0007552%	658726	99.52%	3	0.63%
詔	3366		12	5	0.0007552%	658731	99.52%	3	0.63%
諂	3368		15	5	0.0007552%	658736	99.52%	3	0.63%
鈷	3386		13	5	0.0007552%	658741	99.53%	3	0.63%
隼	3388		10	5	0.0007552%	658746	99.53%	3	0.63%
雁	3389		12	5	0.0007552%	658751	99.54%	3	0.63%
兔	3412		8	4	0.0006042%	658755	99.55%	3	0.63%
	3414		8	4	0.0006042%	658759	99.55%	3	0.63%
劈	3417		15	4	0.0006042%	658763	99.55%	3	0.63%
呂	3423		7	4	0.0006042%	658767	99.56%	3	0.63%
囊	3438		22	4	0.0006042%	658771	99.57%	3	0.63%
埸	3442		11	4	0.0006042%	658775	99.57%	3	0.63%
塢	3443		13	4	0.0006042%	658779	99.57%	3	0.63%
妮	3445		8	4	0.0006042%	658783	99.57%	3	0.63%
嬸	3448		18	4	0.0006042%	658787	99.57%	3	0.63%
宥	3450		9	4	0.0006042%	658791	99.57%	3	0.63%
崙	3453		11	4	0.0006042%	658795	99.58%	3	0.63%
廝	3456		15	4	0.0006042%	658799	99.58%	3	0.63%
	3457		5	4	0.0006042%	658803	99.58%	3	0.63%
弗	3458		5	4	0.0006042%	658807	99.58%	3	0.63%
慬	3465		14	4	0.0006042%	658811	99.58%	3	0.63%
戛	3469		11	4	0.0006042%	658815	99.59%	3	0.63%
扒	3470		5	4	0.0006042%	658819	99.59%	3	0.63%
抉	3471		7	4	0.0006042%	658823	99.59%	3	0.63%
搵	3473		13	4	0.0006042%	658827	99.59%	3	0.63%
摺	3474		14	4	0.0006042%	658831	99.59%	3	0.63%
斐	3479		12	4	0.0006042%	658835	99.59%	3	0.63%
柵	3483		9	4	0.0006042%	658839	99.59%	3	0.63%
	3491		7	4	0.0006042%	658843	99.60%	3	0.63%
湍	3498		12	4	0.0006042%	658847	99.60%	3	0.63%
熔	3505		14	4	0.0006042%	658851	99.61%	3	0.63%
犀	3508		12	4	0.0006042%	658855	99.61%	3	0.63%
狸	3510		10	4	0.0006042%	658859	99.61%	3	0.63%
琉	3513		10	4	0.0006042%	658863	99.61%	3	0.63%
璋	3514		15	4	0.0006042%	658867	99.61%	3	0.63%
盹	3519		9	4	0.0006042%	658871	99.62%	3	0.63%
瞇	3521		15	4	0.0006042%	658875	99.62%	3	0.63%
瞼	3522		18	4	0.0006042%	658879	99.62%	3	0.63%
祟	3526		10	4	0.0006042%	658883	99.62%	3	0.63%
筵	3531		14	4	0.0006042%	658887	99.62%	3	0.63%
籽	3533		9	4	0.0006042%	658891	99.62%	3	0.63%
緋	3538		14	4	0.0006042%	658895	99.63%	3	0.63%
羡	3543		12	4	0.0006042%	658899	99.63%	3	0.63%
耙	3547		10	4	0.0006042%	658903	99.63%	3	0.63%
萃	3555		12	4	0.0006042%	658907	99.64%	3	0.63%
蒿	3557		14	4	0.0006042%	658911	99.64%	3	0.63%
藐	3562		18	4	0.0006042%	658915	99.64%	3	0.63%
蘚	3564		21	4	0.0006042%	658919	99.64%	3	0.63%
蚯	3566		11	4	0.0006042%	658923	99.64%	3	0.63%
蜆	3568		13	4	0.0006042%	658927	99.65%	3	0.63%
蟋	3574		17	4	0.0006042%	658931	99.65%	3	0.63%
蠕	3575		20	4	0.0006042%	658935	99.65%	3	0.63%
袱	3578		11	4	0.0006042%	658939	99.65%	3	0.63%
襪	3581		20	4	0.0006042%	658943	99.65%	3	0.63%
譴	3587		21	4	0.0006042%	658947	99.66%	3	0.63%
踴	3590		16	4	0.0006042%	658951	99.66%	3	0.63%
轆	3594		18	4	0.0006042%	658955	99.66%	3	0.63%
酪	3599		13	4	0.0006042%	658959	99.66%	3	0.63%
鉀	3603		13	4	0.0006042%	658963	99.67%	3	0.63%
阮	3611		6	4	0.0006042%	658967	99.67%	3	0.63%
隋	3612		11	4	0.0006042%	658971	99.67%	3	0.63%
隘	3613		12	4	0.0006042%	658975	99.67%	3	0.63%
霹	3616		21	4	0.0006042%	658979	99.67%	3	0.63%
駒	3622		15	4	0.0006042%	658983	99.68%	3	0.63%
仕	3630		5	3	0.0004531%	658986	99.68%	3	0.63%
仵	3631		6	3	0.0004531%	658989	99.68%	3	0.63%
俏	3633		9	3	0.0004531%	658992	99.68%	3	0.63%
俸	3634		10	3	0.0004531%	658995	99.68%	3	0.63%
偌	3635		11	3	0.0004531%	658998	99.68%	3	0.63%
傖	3636		12	3	0.0004531%	659001	99.69%	3	0.63%
凜	3638		15	3	0.0004531%	659004	99.69%	3	0.63%
刁	3639		2	3	0.0004531%	659007	99.69%	3	0.63%
叱	3642		5	3	0.0004531%	659010	99.69%	3	0.63%
咎	3647		8	3	0.0004531%	659013	99.69%	3	0.63%
哎	3648		9	3	0.0004531%	659016	99.69%	3	0.63%
唷	3651		10	3	0.0004531%	659019	99.69%	3	0.63%
嚕	3653		18	3	0.0004531%	659022	99.69%	3	0.63%
囿	3654		9	3	0.0004531%	659025	99.69%	3	0.63%
塚	3655		13	3	0.0004531%	659028	99.69%	3	0.63%
塋	3656		13	3	0.0004531%	659031	99.69%	3	0.63%
	3658		7	3	0.0004531%	659034	99.70%	3	0.63%
奐	3661		9	3	0.0004531%	659037	99.70%	3	0.63%
姦	3662		9	3	0.0004531%	659040	99.70%	3	0.63%
娟	3663		10	3	0.0004531%	659043	99.70%	3	0.63%
娥	3664		10	3	0.0004531%	659046	99.70%	3	0.63%
婪	3665		11	3	0.0004531%	659049	99.70%	3	0.63%
娼	3666		11	3	0.0004531%	659052	99.70%	3	0.63%
嬴	3668		16	3	0.0004531%	659055	99.70%	3	0.63%
孚	3669		7	3	0.0004531%	659058	99.70%	3	0.63%
孿	3670		22	3	0.0004531%	659061	99.70%	3	0.63%
岔	3671		7	3	0.0004531%	659064	99.70%	3	0.63%
帑	3674		8	3	0.0004531%	659067	99.70%	3	0.63%
幄	3675		12	3	0.0004531%	659070	99.70%	3	0.63%
	3676		9	3	0.0004531%	659073	99.70%	3	0.63%
彝	3677		18	3	0.0004531%	659076	99.70%	3	0.63%
徉	3678		9	3	0.0004531%	659079	99.70%	3	0.63%
忿	3679		8	3	0.0004531%	659082	99.70%	3	0.63%
悼	3680		11	3	0.0004531%	659085	99.71%	3	0.63%
惰	3682		12	3	0.0004531%	659088	99.71%	3	0.63%
惻	3683		12	3	0.0004531%	659091	99.71%	3	0.63%
憨	3685		16	3	0.0004531%	659094	99.71%	3	0.63%
懺	3686		20	3	0.0004531%	659097	99.71%	3	0.63%
戊	3687		5	3	0.0004531%	659100	99.71%	3	0.63%
戢	3688		13	3	0.0004531%	659103	99.71%	3	0.63%
掏	3692		11	3	0.0004531%	659106	99.71%	3	0.63%
捻	3693		11	3	0.0004531%	659109	99.71%	3	0.63%
搔	3696		13	3	0.0004531%	659112	99.71%	3	0.63%
搐	3697		13	3	0.0004531%	659115	99.71%	3	0.63%
摹	3698		15	3	0.0004531%	659118	99.71%	3	0.63%
撩	3699		15	3	0.0004531%	659121	99.71%	3	0.63%
擅	3701		16	3	0.0004531%	659124	99.71%	3	0.63%
攪	3704		23	3	0.0004531%	659127	99.72%	3	0.63%
斟	3705		13	3	0.0004531%	659130	99.72%	3	0.63%
曦	3707		20	3	0.0004531%	659133	99.72%	3	0.63%
杵	3708		8	3	0.0004531%	659136	99.72%	3	0.63%
桓	3709		10	3	0.0004531%	659139	99.72%	3	0.63%
桎	3710		10	3	0.0004531%	659142	99.72%	3	0.63%
梏	3711		11	3	0.0004531%	659145	99.72%	3	0.63%
椿	3713		13	3	0.0004531%	659148	99.72%	3	0.63%
榕	3714		14	3	0.0004531%	659151	99.72%	3	0.63%
樊	3715		15	3	0.0004531%	659154	99.72%	3	0.63%
橄	3717		16	3	0.0004531%	659157	99.72%	3	0.63%
櫻	3720		21	3	0.0004531%	659160	99.72%	3	0.63%
殃	3723		9	3	0.0004531%	659163	99.72%	3	0.63%
沐	3726		7	3	0.0004531%	659166	99.73%	3	0.63%
沱	3727		8	3	0.0004531%	659169	99.73%	3	0.63%
沮	3728		8	3	0.0004531%	659172	99.73%	3	0.63%
涕	3730		10	3	0.0004531%	659175	99.73%	3	0.63%
浦	3731		10	3	0.0004531%	659178	99.73%	3	0.63%
渥	3732		12	3	0.0004531%	659181	99.73%	3	0.63%
湮	3733		12	3	0.0004531%	659184	99.73%	3	0.63%
渙	3734		12	3	0.0004531%	659187	99.73%	3	0.63%
滂	3735		13	3	0.0004531%	659190	99.73%	3	0.63%
濬	3737		17	3	0.0004531%	659193	99.73%	3	0.63%
煦	3739		13	3	0.0004531%	659196	99.73%	3	0.63%
燐	3740		16	3	0.0004531%	659199	99.73%	3	0.63%
燬	3741		17	3	0.0004531%	659202	99.73%	3	0.63%
猥	3744		12	3	0.0004531%	659205	99.73%	3	0.63%
獃	3746		14	3	0.0004531%	659208	99.73%	3	0.63%
獷	3748		18	3	0.0004531%	659211	99.74%	3	0.63%
珀	3749		9	3	0.0004531%	659214	99.74%	3	0.63%
琢	3750		12	3	0.0004531%	659217	99.74%	3	0.63%
琥	3751		12	3	0.0004531%	659220	99.74%	3	0.63%
瓢	3752		16	3	0.0004531%	659223	99.74%	3	0.63%
甦	3753		12	3	0.0004531%	659226	99.74%	3	0.63%
疋	3754		5	3	0.0004531%	659229	99.74%	3	0.63%
痰	3756		13	3	0.0004531%	659232	99.74%	3	0.63%
瘁	3757		13	3	0.0004531%	659235	99.74%	3	0.63%
皈	3759		9	3	0.0004531%	659238	99.74%	3	0.63%
	3761		11	3	0.0004531%	659241	99.74%	3	0.63%
瞎	3762		15	3	0.0004531%	659244	99.74%	3	0.63%
瞌	3763		15	3	0.0004531%	659247	99.74%	3	0.63%
磊	3768		15	3	0.0004531%	659250	99.74%	3	0.63%
禧	3770		16	3	0.0004531%	659253	99.75%	3	0.63%
穹	3771		8	3	0.0004531%	659256	99.75%	3	0.63%
簫	3773		18	3	0.0004531%	659259	99.75%	3	0.63%
紆	3775		9	3	0.0004531%	659262	99.75%	3	0.63%
綁	3776		13	3	0.0004531%	659265	99.75%	3	0.63%
綢	3777		14	3	0.0004531%	659268	99.75%	3	0.63%
縝	3779		16	3	0.0004531%	659271	99.75%	3	0.63%
罅	3782		17	3	0.0004531%	659274	99.75%	3	0.63%
翱	3784		16	3	0.0004531%	659277	99.75%	3	0.63%
耘	3785		10	3	0.0004531%	659280	99.75%	3	0.63%
	3786		10	3	0.0004531%	659283	99.75%	3	0.63%
肄	3787		13	3	0.0004531%	659286	99.75%	3	0.63%
肘	3789		7	3	0.0004531%	659289	99.75%	3	0.63%
臆	3792		17	3	0.0004531%	659292	99.76%	3	0.63%
臻	3793		16	3	0.0004531%	659295	99.76%	3	0.63%
荀	3795		10	3	0.0004531%	659298	99.76%	3	0.63%
蓓	3797		14	3	0.0004531%	659301	99.76%	3	0.63%
藪	3800		19	3	0.0004531%	659304	99.76%	3	0.63%
蘢	3801		20	3	0.0004531%	659307	99.76%	3	0.63%
蘸	3802		23	3	0.0004531%	659310	99.76%	3	0.63%
蘿	3803		23	3	0.0004531%	659313	99.76%	3	0.63%
蛛	3806		12	3	0.0004531%	659316	99.76%	3	0.63%
蜘	3809		14	3	0.0004531%	659319	99.76%	3	0.63%
蟒	3811		17	3	0.0004531%	659322	99.76%	3	0.63%
袂	3814		9	3	0.0004531%	659325	99.77%	3	0.63%
褂	3815		13	3	0.0004531%	659328	99.77%	3	0.63%
褒	3816		15	3	0.0004531%	659331	99.77%	3	0.63%
褸	3817		16	3	0.0004531%	659334	99.77%	3	0.63%
誡	3818		14	3	0.0004531%	659337	99.77%	3	0.63%
謔	3820		16	3	0.0004531%	659340	99.77%	3	0.63%
谿	3821		17	3	0.0004531%	659343	99.77%	3	0.63%
賠	3822		15	3	0.0004531%	659346	99.77%	3	0.63%
踩	3825		15	3	0.0004531%	659349	99.77%	3	0.63%
蹄	3826		16	3	0.0004531%	659352	99.77%	3	0.63%
躇	3828		19	3	0.0004531%	659355	99.77%	3	0.63%
躊	3829		21	3	0.0004531%	659358	99.77%	3	0.63%
釜	3834		10	3	0.0004531%	659361	99.77%	3	0.63%
	3836		15	3	0.0004531%	659364	99.78%	3	0.63%
鋸	3837		16	3	0.0004531%	659367	99.78%	3	0.63%
鑣	3839		23	3	0.0004531%	659370	99.78%	3	0.63%
阱	3841		6	3	0.0004531%	659373	99.78%	3	0.63%
隕	3842		12	3	0.0004531%	659376	99.78%	3	0.63%
雋	3844		13	3	0.0004531%	659379	99.78%	3	0.63%
霾	3845		22	3	0.0004531%	659382	99.78%	3	0.63%
靦	3846		16	3	0.0004531%	659385	99.78%	3	0.63%
鞠	3847		17	3	0.0004531%	659388	99.78%	3	0.63%
韁	3848		22	3	0.0004531%	659391	99.78%	3	0.63%
顱	3849		25	3	0.0004531%	659394	99.78%	3	0.63%
颺	3851		18	3	0.0004531%	659397	99.78%	3	0.63%
飆	3852		21	3	0.0004531%	659400	99.78%	3	0.63%
餒	3854		15	3	0.0004531%	659403	99.78%	3	0.63%
饞	3856		25	3	0.0004531%	659406	99.78%	3	0.63%
駱	3857		16	3	0.0004531%	659409	99.79%	3	0.63%
騁	3858		17	3	0.0004531%	659412	99.79%	3	0.63%
駿	3859		17	3	0.0004531%	659415	99.79%	3	0.63%
鵠	3861		18	3	0.0004531%	659418	99.79%	3	0.63%
鼎	3865		13	3	0.0004531%	659421	99.79%	3	0.63%
鼾	3866		17	3	0.0004531%	659424	99.79%	3	0.63%
曝	1938		19	27	0.004078%	659451	96.79%	2	0.42%
樽	2090		16	22	0.003323%	659473	97.36%	2	0.42%
姪	2394		9	15	0.002266%	659488	98.21%	2	0.42%
埧	2507		11	13	0.001964%	659501	98.45%	2	0.42%
砰	2536		10	13	0.001964%	659514	98.51%	2	0.42%
鞂	2627		14	12	0.001813%	659526	98.68%	2	0.42%
痺	2673		13	11	0.001662%	659537	98.76%	2	0.42%
閩	2696		14	11	0.001662%	659548	98.79%	2	0.42%
咱	2874		9	8	0.001208%	659556	99.05%	2	0.42%
棠	2900		12	8	0.001208%	659564	99.08%	2	0.42%
瘤	2918		15	8	0.001208%	659572	99.10%	2	0.42%
粱	2928		13	8	0.001208%	659580	99.11%	2	0.42%
釬	2951		11	8	0.001208%	659588	99.14%	2	0.42%
鱷	2959		27	8	0.001208%	659596	99.15%	2	0.42%
悖	3001		10	7	0.001057%	659603	99.19%	2	0.42%
琵	3033		12	7	0.001057%	659610	99.23%	2	0.42%
琶	3034		12	7	0.001057%	659617	99.23%	2	0.42%
芯	3053		8	7	0.001057%	659624	99.25%	2	0.42%
蛻	3057		13	7	0.001057%	659631	99.25%	2	0.42%
迺	3068		9	7	0.001057%	659638	99.27%	2	0.42%
咨	3091		9	6	0.0009063%	659644	99.29%	2	0.42%
喀	3094		12	6	0.0009063%	659650	99.29%	2	0.42%
	3098		7	6	0.0009063%	659656	99.29%	2	0.42%
孃	3105		20	6	0.0009063%	659662	99.30%	2	0.42%
杞	3139		7	6	0.0009063%	659668	99.33%	2	0.42%
棧	3145		12	6	0.0009063%	659674	99.34%	2	0.42%
灸	3162		7	6	0.0009063%	659680	99.35%	2	0.42%
炯	3164		9	6	0.0009063%	659686	99.35%	2	0.42%
緘	3191		15	6	0.0009063%	659692	99.38%	2	0.42%
芸	3197		8	6	0.0009063%	659698	99.38%	2	0.42%
迸	3222		9	6	0.0009063%	659704	99.41%	2	0.42%
錚	3228		16	6	0.0009063%	659710	99.41%	2	0.42%
阜	3231		8	6	0.0009063%	659716	99.41%	2	0.42%
匣	3251		7	5	0.0007552%	659721	99.43%	2	0.42%
嗥	3260		13	5	0.0007552%	659726	99.44%	2	0.42%
	3264		7	5	0.0007552%	659731	99.44%	2	0.42%
彫	3279		11	5	0.0007552%	659736	99.45%	2	0.42%
押	3283		8	5	0.0007552%	659741	99.46%	2	0.42%
氦	3300		10	5	0.0007552%	659746	99.47%	2	0.42%
沼	3303		8	5	0.0007552%	659751	99.47%	2	0.42%
琪	3315		12	5	0.0007552%	659756	99.48%	2	0.42%
蟑	3362		17	5	0.0007552%	659761	99.51%	2	0.42%
鄔	3380		12	5	0.0007552%	659766	99.53%	2	0.42%
鎦	3387		18	5	0.0007552%	659771	99.53%	2	0.42%
韌	3395		12	5	0.0007552%	659776	99.54%	2	0.42%
齦	3404		21	5	0.0007552%	659781	99.55%	2	0.42%
咄	3424		8	4	0.0006042%	659785	99.56%	2	0.42%
咐	3425		8	4	0.0006042%	659789	99.56%	2	0.42%
呱	3426		8	4	0.0006042%	659793	99.56%	2	0.42%
咯	3427		9	4	0.0006042%	659797	99.56%	2	0.42%
喳	3430		12	4	0.0006042%	659801	99.56%	2	0.42%
嘖	3432		14	4	0.0006042%	659805	99.56%	2	0.42%
嘮	3434		15	4	0.0006042%	659809	99.56%	2	0.42%
噹	3435		16	4	0.0006042%	659813	99.57%	2	0.42%
姥	3446		9	4	0.0006042%	659817	99.57%	2	0.42%
孜	3449		7	4	0.0006042%	659821	99.57%	2	0.42%
戕	3468		8	4	0.0006042%	659825	99.59%	2	0.42%
擰	3475		17	4	0.0006042%	659829	99.59%	2	0.42%
敖	3477		11	4	0.0006042%	659833	99.59%	2	0.42%
晏	3480		10	4	0.0006042%	659837	99.59%	2	0.42%
杳	3482		8	4	0.0006042%	659841	99.59%	2	0.42%
毆	3487		15	4	0.0006042%	659845	99.60%	2	0.42%
汨	3493		7	4	0.0006042%	659849	99.60%	2	0.42%
泵	3495		9	4	0.0006042%	659853	99.60%	2	0.42%
淙	3497		11	4	0.0006042%	659857	99.60%	2	0.42%
濡	3501		17	4	0.0006042%	659861	99.61%	2	0.42%
狩	3509		9	4	0.0006042%	659865	99.61%	2	0.42%
狺	3511		10	4	0.0006042%	659869	99.61%	2	0.42%
璣	3516		16	4	0.0006042%	659873	99.61%	2	0.42%
瘀	3517		13	4	0.0006042%	659877	99.61%	2	0.42%
硼	3524		13	4	0.0006042%	659881	99.62%	2	0.42%
磷	3525		17	4	0.0006042%	659885	99.62%	2	0.42%
稷	3527		15	4	0.0006042%	659889	99.62%	2	0.42%
笆	3529		10	4	0.0006042%	659893	99.62%	2	0.42%
繙	3540		18	4	0.0006042%	659897	99.63%	2	0.42%
耆	3546		10	4	0.0006042%	659901	99.63%	2	0.42%
芍	3551		7	4	0.0006042%	659905	99.64%	2	0.42%
薔	3560		17	4	0.0006042%	659909	99.64%	2	0.42%
薇	3561		17	4	0.0006042%	659913	99.64%	2	0.42%
蜇	3567		13	4	0.0006042%	659917	99.65%	2	0.42%
蜴	3570		14	4	0.0006042%	659921	99.65%	2	0.42%
螂	3572		15	4	0.0006042%	659925	99.65%	2	0.42%
袓	3577		10	4	0.0006042%	659929	99.65%	2	0.42%
諄	3584		15	4	0.0006042%	659933	99.66%	2	0.42%
鋅	3604		15	4	0.0006042%	659937	99.67%	2	0.42%
鐸	3606		21	4	0.0006042%	659941	99.67%	2	0.42%
閽	3609		16	4	0.0006042%	659945	99.67%	2	0.42%
鵬	3625		19	4	0.0006042%	659949	99.68%	2	0.42%
丫	3626		3	3	0.0004531%	659952	99.68%	2	0.42%
乒	3628		6	3	0.0004531%	659955	99.68%	2	0.42%
乓	3629		6	3	0.0004531%	659958	99.68%	2	0.42%
叻	3643		5	3	0.0004531%	659961	99.69%	2	0.42%
吩	3644		7	3	0.0004531%	659964	99.69%	2	0.42%
	3645		8	3	0.0004531%	659967	99.69%	2	0.42%
咋	3646		8	3	0.0004531%	659970	99.69%	2	0.42%
哇	3649		9	3	0.0004531%	659973	99.69%	2	0.42%
咧	3650		9	3	0.0004531%	659976	99.69%	2	0.42%
啣	3652		11	3	0.0004531%	659979	99.69%	2	0.42%
壅	3657		16	3	0.0004531%	659982	99.69%	2	0.42%
壹	3659		12	3	0.0004531%	659985	99.70%	2	0.42%
奕	3660		9	3	0.0004531%	659988	99.70%	2	0.42%
婢	3667		11	3	0.0004531%	659991	99.70%	2	0.42%
嶂	3672		14	3	0.0004531%	659994	99.70%	2	0.42%
帚	3673		8	3	0.0004531%	659997	99.70%	2	0.42%
愕	3681		12	3	0.0004531%	660000	99.71%	2	0.42%
愨	3684		14	3	0.0004531%	660003	99.71%	2	0.42%
扳	3689		7	3	0.0004531%	660006	99.71%	2	0.42%
捎	3690		10	3	0.0004531%	660009	99.71%	2	0.42%
捆	3691		10	3	0.0004531%	660012	99.71%	2	0.42%
据	3694		11	3	0.0004531%	660015	99.71%	2	0.42%
	3695		12	3	0.0004531%	660018	99.71%	2	0.42%
撬	3700		15	3	0.0004531%	660021	99.71%	2	0.42%
撿	3702		16	3	0.0004531%	660024	99.71%	2	0.42%
擸	3703		18	3	0.0004531%	660027	99.72%	2	0.42%
暸	3706		16	3	0.0004531%	660030	99.72%	2	0.42%
椒	3712		12	3	0.0004531%	660033	99.72%	2	0.42%
檐	3718		17	3	0.0004531%	660036	99.72%	2	0.42%
櫝	3719		19	3	0.0004531%	660039	99.72%	2	0.42%
櫺	3721		21	3	0.0004531%	660042	99.72%	2	0.42%
汎	3725		6	3	0.0004531%	660045	99.73%	2	0.42%
泯	3729		8	3	0.0004531%	660048	99.73%	2	0.42%
滬	3736		14	3	0.0004531%	660051	99.73%	2	0.42%
焊	3738		11	3	0.0004531%	660054	99.73%	2	0.42%
爹	3742		10	3	0.0004531%	660057	99.73%	2	0.42%
犁	3743		11	3	0.0004531%	660060	99.73%	2	0.42%
猿	3745		13	3	0.0004531%	660063	99.73%	2	0.42%
獰	3747		17	3	0.0004531%	660066	99.74%	2	0.42%
痊	3755		11	3	0.0004531%	660069	99.74%	2	0.42%
瘴	3758		16	3	0.0004531%	660072	99.74%	2	0.42%
盃	3760		9	3	0.0004531%	660075	99.74%	2	0.42%
瞿	3764		18	3	0.0004531%	660078	99.74%	2	0.42%
矽	3765		8	3	0.0004531%	660081	99.74%	2	0.42%
硃	3766		11	3	0.0004531%	660084	99.74%	2	0.42%
碘	3767		13	3	0.0004531%	660087	99.74%	2	0.42%
磐	3769		15	3	0.0004531%	660090	99.75%	2	0.42%
箴	3772		15	3	0.0004531%	660093	99.75%	2	0.42%
粧	3774		12	3	0.0004531%	660096	99.75%	2	0.42%
緞	3778		15	3	0.0004531%	660099	99.75%	2	0.42%
縐	3780		16	3	0.0004531%	660102	99.75%	2	0.42%
肋	3788		6	3	0.0004531%	660105	99.75%	2	0.42%
肪	3790		8	3	0.0004531%	660108	99.75%	2	0.42%
腎	3791		12	3	0.0004531%	660111	99.76%	2	0.42%
舅	3794		13	3	0.0004531%	660114	99.76%	2	0.42%
蒔	3798		14	3	0.0004531%	660117	99.76%	2	0.42%
薈	3799		17	3	0.0004531%	660120	99.76%	2	0.42%
衊	3812		21	3	0.0004531%	660123	99.76%	2	0.42%
衢	3813		24	3	0.0004531%	660126	99.77%	2	0.42%
諜	3819		16	3	0.0004531%	660129	99.77%	2	0.42%
跛	3823		12	3	0.0004531%	660132	99.77%	2	0.42%
踉	3824		14	3	0.0004531%	660135	99.77%	2	0.42%
蹌	3827		17	3	0.0004531%	660138	99.77%	2	0.42%
輋	3830		13	3	0.0004531%	660141	99.77%	2	0.42%
邵	3832		7	3	0.0004531%	660144	99.77%	2	0.42%
酗	3833		11	3	0.0004531%	660147	99.77%	2	0.42%
鉗	3835		13	3	0.0004531%	660150	99.78%	2	0.42%
錮	3838		16	3	0.0004531%	660153	99.78%	2	0.42%
閂	3840		9	3	0.0004531%	660156	99.78%	2	0.42%
雇	3843		12	3	0.0004531%	660159	99.78%	2	0.42%
颯	3850		14	3	0.0004531%	660162	99.78%	2	0.42%
鰥	3860		21	3	0.0004531%	660165	99.79%	2	0.42%
黍	3862		12	3	0.0004531%	660168	99.79%	2	0.42%
丑	3867		4	2	0.0003021%	660170	99.79%	2	0.42%
	3868		3	2	0.0003021%	660172	99.79%	2	0.42%
	3869		5	2	0.0003021%	660174	99.79%	2	0.42%
亍	3870		3	2	0.0003021%	660176	99.79%	2	0.42%
仆	3872		4	2	0.0003021%	660178	99.79%	2	0.42%
偕	3874		11	2	0.0003021%	660180	99.79%	2	0.42%
僭	3875		14	2	0.0003021%	660182	99.79%	2	0.42%
兀	3876		3	2	0.0003021%	660184	99.79%	2	0.42%
冽	3878		8	2	0.0003021%	660186	99.79%	2	0.42%
	3880		7	2	0.0003021%	660188	99.79%	2	0.42%
	3881		8	2	0.0003021%	660190	99.79%	2	0.42%
勘	3882		11	2	0.0003021%	660192	99.79%	2	0.42%
勦	3883		13	2	0.0003021%	660194	99.79%	2	0.42%
匙	3884		11	2	0.0003021%	660196	99.79%	2	0.42%
匱	3885		14	2	0.0003021%	660198	99.80%	2	0.42%
呸	3886		8	2	0.0003021%	660200	99.80%	2	0.42%
呷	3887		8	2	0.0003021%	660202	99.80%	2	0.42%
咫	3888		9	2	0.0003021%	660204	99.80%	2	0.42%
咿	3889		9	2	0.0003021%	660206	99.80%	2	0.42%
咭	3890		9	2	0.0003021%	660208	99.80%	2	0.42%
啃	3893		11	2	0.0003021%	660210	99.80%	2	0.42%
啕	3894		11	2	0.0003021%	660212	99.80%	2	0.42%
嗤	3896		13	2	0.0003021%	660214	99.80%	2	0.42%
嗯	3897		13	2	0.0003021%	660216	99.80%	2	0.42%
嗔	3899		13	2	0.0003021%	660218	99.80%	2	0.42%
嘍	3901		14	2	0.0003021%	660220	99.80%	2	0.42%
噎	3904		15	2	0.0003021%	660222	99.80%	2	0.42%
嘰	3905		15	2	0.0003021%	660224	99.80%	2	0.42%
噤	3906		16	2	0.0003021%	660226	99.80%	2	0.42%
垛	3911		9	2	0.0003021%	660228	99.80%	2	0.42%
夔	3912		21	2	0.0003021%	660230	99.80%	2	0.42%
奄	3913		8	2	0.0003021%	660232	99.80%	2	0.42%
奎	3914		9	2	0.0003021%	660234	99.80%	2	0.42%
妓	3915		7	2	0.0003021%	660236	99.80%	2	0.42%
姜	3916		9	2	0.0003021%	660238	99.80%	2	0.42%
婿	3917		12	2	0.0003021%	660240	99.80%	2	0.42%
孑	3919		3	2	0.0003021%	660242	99.81%	2	0.42%
孖	3920		6	2	0.0003021%	660244	99.81%	2	0.42%
孰	3922		11	2	0.0003021%	660246	99.81%	2	0.42%
尢	3923		3	2	0.0003021%	660248	99.81%	2	0.42%
尬	3924		7	2	0.0003021%	660250	99.81%	2	0.42%
尷	3925		17	2	0.0003021%	660252	99.81%	2	0.42%
尹	3926		4	2	0.0003021%	660254	99.81%	2	0.42%
崛	3927		11	2	0.0003021%	660256	99.81%	2	0.42%
嶽	3930		17	2	0.0003021%	660258	99.81%	2	0.42%
巉	3931		20	2	0.0003021%	660260	99.81%	2	0.42%
帖	3933		8	2	0.0003021%	660262	99.81%	2	0.42%
帥	3934		9	2	0.0003021%	660264	99.81%	2	0.42%
幀	3935		12	2	0.0003021%	660266	99.81%	2	0.42%
庵	3936		11	2	0.0003021%	660268	99.81%	2	0.42%
弛	3937		6	2	0.0003021%	660270	99.81%	2	0.42%
弧	3938		8	2	0.0003021%	660272	99.81%	2	0.42%
彬	3939		11	2	0.0003021%	660274	99.81%	2	0.42%
彪	3940		11	2	0.0003021%	660276	99.81%	2	0.42%
彳	3941		3	2	0.0003021%	660278	99.81%	2	0.42%
徽	3942		17	2	0.0003021%	660280	99.81%	2	0.42%
忤	3945		7	2	0.0003021%	660282	99.81%	2	0.42%
怵	3947		8	2	0.0003021%	660284	99.81%	2	0.42%
怦	3948		8	2	0.0003021%	660286	99.81%	2	0.42%
怠	3949		9	2	0.0003021%	660288	99.81%	2	0.42%
恃	3950		9	2	0.0003021%	660290	99.81%	2	0.42%
恣	3952		10	2	0.0003021%	660292	99.82%	2	0.42%
悚	3953		10	2	0.0003021%	660294	99.82%	2	0.42%
悍	3954		10	2	0.0003021%	660296	99.82%	2	0.42%
悒	3955		10	2	0.0003021%	660298	99.82%	2	0.42%
愷	3958		13	2	0.0003021%	660300	99.82%	2	0.42%
慵	3960		14	2	0.0003021%	660302	99.82%	2	0.42%
懟	3961		18	2	0.0003021%	660304	99.82%	2	0.42%
懿	3962		22	2	0.0003021%	660306	99.82%	2	0.42%
戳	3964		18	2	0.0003021%	660308	99.82%	2	0.42%
扑	3965		5	2	0.0003021%	660310	99.82%	2	0.42%
扛	3966		6	2	0.0003021%	660312	99.82%	2	0.42%
拷	3968		9	2	0.0003021%	660314	99.82%	2	0.42%
挈	3969		10	2	0.0003021%	660316	99.82%	2	0.42%
捍	3970		10	2	0.0003021%	660318	99.82%	2	0.42%
掖	3971		11	2	0.0003021%	660320	99.82%	2	0.42%
掬	3972		11	2	0.0003021%	660322	99.82%	2	0.42%
掇	3973		11	2	0.0003021%	660324	99.82%	2	0.42%
揩	3974		12	2	0.0003021%	660326	99.82%	2	0.42%
揣	3975		12	2	0.0003021%	660328	99.82%	2	0.42%
揖	3976		12	2	0.0003021%	660330	99.82%	2	0.42%
捶	3977		12	2	0.0003021%	660332	99.82%	2	0.42%
揪	3978		12	2	0.0003021%	660334	99.82%	2	0.42%
揄	3979		12	2	0.0003021%	660336	99.82%	2	0.42%
搪	3980		13	2	0.0003021%	660338	99.82%	2	0.42%
摶	3981		14	2	0.0003021%	660340	99.82%	2	0.42%
摰	3982		15	2	0.0003021%	660342	99.82%	2	0.42%
	3983		16	2	0.0003021%	660344	99.82%	2	0.42%
撾	3984		16	2	0.0003021%	660346	99.82%	2	0.42%
擻	3986		18	2	0.0003021%	660348	99.83%	2	0.42%
擷	3987		18	2	0.0003021%	660350	99.83%	2	0.42%
攫	3988		23	2	0.0003021%	660352	99.83%	2	0.42%
敝	3989		11	2	0.0003021%	660354	99.83%	2	0.42%
札	3990		5	2	0.0003021%	660356	99.83%	2	0.42%
枇	3991		8	2	0.0003021%	660358	99.83%	2	0.42%
柄	3992		9	2	0.0003021%	660360	99.83%	2	0.42%
柚	3993		9	2	0.0003021%	660362	99.83%	2	0.42%
枷	3994		9	2	0.0003021%	660364	99.83%	2	0.42%
梟	3996		11	2	0.0003021%	660366	99.83%	2	0.42%
楫	3998		13	2	0.0003021%	660368	99.83%	2	0.42%
榨	3999		14	2	0.0003021%	660370	99.83%	2	0.42%
槁	4000		14	2	0.0003021%	660372	99.83%	2	0.42%
榷	4001		14	2	0.0003021%	660374	99.83%	2	0.42%
槐	4002		14	2	0.0003021%	660376	99.83%	2	0.42%
榭	4003		14	2	0.0003021%	660378	99.83%	2	0.42%
榦	4004		14	2	0.0003021%	660380	99.83%	2	0.42%
榖	4005		14	2	0.0003021%	660382	99.83%	2	0.42%
槽	4007		15	2	0.0003021%	660384	99.83%	2	0.42%
櫛	4010		17	2	0.0003021%	660386	99.83%	2	0.42%
檣	4011		17	2	0.0003021%	660388	99.83%	2	0.42%
橾	4012		17	2	0.0003021%	660390	99.83%	2	0.42%
檬	4013		18	2	0.0003021%	660392	99.83%	2	0.42%
檸	4014		18	2	0.0003021%	660394	99.83%	2	0.42%
殆	4015		9	2	0.0003021%	660396	99.83%	2	0.42%
氈	4018		17	2	0.0003021%	660398	99.84%	2	0.42%
氓	4019		8	2	0.0003021%	660400	99.84%	2	0.42%
汐	4024		6	2	0.0003021%	660402	99.84%	2	0.42%
泗	4025		8	2	0.0003021%	660404	99.84%	2	0.42%
沬	4027		8	2	0.0003021%	660406	99.84%	2	0.42%
泫	4028		8	2	0.0003021%	660408	99.84%	2	0.42%
洌	4029		9	2	0.0003021%	660410	99.84%	2	0.42%
淇	4030		11	2	0.0003021%	660412	99.84%	2	0.42%
淮	4031		11	2	0.0003021%	660414	99.84%	2	0.42%
淼	4032		12	2	0.0003021%	660416	99.84%	2	0.42%
滓	4033		13	2	0.0003021%	660418	99.84%	2	0.42%
漿	4034		15	2	0.0003021%	660420	99.84%	2	0.42%
潦	4035		15	2	0.0003021%	660422	99.84%	2	0.42%
瀆	4036		18	2	0.0003021%	660424	99.84%	2	0.42%
瀛	4037		19	2	0.0003021%	660426	99.84%	2	0.42%
瀟	4038		19	2	0.0003021%	660428	99.84%	2	0.42%
炬	4039		9	2	0.0003021%	660430	99.84%	2	0.42%
焙	4040		12	2	0.0003021%	660432	99.84%	2	0.42%
熏	4041		14	2	0.0003021%	660434	99.84%	2	0.42%
熨	4042		15	2	0.0003021%	660436	99.84%	2	0.42%
熹	4043		16	2	0.0003021%	660438	99.84%	2	0.42%
燼	4044		18	2	0.0003021%	660440	99.84%	2	0.42%
瑙	4046		13	2	0.0003021%	660442	99.84%	2	0.42%
瑤	4047		14	2	0.0003021%	660444	99.84%	2	0.42%
瓊	4050		19	2	0.0003021%	660446	99.84%	2	0.42%
畦	4051		11	2	0.0003021%	660448	99.85%	2	0.42%
疙	4052		8	2	0.0003021%	660450	99.85%	2	0.42%
痼	4054		13	2	0.0003021%	660452	99.85%	2	0.42%
瘠	4055		15	2	0.0003021%	660454	99.85%	2	0.42%
瘩	4056		15	2	0.0003021%	660456	99.85%	2	0.42%
皂	4059		7	2	0.0003021%	660458	99.85%	2	0.42%
皋	4060		10	2	0.0003021%	660460	99.85%	2	0.42%
皿	4061		5	2	0.0003021%	660462	99.85%	2	0.42%
睏	4063		12	2	0.0003021%	660464	99.85%	2	0.42%
睞	4064		13	2	0.0003021%	660466	99.85%	2	0.42%
睬	4065		13	2	0.0003021%	660468	99.85%	2	0.42%
睥	4066		13	2	0.0003021%	660470	99.85%	2	0.42%
瞅	4067		14	2	0.0003021%	660472	99.85%	2	0.42%
瞟	4068		16	2	0.0003021%	660474	99.85%	2	0.42%
瞶	4069		17	2	0.0003021%	660476	99.85%	2	0.42%
矚	4071		26	2	0.0003021%	660478	99.85%	2	0.42%
硝	4075		12	2	0.0003021%	660480	99.85%	2	0.42%
碇	4076		13	2	0.0003021%	660482	99.85%	2	0.42%
磺	4077		17	2	0.0003021%	660484	99.85%	2	0.42%
祀	4078		7	2	0.0003021%	660486	99.85%	2	0.42%
祁	4079		7	2	0.0003021%	660488	99.85%	2	0.42%
稔	4083		13	2	0.0003021%	660490	99.85%	2	0.42%
窈	4085		10	2	0.0003021%	660492	99.86%	2	0.42%
窕	4086		11	2	0.0003021%	660494	99.86%	2	0.42%
窳	4087		15	2	0.0003021%	660496	99.86%	2	0.42%
	4089		10	2	0.0003021%	660498	99.86%	2	0.42%
筷	4090		13	2	0.0003021%	660500	99.86%	2	0.42%
箏	4091		14	2	0.0003021%	660502	99.86%	2	0.42%
箇	4092		14	2	0.0003021%	660504	99.86%	2	0.42%
劄	4093		14	2	0.0003021%	660506	99.86%	2	0.42%
篩	4094		16	2	0.0003021%	660508	99.86%	2	0.42%
篷	4095		17	2	0.0003021%	660510	99.86%	2	0.42%
粕	4096		11	2	0.0003021%	660512	99.86%	2	0.42%
綑	4099		13	2	0.0003021%	660514	99.86%	2	0.42%
綞	4100		15	2	0.0003021%	660516	99.86%	2	0.42%
緲	4101		15	2	0.0003021%	660518	99.86%	2	0.42%
繆	4102		17	2	0.0003021%	660520	99.86%	2	0.42%
繭	4104		19	2	0.0003021%	660522	99.86%	2	0.42%
罄	4105		17	2	0.0003021%	660524	99.86%	2	0.42%
罔	4107		8	2	0.0003021%	660526	99.86%	2	0.42%
脣	4110		11	2	0.0003021%	660528	99.86%	2	0.42%
脩	4111		11	2	0.0003021%	660530	99.86%	2	0.42%
腕	4112		12	2	0.0003021%	660532	99.86%	2	0.42%
腋	4113		12	2	0.0003021%	660534	99.86%	2	0.42%
腑	4114		12	2	0.0003021%	660536	99.86%	2	0.42%
腊	4115		12	2	0.0003021%	660538	99.86%	2	0.42%
舲	4119		11	2	0.0003021%	660540	99.87%	2	0.42%
芷	4121		8	2	0.0003021%	660542	99.87%	2	0.42%
芮	4122		8	2	0.0003021%	660544	99.87%	2	0.42%
苞	4123		9	2	0.0003021%	660546	99.87%	2	0.42%
荐	4124		10	2	0.0003021%	660548	99.87%	2	0.42%
茹	4125		10	2	0.0003021%	660550	99.87%	2	0.42%
莞	4126		11	2	0.0003021%	660552	99.87%	2	0.42%
莘	4127		11	2	0.0003021%	660554	99.87%	2	0.42%
莠	4128		11	2	0.0003021%	660556	99.87%	2	0.42%
菱	4129		12	2	0.0003021%	660558	99.87%	2	0.42%
蒲	4131		14	2	0.0003021%	660560	99.87%	2	0.42%
蓐	4133		14	2	0.0003021%	660562	99.87%	2	0.42%
蕊	4134		16	2	0.0003021%	660564	99.87%	2	0.42%
藻	4135		20	2	0.0003021%	660566	99.87%	2	0.42%
虜	4137		13	2	0.0003021%	660568	99.87%	2	0.42%
蛾	4138		13	2	0.0003021%	660570	99.87%	2	0.42%
蜡	4139		14	2	0.0003021%	660572	99.87%	2	0.42%
蠹	4142		24	2	0.0003021%	660574	99.87%	2	0.42%
衙	4143		13	2	0.0003021%	660576	99.87%	2	0.42%
衾	4144		10	2	0.0003021%	660578	99.87%	2	0.42%
袈	4145		11	2	0.0003021%	660580	99.87%	2	0.42%
袤	4146		11	2	0.0003021%	660582	99.87%	2	0.42%
裟	4147		13	2	0.0003021%	660584	99.87%	2	0.42%
裾	4149		13	2	0.0003021%	660586	99.87%	2	0.42%
褥	4150		15	2	0.0003021%	660588	99.88%	2	0.42%
襤	4151		19	2	0.0003021%	660590	99.88%	2	0.42%
覦	4152		16	2	0.0003021%	660592	99.88%	2	0.42%
覬	4153		17	2	0.0003021%	660594	99.88%	2	0.42%
觴	4154		18	2	0.0003021%	660596	99.88%	2	0.42%
訕	4155		10	2	0.0003021%	660598	99.88%	2	0.42%
訢	4157		11	2	0.0003021%	660600	99.88%	2	0.42%
諫	4158		16	2	0.0003021%	660602	99.88%	2	0.42%
謢	4160		17	2	0.0003021%	660604	99.88%	2	0.42%
謳	4161		18	2	0.0003021%	660606	99.88%	2	0.42%
譁	4162		19	2	0.0003021%	660608	99.88%	2	0.42%
豹	4163		10	2	0.0003021%	660610	99.88%	2	0.42%
貂	4164		12	2	0.0003021%	660612	99.88%	2	0.42%
贓	4167		21	2	0.0003021%	660614	99.88%	2	0.42%
贖	4168		22	2	0.0003021%	660616	99.88%	2	0.42%
贛	4169		24	2	0.0003021%	660618	99.88%	2	0.42%
趺	4171		11	2	0.0003021%	660620	99.88%	2	0.42%
跎	4172		12	2	0.0003021%	660622	99.88%	2	0.42%
跚	4173		12	2	0.0003021%	660624	99.88%	2	0.42%
蹉	4174		17	2	0.0003021%	660626	99.88%	2	0.42%
蹙	4175		18	2	0.0003021%	660628	99.88%	2	0.42%
蹣	4176		18	2	0.0003021%	660630	99.88%	2	0.42%
蹬	4177		19	2	0.0003021%	660632	99.88%	2	0.42%
蹺	4178		19	2	0.0003021%	660634	99.88%	2	0.42%
躡	4179		25	2	0.0003021%	660636	99.88%	2	0.42%
軔	4180		10	2	0.0003021%	660638	99.88%	2	0.42%
轤	4181		23	2	0.0003021%	660640	99.88%	2	0.42%
逞	4182		10	2	0.0003021%	660642	99.88%	2	0.42%
邸	4185		7	2	0.0003021%	660644	99.89%	2	0.42%
郤	4186		9	2	0.0003021%	660646	99.89%	2	0.42%
酉	4187		7	2	0.0003021%	660648	99.89%	2	0.42%
釆	4190		7	2	0.0003021%	660650	99.89%	2	0.42%
鈸	4191		13	2	0.0003021%	660652	99.89%	2	0.42%
鏈	4200		19	2	0.0003021%	660654	99.89%	2	0.42%
鐮	4201		21	2	0.0003021%	660656	99.89%	2	0.42%
鑊	4202		22	2	0.0003021%	660658	99.89%	2	0.42%
閎	4203		12	2	0.0003021%	660660	99.89%	2	0.42%
闃	4204		17	2	0.0003021%	660662	99.89%	2	0.42%
闕	4205		18	2	0.0003021%	660664	99.89%	2	0.42%
阪	4206		6	2	0.0003021%	660666	99.89%	2	0.42%
陝	4207		9	2	0.0003021%	660668	99.89%	2	0.42%
陲	4208		11	2	0.0003021%	660670	99.89%	2	0.42%
隴	4209		18	2	0.0003021%	660672	99.89%	2	0.42%
靂	4210		24	2	0.0003021%	660674	99.89%	2	0.42%
靄	4211		24	2	0.0003021%	660676	99.89%	2	0.42%
靚	4212		15	2	0.0003021%	660678	99.89%	2	0.42%
靴	4213		13	2	0.0003021%	660680	99.89%	2	0.42%
韶	4215		14	2	0.0003021%	660682	99.89%	2	0.42%
顎	4216		18	2	0.0003021%	660684	99.90%	2	0.42%
飭	4218		12	2	0.0003021%	660686	99.90%	2	0.42%
餚	4219		16	2	0.0003021%	660688	99.90%	2	0.42%
	4220		18	2	0.0003021%	660690	99.90%	2	0.42%
饌	4223		20	2	0.0003021%	660692	99.90%	2	0.42%
騮	4224		20	2	0.0003021%	660694	99.90%	2	0.42%
騾	4225		21	2	0.0003021%	660696	99.90%	2	0.42%
骸	4227		16	2	0.0003021%	660698	99.90%	2	0.42%
髻	4228		16	2	0.0003021%	660700	99.90%	2	0.42%
鳶	4229		14	2	0.0003021%	660702	99.90%	2	0.42%
鶩	4230		20	2	0.0003021%	660704	99.90%	2	0.42%
	1217		15	74	0.01118%	660778	91.85%	1	0.21%
砦	1840		11	31	0.004682%	660809	96.37%	1	0.21%
溴	1864		13	30	0.004531%	660839	96.48%	1	0.21%
磯	2036		17	24	0.003625%	660863	97.17%	1	0.21%
鏢	2432		19	15	0.002266%	660878	98.30%	1	0.21%
浬	2461		10	14	0.002115%	660892	98.36%	1	0.21%
銥	2495		14	14	0.002115%	660906	98.43%	1	0.21%
呃	2503		7	13	0.001964%	660919	98.45%	1	0.21%
埭	2720		11	10	0.00151%	660929	98.83%	1	0.21%
庠	2725		9	10	0.00151%	660939	98.84%	1	0.21%
鈾	2854		13	9	0.001359%	660948	99.02%	1	0.21%
齲	2861		24	9	0.001359%	660957	99.03%	1	0.21%
琺	2914		12	8	0.001208%	660965	99.10%	1	0.21%
磬	2923		16	8	0.001208%	660973	99.11%	1	0.21%
鐳	2952		21	8	0.001208%	660981	99.14%	1	0.21%
甥	3035		12	7	0.001057%	660988	99.23%	1	0.21%
竇	3043		20	7	0.001057%	660995	99.24%	1	0.21%
鯨	3078		19	7	0.001057%	661002	99.28%	1	0.21%
娩	3104		10	6	0.0009063%	661008	99.30%	1	0.21%
彤	3115		7	6	0.0009063%	661014	99.31%	1	0.21%
暹	3138		16	6	0.0009063%	661020	99.33%	1	0.21%
灕	3161		22	6	0.0009063%	661026	99.35%	1	0.21%
菁	3199		12	6	0.0009063%	661032	99.39%	1	0.21%
虢	3204		15	6	0.0009063%	661038	99.39%	1	0.21%
鈽	3225		13	6	0.0009063%	661044	99.41%	1	0.21%
撳	3286		15	5	0.0007552%	661049	99.46%	1	0.21%
渚	3308		11	5	0.0007552%	661054	99.47%	1	0.21%
舂	3349		11	5	0.0007552%	661059	99.50%	1	0.21%
鄺	3381		17	5	0.0007552%	661064	99.53%	1	0.21%
鹵	3401		11	5	0.0007552%	661069	99.54%	1	0.21%
黿	3403		17	5	0.0007552%	661074	99.55%	1	0.21%
丐	3406		4	4	0.0006042%	661078	99.55%	1	0.21%
噶	3436		16	4	0.0006042%	661082	99.57%	1	0.21%
圭	3440		6	4	0.0006042%	661086	99.57%	1	0.21%
	3463		9	4	0.0006042%	661090	99.58%	1	0.21%
氘	3489		6	4	0.0006042%	661094	99.60%	1	0.21%
涅	3496		10	4	0.0006042%	661098	99.60%	1	0.21%
綬	3537		14	4	0.0006042%	661102	99.63%	1	0.21%
茱	3554		10	4	0.0006042%	661106	99.64%	1	0.21%
萸	3556		12	4	0.0006042%	661110	99.64%	1	0.21%
蚋	3565		10	4	0.0006042%	661114	99.64%	1	0.21%
蜢	3569		14	4	0.0006042%	661118	99.65%	1	0.21%
袁	3576		10	4	0.0006042%	661122	99.65%	1	0.21%
諍	3585		15	4	0.0006042%	661126	99.66%	1	0.21%
丰	3627		4	3	0.0004531%	661129	99.68%	1	0.21%
佚	3632		7	3	0.0004531%	661132	99.68%	1	0.21%
	3637		11	3	0.0004531%	661135	99.69%	1	0.21%
卹	3640		8	3	0.0004531%	661138	99.69%	1	0.21%
叡	3641		16	3	0.0004531%	661141	99.69%	1	0.21%
槿	3716		15	3	0.0004531%	661144	99.72%	1	0.21%
欉	3722		22	3	0.0004531%	661147	99.72%	1	0.21%
氮	3724		12	3	0.0004531%	661150	99.72%	1	0.21%
纘	3781		25	3	0.0004531%	661153	99.75%	1	0.21%
羚	3783		11	3	0.0004531%	661156	99.75%	1	0.21%
葺	3796		13	3	0.0004531%	661159	99.76%	1	0.21%
虱	3804		8	3	0.0004531%	661162	99.76%	1	0.21%
蚣	3805		10	3	0.0004531%	661165	99.76%	1	0.21%
蜈	3807		13	3	0.0004531%	661168	99.76%	1	0.21%
蜉	3808		13	3	0.0004531%	661171	99.76%	1	0.21%
蝣	3810		15	3	0.0004531%	661174	99.76%	1	0.21%
轔	3831		19	3	0.0004531%	661177	99.77%	1	0.21%
飩	3853		12	3	0.0004531%	661180	99.78%	1	0.21%
餛	3855		16	3	0.0004531%	661183	99.78%	1	0.21%
黔	3863		16	3	0.0004531%	661186	99.79%	1	0.21%
黠	3864		18	3	0.0004531%	661189	99.79%	1	0.21%
亳	3871		10	2	0.0003021%	661191	99.79%	1	0.21%
佰	3873		8	2	0.0003021%	661193	99.79%	1	0.21%
冉	3877		5	2	0.0003021%	661195	99.79%	1	0.21%
冼	3879		8	2	0.0003021%	661197	99.79%	1	0.21%
唅	3891		10	2	0.0003021%	661199	99.80%	1	0.21%
啪	3892		11	2	0.0003021%	661201	99.80%	1	0.21%
唬	3895		11	2	0.0003021%	661203	99.80%	1	0.21%
嘟	3898		13	2	0.0003021%	661205	99.80%	1	0.21%
	3900		14	2	0.0003021%	661207	99.80%	1	0.21%
嗷	3902		14	2	0.0003021%	661209	99.80%	1	0.21%
嘿	3903		15	2	0.0003021%	661211	99.80%	1	0.21%
噥	3907		16	2	0.0003021%	661213	99.80%	1	0.21%
嚶	3908		20	2	0.0003021%	661215	99.80%	1	0.21%
囡	3909		6	2	0.0003021%	661217	99.80%	1	0.21%
囤	3910		7	2	0.0003021%	661219	99.80%	1	0.21%
嬗	3918		16	2	0.0003021%	661221	99.80%	1	0.21%
孢	3921		8	2	0.0003021%	661223	99.81%	1	0.21%
崤	3928		11	2	0.0003021%	661225	99.81%	1	0.21%
嵯	3929		13	2	0.0003021%	661227	99.81%	1	0.21%
巫	3932		7	2	0.0003021%	661229	99.81%	1	0.21%
忒	3943		7	2	0.0003021%	661231	99.81%	1	0.21%
忡	3944		7	2	0.0003021%	661233	99.81%	1	0.21%
怏	3946		8	2	0.0003021%	661235	99.81%	1	0.21%
恪	3951		9	2	0.0003021%	661237	99.81%	1	0.21%
惴	3956		12	2	0.0003021%	661239	99.82%	1	0.21%
惸	3957		12	2	0.0003021%	661241	99.82%	1	0.21%
愿	3959		14	2	0.0003021%	661243	99.82%	1	0.21%
戔	3963		8	2	0.0003021%	661245	99.82%	1	0.21%
拊	3967		8	2	0.0003021%	661247	99.82%	1	0.21%
攆	3985		18	2	0.0003021%	661249	99.83%	1	0.21%
栩	3995		10	2	0.0003021%	661251	99.83%	1	0.21%
棱	3997		12	2	0.0003021%	661253	99.83%	1	0.21%
樟	4006		15	2	0.0003021%	661255	99.83%	1	0.21%
槤	4008		15	2	0.0003021%	661257	99.83%	1	0.21%
檜	4009		17	2	0.0003021%	661259	99.83%	1	0.21%
	4016		9	2	0.0003021%	661261	99.83%	1	0.21%
毯	4017		12	2	0.0003021%	661263	99.83%	1	0.21%
氚	4020		7	2	0.0003021%	661265	99.84%	1	0.21%
氪	4021		11	2	0.0003021%	661267	99.84%	1	0.21%
氯	4022		12	2	0.0003021%	661269	99.84%	1	0.21%
汙	4023		6	2	0.0003021%	661271	99.84%	1	0.21%
泱	4026		8	2	0.0003021%	661273	99.84%	1	0.21%
猺	4045		13	2	0.0003021%	661275	99.84%	1	0.21%
璜	4048		16	2	0.0003021%	661277	99.84%	1	0.21%
璠	4049		16	2	0.0003021%	661279	99.84%	1	0.21%
痣	4053		12	2	0.0003021%	661281	99.85%	1	0.21%
癃	4057		17	2	0.0003021%	661283	99.85%	1	0.21%
癲	4058		24	2	0.0003021%	661285	99.85%	1	0.21%
盥	4062		16	2	0.0003021%	661287	99.85%	1	0.21%
瞽	4070		18	2	0.0003021%	661289	99.85%	1	0.21%
矻	4072		8	2	0.0003021%	661291	99.85%	1	0.21%
砉	4073		9	2	0.0003021%	661293	99.85%	1	0.21%
砝	4074		10	2	0.0003021%	661295	99.85%	1	0.21%
祂	4080		7	2	0.0003021%	661297	99.85%	1	0.21%
	4081		9	2	0.0003021%	661299	99.85%	1	0.21%
祐	4082		9	2	0.0003021%	661301	99.85%	1	0.21%
穰	4084		22	2	0.0003021%	661303	99.86%	1	0.21%
窿	4088		17	2	0.0003021%	661305	99.86%	1	0.21%
粼	4097		14	2	0.0003021%	661307	99.86%	1	0.21%
紏	4098		10	2	0.0003021%	661309	99.86%	1	0.21%
縵	4103		17	2	0.0003021%	661311	99.86%	1	0.21%
罌	4106		20	2	0.0003021%	661313	99.86%	1	0.21%
羲	4108		16	2	0.0003021%	661315	99.86%	1	0.21%
羹	4109		19	2	0.0003021%	661317	99.86%	1	0.21%
臀	4116		17	2	0.0003021%	661319	99.86%	1	0.21%
舢	4117		9	2	0.0003021%	661321	99.87%	1	0.21%
舨	4118		10	2	0.0003021%	661323	99.87%	1	0.21%
艸	4120		6	2	0.0003021%	661325	99.87%	1	0.21%
菇	4130		12	2	0.0003021%	661327	99.87%	1	0.21%
蒜	4132		14	2	0.0003021%	661329	99.87%	1	0.21%
蘑	4136		20	2	0.0003021%	661331	99.87%	1	0.21%
蝎	4140		15	2	0.0003021%	661333	99.87%	1	0.21%
蟆	4141		17	2	0.0003021%	661335	99.87%	1	0.21%
裴	4148		13	2	0.0003021%	661337	99.87%	1	0.21%
訛	4156		11	2	0.0003021%	661339	99.88%	1	0.21%
謅	4159		17	2	0.0003021%	661341	99.88%	1	0.21%
賒	4165		14	2	0.0003021%	661343	99.88%	1	0.21%
賙	4166		15	2	0.0003021%	661345	99.88%	1	0.21%
赳	4170		9	2	0.0003021%	661347	99.88%	1	0.21%
逮	4183		11	2	0.0003021%	661349	99.89%	1	0.21%
遯	4184		14	2	0.0003021%	661351	99.89%	1	0.21%
醪	4188		18	2	0.0003021%	661353	99.89%	1	0.21%
醺	4189		21	2	0.0003021%	661355	99.89%	1	0.21%
鈹	4192		13	2	0.0003021%	661357	99.89%	1	0.21%
鉆	4193		13	2	0.0003021%	661359	99.89%	1	0.21%
鉻	4194		14	2	0.0003021%	661361	99.89%	1	0.21%
鋇	4195		15	2	0.0003021%	661363	99.89%	1	0.21%
鋰	4196		15	2	0.0003021%	661365	99.89%	1	0.21%
鋂	4197		15	2	0.0003021%	661367	99.89%	1	0.21%
鋦	4198		15	2	0.0003021%	661369	99.89%	1	0.21%
鎘	4199		18	2	0.0003021%	661371	99.89%	1	0.21%
韜	4214		19	2	0.0003021%	661373	99.89%	1	0.21%
颼	4217		18	2	0.0003021%	661375	99.90%	1	0.21%
餽	4221		18	2	0.0003021%	661377	99.90%	1	0.21%
饉	4222		19	2	0.0003021%	661379	99.90%	1	0.21%
驛	4226		23	2	0.0003021%	661381	99.90%	1	0.21%
鸛	4231		29	2	0.0003021%	661383	99.90%	1	0.21%
	4232		6	1	0.000151%	661384	99.90%	1	0.21%
仟	4233		5	1	0.000151%	661385	99.90%	1	0.21%
伎	4234		6	1	0.000151%	661386	99.90%	1	0.21%
佃	4235		7	1	0.000151%	661387	99.90%	1	0.21%
佘	4236		7	1	0.000151%	661388	99.90%	1	0.21%
佯	4237		8	1	0.000151%	661389	99.90%	1	0.21%
佻	4238		8	1	0.000151%	661390	99.90%	1	0.21%
侄	4239		8	1	0.000151%	661391	99.90%	1	0.21%
佫	4240		8	1	0.000151%	661392	99.90%	1	0.21%
俘	4241		9	1	0.000151%	661393	99.90%	1	0.21%
俚	4242		9	1	0.000151%	661394	99.90%	1	0.21%
俎	4243		9	1	0.000151%	661395	99.90%	1	0.21%
俛	4244		9	1	0.000151%	661396	99.90%	1	0.21%
俬	4245		9	1	0.000151%	661397	99.90%	1	0.21%
倌	4246		10	1	0.000151%	661398	99.90%	1	0.21%
俺	4247		10	1	0.000151%	661399	99.90%	1	0.21%
偃	4248		11	1	0.000151%	661400	99.90%	1	0.21%
倏	4249		11	1	0.000151%	661401	99.90%	1	0.21%
偪	4250		11	1	0.000151%	661402	99.90%	1	0.21%
傚	4251		12	1	0.000151%	661403	99.90%	1	0.21%
僉	4252		13	1	0.000151%	661404	99.90%	1	0.21%
僮	4253		14	1	0.000151%	661405	99.90%	1	0.21%
僨	4254		14	1	0.000151%	661406	99.90%	1	0.21%
儔	4255		16	1	0.000151%	661407	99.90%	1	0.21%
儷	4256		21	1	0.000151%	661408	99.90%	1	0.21%
冇	4257		4	1	0.000151%	661409	99.90%	1	0.21%
冑	4258		9	1	0.000151%	661410	99.90%	1	0.21%
几	4259		2	1	0.000151%	661411	99.90%	1	0.21%
刱	4260		8	1	0.000151%	661412	99.90%	1	0.21%
剃	4261		9	1	0.000151%	661413	99.90%	1	0.21%
剋	4262		9	1	0.000151%	661414	99.90%	1	0.21%
	4263		15	1	0.000151%	661415	99.90%	1	0.21%
劊	4264		15	1	0.000151%	661416	99.90%	1	0.21%
劬	4265		7	1	0.000151%	661417	99.90%	1	0.21%
勛	4266		12	1	0.000151%	661418	99.90%	1	0.21%
勰	4267		15	1	0.000151%	661419	99.90%	1	0.21%
勷	4268		19	1	0.000151%	661420	99.91%	1	0.21%
勺	4269		3	1	0.000151%	661421	99.91%	1	0.21%
匍	4270		9	1	0.000151%	661422	99.91%	1	0.21%
匐	4271		11	1	0.000151%	661423	99.91%	1	0.21%
卯	4272		5	1	0.000151%	661424	99.91%	1	0.21%
厝	4273		10	1	0.000151%	661425	99.91%	1	0.21%
叉	4274		3	1	0.000151%	661426	99.91%	1	0.21%
叟	4275		9	1	0.000151%	661427	99.91%	1	0.21%
	4276		6	1	0.000151%	661428	99.91%	1	0.21%
吒	4277		6	1	0.000151%	661429	99.91%	1	0.21%
吮	4278		7	1	0.000151%	661430	99.91%	1	0.21%
吥	4279		7	1	0.000151%	661431	99.91%	1	0.21%
咚	4280		8	1	0.000151%	661432	99.91%	1	0.21%
呤	4281		8	1	0.000151%	661433	99.91%	1	0.21%
	4282		9	1	0.000151%	661434	99.91%	1	0.21%
	4283		9	1	0.000151%	661435	99.91%	1	0.21%
咦	4284		9	1	0.000151%	661436	99.91%	1	0.21%
唁	4285		10	1	0.000151%	661437	99.91%	1	0.21%
唆	4286		10	1	0.000151%	661438	99.91%	1	0.21%
哽	4287		10	1	0.000151%	661439	99.91%	1	0.21%
唏	4288		10	1	0.000151%	661440	99.91%	1	0.21%
啖	4289		11	1	0.000151%	661441	99.91%	1	0.21%
啁	4290		11	1	0.000151%	661442	99.91%	1	0.21%
	4291		12	1	0.000151%	661443	99.91%	1	0.21%
喑	4292		12	1	0.000151%	661444	99.91%	1	0.21%
嗦	4293		13	1	0.000151%	661445	99.91%	1	0.21%
嗒	4294		13	1	0.000151%	661446	99.91%	1	0.21%
	4295		14	1	0.000151%	661447	99.91%	1	0.21%
嘀	4296		14	1	0.000151%	661448	99.91%	1	0.21%
嘹	4297		15	1	0.000151%	661449	99.91%	1	0.21%
噙	4298		16	1	0.000151%	661450	99.91%	1	0.21%
噫	4299		16	1	0.000151%	661451	99.91%	1	0.21%
噱	4300		16	1	0.000151%	661452	99.91%	1	0.21%
嚎	4301		17	1	0.000151%	661453	99.91%	1	0.21%
嚀	4302		17	1	0.000151%	661454	99.91%	1	0.21%
嚨	4303		20	1	0.000151%	661455	99.91%	1	0.21%
囈	4304		22	1	0.000151%	661456	99.91%	1	0.21%
囫	4305		7	1	0.000151%	661457	99.91%	1	0.21%
圇	4306		11	1	0.000151%	661458	99.91%	1	0.21%
坍	4307		7	1	0.000151%	661459	99.91%	1	0.21%
坯	4308		8	1	0.000151%	661460	99.91%	1	0.21%
坵	4309		8	1	0.000151%	661461	99.91%	1	0.21%
垣	4310		9	1	0.000151%	661462	99.91%	1	0.21%
堊	4311		11	1	0.000151%	661463	99.91%	1	0.21%
堰	4312		12	1	0.000151%	661464	99.91%	1	0.21%
塱	4313		13	1	0.000151%	661465	99.91%	1	0.21%
墩	4314		15	1	0.000151%	661466	99.91%	1	0.21%
壬	4315		4	1	0.000151%	661467	99.91%	1	0.21%
夙	4316		6	1	0.000151%	661468	99.91%	1	0.21%
妝	4317		7	1	0.000151%	661469	99.91%	1	0.21%
妞	4318		7	1	0.000151%	661470	99.91%	1	0.21%
妾	4319		8	1	0.000151%	661471	99.91%	1	0.21%
姨	4320		9	1	0.000151%	661472	99.91%	1	0.21%
姚	4321		9	1	0.000151%	661473	99.91%	1	0.21%
姝	4322		9	1	0.000151%	661474	99.91%	1	0.21%
婁	4323		11	1	0.000151%	661475	99.91%	1	0.21%
媧	4324		12	1	0.000151%	661476	99.91%	1	0.21%
媮	4325		12	1	0.000151%	661477	99.91%	1	0.21%
嫡	4326		14	1	0.000151%	661478	99.91%	1	0.21%
嫦	4327		14	1	0.000151%	661479	99.91%	1	0.21%
嬋	4328		15	1	0.000151%	661480	99.91%	1	0.21%
嬈	4329		15	1	0.000151%	661481	99.91%	1	0.21%
嬪	4330		17	1	0.000151%	661482	99.91%	1	0.21%
孀	4331		20	1	0.000151%	661483	99.91%	1	0.21%
孱	4332		12	1	0.000151%	661484	99.91%	1	0.21%
孵	4333		14	1	0.000151%	661485	99.91%	1	0.21%
宕	4334		8	1	0.000151%	661486	99.92%	1	0.21%
宦	4335		9	1	0.000151%	661487	99.92%	1	0.21%
宸	4336		10	1	0.000151%	661488	99.92%	1	0.21%
寢	4337		14	1	0.000151%	661489	99.92%	1	0.21%
尸	4338		3	1	0.000151%	661490	99.92%	1	0.21%
屺	4339		6	1	0.000151%	661491	99.92%	1	0.21%
岷	4340		8	1	0.000151%	661492	99.92%	1	0.21%
岬	4341		8	1	0.000151%	661493	99.92%	1	0.21%
峋	4342		9	1	0.000151%	661494	99.92%	1	0.21%
峪	4343		10	1	0.000151%	661495	99.92%	1	0.21%
崢	4344		11	1	0.000151%	661496	99.92%	1	0.21%
崑	4345		11	1	0.000151%	661497	99.92%	1	0.21%
嵌	4346		12	1	0.000151%	661498	99.92%	1	0.21%
嵐	4347		12	1	0.000151%	661499	99.92%	1	0.21%
嶙	4348		15	1	0.000151%	661500	99.92%	1	0.21%
嶸	4349		17	1	0.000151%	661501	99.92%	1	0.21%
巽	4350		12	1	0.000151%	661502	99.92%	1	0.21%
帘	4351		8	1	0.000151%	661503	99.92%	1	0.21%
幃	4352		12	1	0.000151%	661504	99.92%	1	0.21%
幗	4353		14	1	0.000151%	661505	99.92%	1	0.21%
幔	4354		14	1	0.000151%	661506	99.92%	1	0.21%
幘	4355		14	1	0.000151%	661507	99.92%	1	0.21%
幡	4356		15	1	0.000151%	661508	99.92%	1	0.21%
庚	4357		8	1	0.000151%	661509	99.92%	1	0.21%
庥	4358		9	1	0.000151%	661510	99.92%	1	0.21%
	4359		14	1	0.000151%	661511	99.92%	1	0.21%
廡	4360		15	1	0.000151%	661512	99.92%	1	0.21%
廩	4361		16	1	0.000151%	661513	99.92%	1	0.21%
廾	4362		3	1	0.000151%	661514	99.92%	1	0.21%
弁	4363		5	1	0.000151%	661515	99.92%	1	0.21%
弩	4364		8	1	0.000151%	661516	99.92%	1	0.21%
弼	4365		12	1	0.000151%	661517	99.92%	1	0.21%
徇	4366		9	1	0.000151%	661518	99.92%	1	0.21%
徠	4367		11	1	0.000151%	661519	99.92%	1	0.21%
忖	4368		6	1	0.000151%	661520	99.92%	1	0.21%
忻	4369		7	1	0.000151%	661521	99.92%	1	0.21%
忝	4370		8	1	0.000151%	661522	99.92%	1	0.21%
怛	4371		8	1	0.000151%	661523	99.92%	1	0.21%
恫	4372		9	1	0.000151%	661524	99.92%	1	0.21%
惓	4373		11	1	0.000151%	661525	99.92%	1	0.21%
愜	4374		12	1	0.000151%	661526	99.92%	1	0.21%
慍	4375		13	1	0.000151%	661527	99.92%	1	0.21%
愫	4376		13	1	0.000151%	661528	99.92%	1	0.21%
慇	4377		14	1	0.000151%	661529	99.92%	1	0.21%
慳	4378		14	1	0.000151%	661530	99.92%	1	0.21%
慝	4379		15	1	0.000151%	661531	99.92%	1	0.21%
慼	4380		15	1	0.000151%	661532	99.92%	1	0.21%
憋	4381		15	1	0.000151%	661533	99.92%	1	0.21%
憒	4382		15	1	0.000151%	661534	99.92%	1	0.21%
懍	4383		16	1	0.000151%	661535	99.92%	1	0.21%
懃	4384		17	1	0.000151%	661536	99.92%	1	0.21%
懾	4385		21	1	0.000151%	661537	99.92%	1	0.21%
戎	4386		6	1	0.000151%	661538	99.92%	1	0.21%
戟	4387		12	1	0.000151%	661539	99.92%	1	0.21%
戡	4388		13	1	0.000151%	661540	99.92%	1	0.21%
戮	4389		15	1	0.000151%	661541	99.92%	1	0.21%
戽	4390		8	1	0.000151%	661542	99.92%	1	0.21%
	4391		8	1	0.000151%	661543	99.92%	1	0.21%
拌	4392		8	1	0.000151%	661544	99.92%	1	0.21%
拈	4393		8	1	0.000151%	661545	99.92%	1	0.21%
拇	4394		8	1	0.000151%	661546	99.92%	1	0.21%
拗	4395		8	1	0.000151%	661547	99.92%	1	0.21%
拑	4396		8	1	0.000151%	661548	99.92%	1	0.21%
拽	4397		9	1	0.000151%	661549	99.92%	1	0.21%
拴	4398		9	1	0.000151%	661550	99.92%	1	0.21%
拏	4399		9	1	0.000151%	661551	99.92%	1	0.21%
挹	4400		10	1	0.000151%	661552	99.93%	1	0.21%
捺	4401		11	1	0.000151%	661553	99.93%	1	0.21%
掂	4402		11	1	0.000151%	661554	99.93%	1	0.21%
揍	4403		12	1	0.000151%	661555	99.93%	1	0.21%
揹	4404		12	1	0.000151%	661556	99.93%	1	0.21%
揶	4405		12	1	0.000151%	661557	99.93%	1	0.21%
搆	4406		13	1	0.000151%	661558	99.93%	1	0.21%
搦	4407		13	1	0.000151%	661559	99.93%	1	0.21%
搥	4408		13	1	0.000151%	661560	99.93%	1	0.21%
摻	4409		14	1	0.000151%	661561	99.93%	1	0.21%
撅	4410		15	1	0.000151%	661562	99.93%	1	0.21%
撟	4411		15	1	0.000151%	661563	99.93%	1	0.21%
撘	4412		15	1	0.000151%	661564	99.93%	1	0.21%
撻	4413		16	1	0.000151%	661565	99.93%	1	0.21%
擒	4414		16	1	0.000151%	661566	99.93%	1	0.21%
擘	4415		17	1	0.000151%	661567	99.93%	1	0.21%
擯	4416		17	1	0.000151%	661568	99.93%	1	0.21%
	4417		22	1	0.000151%	661569	99.93%	1	0.21%
攢	4418		22	1	0.000151%	661570	99.93%	1	0.21%
敕	4419		11	1	0.000151%	661571	99.93%	1	0.21%
斂	4420		17	1	0.000151%	661572	99.93%	1	0.21%
斲	4421		15	1	0.000151%	661573	99.93%	1	0.21%
旂	4422		10	1	0.000151%	661574	99.93%	1	0.21%
旌	4423		11	1	0.000151%	661575	99.93%	1	0.21%
旎	4424		11	1	0.000151%	661576	99.93%	1	0.21%
旖	4425		14	1	0.000151%	661577	99.93%	1	0.21%
旛	4426		18	1	0.000151%	661578	99.93%	1	0.21%
旰	4427		7	1	0.000151%	661579	99.93%	1	0.21%
昊	4428		8	1	0.000151%	661580	99.93%	1	0.21%
昉	4429		8	1	0.000151%	661581	99.93%	1	0.21%
昺	4430		9	1	0.000151%	661582	99.93%	1	0.21%
晁	4431		10	1	0.000151%	661583	99.93%	1	0.21%
	4432		11	1	0.000151%	661584	99.93%	1	0.21%
晾	4433		12	1	0.000151%	661585	99.93%	1	0.21%
暄	4434		13	1	0.000151%	661586	99.93%	1	0.21%
曖	4435		17	1	0.000151%	661587	99.93%	1	0.21%
曚	4436		18	1	0.000151%	661588	99.93%	1	0.21%
曣	4437		20	1	0.000151%	661589	99.93%	1	0.21%
	4438		9	1	0.000151%	661590	99.93%	1	0.21%
朕	4439		10	1	0.000151%	661591	99.93%	1	0.21%
朓	4440		10	1	0.000151%	661592	99.93%	1	0.21%
	4441		11	1	0.000151%	661593	99.93%	1	0.21%
杇	4442		7	1	0.000151%	661594	99.93%	1	0.21%
杈	4443		7	1	0.000151%	661595	99.93%	1	0.21%
杷	4444		8	1	0.000151%	661596	99.93%	1	0.21%
杼	4445		8	1	0.000151%	661597	99.93%	1	0.21%
杪	4446		8	1	0.000151%	661598	99.93%	1	0.21%
枒	4447		8	1	0.000151%	661599	99.93%	1	0.21%
柩	4448		9	1	0.000151%	661600	99.93%	1	0.21%
柑	4449		9	1	0.000151%	661601	99.93%	1	0.21%
柞	4450		9	1	0.000151%	661602	99.93%	1	0.21%
	4451		10	1	0.000151%	661603	99.93%	1	0.21%
桅	4452		10	1	0.000151%	661604	99.93%	1	0.21%
梆	4453		11	1	0.000151%	661605	99.93%	1	0.21%
梔	4454		11	1	0.000151%	661606	99.93%	1	0.21%
椎	4455		12	1	0.000151%	661607	99.93%	1	0.21%
棎	4456		12	1	0.000151%	661608	99.93%	1	0.21%
楨	4457		13	1	0.000151%	661609	99.93%	1	0.21%
楝	4458		13	1	0.000151%	661610	99.93%	1	0.21%
楣	4459		13	1	0.000151%	661611	99.93%	1	0.21%
椽	4460		13	1	0.000151%	661612	99.93%	1	0.21%
榛	4461		14	1	0.000151%	661613	99.93%	1	0.21%
槃	4462		14	1	0.000151%	661614	99.93%	1	0.21%
樅	4463		15	1	0.000151%	661615	99.93%	1	0.21%
樺	4464		16	1	0.000151%	661616	99.93%	1	0.21%
樵	4465		16	1	0.000151%	661617	99.93%	1	0.21%
檄	4466		17	1	0.000151%	661618	99.94%	1	0.21%
櫓	4467		19	1	0.000151%	661619	99.94%	1	0.21%
櫫	4468		19	1	0.000151%	661620	99.94%	1	0.21%
櫪	4469		20	1	0.000151%	661621	99.94%	1	0.21%
櫸	4470		21	1	0.000151%	661622	99.94%	1	0.21%
欬	4471		10	1	0.000151%	661623	99.94%	1	0.21%
欹	4472		12	1	0.000151%	661624	99.94%	1	0.21%
歙	4473		16	1	0.000151%	661625	99.94%	1	0.21%
歟	4474		18	1	0.000151%	661626	99.94%	1	0.21%
歿	4475		8	1	0.000151%	661627	99.94%	1	0.21%
殍	4476		11	1	0.000151%	661628	99.94%	1	0.21%
殞	4477		14	1	0.000151%	661629	99.94%	1	0.21%
殯	4478		18	1	0.000151%	661630	99.94%	1	0.21%
殽	4479		12	1	0.000151%	661631	99.94%	1	0.21%
毘	4480		9	1	0.000151%	661632	99.94%	1	0.21%
毬	4481		11	1	0.000151%	661633	99.94%	1	0.21%
毽	4482		13	1	0.000151%	661634	99.94%	1	0.21%
氖	4483		6	1	0.000151%	661635	99.94%	1	0.21%
氡	4484		9	1	0.000151%	661636	99.94%	1	0.21%
氤	4485		10	1	0.000151%	661637	99.94%	1	0.21%
汛	4486		6	1	0.000151%	661638	99.94%	1	0.21%
汔	4487		6	1	0.000151%	661639	99.94%	1	0.21%
汞	4488		7	1	0.000151%	661640	99.94%	1	0.21%
汾	4489		7	1	0.000151%	661641	99.94%	1	0.21%
沆	4490		7	1	0.000151%	661642	99.94%	1	0.21%
泌	4491		8	1	0.000151%	661643	99.94%	1	0.21%
泓	4492		8	1	0.000151%	661644	99.94%	1	0.21%
泄	4493		8	1	0.000151%	661645	99.94%	1	0.21%
泅	4494		8	1	0.000151%	661646	99.94%	1	0.21%
泮	4495		8	1	0.000151%	661647	99.94%	1	0.21%
浹	4496		10	1	0.000151%	661648	99.94%	1	0.21%
浣	4497		10	1	0.000151%	661649	99.94%	1	0.21%
淞	4498		11	1	0.000151%	661650	99.94%	1	0.21%
淀	4499		11	1	0.000151%	661651	99.94%	1	0.21%
淩	4500		11	1	0.000151%	661652	99.94%	1	0.21%
渝	4501		12	1	0.000151%	661653	99.94%	1	0.21%
湎	4502		12	1	0.000151%	661654	99.94%	1	0.21%
湫	4503		12	1	0.000151%	661655	99.94%	1	0.21%
湤	4504		12	1	0.000151%	661656	99.94%	1	0.21%
溲	4505		12	1	0.000151%	661657	99.94%	1	0.21%
溛	4506		13	1	0.000151%	661658	99.94%	1	0.21%
溏	4507		13	1	0.000151%	661659	99.94%	1	0.21%
漥	4508		14	1	0.000151%	661660	99.94%	1	0.21%
滸	4509		14	1	0.000151%	661661	99.94%	1	0.21%
滻	4510		14	1	0.000151%	661662	99.94%	1	0.21%
潸	4511		15	1	0.000151%	661663	99.94%	1	0.21%
滕	4512		15	1	0.000151%	661664	99.94%	1	0.21%
潯	4513		15	1	0.000151%	661665	99.94%	1	0.21%
濂	4514		16	1	0.000151%	661666	99.94%	1	0.21%
澱	4515		16	1	0.000151%	661667	99.94%	1	0.21%
潞	4516		16	1	0.000151%	661668	99.94%	1	0.21%
瀣	4517		19	1	0.000151%	661669	99.94%	1	0.21%
瀹	4518		20	1	0.000151%	661670	99.94%	1	0.21%
	4519		6	1	0.000151%	661671	99.94%	1	0.21%
炓	4520		8	1	0.000151%	661672	99.94%	1	0.21%
烽	4521		11	1	0.000151%	661673	99.94%	1	0.21%
焗	4522		11	1	0.000151%	661674	99.94%	1	0.21%
	4523		13	1	0.000151%	661675	99.94%	1	0.21%
煢	4524		13	1	0.000151%	661676	99.94%	1	0.21%
煲	4525		13	1	0.000151%	661677	99.94%	1	0.21%
燊	4526		16	1	0.000151%	661678	99.94%	1	0.21%
燴	4527		17	1	0.000151%	661679	99.94%	1	0.21%
燻	4528		18	1	0.000151%	661680	99.94%	1	0.21%
牴	4529		9	1	0.000151%	661681	99.94%	1	0.21%
犄	4530		12	1	0.000151%	661682	99.94%	1	0.21%
狙	4531		8	1	0.000151%	661683	99.94%	1	0.21%
猙	4532		11	1	0.000151%	661684	99.95%	1	0.21%
猊	4533		11	1	0.000151%	661685	99.95%	1	0.21%
獒	4534		15	1	0.000151%	661686	99.95%	1	0.21%
獠	4535		15	1	0.000151%	661687	99.95%	1	0.21%
獾	4536		21	1	0.000151%	661688	99.95%	1	0.21%
珥	4537		10	1	0.000151%	661689	99.95%	1	0.21%
琅	4538		11	1	0.000151%	661690	99.95%	1	0.21%
	4539		12	1	0.000151%	661691	99.95%	1	0.21%
琛	4540		12	1	0.000151%	661692	99.95%	1	0.21%
琬	4541		12	1	0.000151%	661693	99.95%	1	0.21%
瑕	4542		13	1	0.000151%	661694	99.95%	1	0.21%
瑜	4543		13	1	0.000151%	661695	99.95%	1	0.21%
甄	4544		14	1	0.000151%	661696	99.95%	1	0.21%
甌	4545		16	1	0.000151%	661697	99.95%	1	0.21%
甍	4546		16	1	0.000151%	661698	99.95%	1	0.21%
甑	4547		17	1	0.000151%	661699	99.95%	1	0.21%
甬	4548		7	1	0.000151%	661700	99.95%	1	0.21%
疣	4549		9	1	0.000151%	661701	99.95%	1	0.21%
疹	4550		10	1	0.000151%	661702	99.95%	1	0.21%
疵	4551		11	1	0.000151%	661703	99.95%	1	0.21%
痞	4552		12	1	0.000151%	661704	99.95%	1	0.21%
痠	4553		12	1	0.000151%	661705	99.95%	1	0.21%
瘧	4554		14	1	0.000151%	661706	99.95%	1	0.21%
瘖	4555		14	1	0.000151%	661707	99.95%	1	0.21%
瘼	4556		16	1	0.000151%	661708	99.95%	1	0.21%
癆	4557		17	1	0.000151%	661709	99.95%	1	0.21%
癇	4558		17	1	0.000151%	661710	99.95%	1	0.21%
盔	4559		11	1	0.000151%	661711	99.95%	1	0.21%
盱	4560		8	1	0.000151%	661712	99.95%	1	0.21%
眯	4561		11	1	0.000151%	661713	99.95%	1	0.21%
睇	4562		12	1	0.000151%	661714	99.95%	1	0.21%
睢	4563		13	1	0.000151%	661715	99.95%	1	0.21%
瞄	4564		14	1	0.000151%	661716	99.95%	1	0.21%
睿	4565		14	1	0.000151%	661717	99.95%	1	0.21%
瞑	4566		15	1	0.000151%	661718	99.95%	1	0.21%
瞠	4567		16	1	0.000151%	661719	99.95%	1	0.21%
矼	4568		8	1	0.000151%	661720	99.95%	1	0.21%
砑	4569		9	1	0.000151%	661721	99.95%	1	0.21%
砸	4570		10	1	0.000151%	661722	99.95%	1	0.21%
砥	4571		10	1	0.000151%	661723	99.95%	1	0.21%
砭	4572		10	1	0.000151%	661724	99.95%	1	0.21%
硅	4573		11	1	0.000151%	661725	99.95%	1	0.21%
硯	4574		12	1	0.000151%	661726	99.95%	1	0.21%
硤	4575		12	1	0.000151%	661727	99.95%	1	0.21%
硨	4576		12	1	0.000151%	661728	99.95%	1	0.21%
碓	4577		13	1	0.000151%	661729	99.95%	1	0.21%
碁	4578		13	1	0.000151%	661730	99.95%	1	0.21%
碣	4579		14	1	0.000151%	661731	99.95%	1	0.21%
碾	4580		15	1	0.000151%	661732	99.95%	1	0.21%
磕	4581		15	1	0.000151%	661733	99.95%	1	0.21%
磲	4582		17	1	0.000151%	661734	99.95%	1	0.21%
祉	4583		8	1	0.000151%	661735	99.95%	1	0.21%
祕	4584		9	1	0.000151%	661736	99.95%	1	0.21%
祛	4585		9	1	0.000151%	661737	99.95%	1	0.21%
禎	4586		13	1	0.000151%	661738	99.95%	1	0.21%
禊	4587		13	1	0.000151%	661739	99.95%	1	0.21%
秣	4588		10	1	0.000151%	661740	99.95%	1	0.21%
稈	4589		12	1	0.000151%	661741	99.95%	1	0.21%
稟	4590		13	1	0.000151%	661742	99.95%	1	0.21%
竅	4591		18	1	0.000151%	661743	99.95%	1	0.21%
竺	4592		8	1	0.000151%	661744	99.95%	1	0.21%
竽	4593		9	1	0.000151%	661745	99.95%	1	0.21%
笈	4594		10	1	0.000151%	661746	99.95%	1	0.21%
笳	4595		11	1	0.000151%	661747	99.95%	1	0.21%
筍	4596		12	1	0.000151%	661748	99.95%	1	0.21%
筏	4597		12	1	0.000151%	661749	99.95%	1	0.21%
筱	4598		13	1	0.000151%	661750	99.95%	1	0.21%
箔	4599		14	1	0.000151%	661751	99.96%	1	0.21%
篆	4600		15	1	0.000151%	661752	99.96%	1	0.21%
簑	4601		16	1	0.000151%	661753	99.96%	1	0.21%
篾	4602		17	1	0.000151%	661754	99.96%	1	0.21%
簧	4603		18	1	0.000151%	661755	99.96%	1	0.21%
簪	4604		18	1	0.000151%	661756	99.96%	1	0.21%
簟	4605		18	1	0.000151%	661757	99.96%	1	0.21%
籤	4606		23	1	0.000151%	661758	99.96%	1	0.21%
籣	4607		23	1	0.000151%	661759	99.96%	1	0.21%
粥	4608		12	1	0.000151%	661760	99.96%	1	0.21%
粳	4609		13	1	0.000151%	661761	99.96%	1	0.21%
糈	4610		15	1	0.000151%	661762	99.96%	1	0.21%
糠	4611		17	1	0.000151%	661763	99.96%	1	0.21%
糜	4612		17	1	0.000151%	661764	99.96%	1	0.21%
紉	4613		9	1	0.000151%	661765	99.96%	1	0.21%
紇	4614		9	1	0.000151%	661766	99.96%	1	0.21%
紝	4615		10	1	0.000151%	661767	99.96%	1	0.21%
絀	4616		11	1	0.000151%	661768	99.96%	1	0.21%
	4617		13	1	0.000151%	661769	99.96%	1	0.21%
絹	4618		13	1	0.000151%	661770	99.96%	1	0.21%
綸	4619		14	1	0.000151%	661771	99.96%	1	0.21%
綹	4620		14	1	0.000151%	661772	99.96%	1	0.21%
綦	4621		14	1	0.000151%	661773	99.96%	1	0.21%
縊	4622		16	1	0.000151%	661774	99.96%	1	0.21%
縟	4623		16	1	0.000151%	661775	99.96%	1	0.21%
縲	4624		17	1	0.000151%	661776	99.96%	1	0.21%
繅	4625		17	1	0.000151%	661777	99.96%	1	0.21%
縴	4626		17	1	0.000151%	661778	99.96%	1	0.21%
縳	4627		17	1	0.000151%	661779	99.96%	1	0.21%
繕	4628		18	1	0.000151%	661780	99.96%	1	0.21%
纂	4629		20	1	0.000151%	661781	99.96%	1	0.21%
纙	4630		25	1	0.000151%	661782	99.96%	1	0.21%
罝	4631		10	1	0.000151%	661783	99.96%	1	0.21%
罹	4632		16	1	0.000151%	661784	99.96%	1	0.21%
罻	4633		16	1	0.000151%	661785	99.96%	1	0.21%
羌	4634		8	1	0.000151%	661786	99.96%	1	0.21%
聒	4635		12	1	0.000151%	661787	99.96%	1	0.21%
聶	4636		18	1	0.000151%	661788	99.96%	1	0.21%
聿	4637		6	1	0.000151%	661789	99.96%	1	0.21%
肓	4638		7	1	0.000151%	661790	99.96%	1	0.21%
胄	4639		9	1	0.000151%	661791	99.96%	1	0.21%
胭	4640		10	1	0.000151%	661792	99.96%	1	0.21%
腮	4641		13	1	0.000151%	661793	99.96%	1	0.21%
腺	4642		13	1	0.000151%	661794	99.96%	1	0.21%
腩	4643		13	1	0.000151%	661795	99.96%	1	0.21%
膞	4644		15	1	0.000151%	661796	99.96%	1	0.21%
臃	4645		17	1	0.000151%	661797	99.96%	1	0.21%
膾	4646		17	1	0.000151%	661798	99.96%	1	0.21%
臚	4647		20	1	0.000151%	661799	99.96%	1	0.21%
臧	4648		14	1	0.000151%	661800	99.96%	1	0.21%
臾	4649		8	1	0.000151%	661801	99.96%	1	0.21%
舛	4650		6	1	0.000151%	661802	99.96%	1	0.21%
舫	4651		10	1	0.000151%	661803	99.96%	1	0.21%
舷	4652		11	1	0.000151%	661804	99.96%	1	0.21%
艙	4653		16	1	0.000151%	661805	99.96%	1	0.21%
艟	4654		18	1	0.000151%	661806	99.96%	1	0.21%
艨	4655		20	1	0.000151%	661807	99.96%	1	0.21%
芋	4656		7	1	0.000151%	661808	99.96%	1	0.21%
芎	4657		7	1	0.000151%	661809	99.96%	1	0.21%
芃	4658		7	1	0.000151%	661810	99.96%	1	0.21%
	4659		8	1	0.000151%	661811	99.96%	1	0.21%
芥	4660		8	1	0.000151%	661812	99.96%	1	0.21%
芾	4661		8	1	0.000151%	661813	99.96%	1	0.21%
苧	4662		9	1	0.000151%	661814	99.96%	1	0.21%
苣	4663		9	1	0.000151%	661815	99.96%	1	0.21%
茍	4664		9	1	0.000151%	661816	99.96%	1	0.21%
茜	4665		10	1	0.000151%	661817	99.97%	1	0.21%
莒	4666		11	1	0.000151%	661818	99.97%	1	0.21%
荻	4667		11	1	0.000151%	661819	99.97%	1	0.21%
荼	4668		11	1	0.000151%	661820	99.97%	1	0.21%
莨	4669		11	1	0.000151%	661821	99.97%	1	0.21%
荳	4670		11	1	0.000151%	661822	99.97%	1	0.21%
菸	4671		12	1	0.000151%	661823	99.97%	1	0.21%
菠	4672		12	1	0.000151%	661824	99.97%	1	0.21%
萋	4673		12	1	0.000151%	661825	99.97%	1	0.21%
萵	4674		13	1	0.000151%	661826	99.97%	1	0.21%
葸	4675		13	1	0.000151%	661827	99.97%	1	0.21%
蓁	4676		14	1	0.000151%	661828	99.97%	1	0.21%
蔔	4677		15	1	0.000151%	661829	99.97%	1	0.21%
蔻	4678		15	1	0.000151%	661830	99.97%	1	0.21%
蔞	4679		15	1	0.000151%	661831	99.97%	1	0.21%
蕈	4680		16	1	0.000151%	661832	99.97%	1	0.21%
蕨	4681		16	1	0.000151%	661833	99.97%	1	0.21%
蕘	4682		16	1	0.000151%	661834	99.97%	1	0.21%
薑	4683		17	1	0.000151%	661835	99.97%	1	0.21%
薀	4684		17	1	0.000151%	661836	99.97%	1	0.21%
薤	4685		17	1	0.000151%	661837	99.97%	1	0.21%
薦	4686		18	1	0.000151%	661838	99.97%	1	0.21%
藜	4687		19	1	0.000151%	661839	99.97%	1	0.21%
蚌	4688		10	1	0.000151%	661840	99.97%	1	0.21%
蚧	4689		10	1	0.000151%	661841	99.97%	1	0.21%
蚱	4690		11	1	0.000151%	661842	99.97%	1	0.21%
蛩	4691		12	1	0.000151%	661843	99.97%	1	0.21%
蜓	4692		13	1	0.000151%	661844	99.97%	1	0.21%
蜃	4693		13	1	0.000151%	661845	99.97%	1	0.21%
蜥	4694		14	1	0.000151%	661846	99.97%	1	0.21%
蜮	4695		14	1	0.000151%	661847	99.97%	1	0.21%
蜚	4696		14	1	0.000151%	661848	99.97%	1	0.21%
蝠	4697		15	1	0.000151%	661849	99.97%	1	0.21%
蝸	4698		15	1	0.000151%	661850	99.97%	1	0.21%
蝙	4699		15	1	0.000151%	661851	99.97%	1	0.21%
螃	4700		16	1	0.000151%	661852	99.97%	1	0.21%
蟄	4701		17	1	0.000151%	661853	99.97%	1	0.21%
螽	4702		17	1	0.000151%	661854	99.97%	1	0.21%
蟾	4703		19	1	0.000151%	661855	99.97%	1	0.21%
衲	4704		9	1	0.000151%	661856	99.97%	1	0.21%
袒	4705		10	1	0.000151%	661857	99.97%	1	0.21%
褓	4706		14	1	0.000151%	661858	99.97%	1	0.21%
褟	4707		15	1	0.000151%	661859	99.97%	1	0.21%
襁	4708		16	1	0.000151%	661860	99.97%	1	0.21%
褻	4709		17	1	0.000151%	661861	99.97%	1	0.21%
襌	4710		17	1	0.000151%	661862	99.97%	1	0.21%
襖	4711		18	1	0.000151%	661863	99.97%	1	0.21%
襾	4712		6	1	0.000151%	661864	99.97%	1	0.21%
覈	4713		19	1	0.000151%	661865	99.97%	1	0.21%
覯	4714		17	1	0.000151%	661866	99.97%	1	0.21%
覷	4715		19	1	0.000151%	661867	99.97%	1	0.21%
訃	4716		9	1	0.000151%	661868	99.97%	1	0.21%
訏	4717		10	1	0.000151%	661869	99.97%	1	0.21%
訟	4718		11	1	0.000151%	661870	99.97%	1	0.21%
訧	4719		11	1	0.000151%	661871	99.97%	1	0.21%
詁	4720		12	1	0.000151%	661872	99.97%	1	0.21%
詆	4721		12	1	0.000151%	661873	99.97%	1	0.21%
詖	4722		12	1	0.000151%	661874	99.97%	1	0.21%
詘	4723		12	1	0.000151%	661875	99.97%	1	0.21%
詮	4724		13	1	0.000151%	661876	99.97%	1	0.21%
詡	4725		13	1	0.000151%	661877	99.97%	1	0.21%
誣	4726		14	1	0.000151%	661878	99.97%	1	0.21%
諉	4727		15	1	0.000151%	661879	99.97%	1	0.21%
誹	4728		15	1	0.000151%	661880	99.97%	1	0.21%
謁	4729		16	1	0.000151%	661881	99.97%	1	0.21%
謗	4730		17	1	0.000151%	661882	99.97%	1	0.21%
謄	4731		17	1	0.000151%	661883	99.98%	1	0.21%
謦	4732		18	1	0.000151%	661884	99.98%	1	0.21%
譚	4733		19	1	0.000151%	661885	99.98%	1	0.21%
譎	4734		19	1	0.000151%	661886	99.98%	1	0.21%
譭	4735		20	1	0.000151%	661887	99.98%	1	0.21%
譅	4736		21	1	0.000151%	661888	99.98%	1	0.21%
譾	4737		22	1	0.000151%	661889	99.98%	1	0.21%
讕	4738		24	1	0.000151%	661890	99.98%	1	0.21%
豉	4739		11	1	0.000151%	661891	99.98%	1	0.21%
豕	4740		7	1	0.000151%	661892	99.98%	1	0.21%
豚	4741		11	1	0.000151%	661893	99.98%	1	0.21%
豳	4742		17	1	0.000151%	661894	99.98%	1	0.21%
豺	4743		10	1	0.000151%	661895	99.98%	1	0.21%
賁	4744		12	1	0.000151%	661896	99.98%	1	0.21%
賻	4745		17	1	0.000151%	661897	99.98%	1	0.21%
趟	4746		15	1	0.000151%	661898	99.98%	1	0.21%
趴	4747		9	1	0.000151%	661899	99.98%	1	0.21%
跣	4748		13	1	0.000151%	661900	99.98%	1	0.21%
跫	4749		13	1	0.000151%	661901	99.98%	1	0.21%
踟	4750		15	1	0.000151%	661902	99.98%	1	0.21%
踮	4751		15	1	0.000151%	661903	99.98%	1	0.21%
蹂	4752		16	1	0.000151%	661904	99.98%	1	0.21%
蹊	4753		17	1	0.000151%	661905	99.98%	1	0.21%
蹚	4754		18	1	0.000151%	661906	99.98%	1	0.21%
蹩	4755		18	1	0.000151%	661907	99.98%	1	0.21%
蹼	4756		19	1	0.000151%	661908	99.98%	1	0.21%
躋	4757		21	1	0.000151%	661909	99.98%	1	0.21%
躕	4758		22	1	0.000151%	661910	99.98%	1	0.21%
躪	4759		27	1	0.000151%	661911	99.98%	1	0.21%
軏	4760		10	1	0.000151%	661912	99.98%	1	0.21%
軼	4761		12	1	0.000151%	661913	99.98%	1	0.21%
輊	4762		13	1	0.000151%	661914	99.98%	1	0.21%
轂	4763		17	1	0.000151%	661915	99.98%	1	0.21%
轎	4764		19	1	0.000151%	661916	99.98%	1	0.21%
迤	4765		8	1	0.000151%	661917	99.98%	1	0.21%
逑	4766		10	1	0.000151%	661918	99.98%	1	0.21%
遴	4767		15	1	0.000151%	661919	99.98%	1	0.21%
邈	4768		17	1	0.000151%	661920	99.98%	1	0.21%
邐	4769		22	1	0.000151%	661921	99.98%	1	0.21%
邯	4770		7	1	0.000151%	661922	99.98%	1	0.21%
郅	4771		8	1	0.000151%	661923	99.98%	1	0.21%
鄱	4772		14	1	0.000151%	661924	99.98%	1	0.21%
鄲	4773		14	1	0.000151%	661925	99.98%	1	0.21%
酥	4774		12	1	0.000151%	661926	99.98%	1	0.21%
酢	4775		12	1	0.000151%	661927	99.98%	1	0.21%
醃	4776		15	1	0.000151%	661928	99.98%	1	0.21%
醐	4777		16	1	0.000151%	661929	99.98%	1	0.21%
醍	4778		16	1	0.000151%	661930	99.98%	1	0.21%
醣	4779		17	1	0.000151%	661931	99.98%	1	0.21%
醱	4780		19	1	0.000151%	661932	99.98%	1	0.21%
醮	4781		19	1	0.000151%	661933	99.98%	1	0.21%
釵	4782		11	1	0.000151%	661934	99.98%	1	0.21%
釷	4783		11	1	0.000151%	661935	99.98%	1	0.21%
鈦	4784		12	1	0.000151%	661936	99.98%	1	0.21%
	4785		13	1	0.000151%	661937	99.98%	1	0.21%
鈳	4786		13	1	0.000151%	661938	99.98%	1	0.21%
鉧	4787		13	1	0.000151%	661939	99.98%	1	0.21%
鉲	4788		13	1	0.000151%	661940	99.98%	1	0.21%
銹	4789		15	1	0.000151%	661941	99.98%	1	0.21%
錠	4790		16	1	0.000151%	661942	99.98%	1	0.21%
鍺	4791		16	1	0.000151%	661943	99.98%	1	0.21%
錼	4792		16	1	0.000151%	661944	99.98%	1	0.21%
錩	4793		16	1	0.000151%	661945	99.98%	1	0.21%
錨	4794		17	1	0.000151%	661946	99.98%	1	0.21%
鍬	4795		17	1	0.000151%	661947	99.98%	1	0.21%
鍼	4796		17	1	0.000151%	661948	99.98%	1	0.21%
鎬	4797		18	1	0.000151%	661949	99.99%	1	0.21%
鎗	4798		18	1	0.000151%	661950	99.99%	1	0.21%
鏟	4799		19	1	0.000151%	661951	99.99%	1	0.21%
鏃	4800		19	1	0.000151%	661952	99.99%	1	0.21%
鏘	4801		19	1	0.000151%	661953	99.99%	1	0.21%
鏤	4802		19	1	0.000151%	661954	99.99%	1	0.21%
鐃	4803		20	1	0.000151%	661955	99.99%	1	0.21%
閔	4804		12	1	0.000151%	661956	99.99%	1	0.21%
閏	4805		12	1	0.000151%	661957	99.99%	1	0.21%
閞	4806		13	1	0.000151%	661958	99.99%	1	0.21%
閭	4807		15	1	0.000151%	661959	99.99%	1	0.21%
閻	4808		16	1	0.000151%	661960	99.99%	1	0.21%
闍	4809		16	1	0.000151%	661961	99.99%	1	0.21%
闋	4810		17	1	0.000151%	661962	99.99%	1	0.21%
闔	4811		18	1	0.000151%	661963	99.99%	1	0.21%
闐	4812		18	1	0.000151%	661964	99.99%	1	0.21%
陂	4813		7	1	0.000151%	661965	99.99%	1	0.21%
陞	4814		9	1	0.000151%	661966	99.99%	1	0.21%
陜	4815		9	1	0.000151%	661967	99.99%	1	0.21%
陟	4816		9	1	0.000151%	661968	99.99%	1	0.21%
隍	4817		11	1	0.000151%	661969	99.99%	1	0.21%
雹	4818		13	1	0.000151%	661970	99.99%	1	0.21%
霽	4819		22	1	0.000151%	661971	99.99%	1	0.21%
	4820		12	1	0.000151%	661972	99.99%	1	0.21%
靶	4821		13	1	0.000151%	661973	99.99%	1	0.21%
鞘	4822		16	1	0.000151%	661974	99.99%	1	0.21%
韃	4823		22	1	0.000151%	661975	99.99%	1	0.21%
頡	4824		15	1	0.000151%	661976	99.99%	1	0.21%
顴	4825		26	1	0.000151%	661977	99.99%	1	0.21%
餔	4826		15	1	0.000151%	661978	99.99%	1	0.21%
餡	4827		16	1	0.000151%	661979	99.99%	1	0.21%
餾	4828		18	1	0.000151%	661980	99.99%	1	0.21%
餼	4829		18	1	0.000151%	661981	99.99%	1	0.21%
饅	4830		19	1	0.000151%	661982	99.99%	1	0.21%
饈	4831		19	1	0.000151%	661983	99.99%	1	0.21%
饃	4832		19	1	0.000151%	661984	99.99%	1	0.21%
饋	4833		20	1	0.000151%	661985	99.99%	1	0.21%
饜	4834		23	1	0.000151%	661986	99.99%	1	0.21%
馥	4835		18	1	0.000151%	661987	99.99%	1	0.21%
馭	4836		12	1	0.000151%	661988	99.99%	1	0.21%
馱	4837		13	1	0.000151%	661989	99.99%	1	0.21%
	4838		15	1	0.000151%	661990	99.99%	1	0.21%
骷	4839		15	1	0.000151%	661991	99.99%	1	0.21%
骼	4840		16	1	0.000151%	661992	99.99%	1	0.21%
髀	4841		18	1	0.000151%	661993	99.99%	1	0.21%
髏	4842		21	1	0.000151%	661994	99.99%	1	0.21%
髯	4843		15	1	0.000151%	661995	99.99%	1	0.21%
髲	4844		15	1	0.000151%	661996	99.99%	1	0.21%
髭	4845		16	1	0.000151%	661997	99.99%	1	0.21%
髹	4846		16	1	0.000151%	661998	99.99%	1	0.21%
鬈	4847		18	1	0.000151%	661999	99.99%	1	0.21%
鬞	4848		22	1	0.000151%	662000	99.99%	1	0.21%
魁	4849		14	1	0.000151%	662001	99.99%	1	0.21%
魘	4850		24	1	0.000151%	662002	99.99%	1	0.21%
鯽	4851		18	1	0.000151%	662003	99.99%	1	0.21%
鯁	4852		18	1	0.000151%	662004	99.99%	1	0.21%
鯪	4853		19	1	0.000151%	662005	99.99%	1	0.21%
	4854		20	1	0.000151%	662006	99.99%	1	0.21%
鱈	4855		22	1	0.000151%	662007	99.99%	1	0.21%
鳩	4856		13	1	0.000151%	662008	99.99%	1	0.21%
鴕	4857		16	1	0.000151%	662009	99.99%	1	0.21%
鴣	4858		16	1	0.000151%	662010	99.99%	1	0.21%
鴦	4859		16	1	0.000151%	662011	99.99%	1	0.21%
鴛	4860		16	1	0.000151%	662012	99.99%	1	0.21%
鶿	4861		20	1	0.000151%	662013	99.99%	1	0.21%
鷓	4862		22	1	0.000151%	662014	99.99%	1	0.21%
鷺	4863		24	1	0.000151%	662015	99.9999999999%	1	0.21%
鹼	4864		24	1	0.000151%	662016	99.9999999999%	1	0.21%
麇	4865		16	1	0.000151%	662017	99.9999999999%	1	0.21%
麋	4866		17	1	0.000151%	662018	99.9999999999%	1	0.21%
麴	4867		19	1	0.000151%	662019	99.9999999999%	1	0.21%
黌	4868		25	1	0.000151%	662020	99.9999999999%	1	0.21%
黜	4869		17	1	0.000151%	662021	99.9999999999%	1	0.21%
黴	4870		23	1	0.000151%	662022	99.9999999999%	1	0.21%
黽	4871		13	1	0.000151%	662023	99.9999999999%	1	0.21%
鼙	4872		21	1	0.000151%	662024	99.9999999999%	1	0.21%
齎	4873		21	1	0.000151%	662025	99.9999999999%	1	0.21%
齧	4874		21	1	0.000151%	662026	99.9999999999%	1	0.21%
齪	4875		22	1	0.000151%	662027	99.9999999999%	1	0.21%
齷	4876		24	1	0.000151%	662028	99.9999999999%	1	0.21%
