序號,詞目,詞頻,累計詞頻,百分比,累計百分比
1,的,39282,39282,6.36345670,6.36345670
2,在,8522,47804,1.38051469,7.74397139
3,一,7684,55488,1.24476354,8.98873492
4,有,6820,62308,1.10480054,10.09353546
5,是,6692,69000,1.08406528,11.17760074
6,了,4719,73719,0.76445069,11.94205143
7,這,3970,77689,0.64311703,12.58516846
8,個,3965,81654,0.64230706,13.22747551
9,為,3835,85489,0.62124781,13.84872332
10,也,3615,89104,0.58560908,14.43433241
11,到,3606,92710,0.58415113,15.01848354
12,以,3249,95959,0.52631920,15.54480274
13,上,3206,99165,0.51935345,16.06415619
14,他,2940,102105,0.47626299,16.54041918
15,人,2805,104910,0.45439377,16.99481295
16,而,2772,107682,0.44904796,17.44386091
17,我,2731,110413,0.44240620,17.88626710
18,中,2698,113111,0.43706039,18.32332749
19,不,2608,115719,0.42248091,18.74580840
20,和,2528,118247,0.40952137,19.15532977
21,與,2527,120774,0.40935938,19.56468915
22,之,2482,123256,0.40206964,19.96675879
23,就,2376,125632,0.38489825,20.35165704
24,會,2361,127993,0.38246834,20.73412538
25,來,2265,130258,0.36691689,21.10104227
26,大,2177,132435,0.35266140,21.45370367
27,將,2100,134535,0.34018785,21.79389152
28,都,2061,136596,0.33387007,22.12776160
29,對,2034,138630,0.32949623,22.45725783
30,要,1999,140629,0.32382643,22.78108426
31,最,1999,142628,0.32382643,23.10491069
32,於,1992,144620,0.32269247,23.42760317
33,後,1953,146573,0.31637470,23.74397787
34,及,1842,148415,0.29839334,24.04237121
35,時,1835,150250,0.29725938,24.33963059
36,多,1827,152077,0.29596343,24.63559402
37,說,1804,153881,0.29223756,24.92783158
38,得,1788,155669,0.28964565,25.21747723
39,可以,1605,157274,0.26000071,25.47747794
40,你,1601,158875,0.25935274,25.73683068
41,可,1584,160459,0.25659883,25.99342951
42,但,1518,161977,0.24590722,26.23933673
43,年,1516,163493,0.24558323,26.48491996
44,所,1487,164980,0.24088540,26.72580535
45,下,1484,166464,0.24039941,26.96620477
46,很,1448,167912,0.23456762,27.20077239
47,並,1412,169324,0.22873583,27.42950822
48,等,1395,170719,0.22598193,27.65549015
49,種,1378,172097,0.22322803,27.87871817
50,著,1357,173454,0.21982615,28.09854432
51,能,1320,174774,0.21383236,28.31237668
52,更,1226,176000,0.19860491,28.51098159
53,每,1200,177200,0.19439306,28.70537464
54,好,1176,178376,0.19050520,28.89587984
55,或,1165,179541,0.18872326,29.08460310
56,兩,1156,180697,0.18726531,29.27186841
57,還,1154,181851,0.18694132,29.45880973
58,我們,1140,182991,0.18467340,29.64348313
59,已,1129,184120,0.18289147,29.82637460
60,由,1123,185243,0.18191950,30.00829410
61,地,1105,186348,0.17900361,30.18729771
62,從,1090,187438,0.17657369,30.36387140
63,讓,1075,188513,0.17414378,30.53801518
64,前,1037,189550,0.16798800,30.70600318
65,她,1031,190581,0.16701603,30.87301922
66,只,1026,191607,0.16620606,31.03922528
67,他們,1016,192623,0.16458612,31.20381140
68,成,999,193622,0.16183222,31.36564362
69,被,999,194621,0.16183222,31.52747584
70,各,996,195617,0.16134624,31.68882208
71,出,995,196612,0.16118424,31.85000632
72,台灣,990,197602,0.16037427,32.01038059
73,三,981,198583,0.15891632,32.16929691
74,看,980,199563,0.15875433,32.32805124
75,新,974,200537,0.15778236,32.48583361
76,做,971,201508,0.15729638,32.64312999
77,自己,967,202475,0.15664840,32.79977839
78,再,959,203434,0.15535245,32.95513084
79,其,935,204369,0.15146459,33.10659543
80,沒有,934,205303,0.15130260,33.25789803
81,則,933,206236,0.15114060,33.40903863
82,因為,917,207153,0.14854869,33.55758732
83,高,903,208056,0.14628077,33.70386810
84,次,887,208943,0.14368887,33.84755697
85,過,887,209830,0.14368887,33.99124583
86,元,869,210699,0.14077297,34.13201880
87,用,856,211555,0.13866705,34.27068585
88,此,851,212406,0.13785708,34.40854293
89,又,849,213255,0.13753309,34.54607601
90,小,838,214093,0.13575115,34.68182717
91,內,838,214931,0.13575115,34.81757832
92,如果,809,215740,0.13105332,34.94863163
93,位,808,216548,0.13089132,35.07952296
94,第,789,217337,0.12781343,35.20733639
95,才,780,218117,0.12635549,35.33369188
96,可能,780,218897,0.12635549,35.46004737
97,表示,775,219672,0.12554552,35.58559288
98,外,772,220444,0.12505953,35.71065242
99,那,771,221215,0.12489754,35.83554995
100,使,752,221967,0.12181965,35.95736960
101,些,750,222717,0.12149566,36.07886526
102,就是,750,223467,0.12149566,36.20036092
103,把,738,224205,0.11955173,36.31991265
104,市場,735,224940,0.11906575,36.43897840
105,二,733,225673,0.11874176,36.55772016
106,卻,728,226401,0.11793179,36.67565195
107,因此,695,227096,0.11258598,36.78823792
108,投資,673,227769,0.10902211,36.89726003
109,目前,672,228441,0.10886011,37.00612014
110,當,672,229113,0.10886011,37.11498025
111,公司,671,229784,0.10869812,37.22367837
112,較,668,230452,0.10821213,37.33189050
113,因,664,231116,0.10756416,37.43945466
114,家,663,231779,0.10740216,37.54685683
115,但是,655,232434,0.10610621,37.65296304
116,天,644,233078,0.10432427,37.75728731
117,想,635,233713,0.10286633,37.86015364
118,至,632,234345,0.10238034,37.96253398
119,問題,631,234976,0.10221835,38.06475233
120,如,618,235594,0.10011242,38.16486475
121,去,617,236211,0.09995043,38.26481518
122,給,611,236822,0.09897846,38.36379365
123,所以,609,237431,0.09865448,38.46244812
124,它,598,238029,0.09687254,38.55932066
125,全,596,238625,0.09654855,38.65586921
126,裡,595,239220,0.09638656,38.75225577
127,該,591,239811,0.09573858,38.84799435
128,使用,584,240395,0.09460462,38.94259897
129,不過,581,240976,0.09411864,39.03671761
130,點,558,241534,0.09039277,39.12711038
131,無,553,242087,0.08958280,39.21669318
132,幾,550,242637,0.08909682,39.30579000
133,起,546,243183,0.08844884,39.39423884
134,向,537,243720,0.08699089,39.48122973
135,除,536,244256,0.08682890,39.56805863
136,本,534,244790,0.08650491,39.65456354
137,四,531,245321,0.08601893,39.74058247
138,時間,517,245838,0.08375101,39.82433347
139,總統,505,246343,0.08180708,39.90614055
140,雖然,502,246845,0.08132110,39.98746165
141,今年,497,247342,0.08051112,40.06797277
142,不是,494,247836,0.08002514,40.14799791
143,名,494,248330,0.08002514,40.22802306
144,比,487,248817,0.07889118,40.30691424
145,工作,484,249301,0.07840520,40.38531944
146,仍,482,249783,0.07808121,40.46340065
147,開始,482,250265,0.07808121,40.54148186
148,不同,471,250736,0.07629927,40.61778113
149,間,464,251200,0.07516532,40.69294645
150,應,463,251663,0.07500332,40.76794977
151,即,459,252122,0.07435534,40.84230511
152,其他,457,252579,0.07403136,40.91633647
153,已經,454,253033,0.07354537,40.98988184
154,像,454,253487,0.07354537,41.06342721
155,記者,452,253939,0.07322138,41.13664860
156,美國,451,254390,0.07305939,41.20970799
157,發展,449,254839,0.07273540,41.28244339
158,以及,443,255282,0.07176344,41.35420683
159,自,441,255723,0.07143945,41.42564628
160,許多,439,256162,0.07111546,41.49676174
161,必須,438,256600,0.07095347,41.56771520
162,受,438,257038,0.07095347,41.63866867
163,事,436,257474,0.07062948,41.70929814
164,相當,434,257908,0.07030549,41.77960363
165,希望,428,258336,0.06933352,41.84893716
166,發現,426,258762,0.06900953,41.91794669
167,由於,422,259184,0.06836156,41.98630825
168,報導,422,259606,0.06836156,42.05466981
169,月,416,260022,0.06738959,42.12205940
170,作,416,260438,0.06738959,42.18944899
171,方式,414,260852,0.06706560,42.25651460
172,另,414,261266,0.06706560,42.32358020
173,太,408,261674,0.06609364,42.38967384
174,指出,408,262082,0.06609364,42.45576748
175,便,405,262487,0.06560766,42.52137514
176,未來,403,262890,0.06528367,42.58665880
177,產品,403,263293,0.06528367,42.65194247
178,台北,398,263691,0.06447370,42.71641617
179,政府,395,264086,0.06398771,42.78040388
180,什麼,392,264478,0.06350173,42.84390562
181,提供,390,264868,0.06317774,42.90708336
182,五,389,265257,0.06301575,42.97009911
183,者,385,265642,0.06236777,43.03246688
184,電腦,384,266026,0.06220578,43.09467266
185,重要,383,266409,0.06204378,43.15671644
186,曾,383,266792,0.06204378,43.21876023
187,生活,381,267173,0.06171980,43.28048002
188,無法,381,267554,0.06171980,43.34219982
189,約,374,267928,0.06058584,43.40278565
190,十,373,268301,0.06042384,43.46320949
191,也是,372,268673,0.06026185,43.52347134
192,而且,371,269044,0.06009985,43.58357119
193,不會,369,269413,0.05977586,43.64334706
194,表現,368,269781,0.05961387,43.70296093
195,項,367,270148,0.05945188,43.76241281
196,同時,364,270512,0.05896589,43.82137870
197,若,363,270875,0.05880390,43.88018260
198,影響,362,271237,0.05864191,43.93882451
199,長,360,271597,0.05831792,43.99714242
200,分,358,271955,0.05799393,44.05513635
201,都是,357,272312,0.05783193,44.11296828
202,國,355,272667,0.05750795,44.17047623
203,現在,353,273020,0.05718396,44.22766019
204,數,353,273373,0.05718396,44.28484415
205,如何,350,273723,0.05669797,44.34154212
206,設計,349,274072,0.05653598,44.39807810
207,正,348,274420,0.05637399,44.45445209
208,先,345,274765,0.05588800,44.51034009
209,去年,344,275109,0.05572601,44.56606610
210,見,342,275451,0.05540202,44.62146812
211,世界,341,275792,0.05524003,44.67670815
212,處,341,276133,0.05524003,44.73194817
213,主要,340,276473,0.05507803,44.78702621
214,比較,339,276812,0.05491604,44.84194225
215,增加,338,277150,0.05475404,44.89669629
216,未,335,277485,0.05426806,44.95096435
217,走,334,277819,0.05410607,45.00507042
218,第一,334,278153,0.05410607,45.05917649
219,需要,333,278486,0.05394407,45.11312056
220,出現,331,278817,0.05362008,45.16674064
221,甚至,330,279147,0.05345809,45.22019873
222,進行,329,279476,0.05329610,45.27349483
223,一般,326,279802,0.05281011,45.32630494
224,方面,325,280127,0.05264812,45.37895306
225,認為,325,280452,0.05264812,45.43160118
226,不能,320,280772,0.05183815,45.48343933
227,還是,318,281090,0.05151416,45.53495349
228,加,317,281407,0.05135217,45.58630566
229,近,317,281724,0.05135217,45.63765782
230,選擇,315,282039,0.05102818,45.68868600
231,歲,314,282353,0.05086618,45.73955218
232,大陸,312,282665,0.05054219,45.79009438
233,心,312,282977,0.05054219,45.84063657
234,達,312,283289,0.05054219,45.89117877
235,發生,309,283598,0.05005621,45.94123498
236,言,308,283906,0.04989422,45.99112920
237,時候,308,284214,0.04989422,46.04102341
238,特別,306,284520,0.04957023,46.09059364
239,場,306,284826,0.04957023,46.14016387
240,一些,305,285131,0.04940824,46.18957211
241,且,305,285436,0.04940824,46.23898034
242,活動,305,285741,0.04940824,46.28838858
243,一定,303,286044,0.04908425,46.33747283
244,錢,301,286345,0.04876026,46.38623308
245,應該,301,286646,0.04876026,46.43499334
246,昨天,299,286945,0.04843627,46.48342961
247,包括,298,287243,0.04827428,46.53170389
248,低,297,287540,0.04811228,46.57981617
249,打,295,287835,0.04778829,46.62760446
250,社會,294,288129,0.04762630,46.67523076
251,日本,293,288422,0.04746430,46.72269507
252,作品,292,288714,0.04730231,46.76999738
253,沒,292,289006,0.04730231,46.81729969
254,非常,292,289298,0.04730231,46.86460200
255,連,292,289590,0.04730231,46.91190431
256,機會,292,289882,0.04730231,46.95920662
257,少,286,290168,0.04633035,47.00553696
258,企業,284,290452,0.04600636,47.05154332
259,藝術,284,290736,0.04600636,47.09754968
260,找,283,291019,0.04584436,47.14339404
261,知道,283,291302,0.04584436,47.18923840
262,日,282,291584,0.04568237,47.23492077
263,常,282,291866,0.04568237,47.28060314
264,開,282,292148,0.04568237,47.32628551
265,股票,280,292428,0.04535838,47.37164388
266,難,280,292708,0.04535838,47.41700226
267,具,278,292986,0.04503439,47.46203666
268,功能,277,293263,0.04487240,47.50690905
269,真,277,293540,0.04487240,47.55178145
270,經濟,277,293817,0.04487240,47.59665385
271,攝影,276,294093,0.04471040,47.64136425
272,業者,275,294368,0.04454841,47.68591266
273,成為,274,294642,0.04438641,47.73029907
274,系統,273,294915,0.04422442,47.77452349
275,當然,273,295188,0.04422442,47.81874791
276,是否,272,295460,0.04406243,47.86281034
277,部分,272,295732,0.04406243,47.90687277
278,買,272,296004,0.04406243,47.95093519
279,亦,270,296274,0.04373844,47.99467363
280,張,270,296544,0.04373844,48.03841207
281,片,269,296813,0.04357644,48.08198851
282,吃,268,297081,0.04341445,48.12540296
283,車,268,297349,0.04341445,48.16881741
284,一樣,267,297616,0.04325246,48.21206986
285,服務,267,297883,0.04325246,48.25532232
286,一直,266,298149,0.04309046,48.29841278
287,任何,266,298415,0.04309046,48.34150324
288,成長,266,298681,0.04309046,48.38459370
289,地方,265,298946,0.04292847,48.42752217
290,結果,265,299211,0.04292847,48.47045064
291,回,264,299475,0.04276647,48.51321711
292,帶,264,299739,0.04276647,48.55598358
293,另外,262,300001,0.04244248,48.59842606
294,期,262,300263,0.04244248,48.64086855
295,要求,261,300524,0.04228049,48.68314904
296,關係,260,300784,0.04211850,48.72526753
297,六,259,301043,0.04195650,48.76722403
298,容易,258,301301,0.04179451,48.80901854
299,國家,257,301558,0.04163251,48.85065105
300,中共,256,301814,0.04147052,48.89212157
301,環境,256,302070,0.04147052,48.93359209
302,樣,255,302325,0.04130852,48.97490062
303,研究,254,302579,0.04114653,49.01604715
304,進,254,302833,0.04114653,49.05719368
305,只是,253,303086,0.04098454,49.09817821
306,們,251,303337,0.04066055,49.13883876
307,話,251,303588,0.04066055,49.17949931
308,令,248,303836,0.04017456,49.21967387
309,類,248,304084,0.04017456,49.25984844
310,大家,247,304331,0.04001257,49.29986101
311,個人,247,304578,0.04001257,49.33987358
312,完全,246,304824,0.03985058,49.37972416
313,股,246,305070,0.03985058,49.41957473
314,今天,245,305315,0.03968858,49.45926332
315,利用,245,305560,0.03968858,49.49895190
316,美元,245,305805,0.03968858,49.53864048
317,極,245,306050,0.03968858,49.57832906
318,過去,245,306295,0.03968858,49.61801764
319,電影,245,306540,0.03968858,49.65770623
320,處理,244,306784,0.03952659,49.69723281
321,股市,242,307026,0.03920260,49.73643541
322,自然,241,307267,0.03904061,49.77547602
323,決定,241,307508,0.03904061,49.81451663
324,身,241,307749,0.03904061,49.85355723
325,地區,240,307989,0.03887861,49.89243584
326,成功,240,308229,0.03887861,49.93131445
327,非,240,308469,0.03887861,49.97019306
328,跟,240,308709,0.03887861,50.00907168
329,您,239,308948,0.03871662,50.04778829
330,推出,238,309186,0.03855462,50.08634292
331,整,238,309424,0.03855462,50.12489754
332,隨,238,309662,0.03855462,50.16345216
333,能力,235,309897,0.03806864,50.20152080
334,變,234,310131,0.03790665,50.23942745
335,了解,233,310364,0.03774465,50.27717210
336,空間,231,310595,0.03742066,50.31459276
337,產生,231,310826,0.03742066,50.35201343
338,呢,230,311056,0.03725867,50.38927210
339,往,230,311286,0.03725867,50.42653076
340,最後,230,311516,0.03725867,50.46378943
341,加上,228,311744,0.03693468,50.50072411
342,同,228,311972,0.03693468,50.53765879
343,請,228,312200,0.03693468,50.57459348
344,國內,227,312427,0.03677269,50.61136616
345,進入,227,312654,0.03677269,50.64813885
346,愈,227,312881,0.03677269,50.68491153
347,妳,226,313107,0.03661069,50.72152223
348,民眾,225,313332,0.03644870,50.75797093
349,遊戲,225,313557,0.03644870,50.79441962
350,對於,225,313782,0.03644870,50.83086832
351,總,225,314007,0.03644870,50.86731702
352,台,224,314231,0.03628670,50.90360372
353,佳,224,314455,0.03628670,50.93989043
354,問,224,314679,0.03628670,50.97617713
355,認,224,314903,0.03628670,51.01246383
356,廣告,224,315127,0.03628670,51.04875054
357,如此,223,315350,0.03612471,51.08487525
358,銀行,223,315573,0.03612471,51.12099996
359,資料,221,315794,0.03580072,51.15680068
360,件,219,316013,0.03547673,51.19227741
361,完成,219,316232,0.03547673,51.22775414
362,或是,219,316451,0.03547673,51.26323088
363,孩子,219,316670,0.03547673,51.29870761
364,經營,219,316889,0.03547673,51.33418434
365,早,218,317107,0.03531474,51.36949908
366,這些,218,317325,0.03531474,51.40481382
367,當時,218,317543,0.03531474,51.44012856
368,技術,217,317760,0.03515274,51.47528130
369,情況,216,317976,0.03499075,51.51027205
370,部,215,318191,0.03482876,51.54510081
371,朋友,214,318405,0.03466676,51.57976757
372,資訊,214,318619,0.03466676,51.61443433
373,國際,213,318832,0.03450477,51.64893910
374,其中,212,319044,0.03434277,51.68328187
375,聽,212,319256,0.03434277,51.71762465
376,面,211,319467,0.03418078,51.75180543
377,能夠,210,319677,0.03401878,51.78582421
378,均,209,319886,0.03385679,51.81968100
379,其實,209,320095,0.03385679,51.85353779
380,某,209,320304,0.03385679,51.88739458
381,文化,208,320512,0.03369480,51.92108938
382,快,208,320720,0.03369480,51.95478418
383,廠商,208,320928,0.03369480,51.98847897
384,原因,207,321135,0.03353280,52.02201177
385,不要,205,321340,0.03320881,52.05522059
386,香港,205,321545,0.03320881,52.08842940
387,半,204,321749,0.03304682,52.12147622
388,喜歡,204,321953,0.03304682,52.15452304
389,可是,203,322156,0.03288483,52.18740787
390,身體,203,322359,0.03288483,52.22029269
391,放,203,322562,0.03288483,52.25317752
392,經驗,203,322765,0.03288483,52.28606234
393,花,202,322967,0.03272283,52.31878517
394,最近,202,323169,0.03272283,52.35150800
395,水,201,323370,0.03256084,52.38406884
396,型,201,323571,0.03256084,52.41662968
397,效果,201,323772,0.03256084,52.44919051
398,造成,201,323973,0.03256084,52.48175135
399,價格,201,324174,0.03256084,52.51431219
400,行,200,324374,0.03239884,52.54671103
401,土地,199,324573,0.03223685,52.57894788
402,手,198,324771,0.03207485,52.61102273
403,代表,198,324969,0.03207485,52.64309759
404,底,198,325167,0.03207485,52.67517244
405,段,197,325364,0.03191286,52.70708530
406,音樂,197,325561,0.03191286,52.73899816
407,感覺,197,325758,0.03191286,52.77091102
408,萬,197,325955,0.03191286,52.80282388
409,選,196,326151,0.03175087,52.83457475
410,單位,195,326346,0.03158887,52.86616362
411,不斷,194,326540,0.03142688,52.89759050
412,注意,194,326734,0.03142688,52.92901738
413,經過,194,326928,0.03142688,52.96044425
414,方法,193,327121,0.03126488,52.99170914
415,那麼,193,327314,0.03126488,53.02297402
416,政治,193,327507,0.03126488,53.05423890
417,需,193,327700,0.03126488,53.08550379
418,傳統,192,327892,0.03110289,53.11660667
419,至於,191,328083,0.03094089,53.14754757
420,顯示,191,328274,0.03094089,53.17848846
421,出來,190,328464,0.03077890,53.20926736
422,接受,190,328654,0.03077890,53.24004627
423,資金,190,328844,0.03077890,53.27082517
424,七,188,329032,0.03045491,53.30128008
425,相關,188,329220,0.03045491,53.33173499
426,目標,187,329407,0.03029292,53.36202791
427,老,187,329594,0.03029292,53.39232083
428,經,187,329781,0.03029292,53.42261374
429,品質,186,329967,0.03013092,53.45274467
430,根據,186,330153,0.03013092,53.48287559
431,管理,186,330339,0.03013092,53.51300652
432,網路,186,330525,0.03013092,53.54313744
433,嗎,183,330708,0.02964494,53.57278238
434,尤其,182,330890,0.02948295,53.60226533
435,直接,181,331071,0.02932095,53.63158628
436,拿,181,331252,0.02932095,53.66090723
437,真正,181,331433,0.02932095,53.69022819
438,屬,181,331614,0.02932095,53.71954914
439,人員,180,331794,0.02915896,53.74870810
440,不少,180,331974,0.02915896,53.77786705
441,首,180,332154,0.02915896,53.80702601
442,女性,179,332333,0.02899696,53.83602298
443,計畫,179,332512,0.02899696,53.86501994
444,部份,179,332691,0.02899696,53.89401691
445,過程,179,332870,0.02899696,53.92301387
446,中國,178,333048,0.02883497,53.95184884
447,告訴,178,333226,0.02883497,53.98068381
448,份,177,333403,0.02867298,54.00935679
449,入,176,333579,0.02851098,54.03786777
450,產業,176,333755,0.02851098,54.06637875
451,愛,176,333931,0.02851098,54.09488973
452,據,176,334107,0.02851098,54.12340071
453,八,174,334281,0.02818699,54.15158771
454,書,174,334455,0.02818699,54.17977470
455,參加,174,334629,0.02818699,54.20796169
456,僅,174,334803,0.02818699,54.23614868
457,別人,173,334976,0.02802500,54.26417368
458,建議,173,335149,0.02802500,54.29219868
459,原,173,335322,0.02802500,54.32022368
460,軟體,173,335495,0.02802500,54.34824868
461,這樣,173,335668,0.02802500,54.37627368
462,繼續,173,335841,0.02802500,54.40429868
463,警方,173,336014,0.02802500,54.43232368
464,十分,172,336186,0.02786300,54.46018668
465,即使,172,336358,0.02786300,54.48804969
466,改變,172,336530,0.02786300,54.51591269
467,接,172,336702,0.02786300,54.54377570
468,度,171,336873,0.02770101,54.57147671
469,透過,170,337043,0.02753902,54.59901572
470,幾乎,170,337213,0.02753902,54.62655474
471,依,169,337382,0.02737702,54.65393176
472,然後,169,337551,0.02737702,54.68130878
473,有些,168,337719,0.02721503,54.70852381
474,例如,168,337887,0.02721503,54.73573884
475,強調,168,338055,0.02721503,54.76295387
476,道,168,338223,0.02721503,54.79016890
477,電話,168,338391,0.02721503,54.81738392
478,頭,168,338559,0.02721503,54.84459895
479,一起,167,338726,0.02705303,54.87165198
480,生,167,338893,0.02705303,54.89870502
481,轉,167,339060,0.02705303,54.92575805
482,主,164,339224,0.02656705,54.95232510
483,配合,164,339388,0.02656705,54.97889215
484,準備,164,339552,0.02656705,55.00545920
485,解決,164,339716,0.02656705,55.03202626
486,比賽,163,339879,0.02640506,55.05843131
487,提出,163,340042,0.02640506,55.08483637
488,開發,163,340205,0.02640506,55.11124143
489,嚴重,163,340368,0.02640506,55.13764648
490,似乎,161,340529,0.02608107,55.16372755
491,別,161,340690,0.02608107,55.18980862
492,組,161,340851,0.02608107,55.21588969
493,雖,161,341012,0.02608107,55.24197076
494,左右,160,341172,0.02591907,55.26788983
495,住,160,341332,0.02591907,55.29380891
496,基金,160,341492,0.02591907,55.31972798
497,支,159,341651,0.02575708,55.34548506
498,生產,159,341810,0.02575708,55.37124214
499,美,159,341969,0.02575708,55.39699922
500,健康,159,342128,0.02575708,55.42275630
501,國民黨,159,342287,0.02575708,55.44851338
502,人士,158,342445,0.02559509,55.47410846
503,事實,158,342603,0.02559509,55.49970355
504,重,158,342761,0.02559509,55.52529864
505,情形,158,342919,0.02559509,55.55089372
506,狀況,157,343076,0.02543309,55.57632681
507,專業,157,343233,0.02543309,55.60175991
508,現象,157,343390,0.02543309,55.62719300
509,隊,157,343547,0.02543309,55.65262609
510,獲,157,343704,0.02543309,55.67805918
511,程式,156,343860,0.02527110,55.70333028
512,覺,156,344016,0.02527110,55.72860137
513,季,155,344171,0.02510910,55.75371048
514,何,154,344325,0.02494711,55.77865759
515,吧,154,344479,0.02494711,55.80360470
516,並且,154,344633,0.02494711,55.82855180
517,寫,154,344787,0.02494711,55.85349891
518,女,153,344940,0.02478511,55.87828403
519,畫,153,345093,0.02478511,55.90306914
520,內容,152,345245,0.02462312,55.92769226
521,消費者,152,345397,0.02462312,55.95231538
522,然而,151,345548,0.02446113,55.97677651
523,超過,151,345699,0.02446113,56.00123764
524,感,151,345850,0.02446113,56.02569876
525,初,150,346000,0.02429913,56.04999789
526,致,150,346150,0.02429913,56.07429703
527,隻,150,346300,0.02429913,56.09859616
528,運動,150,346450,0.02429913,56.12289529
529,需求,150,346600,0.02429913,56.14719442
530,價,150,346750,0.02429913,56.17149355
531,仍然,149,346899,0.02413714,56.19563069
532,方,149,347048,0.02413714,56.21976783
533,投資人,149,347197,0.02413714,56.24390497
534,改,149,347346,0.02413714,56.26804211
535,引起,148,347494,0.02397514,56.29201725
536,演出,148,347642,0.02397514,56.31599239
537,稱,148,347790,0.02397514,56.33996754
538,標準,148,347938,0.02397514,56.36394268
539,共,147,348085,0.02381315,56.38775583
540,客戶,147,348232,0.02381315,56.41156898
541,案,147,348379,0.02381315,56.43538213
542,壓力,147,348526,0.02381315,56.45919528
543,覺得,147,348673,0.02381315,56.48300843
544,兩岸,146,348819,0.02365116,56.50665958
545,員工,146,348965,0.02365116,56.53031074
546,執行,146,349111,0.02365116,56.55396189
547,獲得,146,349257,0.02365116,56.57761305
548,發,145,349402,0.02348916,56.60110221
549,億,145,349547,0.02348916,56.62459137
550,同樣,144,349691,0.02332717,56.64791854
551,成立,144,349835,0.02332717,56.67124570
552,所有,144,349979,0.02332717,56.69457287
553,為什麼,144,350123,0.02332717,56.71790004
554,原本,144,350267,0.02332717,56.74122720
555,換,144,350411,0.02332717,56.76455437
556,年輕,143,350554,0.02316517,56.78771954
557,相信,143,350697,0.02316517,56.81088472
558,因素,142,350839,0.02300318,56.83388789
559,安全,142,350981,0.02300318,56.85689107
560,球,142,351123,0.02300318,56.87989425
561,報,142,351265,0.02300318,56.90289743
562,談,142,351407,0.02300318,56.92590061
563,邊,142,351549,0.02300318,56.94890379
564,加入,141,351690,0.02284118,56.97174497
565,努力,141,351831,0.02284118,56.99458615
566,改善,141,351972,0.02284118,57.01742734
567,指,141,352113,0.02284118,57.04026852
568,故事,141,352254,0.02284118,57.06310971
569,精神,141,352395,0.02284118,57.08595089
570,角色,140,352535,0.02267919,57.10863008
571,拍,140,352675,0.02267919,57.13130927
572,東西,140,352815,0.02267919,57.15398846
573,條,140,352955,0.02267919,57.17666765
574,式,139,353094,0.02251720,57.19918485
575,成本,139,353233,0.02251720,57.22170204
576,聲,139,353372,0.02251720,57.24421924
577,之後,138,353510,0.02235520,57.26657444
578,路,138,353648,0.02235520,57.28892964
579,工程,137,353785,0.02219321,57.31112285
580,合作,137,353922,0.02219321,57.33331605
581,此外,137,354059,0.02219321,57.35550926
582,老師,137,354196,0.02219321,57.37770247
583,系列,137,354333,0.02219321,57.39989568
584,情緒,137,354470,0.02219321,57.42208888
585,款,137,354607,0.02219321,57.44428209
586,群,137,354744,0.02219321,57.46647530
587,餘,137,354881,0.02219321,57.48866850
588,學生,137,355018,0.02219321,57.51086171
589,口,136,355154,0.02203121,57.53289293
590,套,136,355290,0.02203121,57.55492414
591,基本,136,355426,0.02203121,57.57695535
592,球員,136,355562,0.02203121,57.59898656
593,組織,136,355698,0.02203121,57.62101778
594,廠,136,355834,0.02203121,57.64304899
595,擁有,136,355970,0.02203121,57.66508020
596,算,135,356105,0.02186922,57.68694942
597,一切,134,356239,0.02170722,57.70865665
598,病人,134,356373,0.02170722,57.73036387
599,馬,134,356507,0.02170722,57.75207110
600,百,133,356640,0.02154523,57.77361633
601,李登輝,133,356773,0.02154523,57.79516156
602,速度,133,356906,0.02154523,57.81670679
603,避免,133,357039,0.02154523,57.83825202
604,減少,132,357171,0.02138324,57.85963525
605,影像,132,357303,0.02138324,57.88101849
606,大量,131,357434,0.02122124,57.90223973
607,不但,131,357565,0.02122124,57.92346097
608,分鐘,131,357696,0.02122124,57.94468222
609,死,131,357827,0.02122124,57.96590346
610,不僅,130,357957,0.02105925,57.98696271
611,這麼,130,358087,0.02105925,58.00802195
612,造,130,358217,0.02105925,58.02908120
613,創作,130,358347,0.02105925,58.05014045
614,靠,130,358477,0.02105925,58.07119970
615,分別,129,358606,0.02089725,58.09209695
616,事情,129,358735,0.02089725,58.11299420
617,持續,129,358864,0.02089725,58.13389146
618,價值,129,358993,0.02089725,58.15478871
619,學,129,359122,0.02089725,58.17568596
620,觀念,129,359251,0.02089725,58.19658322
621,吸引,128,359379,0.02073526,58.21731848
622,起來,128,359507,0.02073526,58.23805374
623,送,128,359635,0.02073526,58.25878900
624,獲利,128,359763,0.02073526,58.27952426
625,人們,127,359890,0.02057327,58.30009752
626,反應,127,360017,0.02057327,58.32067079
627,目的,127,360144,0.02057327,58.34124405
628,行動,127,360271,0.02057327,58.36181732
629,牠,127,360398,0.02057327,58.38239058
630,長期,127,360525,0.02057327,58.40296385
631,控制,127,360652,0.02057327,58.42353711
632,調查,127,360779,0.02057327,58.44411038
633,醫師,127,360906,0.02057327,58.46468364
634,版,126,361032,0.02041127,58.48509491
635,建立,126,361158,0.02041127,58.50550618
636,時代,126,361284,0.02041127,58.52591745
637,舉行,126,361410,0.02041127,58.54632873
638,觀眾,126,361536,0.02041127,58.56674000
639,小時,125,361661,0.02024928,58.58698927
640,呈現,125,361786,0.02024928,58.60723855
641,李,125,361911,0.02024928,58.62748783
642,步,125,362036,0.02024928,58.64773710
643,穿,125,362161,0.02024928,58.66798638
644,新黨,125,362286,0.02024928,58.68823566
645,購買,125,362411,0.02024928,58.70848493
646,先生,124,362535,0.02008728,58.72857222
647,考慮,124,362659,0.02008728,58.74865950
648,訓練,124,362783,0.02008728,58.76874678
649,照片,124,362907,0.02008728,58.78883406
650,頗,124,363031,0.02008728,58.80892135
651,層,124,363155,0.02008728,58.82900863
652,遭,124,363279,0.02008728,58.84909591
653,生命,123,363402,0.01992529,58.86902120
654,完,123,363525,0.01992529,58.88894649
655,則是,123,363648,0.01992529,58.90887178
656,重新,123,363771,0.01992529,58.92879706
657,通常,123,363894,0.01992529,58.94872235
658,積極,123,364017,0.01992529,58.96864764
659,讀者,123,364140,0.01992529,58.98857293
660,上午,122,364262,0.01976329,59.00833622
661,動作,122,364384,0.01976329,59.02809952
662,業務,122,364506,0.01976329,59.04786281
663,賣,122,364628,0.01976329,59.06762610
664,導演,122,364750,0.01976329,59.08738940
665,相,121,364871,0.01960130,59.10699070
666,深,121,364992,0.01960130,59.12659200
667,開放,121,365113,0.01960130,59.14619330
668,電視,121,365234,0.01960130,59.16579460
669,代,120,365354,0.01943931,59.18523390
670,強,120,365474,0.01943931,59.20467321
671,治療,119,365593,0.01927731,59.22395052
672,後來,119,365712,0.01927731,59.24322783
673,家庭,118,365830,0.01911532,59.26234315
674,清楚,118,365948,0.01911532,59.28145847
675,規定,118,366066,0.01911532,59.30057378
676,絕對,118,366184,0.01911532,59.31968910
677,越,118,366302,0.01911532,59.33880442
678,變化,118,366420,0.01911532,59.35791974
679,針對,117,366537,0.01895332,59.37687306
680,報告,117,366654,0.01895332,59.39582638
681,學校,117,366771,0.01895332,59.41477970
682,擔任,117,366888,0.01895332,59.43373303
683,幫助,117,367005,0.01895332,59.45268635
684,主管,116,367121,0.01879133,59.47147768
685,叫,116,367237,0.01879133,59.49026901
686,民進黨,116,367353,0.01879133,59.50906034
687,食物,116,367469,0.01879133,59.52785167
688,提升,116,367585,0.01879133,59.54664299
689,中心,115,367700,0.01862933,59.56527233
690,台北市,115,367815,0.01862933,59.58390166
691,坐,115,367930,0.01862933,59.60253100
692,所謂,115,368045,0.01862933,59.62116033
693,英國,115,368160,0.01862933,59.63978967
694,教育,115,368275,0.01862933,59.65841900
695,媒體,115,368390,0.01862933,59.67704834
696,期間,115,368505,0.01862933,59.69567767
697,視,115,368620,0.01862933,59.71430700
698,實際,115,368735,0.01862933,59.73293634
699,反而,114,368849,0.01846734,59.75140368
700,提高,114,368963,0.01846734,59.76987102
701,筆者,114,369077,0.01846734,59.78833836
702,歷史,114,369191,0.01846734,59.80680570
703,不可,113,369304,0.01830535,59.82511105
704,有關,113,369417,0.01830535,59.84341639
705,含,113,369530,0.01830535,59.86172174
706,尚,113,369643,0.01830535,59.88002709
707,負責,113,369756,0.01830535,59.89833243
708,風險,113,369869,0.01830535,59.91663778
709,站,113,369982,0.01830535,59.93494312
710,高雄,113,370095,0.01830535,59.95324847
711,維持,113,370208,0.01830535,59.97155382
712,製作,113,370321,0.01830535,59.98985916
713,銷售,113,370434,0.01830535,60.00816451
714,於是,112,370546,0.01814335,60.02630786
715,門,112,370658,0.01814335,60.04445121
716,附近,112,370770,0.01814335,60.06259456
717,保護,112,370882,0.01814335,60.08073792
718,遠,112,370994,0.01814335,60.09888127
719,調整,112,371106,0.01814335,60.11702462
720,適合,112,371218,0.01814335,60.13516797
721,久,111,371329,0.01798136,60.15314933
722,或許,111,371440,0.01798136,60.17113069
723,直,111,371551,0.01798136,60.18911204
724,金融,111,371662,0.01798136,60.20709340
725,品牌,111,371773,0.01798136,60.22507476
726,現,111,371884,0.01798136,60.24305612
727,藉,111,371995,0.01798136,60.26103748
728,事件,110,372105,0.01781936,60.27885684
729,待,110,372215,0.01781936,60.29667620
730,皆,110,372325,0.01781936,60.31449557
731,面對,110,372435,0.01781936,60.33231493
732,訊息,110,372545,0.01781936,60.35013429
733,意義,110,372655,0.01781936,60.36795366
734,雜誌,110,372765,0.01781936,60.38577302
735,人物,109,372874,0.01765737,60.40343039
736,只要,109,372983,0.01765737,60.42108776
737,例,109,373092,0.01765737,60.43874513
738,流行,109,373201,0.01765737,60.45640250
739,般,109,373310,0.01765737,60.47405987
740,討論,109,373419,0.01765737,60.49171724
741,商品,109,373528,0.01765737,60.50937461
742,結合,109,373637,0.01765737,60.52703197
743,講,109,373746,0.01765737,60.54468934
744,關,109,373855,0.01765737,60.56234671
745,多少,108,373963,0.01749538,60.57984209
746,知,108,374071,0.01749538,60.59733746
747,根本,108,374179,0.01749538,60.61483284
748,經常,108,374287,0.01749538,60.63232821
749,學習,108,374395,0.01749538,60.64982359
750,競爭,108,374503,0.01749538,60.66731896
751,裏,108,374611,0.01749538,60.68481434
752,分析,107,374718,0.01733338,60.70214772
753,王,107,374825,0.01733338,60.71948110
754,任,107,374932,0.01733338,60.73681448
755,怎麼,107,375039,0.01733338,60.75414786
756,規劃,107,375146,0.01733338,60.77148124
757,演員,107,375253,0.01733338,60.78881462
758,求,106,375359,0.01717139,60.80598601
759,明顯,106,375465,0.01717139,60.82315740
760,剛,106,375571,0.01717139,60.84032878
761,階段,106,375677,0.01717139,60.85750017
762,運用,106,375783,0.01717139,60.87467156
763,簡單,106,375889,0.01717139,60.89184294
764,台中,105,375994,0.01700939,60.90885234
765,利率,105,376099,0.01700939,60.92586173
766,省,105,376204,0.01700939,60.94287112
767,食品,105,376309,0.01700939,60.95988051
768,理,105,376414,0.01700939,60.97688991
769,當地,105,376519,0.01700939,60.99389930
770,滿,105,376624,0.01700939,61.01090869
771,誰,105,376729,0.01700939,61.02791808
772,瞭解,105,376834,0.01700939,61.04492748
773,舉辦,105,376939,0.01700939,61.06193687
774,今,104,377043,0.01684740,61.07878427
775,持,104,377147,0.01684740,61.09563166
776,值得,104,377251,0.01684740,61.11247906
777,現代,104,377355,0.01684740,61.12932646
778,逐漸,104,377459,0.01684740,61.14617386
779,發揮,104,377563,0.01684740,61.16302126
780,量,104,377667,0.01684740,61.17986866
781,母親,103,377770,0.01668540,61.19655406
782,利,103,377873,0.01668540,61.21323946
783,倍,103,377976,0.01668540,61.22992487
784,展,103,378079,0.01668540,61.24661027
785,專家,103,378182,0.01668540,61.26329568
786,賺,103,378285,0.01668540,61.27998108
787,老闆,102,378387,0.01652341,61.29650449
788,球隊,102,378489,0.01652341,61.31302790
789,結束,102,378591,0.01652341,61.32955131
790,檢查,102,378693,0.01652341,61.34607472
791,申請,101,378794,0.01636142,61.36243613
792,共同,101,378895,0.01636142,61.37879755
793,否則,101,378996,0.01636142,61.39515896
794,股價,101,379097,0.01636142,61.41152038
795,降低,101,379198,0.01636142,61.42788180
796,參與,101,379299,0.01636142,61.44424321
797,操作,101,379400,0.01636142,61.46060463
798,小孩,100,379500,0.01619942,61.47680405
799,加強,100,379600,0.01619942,61.49300347
800,肯定,100,379700,0.01619942,61.50920289
801,政策,100,379800,0.01619942,61.52540231
802,倒,100,379900,0.01619942,61.54160173
803,習慣,100,380000,0.01619942,61.55780116
804,確定,100,380100,0.01619942,61.57400058
805,戰,100,380200,0.01619942,61.59020000
806,不再,99,380299,0.01603743,61.60623743
807,本身,99,380398,0.01603743,61.62227485
808,制度,99,380497,0.01603743,61.63831228
809,或者,99,380596,0.01603743,61.65434971
810,馬上,99,380695,0.01603743,61.67038713
811,條件,99,380794,0.01603743,61.68642456
812,規模,99,380893,0.01603743,61.70246199
813,設備,99,380992,0.01603743,61.71849942
814,提,99,381091,0.01603743,61.73453684
815,實在,99,381190,0.01603743,61.75057427
816,盡,99,381289,0.01603743,61.76661170
817,選舉,99,381388,0.01603743,61.78264912
818,總經理,99,381487,0.01603743,61.79868655
819,不管,98,381585,0.01587543,61.81456198
820,主題,98,381683,0.01587543,61.83043742
821,正式,98,381781,0.01587543,61.84631285
822,字,98,381879,0.01587543,61.86218828
823,留,98,381977,0.01587543,61.87806372
824,區,98,382075,0.01587543,61.89393915
825,採,98,382173,0.01587543,61.90981458
826,符合,98,382271,0.01587543,61.92569001
827,感受,98,382369,0.01587543,61.94156545
828,歐洲,98,382467,0.01587543,61.95744088
829,一旦,97,382564,0.01571344,61.97315432
830,支持,97,382661,0.01571344,61.98886776
831,法,97,382758,0.01571344,62.00458120
832,的確,97,382855,0.01571344,62.02029464
833,表達,97,382952,0.01571344,62.03600807
834,表演,97,383049,0.01571344,62.05172151
835,既,97,383146,0.01571344,62.06743495
836,發行,97,383243,0.01571344,62.08314839
837,策略,97,383340,0.01571344,62.09886183
838,意,97,383437,0.01571344,62.11457527
839,自由,96,383533,0.01555144,62.13012671
840,行情,96,383629,0.01555144,62.14567816
841,相同,96,383725,0.01555144,62.16122960
842,現場,96,383821,0.01555144,62.17678105
843,終於,96,383917,0.01555144,62.19233249
844,預算,96,384013,0.01555144,62.20788393
845,製造,96,384109,0.01555144,62.22343538
846,興趣,96,384205,0.01555144,62.23898682
847,穩定,96,384301,0.01555144,62.25453827
848,止,95,384396,0.01538945,62.26992772
849,父親,95,384491,0.01538945,62.28531717
850,快速,95,384586,0.01538945,62.30070662
851,科技,95,384681,0.01538945,62.31609607
852,重視,95,384776,0.01538945,62.33148552
853,曾經,95,384871,0.01538945,62.34687497
854,跑,95,384966,0.01538945,62.36226442
855,號,95,385061,0.01538945,62.37765387
856,達到,95,385156,0.01538945,62.39304332
857,不錯,94,385250,0.01522746,62.40827078
858,平均,94,385344,0.01522746,62.42349823
859,民國,94,385438,0.01522746,62.43872569
860,再度,94,385532,0.01522746,62.45395314
861,地點,94,385626,0.01522746,62.46918060
862,安排,94,385720,0.01522746,62.48440806
863,形成,94,385814,0.01522746,62.49963551
864,角度,94,385908,0.01522746,62.51486297
865,玩,94,386002,0.01522746,62.53009043
866,指數,94,386096,0.01522746,62.54531788
867,原來,94,386190,0.01522746,62.56054534
868,座,94,386284,0.01522746,62.57577279
869,絕,94,386378,0.01522746,62.59100025
870,支援,93,386471,0.01506546,62.60606571
871,列,93,386564,0.01506546,62.62113117
872,多數,93,386657,0.01506546,62.63619664
873,自我,93,386750,0.01506546,62.65126210
874,使用者,93,386843,0.01506546,62.66632756
875,性,93,386936,0.01506546,62.68139302
876,房地產,93,387029,0.01506546,62.69645848
877,眼,93,387122,0.01506546,62.71152394
878,眼睛,93,387215,0.01506546,62.72658941
879,畫面,93,387308,0.01506546,62.74165487
880,九,92,387400,0.01490347,62.75655834
881,下午,92,387492,0.01490347,62.77146180
882,正常,92,387584,0.01490347,62.78636527
883,收,92,387676,0.01490347,62.80126874
884,死亡,92,387768,0.01490347,62.81617221
885,享受,92,387860,0.01490347,62.83107567
886,相對,92,387952,0.01490347,62.84597914
887,限制,92,388044,0.01490347,62.86088261
888,特殊,92,388136,0.01490347,62.87578608
889,追求,92,388228,0.01490347,62.89068954
890,推動,92,388320,0.01490347,62.90559301
891,採用,92,388412,0.01490347,62.92049648
892,創造,92,388504,0.01490347,62.93539995
893,會議,92,388596,0.01490347,62.95030342
894,樓,92,388688,0.01490347,62.96520688
895,擔心,92,388780,0.01490347,62.98011035
896,舉,92,388872,0.01490347,62.99501382
897,方向,91,388963,0.01474147,63.00975529
898,作業,91,389054,0.01474147,63.02449676
899,往往,91,389145,0.01474147,63.03923824
900,勝,91,389236,0.01474147,63.05397971
901,塊,91,389327,0.01474147,63.06872119
902,感染,91,389418,0.01474147,63.08346266
903,導致,91,389509,0.01474147,63.09820413
904,充滿,90,389599,0.01457948,63.11278361
905,行為,90,389689,0.01457948,63.12736309
906,汽車,90,389779,0.01457948,63.14194257
907,人類,89,389868,0.01441749,63.15636005
908,也許,89,389957,0.01441749,63.17077754
909,取,89,390046,0.01441749,63.18519502
910,唯一,89,390135,0.01441749,63.19961251
911,理想,89,390224,0.01441749,63.21402999
912,景氣,89,390313,0.01441749,63.22844748
913,雙方,89,390402,0.01441749,63.24286496
914,力量,88,390490,0.01425549,63.25712046
915,女人,88,390578,0.01425549,63.27137595
916,工具,88,390666,0.01425549,63.28563144
917,水準,88,390754,0.01425549,63.29988693
918,立委,88,390842,0.01425549,63.31414242
919,官員,88,390930,0.01425549,63.32839791
920,居,88,391018,0.01425549,63.34265340
921,風格,88,391106,0.01425549,63.35690889
922,級,88,391194,0.01425549,63.37116438
923,動,88,391282,0.01425549,63.38541987
924,組合,88,391370,0.01425549,63.39967536
925,須,88,391458,0.01425549,63.41393085
926,語言,88,391546,0.01425549,63.42818635
927,課程,88,391634,0.01425549,63.44244184
928,機構,88,391722,0.01425549,63.45669733
929,類似,88,391810,0.01425549,63.47095282
930,觀察,88,391898,0.01425549,63.48520831
931,人民,87,391985,0.01409350,63.49930180
932,力,87,392072,0.01409350,63.51339530
933,正是,87,392159,0.01409350,63.52748880
934,正確,87,392246,0.01409350,63.54158229
935,自動,87,392333,0.01409350,63.55567579
936,至少,87,392420,0.01409350,63.56976929
937,我國,87,392507,0.01409350,63.58386278
938,具有,87,392594,0.01409350,63.59795628
939,房子,87,392681,0.01409350,63.61204978
940,狀態,87,392768,0.01409350,63.62614327
941,資源,87,392855,0.01409350,63.64023677
942,錯,87,392942,0.01409350,63.65433027
943,趨勢,87,393029,0.01409350,63.66842376
944,職棒,87,393116,0.01409350,63.68251726
945,父母,86,393202,0.01393150,63.69644876
946,立法院,86,393288,0.01393150,63.71038027
947,交通,86,393374,0.01393150,63.72431177
948,地位,86,393460,0.01393150,63.73824327
949,值,86,393546,0.01393150,63.75217477
950,記,86,393632,0.01393150,63.76610627
951,程度,86,393718,0.01393150,63.78003778
952,模式,86,393804,0.01393150,63.79396928
953,整體,86,393890,0.01393150,63.80790078
954,辦法,86,393976,0.01393150,63.82183228
955,不足,85,394061,0.01376951,63.83560179
956,事業,85,394146,0.01376951,63.84937130
957,定,85,394231,0.01376951,63.86314081
958,計劃,85,394316,0.01376951,63.87691032
959,新加坡,85,394401,0.01376951,63.89067982
960,節目,85,394486,0.01376951,63.90444933
961,圖,85,394571,0.01376951,63.91821884
962,豐富,85,394656,0.01376951,63.93198835
963,醫院,85,394741,0.01376951,63.94575786
964,關鍵,85,394826,0.01376951,63.95952737
965,介紹,84,394910,0.01360751,63.97313488
966,內部,84,394994,0.01360751,63.98674239
967,以後,84,395078,0.01360751,64.00034991
968,市,84,395162,0.01360751,64.01395742
969,永遠,84,395246,0.01360751,64.02756494
970,行政院,84,395330,0.01360751,64.04117245
971,保持,84,395414,0.01360751,64.05477996
972,帶來,84,395498,0.01360751,64.06838748
973,週,84,395582,0.01360751,64.08199499
974,戲,84,395666,0.01360751,64.09560251
975,聲音,84,395750,0.01360751,64.10921002
976,離開,84,395834,0.01360751,64.12281753
977,黨,84,395918,0.01360751,64.13642505
978,以前,83,396001,0.01344552,64.14987057
979,交易,83,396084,0.01344552,64.16331609
980,存在,83,396167,0.01344552,64.17676161
981,你們,83,396250,0.01344552,64.19020713
982,局,83,396333,0.01344552,64.20365265
983,屆,83,396416,0.01344552,64.21709817
984,展開,83,396499,0.01344552,64.23054368
985,責任,83,396582,0.01344552,64.24398920
986,喝,83,396665,0.01344552,64.25743472
987,新聞,83,396748,0.01344552,64.27088024
988,電子,83,396831,0.01344552,64.28432576
989,態度,83,396914,0.01344552,64.29777128
990,說明,83,396997,0.01344552,64.31121680
991,增,83,397080,0.01344552,64.32466232
992,下來,82,397162,0.01328353,64.33794585
993,公尺,82,397244,0.01328353,64.35122937
994,文,82,397326,0.01328353,64.36451290
995,印象,82,397408,0.01328353,64.37779643
996,困難,82,397490,0.01328353,64.39107995
997,亞洲,82,397572,0.01328353,64.40436348
998,姓,82,397654,0.01328353,64.41764700
999,按,82,397736,0.01328353,64.43093053
1000,重點,82,397818,0.01328353,64.44421405
1001,原則,82,397900,0.01328353,64.45749758
1002,累積,82,397982,0.01328353,64.47078110
1003,通過,82,398064,0.01328353,64.48406463
1004,富,82,398146,0.01328353,64.49734815
1005,業,82,398228,0.01328353,64.51063168
1006,緊張,82,398310,0.01328353,64.52391521
1007,辦,82,398392,0.01328353,64.53719873
1008,顆,82,398474,0.01328353,64.55048226
1009,不必,81,398555,0.01312153,64.56360379
1010,作用,81,398636,0.01312153,64.57672532
1011,投入,81,398717,0.01312153,64.58984685
1012,拍攝,81,398798,0.01312153,64.60296838
1013,易,81,398879,0.01312153,64.61608991
1014,效率,81,398960,0.01312153,64.62921144
1015,財,81,399041,0.01312153,64.64233298
1016,基礎,81,399122,0.01312153,64.65545451
1017,從事,81,399203,0.01312153,64.66857604
1018,設定,81,399284,0.01312153,64.68169757
1019,業績,81,399365,0.01312153,64.69481910
1020,大幅,80,399445,0.01295954,64.70777864
1021,不論,80,399525,0.01295954,64.72073818
1022,必要,80,399605,0.01295954,64.73369771
1023,空,80,399685,0.01295954,64.74665725
1024,金額,80,399765,0.01295954,64.75961679
1025,恢復,80,399845,0.01295954,64.77257632
1026,差,80,399925,0.01295954,64.78553586
1027,特色,80,400005,0.01295954,64.79849540
1028,財務,80,400085,0.01295954,64.81145493
1029,票,80,400165,0.01295954,64.82441447
1030,等等,80,400245,0.01295954,64.83737401
1031,實施,80,400325,0.01295954,64.85033355
1032,德國,80,400405,0.01295954,64.86329308
1033,人生,79,400484,0.01279754,64.87609063
1034,形式,79,400563,0.01279754,64.88888817
1035,前往,79,400642,0.01279754,64.90168571
1036,故,79,400721,0.01279754,64.91448325
1037,教,79,400800,0.01279754,64.92728080
1038,筆,79,400879,0.01279754,64.94007834
1039,澳洲,79,400958,0.01279754,64.95287588
1040,題材,79,401037,0.01279754,64.96567343
1041,歡迎,79,401116,0.01279754,64.97847097
1042,全部,78,401194,0.01263555,64.99110652
1043,供,78,401272,0.01263555,65.00374207
1044,面臨,78,401350,0.01263555,65.01637761
1045,動物,78,401428,0.01263555,65.02901316
1046,參考,78,401506,0.01263555,65.04164871
1047,接觸,78,401584,0.01263555,65.05428426
1048,期貨,78,401662,0.01263555,65.06691981
1049,預期,78,401740,0.01263555,65.07955536
1050,機,78,401818,0.01263555,65.09219091
1051,總是,78,401896,0.01263555,65.10482646
1052,顧客,78,401974,0.01263555,65.11746200
1053,之間,77,402051,0.01247355,65.12993556
1054,反,77,402128,0.01247355,65.14240911
1055,作法,77,402205,0.01247355,65.15488267
1056,到底,77,402282,0.01247355,65.16735622
1057,距離,77,402359,0.01247355,65.17982978
1058,輛,77,402436,0.01247355,65.19230333
1059,營運,77,402513,0.01247355,65.20477689
1060,顏色,77,402590,0.01247355,65.21725044
1061,鏡頭,77,402667,0.01247355,65.22972399
1062,上漲,76,402743,0.01231156,65.24203555
1063,不知,76,402819,0.01231156,65.25434711
1064,心理,76,402895,0.01231156,65.26665867
1065,比例,76,402971,0.01231156,65.27897024
1066,句,76,403047,0.01231156,65.29128180
1067,打開,76,403123,0.01231156,65.30359336
1068,好像,76,403199,0.01231156,65.31590492
1069,完整,76,403275,0.01231156,65.32821648
1070,男性,76,403351,0.01231156,65.34052804
1071,背景,76,403427,0.01231156,65.35283960
1072,消費,76,403503,0.01231156,65.36515116
1073,掉,76,403579,0.01231156,65.37746272
1074,連戰,76,403655,0.01231156,65.38977428
1075,結構,76,403731,0.01231156,65.40208584
1076,預計,76,403807,0.01231156,65.41439740
1077,山,75,403882,0.01214957,65.42654696
1078,民間,75,403957,0.01214957,65.43869653
1079,立即,75,404032,0.01214957,65.45084610
1080,她們,75,404107,0.01214957,65.46299566
1081,即將,75,404182,0.01214957,65.47514523
1082,協助,75,404257,0.01214957,65.48729479
1083,缺乏,75,404332,0.01214957,65.49944436
1084,統一,75,404407,0.01214957,65.51159393
1085,硬碟,75,404482,0.01214957,65.52374349
1086,網際網路,75,404557,0.01214957,65.53589306
1087,餐廳,75,404632,0.01214957,65.54804262
1088,擴大,75,404707,0.01214957,65.56019219
1089,顯,75,404782,0.01214957,65.57234176
1090,顯然,75,404857,0.01214957,65.58449132
1091,它們,74,404931,0.01198757,65.59647889
1092,成績,74,405005,0.01198757,65.60846647
1093,有效,74,405079,0.01198757,65.62045404
1094,投,74,405153,0.01198757,65.63244161
1095,展現,74,405227,0.01198757,65.64442918
1096,疾病,74,405301,0.01198757,65.65641675
1097,設,74,405375,0.01198757,65.66840432
1098,順利,74,405449,0.01198757,65.68039190
1099,應用,74,405523,0.01198757,65.69237947
1100,太太,73,405596,0.01182558,65.70420505
1101,日前,73,405669,0.01182558,65.71603062
1102,牠們,73,405742,0.01182558,65.72785620
1103,建築,73,405815,0.01182558,65.73968178
1104,兼,73,405888,0.01182558,65.75150736
1105,旁,73,405961,0.01182558,65.76333293
1106,掌握,73,406034,0.01182558,65.77515851
1107,發表,73,406107,0.01182558,65.78698409
1108,意見,73,406180,0.01182558,65.79880967
1109,認識,73,406253,0.01182558,65.81063524
1110,臉,73,406326,0.01182558,65.82246082
1111,不知道,72,406398,0.01166358,65.83412441
1112,成員,72,406470,0.01166358,65.84578799
1113,甚,72,406542,0.01166358,65.85745157
1114,啊,72,406614,0.01166358,65.86911516
1115,常常,72,406686,0.01166358,65.88077874
1116,晚上,72,406758,0.01166358,65.89244232
1117,這是,72,406830,0.01166358,65.90410591
1118,陸續,72,406902,0.01166358,65.91576949
1119,無論,72,406974,0.01166358,65.92743307
1120,集中,72,407046,0.01166358,65.93909666
1121,裝,72,407118,0.01166358,65.95076024
1122,範圍,72,407190,0.01166358,65.96242382
1123,讀,72,407262,0.01166358,65.97408741
1124,工業,71,407333,0.01150159,65.98558899
1125,似,71,407404,0.01150159,65.99709058
1126,兒子,71,407475,0.01150159,66.00859217
1127,法國,71,407546,0.01150159,66.02009376
1128,思考,71,407617,0.01150159,66.03159535
1129,挑戰,71,407688,0.01150159,66.04309694
1130,強烈,71,407759,0.01150159,66.05459853
1131,情感,71,407830,0.01150159,66.06610012
1132,竟,71,407901,0.01150159,66.07760171
1133,短,71,407972,0.01150159,66.08910330
1134,幫,71,408043,0.01150159,66.10060489
1135,藝術家,71,408114,0.01150159,66.11210648
1136,贏,71,408185,0.01150159,66.12360806
1137,變成,71,408256,0.01150159,66.13510965
1138,大眾,70,408326,0.01133959,66.14644925
1139,台中市,70,408396,0.01133959,66.15778884
1140,佔,70,408466,0.01133959,66.16912844
1141,城市,70,408536,0.01133959,66.18046803
1142,症狀,70,408606,0.01133959,66.19180763
1143,報紙,70,408676,0.01133959,66.20314722
1144,碰,70,408746,0.01133959,66.21448682
1145,艘,70,408816,0.01133959,66.22582641
1146,立刻,69,408885,0.01117760,66.23700401
1147,如今,69,408954,0.01117760,66.24818161
1148,位置,69,409023,0.01117760,66.25935922
1149,免,69,409092,0.01117760,66.27053682
1150,形象,69,409161,0.01117760,66.28171442
1151,哪,69,409230,0.01117760,66.29289202
1152,差異,69,409299,0.01117760,66.30406962
1153,海,69,409368,0.01117760,66.31524722
1154,排,69,409437,0.01117760,66.32642482
1155,進口,69,409506,0.01117760,66.33760242
1156,進步,69,409575,0.01117760,66.34878002
1157,溝通,69,409644,0.01117760,66.35995762
1158,確實,69,409713,0.01117760,66.37113522
1159,千,68,409781,0.01101561,66.38215083
1160,子,68,409849,0.01101561,66.39316644
1161,才能,68,409917,0.01101561,66.40418204
1162,中央,68,409985,0.01101561,66.41519765
1163,民主,68,410053,0.01101561,66.42621326
1164,交,68,410121,0.01101561,66.43722886
1165,全球,68,410189,0.01101561,66.44824447
1166,看法,68,410257,0.01101561,66.45926008
1167,重大,68,410325,0.01101561,66.47027568
1168,酒,68,410393,0.01101561,66.48129129
1169,答,68,410461,0.01101561,66.49230689
1170,超,68,410529,0.01101561,66.50332250
1171,項目,68,410597,0.01101561,66.51433811
1172,搭配,68,410665,0.01101561,66.52535371
1173,遇,68,410733,0.01101561,66.53636932
1174,團體,68,410801,0.01101561,66.54738493
1175,對方,68,410869,0.01101561,66.55840053
1176,說法,68,410937,0.01101561,66.56941614
1177,舊,68,411005,0.01101561,66.58043175
1178,不好,67,411072,0.01085361,66.59128536
1179,不如,67,411139,0.01085361,66.60213897
1180,不夠,67,411206,0.01085361,66.61299258
1181,今日,67,411273,0.01085361,66.62384620
1182,少數,67,411340,0.01085361,66.63469981
1183,回答,67,411407,0.01085361,66.64555342
1184,林,67,411474,0.01085361,66.65640703
1185,個性,67,411541,0.01085361,66.66726065
1186,腳,67,411608,0.01085361,66.67811426
1187,董事長,67,411675,0.01085361,66.68896787
1188,獨,67,411742,0.01085361,66.69982148
1189,願意,67,411809,0.01085361,66.71067509
1190,大約,66,411875,0.01069162,66.72136671
1191,小組,66,411941,0.01069162,66.73205833
1192,來自,66,412007,0.01069162,66.74274995
1193,金,66,412073,0.01069162,66.75344157
1194,消息,66,412139,0.01069162,66.76413319
1195,財政部,66,412205,0.01069162,66.77482480
1196,國代,66,412271,0.01069162,66.78551642
1197,想像,66,412337,0.01069162,66.79620804
1198,損失,66,412403,0.01069162,66.80689966
1199,遊客,66,412469,0.01069162,66.81759128
1200,儘管,66,412535,0.01069162,66.82828289
1201,一點,65,412600,0.01052962,66.83881252
1202,中國大陸,65,412665,0.01052962,66.84934214
1203,予,65,412730,0.01052962,66.85987177
1204,民族,65,412795,0.01052962,66.87040139
1205,白,65,412860,0.01052962,66.88093101
1206,攻擊,65,412925,0.01052962,66.89146064
1207,足,65,412990,0.01052962,66.90199026
1208,怕,65,413055,0.01052962,66.91251988
1209,信心,65,413120,0.01052962,66.92304951
1210,首先,65,413185,0.01052962,66.93357913
1211,患者,65,413250,0.01052962,66.94410876
1212,普遍,65,413315,0.01052962,66.95463838
1213,費用,65,413380,0.01052962,66.96516800
1214,集團,65,413445,0.01052962,66.97569763
1215,演習,65,413510,0.01052962,66.98622725
1216,滿足,65,413575,0.01052962,66.99675688
1217,舞台,65,413640,0.01052962,67.00728650
1218,辦理,65,413705,0.01052962,67.01781612
1219,引進,64,413769,0.01036763,67.02818375
1220,心情,64,413833,0.01036763,67.03855138
1221,以往,64,413897,0.01036763,67.04891901
1222,外國,64,413961,0.01036763,67.05928664
1223,回來,64,414025,0.01036763,67.06965427
1224,刺激,64,414089,0.01036763,67.08002190
1225,武器,64,414153,0.01036763,67.09038953
1226,時期,64,414217,0.01036763,67.10075716
1227,財富,64,414281,0.01036763,67.11112479
1228,國外,64,414345,0.01036763,67.12149242
1229,理財,64,414409,0.01036763,67.13186005
1230,統計,64,414473,0.01036763,67.14222768
1231,演,64,414537,0.01036763,67.15259531
1232,線,64,414601,0.01036763,67.16296294
1233,辦公室,64,414665,0.01036763,67.17333057
1234,優勢,64,414729,0.01036763,67.18369820
1235,懂,64,414793,0.01036763,67.19406583
1236,人口,63,414856,0.01020564,67.20427146
1237,公里,63,414919,0.01020564,67.21447710
1238,卡,63,414982,0.01020564,67.22468273
1239,外資,63,415045,0.01020564,67.23488837
1240,同意,63,415108,0.01020564,67.24509401
1241,作者,63,415171,0.01020564,67.25529964
1242,形,63,415234,0.01020564,67.26550528
1243,爭,63,415297,0.01020564,67.27571091
1244,促銷,63,415360,0.01020564,67.28591655
1245,看起來,63,415423,0.01020564,67.29612218
1246,突然,63,415486,0.01020564,67.30632782
1247,旅遊,63,415549,0.01020564,67.31653345
1248,婦女,63,415612,0.01020564,67.32673909
1249,教授,63,415675,0.01020564,67.33694472
1250,教練,63,415738,0.01020564,67.34715036
1251,飯店,63,415801,0.01020564,67.35735600
1252,對象,63,415864,0.01020564,67.36756163
1253,諸,63,415927,0.01020564,67.37776727
1254,學者,63,415990,0.01020564,67.38797290
1255,大小,62,416052,0.01004364,67.39801654
1256,文字,62,416114,0.01004364,67.40806018
1257,日子,62,416176,0.01004364,67.41810383
1258,合,62,416238,0.01004364,67.42814747
1259,估計,62,416300,0.01004364,67.43819111
1260,男人,62,416362,0.01004364,67.44823475
1261,坪,62,416424,0.01004364,67.45827839
1262,表,62,416486,0.01004364,67.46832203
1263,南,62,416548,0.01004364,67.47836567
1264,氣氛,62,416610,0.01004364,67.48840931
1265,院長,62,416672,0.01004364,67.49845296
1266,意識,62,416734,0.01004364,67.50849660
1267,漲,62,416796,0.01004364,67.51854024
1268,領,62,416858,0.01004364,67.52858388
1269,篇,62,416920,0.01004364,67.53862752
1270,藥物,62,416982,0.01004364,67.54867116
1271,公斤,61,417043,0.00988165,67.55855281
1272,合理,61,417104,0.00988165,67.56843446
1273,曲,61,417165,0.00988165,67.57831610
1274,投手,61,417226,0.00988165,67.58819775
1275,垃圾,61,417287,0.00988165,67.59807940
1276,店,61,417348,0.00988165,67.60796104
1277,彼此,61,417409,0.00988165,67.61784269
1278,昨日,61,417470,0.00988165,67.62772434
1279,家人,61,417531,0.00988165,67.63760598
1280,接近,61,417592,0.00988165,67.64748763
1281,採取,61,417653,0.00988165,67.65736928
1282,期待,61,417714,0.00988165,67.66725093
1283,貸款,61,417775,0.00988165,67.67713257
1284,編,61,417836,0.00988165,67.68701422
1285,興建,61,417897,0.00988165,67.69689587
1286,邀請,61,417958,0.00988165,67.70677751
1287,大學,60,418018,0.00971965,67.71649717
1288,方便,60,418078,0.00971965,67.72621682
1289,以免,60,418138,0.00971965,67.73593647
1290,出版,60,418198,0.00971965,67.74565613
1291,忙,60,418258,0.00971965,67.75537578
1292,扮演,60,418318,0.00971965,67.76509543
1293,材料,60,418378,0.00971965,67.77481508
1294,良好,60,418438,0.00971965,67.78453474
1295,例子,60,418498,0.00971965,67.79425439
1296,居民,60,418558,0.00971965,67.80397404
1297,幸福,60,418618,0.00971965,67.81369369
1298,明星,60,418678,0.00971965,67.82341335
1299,空氣,60,418738,0.00971965,67.83313300
1300,便宜,60,418798,0.00971965,67.84285265
1301,秒,60,418858,0.00971965,67.85257231
1302,突破,60,418918,0.00971965,67.86229196
1303,面積,60,418978,0.00971965,67.87201161
1304,氣,60,419038,0.00971965,67.88173126
1305,笑,60,419098,0.00971965,67.89145092
1306,售價,60,419158,0.00971965,67.90117057
1307,許,60,419218,0.00971965,67.91089022
1308,照顧,60,419278,0.00971965,67.92060988
1309,實現,60,419338,0.00971965,67.93032953
1310,漸,60,419398,0.00971965,67.94004918
1311,檔案,60,419458,0.00971965,67.94976883
1312,關心,60,419518,0.00971965,67.95948849
1313,鱷魚,60,419578,0.00971965,67.96920814
1314,乃,59,419637,0.00955766,67.97876580
1315,世紀,59,419696,0.00955766,67.98832346
1316,光,59,419755,0.00955766,67.99788112
1317,存,59,419814,0.00955766,68.00743877
1318,考量,59,419873,0.00955766,68.01699643
1319,而是,59,419932,0.00955766,68.02655409
1320,男,59,419991,0.00955766,68.03611175
1321,欣賞,59,420050,0.00955766,68.04566941
1322,是不是,59,420109,0.00955766,68.05522707
1323,活,59,420168,0.00955766,68.06478473
1324,紀錄,59,420227,0.00955766,68.07434238
1325,破壞,59,420286,0.00955766,68.08390004
1326,堅持,59,420345,0.00955766,68.09345770
1327,造型,59,420404,0.00955766,68.10301536
1328,報名,59,420463,0.00955766,68.11257302
1329,報酬率,59,420522,0.00955766,68.12213068
1330,替,59,420581,0.00955766,68.13168834
1331,測試,59,420640,0.00955766,68.14124599
1332,媽媽,59,420699,0.00955766,68.15080365
1333,新台幣,59,420758,0.00955766,68.16036131
1334,當年,59,420817,0.00955766,68.16991897
1335,當初,59,420876,0.00955766,68.17947663
1336,解釋,59,420935,0.00955766,68.18903429
1337,電,59,420994,0.00955766,68.19859195
1338,趕,59,421053,0.00955766,68.20814960
1339,營收,59,421112,0.00955766,68.21770726
1340,下去,58,421170,0.00939566,68.22710293
1341,公開,58,421228,0.00939566,68.23649859
1342,北,58,421286,0.00939566,68.24589426
1343,安裝,58,421344,0.00939566,68.25528992
1344,快樂,58,421402,0.00939566,68.26468559
1345,周,58,421460,0.00939566,68.27408125
1346,美人兒,58,421518,0.00939566,68.28347691
1347,飛,58,421576,0.00939566,68.29287258
1348,紐約,58,421634,0.00939566,68.30226824
1349,高級,58,421692,0.00939566,68.31166391
1350,這個,58,421750,0.00939566,68.32105957
1351,跳,58,421808,0.00939566,68.33045524
1352,雙,58,421866,0.00939566,68.33985090
1353,不只,57,421923,0.00923367,68.34908457
1354,比方,57,421980,0.00923367,68.35831824
1355,令人,57,422037,0.00923367,68.36755191
1356,出口,57,422094,0.00923367,68.37678558
1357,市長,57,422151,0.00923367,68.38601925
1358,打擊,57,422208,0.00923367,68.39525292
1359,皮膚,57,422265,0.00923367,68.40448659
1360,休閒,57,422322,0.00923367,68.41372026
1361,肌膚,57,422379,0.00923367,68.42295393
1362,色,57,422436,0.00923367,68.43218760
1363,行業,57,422493,0.00923367,68.44142127
1364,事實上,57,422550,0.00923367,68.45065494
1365,波,57,422607,0.00923367,68.45988861
1366,玩家,57,422664,0.00923367,68.46912228
1367,表面,57,422721,0.00923367,68.47835595
1368,卻是,57,422778,0.00923367,68.48758962
1369,恐怕,57,422835,0.00923367,68.49682329
1370,商業,57,422892,0.00923367,68.50605696
1371,通,57,422949,0.00923367,68.51529063
1372,創,57,423006,0.00923367,68.52452430
1373,創意,57,423063,0.00923367,68.53375797
1374,尋找,57,423120,0.00923367,68.54299164
1375,傷害,57,423177,0.00923367,68.55222531
1376,運作,57,423234,0.00923367,68.56145898
1377,鼓勵,57,423291,0.00923367,68.57069265
1378,樂團,57,423348,0.00923367,68.57992633
1379,獎,57,423405,0.00923367,68.58916000
1380,獨立,57,423462,0.00923367,68.59839367
1381,賺錢,57,423519,0.00923367,68.60762734
1382,屬於,57,423576,0.00923367,68.61686101
1383,體,57,423633,0.00923367,68.62609468
1384,下跌,56,423689,0.00907168,68.63516635
1385,不妨,56,423745,0.00907168,68.64423803
1386,外界,56,423801,0.00907168,68.65330970
1387,休息,56,423857,0.00907168,68.66238138
1388,任務,56,423913,0.00907168,68.67145306
1389,年代,56,423969,0.00907168,68.68052473
1390,其它,56,424025,0.00907168,68.68959641
1391,拉,56,424081,0.00907168,68.69866808
1392,物件,56,424137,0.00907168,68.70773976
1393,知名,56,424193,0.00907168,68.71681144
1394,國人,56,424249,0.00907168,68.72588311
1395,夠,56,424305,0.00907168,68.73495479
1396,欲,56,424361,0.00907168,68.74402646
1397,終,56,424417,0.00907168,68.75309814
1398,著名,56,424473,0.00907168,68.76216982
1399,業界,56,424529,0.00907168,68.77124149
1400,照,56,424585,0.00907168,68.78031317
1401,經理,56,424641,0.00907168,68.78938484
1402,試,56,424697,0.00907168,68.79845652
1403,隔,56,424753,0.00907168,68.80752820
1404,輕,56,424809,0.00907168,68.81659987
1405,際,56,424865,0.00907168,68.82567155
1406,編輯,56,424921,0.00907168,68.83474322
1407,擁,56,424977,0.00907168,68.84381490
1408,選手,56,425033,0.00907168,68.85288657
1409,錯誤,56,425089,0.00907168,68.86195825
1410,黨團,56,425145,0.00907168,68.87102993
1411,引擎,55,425200,0.00890968,68.87993961
1412,技巧,55,425255,0.00890968,68.88884929
1413,型態,55,425310,0.00890968,68.89775897
1414,病,55,425365,0.00890968,68.90666865
1415,紛紛,55,425420,0.00890968,68.91557834
1416,球迷,55,425475,0.00890968,68.92448802
1417,理論,55,425530,0.00890968,68.93339770
1418,產,55,425585,0.00890968,68.94230738
1419,船,55,425640,0.00890968,68.95121706
1420,短期,55,425695,0.00890968,68.96012674
1421,想法,55,425750,0.00890968,68.96903643
1422,實,55,425805,0.00890968,68.97794611
1423,對手,55,425860,0.00890968,68.98685579
1424,輕鬆,55,425915,0.00890968,68.99576547
1425,人體,54,425969,0.00874769,69.00451316
1426,升,54,426023,0.00874769,69.01326085
1427,可望,54,426077,0.00874769,69.02200853
1428,而已,54,426131,0.00874769,69.03075622
1429,判斷,54,426185,0.00874769,69.03950391
1430,限,54,426239,0.00874769,69.04825160
1431,食用,54,426293,0.00874769,69.05699928
1432,借,54,426347,0.00874769,69.06574697
1433,設置,54,426401,0.00874769,69.07449466
1434,連線,54,426455,0.00874769,69.08324235
1435,評估,54,426509,0.00874769,69.09199003
1436,跌,54,426563,0.00874769,69.10073772
1437,預測,54,426617,0.00874769,69.10948541
1438,夢想,54,426671,0.00874769,69.11823310
1439,領導,54,426725,0.00874769,69.12698078
1440,數字,54,426779,0.00874769,69.13572847
1441,調降,54,426833,0.00874769,69.14447616
1442,適當,54,426887,0.00874769,69.15322385
1443,謝,54,426941,0.00874769,69.16197153
1444,證明,54,426995,0.00874769,69.17071922
1445,人才,53,427048,0.00858569,69.17930492
1446,上述,53,427101,0.00858569,69.18789061
1447,大師,53,427154,0.00858569,69.19647630
1448,大概,53,427207,0.00858569,69.20506200
1449,心態,53,427260,0.00858569,69.21364769
1450,手法,53,427313,0.00858569,69.22223338
1451,全面,53,427366,0.00858569,69.23081908
1452,血,53,427419,0.00858569,69.23940477
1453,利益,53,427472,0.00858569,69.24799046
1454,男孩,53,427525,0.00858569,69.25657616
1455,指示,53,427578,0.00858569,69.26516185
1456,美麗,53,427631,0.00858569,69.27374754
1457,飛機,53,427684,0.00858569,69.28233324
1458,深入,53,427737,0.00858569,69.29091893
1459,理由,53,427790,0.00858569,69.29950462
1460,設立,53,427843,0.00858569,69.30809032
1461,單,53,427896,0.00858569,69.31667601
1462,焦點,53,427949,0.00858569,69.32526170
1463,嫌,53,428002,0.00858569,69.33384739
1464,種種,53,428055,0.00858569,69.34243309
1465,製,53,428108,0.00858569,69.35101878
1466,螢幕,53,428161,0.00858569,69.35960447
1467,營養,53,428214,0.00858569,69.36819017
1468,一生,52,428266,0.00842370,69.37661387
1469,不敢,52,428318,0.00842370,69.38503757
1470,必,52,428370,0.00842370,69.39346127
1471,本來,52,428422,0.00842370,69.40188496
1472,年齡,52,428474,0.00842370,69.41030866
1473,收入,52,428526,0.00842370,69.41873236
1474,江澤民,52,428578,0.00842370,69.42715606
1475,色彩,52,428630,0.00842370,69.43557976
1476,兒童,52,428682,0.00842370,69.44400346
1477,具備,52,428734,0.00842370,69.45242716
1478,東,52,428786,0.00842370,69.46085086
1479,法律,52,428838,0.00842370,69.46927456
1480,保障,52,428890,0.00842370,69.47769826
1481,架構,52,428942,0.00842370,69.48612196
1482,夏天,52,428994,0.00842370,69.49454565
1483,基,52,429046,0.00842370,69.50296935
1484,培養,52,429098,0.00842370,69.51139305
1485,透露,52,429150,0.00842370,69.51981675
1486,幅,52,429202,0.00842370,69.52824045
1487,愛情,52,429254,0.00842370,69.53666415
1488,數量,52,429306,0.00842370,69.54508785
1489,熱,52,429358,0.00842370,69.55351155
1490,魅力,52,429410,0.00842370,69.56193525
1491,營業,52,429462,0.00842370,69.57035895
1492,土,51,429513,0.00826170,69.57862065
1493,之外,51,429564,0.00826170,69.58688236
1494,手術,51,429615,0.00826170,69.59514406
1495,主席,51,429666,0.00826170,69.60340577
1496,主動,51,429717,0.00826170,69.61166747
1497,古,51,429768,0.00826170,69.61992918
1498,只有,51,429819,0.00826170,69.62819088
1499,同學,51,429870,0.00826170,69.63645259
1500,有時,51,429921,0.00826170,69.64471429
1501,有趣,51,429972,0.00826170,69.65297600
1502,依據,51,430023,0.00826170,69.66123770
1503,居住,51,430074,0.00826170,69.66949941
1504,益,51,430125,0.00826170,69.67776111
1505,配,51,430176,0.00826170,69.68602282
1506,假,51,430227,0.00826170,69.69428452
1507,參觀,51,430278,0.00826170,69.70254623
1508,採購,51,430329,0.00826170,69.71080793
1509,深刻,51,430380,0.00826170,69.71906963
1510,這種,51,430431,0.00826170,69.72733134
1511,提醒,51,430482,0.00826170,69.73559304
1512,給予,51,430533,0.00826170,69.74385475
1513,意外,51,430584,0.00826170,69.75211645
1514,意思,51,430635,0.00826170,69.76037816
1515,會員,51,430686,0.00826170,69.76863986
1516,機器,51,430737,0.00826170,69.77690157
1517,錄音,51,430788,0.00826170,69.78516327
1518,壞,51,430839,0.00826170,69.79342498
1519,競選,51,430890,0.00826170,69.80168668
1520,才是,50,430940,0.00809971,69.80978639
1521,兄弟,50,430990,0.00809971,69.81788611
1522,市民,50,431040,0.00809971,69.82598582
1523,打算,50,431090,0.00809971,69.83408553
1524,名字,50,431140,0.00809971,69.84218524
1525,西元,50,431190,0.00809971,69.85028495
1526,批,50,431240,0.00809971,69.85838466
1527,更是,50,431290,0.00809971,69.86648437
1528,固定,50,431340,0.00809971,69.87458408
1529,房間,50,431390,0.00809971,69.88268379
1530,爭議,50,431440,0.00809971,69.89078350
1531,知識,50,431490,0.00809971,69.89888321
1532,信,50,431540,0.00809971,69.90698292
1533,宣布,50,431590,0.00809971,69.91508263
1534,昨,50,431640,0.00809971,69.92318234
1535,研發,50,431690,0.00809971,69.93128205
1536,紅,50,431740,0.00809971,69.93938177
1537,軍事,50,431790,0.00809971,69.94748148
1538,飛彈,50,431840,0.00809971,69.95558119
1539,浪漫,50,431890,0.00809971,69.96368090
1540,海軍,50,431940,0.00809971,69.97178061
1541,配備,50,431990,0.00809971,69.97988032
1542,高度,50,432040,0.00809971,69.98798003
1543,唱片,50,432090,0.00809971,69.99607974
1544,推薦,50,432140,0.00809971,70.00417945
1545,毫,50,432190,0.00809971,70.01227916
1546,朝,50,432240,0.00809971,70.02037887
1547,稍,50,432290,0.00809971,70.02847858
1548,蓋,50,432340,0.00809971,70.03657829
1549,劇,50,432390,0.00809971,70.04467800
1550,離,50,432440,0.00809971,70.05277771
1551,嚴格,50,432490,0.00809971,70.06087743
1552,體重,50,432540,0.00809971,70.06897714
1553,不滿,49,432589,0.00793772,70.07691485
1554,不願,49,432638,0.00793772,70.08485257
1555,公園,49,432687,0.00793772,70.09279029
1556,升級,49,432736,0.00793772,70.10072800
1557,引發,49,432785,0.00793772,70.10866572
1558,主任,49,432834,0.00793772,70.11660343
1559,以為,49,432883,0.00793772,70.12454115
1560,付,49,432932,0.00793772,70.13247887
1561,出生,49,432981,0.00793772,70.14041658
1562,台南,49,433030,0.00793772,70.14835430
1563,失敗,49,433079,0.00793772,70.15629202
1564,肌肉,49,433128,0.00793772,70.16422973
1565,忘,49,433177,0.00793772,70.17216745
1566,社區,49,433226,0.00793772,70.18010517
1567,流,49,433275,0.00793772,70.18804288
1568,界,49,433324,0.00793772,70.19598060
1569,風,49,433373,0.00793772,70.20391832
1570,修改,49,433422,0.00793772,70.21185603
1571,效,49,433471,0.00793772,70.21979375
1572,特質,49,433520,0.00793772,70.22773147
1573,區域,49,433569,0.00793772,70.23566918
1574,唱,49,433618,0.00793772,70.24360690
1575,敗,49,433667,0.00793772,70.25154461
1576,陳,49,433716,0.00793772,70.25948233
1577,痛苦,49,433765,0.00793772,70.26742005
1578,傳,49,433814,0.00793772,70.27535776
1579,達成,49,433863,0.00793772,70.28329548
1580,劇場,49,433912,0.00793772,70.29123320
1581,熟悉,49,433961,0.00793772,70.29917091
1582,龐大,49,434010,0.00793772,70.30710863
1583,體會,49,434059,0.00793772,70.31504635
1584,不用,48,434107,0.00777572,70.32282207
1585,不易,48,434155,0.00777572,70.33059779
1586,分散,48,434203,0.00777572,70.33837351
1587,化,48,434251,0.00777572,70.34614924
1588,文件,48,434299,0.00777572,70.35392496
1589,主角,48,434347,0.00777572,70.36170068
1590,以色列,48,434395,0.00777572,70.36947640
1591,包含,48,434443,0.00777572,70.37725212
1592,平常,48,434491,0.00777572,70.38502785
1593,合約,48,434539,0.00777572,70.39280357
1594,老虎,48,434587,0.00777572,70.40057929
1595,至今,48,434635,0.00777572,70.40835501
1596,衣服,48,434683,0.00777572,70.41613074
1597,車款,48,434731,0.00777572,70.42390646
1598,依然,48,434779,0.00777572,70.43168218
1599,供應,48,434827,0.00777572,70.43945790
1600,具體,48,434875,0.00777572,70.44723362
1601,委託,48,434923,0.00777572,70.45500935
1602,放棄,48,434971,0.00777572,70.46278507
1603,杯,48,435019,0.00777572,70.47056079
1604,爭取,48,435067,0.00777572,70.47833651
1605,洋將,48,435115,0.00777572,70.48611224
1606,苦,48,435163,0.00777572,70.49388796
1607,計,48,435211,0.00777572,70.50166368
1608,負擔,48,435259,0.00777572,70.50943940
1609,記憶,48,435307,0.00777572,70.51721513
1610,族群,48,435355,0.00777572,70.52499085
1611,通訊,48,435403,0.00777572,70.53276657
1612,連續,48,435451,0.00777572,70.54054229
1613,慢慢,48,435499,0.00777572,70.54831801
1614,滿意,48,435547,0.00777572,70.55609374
1615,潛力,48,435595,0.00777572,70.56386946
1616,衝突,48,435643,0.00777572,70.57164518
1617,輸,48,435691,0.00777572,70.57942090
1618,醫生,48,435739,0.00777572,70.58719663
1619,一向,47,435786,0.00761373,70.59481035
1620,不到,47,435833,0.00761373,70.60242408
1621,不像,47,435880,0.00761373,70.61003781
1622,公,47,435927,0.00761373,70.61765154
1623,氏,47,435974,0.00761373,70.62526527
1624,召開,47,436021,0.00761373,70.63287899
1625,交流,47,436068,0.00761373,70.64049272
1626,成熟,47,436115,0.00761373,70.64810645
1627,行銷,47,436162,0.00761373,70.65572018
1628,改革,47,436209,0.00761373,70.66333391
1629,拒絕,47,436256,0.00761373,70.67094763
1630,屋,47,436303,0.00761373,70.67856136
1631,指導,47,436350,0.00761373,70.68617509
1632,派,47,436397,0.00761373,70.69378882
1633,看看,47,436444,0.00761373,70.70140255
1634,旅館,47,436491,0.00761373,70.70901627
1635,班,47,436538,0.00761373,70.71663000
1636,高雄市,47,436585,0.00761373,70.72424373
1637,黑道,47,436632,0.00761373,70.73185746
1638,感謝,47,436679,0.00761373,70.73947119
1639,預定,47,436726,0.00761373,70.74708491
1640,練習,47,436773,0.00761373,70.75469864
1641,複雜,47,436820,0.00761373,70.76231237
1642,獨特,47,436867,0.00761373,70.76992610
1643,懷疑,47,436914,0.00761373,70.77753983
1644,繼,47,436961,0.00761373,70.78515355
1645,譬如,47,437008,0.00761373,70.79276728
1646,人事,46,437054,0.00745173,70.80021902
1647,不久,46,437100,0.00745173,70.80767075
1648,互動,46,437146,0.00745173,70.81512248
1649,內心,46,437192,0.00745173,70.82257422
1650,心靈,46,437238,0.00745173,70.83002595
1651,充分,46,437284,0.00745173,70.83747769
1652,只好,46,437330,0.00745173,70.84492942
1653,失去,46,437376,0.00745173,70.85238115
1654,同事,46,437422,0.00745173,70.85983289
1655,希臘,46,437468,0.00745173,70.86728462
1656,性能,46,437514,0.00745173,70.87473635
1657,物,46,437560,0.00745173,70.88218809
1658,促進,46,437606,0.00745173,70.88963982
1659,指標,46,437652,0.00745173,70.89709156
1660,英文,46,437698,0.00745173,70.90454329
1661,候選人,46,437744,0.00745173,70.91199502
1662,容量,46,437790,0.00745173,70.91944676
1663,時機,46,437836,0.00745173,70.92689849
1664,真是,46,437882,0.00745173,70.93435023
1665,訊,46,437928,0.00745173,70.94180196
1666,將來,46,437974,0.00745173,70.94925369
1667,情,46,438020,0.00745173,70.95670543
1668,措施,46,438066,0.00745173,70.96415716
1669,晚,46,438112,0.00745173,70.97160889
1670,異常,46,438158,0.00745173,70.97906063
1671,植物,46,438204,0.00745173,70.98651236
1672,等於,46,438250,0.00745173,70.99396410
1673,過敏,46,438296,0.00745173,71.00141583
1674,預防,46,438342,0.00745173,71.00886756
1675,領域,46,438388,0.00745173,71.01631930
1676,樂,46,438434,0.00745173,71.02377103
1677,虧損,46,438480,0.00745173,71.03122276
1678,轉變,46,438526,0.00745173,71.03867450
1679,觀,46,438572,0.00745173,71.04612623
1680,大多,45,438617,0.00728974,71.05341597
1681,工廠,45,438662,0.00728974,71.06070571
1682,引,45,438707,0.00728974,71.06799545
1683,主機板,45,438752,0.00728974,71.07528519
1684,北京,45,438797,0.00728974,71.08257493
1685,占,45,438842,0.00728974,71.08986467
1686,外銷,45,438887,0.00728974,71.09715441
1687,立場,45,438932,0.00728974,71.10444415
1688,危險,45,438977,0.00728974,71.11173389
1689,有沒有,45,439022,0.00728974,71.11902363
1690,污染,45,439067,0.00728974,71.12631337
1691,自行,45,439112,0.00728974,71.13360311
1692,免費,45,439157,0.00728974,71.14089285
1693,利潤,45,439202,0.00728974,71.14818259
1694,和平,45,439247,0.00728974,71.15547233
1695,信託,45,439292,0.00728974,71.16276207
1696,指揮,45,439337,0.00728974,71.17005181
1697,政黨,45,439382,0.00728974,71.17734155
1698,科學,45,439427,0.00728974,71.18463128
1699,赴,45,439472,0.00728974,71.19192102
1700,原料,45,439517,0.00728974,71.19921076
1701,桃園,45,439562,0.00728974,71.20650050
1702,海外,45,439607,0.00728974,71.21379024
1703,留下,45,439652,0.00728974,71.22107998
1704,財產,45,439697,0.00728974,71.22836972
1705,退休,45,439742,0.00728974,71.23565946
1706,乾淨,45,439787,0.00728974,71.24294920
1707,望,45,439832,0.00728974,71.25023894
1708,部位,45,439877,0.00728974,71.25752868
1709,提名,45,439922,0.00728974,71.26481842
1710,等待,45,439967,0.00728974,71.27210816
1711,黃,45,440012,0.00728974,71.27939790
1712,實力,45,440057,0.00728974,71.28668764
1713,種類,45,440102,0.00728974,71.29397738
1714,碼,45,440147,0.00728974,71.30126712
1715,整合,45,440192,0.00728974,71.30855686
1716,檢討,45,440237,0.00728974,71.31584660
1717,口紅,44,440281,0.00712775,71.32297434
1718,女兒,44,440325,0.00712775,71.33010209
1719,歹徒,44,440369,0.00712775,71.33722983
1720,仔細,44,440413,0.00712775,71.34435758
1721,可惜,44,440457,0.00712775,71.35148532
1722,成就,44,440501,0.00712775,71.35861307
1723,早期,44,440545,0.00712775,71.36574082
1724,行程,44,440589,0.00712775,71.37286856
1725,西方,44,440633,0.00712775,71.37999631
1726,究竟,44,440677,0.00712775,71.38712405
1727,宜,44,440721,0.00712775,71.39425180
1728,泡,44,440765,0.00712775,71.40137954
1729,股東,44,440809,0.00712775,71.40850729
1730,金錢,44,440853,0.00712775,71.41563503
1731,威脅,44,440897,0.00712775,71.42276278
1732,洗,44,440941,0.00712775,71.42989052
1733,根,44,440985,0.00712775,71.43701827
1734,神,44,441029,0.00712775,71.44414602
1735,起士,44,441073,0.00712775,71.45127376
1736,密切,44,441117,0.00712775,71.45840151
1737,專,44,441161,0.00712775,71.46552925
1738,移,44,441205,0.00712775,71.47265700
1739,許水德,44,441249,0.00712775,71.47978474
1740,竟然,44,441293,0.00712775,71.48691249
1741,描述,44,441337,0.00712775,71.49404023
1742,債券,44,441381,0.00712775,71.50116798
1743,概念,44,441425,0.00712775,71.50829572
1744,節,44,441469,0.00712775,71.51542347
1745,義大利,44,441513,0.00712775,71.52255121
1746,補,44,441557,0.00712775,71.52967896
1747,話題,44,441601,0.00712775,71.53680671
1748,資產,44,441645,0.00712775,71.54393445
1749,樂觀,44,441689,0.00712775,71.55106220
1750,衝擊,44,441733,0.00712775,71.55818994
1751,整理,44,441777,0.00712775,71.56531769
1752,機關,44,441821,0.00712775,71.57244543
1753,隨時,44,441865,0.00712775,71.57957318
1754,凡,43,441908,0.00696575,71.58653893
1755,反對,43,441951,0.00696575,71.59350468
1756,加速,43,441994,0.00696575,71.60047043
1757,立,43,442037,0.00696575,71.60743618
1758,印,43,442080,0.00696575,71.61440193
1759,好好,43,442123,0.00696575,71.62136768
1760,助,43,442166,0.00696575,71.62833344
1761,彷彿,43,442209,0.00696575,71.63529919
1762,足夠,43,442252,0.00696575,71.64226494
1763,東南亞,43,442295,0.00696575,71.64923069
1764,南非,43,442338,0.00696575,71.65619644
1765,建,43,442381,0.00696575,71.66316219
1766,相互,43,442424,0.00696575,71.67012794
1767,記錄,43,442467,0.00696575,71.67709369
1768,假如,43,442510,0.00696575,71.68405945
1769,現實,43,442553,0.00696575,71.69102520
1770,眼光,43,442596,0.00696575,71.69799095
1771,移動,43,442639,0.00696575,71.70495670
1772,稅,43,442682,0.00696575,71.71192245
1773,象徵,43,442725,0.00696575,71.71888820
1774,進一步,43,442768,0.00696575,71.72585395
1775,過度,43,442811,0.00696575,71.73281970
1776,綜合,43,442854,0.00696575,71.73978545
1777,認同,43,442897,0.00696575,71.74675121
1778,樂趣,43,442940,0.00696575,71.75371696
1779,熱門,43,442983,0.00696575,71.76068271
1780,機率,43,443026,0.00696575,71.76764846
1781,親自,43,443069,0.00696575,71.77461421
1782,環保,43,443112,0.00696575,71.78157996
1783,職業,43,443155,0.00696575,71.78854571
1784,寶寶,43,443198,0.00696575,71.79551146
1785,女孩,42,443240,0.00680376,71.80231522
1786,小心,42,443282,0.00680376,71.80911898
1787,小姐,42,443324,0.00680376,71.81592274
1788,之前,42,443366,0.00680376,71.82272649
1789,公分,42,443408,0.00680376,71.82953025
1790,戶,42,443450,0.00680376,71.83633401
1791,代理,42,443492,0.00680376,71.84313776
1792,目,42,443534,0.00680376,71.84994152
1793,年度,42,443576,0.00680376,71.85674528
1794,年紀,42,443618,0.00680376,71.86354903
1795,作為,42,443660,0.00680376,71.87035279
1796,吸收,42,443702,0.00680376,71.87715655
1797,抓,42,443744,0.00680376,71.88396030
1798,身上,42,443786,0.00680376,71.89076406
1799,取代,42,443828,0.00680376,71.89756782
1800,呼籲,42,443870,0.00680376,71.90437158
1801,尚未,42,443912,0.00680376,71.91117533
1802,油,42,443954,0.00680376,71.91797909
1803,初期,42,443996,0.00680376,71.92478285
1804,前後,42,444038,0.00680376,71.93158660
1805,星期,42,444080,0.00680376,71.93839036
1806,架,42,444122,0.00680376,71.94519412
1807,背,42,444164,0.00680376,71.95199787
1808,音響,42,444206,0.00680376,71.95880163
1809,頁,42,444248,0.00680376,71.96560539
1810,偵辦,42,444290,0.00680376,71.97240915
1811,帶動,42,444332,0.00680376,71.97921290
1812,推廣,42,444374,0.00680376,71.98601666
1813,略,42,444416,0.00680376,71.99282042
1814,畢業,42,444458,0.00680376,71.99962417
1815,組成,42,444500,0.00680376,72.00642793
1816,棒,42,444542,0.00680376,72.01323169
1817,買賣,42,444584,0.00680376,72.02003544
1818,飲食,42,444626,0.00680376,72.02683920
1819,意願,42,444668,0.00680376,72.03364296
1820,溫泉,42,444710,0.00680376,72.04044672
1821,當代,42,444752,0.00680376,72.04725047
1822,裝置,42,444794,0.00680376,72.05405423
1823,管道,42,444836,0.00680376,72.06085799
1824,衛生,42,444878,0.00680376,72.06766174
1825,機械,42,444920,0.00680376,72.07446550
1826,分享,41,444961,0.00664176,72.08110726
1827,分配,41,445002,0.00664176,72.08774903
1828,反映,41,445043,0.00664176,72.09439079
1829,右,41,445084,0.00664176,72.10103255
1830,因而,41,445125,0.00664176,72.10767431
1831,年輕人,41,445166,0.00664176,72.11431608
1832,成果,41,445207,0.00664176,72.12095784
1833,有限,41,445248,0.00664176,72.12759960
1834,宋楚瑜,41,445289,0.00664176,72.13424136
1835,決心,41,445330,0.00664176,72.14088313
1836,男子,41,445371,0.00664176,72.14752489
1837,身分,41,445412,0.00664176,72.15416665
1838,呼之欲出,41,445453,0.00664176,72.16080842
1839,委員,41,445494,0.00664176,72.16745018
1840,空軍,41,445535,0.00664176,72.17409194
1841,附,41,445576,0.00664176,72.18073370
1842,保留,41,445617,0.00664176,72.18737547
1843,冒險,41,445658,0.00664176,72.19401723
1844,指定,41,445699,0.00664176,72.20065899
1845,降,41,445740,0.00664176,72.20730076
1846,展出,41,445781,0.00664176,72.21394252
1847,偏,41,445822,0.00664176,72.22058428
1848,專門,41,445863,0.00664176,72.22722604
1849,得到,41,445904,0.00664176,72.23386781
1850,規格,41,445945,0.00664176,72.24050957
1851,博士,41,445986,0.00664176,72.24715133
1852,畫家,41,446027,0.00664176,72.25379309
1853,開幕,41,446068,0.00664176,72.26043486
1854,奧運,41,446109,0.00664176,72.26707662
1855,當選,41,446150,0.00664176,72.27371838
1856,經費,41,446191,0.00664176,72.28036015
1857,道路,41,446232,0.00664176,72.28700191
1858,實驗,41,446273,0.00664176,72.29364367
1859,演奏,41,446314,0.00664176,72.30028543
1860,領先,41,446355,0.00664176,72.30692720
1861,審查,41,446396,0.00664176,72.31356896
1862,層次,41,446437,0.00664176,72.32021072
1863,播出,41,446478,0.00664176,72.32685248
1864,課,41,446519,0.00664176,72.33349425
1865,調,41,446560,0.00664176,72.34013601
1866,總統府,41,446601,0.00664176,72.34677777
1867,藥,41,446642,0.00664176,72.35341954
1868,上面,40,446682,0.00647977,72.35989930
1869,大型,40,446722,0.00647977,72.36637907
1870,不想,40,446762,0.00647977,72.37285884
1871,仍是,40,446802,0.00647977,72.37933861
1872,切,40,446842,0.00647977,72.38581838
1873,台商,40,446882,0.00647977,72.39229815
1874,必然,40,446922,0.00647977,72.39877792
1875,回家,40,446962,0.00647977,72.40525768
1876,迅速,40,447002,0.00647977,72.41173745
1877,刻,40,447042,0.00647977,72.41821722
1878,版本,40,447082,0.00647977,72.42469699
1879,保守,40,447122,0.00647977,72.43117676
1880,係,40,447162,0.00647977,72.43765653
1881,美好,40,447202,0.00647977,72.44413630
1882,訂,40,447242,0.00647977,72.45061606
1883,哪裡,40,447282,0.00647977,72.45709583
1884,核心,40,447322,0.00647977,72.46357560
1885,特,40,447362,0.00647977,72.47005537
1886,除非,40,447402,0.00647977,72.47653514
1887,停,40,447442,0.00647977,72.48301491
1888,基地,40,447482,0.00647977,72.48949468
1889,連結,40,447522,0.00647977,72.49597444
1890,逐,40,447562,0.00647977,72.50245421
1891,番,40,447602,0.00647977,72.50893398
1892,診斷,40,447642,0.00647977,72.51541375
1893,微軟,40,447682,0.00647977,72.52189352
1894,當天,40,447722,0.00647977,72.52837329
1895,經歷,40,447762,0.00647977,72.53485306
1896,經濟部,40,447802,0.00647977,72.54133282
1897,落,40,447842,0.00647977,72.54781259
1898,裡面,40,447882,0.00647977,72.55429236
1899,演講,40,447922,0.00647977,72.56077213
1900,端,40,447962,0.00647977,72.56725190
1901,敵人,40,448002,0.00647977,72.57373167
1902,質疑,40,448042,0.00647977,72.58021143
1903,縣,40,448082,0.00647977,72.58669120
1904,一半,39,448121,0.00631777,72.59300898
1905,上升,39,448160,0.00631777,72.59932675
1906,上師,39,448199,0.00631777,72.60564453
1907,介入,39,448238,0.00631777,72.61196230
1908,元件,39,448277,0.00631777,72.61828008
1909,乎,39,448316,0.00631777,72.62459785
1910,付出,39,448355,0.00631777,72.63091562
1911,生存,39,448394,0.00631777,72.63723340
1912,行政,39,448433,0.00631777,72.64355117
1913,行政院長,39,448472,0.00631777,72.64986895
1914,西,39,448511,0.00631777,72.65618672
1915,來源,39,448550,0.00631777,72.66250450
1916,建設,39,448589,0.00631777,72.66882227
1917,相反,39,448628,0.00631777,72.67514004
1918,看見,39,448667,0.00631777,72.68145782
1919,時刻,39,448706,0.00631777,72.68777559
1920,烤,39,448745,0.00631777,72.69409337
1921,高達,39,448784,0.00631777,72.70041114
1922,啤酒,39,448823,0.00631777,72.70672892
1923,探討,39,448862,0.00631777,72.71304669
1924,推,39,448901,0.00631777,72.71936446
1925,率,39,448940,0.00631777,72.72568224
1926,軟片,39,448979,0.00631777,72.73200001
1927,這次,39,449018,0.00631777,72.73831779
1928,章,39,449057,0.00631777,72.74463556
1929,單純,39,449096,0.00631777,72.75095334
1930,減,39,449135,0.00631777,72.75727111
1931,陽光,39,449174,0.00631777,72.76358888
1932,飯,39,449213,0.00631777,72.76990666
1933,境,39,449252,0.00631777,72.77622443
1934,漸漸,39,449291,0.00631777,72.78254221
1935,廣,39,449330,0.00631777,72.78885998
1936,戰爭,39,449369,0.00631777,72.79517776
1937,戰鬥,39,449408,0.00631777,72.80149553
1938,體驗,39,449447,0.00631777,72.80781330
1939,不佳,38,449485,0.00615578,72.81396909
1940,互相,38,449523,0.00615578,72.82012487
1941,反省,38,449561,0.00615578,72.82628065
1942,反彈,38,449599,0.00615578,72.83243643
1943,方案,38,449637,0.00615578,72.83859221
1944,台幣,38,449675,0.00615578,72.84474799
1945,市府,38,449713,0.00615578,72.85090377
1946,末,38,449751,0.00615578,72.85705955
1947,生態,38,449789,0.00615578,72.86321533
1948,交換,38,449827,0.00615578,72.86937111
1949,全力,38,449865,0.00615578,72.87552689
1950,百貨公司,38,449903,0.00615578,72.88168267
1951,完美,38,449941,0.00615578,72.88783845
1952,抗生素,38,449979,0.00615578,72.89399423
1953,投票,38,450017,0.00615578,72.90015001
1954,辛苦,38,450055,0.00615578,72.90630579
1955,防,38,450093,0.00615578,72.91246157
1956,定位,38,450131,0.00615578,72.91861735
1957,服裝,38,450169,0.00615578,72.92477313
1958,保,38,450207,0.00615578,72.93092891
1959,思想,38,450245,0.00615578,72.93708469
1960,為何,38,450283,0.00615578,72.94324047
1961,負,38,450321,0.00615578,72.94939625
1962,香,38,450359,0.00615578,72.95555203
1963,家屬,38,450397,0.00615578,72.96170781
1964,展覽,38,450435,0.00615578,72.96786359
1965,病患,38,450473,0.00615578,72.97401937
1966,真實,38,450511,0.00615578,72.98017515
1967,院,38,450549,0.00615578,72.98633093
1968,停止,38,450587,0.00615578,72.99248671
1969,側,38,450625,0.00615578,72.99864249
1970,殺,38,450663,0.00615578,73.00479827
1971,規則,38,450701,0.00615578,73.01095405
1972,剩,38,450739,0.00615578,73.01710983
1973,景觀,38,450777,0.00615578,73.02326561
1974,森林,38,450815,0.00615578,73.02942139
1975,結婚,38,450853,0.00615578,73.03557717
1976,貴,38,450891,0.00615578,73.04173295
1977,趁,38,450929,0.00615578,73.04788873
1978,雄,38,450967,0.00615578,73.05404451
1979,感情,38,451005,0.00615578,73.06020029
1980,搭,38,451043,0.00615578,73.06635607
1981,解,38,451081,0.00615578,73.07251185
1982,詳細,38,451119,0.00615578,73.07866763
1983,運,38,451157,0.00615578,73.08482341
1984,嘛,38,451195,0.00615578,73.09097919
1985,嘗試,38,451233,0.00615578,73.09713497
1986,團,38,451271,0.00615578,73.10329075
1987,障礙,38,451309,0.00615578,73.10944653
1988,寬,38,451347,0.00615578,73.11560231
1989,影片,38,451385,0.00615578,73.12175809
1990,優秀,38,451423,0.00615578,73.12791387
1991,聯合,38,451461,0.00615578,73.13406965
1992,賽,38,451499,0.00615578,73.14022543
1993,購,38,451537,0.00615578,73.14638121
1994,趨,38,451575,0.00615578,73.15253699
1995,曝光,38,451613,0.00615578,73.15869277
1996,議題,38,451651,0.00615578,73.16484855
1997,不良,37,451688,0.00599379,73.17084234
1998,不動產,37,451725,0.00599379,73.17683612
1999,比率,37,451762,0.00599379,73.18282991
2000,出任,37,451799,0.00599379,73.18882370
2001,平衡,37,451836,0.00599379,73.19481748
2002,正面,37,451873,0.00599379,73.20081127
2003,危機,37,451910,0.00599379,73.20680505
2004,名單,37,451947,0.00599379,73.21279884
2005,因應,37,451984,0.00599379,73.21879262
2006,早上,37,452021,0.00599379,73.22478641
2007,作家,37,452058,0.00599379,73.23078020
2008,告,37,452095,0.00599379,73.23677398
2009,批評,37,452132,0.00599379,73.24276777
2010,男女,37,452169,0.00599379,73.24876155
2011,防止,37,452206,0.00599379,73.25475534
2012,忽略,37,452243,0.00599379,73.26074913
2013,長頸鹿,37,452280,0.00599379,73.26674291
2014,青年,37,452317,0.00599379,73.27273670
2015,信用卡,37,452354,0.00599379,73.27873048
2016,員,37,452391,0.00599379,73.28472427
2017,旅客,37,452428,0.00599379,73.29071806
2018,國民,37,452465,0.00599379,73.29671184
2019,訪問,37,452502,0.00599379,73.30270563
2020,喜愛,37,452539,0.00599379,73.30869941
2021,棒球,37,452576,0.00599379,73.31469320
2022,湯,37,452613,0.00599379,73.32068699
2023,登記,37,452650,0.00599379,73.32668077
2024,貿易,37,452687,0.00599379,73.33267456
2025,實質,37,452724,0.00599379,73.33866834
2026,歌曲,37,452761,0.00599379,73.34466213
2027,聞,37,452798,0.00599379,73.35065591
2028,認知,37,452835,0.00599379,73.35664970
2029,績效,37,452872,0.00599379,73.36264349
2030,擺,37,452909,0.00599379,73.36863727
2031,繪畫,37,452946,0.00599379,73.37463106
2032,類型,37,452983,0.00599379,73.38062484
2033,權力,37,453020,0.00599379,73.38661863
2034,鹽,37,453057,0.00599379,73.39261242
2035,一致,36,453093,0.00583179,73.39844421
2036,中國人,36,453129,0.00583179,73.40427600
2037,化粧,36,453165,0.00583179,73.41010779
2038,火,36,453201,0.00583179,73.41593958
2039,出去,36,453237,0.00583179,73.42177137
2040,出發,36,453273,0.00583179,73.42760317
2041,失,36,453309,0.00583179,73.43343496
2042,左,36,453345,0.00583179,73.43926675
2043,合法,36,453381,0.00583179,73.44509854
2044,走勢,36,453417,0.00583179,73.45093033
2045,身材,36,453453,0.00583179,73.45676212
2046,車輛,36,453489,0.00583179,73.46259392
2047,依照,36,453525,0.00583179,73.46842571
2048,取得,36,453561,0.00583179,73.47425750
2049,夜,36,453597,0.00583179,73.48008929
2050,所得,36,453633,0.00583179,73.48592108
2051,抱,36,453669,0.00583179,73.49175287
2052,青少年,36,453705,0.00583179,73.49758467
2053,保證,36,453741,0.00583179,73.50341646
2054,品,36,453777,0.00583179,73.50924825
2055,既然,36,453813,0.00583179,73.51508004
2056,要道,36,453849,0.00583179,73.52091183
2057,食,36,453885,0.00583179,73.52674362
2058,家族,36,453921,0.00583179,73.53257542
2059,消失,36,453957,0.00583179,73.53840721
2060,特性,36,453993,0.00583179,73.54423900
2061,特洛伊,36,454029,0.00583179,73.55007079
2062,能否,36,454065,0.00583179,73.55590258
2063,陣,36,454101,0.00583179,73.56173437
2064,唯,36,454137,0.00583179,73.56756617
2065,排名,36,454173,0.00583179,73.57339796
2066,現今,36,454209,0.00583179,73.57922975
2067,都市,36,454245,0.00583179,73.58506154
2068,博物館,36,454281,0.00583179,73.59089333
2069,幅度,36,454317,0.00583179,73.59672512
2070,晶片,36,454353,0.00583179,73.60255692
2071,答案,36,454389,0.00583179,73.60838871
2072,幹部,36,454425,0.00583179,73.61422050
2073,會不會,36,454461,0.00583179,73.62005229
2074,落實,36,454497,0.00583179,73.62588408
2075,遍,36,454533,0.00583179,73.63171588
2076,徹底,36,454569,0.00583179,73.63754767
2077,歌劇,36,454605,0.00583179,73.64337946
2078,數據,36,454641,0.00583179,73.64921125
2079,確保,36,454677,0.00583179,73.65504304
2080,論,36,454713,0.00583179,73.66087483
2081,器材,36,454749,0.00583179,73.66670663
2082,機種,36,454785,0.00583179,73.67253842
2083,競爭力,36,454821,0.00583179,73.67837021
2084,人選,35,454856,0.00566980,73.68404001
2085,下降,35,454891,0.00566980,73.68970980
2086,上市公司,35,454926,0.00566980,73.69537960
2087,工會,35,454961,0.00566980,73.70104940
2088,尺寸,35,454996,0.00566980,73.70671920
2089,主委,35,455031,0.00566980,73.71238899
2090,出售,35,455066,0.00566980,73.71805879
2091,母,35,455101,0.00566980,73.72372859
2092,生長,35,455136,0.00566980,73.72939839
2093,白色,35,455171,0.00566980,73.73506818
2094,收藏,35,455206,0.00566980,73.74073798
2095,吹,35,455241,0.00566980,73.74640778
2096,局面,35,455276,0.00566980,73.75207758
2097,形容,35,455311,0.00566980,73.75774737
2098,車子,35,455346,0.00566980,73.76341717
2099,味,35,455381,0.00566980,73.76908697
2100,虎,35,455416,0.00566980,73.77475677
2101,金屬,35,455451,0.00566980,73.78042656
2102,長大,35,455486,0.00566980,73.78609636
2103,冠軍,35,455521,0.00566980,73.79176616
2104,盈餘,35,455556,0.00566980,73.79743596
2105,看出,35,455591,0.00566980,73.80310575
2106,英雄,35,455626,0.00566980,73.80877555
2107,修正,35,455661,0.00566980,73.81444535
2108,原先,35,455696,0.00566980,73.82011515
2109,哦,35,455731,0.00566980,73.82578494
2110,高層,35,455766,0.00566980,73.83145474
2111,國大,35,455801,0.00566980,73.83712454
2112,國王,35,455836,0.00566980,73.84279434
2113,混合,35,455871,0.00566980,73.84846413
2114,理念,35,455906,0.00566980,73.85413393
2115,畢竟,35,455941,0.00566980,73.85980373
2116,細胞,35,455976,0.00566980,73.86547353
2117,莫,35,456011,0.00566980,73.87114332
2118,備,35,456046,0.00566980,73.87681312
2119,尋,35,456081,0.00566980,73.88248292
2120,就業,35,456116,0.00566980,73.88815272
2121,象,35,456151,0.00566980,73.89382251
2122,超越,35,456186,0.00566980,73.89949231
2123,新竹,35,456221,0.00566980,73.90516211
2124,補充,35,456256,0.00566980,73.91083191
2125,載,35,456291,0.00566980,73.91650170
2126,預估,35,456326,0.00566980,73.92217150
2127,膀胱,35,456361,0.00566980,73.92784130
2128,樣子,35,456396,0.00566980,73.93351109
2129,蔬菜,35,456431,0.00566980,73.93918089
2130,調查局,35,456466,0.00566980,73.94485069
2131,戰場,35,456501,0.00566980,73.95052049
2132,優先,35,456536,0.00566980,73.95619028
2133,鎮,35,456571,0.00566980,73.96186008
2134,額,35,456606,0.00566980,73.96752988
2135,證實,35,456641,0.00566980,73.97319968
2136,關於,35,456676,0.00566980,73.97886947
2137,人力,34,456710,0.00550780,73.98437728
2138,上下,34,456744,0.00550780,73.98988508
2139,上班,34,456778,0.00550780,73.99539288
2140,大樓,34,456812,0.00550780,74.00090069
2141,不多,34,456846,0.00550780,74.00640849
2142,中文,34,456880,0.00550780,74.01191629
2143,手段,34,456914,0.00550780,74.01742410
2144,主持,34,456948,0.00550780,74.02293190
2145,外交,34,456982,0.00550780,74.02843970
2146,生意,34,457016,0.00550780,74.03394751
2147,皮,34,457050,0.00550780,74.03945531
2148,企圖,34,457084,0.00550780,74.04496311
2149,協調,34,457118,0.00550780,74.05047092
2150,味道,34,457152,0.00550780,74.05597872
2151,明白,34,457186,0.00550780,74.06148652
2152,明確,34,457220,0.00550780,74.06699433
2153,相紙,34,457254,0.00550780,74.07250213
2154,重複,34,457288,0.00550780,74.07800993
2155,倒是,34,457322,0.00550780,74.08351774
2156,恐懼,34,457356,0.00550780,74.08902554
2157,旅,34,457390,0.00550780,74.09453334
2158,副,34,457424,0.00550780,74.10004115
2159,情勢,34,457458,0.00550780,74.10554895
2160,球團,34,457492,0.00550780,74.11105675
2161,眼部,34,457526,0.00550780,74.11656456
2162,移民,34,457560,0.00550780,74.12207236
2163,規畫,34,457594,0.00550780,74.12758016
2164,部門,34,457628,0.00550780,74.13308797
2165,創業,34,457662,0.00550780,74.13859577
2166,喔,34,457696,0.00550780,74.14410357
2167,智慧,34,457730,0.00550780,74.14961138
2168,然,34,457764,0.00550780,74.15511918
2169,煮,34,457798,0.00550780,74.16062698
2170,發出,34,457832,0.00550780,74.16613479
2171,硬體,34,457866,0.00550780,74.17164259
2172,貼,34,457900,0.00550780,74.17715039
2173,亂,34,457934,0.00550780,74.18265820
2174,當中,34,457968,0.00550780,74.18816600
2175,睡,34,458002,0.00550780,74.19367380
2176,說話,34,458036,0.00550780,74.19918161
2177,標示,34,458070,0.00550780,74.20468941
2178,熱烈,34,458104,0.00550780,74.21019721
2179,適,34,458138,0.00550780,74.21570502
2180,縣府,34,458172,0.00550780,74.22121282
2181,龍,34,458206,0.00550780,74.22672062
2182,戴,34,458240,0.00550780,74.23222842
2183,擦,34,458274,0.00550780,74.23773623
2184,證據,34,458308,0.00550780,74.24324403
2185,議員,34,458342,0.00550780,74.24875183
2186,驚人,34,458376,0.00550780,74.25425964
2187,觀光,34,458410,0.00550780,74.25976744
2188,不利,33,458443,0.00534581,74.26511325
2189,不幸,33,458476,0.00534581,74.27045906
2190,中午,33,458509,0.00534581,74.27580487
2191,牛,33,458542,0.00534581,74.28115068
2192,主張,33,458575,0.00534581,74.28649649
2193,他人,33,458608,0.00534581,74.29184230
2194,刊,33,458641,0.00534581,74.29718810
2195,央行,33,458674,0.00534581,74.30253391
2196,共識,33,458707,0.00534581,74.30787972
2197,作戰,33,458740,0.00534581,74.31322553
2198,尿,33,458773,0.00534581,74.31857134
2199,決議,33,458806,0.00534581,74.32391715
2200,其餘,33,458839,0.00534581,74.32926296
2201,命運,33,458872,0.00534581,74.33460877
2202,屆時,33,458905,0.00534581,74.33995458
2203,性別,33,458938,0.00534581,74.34530039
2204,服飾,33,458971,0.00534581,74.35064619
2205,林洋港,33,459004,0.00534581,74.35599200
2206,波士頓,33,459037,0.00534581,74.36133781
2207,物質,33,459070,0.00534581,74.36668362
2208,急,33,459103,0.00534581,74.37202943
2209,持有,33,459136,0.00534581,74.37737524
2210,軍方,33,459169,0.00534581,74.38272105
2211,香水,33,459202,0.00534581,74.38806686
2212,展示,33,459235,0.00534581,74.39341267
2213,旅行,33,459268,0.00534581,74.39875848
2214,案例,33,459301,0.00534581,74.40410429
2215,浪費,33,459334,0.00534581,74.40945009
2216,涉及,33,459367,0.00534581,74.41479590
2217,紙,33,459400,0.00534581,74.42014171
2218,記憶體,33,459433,0.00534581,74.42548752
2219,偉大,33,459466,0.00534581,74.43083333
2220,商,33,459499,0.00534581,74.43617914
2221,密碼,33,459532,0.00534581,74.44152495
2222,專案,33,459565,0.00534581,74.44687076
2223,掛,33,459598,0.00534581,74.45221657
2224,現任,33,459631,0.00534581,74.45756238
2225,眾多,33,459664,0.00534581,74.46290818
2226,荷蘭,33,459697,0.00534581,74.46825399
2227,速,33,459730,0.00534581,74.47359980
2228,魚,33,459763,0.00534581,74.47894561
2229,場所,33,459796,0.00534581,74.48429142
2230,提昇,33,459829,0.00534581,74.48963723
2231,鄉,33,459862,0.00534581,74.49498304
2232,經建會,33,459895,0.00534581,74.50032885
2233,裕隆,33,459928,0.00534581,74.50567466
2234,夢,33,459961,0.00534581,74.51102047
2235,層面,33,459994,0.00534581,74.51636628
2236,暫時,33,460027,0.00534581,74.52171208
2237,激烈,33,460060,0.00534581,74.52705789
2238,壓,33,460093,0.00534581,74.53240370
2239,檢察官,33,460126,0.00534581,74.53774951
2240,韓國,33,460159,0.00534581,74.54309532
2241,職,33,460192,0.00534581,74.54844113
2242,上海,32,460224,0.00518381,74.55362494
2243,公平,32,460256,0.00518381,74.55880876
2244,天然,32,460288,0.00518381,74.56399257
2245,主導,32,460320,0.00518381,74.56917639
2246,出席,32,460352,0.00518381,74.57436020
2247,史,32,460384,0.00518381,74.57954402
2248,平時,32,460416,0.00518381,74.58472783
2249,犯罪,32,460448,0.00518381,74.58991165
2250,回應,32,460480,0.00518381,74.59509546
2251,好處,32,460512,0.00518381,74.60027928
2252,血液,32,460544,0.00518381,74.60546309
2253,克里斯,32,460576,0.00518381,74.61064691
2254,兵,32,460608,0.00518381,74.61583072
2255,抗爭,32,460640,0.00518381,74.62101454
2256,事物,32,460672,0.00518381,74.62619835
2257,享,32,460704,0.00518381,74.63138217
2258,到達,32,460736,0.00518381,74.63656598
2259,協商,32,460768,0.00518381,74.64174980
2260,咖啡,32,460800,0.00518381,74.64693361
2261,定期,32,460832,0.00518381,74.65211743
2262,定義,32,460864,0.00518381,74.65730124
2263,承認,32,460896,0.00518381,74.66248506
2264,拍賣,32,460928,0.00518381,74.66766887
2265,直到,32,460960,0.00518381,74.67285269
2266,訂單,32,460992,0.00518381,74.67803650
2267,疲勞,32,461024,0.00518381,74.68322032
2268,衰退,32,461056,0.00518381,74.68840413
2269,記者會,32,461088,0.00518381,74.69358795
2270,健全,32,461120,0.00518381,74.69877176
2271,排除,32,461152,0.00518381,74.70395557
2272,教學,32,461184,0.00518381,74.70913939
2273,眾,32,461216,0.00518381,74.71432320
2274,設施,32,461248,0.00518381,74.71950702
2275,尊重,32,461280,0.00518381,74.72469083
2276,惡化,32,461312,0.00518381,74.72987465
2277,斑馬,32,461344,0.00518381,74.73505846
2278,棟,32,461376,0.00518381,74.74024228
2279,街,32,461408,0.00518381,74.74542609
2280,集,32,461440,0.00518381,74.75060991
2281,傷,32,461472,0.00518381,74.75579372
2282,愈來愈,32,461504,0.00518381,74.76097754
2283,睫毛,32,461536,0.00518381,74.76616135
2284,經理人,32,461568,0.00518381,74.77134517
2285,詢問,32,461600,0.00518381,74.77652898
2286,資格,32,461632,0.00518381,74.78171280
2287,路線,32,461664,0.00518381,74.78689661
2288,對話,32,461696,0.00518381,74.79208043
2289,慢,32,461728,0.00518381,74.79726424
2290,構,32,461760,0.00518381,74.80244806
2291,演唱,32,461792,0.00518381,74.80763187
2292,雌,32,461824,0.00518381,74.81281569
2293,價位,32,461856,0.00518381,74.81799950
2294,彈性,32,461888,0.00518381,74.82318332
2295,機場,32,461920,0.00518381,74.82836713
2296,幫忙,32,461952,0.00518381,74.83355095
2297,醫療,32,461984,0.00518381,74.83873476
2298,體力,32,462016,0.00518381,74.84391858
2299,體系,32,462048,0.00518381,74.84910239
2300,十足,31,462079,0.00502182,74.85412421
2301,不一樣,31,462110,0.00502182,74.85914603
2302,中部,31,462141,0.00502182,74.86416785
2303,天下,31,462172,0.00502182,74.86918967
2304,包,31,462203,0.00502182,74.87421149
2305,包裝,31,462234,0.00502182,74.87923331
2306,可能性,31,462265,0.00502182,74.88425513
2307,可愛,31,462296,0.00502182,74.88927696
2308,多半,31,462327,0.00502182,74.89429878
2309,守,31,462358,0.00502182,74.89932060
2310,自信,31,462389,0.00502182,74.90434242
2311,何況,31,462420,0.00502182,74.90936424
2312,伺服器,31,462451,0.00502182,74.91438606
2313,困擾,31,462482,0.00502182,74.91940788
2314,床,31,462513,0.00502182,74.92442970
2315,改裝,31,462544,0.00502182,74.92945152
2316,材質,31,462575,0.00502182,74.93447334
2317,角落,31,462606,0.00502182,74.93949516
2318,宗教,31,462637,0.00502182,74.94451698
2319,明年,31,462668,0.00502182,74.94953880
2320,服用,31,462699,0.00502182,74.95456062
2321,炒作,31,462730,0.00502182,74.95958244
2322,爬,31,462761,0.00502182,74.96460426
2323,初步,31,462792,0.00502182,74.96962608
2324,保險,31,462823,0.00502182,74.97464791
2325,前面,31,462854,0.00502182,74.97966973
2326,客人,31,462885,0.00502182,74.98469155
2327,挑選,31,462916,0.00502182,74.98971337
2328,柯林頓,31,462947,0.00502182,74.99473519
2329,美食,31,462978,0.00502182,74.99975701
2330,背後,31,463009,0.00502182,75.00477883
2331,英語,31,463040,0.00502182,75.00980065
2332,計程車,31,463071,0.00502182,75.01482247
2333,計算,31,463102,0.00502182,75.01984429
2334,原住民,31,463133,0.00502182,75.02486611
2335,泰國,31,463164,0.00502182,75.02988793
2336,追,31,463195,0.00502182,75.03490975
2337,高音,31,463226,0.00502182,75.03993157
2338,國會,31,463257,0.00502182,75.04495339
2339,專用,31,463288,0.00502182,75.04997521
2340,強化,31,463319,0.00502182,75.05499704
2341,清,31,463350,0.00502182,75.06001886
2342,現代化,31,463381,0.00502182,75.06504068
2343,期望,31,463412,0.00502182,75.07006250
2344,減肥,31,463443,0.00502182,75.07508432
2345,痛,31,463474,0.00502182,75.08010614
2346,結,31,463505,0.00502182,75.08512796
2347,進場,31,463536,0.00502182,75.09014978
2348,傳說,31,463567,0.00502182,75.09517160
2349,感動,31,463598,0.00502182,75.10019342
2350,置,31,463629,0.00502182,75.10521524
2351,電子股,31,463660,0.00502182,75.11023706
2352,構想,31,463691,0.00502182,75.11525888
2353,語,31,463722,0.00502182,75.12028070
2354,廣泛,31,463753,0.00502182,75.12530252
2355,模組,31,463784,0.00502182,75.13032434
2356,閱讀,31,463815,0.00502182,75.13534617
2357,噸,31,463846,0.00502182,75.14036799
2358,戰術,31,463877,0.00502182,75.14538981
2359,餐,31,463908,0.00502182,75.15041163
2360,嬰兒,31,463939,0.00502182,75.15543345
2361,轉換,31,463970,0.00502182,75.16045527
2362,懷,31,464001,0.00502182,75.16547709
2363,競賽,31,464032,0.00502182,75.17049891
2364,人工,30,464062,0.00485983,75.17535874
2365,上揚,30,464092,0.00485983,75.18021856
2366,大致,30,464122,0.00485983,75.18507839
2367,大會,30,464152,0.00485983,75.18993822
2368,女子,30,464182,0.00485983,75.19479804
2369,小小,30,464212,0.00485983,75.19965787
2370,公布,30,464242,0.00485983,75.20451769
2371,文章,30,464272,0.00485983,75.20937752
2372,日常,30,464302,0.00485983,75.21423735
2373,水質,30,464332,0.00485983,75.21909717
2374,加拿大,30,464362,0.00485983,75.22395700
2375,外表,30,464392,0.00485983,75.22881683
2376,民,30,464422,0.00485983,75.23367665
2377,立體,30,464452,0.00485983,75.23853648
2378,回饋,30,464482,0.00485983,75.24339631
2379,如同,30,464512,0.00485983,75.24825613
2380,考,30,464542,0.00485983,75.25311596
2381,作曲家,30,464572,0.00485983,75.25797579
2382,呈,30,464602,0.00485983,75.26283561
2383,宏碁,30,464632,0.00485983,75.26769544
2384,弄,30,464662,0.00485983,75.27255526
2385,村,30,464692,0.00485983,75.27741509
2386,決策,30,464722,0.00485983,75.28227492
2387,車主,30,464752,0.00485983,75.28713474
2388,並非,30,464782,0.00485983,75.29199457
2389,味精,30,464812,0.00485983,75.29685440
2390,性質,30,464842,0.00485983,75.30171422
2391,抱怨,30,464872,0.00485983,75.30657405
2392,物品,30,464902,0.00485983,75.31143388
2393,近來,30,464932,0.00485983,75.31629370
2394,亮,30,464962,0.00485983,75.32115353
2395,保養,30,464992,0.00485983,75.32601335
2396,城,30,465022,0.00485983,75.33087318
2397,指令,30,465052,0.00485983,75.33573301
2398,活潑,30,465082,0.00485983,75.34059283
2399,看好,30,465112,0.00485983,75.34545266
2400,胎兒,30,465142,0.00485983,75.35031249
2401,首長,30,465172,0.00485983,75.35517231
2402,效益,30,465202,0.00485983,75.36003214
2403,效應,30,465232,0.00485983,75.36489197
2404,書籍,30,465262,0.00485983,75.36975179
2405,桌,30,465292,0.00485983,75.37461162
2406,特定,30,465322,0.00485983,75.37947145
2407,秘書長,30,465352,0.00485983,75.38433127
2408,草,30,465382,0.00485983,75.38919110
2409,追蹤,30,465412,0.00485983,75.39405092
2410,啦,30,465442,0.00485983,75.39891075
2411,細節,30,465472,0.00485983,75.40377058
2412,陳水扁,30,465502,0.00485983,75.40863040
2413,報酬,30,465532,0.00485983,75.41349023
2414,循環,30,465562,0.00485983,75.41835006
2415,舒適,30,465592,0.00485983,75.42320988
2416,視覺,30,465622,0.00485983,75.42806971
2417,郵件,30,465652,0.00485983,75.43292954
2418,飲料,30,465682,0.00485983,75.43778936
2419,債,30,465712,0.00485983,75.44264919
2420,微笑,30,465742,0.00485983,75.44750901
2421,搞,30,465772,0.00485983,75.45236884
2422,腦袋,30,465802,0.00485983,75.45722867
2423,道理,30,465832,0.00485983,75.46208849
2424,圖書館,30,465862,0.00485983,75.46694832
2425,漂亮,30,465892,0.00485983,75.47180815
2426,維護,30,465922,0.00485983,75.47666797
2427,廚房,30,465952,0.00485983,75.48152780
2428,數據機,30,465982,0.00485983,75.48638763
2429,樂器,30,466012,0.00485983,75.49124745
2430,獎金,30,466042,0.00485983,75.49610728
2431,憑,30,466072,0.00485983,75.50096711
2432,樹,30,466102,0.00485983,75.50582693
2433,親,30,466132,0.00485983,75.51068676
2434,頻頻,30,466162,0.00485983,75.51554658
2435,藏,30,466192,0.00485983,75.52040641
2436,鎳,30,466222,0.00485983,75.52526624
2437,邊緣,30,466252,0.00485983,75.53012606
2438,攝取,30,466282,0.00485983,75.53498589
2439,權,30,466312,0.00485983,75.53984572
2440,顯示卡,30,466342,0.00485983,75.54470554
2441,鑰匙,30,466372,0.00485983,75.54956537
2442,大盤,29,466401,0.00469783,75.55426320
2443,子宮,29,466430,0.00469783,75.55896103
2444,小朋友,29,466459,0.00469783,75.56365887
2445,不一定,29,466488,0.00469783,75.56835670
2446,天空,29,466517,0.00469783,75.57305453
2447,太陽,29,466546,0.00469783,75.57775236
2448,主人,29,466575,0.00469783,75.58245019
2449,主流,29,466604,0.00469783,75.58714803
2450,功效,29,466633,0.00469783,75.59184586
2451,可怕,29,466662,0.00469783,75.59654369
2452,全壘打,29,466691,0.00469783,75.60124152
2453,百貨,29,466720,0.00469783,75.60593936
2454,考試,29,466749,0.00469783,75.61063719
2455,肉,29,466778,0.00469783,75.61533502
2456,那些,29,466807,0.00469783,75.62003285
2457,來臨,29,466836,0.00469783,75.62473068
2458,拍照,29,466865,0.00469783,75.62942852
2459,金門,29,466894,0.00469783,75.63412635
2460,宣傳,29,466923,0.00469783,75.63882418
2461,客,29,466952,0.00469783,75.64352201
2462,後面,29,466981,0.00469783,75.64821985
2463,省府,29,467010,0.00469783,75.65291768
2464,紀念,29,467039,0.00469783,75.65761551
2465,負責人,29,467068,0.00469783,75.66231334
2466,倫敦,29,467097,0.00469783,75.66701117
2467,娛樂,29,467126,0.00469783,75.67170901
2468,差別,29,467155,0.00469783,75.67640684
2469,差距,29,467184,0.00469783,75.68110467
2470,消除,29,467213,0.00469783,75.68580250
2471,破,29,467242,0.00469783,75.69050034
2472,高中,29,467271,0.00469783,75.69519817
2473,高興,29,467300,0.00469783,75.69989600
2474,乾,29,467329,0.00469783,75.70459383
2475,動力,29,467358,0.00469783,75.70929166
2476,寄,29,467387,0.00469783,75.71398950
2477,從此,29,467416,0.00469783,75.71868733
2478,清晰,29,467445,0.00469783,75.72338516
2479,現金,29,467474,0.00469783,75.72808299
2480,瓶,29,467503,0.00469783,75.73278083
2481,產能,29,467532,0.00469783,75.73747866
2482,貨,29,467561,0.00469783,75.74217649
2483,場地,29,467590,0.00469783,75.74687432
2484,愉快,29,467619,0.00469783,75.75157215
2485,提到,29,467648,0.00469783,75.75626999
2486,善,29,467677,0.00469783,75.76096782
2487,訴求,29,467706,0.00469783,75.76566565
2488,黑色,29,467735,0.00469783,75.77036348
2489,搶,29,467764,0.00469783,75.77506131
2490,節奏,29,467793,0.00469783,75.77975915
2491,農民,29,467822,0.00469783,75.78445698
2492,農會,29,467851,0.00469783,75.78915481
2493,運動會,29,467880,0.00469783,75.79385264
2494,運輸,29,467909,0.00469783,75.79855048
2495,道德,29,467938,0.00469783,75.80324831
2496,槍,29,467967,0.00469783,75.80794614
2497,輕易,29,467996,0.00469783,75.81264397
2498,儀式,29,468025,0.00469783,75.81734180
2499,確認,29,468054,0.00469783,75.82203964
2500,燕窩,29,468083,0.00469783,75.82673747
2501,興奮,29,468112,0.00469783,75.83143530
2502,薄,29,468141,0.00469783,75.83613313
2503,懷孕,29,468170,0.00469783,75.84083097
2504,證券,29,468199,0.00469783,75.84552880
2505,歡樂,29,468228,0.00469783,75.85022663
2506,不大,28,468256,0.00453584,75.85476247
2507,不料,28,468284,0.00453584,75.85929831
2508,不當,28,468312,0.00453584,75.86383414
2509,公頃,28,468340,0.00453584,75.86836998
2510,匹,28,468368,0.00453584,75.87290582
2511,友,28,468396,0.00453584,75.87744166
2512,代理商,28,468424,0.00453584,75.88197750
2513,出身,28,468452,0.00453584,75.88651333
2514,外觀,28,468480,0.00453584,75.89104917
2515,回去,28,468508,0.00453584,75.89558501
2516,在野黨,28,468536,0.00453584,75.90012085
2517,存款,28,468564,0.00453584,75.90465669
2518,成分,28,468592,0.00453584,75.90919252
2519,成交,28,468620,0.00453584,75.91372836
2520,抗議,28,468648,0.00453584,75.91826420
2521,把握,28,468676,0.00453584,75.92280004
2522,更換,28,468704,0.00453584,75.92733588
2523,車型,28,468732,0.00453584,75.93187171
2524,阮,28,468760,0.00453584,75.93640755
2525,刻意,28,468788,0.00453584,75.94094339
2526,受傷,28,468816,0.00453584,75.94547923
2527,始終,28,468844,0.00453584,75.95001507
2528,季節,28,468872,0.00453584,75.95455090
2529,房屋,28,468900,0.00453584,75.95908674
2530,放鬆,28,468928,0.00453584,75.96362258
2531,法人,28,468956,0.00453584,75.96815842
2532,沮喪,28,468984,0.00453584,75.97269426
2533,沿,28,469012,0.00453584,75.97723009
2534,炒,28,469040,0.00453584,75.98176593
2535,狀,28,469068,0.00453584,75.98630177
2536,雨,28,469096,0.00453584,75.99083761
2537,前衛,28,469124,0.00453584,75.99537345
2538,封,28,469152,0.00453584,75.99990928
2539,美金,28,469180,0.00453584,76.00444512
2540,軍,28,469208,0.00453584,76.00898096
2541,家具,28,469236,0.00453584,76.01351680
2542,差不多,28,469264,0.00453584,76.01805264
2543,氣候,28,469292,0.00453584,76.02258847
2544,圈,28,469320,0.00453584,76.02712431
2545,帶領,28,469348,0.00453584,76.03166015
2546,細,28,469376,0.00453584,76.03619599
2547,聊天,28,469404,0.00453584,76.04073183
2548,荷,28,469432,0.00453584,76.04526766
2549,貨幣,28,469460,0.00453584,76.04980350
2550,釣魚台,28,469488,0.00453584,76.05433934
2551,勞工,28,469516,0.00453584,76.05887518
2552,場面,28,469544,0.00453584,76.06341101
2553,游,28,469572,0.00453584,76.06794685
2554,傳達,28,469600,0.00453584,76.07248269
2555,勢力,28,469628,0.00453584,76.07701853
2556,瑞士,28,469656,0.00453584,76.08155437
2557,詮釋,28,469684,0.00453584,76.08609020
2558,歌,28,469712,0.00453584,76.09062604
2559,管制,28,469740,0.00453584,76.09516188
2560,精英,28,469768,0.00453584,76.09969772
2561,輔助,28,469796,0.00453584,76.10423356
2562,劉,28,469824,0.00453584,76.10876939
2563,播放,28,469852,0.00453584,76.11330523
2564,歐美,28,469880,0.00453584,76.11784107
2565,賣場,28,469908,0.00453584,76.12237691
2566,踏板,28,469936,0.00453584,76.12691275
2567,遭遇,28,469964,0.00453584,76.13144858
2568,鄰居,28,469992,0.00453584,76.13598442
2569,選購,28,470020,0.00453584,76.14052026
2570,鋼琴,28,470048,0.00453584,76.14505610
2571,癌症,28,470076,0.00453584,76.14959194
2572,臨時,28,470104,0.00453584,76.15412777
2573,鍋,28,470132,0.00453584,76.15866361
2574,藉由,28,470160,0.00453584,76.16319945
2575,鎖定,28,470188,0.00453584,76.16773529
2576,證管會,28,470216,0.00453584,76.17227113
2577,觀點,28,470244,0.00453584,76.17680696
2578,一再,27,470271,0.00437384,76.18118081
2579,中華民國,27,470298,0.00437384,76.18555465
2580,互,27,470325,0.00437384,76.18992850
2581,公共,27,470352,0.00437384,76.19430234
2582,天氣,27,470379,0.00437384,76.19867618
2583,比重,27,470406,0.00437384,76.20305003
2584,牛肉,27,470433,0.00437384,76.20742387
2585,主機,27,470460,0.00437384,76.21179771
2586,出貨,27,470487,0.00437384,76.21617156
2587,司機,27,470514,0.00437384,76.22054540
2588,必需,27,470541,0.00437384,76.22491925
2589,本土,27,470568,0.00437384,76.22929309
2590,用心,27,470595,0.00437384,76.23366693
2591,同步,27,470622,0.00437384,76.23804078
2592,名稱,27,470649,0.00437384,76.24241462
2593,老人,27,470676,0.00437384,76.24678846
2594,行庫,27,470703,0.00437384,76.25116231
2595,克,27,470730,0.00437384,76.25553615
2596,助益,27,470757,0.00437384,76.25991000
2597,李鵬,27,470784,0.00437384,76.26428384
2598,沒想到,27,470811,0.00437384,76.26865768
2599,亞特蘭大,27,470838,0.00437384,76.27303153
2600,其次,27,470865,0.00437384,76.27740537
2601,典型,27,470892,0.00437384,76.28177921
2602,到處,27,470919,0.00437384,76.28615306
2603,延伸,27,470946,0.00437384,76.29052690
2604,房價,27,470973,0.00437384,76.29490075
2605,所在,27,471000,0.00437384,76.29927459
2606,抽,27,471027,0.00437384,76.30364843
2607,明,27,471054,0.00437384,76.30802228
2608,林振國,27,471081,0.00437384,76.31239612
2609,表情,27,471108,0.00437384,76.31676996
2610,便是,27,471135,0.00437384,76.32114381
2611,俄羅斯,27,471162,0.00437384,76.32551765
2612,相處,27,471189,0.00437384,76.32989150
2613,重要性,27,471216,0.00437384,76.33426534
2614,飛行,27,471243,0.00437384,76.33863918
2615,個別,27,471270,0.00437384,76.34301303
2616,修,27,471297,0.00437384,76.34738687
2617,剛好,27,471324,0.00437384,76.35176072
2618,席,27,471351,0.00437384,76.35613456
2619,校園,27,471378,0.00437384,76.36050840
2620,素材,27,471405,0.00437384,76.36488225
2621,缺,27,471432,0.00437384,76.36925609
2622,國際化,27,471459,0.00437384,76.37362993
2623,婚姻,27,471486,0.00437384,76.37800378
2624,專輯,27,471513,0.00437384,76.38237762
2625,混亂,27,471540,0.00437384,76.38675147
2626,規範,27,471567,0.00437384,76.39112531
2627,途,27,471594,0.00437384,76.39549915
2628,部隊,27,471621,0.00437384,76.39987300
2629,鹿,27,471648,0.00437384,76.40424684
2630,剩下,27,471675,0.00437384,76.40862068
2631,尋求,27,471702,0.00437384,76.41299453
2632,彭,27,471729,0.00437384,76.41736837
2633,敢,27,471756,0.00437384,76.42174222
2634,朝野,27,471783,0.00437384,76.42611606
2635,無奈,27,471810,0.00437384,76.43048990
2636,越南,27,471837,0.00437384,76.43486375
2637,進來,27,471864,0.00437384,76.43923759
2638,進度,27,471891,0.00437384,76.44361143
2639,開店,27,471918,0.00437384,76.44798528
2640,勢,27,471945,0.00437384,76.45235912
2641,新人,27,471972,0.00437384,76.45673297
2642,溫和,27,471999,0.00437384,76.46110681
2643,溫度,27,472026,0.00437384,76.46548065
2644,滑鼠,27,472053,0.00437384,76.46985450
2645,當場,27,472080,0.00437384,76.47422834
2646,節省,27,472107,0.00437384,76.47860218
2647,落後,27,472134,0.00437384,76.48297603
2648,跨,27,472161,0.00437384,76.48734987
2649,農業,27,472188,0.00437384,76.49172372
2650,遊,27,472215,0.00437384,76.49609756
2651,盡量,27,472242,0.00437384,76.50047140
2652,蜜兒,27,472269,0.00437384,76.50484525
2653,領袖,27,472296,0.00437384,76.50921909
2654,影響力,27,472323,0.00437384,76.51359293
2655,標的,27,472350,0.00437384,76.51796678
2656,導,27,472377,0.00437384,76.52234062
2657,檔,27,472404,0.00437384,76.52671447
2658,營造,27,472431,0.00437384,76.53108831
2659,聯絡,27,472458,0.00437384,76.53546215
2660,聯盟,27,472485,0.00437384,76.53983600
2661,購物,27,472512,0.00437384,76.54420984
2662,還有,27,472539,0.00437384,76.54858368
2663,願,27,472566,0.00437384,76.55295753
2664,露,27,472593,0.00437384,76.55733137
2665,變動,27,472620,0.00437384,76.56170522
2666,丈夫,26,472646,0.00421185,76.56591707
2667,不得,26,472672,0.00421185,76.57012891
2668,尤,26,472698,0.00421185,76.57434076
2669,主力,26,472724,0.00421185,76.57855261
2670,主義,26,472750,0.00421185,76.58276446
2671,代價,26,472776,0.00421185,76.58697631
2672,召集人,26,472802,0.00421185,76.59118816
2673,台灣人,26,472828,0.00421185,76.59540001
2674,台灣省,26,472854,0.00421185,76.59961186
2675,民俗,26,472880,0.00421185,76.60382371
2676,石,26,472906,0.00421185,76.60803556
2677,列入,26,472932,0.00421185,76.61224741
2678,地面,26,472958,0.00421185,76.61645926
2679,安定,26,472984,0.00421185,76.62067111
2680,有力,26,473010,0.00421185,76.62488296
2681,有時候,26,473036,0.00421185,76.62909481
2682,老婆,26,473062,0.00421185,76.63330666
2683,行使,26,473088,0.00421185,76.63751851
2684,否,26,473114,0.00421185,76.64173036
2685,否認,26,473140,0.00421185,76.64594221
2686,告知,26,473166,0.00421185,76.65015406
2687,呀,26,473192,0.00421185,76.65436591
2688,私人,26,473218,0.00421185,76.65857776
2689,乳豬,26,473244,0.00421185,76.66278961
2690,例外,26,473270,0.00421185,76.66700145
2691,委員會,26,473296,0.00421185,76.67121330
2692,延長,26,473322,0.00421185,76.67542515
2693,承諾,26,473348,0.00421185,76.67963700
2694,明天,26,473374,0.00421185,76.68384885
2695,東京,26,473400,0.00421185,76.68806070
2696,近日,26,473426,0.00421185,76.69227255
2697,近期,26,473452,0.00421185,76.69648440
2698,保存,26,473478,0.00421185,76.70069625
2699,南部,26,473504,0.00421185,76.70490810
2700,律師,26,473530,0.00421185,76.70911995
2701,拜訪,26,473556,0.00421185,76.71333180
2702,持股,26,473582,0.00421185,76.71754365
2703,施工,26,473608,0.00421185,76.72175550
2704,星,26,473634,0.00421185,76.72596735
2705,玻璃,26,473660,0.00421185,76.73017920
2706,突出,26,473686,0.00421185,76.73439105
2707,美術,26,473712,0.00421185,76.73860290
2708,重心,26,473738,0.00421185,76.74281475
2709,風景,26,473764,0.00421185,76.74702660
2710,個股,26,473790,0.00421185,76.75123845
2711,修憲,26,473816,0.00421185,76.75545030
2712,原始,26,473842,0.00421185,76.75966214
2713,弱,26,473868,0.00421185,76.76387399
2714,氣質,26,473894,0.00421185,76.76808584
2715,海洋,26,473920,0.00421185,76.77229769
2716,能量,26,473946,0.00421185,76.77650954
2717,航線,26,473972,0.00421185,76.78072139
2718,迷,26,473998,0.00421185,76.78493324
2719,乾燥,26,474024,0.00421185,76.78914509
2720,做法,26,474050,0.00421185,76.79335694
2721,動畫,26,474076,0.00421185,76.79756879
2722,敘述,26,474102,0.00421185,76.80178064
2723,旋轉,26,474128,0.00421185,76.80599249
2724,現行,26,474154,0.00421185,76.81020434
2725,產量,26,474180,0.00421185,76.81441619
2726,通路,26,474206,0.00421185,76.81862804
2727,連接,26,474232,0.00421185,76.82283989
2728,陷入,26,474258,0.00421185,76.82705174
2729,麻煩,26,474284,0.00421185,76.83126359
2730,喇叭,26,474310,0.00421185,76.83547544
2731,單一,26,474336,0.00421185,76.83968729
2732,復甦,26,474362,0.00421185,76.84389914
2733,提案,26,474388,0.00421185,76.84811099
2734,港,26,474414,0.00421185,76.85232284
2735,無限,26,474440,0.00421185,76.85653468
2736,短短,26,474466,0.00421185,76.86074653
2737,等級,26,474492,0.00421185,76.86495838
2738,結論,26,474518,0.00421185,76.86917023
2739,超級,26,474544,0.00421185,76.87338208
2740,園區,26,474570,0.00421185,76.87759393
2741,資,26,474596,0.00421185,76.88180578
2742,違規,26,474622,0.00421185,76.88601763
2743,逾,26,474648,0.00421185,76.89022948
2744,預,26,474674,0.00421185,76.89444133
2745,預料,26,474700,0.00421185,76.89865318
2746,團員,26,474726,0.00421185,76.90286503
2747,漢聲雜誌,26,474752,0.00421185,76.90707688
2748,漲幅,26,474778,0.00421185,76.91128873
2749,緊,26,474804,0.00421185,76.91550058
2750,舞蹈,26,474830,0.00421185,76.91971243
2751,蒐集,26,474856,0.00421185,76.92392428
2752,認定,26,474882,0.00421185,76.92813613
2753,劉德華,26,474908,0.00421185,76.93234798
2754,罷,26,474934,0.00421185,76.93655983
2755,衝,26,474960,0.00421185,76.94077168
2756,豬,26,474986,0.00421185,76.94498353
2757,賭客,26,475012,0.00421185,76.94919537
2758,駐,26,475038,0.00421185,76.95340722
2759,據說,26,475064,0.00421185,76.95761907
2760,縣市,26,475090,0.00421185,76.96183092
2761,罹患,26,475116,0.00421185,76.96604277
2762,賴,26,475142,0.00421185,76.97025462
2763,優良,26,475168,0.00421185,76.97446647
2764,儲存,26,475194,0.00421185,76.97867832
2765,牆,26,475220,0.00421185,76.98289017
2766,聰明,26,475246,0.00421185,76.98710202
2767,繞,26,475272,0.00421185,76.99131387
2768,騎,26,475298,0.00421185,76.99552572
2769,屬性,26,475324,0.00421185,76.99973757
2770,顧問,26,475350,0.00421185,77.00394942
2771,顯著,26,475376,0.00421185,77.00816127
2772,大自然,25,475401,0.00404986,77.01221112
2773,工,25,475426,0.00404986,77.01626098
2774,工業區,25,475451,0.00404986,77.02031083
2775,己,25,475476,0.00404986,77.02436069
2776,不及,25,475501,0.00404986,77.02841055
2777,不見,25,475526,0.00404986,77.03246040
2778,中華,25,475551,0.00404986,77.03651026
2779,公債,25,475576,0.00404986,77.04056011
2780,支撐,25,475601,0.00404986,77.04460997
2781,世,25,475626,0.00404986,77.04865982
2782,主辦,25,475651,0.00404986,77.05270968
2783,冊,25,475676,0.00404986,77.05675953
2784,出色,25,475701,0.00404986,77.06080939
2785,刊登,25,475726,0.00404986,77.06485924
2786,外型,25,475751,0.00404986,77.06890910
2787,巨大,25,475776,0.00404986,77.07295895
2788,布瑞爾,25,475801,0.00404986,77.07700881
2789,生物,25,475826,0.00404986,77.08105866
2790,生涯,25,475851,0.00404986,77.08510852
2791,用來,25,475876,0.00404986,77.08915838
2792,先進,25,475901,0.00404986,77.09320823
2793,吋,25,475926,0.00404986,77.09725809
2794,好奇,25,475951,0.00404986,77.10130794
2795,安打,25,475976,0.00404986,77.10535780
2796,收集,25,476001,0.00404986,77.10940765
2797,有無,25,476026,0.00404986,77.11345751
2798,考驗,25,476051,0.00404986,77.11750736
2799,住宅,25,476076,0.00404986,77.12155722
2800,兌換,25,476101,0.00404986,77.12560707
2801,冷,25,476126,0.00404986,77.12965693
2802,利息,25,476151,0.00404986,77.13370678
2803,改進,25,476176,0.00404986,77.13775664
2804,攻,25,476201,0.00404986,77.14180649
2805,角,25,476226,0.00404986,77.14585635
2806,爸爸,25,476251,0.00404986,77.14990621
2807,近年來,25,476276,0.00404986,77.15395606
2808,前年,25,476301,0.00404986,77.15800592
2809,威力,25,476326,0.00404986,77.16205577
2810,室,25,476351,0.00404986,77.16610563
2811,查,25,476376,0.00404986,77.17015548
2812,科,25,476401,0.00404986,77.17420534
2813,美味,25,476426,0.00404986,77.17825519
2814,若干,25,476451,0.00404986,77.18230505
2815,陌生,25,476476,0.00404986,77.18635490
2816,首次,25,476501,0.00404986,77.19040476
2817,首度,25,476526,0.00404986,77.19445461
2818,害怕,25,476551,0.00404986,77.19850447
2819,庫存,25,476576,0.00404986,77.20255432
2820,氣球,25,476601,0.00404986,77.20660418
2821,神經,25,476626,0.00404986,77.21065404
2822,缺點,25,476651,0.00404986,77.21470389
2823,郝,25,476676,0.00404986,77.21875375
2824,國產,25,476701,0.00404986,77.22280360
2825,堆,25,476726,0.00404986,77.22685346
2826,強大,25,476751,0.00404986,77.23090331
2827,得知,25,476776,0.00404986,77.23495317
2828,族,25,476801,0.00404986,77.23900302
2829,淨值,25,476826,0.00404986,77.24305288
2830,理性,25,476851,0.00404986,77.24710273
2831,現代人,25,476876,0.00404986,77.25115259
2832,軟,25,476901,0.00404986,77.25520244
2833,雪茄,25,476926,0.00404986,77.25925230
2834,傑出,25,476951,0.00404986,77.26330215
2835,牌,25,476976,0.00404986,77.26735201
2836,硬,25,477001,0.00404986,77.27140187
2837,評審,25,477026,0.00404986,77.27545172
2838,進去,25,477051,0.00404986,77.27950158
2839,進駐,25,477076,0.00404986,77.28355143
2840,鈔票,25,477101,0.00404986,77.28760129
2841,鈣質,25,477126,0.00404986,77.29165114
2842,意味,25,477151,0.00404986,77.29570100
2843,農藥,25,477176,0.00404986,77.29975085
2844,團隊,25,477201,0.00404986,77.30380071
2845,截,25,477226,0.00404986,77.30785056
2846,輕輕,25,477251,0.00404986,77.31190042
2847,領土,25,477276,0.00404986,77.31595027
2848,領導人,25,477301,0.00404986,77.32000013
2849,廣場,25,477326,0.00404986,77.32404998
2850,談話,25,477351,0.00404986,77.32809984
2851,器官,25,477376,0.00404986,77.33214970
2852,學員,25,477401,0.00404986,77.33619955
2853,據點,25,477426,0.00404986,77.34024941
2854,整個,25,477451,0.00404986,77.34429926
2855,輸入,25,477476,0.00404986,77.34834912
2856,輸出,25,477501,0.00404986,77.35239897
2857,營業稅,25,477526,0.00404986,77.35644883
2858,總統大選,25,477551,0.00404986,77.36049868
2859,總部,25,477576,0.00404986,77.36454854
2860,翻,25,477601,0.00404986,77.36859839
2861,簽,25,477626,0.00404986,77.37264825
2862,權益,25,477651,0.00404986,77.37669810
2863,一片,24,477675,0.00388786,77.38058597
2864,人間,24,477699,0.00388786,77.38447383
2865,口味,24,477723,0.00388786,77.38836169
2866,不在,24,477747,0.00388786,77.39224955
2867,不然,24,477771,0.00388786,77.39613741
2868,內閣,24,477795,0.00388786,77.40002527
2869,公共工程,24,477819,0.00388786,77.40391313
2870,分開,24,477843,0.00388786,77.40780099
2871,化學,24,477867,0.00388786,77.41168885
2872,巴黎,24,477891,0.00388786,77.41557672
2873,比如,24,477915,0.00388786,77.41946458
2874,出國,24,477939,0.00388786,77.42335244
2875,加工,24,477963,0.00388786,77.42724030
2876,半導體,24,477987,0.00388786,77.43112816
2877,古老,24,478011,0.00388786,77.43501602
2878,市面,24,478035,0.00388786,77.43890388
2879,正好,24,478059,0.00388786,77.44279174
2880,印尼,24,478083,0.00388786,77.44667960
2881,印度,24,478107,0.00388786,77.45056747
2882,同期,24,478131,0.00388786,77.45445533
2883,回升,24,478155,0.00388786,77.45834319
2884,存取,24,478179,0.00388786,77.46223105
2885,成交量,24,478203,0.00388786,77.46611891
2886,成長率,24,478227,0.00388786,77.47000677
2887,收購,24,478251,0.00388786,77.47389463
2888,旭通,24,478275,0.00388786,77.47778249
2889,完工,24,478299,0.00388786,77.48167035
2890,宏國,24,478323,0.00388786,77.48555822
2891,折扣,24,478347,0.00388786,77.48944608
2892,步驟,24,478371,0.00388786,77.49333394
2893,身份,24,478395,0.00388786,77.49722180
2894,身邊,24,478419,0.00388786,77.50110966
2895,車廠,24,478443,0.00388786,77.50499752
2896,典禮,24,478467,0.00388786,77.50888538
2897,居然,24,478491,0.00388786,77.51277324
2898,法令,24,478515,0.00388786,77.51666110
2899,法官,24,478539,0.00388786,77.52054897
2900,法案,24,478563,0.00388786,77.52443683
2901,建造,24,478587,0.00388786,77.52832469
2902,指責,24,478611,0.00388786,77.53221255
2903,洋蔥,24,478635,0.00388786,77.53610041
2904,科學家,24,478659,0.00388786,77.53998827
2905,負面,24,478683,0.00388786,77.54387613
2906,凌晨,24,478707,0.00388786,77.54776399
2907,員警,24,478731,0.00388786,77.55165185
2908,徐立德,24,478755,0.00388786,77.55553972
2909,時常,24,478779,0.00388786,77.55942758
2910,格,24,478803,0.00388786,77.56331544
2911,氣勢,24,478827,0.00388786,77.56720330
2912,神壇,24,478851,0.00388786,77.57109116
2913,秘密,24,478875,0.00388786,77.57497902
2914,納入,24,478899,0.00388786,77.57886688
2915,記得,24,478923,0.00388786,77.58275474
2916,貢獻,24,478947,0.00388786,77.58664261
2917,馬來西亞,24,478971,0.00388786,77.59053047
2918,強力,24,478995,0.00388786,77.59441833
2919,盛,24,479019,0.00388786,77.59830619
2920,票房,24,479043,0.00388786,77.60219405
2921,細菌,24,479067,0.00388786,77.60608191
2922,設計師,24,479091,0.00388786,77.60996977
2923,販賣,24,479115,0.00388786,77.61385763
2924,這裡,24,479139,0.00388786,77.61774549
2925,陪,24,479163,0.00388786,77.62163336
2926,頂,24,479187,0.00388786,77.62552122
2927,勝利,24,479211,0.00388786,77.62940908
2928,描繪,24,479235,0.00388786,77.63329694
2929,普通,24,479259,0.00388786,77.63718480
2930,景,24,479283,0.00388786,77.64107266
2931,港口,24,479307,0.00388786,77.64496052
2932,登,24,479331,0.00388786,77.64884838
2933,絨毛,24,479355,0.00388786,77.65273624
2934,開啟,24,479379,0.00388786,77.65662411
2935,黑,24,479403,0.00388786,77.66051197
2936,塑造,24,479427,0.00388786,77.66439983
2937,新鮮,24,479451,0.00388786,77.66828769
2938,溫,24,479475,0.00388786,77.67217555
2939,當局,24,479499,0.00388786,77.67606341
2940,資深,24,479523,0.00388786,77.67995127
2941,跡象,24,479547,0.00388786,77.68383913
2942,圖像,24,479571,0.00388786,77.68772699
2943,夥伴,24,479595,0.00388786,77.69161486
2944,對抗,24,479619,0.00388786,77.69550272
2945,管,24,479643,0.00388786,77.69939058
2946,精緻,24,479667,0.00388786,77.70327844
2947,輔導,24,479691,0.00388786,77.70716630
2948,遠離,24,479715,0.00388786,77.71105416
2949,增添,24,479739,0.00388786,77.71494202
2950,數位,24,479763,0.00388786,77.71882988
2951,暴力,24,479787,0.00388786,77.72271774
2952,模樣,24,479811,0.00388786,77.72660561
2953,樂章,24,479835,0.00388786,77.73049347
2954,熱情,24,479859,0.00388786,77.73438133
2955,熱量,24,479883,0.00388786,77.73826919
2956,熱鬧,24,479907,0.00388786,77.74215705
2957,練,24,479931,0.00388786,77.74604491
2958,論文,24,479955,0.00388786,77.74993277
2959,憲法,24,479979,0.00388786,77.75382063
2960,燈,24,480003,0.00388786,77.75770849
2961,隨後,24,480027,0.00388786,77.76159636
2962,優惠,24,480051,0.00388786,77.76548422
2963,擠,24,480075,0.00388786,77.76937208
2964,邀,24,480099,0.00388786,77.77325994
2965,擺脫,24,480123,0.00388786,77.77714780
2966,醫,24,480147,0.00388786,77.78103566
2967,爆發,24,480171,0.00388786,77.78492352
2968,繳,24,480195,0.00388786,77.78881138
2969,護士,24,480219,0.00388786,77.79269924
2970,魔法,24,480243,0.00388786,77.79658711
2971,一貫,23,480266,0.00372587,77.80031297
2972,人數,23,480289,0.00372587,77.80403884
2973,上場,23,480312,0.00372587,77.80776471
2974,大力,23,480335,0.00372587,77.81149057
2975,大批,23,480358,0.00372587,77.81521644
2976,不孕,23,480381,0.00372587,77.81894231
2977,不安,23,480404,0.00372587,77.82266817
2978,不宜,23,480427,0.00372587,77.82639404
2979,不曾,23,480450,0.00372587,77.83011991
2980,不禁,23,480473,0.00372587,77.83384578
2981,中常委,23,480496,0.00372587,77.83757164
2982,介面,23,480519,0.00372587,77.84129751
2983,公公,23,480542,0.00372587,77.84502338
2984,少女,23,480565,0.00372587,77.84874924
2985,支付,23,480588,0.00372587,77.85247511
2986,文明,23,480611,0.00372587,77.85620098
2987,王子,23,480634,0.00372587,77.85992684
2988,主演,23,480657,0.00372587,77.86365271
2989,以來,23,480680,0.00372587,77.86737858
2990,冬天,23,480703,0.00372587,77.87110444
2991,半年,23,480726,0.00372587,77.87483031
2992,去世,23,480749,0.00372587,77.87855618
2993,失望,23,480772,0.00372587,77.88228204
2994,石頭,23,480795,0.00372587,77.88600791
2995,交往,23,480818,0.00372587,77.88973378
2996,各種,23,480841,0.00372587,77.89345965
2997,合格,23,480864,0.00372587,77.89718551
2998,回到,23,480887,0.00372587,77.90091138
2999,回憶,23,480910,0.00372587,77.90463725
3000,多媒體,23,480933,0.00372587,77.90836311
3001,年級,23,480956,0.00372587,77.91208898
3002,自動化,23,480979,0.00372587,77.91581485
3003,伸展,23,481002,0.00372587,77.91954071
3004,低迷,23,481025,0.00372587,77.92326658
3005,吸,23,481048,0.00372587,77.92699245
3006,依賴,23,481071,0.00372587,77.93071831
3007,依舊,23,481094,0.00372587,77.93444418
3008,刷子,23,481117,0.00372587,77.93817005
3009,呼吸,23,481140,0.00372587,77.94189592
3010,周圍,23,481163,0.00372587,77.94562178
3011,周邊,23,481186,0.00372587,77.94934765
3012,命,23,481209,0.00372587,77.95307352
3013,妻子,23,481232,0.00372587,77.95679938
3014,往來,23,481255,0.00372587,77.96052525
3015,忽視,23,481278,0.00372587,77.96425112
3016,性格,23,481301,0.00372587,77.96797698
3017,房,23,481324,0.00372587,77.97170285
3018,承受,23,481347,0.00372587,77.97542872
3019,拓展,23,481370,0.00372587,77.97915458
3020,押,23,481393,0.00372587,77.98288045
3021,拆除,23,481416,0.00372587,77.98660632
3022,放大,23,481439,0.00372587,77.99033219
3023,果然,23,481462,0.00372587,77.99405805
3024,武,23,481485,0.00372587,77.99778392
3025,注重,23,481508,0.00372587,78.00150979
3026,治,23,481531,0.00372587,78.00523565
3027,肢體,23,481554,0.00372587,78.00896152
3028,股權,23,481577,0.00372587,78.01268739
3029,近年,23,481600,0.00372587,78.01641325
3030,冠,23,481623,0.00372587,78.02013912
3031,勇,23,481646,0.00372587,78.02386499
3032,姿勢,23,481669,0.00372587,78.02759085
3033,相較,23,481692,0.00372587,78.03131672
3034,若是,23,481715,0.00372587,78.03504259
3035,訂購,23,481738,0.00372587,78.03876846
3036,革命,23,481761,0.00372587,78.04249432
3037,音,23,481784,0.00372587,78.04622019
3038,風味,23,481807,0.00372587,78.04994606
3039,風氣,23,481830,0.00372587,78.05367192
3040,風潮,23,481853,0.00372587,78.05739779
3041,個人電腦,23,481876,0.00372587,78.06112366
3042,家長,23,481899,0.00372587,78.06484952
3043,展望,23,481922,0.00372587,78.06857539
3044,捕捉,23,481945,0.00372587,78.07230126
3045,時段,23,481968,0.00372587,78.07602712
3046,校長,23,481991,0.00372587,78.07975299
3047,配樂,23,482014,0.00372587,78.08347886
3048,高速公路,23,482037,0.00372587,78.08720473
3049,商機,23,482060,0.00372587,78.09093059
3050,將是,23,482083,0.00372587,78.09465646
3051,從來,23,482106,0.00372587,78.09838233
3052,情人,23,482129,0.00372587,78.10210819
3053,啟動,23,482152,0.00372587,78.10583406
3054,敏感,23,482175,0.00372587,78.10955993
3055,清潔,23,482198,0.00372587,78.11328579
3056,率領,23,482221,0.00372587,78.11701166
3057,異,23,482244,0.00372587,78.12073753
3058,處分,23,482267,0.00372587,78.12446339
3059,被害人,23,482290,0.00372587,78.12818926
3060,陰影,23,482313,0.00372587,78.13191513
3061,創新,23,482336,0.00372587,78.13564099
3062,提早,23,482359,0.00372587,78.13936686
3063,提前,23,482382,0.00372587,78.14309273
3064,湖,23,482405,0.00372587,78.14681860
3065,無疑,23,482428,0.00372587,78.15054446
3066,發燒,23,482451,0.00372587,78.15427033
3067,答應,23,482474,0.00372587,78.15799620
3068,華人,23,482497,0.00372587,78.16172206
3069,費,23,482520,0.00372587,78.16544793
3070,隊員,23,482543,0.00372587,78.16917380
3071,黃金,23,482566,0.00372587,78.17289966
3072,黃品源,23,482589,0.00372587,78.17662553
3073,傳輸,23,482612,0.00372587,78.18035140
3074,勢必,23,482635,0.00372587,78.18407726
3075,搬,23,482658,0.00372587,78.18780313
3076,搜尋,23,482681,0.00372587,78.19152900
3077,源,23,482704,0.00372587,78.19525487
3078,溫暖,23,482727,0.00372587,78.19898073
3079,詩,23,482750,0.00372587,78.20270660
3080,過濾,23,482773,0.00372587,78.20643247
3081,圖形,23,482796,0.00372587,78.21015833
3082,精彩,23,482819,0.00372587,78.21388420
3083,臺灣,23,482842,0.00372587,78.21761007
3084,認真,23,482865,0.00372587,78.22133593
3085,認證,23,482888,0.00372587,78.22506180
3086,齊,23,482911,0.00372587,78.22878767
3087,數目,23,482934,0.00372587,78.23251353
3088,模擬,23,482957,0.00372587,78.23623940
3089,熟,23,482980,0.00372587,78.23996527
3090,賣出,23,483003,0.00372587,78.24369114
3091,適用,23,483026,0.00372587,78.24741700
3092,駕駛,23,483049,0.00372587,78.25114287
3093,戰機,23,483072,0.00372587,78.25486874
3094,餐桌,23,483095,0.00372587,78.25859460
3095,總裁,23,483118,0.00372587,78.26232047
3096,講究,23,483141,0.00372587,78.26604634
3097,講話,23,483164,0.00372587,78.26977220
3098,簡直,23,483187,0.00372587,78.27349807
3099,關中,23,483210,0.00372587,78.27722394
3100,齣,23,483233,0.00372587,78.28094980
3101,響,23,483256,0.00372587,78.28467567
3102,觀賞,23,483279,0.00372587,78.28840154
3103,一度,22,483301,0.00356387,78.29196541
3104,一時,22,483323,0.00356387,78.29552928
3105,一路,22,483345,0.00356387,78.29909316
3106,人家,22,483367,0.00356387,78.30265703
3107,下面,22,483389,0.00356387,78.30622090
3108,工作者,22,483411,0.00356387,78.30978477
3109,不肯,22,483433,0.00356387,78.31334865
3110,公克,22,483455,0.00356387,78.31691252
3111,公噸,22,483477,0.00356387,78.32047639
3112,天地,22,483499,0.00356387,78.32404027
3113,夫妻,22,483521,0.00356387,78.32760414
3114,廿,22,483543,0.00356387,78.33116801
3115,文學,22,483565,0.00356387,78.33473188
3116,日圓,22,483587,0.00356387,78.33829576
3117,水果,22,483609,0.00356387,78.34185963
3118,世人,22,483631,0.00356387,78.34542350
3119,功課,22,483653,0.00356387,78.34898737
3120,北部,22,483675,0.00356387,78.35255125
3121,卡通,22,483697,0.00356387,78.35611512
3122,平,22,483719,0.00356387,78.35967899
3123,犯,22,483741,0.00356387,78.36324286
3124,丟,22,483763,0.00356387,78.36680674
3125,先後,22,483785,0.00356387,78.37037061
3126,合併,22,483807,0.00356387,78.37393448
3127,地中海型貧血,22,483829,0.00356387,78.37749836
3128,收益,22,483851,0.00356387,78.38106223
3129,自從,22,483873,0.00356387,78.38462610
3130,位元,22,483895,0.00356387,78.38818997
3131,局部,22,483917,0.00356387,78.39175385
3132,找尋,22,483939,0.00356387,78.39531772
3133,更加,22,483961,0.00356387,78.39888159
3134,更新,22,483983,0.00356387,78.40244546
3135,走向,22,484005,0.00356387,78.40600934
3136,使得,22,484027,0.00356387,78.40957321
3137,函式,22,484049,0.00356387,78.41313708
3138,命令,22,484071,0.00356387,78.41670096
3139,季後賽,22,484093,0.00356387,78.42026483
3140,東方,22,484115,0.00356387,78.42382870
3141,法院,22,484137,0.00356387,78.42739257
3142,爸,22,484159,0.00356387,78.43095645
3143,狗,22,484181,0.00356387,78.43452032
3144,亮麗,22,484203,0.00356387,78.43808419
3145,保養品,22,484225,0.00356387,78.44164806
3146,前進,22,484247,0.00356387,78.44521194
3147,幽默,22,484269,0.00356387,78.44877581
3148,挑,22,484291,0.00356387,78.45233968
3149,珍貴,22,484313,0.00356387,78.45590356
3150,相撲,22,484335,0.00356387,78.45946743
3151,紅色,22,484357,0.00356387,78.46303130
3152,風貌,22,484379,0.00356387,78.46659517
3153,害,22,484401,0.00356387,78.47015905
3154,恐怖,22,484423,0.00356387,78.47372292
3155,涉嫌,22,484445,0.00356387,78.47728679
3156,特徵,22,484467,0.00356387,78.48085066
3157,財團,22,484489,0.00356387,78.48441454
3158,高科技,22,484511,0.00356387,78.48797841
3159,高峰,22,484533,0.00356387,78.49154228
3160,副總統,22,484555,0.00356387,78.49510615
3161,動員,22,484577,0.00356387,78.49867003
3162,動態,22,484599,0.00356387,78.50223390
3163,婆婆,22,484621,0.00356387,78.50579777
3164,情報,22,484643,0.00356387,78.50936165
3165,理事長,22,484665,0.00356387,78.51292552
3166,處處,22,484687,0.00356387,78.51648939
3167,部長,22,484709,0.00356387,78.52005326
3168,喪失,22,484731,0.00356387,78.52361714
3169,滋味,22,484753,0.00356387,78.52718101
3170,登陸,22,484775,0.00356387,78.53074488
3171,發布,22,484797,0.00356387,78.53430875
3172,程序,22,484819,0.00356387,78.53787263
3173,窗,22,484841,0.00356387,78.54143650
3174,著手,22,484863,0.00356387,78.54500037
3175,開關,22,484885,0.00356387,78.54856425
3176,集體,22,484907,0.00356387,78.55212812
3177,順,22,484929,0.00356387,78.55569199
3178,傳送,22,484951,0.00356387,78.55925586
3179,想要,22,484973,0.00356387,78.56281974
3180,經由,22,484995,0.00356387,78.56638361
3181,裝備,22,485017,0.00356387,78.56994748
3182,農場,22,485039,0.00356387,78.57351135
3183,零件,22,485061,0.00356387,78.57707523
3184,彰化,22,485083,0.00356387,78.58063910
3185,構成,22,485105,0.00356387,78.58420297
3186,演變,22,485127,0.00356387,78.58776684
3187,漫畫,22,485149,0.00356387,78.59133072
3188,精,22,485171,0.00356387,78.59489459
3189,舞,22,485193,0.00356387,78.59845846
3190,說服,22,485215,0.00356387,78.60202234
3191,領導者,22,485237,0.00356387,78.60558621
3192,厲害,22,485259,0.00356387,78.60915008
3193,寬鬆,22,485281,0.00356387,78.61271395
3194,廣播,22,485303,0.00356387,78.61627783
3195,影,22,485325,0.00356387,78.61984170
3196,慶,22,485347,0.00356387,78.62340557
3197,慶祝,22,485369,0.00356387,78.62696944
3198,盤,22,485391,0.00356387,78.63053332
3199,稿,22,485413,0.00356387,78.63409719
3200,衛星,22,485435,0.00356387,78.63766106
3201,談判,22,485457,0.00356387,78.64122494
3202,誕生,22,485479,0.00356387,78.64478881
3203,躺,22,485501,0.00356387,78.64835268
3204,儘量,22,485523,0.00356387,78.65191655
3205,燒,22,485545,0.00356387,78.65548043
3206,選民,22,485567,0.00356387,78.65904430
3207,檢方,22,485589,0.00356387,78.66260817
3208,轉移,22,485611,0.00356387,78.66617204
3209,額度,22,485633,0.00356387,78.66973592
3210,贊助,22,485655,0.00356387,78.67329979
3211,蘋果,22,485677,0.00356387,78.67686366
3212,警察,22,485699,0.00356387,78.68042754
3213,聽說,22,485721,0.00356387,78.68399141
3214,變更,22,485743,0.00356387,78.68755528
3215,變數,22,485765,0.00356387,78.69111915
3216,體制,22,485787,0.00356387,78.69468303
3217,鷹,22,485809,0.00356387,78.69824690
3218,矚目,22,485831,0.00356387,78.70181077
3219,人人,21,485852,0.00340188,78.70521265
3220,人民幣,21,485873,0.00340188,78.70861453
3221,刀,21,485894,0.00340188,78.71201641
3222,小說,21,485915,0.00340188,78.71541829
3223,中常會,21,485936,0.00340188,78.71882016
3224,允許,21,485957,0.00340188,78.72222204
3225,分泌,21,485978,0.00340188,78.72562392
3226,日後,21,485999,0.00340188,78.72902580
3227,日期,21,486020,0.00340188,78.73242768
3228,火星,21,486041,0.00340188,78.73582956
3229,代號,21,486062,0.00340188,78.73923143
3230,加權指數,21,486083,0.00340188,78.74263331
3231,功力,21,486104,0.00340188,78.74603519
3232,本月,21,486125,0.00340188,78.74943707
3233,未必,21,486146,0.00340188,78.75283895
3234,母親節,21,486167,0.00340188,78.75624083
3235,印刷,21,486188,0.00340188,78.75964271
3236,地球,21,486209,0.00340188,78.76304458
3237,多久,21,486230,0.00340188,78.76644646
3238,多麼,21,486251,0.00340188,78.76984834
3239,有意,21,486272,0.00340188,78.77325022
3240,有線,21,486293,0.00340188,78.77665210
3241,江鵬堅,21,486314,0.00340188,78.78005398
3242,低音,21,486335,0.00340188,78.78345585
3243,克服,21,486356,0.00340188,78.78685773
3244,即是,21,486377,0.00340188,78.79025961
3245,困境,21,486398,0.00340188,78.79366149
3246,快門,21,486419,0.00340188,78.79706337
3247,我方,21,486440,0.00340188,78.80046525
3248,攻勢,21,486461,0.00340188,78.80386713
3249,私下,21,486482,0.00340188,78.80726900
3250,取消,21,486503,0.00340188,78.81067088
3251,和諧,21,486524,0.00340188,78.81407276
3252,固然,21,486545,0.00340188,78.81747464
3253,奇怪,21,486566,0.00340188,78.82087652
3254,延續,21,486587,0.00340188,78.82427840
3255,念,21,486608,0.00340188,78.82768028
3256,板橋,21,486629,0.00340188,78.83108215
3257,花費,21,486650,0.00340188,78.83448403
3258,門口,21,486671,0.00340188,78.83788591
3259,青春痘,21,486692,0.00340188,78.84128779
3260,便利,21,486713,0.00340188,78.84468967
3261,星座,21,486734,0.00340188,78.84809155
3262,洽,21,486755,0.00340188,78.85149342
3263,相容,21,486776,0.00340188,78.85489530
3264,看來,21,486797,0.00340188,78.85829718
3265,美國人,21,486818,0.00340188,78.86169906
3266,胖,21,486839,0.00340188,78.86510094
3267,音效,21,486860,0.00340188,78.86850282
3268,風情,21,486881,0.00340188,78.87190470
3269,校,21,486902,0.00340188,78.87530657
3270,核准,21,486923,0.00340188,78.87870845
3271,消化,21,486944,0.00340188,78.88211033
3272,疼痛,21,486965,0.00340188,78.88551221
3273,航空,21,486986,0.00340188,78.88891409
3274,馬力,21,487007,0.00340188,78.89231597
3275,售,21,487028,0.00340188,78.89571784
3276,從前,21,487049,0.00340188,78.89911972
3277,惟,21,487070,0.00340188,78.90252160
3278,教育部,21,487091,0.00340188,78.90592348
3279,淘汰,21,487112,0.00340188,78.90932536
3280,淨化,21,487133,0.00340188,78.91272724
3281,球場,21,487154,0.00340188,78.91612912
3282,眾人,21,487175,0.00340188,78.91953099
3283,蛋白質,21,487196,0.00340188,78.92293287
3284,被告,21,487217,0.00340188,78.92633475
3285,連任,21,487238,0.00340188,78.92973663
3286,逐步,21,487259,0.00340188,78.93313851
3287,喊,21,487280,0.00340188,78.93654039
3288,喜,21,487301,0.00340188,78.93994227
3289,富豪,21,487322,0.00340188,78.94334414
3290,復,21,487343,0.00340188,78.94674602
3291,握,21,487364,0.00340188,78.95014790
3292,換句話說,21,487385,0.00340188,78.95354978
3293,減輕,21,487406,0.00340188,78.95695166
3294,無力,21,487427,0.00340188,78.96035354
3295,萎縮,21,487448,0.00340188,78.96375541
3296,視窗,21,487469,0.00340188,78.96715729
3297,距,21,487490,0.00340188,78.97055917
3298,進出,21,487511,0.00340188,78.97396105
3299,開會,21,487532,0.00340188,78.97736293
3300,雅典,21,487553,0.00340188,78.98076481
3301,傳遞,21,487574,0.00340188,78.98416669
3302,圓,21,487595,0.00340188,78.98756856
3303,歲月,21,487616,0.00340188,78.99097044
3304,禁止,21,487637,0.00340188,78.99437232
3305,腳步,21,487658,0.00340188,78.99777420
3306,腦,21,487679,0.00340188,79.00117608
3307,補助,21,487700,0.00340188,79.00457796
3308,裝飾,21,487721,0.00340188,79.00797983
3309,資本,21,487742,0.00340188,79.01138171
3310,飾演,21,487763,0.00340188,79.01478359
3311,實用,21,487784,0.00340188,79.01818547
3312,監視,21,487805,0.00340188,79.02158735
3313,算是,21,487826,0.00340188,79.02498923
3314,緊急,21,487847,0.00340188,79.02839111
3315,閣揆,21,487868,0.00340188,79.03179298
3316,廣大,21,487889,0.00340188,79.03519486
3317,撐,21,487910,0.00340188,79.03859674
3318,潮流,21,487931,0.00340188,79.04199862
3319,獎項,21,487952,0.00340188,79.04540050
3320,適應,21,487973,0.00340188,79.04880238
3321,器,21,487994,0.00340188,79.05220426
3322,戰力,21,488015,0.00340188,79.05560613
3323,糖,21,488036,0.00340188,79.05900801
3324,親戚,21,488057,0.00340188,79.06240989
3325,優異,21,488078,0.00340188,79.06581177
3326,優點,21,488099,0.00340188,79.06921365
3327,擬,21,488120,0.00340188,79.07261553
3328,檢驗,21,488141,0.00340188,79.07601740
3329,臨,21,488162,0.00340188,79.07941928
3330,薪資,21,488183,0.00340188,79.08282116
3331,謝謝,21,488204,0.00340188,79.08622304
3332,歸,21,488225,0.00340188,79.08962492
3333,職位,21,488246,0.00340188,79.09302680
3334,職務,21,488267,0.00340188,79.09642868
3335,醫藥分業,21,488288,0.00340188,79.09983055
3336,藝術品,21,488309,0.00340188,79.10323243
3337,籌碼,21,488330,0.00340188,79.10663431
3338,攝影家,21,488351,0.00340188,79.11003619
3339,鐵,21,488372,0.00340188,79.11343807
3340,體育,21,488393,0.00340188,79.11683995
3341,一番,20,488413,0.00323988,79.12007983
3342,人潮,20,488433,0.00323988,79.12331972
3343,三商銀,20,488453,0.00323988,79.12655960
3344,大選,20,488473,0.00323988,79.12979948
3345,大膽,20,488493,0.00323988,79.13303937
3346,女士,20,488513,0.00323988,79.13627925
3347,子女,20,488533,0.00323988,79.13951914
3348,小學,20,488553,0.00323988,79.14275902
3349,工程師,20,488573,0.00323988,79.14599890
3350,不對,20,488593,0.00323988,79.14923879
3351,今後,20,488613,0.00323988,79.15247867
3352,公賣局,20,488633,0.00323988,79.15571856
3353,化粧品,20,488653,0.00323988,79.15895844
3354,心臟,20,488673,0.00323988,79.16219833
3355,方針,20,488693,0.00323988,79.16543821
3356,水泥業,20,488713,0.00323988,79.16867809
3357,水墨,20,488733,0.00323988,79.17191798
3358,牛肉麵,20,488753,0.00323988,79.17515786
3359,加倍,20,488773,0.00323988,79.17839775
3360,台北縣,20,488793,0.00323988,79.18163763
3361,台東,20,488813,0.00323988,79.18487752
3362,四周,20,488833,0.00323988,79.18811740
3363,外在,20,488853,0.00323988,79.19135728
3364,市區,20,488873,0.00323988,79.19459717
3365,平面,20,488893,0.00323988,79.19783705
3366,本質,20,488913,0.00323988,79.20107694
3367,民選,20,488933,0.00323988,79.20431682
3368,生理,20,488953,0.00323988,79.20755671
3369,用途,20,488973,0.00323988,79.21079659
3370,仲介,20,488993,0.00323988,79.21403647
3371,企業界,20,489013,0.00323988,79.21727636
3372,多元化,20,489033,0.00323988,79.22051624
3373,年底,20,489053,0.00323988,79.22375613
3374,作風,20,489073,0.00323988,79.22699601
3375,吳敦義,20,489093,0.00323988,79.23023590
3376,形狀,20,489113,0.00323988,79.23347578
3377,形態,20,489133,0.00323988,79.23671566
3378,忘記,20,489153,0.00323988,79.23995555
3379,忍,20,489173,0.00323988,79.24319543
3380,找出,20,489193,0.00323988,79.24643532
3381,改編,20,489213,0.00323988,79.24967520
3382,決,20,489233,0.00323988,79.25291509
3383,男友,20,489253,0.00323988,79.25615497
3384,車商,20,489273,0.00323988,79.25939485
3385,車體,20,489293,0.00323988,79.26263474
3386,那兒,20,489313,0.00323988,79.26587462
3387,事務,20,489333,0.00323988,79.26911451
3388,事項,20,489353,0.00323988,79.27235439
3389,協會,20,489373,0.00323988,79.27559428
3390,卸,20,489393,0.00323988,79.27883416
3391,固,20,489413,0.00323988,79.28207404
3392,奇,20,489433,0.00323988,79.28531393
3393,幸運,20,489453,0.00323988,79.28855381
3394,念頭,20,489473,0.00323988,79.29179370
3395,拖,20,489493,0.00323988,79.29503358
3396,返,20,489513,0.00323988,79.29827347
3397,保險業,20,489533,0.00323988,79.30151335
3398,厚,20,489553,0.00323988,79.30475323
3399,品味,20,489573,0.00323988,79.30799312
3400,建築物,20,489593,0.00323988,79.31123300
3401,思,20,489613,0.00323988,79.31447289
3402,按摩,20,489633,0.00323988,79.31771277
3403,查獲,20,489653,0.00323988,79.32095266
3404,甚麼,20,489673,0.00323988,79.32419254
3405,砂石車,20,489693,0.00323988,79.32743242
3406,研判,20,489713,0.00323988,79.33067231
3407,述,20,489733,0.00323988,79.33391219
3408,夏日,20,489753,0.00323988,79.33715208
3409,挺,20,489773,0.00323988,79.34039196
3410,旁邊,20,489793,0.00323988,79.34363185
3411,珠寶,20,489813,0.00323988,79.34687173
3412,留意,20,489833,0.00323988,79.35011161
3413,純,20,489853,0.00323988,79.35335150
3414,脂肪,20,489873,0.00323988,79.35659138
3415,財經,20,489893,0.00323988,79.35983127
3416,逃,20,489913,0.00323988,79.36307115
3417,配置,20,489933,0.00323988,79.36631104
3418,除了,20,489953,0.00323988,79.36955092
3419,停留,20,489973,0.00323988,79.37279080
3420,做事,20,489993,0.00323988,79.37603069
3421,偶爾,20,490013,0.00323988,79.37927057
3422,副總經理,20,490033,0.00323988,79.38251046
3423,區分,20,490053,0.00323988,79.38575034
3424,商店,20,490073,0.00323988,79.38899023
3425,國小,20,490093,0.00323988,79.39223011
3426,基層,20,490113,0.00323988,79.39546999
3427,強勢,20,490133,0.00323988,79.39870988
3428,授權,20,490153,0.00323988,79.40194976
3429,教師,20,490173,0.00323988,79.40518965
3430,移送,20,490193,0.00323988,79.40842953
3431,逢,20,490213,0.00323988,79.41166942
3432,雪梨,20,490233,0.00323988,79.41490930
3433,喜好,20,490253,0.00323988,79.41814918
3434,悲劇,20,490273,0.00323988,79.42138907
3435,景象,20,490293,0.00323988,79.42462895
3436,暑假,20,490313,0.00323988,79.42786884
3437,渴望,20,490333,0.00323988,79.43110872
3438,焦慮,20,490353,0.00323988,79.43434861
3439,發言,20,490373,0.00323988,79.43758849
3440,發明,20,490393,0.00323988,79.44082837
3441,程,20,490413,0.00323988,79.44406826
3442,象牙,20,490433,0.00323988,79.44730814
3443,鄉公所,20,490453,0.00323988,79.45054803
3444,開車,20,490473,0.00323988,79.45378791
3445,開拓,20,490493,0.00323988,79.45702779
3446,雲林縣,20,490513,0.00323988,79.46026768
3447,黑白,20,490533,0.00323988,79.46350756
3448,嫌犯,20,490553,0.00323988,79.46674745
3449,新竹市,20,490573,0.00323988,79.46998733
3450,碎片,20,490593,0.00323988,79.47322722
3451,經貿,20,490613,0.00323988,79.47646710
3452,試驗,20,490633,0.00323988,79.47970698
3453,農委會,20,490653,0.00323988,79.48294687
3454,雷,20,490673,0.00323988,79.48618675
3455,境界,20,490693,0.00323988,79.48942664
3456,實踐,20,490713,0.00323988,79.49266652
3457,摸,20,490733,0.00323988,79.49590641
3458,漢聲,20,490753,0.00323988,79.49914629
3459,福,20,490773,0.00323988,79.50238617
3460,種子,20,490793,0.00323988,79.50562606
3461,聚,20,490813,0.00323988,79.50886594
3462,誤,20,490833,0.00323988,79.51210583
3463,領帶,20,490853,0.00323988,79.51534571
3464,劇情,20,490873,0.00323988,79.51858560
3465,模型,20,490893,0.00323988,79.52182548
3466,模糊,20,490913,0.00323988,79.52506536
3467,線條,20,490933,0.00323988,79.52830525
3468,輩,20,490953,0.00323988,79.53154513
3469,鞋,20,490973,0.00323988,79.53478502
3470,機車,20,490993,0.00323988,79.53802490
3471,興,20,491013,0.00323988,79.54126479
3472,險,20,491033,0.00323988,79.54450467
3473,頭部,20,491053,0.00323988,79.54774455
3474,館,20,491073,0.00323988,79.55098444
3475,優雅,20,491093,0.00323988,79.55422432
3476,尷尬,20,491113,0.00323988,79.55746421
3477,環保局,20,491133,0.00323988,79.56070409
3478,縮小,20,491153,0.00323988,79.56394398
3479,聯合國,20,491173,0.00323988,79.56718386
3480,臨床,20,491193,0.00323988,79.57042374
3481,避,20,491213,0.00323988,79.57366363
3482,簡,20,491233,0.00323988,79.57690351
3483,醫學,20,491253,0.00323988,79.58014340
3484,獸,20,491273,0.00323988,79.58338328
3485,簽名,20,491293,0.00323988,79.58662317
3486,關懷,20,491313,0.00323988,79.58986305
3487,攝影者,20,491333,0.00323988,79.59310293
3488,體質,20,491353,0.00323988,79.59634282
3489,粧,20,491373,0.00323988,79.59958270
3490,一日,19,491392,0.00307789,79.60266059
3491,人性,19,491411,0.00307789,79.60573848
3492,大人,19,491430,0.00307789,79.60881637
3493,不法,19,491449,0.00307789,79.61189426
3494,不便,19,491468,0.00307789,79.61497215
3495,不景氣,19,491487,0.00307789,79.61805004
3496,不算,19,491506,0.00307789,79.62112793
3497,不懂,19,491525,0.00307789,79.62420582
3498,公寓,19,491544,0.00307789,79.62728371
3499,切換,19,491563,0.00307789,79.63036160
3500,反覆,19,491582,0.00307789,79.63343949
3501,心得,19,491601,0.00307789,79.63651738
3502,手表,19,491620,0.00307789,79.63959527
3503,手指,19,491639,0.00307789,79.64267316
3504,手腕,19,491658,0.00307789,79.64575105
3505,水平,19,491677,0.00307789,79.64882894
3506,王人達,19,491696,0.00307789,79.65190683
3507,王志剛,19,491715,0.00307789,79.65498472
3508,世代,19,491734,0.00307789,79.65806261
3509,出面,19,491753,0.00307789,79.66114050
3510,出院,19,491772,0.00307789,79.66421839
3511,未能,19,491791,0.00307789,79.66729628
3512,正當,19,491810,0.00307789,79.67037417
3513,用地,19,491829,0.00307789,79.67345206
3514,立院,19,491848,0.00307789,79.67652995
3515,交通部,19,491867,0.00307789,79.67960784
3516,任天堂,19,491886,0.00307789,79.68268573
3517,任意,19,491905,0.00307789,79.68576362
3518,地理,19,491924,0.00307789,79.68884151
3519,有機,19,491943,0.00307789,79.69191940
3520,而言,19,491962,0.00307789,79.69499729
3521,自在,19,491981,0.00307789,79.69807518
3522,自覺,19,492000,0.00307789,79.70115307
3523,行列,19,492019,0.00307789,79.70423096
3524,行星,19,492038,0.00307789,79.70730885
3525,位於,19,492057,0.00307789,79.71038674
3526,佔用,19,492076,0.00307789,79.71346464
3527,佈滿,19,492095,0.00307789,79.71654253
3528,判決,19,492114,0.00307789,79.71962042
3529,卵,19,492133,0.00307789,79.72269831
3530,含有,19,492152,0.00307789,79.72577620
3531,均衡,19,492171,0.00307789,79.72885409
3532,改造,19,492190,0.00307789,79.73193198
3533,男士,19,492209,0.00307789,79.73500987
3534,供給,19,492228,0.00307789,79.73808776
3535,弦樂,19,492247,0.00307789,79.74116565
3536,抱持,19,492266,0.00307789,79.74424354
3537,旺季,19,492285,0.00307789,79.74732143
3538,沾,19,492304,0.00307789,79.75039932
3539,波動,19,492323,0.00307789,79.75347721
3540,法規,19,492342,0.00307789,79.75655510
3541,社團,19,492361,0.00307789,79.75963299
3542,股利,19,492380,0.00307789,79.76271088
3543,金融股,19,492399,0.00307789,79.76578877
3544,長久,19,492418,0.00307789,79.76886666
3545,青春,19,492437,0.00307789,79.77194455
3546,非洲,19,492456,0.00307789,79.77502244
3547,信任,19,492475,0.00307789,79.77810033
3548,信仰,19,492494,0.00307789,79.78117822
3549,促使,19,492513,0.00307789,79.78425611
3550,俄國,19,492532,0.00307789,79.78733400
3551,前天,19,492551,0.00307789,79.79041189
3552,勇氣,19,492570,0.00307789,79.79348978
3553,勇敢,19,492589,0.00307789,79.79656767
3554,勉強,19,492608,0.00307789,79.79964556
3555,咳嗽,19,492627,0.00307789,79.80272345
3556,哈納斯,19,492646,0.00307789,79.80580134
3557,宣稱,19,492665,0.00307789,79.80887923
3558,拜會,19,492684,0.00307789,79.81195712
3559,按照,19,492703,0.00307789,79.81503501
3560,春,19,492722,0.00307789,79.81811290
3561,流失,19,492741,0.00307789,79.82119079
3562,流通,19,492760,0.00307789,79.82426868
3563,活力,19,492779,0.00307789,79.82734657
3564,相片,19,492798,0.00307789,79.83042446
3565,看待,19,492817,0.00307789,79.83350235
3566,秋冬,19,492836,0.00307789,79.83658024
3567,紅魽,19,492855,0.00307789,79.83965813
3568,美化,19,492874,0.00307789,79.84273602
3569,美術館,19,492893,0.00307789,79.84581391
3570,致力,19,492912,0.00307789,79.84889180
3571,英,19,492931,0.00307789,79.85196969
3572,音樂家,19,492950,0.00307789,79.85504758
3573,家電,19,492969,0.00307789,79.85812547
3574,島,19,492988,0.00307789,79.86120336
3575,師生,19,493007,0.00307789,79.86428125
3576,師傅,19,493026,0.00307789,79.86735914
3577,料,19,493045,0.00307789,79.87043703
3578,浴場,19,493064,0.00307789,79.87351492
3579,病情,19,493083,0.00307789,79.87659281
3580,祕書長,19,493102,0.00307789,79.87967070
3581,秩序,19,493121,0.00307789,79.88274859
3582,脆弱,19,493140,0.00307789,79.88582648
3583,記載,19,493159,0.00307789,79.88890437
3584,酒精,19,493178,0.00307789,79.89198226
3585,針,19,493197,0.00307789,79.89506015
3586,馬英九,19,493216,0.00307789,79.89813804
3587,乾脆,19,493235,0.00307789,79.90121593
3588,動人,19,493254,0.00307789,79.90429382
3589,唸,19,493273,0.00307789,79.90737171
3590,國防部,19,493292,0.00307789,79.91044960
3591,彩色,19,493311,0.00307789,79.91352749
3592,接獲,19,493330,0.00307789,79.91660538
3593,教育局,19,493349,0.00307789,79.91968327
3594,教室,19,493368,0.00307789,79.92276116
3595,教導,19,493387,0.00307789,79.92583905
3596,涵蓋,19,493406,0.00307789,79.92891694
3597,烹調,19,493425,0.00307789,79.93199483
3598,現況,19,493444,0.00307789,79.93507272
3599,眼影,19,493463,0.00307789,79.93815061
3600,統治,19,493482,0.00307789,79.94122850
3601,貨櫃,19,493501,0.00307789,79.94430639
3602,通貨膨脹,19,493520,0.00307789,79.94738428
3603,就職,19,493539,0.00307789,79.95046217
3604,測,19,493558,0.00307789,79.95354006
3605,發動,19,493577,0.00307789,79.95661795
3606,稅負,19,493596,0.00307789,79.95969584
3607,著重,19,493615,0.00307789,79.96277373
3608,菲律賓,19,493634,0.00307789,79.96585162
3609,視野,19,493653,0.00307789,79.96892951
3610,評,19,493672,0.00307789,79.97200740
3611,微,19,493691,0.00307789,79.97508529
3612,感冒,19,493710,0.00307789,79.97816318
3613,準,19,493729,0.00307789,79.98124107
3614,煩惱,19,493748,0.00307789,79.98431896
3615,義,19,493767,0.00307789,79.98739685
3616,遂,19,493786,0.00307789,79.99047474
3617,違反,19,493805,0.00307789,79.99355263
3618,幕,19,493824,0.00307789,79.99663052
3619,槓桿,19,493843,0.00307789,79.99970841
3620,漁船,19,493862,0.00307789,80.00278630
3621,維修,19,493881,0.00307789,80.00586419
3622,增進,19,493900,0.00307789,80.00894208
3623,憤怒,19,493919,0.00307789,80.01201997
3624,趟,19,493938,0.00307789,80.01509786
3625,鞋子,19,493957,0.00307789,80.01817575
3626,學術,19,493976,0.00307789,80.02125364
3627,擁抱,19,493995,0.00307789,80.02433153
3628,歷經,19,494014,0.00307789,80.02740942
3629,激勵,19,494033,0.00307789,80.03048731
3630,積,19,494052,0.00307789,80.03356520
3631,縣長,19,494071,0.00307789,80.03664309
3632,戲劇,19,494090,0.00307789,80.03972098
3633,聯想,19,494109,0.00307789,80.04279887
3634,擴張,19,494128,0.00307789,80.04587676
3635,題,19,494147,0.00307789,80.04895465
3636,贈品,19,494166,0.00307789,80.05203254
3637,關節,19,494185,0.00307789,80.05511043
3638,難免,19,494204,0.00307789,80.05818832
3639,類別,19,494223,0.00307789,80.06126621
3640,攜帶,19,494242,0.00307789,80.06434410
3641,犧牲,19,494261,0.00307789,80.06742199
3642,權利,19,494280,0.00307789,80.07049988
3643,讀書,19,494299,0.00307789,80.07357777
3644,顯現,19,494318,0.00307789,80.07665566
3645,人格,18,494336,0.00291590,80.07957156
3646,人馬,18,494354,0.00291590,80.08248745
3647,人際,18,494372,0.00291590,80.08540335
3648,下班,18,494390,0.00291590,80.08831925
3649,干擾,18,494408,0.00291590,80.09123514
3650,不已,18,494426,0.00291590,80.09415104
3651,不受,18,494444,0.00291590,80.09706693
3652,不該,18,494462,0.00291590,80.09998283
3653,不願意,18,494480,0.00291590,80.10289872
3654,不變,18,494498,0.00291590,80.10581462
3655,中東,18,494516,0.00291590,80.10873052
3656,中華賓士,18,494534,0.00291590,80.11164641
3657,內建,18,494552,0.00291590,80.11456231
3658,分局,18,494570,0.00291590,80.11747820
3659,分離,18,494588,0.00291590,80.12039410
3660,勿,18,494606,0.00291590,80.12331000
3661,升高,18,494624,0.00291590,80.12622589
3662,及時,18,494642,0.00291590,80.12914179
3663,戶外,18,494660,0.00291590,80.13205768
3664,手續,18,494678,0.00291590,80.13497358
3665,支票,18,494696,0.00291590,80.13788947
3666,片子,18,494714,0.00291590,80.14080537
3667,主因,18,494732,0.00291590,80.14372127
3668,出入,18,494750,0.00291590,80.14663716
3669,刊物,18,494768,0.00291590,80.14955306
3670,功,18,494786,0.00291590,80.15246895
3671,卡片,18,494804,0.00291590,80.15538485
3672,台南縣,18,494822,0.00291590,80.15830075
3673,四處,18,494840,0.00291590,80.16121664
3674,打破,18,494858,0.00291590,80.16413254
3675,正在,18,494876,0.00291590,80.16704843
3676,民意,18,494894,0.00291590,80.16996433
3677,用戶,18,494912,0.00291590,80.17288022
3678,白血球,18,494930,0.00291590,80.17579612
3679,光線,18,494948,0.00291590,80.17871202
3680,先發,18,494966,0.00291590,80.18162791
3681,同理心,18,494984,0.00291590,80.18454381
3682,向來,18,495002,0.00291590,80.18745970
3683,回收,18,495020,0.00291590,80.19037560
3684,回顧,18,495038,0.00291590,80.19329150
3685,地步,18,495056,0.00291590,80.19620739
3686,地檢署,18,495074,0.00291590,80.19912329
3687,好壞,18,495092,0.00291590,80.20203918
3688,收盤,18,495110,0.00291590,80.20495508
3689,曲線,18,495128,0.00291590,80.20787097
3690,行駛,18,495146,0.00291590,80.21078687
3691,西部,18,495164,0.00291590,80.21370277
3692,住戶,18,495182,0.00291590,80.21661866
3693,伸,18,495200,0.00291590,80.21953456
3694,吳,18,495218,0.00291590,80.22245045
3695,吳伯雄,18,495236,0.00291590,80.22536635
3696,忍受,18,495254,0.00291590,80.22828225
3697,抓住,18,495272,0.00291590,80.23119814
3698,改組,18,495290,0.00291590,80.23411404
3699,系,18,495308,0.00291590,80.23702993
3700,車身,18,495326,0.00291590,80.23994583
3701,那時,18,495344,0.00291590,80.24286172
3702,那樣,18,495362,0.00291590,80.24577762
3703,防守,18,495380,0.00291590,80.24869352
3704,兒,18,495398,0.00291590,80.25160941
3705,制,18,495416,0.00291590,80.25452531
3706,受到,18,495434,0.00291590,80.25744120
3707,幸,18,495452,0.00291590,80.26035710
3708,房車,18,495470,0.00291590,80.26327300
3709,招,18,495488,0.00291590,80.26618889
3710,河,18,495506,0.00291590,80.26910479
3711,知名度,18,495524,0.00291590,80.27202068
3712,花蓮,18,495542,0.00291590,80.27493658
3713,保護區,18,495560,0.00291590,80.27785248
3714,冒,18,495578,0.00291590,80.28076837
3715,前提,18,495596,0.00291590,80.28368427
3716,宣示,18,495614,0.00291590,80.28660016
3717,宣告,18,495632,0.00291590,80.28951606
3718,施,18,495650,0.00291590,80.29243195
3719,某些,18,495668,0.00291590,80.29534785
3720,相似,18,495686,0.00291590,80.29826375
3721,眉毛,18,495704,0.00291590,80.30117964
3722,穿著,18,495722,0.00291590,80.30409554
3723,美容,18,495740,0.00291590,80.30701143
3724,美感,18,495758,0.00291590,80.30992733
3725,原理,18,495776,0.00291590,80.31284323
3726,哲學,18,495794,0.00291590,80.31575912
3727,哭,18,495812,0.00291590,80.31867502
3728,哪些,18,495830,0.00291590,80.32159091
3729,容,18,495848,0.00291590,80.32450681
3730,桃園縣,18,495866,0.00291590,80.32742270
3731,海岸,18,495884,0.00291590,80.33033860
3732,特區,18,495902,0.00291590,80.33325450
3733,神祕,18,495920,0.00291590,80.33617039
3734,純粹,18,495938,0.00291590,80.33908629
3735,茵茵,18,495956,0.00291590,80.34200218
3736,財政,18,495974,0.00291590,80.34491808
3737,退,18,495992,0.00291590,80.34783398
3738,針灸,18,496010,0.00291590,80.35074987
3739,高手,18,496028,0.00291590,80.35366577
3740,假日,18,496046,0.00291590,80.35658166
3741,假設,18,496064,0.00291590,80.35949756
3742,堅強,18,496082,0.00291590,80.36241345
3743,基本面,18,496100,0.00291590,80.36532935
3744,基因,18,496118,0.00291590,80.36824525
3745,將近,18,496136,0.00291590,80.37116114
3746,探索,18,496154,0.00291590,80.37407704
3747,採訪,18,496172,0.00291590,80.37699293
3748,排行榜,18,496190,0.00291590,80.37990883
3749,梁柏薰,18,496208,0.00291590,80.38282473
3750,添,18,496226,0.00291590,80.38574062
3751,深深,18,496244,0.00291590,80.38865652
3752,球季,18,496262,0.00291590,80.39157241
3753,理解,18,496280,0.00291590,80.39448831
3754,聆聽,18,496298,0.00291590,80.39740420
3755,蛋,18,496316,0.00291590,80.40032010
3756,都會,18,496334,0.00291590,80.40323600
3757,陳列,18,496352,0.00291590,80.40615189
3758,單元,18,496370,0.00291590,80.40906779
3759,圍標,18,496388,0.00291590,80.41198368
3760,惡,18,496406,0.00291590,80.41489958
3761,散,18,496424,0.00291590,80.41781548
3762,游泳,18,496442,0.00291590,80.42073137
3763,減緩,18,496460,0.00291590,80.42364727
3764,無形,18,496478,0.00291590,80.42656316
3765,無線,18,496496,0.00291590,80.42947906
3766,發育,18,496514,0.00291590,80.43239495
3767,童年,18,496532,0.00291590,80.43531085
3768,腎,18,496550,0.00291590,80.43822675
3769,菜,18,496568,0.00291590,80.44114264
3770,進而,18,496586,0.00291590,80.44405854
3771,鈣,18,496604,0.00291590,80.44697443
3772,傾向,18,496622,0.00291590,80.44989033
3773,想想,18,496640,0.00291590,80.45280623
3774,業餘,18,496658,0.00291590,80.45572212
3775,碗,18,496676,0.00291590,80.45863802
3776,萬一,18,496694,0.00291590,80.46155391
3777,腹部,18,496712,0.00291590,80.46446981
3778,葉,18,496730,0.00291590,80.46738570
3779,資料庫,18,496748,0.00291590,80.47030160
3780,電腦化,18,496766,0.00291590,80.47321750
3781,頓,18,496784,0.00291590,80.47613339
3782,鼓舞,18,496802,0.00291590,80.47904929
3783,奪,18,496820,0.00291590,80.48196518
3784,對比,18,496838,0.00291590,80.48488108
3785,慢跑,18,496856,0.00291590,80.48779698
3786,歌手,18,496874,0.00291590,80.49071287
3787,疑問,18,496892,0.00291590,80.49362877
3788,睡覺,18,496910,0.00291590,80.49654466
3789,廢,18,496928,0.00291590,80.49946056
3790,摩羯座,18,496946,0.00291590,80.50237646
3791,模特兒,18,496964,0.00291590,80.50529235
3792,箱,18,496982,0.00291590,80.50820825
3793,衛生局,18,497000,0.00291590,80.51112414
3794,調味料,18,497018,0.00291590,80.51404004
3795,質,18,497036,0.00291590,80.51695593
3796,質感,18,497054,0.00291590,80.51987183
3797,震撼,18,497072,0.00291590,80.52278773
3798,養,18,497090,0.00291590,80.52570362
3799,壁畫,18,497108,0.00291590,80.52861952
3800,學問,18,497126,0.00291590,80.53153541
3801,擋,18,497144,0.00291590,80.53445131
3802,機能,18,497162,0.00291590,80.53736721
3803,濃,18,497180,0.00291590,80.54028310
3804,融合,18,497198,0.00291590,80.54319900
3805,醒,18,497216,0.00291590,80.54611489
3806,優,18,497234,0.00291590,80.54903079
3807,嚇,18,497252,0.00291590,80.55194668
3808,總代理,18,497270,0.00291590,80.55486258
3809,繁榮,18,497288,0.00291590,80.55777848
3810,聯,18,497306,0.00291590,80.56069437
3811,薪水,18,497324,0.00291590,80.56361027
3812,還要,18,497342,0.00291590,80.56652616
3813,擴大機,18,497360,0.00291590,80.56944206
3814,擴充,18,497378,0.00291590,80.57235796
3815,藍,18,497396,0.00291590,80.57527385
3816,雙手,18,497414,0.00291590,80.57818975
3817,穩,18,497432,0.00291590,80.58110564
3818,辭,18,497450,0.00291590,80.58402154
3819,關西,18,497468,0.00291590,80.58693743
3820,關閉,18,497486,0.00291590,80.58985333
3821,難過,18,497504,0.00291590,80.59276923
3822,籍,18,497522,0.00291590,80.59568512
3823,議會,18,497540,0.00291590,80.59860102
3824,警告,18,497558,0.00291590,80.60151691
3825,釋放,18,497576,0.00291590,80.60443281
3826,靈活,18,497594,0.00291590,80.60734871
3827,靈魂,18,497612,0.00291590,80.61026460
3828,一律,17,497629,0.00275390,80.61301850
3829,一般人,17,497646,0.00275390,80.61577240
3830,一陣子,17,497663,0.00275390,80.61852631
3831,一帶,17,497680,0.00275390,80.62128021
3832,下半年,17,497697,0.00275390,80.62403411
3833,下旬,17,497714,0.00275390,80.62678801
3834,上課,17,497731,0.00275390,80.62954191
3835,士氣,17,497748,0.00275390,80.63229581
3836,大大,17,497765,0.00275390,80.63504972
3837,女主角,17,497782,0.00275390,80.63780362
3838,工夫,17,497799,0.00275390,80.64055752
3839,今晚,17,497816,0.00275390,80.64331142
3840,分析師,17,497833,0.00275390,80.64606532
3841,少男,17,497850,0.00275390,80.64881922
3842,引用,17,497867,0.00275390,80.65157313
3843,心中,17,497884,0.00275390,80.65432703
3844,心裡,17,497901,0.00275390,80.65708093
3845,月經,17,497918,0.00275390,80.65983483
3846,水泥廠,17,497935,0.00275390,80.66258873
3847,加盟,17,497952,0.00275390,80.66534263
3848,北市,17,497969,0.00275390,80.66809654
3849,古代,17,497986,0.00275390,80.67085044
3850,古剎,17,498003,0.00275390,80.67360434
3851,只能,17,498020,0.00275390,80.67635824
3852,外商,17,498037,0.00275390,80.67911214
3853,外勞,17,498054,0.00275390,80.68186604
3854,平日,17,498071,0.00275390,80.68461995
3855,本人,17,498088,0.00275390,80.68737385
3856,用品,17,498105,0.00275390,80.69012775
3857,示範,17,498122,0.00275390,80.69288165
3858,光碟機,17,498139,0.00275390,80.69563555
3859,回頭,17,498156,0.00275390,80.69838945
3860,守備,17,498173,0.00275390,80.70114336
3861,收錄,17,498190,0.00275390,80.70389726
3862,有利,17,498207,0.00275390,80.70665116
3863,米,17,498224,0.00275390,80.70940506
3864,老舊,17,498241,0.00275390,80.71215896
3865,考試院長,17,498258,0.00275390,80.71491286
3866,自身,17,498275,0.00275390,80.71766676
3867,血管,17,498292,0.00275390,80.72042067
3868,住院,17,498309,0.00275390,80.72317457
3869,低落,17,498326,0.00275390,80.72592847
3870,利多,17,498343,0.00275390,80.72868237
3871,吳奇隆,17,498360,0.00275390,80.73143627
3872,局長,17,498377,0.00275390,80.73419017
3873,役,17,498394,0.00275390,80.73694408
3874,扭曲,17,498411,0.00275390,80.73969798
3875,投信,17,498428,0.00275390,80.74245188
3876,身高,17,498445,0.00275390,80.74520578
3877,車禍,17,498462,0.00275390,80.74795968
3878,周人蔘,17,498479,0.00275390,80.75071358
3879,招標,17,498496,0.00275390,80.75346749
3880,拔,17,498513,0.00275390,80.75622139
3881,放入,17,498530,0.00275390,80.75897529
3882,放寬,17,498547,0.00275390,80.76172919
3883,東帝士,17,498564,0.00275390,80.76448309
3884,注意力,17,498581,0.00275390,80.76723699
3885,屏東,17,498598,0.00275390,80.76999090
3886,屍體,17,498615,0.00275390,80.77274480
3887,後果,17,498632,0.00275390,80.77549870
3888,後者,17,498649,0.00275390,80.77825260
3889,政權,17,498666,0.00275390,80.78100650
3890,春天,17,498683,0.00275390,80.78376040
3891,流程,17,498700,0.00275390,80.78651431
3892,盈利,17,498717,0.00275390,80.78926821
3893,衍生,17,498734,0.00275390,80.79202211
3894,迪士尼,17,498751,0.00275390,80.79477601
3895,重量,17,498768,0.00275390,80.79752991
3896,料理,17,498785,0.00275390,80.80028381
3897,時髦,17,498802,0.00275390,80.80303772
3898,氣象,17,498819,0.00275390,80.80579162
3899,病房,17,498836,0.00275390,80.80854552
3900,神父,17,498853,0.00275390,80.81129942
3901,租,17,498870,0.00275390,80.81405332
3902,胸,17,498887,0.00275390,80.81680722
3903,虔誠,17,498904,0.00275390,80.81956113
3904,退休金,17,498921,0.00275390,80.82231503
3905,高價,17,498938,0.00275390,80.82506893
3906,偷,17,498955,0.00275390,80.82782283
3907,執政黨,17,498972,0.00275390,80.83057673
3908,專櫃,17,498989,0.00275390,80.83333063
3909,張振宇,17,499006,0.00275390,80.83608454
3910,強硬,17,499023,0.00275390,80.83883844
3911,得票率,17,499040,0.00275390,80.84159234
3912,捷運,17,499057,0.00275390,80.84434624
3913,救,17,499074,0.00275390,80.84710014
3914,涼,17,499091,0.00275390,80.84985404
3915,淡,17,499108,0.00275390,80.85260794
3916,添加,17,499125,0.00275390,80.85536185
3917,清查,17,499142,0.00275390,80.85811575
3918,清理,17,499159,0.00275390,80.86086965
3919,深夜,17,499176,0.00275390,80.86362355
3920,深度,17,499193,0.00275390,80.86637745
3921,現成,17,499210,0.00275390,80.86913135
3922,累,17,499227,0.00275390,80.87188526
3923,脫,17,499244,0.00275390,80.87463916
3924,脫離,17,499261,0.00275390,80.87739306
3925,通知,17,499278,0.00275390,80.88014696
3926,造勢,17,499295,0.00275390,80.88290086
3927,途徑,17,499312,0.00275390,80.88565476
3928,頂尖,17,499329,0.00275390,80.88840867
3929,創下,17,499346,0.00275390,80.89116257
3930,創辦人,17,499363,0.00275390,80.89391647
3931,勞基法,17,499380,0.00275390,80.89667037
3932,喜悅,17,499397,0.00275390,80.89942427
3933,普及,17,499414,0.00275390,80.90217817
3934,港幣,17,499431,0.00275390,80.90493208
3935,無數,17,499448,0.00275390,80.90768598
3936,絲毫,17,499465,0.00275390,80.91043988
3937,街道,17,499482,0.00275390,80.91319378
3938,詞,17,499499,0.00275390,80.91594768
3939,開心,17,499516,0.00275390,80.91870158
3940,隊友,17,499533,0.00275390,80.92145549
3941,黃培源,17,499550,0.00275390,80.92420939
3942,黑人,17,499567,0.00275390,80.92696329
3943,黑暗,17,499584,0.00275390,80.92971719
3944,傳染,17,499601,0.00275390,80.93247109
3945,傳播,17,499618,0.00275390,80.93522499
3946,匯率,17,499635,0.00275390,80.93797890
3947,塑膠,17,499652,0.00275390,80.94073280
3948,新興,17,499669,0.00275390,80.94348670
3949,會長,17,499686,0.00275390,80.94624060
3950,會期,17,499703,0.00275390,80.94899450
3951,獅隊,17,499720,0.00275390,80.95174840
3952,腹,17,499737,0.00275390,80.95450231
3953,葡萄酒,17,499754,0.00275390,80.95725621
3954,董事,17,499771,0.00275390,80.96001011
3955,詳,17,499788,0.00275390,80.96276401
3956,誇張,17,499805,0.00275390,80.96551791
3957,躲,17,499822,0.00275390,80.96827181
3958,逼,17,499839,0.00275390,80.97102571
3959,頓時,17,499856,0.00275390,80.97377962
3960,漲價,17,499873,0.00275390,80.97653352
3961,監視器,17,499890,0.00275390,80.97928742
3962,精華,17,499907,0.00275390,80.98204132
3963,製品,17,499924,0.00275390,80.98479522
3964,趕快,17,499941,0.00275390,80.98754912
3965,銅,17,499958,0.00275390,80.99030303
3966,樂園,17,499975,0.00275390,80.99305693
3967,緣,17,499992,0.00275390,80.99581083
3968,緩和,17,500009,0.00275390,80.99856473
3969,課題,17,500026,0.00275390,81.00131863
3970,調度,17,500043,0.00275390,81.00407253
3971,賭博,17,500060,0.00275390,81.00682644
3972,學院,17,500077,0.00275390,81.00958034
3973,戰績,17,500094,0.00275390,81.01233424
3974,蕭提,17,500111,0.00275390,81.01508814
3975,融資,17,500128,0.00275390,81.01784204
3976,諮詢,17,500145,0.00275390,81.02059594
3977,頻,17,500162,0.00275390,81.02334985
3978,頻率,17,500179,0.00275390,81.02610375
3979,頻繁,17,500196,0.00275390,81.02885765
3980,彌補,17,500213,0.00275390,81.03161155
3981,應付,17,500230,0.00275390,81.03436545
3982,應用程式,17,500247,0.00275390,81.03711935
3983,總理,17,500264,0.00275390,81.03987326
3984,舉例,17,500281,0.00275390,81.04262716
3985,隱密,17,500298,0.00275390,81.04538106
3986,簡稱,17,500315,0.00275390,81.04813496
3987,懷念,17,500332,0.00275390,81.05088886
3988,爆炸,17,500349,0.00275390,81.05364276
3989,藝人,17,500366,0.00275390,81.05639667
3990,關切,17,500383,0.00275390,81.05915057
3991,難怪,17,500400,0.00275390,81.06190447
3992,籌備,17,500417,0.00275390,81.06465837
3993,聽眾,17,500434,0.00275390,81.06741227
3994,鑑,17,500451,0.00275390,81.07016617
3995,驚訝,17,500468,0.00275390,81.07292008
3996,蠻,17,500485,0.00275390,81.07567398
3997,一同,16,500501,0.00259191,81.07826588
3998,一面,16,500517,0.00259191,81.08085779
3999,一輩子,16,500533,0.00259191,81.08344970
4000,乙,16,500549,0.00259191,81.08604161
4001,刀具,16,500565,0.00259191,81.08863351
4002,下列,16,500581,0.00259191,81.09122542
4003,上山,16,500597,0.00259191,81.09381733
4004,上班族,16,500613,0.00259191,81.09640924
4005,大都,16,500629,0.00259191,81.09900114
4006,女友,16,500645,0.00259191,81.10159305
4007,女星,16,500661,0.00259191,81.10418496
4008,工人,16,500677,0.00259191,81.10677687
4009,工業局,16,500693,0.00259191,81.10936877
4010,不致,16,500709,0.00259191,81.11196068
4011,不容,16,500725,0.00259191,81.11455259
4012,中視,16,500741,0.00259191,81.11714450
4013,中銀,16,500757,0.00259191,81.11973640
4014,什麼樣,16,500773,0.00259191,81.12232831
4015,公告,16,500789,0.00259191,81.12492022
4016,天窗,16,500805,0.00259191,81.12751213
4017,夫婦,16,500821,0.00259191,81.13010403
4018,幻想,16,500837,0.00259191,81.13269594
4019,手中,16,500853,0.00259191,81.13528785
4020,手冊,16,500869,0.00259191,81.13787975
4021,手臂,16,500885,0.00259191,81.14047166
4022,支出,16,500901,0.00259191,81.14306357
4023,月亮,16,500917,0.00259191,81.14565548
4024,水泥,16,500933,0.00259191,81.14824738
4025,出爐,16,500949,0.00259191,81.15083929
4026,四肢,16,500965,0.00259191,81.15343120
4027,外面,16,500981,0.00259191,81.15602311
4028,布朗,16,500997,0.00259191,81.15861501
4029,平台,16,501013,0.00259191,81.16120692
4030,生病,16,501029,0.00259191,81.16379883
4031,生動,16,501045,0.00259191,81.16639074
4032,光明,16,501061,0.00259191,81.16898264
4033,光碟,16,501077,0.00259191,81.17157455
4034,列印,16,501093,0.00259191,81.17416646
4035,同仁,16,501109,0.00259191,81.17675837
4036,各位,16,501125,0.00259191,81.17935027
4037,名詞,16,501141,0.00259191,81.18194218
4038,合適,16,501157,0.00259191,81.18453409
4039,地上,16,501173,0.00259191,81.18712600
4040,地板,16,501189,0.00259191,81.18971790
4041,宇宙,16,501205,0.00259191,81.19230981
4042,成份,16,501221,0.00259191,81.19490172
4043,成效,16,501237,0.00259191,81.19749363
4044,收縮,16,501253,0.00259191,81.20008553
4045,早餐,16,501269,0.00259191,81.20267744
4046,老爸,16,501285,0.00259191,81.20526935
4047,耳,16,501301,0.00259191,81.20786126
4048,自由時報,16,501317,0.00259191,81.21045316
4049,西班牙,16,501333,0.00259191,81.21304507
4050,佛,16,501349,0.00259191,81.21563698
4051,佛教,16,501365,0.00259191,81.21822888
4052,含量,16,501381,0.00259191,81.22082079
4053,妙,16,501397,0.00259191,81.22341270
4054,完善,16,501413,0.00259191,81.22600461
4055,技能,16,501429,0.00259191,81.22859651
4056,扭力,16,501445,0.00259191,81.23118842
4057,投注,16,501461,0.00259191,81.23378033
4058,改良,16,501477,0.00259191,81.23637224
4059,矣,16,501493,0.00259191,81.23896414
4060,走出,16,501509,0.00259191,81.24155605
4061,身心,16,501525,0.00259191,81.24414796
4062,車室,16,501541,0.00259191,81.24673987
4063,那裡,16,501557,0.00259191,81.24933177
4064,到期,16,501573,0.00259191,81.25192368
4065,官,16,501589,0.00259191,81.25451559
4066,居家,16,501605,0.00259191,81.25710750
4067,底價,16,501621,0.00259191,81.25969940
4068,往後,16,501637,0.00259191,81.26229131
4069,承辦,16,501653,0.00259191,81.26488322
4070,抵達,16,501669,0.00259191,81.26747513
4071,明亮,16,501685,0.00259191,81.27006703
4072,服役,16,501701,0.00259191,81.27265894
4073,服務業,16,501717,0.00259191,81.27525085
4074,肩膀,16,501733,0.00259191,81.27784276
4075,迎接,16,501749,0.00259191,81.28043466
4076,保育,16,501765,0.00259191,81.28302657
4077,威廉斯,16,501781,0.00259191,81.28561848
4078,宣佈,16,501797,0.00259191,81.28821039
4079,拜,16,501813,0.00259191,81.29080229
4080,政,16,501829,0.00259191,81.29339420
4081,毒,16,501845,0.00259191,81.29598611
4082,活絡,16,501861,0.00259191,81.29857801
4083,派系,16,501877,0.00259191,81.30116992
4084,洛杉磯,16,501893,0.00259191,81.30376183
4085,珊瑚,16,501909,0.00259191,81.30635374
4086,美軍,16,501925,0.00259191,81.30894564
4087,重覆,16,501941,0.00259191,81.31153755
4088,降價,16,501957,0.00259191,81.31412946
4089,音色,16,501973,0.00259191,81.31672137
4090,香味,16,501989,0.00259191,81.31931327
4091,唇型,16,502005,0.00259191,81.32190518
4092,夏,16,502021,0.00259191,81.32449709
4093,拿來,16,502037,0.00259191,81.32708900
4094,時盛時衰,16,502053,0.00259191,81.32968090
4095,案件,16,502069,0.00259191,81.33227281
4096,消波塊,16,502085,0.00259191,81.33486472
4097,特價,16,502101,0.00259191,81.33745663
4098,破產,16,502117,0.00259191,81.34004853
4099,神奇,16,502133,0.00259191,81.34264044
4100,粉底,16,502149,0.00259191,81.34523235
4101,能不能,16,502165,0.00259191,81.34782426
4102,追查,16,502181,0.00259191,81.35041616
4103,陣容,16,502197,0.00259191,81.35300807
4104,高雄縣,16,502213,0.00259191,81.35559998
4105,副作用,16,502229,0.00259191,81.35819189
4106,副院長,16,502245,0.00259191,81.36078379
4107,匙,16,502261,0.00259191,81.36337570
4108,國語,16,502277,0.00259191,81.36596761
4109,專心,16,502293,0.00259191,81.36855952
4110,張正憲,16,502309,0.00259191,81.37115142
4111,排列,16,502325,0.00259191,81.37374333
4112,啟發,16,502341,0.00259191,81.37633524
4113,晚餐,16,502357,0.00259191,81.37892714
4114,淡水,16,502373,0.00259191,81.38151905
4115,淺,16,502389,0.00259191,81.38411096
4116,清新,16,502405,0.00259191,81.38670287
4117,混,16,502421,0.00259191,81.38929477
4118,粗,16,502437,0.00259191,81.39188668
4119,組裝軟體,16,502453,0.00259191,81.39447859
4120,脖子,16,502469,0.00259191,81.39707050
4121,透,16,502485,0.00259191,81.39966240
4122,透明,16,502501,0.00259191,81.40225431
4123,陳履安,16,502517,0.00259191,81.40484622
4124,喜劇,16,502533,0.00259191,81.40743813
4125,圍,16,502549,0.00259191,81.41003003
4126,報價,16,502565,0.00259191,81.41262194
4127,尊敬,16,502581,0.00259191,81.41521385
4128,悲觀,16,502597,0.00259191,81.41780576
4129,描寫,16,502613,0.00259191,81.42039766
4130,智力,16,502629,0.00259191,81.42298957
4131,焚化爐,16,502645,0.00259191,81.42558148
4132,無尾熊,16,502661,0.00259191,81.42817339
4133,發達,16,502677,0.00259191,81.43076529
4134,發覺,16,502693,0.00259191,81.43335720
4135,稍微,16,502709,0.00259191,81.43594911
4136,稅制,16,502725,0.00259191,81.43854102
4137,結局,16,502741,0.00259191,81.44113292
4138,腎臟,16,502757,0.00259191,81.44372483
4139,華衛,16,502773,0.00259191,81.44631674
4140,街頭,16,502789,0.00259191,81.44890864
4141,註冊,16,502805,0.00259191,81.45150055
4142,買主,16,502821,0.00259191,81.45409246
4143,進攻,16,502837,0.00259191,81.45668437
4144,順序,16,502853,0.00259191,81.45927627
4145,債務,16,502869,0.00259191,81.46186818
4146,僅僅,16,502885,0.00259191,81.46446009
4147,園,16,502901,0.00259191,81.46705200
4148,塗,16,502917,0.00259191,81.46964390
4149,搭乘,16,502933,0.00259191,81.47223581
4150,暗房,16,502949,0.00259191,81.47482772
4151,溫馨,16,502965,0.00259191,81.47741963
4152,獅子,16,502981,0.00259191,81.48001153
4153,當前,16,502997,0.00259191,81.48260344
4154,經濟部長,16,503013,0.00259191,81.48519535
4155,補習班,16,503029,0.00259191,81.48778726
4156,解除,16,503045,0.00259191,81.49037916
4157,誠意,16,503061,0.00259191,81.49297107
4158,運送,16,503077,0.00259191,81.49556298
4159,電子業,16,503093,0.00259191,81.49815489
4160,電池,16,503109,0.00259191,81.50074679
4161,飾,16,503125,0.00259191,81.50333870
4162,像是,16,503141,0.00259191,81.50593061
4163,圖案,16,503157,0.00259191,81.50852252
4164,瑪格,16,503173,0.00259191,81.51111442
4165,監控,16,503189,0.00259191,81.51370633
4166,精品,16,503205,0.00259191,81.51629824
4167,豪華,16,503221,0.00259191,81.51889015
4168,趕緊,16,503237,0.00259191,81.52148205
4169,寬敞,16,503253,0.00259191,81.52407396
4170,寫作,16,503269,0.00259191,81.52666587
4171,廠房,16,503285,0.00259191,81.52925777
4172,撰寫,16,503301,0.00259191,81.53184968
4173,撥,16,503317,0.00259191,81.53444159
4174,暫存器,16,503333,0.00259191,81.53703350
4175,標,16,503349,0.00259191,81.53962540
4176,樓梯,16,503365,0.00259191,81.54221731
4177,樂曲,16,503381,0.00259191,81.54480922
4178,熬,16,503397,0.00259191,81.54740113
4179,範例,16,503413,0.00259191,81.54999303
4180,衝動,16,503429,0.00259191,81.55258494
4181,輪,16,503445,0.00259191,81.55517685
4182,遭受,16,503461,0.00259191,81.55776876
4183,遷,16,503477,0.00259191,81.56036066
4184,銷售量,16,503493,0.00259191,81.56295257
4185,歷,16,503509,0.00259191,81.56554448
4186,興農,16,503525,0.00259191,81.56813639
4187,親切,16,503541,0.00259191,81.57072829
4188,親友,16,503557,0.00259191,81.57332020
4189,親近,16,503573,0.00259191,81.57591211
4190,遺,16,503589,0.00259191,81.57850402
4191,隨便,16,503605,0.00259191,81.58109592
4192,頻道,16,503621,0.00259191,81.58368783
4193,頻寬,16,503637,0.00259191,81.58627974
4194,頭腦,16,503653,0.00259191,81.58887165
4195,營業額,16,503669,0.00259191,81.59146355
4196,環,16,503685,0.00259191,81.59405546
4197,環保署,16,503701,0.00259191,81.59664737
4198,總教練,16,503717,0.00259191,81.59923928
4199,臉部,16,503733,0.00259191,81.60183118
4200,黏,16,503749,0.00259191,81.60442309
4201,擴展,16,503765,0.00259191,81.60701500
4202,斷,16,503781,0.00259191,81.60960690
4203,禮物,16,503797,0.00259191,81.61219881
4204,藉口,16,503813,0.00259191,81.61479072
4205,離去,16,503829,0.00259191,81.61738263
4206,雙子座,16,503845,0.00259191,81.61997453
4207,繳稅,16,503861,0.00259191,81.62256644
4208,譜,16,503877,0.00259191,81.62515835
4209,鏡子,16,503893,0.00259191,81.62775026
4210,關注,16,503909,0.00259191,81.63034216
4211,關係人,16,503925,0.00259191,81.63293407
4212,難得,16,503941,0.00259191,81.63552598
4213,難道,16,503957,0.00259191,81.63811789
4214,籌措,16,503973,0.00259191,81.64070979
4215,譯,16,503989,0.00259191,81.64330170
4216,驅動程式,16,504005,0.00259191,81.64589361
4217,權威,16,504021,0.00259191,81.64848552
4218,一連串,15,504036,0.00242991,81.65091543
4219,三台,15,504051,0.00242991,81.65334534
4220,下方,15,504066,0.00242991,81.65577526
4221,口袋,15,504081,0.00242991,81.65820517
4222,大地,15,504096,0.00242991,81.66063508
4223,大多數,15,504111,0.00242991,81.66306500
4224,大門,15,504126,0.00242991,81.66549491
4225,大氣,15,504141,0.00242991,81.66792482
4226,工務局,15,504156,0.00242991,81.67035473
4227,不合,15,504171,0.00242991,81.67278465
4228,不免,15,504186,0.00242991,81.67521456
4229,不得不,15,504201,0.00242991,81.67764447
4230,不惜,15,504216,0.00242991,81.68007439
4231,不等,15,504231,0.00242991,81.68250430
4232,中旬,15,504246,0.00242991,81.68493421
4233,之中,15,504261,0.00242991,81.68736413
4234,介,15,504276,0.00242991,81.68979404
4235,內政部,15,504291,0.00242991,81.69222395
4236,公元,15,504306,0.00242991,81.69465387
4237,公車,15,504321,0.00242991,81.69708378
4238,友人,15,504336,0.00242991,81.69951369
4239,天天,15,504351,0.00242991,81.70194361
4240,天堂,15,504366,0.00242991,81.70437352
4241,少年,15,504381,0.00242991,81.70680343
4242,心性,15,504396,0.00242991,81.70923335
4243,文化中心,15,504411,0.00242991,81.71166326
4244,日本人,15,504426,0.00242991,81.71409317
4245,木星,15,504441,0.00242991,81.71652309
4246,水面,15,504456,0.00242991,81.71895300
4247,主權,15,504471,0.00242991,81.72138291
4248,凸顯,15,504486,0.00242991,81.72381283
4249,加熱,15,504501,0.00242991,81.72624274
4250,功夫,15,504516,0.00242991,81.72867265
4251,古典,15,504531,0.00242991,81.73110257
4252,四季,15,504546,0.00242991,81.73353248
4253,孕婦,15,504561,0.00242991,81.73596239
4254,市價,15,504576,0.00242991,81.73839230
4255,幼兒,15,504591,0.00242991,81.74082222
4256,必定,15,504606,0.00242991,81.74325213
4257,生氣,15,504621,0.00242991,81.74568204
4258,白人,15,504636,0.00242991,81.74811196
4259,示,15,504651,0.00242991,81.75054187
4260,交配,15,504666,0.00242991,81.75297178
4261,份量,15,504681,0.00242991,81.75540170
4262,吉他,15,504696,0.00242991,81.75783161
4263,名牌,15,504711,0.00242991,81.76026152
4264,回歸,15,504726,0.00242991,81.76269144
4265,成交值,15,504741,0.00242991,81.76512135
4266,成年,15,504756,0.00242991,81.76755126
4267,考試院,15,504771,0.00242991,81.76998118
4268,肉體,15,504786,0.00242991,81.77241109
4269,串,15,504801,0.00242991,81.77484100
4270,伴,15,504816,0.00242991,81.77727092
4271,冷氣,15,504831,0.00242991,81.77970083
4272,冷靜,15,504846,0.00242991,81.78213074
4273,吳俊良,15,504861,0.00242991,81.78456066
4274,尿液,15,504876,0.00242991,81.78699057
4275,希臘人,15,504891,0.00242991,81.78942048
4276,批判,15,504906,0.00242991,81.79185040
4277,村民,15,504921,0.00242991,81.79428031
4278,汽油,15,504936,0.00242991,81.79671022
4279,肚子,15,504951,0.00242991,81.79914013
4280,見面,15,504966,0.00242991,81.80157005
4281,言語,15,504981,0.00242991,81.80399996
4282,走私,15,504996,0.00242991,81.80642987
4283,走路,15,505011,0.00242991,81.80885979
4284,身價,15,505026,0.00242991,81.81128970
4285,身軀,15,505041,0.00242991,81.81371961
4286,車牌,15,505056,0.00242991,81.81614953
4287,那是,15,505071,0.00242991,81.81857944
4288,併發症,15,505086,0.00242991,81.82100935
4289,刮,15,505101,0.00242991,81.82343927
4290,協議,15,505116,0.00242991,81.82586918
4291,味全,15,505131,0.00242991,81.82829909
4292,呼,15,505146,0.00242991,81.83072901
4293,周年,15,505161,0.00242991,81.83315892
4294,奇蹟,15,505176,0.00242991,81.83558883
4295,妻,15,505191,0.00242991,81.83801875
4296,始,15,505206,0.00242991,81.84044866
4297,承擔,15,505221,0.00242991,81.84287857
4298,招式,15,505236,0.00242991,81.84530849
4299,朋馳,15,505251,0.00242991,81.84773840
4300,東區,15,505266,0.00242991,81.85016831
4301,東部,15,505281,0.00242991,81.85259823
4302,武士,15,505296,0.00242991,81.85502814
4303,注射,15,505311,0.00242991,81.85745805
4304,油畫,15,505326,0.00242991,81.85988796
4305,金星,15,505341,0.00242991,81.86231788
4306,長久以來,15,505356,0.00242991,81.86474779
4307,前景,15,505371,0.00242991,81.86717770
4308,南方,15,505386,0.00242991,81.86960762
4309,咬,15,505401,0.00242991,81.87203753
4310,奏,15,505416,0.00242991,81.87446744
4311,客觀,15,505431,0.00242991,81.87689736
4312,度假,15,505446,0.00242991,81.87932727
4313,後座,15,505461,0.00242991,81.88175718
4314,思索,15,505476,0.00242991,81.88418710
4315,怎,15,505491,0.00242991,81.88661701
4316,怎樣,15,505506,0.00242991,81.88904692
4317,政局,15,505521,0.00242991,81.89147684
4318,毒品,15,505536,0.00242991,81.89390675
4319,約會,15,505551,0.00242991,81.89633666
4320,迫,15,505566,0.00242991,81.89876658
4321,面前,15,505581,0.00242991,81.90119649
4322,面貌,15,505596,0.00242991,81.90362640
4323,面膜,15,505611,0.00242991,81.90605632
4324,香港人,15,505626,0.00242991,81.90848623
4325,乘,15,505641,0.00242991,81.91091614
4326,倚天,15,505656,0.00242991,81.91334606
4327,倘若,15,505671,0.00242991,81.91577597
4328,修行,15,505686,0.00242991,81.91820588
4329,唇,15,505701,0.00242991,81.92063579
4330,夏季,15,505716,0.00242991,81.92306571
4331,容納,15,505731,0.00242991,81.92549562
4332,座車,15,505746,0.00242991,81.92792553
4333,徒,15,505761,0.00242991,81.93035545
4334,時空,15,505776,0.00242991,81.93278536
4335,時時,15,505791,0.00242991,81.93521527
4336,時脈,15,505806,0.00242991,81.93764519
4337,時報,15,505821,0.00242991,81.94007510
4338,海鮮,15,505836,0.00242991,81.94250501
4339,海邊,15,505851,0.00242991,81.94493493
4340,海灘,15,505866,0.00242991,81.94736484
4341,特地,15,505881,0.00242991,81.94979475
4342,畔,15,505896,0.00242991,81.95222467
4343,神聖,15,505911,0.00242991,81.95465458
4344,紗,15,505926,0.00242991,81.95708449
4345,財政部長,15,505941,0.00242991,81.95951441
4346,退稅,15,505956,0.00242991,81.96194432
4347,追逐,15,505971,0.00242991,81.96437423
4348,骨,15,505986,0.00242991,81.96680415
4349,停車,15,506001,0.00242991,81.96923406
4350,偵測,15,506016,0.00242991,81.97166397
4351,剪,15,506031,0.00242991,81.97409389
4352,曼谷,15,506046,0.00242991,81.97652380
4353,國防,15,506061,0.00242991,81.97895371
4354,堂,15,506076,0.00242991,81.98138362
4355,密度,15,506091,0.00242991,81.98381354
4356,密集,15,506106,0.00242991,81.98624345
4357,專注,15,506121,0.00242991,81.98867336
4358,強制,15,506136,0.00242991,81.99110328
4359,情節,15,506151,0.00242991,81.99353319
4360,接下來,15,506166,0.00242991,81.99596310
4361,捧,15,506181,0.00242991,81.99839302
4362,排水,15,506196,0.00242991,82.00082293
4363,排出,15,506211,0.00242991,82.00325284
4364,教堂,15,506226,0.00242991,82.00568276
4365,桶,15,506241,0.00242991,82.00811267
4366,殺價,15,506256,0.00242991,82.01054258
4367,清真寺,15,506271,0.00242991,82.01297250
4368,產銷,15,506286,0.00242991,82.01540241
4369,眼線,15,506301,0.00242991,82.01783232
4370,粒子,15,506316,0.00242991,82.02026224
4371,聊,15,506331,0.00242991,82.02269215
4372,莊嚴,15,506346,0.00242991,82.02512206
4373,訪,15,506361,0.00242991,82.02755198
4374,連鎖,15,506376,0.00242991,82.02998189
4375,陪同,15,506391,0.00242991,82.03241180
4376,陰道,15,506406,0.00242991,82.03484172
4377,陷,15,506421,0.00242991,82.03727163
4378,創辦,15,506436,0.00242991,82.03970154
4379,場景,15,506451,0.00242991,82.04213146
4380,帽子,15,506466,0.00242991,82.04456137
4381,掌控,15,506481,0.00242991,82.04699128
4382,期限,15,506496,0.00242991,82.04942119
4383,椅子,15,506511,0.00242991,82.05185111
4384,殘骸,15,506526,0.00242991,82.05428102
4385,殖民地,15,506541,0.00242991,82.05671093
4386,痘痘,15,506556,0.00242991,82.05914085
4387,稅捐處,15,506571,0.00242991,82.06157076
4388,答覆,15,506586,0.00242991,82.06400067
4389,視訊,15,506601,0.00242991,82.06643059
4390,貴賓,15,506616,0.00242991,82.06886050
4391,買氣,15,506631,0.00242991,82.07129041
4392,跌價,15,506646,0.00242991,82.07372033
4393,週邊,15,506661,0.00242991,82.07615024
4394,開設,15,506676,0.00242991,82.07858015
4395,雲,15,506691,0.00242991,82.08101007
4396,黃崇仁,15,506706,0.00242991,82.08343998
4397,債權人,15,506721,0.00242991,82.08586989
4398,傳奇,15,506736,0.00242991,82.08829981
4399,新店,15,506751,0.00242991,82.09072972
4400,暗示,15,506766,0.00242991,82.09315963
4401,業務員,15,506781,0.00242991,82.09558955
4402,極力,15,506796,0.00242991,82.09801946
4403,溫柔,15,506811,0.00242991,82.10044937
4404,經典,15,506826,0.00242991,82.10287929
4405,綁架,15,506841,0.00242991,82.10530920
4406,群體,15,506856,0.00242991,82.10773911
4407,腰,15,506871,0.00242991,82.11016902
4408,葡萄,15,506886,0.00242991,82.11259894
4409,號召,15,506901,0.00242991,82.11502885
4410,補償,15,506916,0.00242991,82.11745876
4411,跟進,15,506931,0.00242991,82.11988868
4412,過來,15,506946,0.00242991,82.12231859
4413,電玩,15,506961,0.00242991,82.12474850
4414,嘉義,15,506976,0.00242991,82.12717842
4415,圖坦卡門,15,506991,0.00242991,82.12960833
4416,對應,15,507006,0.00242991,82.13203824
4417,暢銷,15,507021,0.00242991,82.13446816
4418,瘋狂,15,507036,0.00242991,82.13689807
4419,聚會,15,507051,0.00242991,82.13932798
4420,聚酯棉,15,507066,0.00242991,82.14175790
4421,劉邦友,15,507081,0.00242991,82.14418781
4422,嘴,15,507096,0.00242991,82.14661772
4423,增長,15,507111,0.00242991,82.14904764
4424,審,15,507126,0.00242991,82.15147755
4425,影迷,15,507141,0.00242991,82.15390746
4426,摩托車,15,507156,0.00242991,82.15633738
4427,撞,15,507171,0.00242991,82.15876729
4428,播,15,507186,0.00242991,82.16119720
4429,標榜,15,507201,0.00242991,82.16362712
4430,熱潮,15,507216,0.00242991,82.16605703
4431,蓬勃,15,507231,0.00242991,82.16848694
4432,衛生署,15,507246,0.00242991,82.17091685
4433,課稅,15,507261,0.00242991,82.17334677
4434,賦予,15,507276,0.00242991,82.17577668
4435,賭,15,507291,0.00242991,82.17820659
4436,踩,15,507306,0.00242991,82.18063651
4437,靠近,15,507321,0.00242991,82.18306642
4438,噪音,15,507336,0.00242991,82.18549633
4439,操控,15,507351,0.00242991,82.18792625
4440,親密,15,507366,0.00242991,82.19035616
4441,諷刺,15,507381,0.00242991,82.19278607
4442,錯過,15,507396,0.00242991,82.19521599
4443,檢舉,15,507411,0.00242991,82.19764590
4444,營養素,15,507426,0.00242991,82.20007581
4445,縮短,15,507441,0.00242991,82.20250573
4446,績優股,15,507456,0.00242991,82.20493564
4447,總計,15,507471,0.00242991,82.20736555
4448,瀏覽器,15,507486,0.00242991,82.20979547
4449,糧食,15,507501,0.00242991,82.21222538
4450,謹慎,15,507516,0.00242991,82.21465529
4451,豐田,15,507531,0.00242991,82.21708521
4452,轉化,15,507546,0.00242991,82.21951512
4453,證,15,507561,0.00242991,82.22194503
4454,證券商,15,507576,0.00242991,82.22437495
4455,轎車,15,507591,0.00242991,82.22680486
4456,礦石,15,507606,0.00242991,82.22923477
4457,警員,15,507621,0.00242991,82.23166468
4458,釋出,15,507636,0.00242991,82.23409460
4459,麵包,15,507651,0.00242991,82.23652451
4460,驅動,15,507666,0.00242991,82.23895442
4461,彎,15,507681,0.00242991,82.24138434
4462,體能,15,507696,0.00242991,82.24381425
4463,觀光客,15,507711,0.00242991,82.24624416
4464,一身,14,507725,0.00226792,82.24851208
4465,一味,14,507739,0.00226792,82.25078000
4466,一邊,14,507753,0.00226792,82.25304792
4467,人參,14,507767,0.00226792,82.25531584
4468,人際關係,14,507781,0.00226792,82.25758376
4469,又是,14,507795,0.00226792,82.25985168
4470,上台,14,507809,0.00226792,82.26211960
4471,上帝,14,507823,0.00226792,82.26438752
4472,士兵,14,507837,0.00226792,82.26665544
4473,大哥,14,507851,0.00226792,82.26892335
4474,大海,14,507865,0.00226792,82.27119127
4475,寸,14,507879,0.00226792,82.27345919
4476,小提琴,14,507893,0.00226792,82.27572711
4477,已是,14,507907,0.00226792,82.27799503
4478,不可思議,14,507921,0.00226792,82.28026295
4479,不成,14,507935,0.00226792,82.28253087
4480,不見得,14,507949,0.00226792,82.28479879
4481,不清,14,507963,0.00226792,82.28706671
4482,不適,14,507977,0.00226792,82.28933462
4483,中央社,14,507991,0.00226792,82.29160254
4484,中央銀行,14,508005,0.00226792,82.29387046
4485,中毒,14,508019,0.00226792,82.29613838
4486,中醫,14,508033,0.00226792,82.29840630
4487,中壢市,14,508047,0.00226792,82.30067422
4488,內在,14,508061,0.00226792,82.30294214
4489,內涵,14,508075,0.00226792,82.30521006
4490,公關,14,508089,0.00226792,82.30747798
4491,分子,14,508103,0.00226792,82.30974590
4492,分佈,14,508117,0.00226792,82.31201381
4493,分明,14,508131,0.00226792,82.31428173
4494,分解,14,508145,0.00226792,82.31654965
4495,分辨,14,508159,0.00226792,82.31881757
4496,分類,14,508173,0.00226792,82.32108549
4497,勻,14,508187,0.00226792,82.32335341
4498,化解,14,508201,0.00226792,82.32562133
4499,反射,14,508215,0.00226792,82.32788925
4500,天體,14,508229,0.00226792,82.33015717
4501,少許,14,508243,0.00226792,82.33242509
4502,心血,14,508257,0.00226792,82.33469300
4503,心智,14,508271,0.00226792,82.33696092
4504,月份,14,508285,0.00226792,82.33922884
4505,比擬,14,508299,0.00226792,82.34149676
4506,父,14,508313,0.00226792,82.34376468
4507,代替,14,508327,0.00226792,82.34603260
4508,充斥,14,508341,0.00226792,82.34830052
4509,加州,14,508355,0.00226792,82.35056844
4510,可見,14,508369,0.00226792,82.35283636
4511,台泥,14,508383,0.00226792,82.35510428
4512,台南市,14,508397,0.00226792,82.35737219
4513,台海,14,508411,0.00226792,82.35964011
4514,台積電,14,508425,0.00226792,82.36190803
4515,外來,14,508439,0.00226792,82.36417595
4516,外套,14,508453,0.00226792,82.36644387
4517,奶,14,508467,0.00226792,82.36871179
4518,奶油,14,508481,0.00226792,82.37097971
4519,巨,14,508495,0.00226792,82.37324763
4520,市公所,14,508509,0.00226792,82.37551555
4521,布,14,508523,0.00226792,82.37778347
4522,平凡,14,508537,0.00226792,82.38005138
4523,平方,14,508551,0.00226792,82.38231930
4524,平價,14,508565,0.00226792,82.38458722
4525,平穩,14,508579,0.00226792,82.38685514
4526,生日,14,508593,0.00226792,82.38912306
4527,甲,14,508607,0.00226792,82.39139098
4528,目錄,14,508621,0.00226792,82.39365890
4529,矛盾,14,508635,0.00226792,82.39592682
4530,企圖心,14,508649,0.00226792,82.39819474
4531,全然,14,508663,0.00226792,82.40046266
4532,全體,14,508677,0.00226792,82.40273057
4533,共享,14,508691,0.00226792,82.40499849
4534,同意權,14,508705,0.00226792,82.40726641
4535,同業,14,508719,0.00226792,82.40953433
4536,地下,14,508733,0.00226792,82.41180225
4537,地圖,14,508747,0.00226792,82.41407017
4538,多重,14,508761,0.00226792,82.41633809
4539,好萊塢,14,508775,0.00226792,82.41860601
4540,存活,14,508789,0.00226792,82.42087393
4541,安,14,508803,0.00226792,82.42314185
4542,安詳,14,508817,0.00226792,82.42540976
4543,年初,14,508831,0.00226792,82.42767768
4544,此時,14,508845,0.00226792,82.42994560
4545,汙染,14,508859,0.00226792,82.43221352
4546,老鼠,14,508873,0.00226792,82.43448144
4547,位子,14,508887,0.00226792,82.43674936
4548,位址,14,508901,0.00226792,82.43901728
4549,住宅區,14,508915,0.00226792,82.44128520
4550,低價,14,508929,0.00226792,82.44355312
4551,即可,14,508943,0.00226792,82.44582104
4552,夾,14,508957,0.00226792,82.44808895
4553,希文,14,508971,0.00226792,82.45035687
4554,志,14,508985,0.00226792,82.45262479
4555,抗,14,508999,0.00226792,82.45489271
4556,技藝,14,509013,0.00226792,82.45716063
4557,沒什麼,14,509027,0.00226792,82.45942855
4558,阪急,14,509041,0.00226792,82.46169647
4559,京劇,14,509055,0.00226792,82.46396439
4560,來回,14,509069,0.00226792,82.46623231
4561,兩稅合一,14,509083,0.00226792,82.46850023
4562,刷,14,509097,0.00226792,82.47076814
4563,周遭,14,509111,0.00226792,82.47303606
4564,宜蘭縣,14,509125,0.00226792,82.47530398
4565,帕西諾,14,509139,0.00226792,82.47757190
4566,底片,14,509153,0.00226792,82.47983982
4567,忠實,14,509167,0.00226792,82.48210774
4568,怪,14,509181,0.00226792,82.48437566
4569,抵,14,509195,0.00226792,82.48664358
4570,放心,14,509209,0.00226792,82.48891150
4571,昔日,14,509223,0.00226792,82.49117942
4572,注入,14,509237,0.00226792,82.49344733
4573,油脂,14,509251,0.00226792,82.49571525
4574,物價,14,509265,0.00226792,82.49798317
4575,邱創煥,14,509279,0.00226792,82.50025109
4576,非法,14,509293,0.00226792,82.50251901
4577,信用,14,509307,0.00226792,82.50478693
4578,契約,14,509321,0.00226792,82.50705485
4579,宣傳車,14,509335,0.00226792,82.50932277
4580,建商,14,509349,0.00226792,82.51159069
4581,後方,14,509363,0.00226792,82.51385860
4582,急性,14,509377,0.00226792,82.51612652
4583,恨,14,509391,0.00226792,82.51839444
4584,按鈕,14,509405,0.00226792,82.52066236
4585,春夏,14,509419,0.00226792,82.52293028
4586,昨晚,14,509433,0.00226792,82.52519820
4587,相繼,14,509447,0.00226792,82.52746612
4588,美鈔,14,509461,0.00226792,82.52973404
4589,耐,14,509475,0.00226792,82.53200196
4590,耐心,14,509489,0.00226792,82.53426988
4591,苗栗,14,509503,0.00226792,82.53653779
4592,要不要,14,509517,0.00226792,82.53880571
4593,軍人,14,509531,0.00226792,82.54107363
4594,軌,14,509545,0.00226792,82.54334155
4595,師,14,509559,0.00226792,82.54560947
4596,息,14,509573,0.00226792,82.54787739
4597,捕,14,509587,0.00226792,82.55014531
4598,效能,14,509601,0.00226792,82.55241323
4599,書法,14,509615,0.00226792,82.55468115
4600,消滅,14,509629,0.00226792,82.55694907
4601,病變,14,509643,0.00226792,82.55921698
4602,神秘,14,509657,0.00226792,82.56148490
4603,缺少,14,509671,0.00226792,82.56375282
4604,退出,14,509685,0.00226792,82.56602074
4605,陣營,14,509699,0.00226792,82.56828866
4606,除權,14,509713,0.00226792,82.57055658
4607,馬克,14,509727,0.00226792,82.57282450
4608,高山,14,509741,0.00226792,82.57509242
4609,高低,14,509755,0.00226792,82.57736034
4610,停火,14,509769,0.00226792,82.57962826
4611,偶像,14,509783,0.00226792,82.58189617
4612,副理,14,509797,0.00226792,82.58416409
4613,區隔,14,509811,0.00226792,82.58643201
4614,執,14,509825,0.00226792,82.58869993
4615,婚,14,509839,0.00226792,82.59096785
4616,專利,14,509853,0.00226792,82.59323577
4617,專題,14,509867,0.00226792,82.59550369
4618,專欄,14,509881,0.00226792,82.59777161
4619,康定級,14,509895,0.00226792,82.60003953
4620,張力,14,509909,0.00226792,82.60230745
4621,張京育,14,509923,0.00226792,82.60457536
4622,情境,14,509937,0.00226792,82.60684328
4623,接收,14,509951,0.00226792,82.60911120
4624,推展,14,509965,0.00226792,82.61137912
4625,掀起,14,509979,0.00226792,82.61364704
4626,教材,14,509993,0.00226792,82.61591496
4627,族人,14,510007,0.00226792,82.61818288
4628,清晨,14,510021,0.00226792,82.62045080
4629,猛,14,510035,0.00226792,82.62271872
4630,率先,14,510049,0.00226792,82.62498664
4631,現代主義,14,510063,0.00226792,82.62725455
4632,符號,14,510077,0.00226792,82.62952247
4633,組頭,14,510091,0.00226792,82.63179039
4634,荷包,14,510105,0.00226792,82.63405831
4635,設法,14,510119,0.00226792,82.63632623
4636,連帶,14,510133,0.00226792,82.63859415
4637,連續劇,14,510147,0.00226792,82.64086207
4638,陳文茜,14,510161,0.00226792,82.64312999
4639,陳金茂,14,510175,0.00226792,82.64539791
4640,陰錯陽差,14,510189,0.00226792,82.64766583
4641,報復,14,510203,0.00226792,82.64993374
4642,就醫,14,510217,0.00226792,82.65220166
4643,復原,14,510231,0.00226792,82.65446958
4644,循,14,510245,0.00226792,82.65673750
4645,悲情,14,510259,0.00226792,82.65900542
4646,提示,14,510273,0.00226792,82.66127334
4647,無比,14,510287,0.00226792,82.66354126
4648,童,14,510301,0.00226792,82.66580918
4649,脾氣,14,510315,0.00226792,82.66807710
4650,舒服,14,510329,0.00226792,82.67034502
4651,評價,14,510343,0.00226792,82.67261293
4652,買進,14,510357,0.00226792,82.67488085
4653,開闢,14,510371,0.00226792,82.67714877
4654,隊長,14,510385,0.00226792,82.67941669
4655,階層,14,510399,0.00226792,82.68168461
4656,飲,14,510413,0.00226792,82.68395253
4657,黃文博,14,510427,0.00226792,82.68622045
4658,黑手黨,14,510441,0.00226792,82.68848837
4659,黑金,14,510455,0.00226792,82.69075629
4660,圓滿,14,510469,0.00226792,82.69302421
4661,敬,14,510483,0.00226792,82.69529212
4662,暗,14,510497,0.00226792,82.69756004
4663,會場,14,510511,0.00226792,82.69982796
4664,極端,14,510525,0.00226792,82.70209588
4665,獅子座,14,510539,0.00226792,82.70436380
4666,羨慕,14,510553,0.00226792,82.70663172
4667,群眾,14,510567,0.00226792,82.70889964
4668,葉爾欽,14,510581,0.00226792,82.71116756
4669,補助款,14,510595,0.00226792,82.71343548
4670,裝潢,14,510609,0.00226792,82.71570340
4671,電台,14,510623,0.00226792,82.71797131
4672,電源,14,510637,0.00226792,82.72023923
4673,實行,14,510651,0.00226792,82.72250715
4674,對不起,14,510665,0.00226792,82.72477507
4675,對立,14,510679,0.00226792,82.72704299
4676,對待,14,510693,0.00226792,82.72931091
4677,慘,14,510707,0.00226792,82.73157883
4678,旗下,14,510721,0.00226792,82.73384675
4679,榮,14,510735,0.00226792,82.73611467
4680,監督,14,510749,0.00226792,82.73838258
4681,福建,14,510763,0.00226792,82.74065050
4682,種植,14,510777,0.00226792,82.74291842
4683,管弦,14,510791,0.00226792,82.74518634
4684,綠色,14,510805,0.00226792,82.74745426
4685,舞者,14,510819,0.00226792,82.74972218
4686,蒜頭,14,510833,0.00226792,82.75199010
4687,製造商,14,510847,0.00226792,82.75425802
4688,誘惑,14,510861,0.00226792,82.75652594
4689,儀器,14,510875,0.00226792,82.75879386
4690,僵硬,14,510889,0.00226792,82.76106177
4691,價差,14,510903,0.00226792,82.76332969
4692,劉松藩,14,510917,0.00226792,82.76559761
4693,審核,14,510931,0.00226792,82.76786553
4694,廢棄物,14,510945,0.00226792,82.77013345
4695,影子,14,510959,0.00226792,82.77240137
4696,德,14,510973,0.00226792,82.77466929
4697,暫,14,510987,0.00226792,82.77693721
4698,潛水,14,511001,0.00226792,82.77920513
4699,瘦,14,511015,0.00226792,82.78147305
4700,確切,14,511029,0.00226792,82.78374096
4701,線索,14,511043,0.00226792,82.78600888
4702,罵,14,511057,0.00226792,82.78827680
4703,膚色,14,511071,0.00226792,82.79054472
4704,蝦,14,511085,0.00226792,82.79281264
4705,賠,14,511099,0.00226792,82.79508056
4706,賠償,14,511113,0.00226792,82.79734848
4707,趣,14,511127,0.00226792,82.79961640
4708,輪廓,14,511141,0.00226792,82.80188432
4709,適量,14,511155,0.00226792,82.80415224
4710,鄰近,14,511169,0.00226792,82.80642015
4711,凝聚,14,511183,0.00226792,82.80868807
4712,整頓,14,511197,0.00226792,82.81095599
4713,機身,14,511211,0.00226792,82.81322391
4714,機車行,14,511225,0.00226792,82.81549183
4715,辦案,14,511239,0.00226792,82.81775975
4716,遺憾,14,511253,0.00226792,82.82002767
4717,隨即,14,511267,0.00226792,82.82229559
4718,優美,14,511281,0.00226792,82.82456351
4719,壓縮,14,511295,0.00226792,82.82683143
4720,擊出,14,511309,0.00226792,82.82909934
4721,營,14,511323,0.00226792,82.83136726
4722,瞬間,14,511337,0.00226792,82.83363518
4723,總之,14,511351,0.00226792,82.83590310
4724,總公司,14,511365,0.00226792,82.83817102
4725,聯電,14,511379,0.00226792,82.84043894
4726,避開,14,511393,0.00226792,82.84270686
4727,餵,14,511407,0.00226792,82.84497478
4728,鮮,14,511421,0.00226792,82.84724270
4729,獵物,14,511435,0.00226792,82.84951062
4730,禮,14,511449,0.00226792,82.85177853
4731,藍色,14,511463,0.00226792,82.85404645
4732,題目,14,511477,0.00226792,82.85631437
4733,簽訂,14,511491,0.00226792,82.85858229
4734,羅茲威爾,14,511505,0.00226792,82.86085021
4735,藥局,14,511519,0.00226792,82.86311813
4736,關卡,14,511533,0.00226792,82.86538605
4737,勸,14,511547,0.00226792,82.86765397
4738,嚴肅,14,511561,0.00226792,82.86992189
4739,嚴謹,14,511575,0.00226792,82.87218981
4740,籃球,14,511589,0.00226792,82.87445772
4741,艦,14,511603,0.00226792,82.87672564
4742,攝,14,511617,0.00226792,82.87899356
4743,蘭高登,14,511631,0.00226792,82.88126148
4744,囉,14,511645,0.00226792,82.88352940
4745,驕傲,14,511659,0.00226792,82.88579732
4746,邏輯,14,511673,0.00226792,82.88806524
4747,顯影,14,511687,0.00226792,82.89033316
4748,驚,14,511701,0.00226792,82.89260108
4749,靈感,14,511715,0.00226792,82.89486900
4750,讚美,14,511729,0.00226792,82.89713691
4751,一併,13,511742,0.00210592,82.89924284
4752,一流,13,511755,0.00210592,82.90134876
4753,一點點,13,511768,0.00210592,82.90345469
4754,人權,13,511781,0.00210592,82.90556061
4755,入侵,13,511794,0.00210592,82.90766654
4756,三通,13,511807,0.00210592,82.90977246
4757,下游,13,511820,0.00210592,82.91187839
4758,上任,13,511833,0.00210592,82.91398431
4759,亡者,13,511846,0.00210592,82.91609024
4760,大方,13,511859,0.00210592,82.91819616
4761,大將,13,511872,0.00210592,82.92030209
4762,山區,13,511885,0.00210592,82.92240801
4763,不可以,13,511898,0.00210592,82.92451394
4764,不具,13,511911,0.00210592,82.92661986
4765,不停,13,511924,0.00210592,82.92872579
4766,不符,13,511937,0.00210592,82.93083171
4767,中文版,13,511950,0.00210592,82.93293764
4768,中生代,13,511963,0.00210592,82.93504356
4769,中年,13,511976,0.00210592,82.93714949
4770,中音,13,511989,0.00210592,82.93925541
4771,中間,13,512002,0.00210592,82.94136133
4772,內衣,13,512015,0.00210592,82.94346726
4773,公文,13,512028,0.00210592,82.94557318
4774,公主,13,512041,0.00210592,82.94767911
4775,公佈,13,512054,0.00210592,82.94978503
4776,公所,13,512067,0.00210592,82.95189096
4777,公營,13,512080,0.00210592,82.95399688
4778,午餐,13,512093,0.00210592,82.95610281
4779,太平洋,13,512106,0.00210592,82.95820873
4780,心力,13,512119,0.00210592,82.96031466
4781,文化局,13,512132,0.00210592,82.96242058
4782,文建會,13,512145,0.00210592,82.96452651
4783,毛,13,512158,0.00210592,82.96663243
4784,毛病,13,512171,0.00210592,82.96873836
4785,水分,13,512184,0.00210592,82.97084428
4786,以便,13,512197,0.00210592,82.97295021
4787,加工出口區,13,512210,0.00210592,82.97505613
4788,台北市長,13,512223,0.00210592,82.97716206
4789,外用,13,512236,0.00210592,82.97926798
4790,外交部,13,512249,0.00210592,82.98137391
4791,外形,13,512262,0.00210592,82.98347983
4792,外流,13,512275,0.00210592,82.98558575
4793,外國人,13,512288,0.00210592,82.98769168
4794,平原,13,512301,0.00210592,82.98979760
4795,弗瑞茲,13,512314,0.00210592,82.99190353
4796,打者,13,512327,0.00210592,82.99400945
4797,本性,13,512340,0.00210592,82.99611538
4798,民政局,13,512353,0.00210592,82.99822130
4799,民營,13,512366,0.00210592,83.00032723
4800,永和,13,512379,0.00210592,83.00243315
4801,生命力,13,512392,0.00210592,83.00453908
4802,申報,13,512405,0.00210592,83.00664500
4803,目擊者,13,512418,0.00210592,83.00875093
4804,企管,13,512431,0.00210592,83.01085685
4805,光芒,13,512444,0.00210592,83.01296278
4806,光圈,13,512457,0.00210592,83.01506870
4807,全委會,13,512470,0.00210592,83.01717463
4808,再見,13,512483,0.00210592,83.01928055
4809,刑事組,13,512496,0.00210592,83.02138648
4810,地形,13,512509,0.00210592,83.02349240
4811,在意,13,512522,0.00210592,83.02559833
4812,如此一來,13,512535,0.00210592,83.02770425
4813,安心,13,512548,0.00210592,83.02981018
4814,安全性,13,512561,0.00210592,83.03191610
4815,安靜,13,512574,0.00210592,83.03402202
4816,收視,13,512587,0.00210592,83.03612795
4817,朵,13,512600,0.00210592,83.03823387
4818,死亡率,13,512613,0.00210592,83.04033980
4819,江丙坤,13,512626,0.00210592,83.04244572
4820,百日咳,13,512639,0.00210592,83.04455165
4821,老公,13,512652,0.00210592,83.04665757
4822,老化,13,512665,0.00210592,83.04876350
4823,肌瘤,13,512678,0.00210592,83.05086942
4824,自殺,13,512691,0.00210592,83.05297535
4825,艾瑪,13,512704,0.00210592,83.05508127
4826,行走,13,512717,0.00210592,83.05718720
4827,衣,13,512730,0.00210592,83.05929312
4828,住宿,13,512743,0.00210592,83.06139905
4829,住專,13,512756,0.00210592,83.06350497
4830,佛珠,13,512769,0.00210592,83.06561090
4831,免疫,13,512782,0.00210592,83.06771682
4832,局勢,13,512795,0.00210592,83.06982275
4833,尿布,13,512808,0.00210592,83.07192867
4834,尾巴,13,512821,0.00210592,83.07403460
4835,序,13,512834,0.00210592,83.07614052
4836,抗體,13,512847,0.00210592,83.07824645
4837,更改,13,512860,0.00210592,83.08035237
4838,材,13,512873,0.00210592,83.08245829
4839,谷底,13,512886,0.00210592,83.08456422
4840,走道,13,512899,0.00210592,83.08667014
4841,足球,13,512912,0.00210592,83.08877607
4842,身為,13,512925,0.00210592,83.09088199
4843,車廂,13,512938,0.00210592,83.09298792
4844,巡迴,13,512951,0.00210592,83.09509384
4845,里,13,512964,0.00210592,83.09719977
4846,亞太營運中心,13,512977,0.00210592,83.09930569
4847,享有,13,512990,0.00210592,83.10141162
4848,使命,13,513003,0.00210592,83.10351754
4849,刮鬍刀,13,513016,0.00210592,83.10562347
4850,受損,13,513029,0.00210592,83.10772939
4851,奇幻,13,513042,0.00210592,83.10983532
4852,姊妹,13,513055,0.00210592,83.11194124
4853,定存,13,513068,0.00210592,83.11404717
4854,定時,13,513081,0.00210592,83.11615309
4855,岸,13,513094,0.00210592,83.11825902
4856,延,13,513107,0.00210592,83.12036494
4857,忽然,13,513120,0.00210592,83.12247087
4858,拓寬,13,513133,0.00210592,83.12457679
4859,抨擊,13,513146,0.00210592,83.12668271
4860,抽象,13,513159,0.00210592,83.12878864
4861,玫瑰,13,513172,0.00210592,83.13089456
4862,空中,13,513185,0.00210592,83.13300049
4863,花錢,13,513198,0.00210592,83.13510641
4864,金龜車,13,513211,0.00210592,83.13721234
4865,長官,13,513224,0.00210592,83.13931826
4866,長度,13,513237,0.00210592,83.14142419
4867,長崎,13,513250,0.00210592,83.14353011
4868,門號,13,513263,0.00210592,83.14563604
4869,阻力,13,513276,0.00210592,83.14774196
4870,阻礙,13,513289,0.00210592,83.14984789
4871,信號,13,513302,0.00210592,83.15195381
4872,信賴,13,513315,0.00210592,83.15405974
4873,侵入,13,513328,0.00210592,83.15616566
4874,垂直,13,513341,0.00210592,83.15827159
4875,契機,13,513354,0.00210592,83.16037751
4876,恰當,13,513367,0.00210592,83.16248344
4877,拼,13,513380,0.00210592,83.16458936
4878,故意,13,513393,0.00210592,83.16669529
4879,施行,13,513406,0.00210592,83.16880121
4880,流入,13,513419,0.00210592,83.17090714
4881,珍惜,13,513432,0.00210592,83.17301306
4882,疫苗,13,513445,0.00210592,83.17511898
4883,省議員,13,513458,0.00210592,83.17722491
4884,看成,13,513471,0.00210592,83.17933083
4885,致命,13,513484,0.00210592,83.18143676
4886,負荷,13,513497,0.00210592,83.18354268
4887,重重,13,513510,0.00210592,83.18564861
4888,風波,13,513523,0.00210592,83.18775453
4889,風暴,13,513536,0.00210592,83.18986046
4890,食鹽,13,513549,0.00210592,83.19196638
4891,香菇,13,513562,0.00210592,83.19407231
4892,個個,13,513575,0.00210592,83.19617823
4893,倉庫,13,513588,0.00210592,83.19828416
4894,套裝,13,513601,0.00210592,83.20039008
4895,徑,13,513614,0.00210592,83.20249601
4896,恐,13,513627,0.00210592,83.20460193
4897,扇,13,513640,0.00210592,83.20670786
4898,拿下,13,513653,0.00210592,83.20881378
4899,挫折,13,513666,0.00210592,83.21091971
4900,校區,13,513679,0.00210592,83.21302563
4901,格外,13,513692,0.00210592,83.21513156
4902,氣息,13,513705,0.00210592,83.21723748
4903,海外基金,13,513718,0.00210592,83.21934341
4904,病例,13,513731,0.00210592,83.22144933
4905,症,13,513744,0.00210592,83.22355525
4906,耗,13,513757,0.00210592,83.22566118
4907,草原,13,513770,0.00210592,83.22776710
4908,記憶力,13,513783,0.00210592,83.22987303
4909,訓,13,513796,0.00210592,83.23197895
4910,起碼,13,513809,0.00210592,83.23408488
4911,迷宮,13,513822,0.00210592,83.23619080
4912,院會,13,513835,0.00210592,83.23829673
4913,高企,13,513848,0.00210592,83.24040265
4914,高階,13,513861,0.00210592,83.24250858
4915,高檔,13,513874,0.00210592,83.24461450
4916,做人,13,513887,0.00210592,83.24672043
4917,偶而,13,513900,0.00210592,83.24882635
4918,動輒,13,513913,0.00210592,83.25093228
4919,動機,13,513926,0.00210592,83.25303820
4920,區別,13,513939,0.00210592,83.25514413
4921,國壽,13,513952,0.00210592,83.25725005
4922,堅,13,513965,0.00210592,83.25935598
4923,培育,13,513978,0.00210592,83.26146190
4924,婚禮,13,513991,0.00210592,83.26356783
4925,專案小組,13,514004,0.00210592,83.26567375
4926,帳,13,514017,0.00210592,83.26777967
4927,康澤爾,13,514030,0.00210592,83.26988560
4928,情事,13,514043,0.00210592,83.27199152
4929,接任,13,514056,0.00210592,83.27409745
4930,推測,13,514069,0.00210592,83.27620337
4931,推銷,13,514082,0.00210592,83.27830930
4932,旋律,13,514095,0.00210592,83.28041522
4933,晚間,13,514108,0.00210592,83.28252115
4934,條紋,13,514121,0.00210592,83.28462707
4935,牽涉,13,514134,0.00210592,83.28673300
4936,異動,13,514147,0.00210592,83.28883892
4937,眼神,13,514160,0.00210592,83.29094485
4938,粗糙,13,514173,0.00210592,83.29305077
4939,細心,13,514186,0.00210592,83.29515670
4940,累計,13,514199,0.00210592,83.29726262
4941,莫斯科,13,514212,0.00210592,83.29936855
4942,許文龍,13,514225,0.00210592,83.30147447
4943,設廠,13,514238,0.00210592,83.30358040
4944,貧窮,13,514251,0.00210592,83.30568632
4945,這兒,13,514264,0.00210592,83.30779225
4946,通行,13,514277,0.00210592,83.30989817
4947,部會,13,514290,0.00210592,83.31200410
4948,陪伴,13,514303,0.00210592,83.31411002
4949,陳佐鎮,13,514316,0.00210592,83.31621594
4950,陳情,13,514329,0.00210592,83.31832187
4951,陸軍,13,514342,0.00210592,83.32042779
4952,章孝嚴,13,514355,0.00210592,83.32253372
4953,鳥,13,514368,0.00210592,83.32463964
4954,創立,13,514381,0.00210592,83.32674557
4955,勝負,13,514394,0.00210592,83.32885149
4956,喬石,13,514407,0.00210592,83.33095742
4957,堪,13,514420,0.00210592,83.33306334
4958,報案,13,514433,0.00210592,83.33516927
4959,尊嚴,13,514446,0.00210592,83.33727519
4960,復興鄉,13,514459,0.00210592,83.33938112
4961,掌,13,514472,0.00210592,83.34148704
4962,插,13,514485,0.00210592,83.34359297
4963,插入,13,514498,0.00210592,83.34569889
4964,提及,13,514511,0.00210592,83.34780482
4965,換裝,13,514524,0.00210592,83.34991074
4966,散發,13,514537,0.00210592,83.35201667
4967,棋子,13,514550,0.00210592,83.35412259
4968,殖,13,514563,0.00210592,83.35622852
4969,無關,13,514576,0.00210592,83.35833444
4970,畫廊,13,514589,0.00210592,83.36044037
4971,發言人,13,514602,0.00210592,83.36254629
4972,發射,13,514615,0.00210592,83.36465221
4973,發起,13,514628,0.00210592,83.36675814
4974,評論,13,514641,0.00210592,83.36886406
4975,量產,13,514654,0.00210592,83.37096999
4976,開朗,13,514667,0.00210592,83.37307591
4977,黃隆豐,13,514680,0.00210592,83.37518184
4978,傳聞,13,514693,0.00210592,83.37728776
4979,勤,13,514706,0.00210592,83.37939369
4980,幹,13,514719,0.00210592,83.38149961
4981,愛滋病,13,514732,0.00210592,83.38360554
4982,新生兒,13,514745,0.00210592,83.38571146
4983,極度,13,514758,0.00210592,83.38781739
4984,當作,13,514771,0.00210592,83.38992331
4985,經營者,13,514784,0.00210592,83.39202924
4986,解答,13,514797,0.00210592,83.39413516
4987,試試,13,514810,0.00210592,83.39624109
4988,賄選,13,514823,0.00210592,83.39834701
4989,運動鞋,13,514836,0.00210592,83.40045294
4990,道具,13,514849,0.00210592,83.40255886
4991,電動,13,514862,0.00210592,83.40466479
4992,電影院,13,514875,0.00210592,83.40677071
4993,頒獎,13,514888,0.00210592,83.40887663
4994,飾品,13,514901,0.00210592,83.41098256
4995,劃,13,514914,0.00210592,83.41308848
4996,團結,13,514927,0.00210592,83.41519441
4997,壽命,13,514940,0.00210592,83.41730033
4998,夢幻,13,514953,0.00210592,83.41940626
4999,暨,13,514966,0.00210592,83.42151218
5000,榜,13,514979,0.00210592,83.42361811
5001,榮耀,13,514992,0.00210592,83.42572403
5002,滿意度,13,515005,0.00210592,83.42782996
5003,疑惑,13,515018,0.00210592,83.42993588
5004,福利,13,515031,0.00210592,83.43204181
5005,精采,13,515044,0.00210592,83.43414773
5006,聞名,13,515057,0.00210592,83.43625366
5007,腿,13,515070,0.00210592,83.43835958
5008,蜜粉,13,515083,0.00210592,83.44046551
5009,製成,13,515096,0.00210592,83.44257143
5010,製作人,13,515109,0.00210592,83.44467736
5011,遠遠,13,515122,0.00210592,83.44678328
5012,需求量,13,515135,0.00210592,83.44888921
5013,劇照,13,515148,0.00210592,83.45099513
5014,劉財林,13,515161,0.00210592,83.45310106
5015,嘴巴,13,515174,0.00210592,83.45520698
5016,層級,13,515187,0.00210592,83.45731290
5017,廣闊,13,515200,0.00210592,83.45941883
5018,憂慮,13,515213,0.00210592,83.46152475
5019,數值,13,515226,0.00210592,83.46363068
5020,標售,13,515239,0.00210592,83.46573660
5021,澄清,13,515252,0.00210592,83.46784253
5022,潛艦,13,515265,0.00210592,83.46994845
5023,熱絡,13,515278,0.00210592,83.47205438
5024,箱子,13,515291,0.00210592,83.47416030
5025,編列,13,515304,0.00210592,83.47626623
5026,編輯部,13,515317,0.00210592,83.47837215
5027,蔡克信,13,515330,0.00210592,83.48047808
5028,請求,13,515343,0.00210592,83.48258400
5029,請教,13,515356,0.00210592,83.48468993
5030,質詢,13,515369,0.00210592,83.48679585
5031,適度,13,515382,0.00210592,83.48890178
5032,醉,13,515395,0.00210592,83.49100770
5033,戰役,13,515408,0.00210592,83.49311363
5034,戰艦,13,515421,0.00210592,83.49521955
5035,擅長,13,515434,0.00210592,83.49732548
5036,機密,13,515447,0.00210592,83.49943140
5037,燃燒,13,515460,0.00210592,83.50153733
5038,親子,13,515473,0.00210592,83.50364325
5039,親身,13,515486,0.00210592,83.50574917
5040,輸贏,13,515499,0.00210592,83.50785510
5041,辨識,13,515512,0.00210592,83.50996102
5042,選票,13,515525,0.00210592,83.51206695
5043,遺產,13,515538,0.00210592,83.51417287
5044,錄,13,515551,0.00210592,83.51627880
5045,鴕鳥,13,515564,0.00210592,83.51838472
5046,償還,13,515577,0.00210592,83.52049065
5047,壓迫,13,515590,0.00210592,83.52259657
5048,檔期,13,515603,0.00210592,83.52470250
5049,濕,13,515616,0.00210592,83.52680842
5050,聲明,13,515629,0.00210592,83.52891435
5051,擴建,13,515642,0.00210592,83.53102027
5052,禮拜,13,515655,0.00210592,83.53312620
5053,簡化,13,515668,0.00210592,83.53523212
5054,簡報,13,515681,0.00210592,83.53733805
5055,職籃,13,515694,0.00210592,83.53944397
5056,職籃公司,13,515707,0.00210592,83.54154990
5057,舊金山,13,515720,0.00210592,83.54365582
5058,藍圖,13,515733,0.00210592,83.54576175
5059,離婚,13,515746,0.00210592,83.54786767
5060,騎士,13,515759,0.00210592,83.54997359
5061,瀕死,13,515772,0.00210592,83.55207952
5062,穩定基金,13,515785,0.00210592,83.55418544
5063,穩健,13,515798,0.00210592,83.55629137
5064,簽約,13,515811,0.00210592,83.55839729
5065,藥水,13,515824,0.00210592,83.56050322
5066,願望,13,515837,0.00210592,83.56260914
5067,顛覆,13,515850,0.00210592,83.56471507
5068,鬍子,13,515863,0.00210592,83.56682099
5069,寶石,13,515876,0.00210592,83.56892692
5070,獻,13,515889,0.00210592,83.57103284
5071,繼承,13,515902,0.00210592,83.57313877
5072,飄,13,515915,0.00210592,83.57524469
5073,黨派,13,515928,0.00210592,83.57735062
5074,黨籍,13,515941,0.00210592,83.57945654
5075,續,13,515954,0.00210592,83.58156247
5076,顧,13,515967,0.00210592,83.58366839
5077,讀取,13,515980,0.00210592,83.58577432
5078,蘿莉,13,515993,0.00210592,83.58788024
5079,驚喜,13,516006,0.00210592,83.58998617
5080,觀看,13,516019,0.00210592,83.59209209
5081,一會兒,12,516031,0.00194393,83.59403602
5082,三商,12,516043,0.00194393,83.59597995
5083,上方,12,516055,0.00194393,83.59792388
5084,上演,12,516067,0.00194393,83.59986781
5085,大漲,12,516079,0.00194393,83.60181174
5086,女生,12,516091,0.00194393,83.60375567
5087,不去,12,516103,0.00194393,83.60569960
5088,不行,12,516115,0.00194393,83.60764353
5089,不知不覺,12,516127,0.00194393,83.60958747
5090,中長期,12,516139,0.00194393,83.61153140
5091,中時,12,516151,0.00194393,83.61347533
5092,元月,12,516163,0.00194393,83.61541926
5093,內外,12,516175,0.00194393,83.61736319
5094,分布,12,516187,0.00194393,83.61930712
5095,分裂,12,516199,0.00194393,83.62125105
5096,反之,12,516211,0.00194393,83.62319498
5097,引述,12,516223,0.00194393,83.62513891
5098,手工,12,516235,0.00194393,83.62708284
5099,文物,12,516247,0.00194393,83.62902677
5100,斤,12,516259,0.00194393,83.63097070
5101,日記,12,516271,0.00194393,83.63291463
5102,主體,12,516283,0.00194393,83.63485856
5103,充份,12,516295,0.00194393,83.63680249
5104,出門,12,516307,0.00194393,83.63874642
5105,加油,12,516319,0.00194393,83.64069035
5106,加重,12,516331,0.00194393,83.64263429
5107,北韓,12,516343,0.00194393,83.64457822
5108,去除,12,516355,0.00194393,83.64652215
5109,司法,12,516367,0.00194393,83.64846608
5110,史渥特,12,516379,0.00194393,83.65041001
5111,奶水,12,516391,0.00194393,83.65235394
5112,巨集,12,516403,0.00194393,83.65429787
5113,平靜,12,516415,0.00194393,83.65624180
5114,末期,12,516427,0.00194393,83.65818573
5115,民代,12,516439,0.00194393,83.66012966
5116,民航局,12,516451,0.00194393,83.66207359
5117,永,12,516463,0.00194393,83.66401752
5118,瓦斯車,12,516475,0.00194393,83.66596145
5119,生產力,12,516487,0.00194393,83.66790538
5120,生產線,12,516499,0.00194393,83.66984931
5121,田,12,516511,0.00194393,83.67179324
5122,白天,12,516523,0.00194393,83.67373717
5123,目光,12,516535,0.00194393,83.67568110
5124,立法,12,516547,0.00194393,83.67762504
5125,交響曲,12,516559,0.00194393,83.67956897
5126,任職,12,516571,0.00194393,83.68151290
5127,共黨,12,516583,0.00194393,83.68345683
5128,再生,12,516595,0.00194393,83.68540076
5129,同行,12,516607,0.00194393,83.68734469
5130,吐,12,516619,0.00194393,83.68928862
5131,名義,12,516631,0.00194393,83.69123255
5132,地址,12,516643,0.00194393,83.69317648
5133,在乎,12,516655,0.00194393,83.69512041
5134,多樣化,12,516667,0.00194393,83.69706434
5135,多頭,12,516679,0.00194393,83.69900827
5136,安平港,12,516691,0.00194393,83.70095220
5137,安娜,12,516703,0.00194393,83.70289613
5138,年薪,12,516715,0.00194393,83.70484006
5139,成品,12,516727,0.00194393,83.70678399
5140,收費,12,516739,0.00194393,83.70872792
5141,收藏家,12,516751,0.00194393,83.71067185
5142,次數,12,516763,0.00194393,83.71261579
5143,池,12,516775,0.00194393,83.71455972
5144,自由化,12,516787,0.00194393,83.71650365
5145,色澤,12,516799,0.00194393,83.71844758
5146,西藏,12,516811,0.00194393,83.72039151
5147,何時,12,516823,0.00194393,83.72233544
5148,余政憲,12,516835,0.00194393,83.72427937
5149,利空,12,516847,0.00194393,83.72622330
5150,即時,12,516859,0.00194393,83.72816723
5151,均勻,12,516871,0.00194393,83.73011116
5152,尿路,12,516883,0.00194393,83.73205509
5153,折,12,516895,0.00194393,83.73399902
5154,投信基金,12,516907,0.00194393,83.73594295
5155,投資者,12,516919,0.00194393,83.73788688
5156,抑制,12,516931,0.00194393,83.73983081
5157,攸關,12,516943,0.00194393,83.74177474
5158,李遠哲,12,516955,0.00194393,83.74371867
5159,肖像,12,516967,0.00194393,83.74566260
5160,豆腐,12,516979,0.00194393,83.74760654
5161,赤字,12,516991,0.00194393,83.74955047
5162,事宜,12,517003,0.00194393,83.75149440
5163,亞太,12,517015,0.00194393,83.75343833
5164,依序,12,517027,0.00194393,83.75538226
5165,卷,12,517039,0.00194393,83.75732619
5166,受限,12,517051,0.00194393,83.75927012
5167,受惠,12,517063,0.00194393,83.76121405
5168,呼叫,12,517075,0.00194393,83.76315798
5169,和喬,12,517087,0.00194393,83.76510191
5170,夜晚,12,517099,0.00194393,83.76704584
5171,宗旨,12,517111,0.00194393,83.76898977
5172,官方,12,517123,0.00194393,83.77093370
5173,所長,12,517135,0.00194393,83.77287763
5174,拚,12,517147,0.00194393,83.77482156
5175,放假,12,517159,0.00194393,83.77676549
5176,放置,12,517171,0.00194393,83.77870942
5177,林口,12,517183,0.00194393,83.78065336
5178,林正杰,12,517195,0.00194393,83.78259729
5179,武力,12,517207,0.00194393,83.78454122
5180,法門,12,517219,0.00194393,83.78648515
5181,玩者,12,517231,0.00194393,83.78842908
5182,空調,12,517243,0.00194393,83.79037301
5183,糾紛,12,517255,0.00194393,83.79231694
5184,虎隊,12,517267,0.00194393,83.79426087
5185,長長,12,517279,0.00194393,83.79620480
5186,長遠,12,517291,0.00194393,83.79814873
5187,青睞,12,517303,0.00194393,83.80009266
5188,侵犯,12,517315,0.00194393,83.80203659
5189,侷限,12,517327,0.00194393,83.80398052
5190,前來,12,517339,0.00194393,83.80592445
5191,前述,12,517351,0.00194393,83.80786838
5192,前途,12,517363,0.00194393,83.80981231
5193,哈桑薩德,12,517375,0.00194393,83.81175624
5194,客家,12,517387,0.00194393,83.81370017
5195,屏東縣,12,517399,0.00194393,83.81564411
5196,急速,12,517411,0.00194393,83.81758804
5197,怎麼樣,12,517423,0.00194393,83.81953197
5198,政客,12,517435,0.00194393,83.82147590
5199,星星,12,517447,0.00194393,83.82341983
5200,柔軟,12,517459,0.00194393,83.82536376
5201,柯達數位影像,12,517471,0.00194393,83.82730769
5202,查詢,12,517483,0.00194393,83.82925162
5203,洋基,12,517495,0.00194393,83.83119555
5204,活躍,12,517507,0.00194393,83.83313948
5205,為主,12,517519,0.00194393,83.83508341
5206,炸彈,12,517531,0.00194393,83.83702734
5207,盆,12,517543,0.00194393,83.83897127
5208,相差,12,517555,0.00194393,83.84091520
5209,研究員,12,517567,0.00194393,83.84285913
5210,秋天,12,517579,0.00194393,83.84480306
5211,穿越,12,517591,0.00194393,83.84674699
5212,美人,12,517603,0.00194393,83.84869092
5213,美商,12,517615,0.00194393,83.85063486
5214,美景,12,517627,0.00194393,83.85257879
5215,致詞,12,517639,0.00194393,83.85452272
5216,英代爾,12,517651,0.00194393,83.85646665
5217,面子,12,517663,0.00194393,83.85841058
5218,音量,12,517675,0.00194393,83.86035451
5219,首頁,12,517687,0.00194393,83.86229844
5220,乘坐,12,517699,0.00194393,83.86424237
5221,修訂,12,517711,0.00194393,83.86618630
5222,座位,12,517723,0.00194393,83.86813023
5223,捕手,12,517735,0.00194393,83.87007416
5224,時尚,12,517747,0.00194393,83.87201809
5225,書店,12,517759,0.00194393,83.87396202
5226,案子,12,517771,0.00194393,83.87590595
5227,格式,12,517783,0.00194393,83.87784988
5228,浸泡,12,517795,0.00194393,83.87979381
5229,海上,12,517807,0.00194393,83.88173774
5230,海域,12,517819,0.00194393,83.88368167
5231,海報,12,517831,0.00194393,83.88562561
5232,海關,12,517843,0.00194393,83.88756954
5233,浮現,12,517855,0.00194393,83.88951347
5234,特點,12,517867,0.00194393,83.89145740
5235,紐西蘭,12,517879,0.00194393,83.89340133
5236,缺失,12,517891,0.00194393,83.89534526
5237,迷人,12,517903,0.00194393,83.89728919
5238,退伍,12,517915,0.00194393,83.89923312
5239,酒吧,12,517927,0.00194393,83.90117705
5240,馬路,12,517939,0.00194393,83.90312098
5241,骨頭,12,517951,0.00194393,83.90506491
5242,高峰會,12,517963,0.00194393,83.90700884
5243,高速,12,517975,0.00194393,83.90895277
5244,高貴,12,517987,0.00194393,83.91089670
5245,鬥爭,12,517999,0.00194393,83.91284063
5246,假期,12,518011,0.00194393,83.91478456
5247,偶,12,518023,0.00194393,83.91672849
5248,偶然,12,518035,0.00194393,83.91867243
5249,偵訊,12,518047,0.00194393,83.92061636
5250,偏見,12,518059,0.00194393,83.92256029
5251,動工,12,518071,0.00194393,83.92450422
5252,參,12,518083,0.00194393,83.92644815
5253,國民大會,12,518095,0.00194393,83.92839208
5254,國民年金,12,518107,0.00194393,83.93033601
5255,國稅局,12,518119,0.00194393,83.93227994
5256,國際性,12,518131,0.00194393,83.93422387
5257,專賣店,12,518143,0.00194393,83.93616780
5258,將軍,12,518155,0.00194393,83.93811173
5259,崩潰,12,518167,0.00194393,83.94005566
5260,常識,12,518179,0.00194393,83.94199959
5261,帶因,12,518191,0.00194393,83.94394352
5262,張瓊文,12,518203,0.00194393,83.94588745
5263,捷克,12,518215,0.00194393,83.94783138
5264,排卵,12,518227,0.00194393,83.94977531
5265,敏銳,12,518239,0.00194393,83.95171924
5266,殺死,12,518251,0.00194393,83.95366318
5267,清除,12,518263,0.00194393,83.95560711
5268,現身,12,518275,0.00194393,83.95755104
5269,產房,12,518287,0.00194393,83.95949497
5270,盛行,12,518299,0.00194393,83.96143890
5271,移轉,12,518311,0.00194393,83.96338283
5272,終究,12,518323,0.00194393,83.96532676
5273,終場,12,518335,0.00194393,83.96727069
5274,莫札特,12,518347,0.00194393,83.96921462
5275,處理器,12,518359,0.00194393,83.97115855
5276,處境,12,518371,0.00194393,83.97310248
5277,販售,12,518383,0.00194393,83.97504641
5278,通道,12,518395,0.00194393,83.97699034
5279,造就,12,518407,0.00194393,83.97893427
5280,陳述,12,518419,0.00194393,83.98087820
5281,陳猛,12,518431,0.00194393,83.98282213
5282,陳萬福,12,518443,0.00194393,83.98476606
5283,傍晚,12,518455,0.00194393,83.98670999
5284,創作者,12,518467,0.00194393,83.98865393
5285,喝酒,12,518479,0.00194393,83.99059786
5286,單獨,12,518491,0.00194393,83.99254179
5287,場合,12,518503,0.00194393,83.99448572
5288,奠定,12,518515,0.00194393,83.99642965
5289,富翁,12,518527,0.00194393,83.99837358
5290,提撥,12,518539,0.00194393,84.00031751
5291,晶片組,12,518551,0.00194393,84.00226144
5292,景色,12,518563,0.00194393,84.00420537
5293,棵,12,518575,0.00194393,84.00614930
5294,棲,12,518587,0.00194393,84.00809323
5295,款式,12,518599,0.00194393,84.01003716
5296,港商,12,518611,0.00194393,84.01198109
5297,測光,12,518623,0.00194393,84.01392502
5298,測光錶,12,518635,0.00194393,84.01586895
5299,測驗,12,518647,0.00194393,84.01781288
5300,無窮,12,518659,0.00194393,84.01975681
5301,發包,12,518671,0.00194393,84.02170074
5302,短暫,12,518683,0.00194393,84.02364468
5303,華,12,518695,0.00194393,84.02558861
5304,華電,12,518707,0.00194393,84.02753254
5305,菜單,12,518719,0.00194393,84.02947647
5306,虛擬,12,518731,0.00194393,84.03142040
5307,註,12,518743,0.00194393,84.03336433
5308,評比,12,518755,0.00194393,84.03530826
5309,貶值,12,518767,0.00194393,84.03725219
5310,週五,12,518779,0.00194393,84.03919612
5311,進展,12,518791,0.00194393,84.04114005
5312,鄉下,12,518803,0.00194393,84.04308398
5313,開玩笑,12,518815,0.00194393,84.04502791
5314,間接,12,518827,0.00194393,84.04697184
5315,隊伍,12,518839,0.00194393,84.04891577
5316,塔,12,518851,0.00194393,84.05085970
5317,奧林匹克,12,518863,0.00194393,84.05280363
5318,感性,12,518875,0.00194393,84.05474756
5319,搭載,12,518887,0.00194393,84.05669149
5320,新疆,12,518899,0.00194393,84.05863543
5321,楊世緘,12,518911,0.00194393,84.06057936
5322,毀,12,518923,0.00194393,84.06252329
5323,毀滅,12,518935,0.00194393,84.06446722
5324,碰上,12,518947,0.00194393,84.06641115
5325,禁區,12,518959,0.00194393,84.06835508
5326,經營權,12,518971,0.00194393,84.07029901
5327,葉子,12,518983,0.00194393,84.07224294
5328,虞,12,518995,0.00194393,84.07418687
5329,試圖,12,519007,0.00194393,84.07613080
5330,農曆,12,519019,0.00194393,84.07807473
5331,運氣,12,519031,0.00194393,84.08001866
5332,運動員,12,519043,0.00194393,84.08196259
5333,違法,12,519055,0.00194393,84.08390652
5334,隔離,12,519067,0.00194393,84.08585045
5335,零,12,519079,0.00194393,84.08779438
5336,零組件,12,519091,0.00194393,84.08973831
5337,對面,12,519103,0.00194393,84.09168225
5338,構造,12,519115,0.00194393,84.09362618
5339,歌迷,12,519127,0.00194393,84.09557011
5340,熊隊,12,519139,0.00194393,84.09751404
5341,疑慮,12,519151,0.00194393,84.09945797
5342,監察委員,12,519163,0.00194393,84.10140190
5343,種族,12,519175,0.00194393,84.10334583
5344,精心,12,519187,0.00194393,84.10528976
5345,精確,12,519199,0.00194393,84.10723369
5346,維生素,12,519211,0.00194393,84.10917762
5347,聚集,12,519223,0.00194393,84.11112155
5348,臺,12,519235,0.00194393,84.11306548
5349,與眾不同,12,519247,0.00194393,84.11500941
5350,與會,12,519259,0.00194393,84.11695334
5351,銀,12,519271,0.00194393,84.11889727
5352,領隊,12,519283,0.00194393,84.12084120
5353,颱風,12,519295,0.00194393,84.12278513
5354,價錢,12,519307,0.00194393,84.12472906
5355,劇本,12,519319,0.00194393,84.12667300
5356,劉偉建,12,519331,0.00194393,84.12861693
5357,劍士,12,519343,0.00194393,84.13056086
5358,廠牌,12,519355,0.00194393,84.13250479
5359,撞擊,12,519367,0.00194393,84.13444872
5360,皺紋,12,519379,0.00194393,84.13639265
5361,確,12,519391,0.00194393,84.13833658
5362,線路,12,519403,0.00194393,84.14028051
5363,緩慢,12,519415,0.00194393,84.14222444
5364,踢,12,519427,0.00194393,84.14416837
5365,鄧麗君,12,519439,0.00194393,84.14611230
5366,鬧,12,519451,0.00194393,84.14805623
5367,魄力,12,519463,0.00194393,84.15000016
5368,奮鬥,12,519475,0.00194393,84.15194409
5369,學位,12,519487,0.00194393,84.15388802
5370,樹林,12,519499,0.00194393,84.15583195
5371,濃厚,12,519511,0.00194393,84.15777588
5372,興起,12,519523,0.00194393,84.15971981
5373,融入,12,519535,0.00194393,84.16166375
5374,謀,12,519547,0.00194393,84.16360768
5375,選用,12,519559,0.00194393,84.16555161
5376,選項,12,519571,0.00194393,84.16749554
5377,錄影帶,12,519583,0.00194393,84.16943947
5378,靜靜,12,519595,0.00194393,84.17138340
5379,頭盔,12,519607,0.00194393,84.17332733
5380,儲蓄,12,519619,0.00194393,84.17527126
5381,嚐,12,519631,0.00194393,84.17721519
5382,嬰兒潮,12,519643,0.00194393,84.17915912
5383,應是,12,519655,0.00194393,84.18110305
5384,擊,12,519667,0.00194393,84.18304698
5385,擊敗,12,519679,0.00194393,84.18499091
5386,擬定,12,519691,0.00194393,84.18693484
5387,檢視,12,519703,0.00194393,84.18887877
5388,營建,12,519715,0.00194393,84.19082270
5389,糟糕,12,519727,0.00194393,84.19276663
5390,虧,12,519739,0.00194393,84.19471056
5391,謎,12,519751,0.00194393,84.19665450
5392,邁進,12,519763,0.00194393,84.19859843
5393,邀集,12,519775,0.00194393,84.20054236
5394,鮮活,12,519787,0.00194393,84.20248629
5395,叢集,12,519799,0.00194393,84.20443022
5396,轉盤,12,519811,0.00194393,84.20637415
5397,額外,12,519823,0.00194393,84.20831808
5398,繳交,12,519835,0.00194393,84.21026201
5399,嚴,12,519847,0.00194393,84.21220594
5400,寶貝,12,519859,0.00194393,84.21414987
5401,艦艇,12,519871,0.00194393,84.21609380
5402,蘋果電腦,12,519883,0.00194393,84.21803773
5403,覺醒,12,519895,0.00194393,84.21998166
5404,觸摸,12,519907,0.00194393,84.22192559
5405,釋憲,12,519919,0.00194393,84.22386952
5406,黨部,12,519931,0.00194393,84.22581345
5407,露天,12,519943,0.00194393,84.22775738
5408,襯衫,12,519955,0.00194393,84.22970132
5409,驚奇,12,519967,0.00194393,84.23164525
5410,體育場,12,519979,0.00194393,84.23358918
5411,人氣,11,519990,0.00178194,84.23537111
5412,入口,11,520001,0.00178194,84.23715305
5413,入圍,11,520012,0.00178194,84.23893499
5414,入選,11,520023,0.00178194,84.24071692
5415,三重,11,520034,0.00178194,84.24249886
5416,上半年,11,520045,0.00178194,84.24428079
5417,上門,11,520056,0.00178194,84.24606273
5418,上級,11,520067,0.00178194,84.24784467
5419,上游,11,520078,0.00178194,84.24962660
5420,上櫃,11,520089,0.00178194,84.25140854
5421,口服,11,520100,0.00178194,84.25319048
5422,口感,11,520111,0.00178194,84.25497241
5423,大宗,11,520122,0.00178194,84.25675435
5424,大法官會議,11,520133,0.00178194,84.25853629
5425,大哥大,11,520144,0.00178194,84.26031822
5426,山水,11,520155,0.00178194,84.26210016
5427,工作人員,11,520166,0.00178194,84.26388209
5428,工作站,11,520177,0.00178194,84.26566403
5429,工商,11,520188,0.00178194,84.26744597
5430,工藝,11,520199,0.00178194,84.26922790
5431,不怕,11,520210,0.00178194,84.27100984
5432,不堪,11,520221,0.00178194,84.27279178
5433,不難,11,520232,0.00178194,84.27457371
5434,不讓,11,520243,0.00178194,84.27635565
5435,中正機場,11,520254,0.00178194,84.27813758
5436,公務員,11,520265,0.00178194,84.27991952
5437,分工,11,520276,0.00178194,84.28170146
5438,分店,11,520287,0.00178194,84.28348339
5439,切葉蟻,11,520298,0.00178194,84.28526533
5440,反正,11,520309,0.00178194,84.28704727
5441,天秤座,11,520320,0.00178194,84.28882920
5442,夫人,11,520331,0.00178194,84.29061114
5443,引導,11,520342,0.00178194,84.29239308
5444,日常生活,11,520353,0.00178194,84.29417501
5445,欠缺,11,520364,0.00178194,84.29595695
5446,水份,11,520375,0.00178194,84.29773888
5447,火車,11,520386,0.00178194,84.29952082
5448,父母親,11,520397,0.00178194,84.30130276
5449,牙齒,11,520408,0.00178194,84.30308469
5450,主辦單位,11,520419,0.00178194,84.30486663
5451,代表性,11,520430,0.00178194,84.30664857
5452,仙人掌桿菌,11,520441,0.00178194,84.30843050
5453,仙仔,11,520452,0.00178194,84.31021244
5454,充足,11,520463,0.00178194,84.31199438
5455,冬,11,520474,0.00178194,84.31377631
5456,出局,11,520485,0.00178194,84.31555825
5457,出動,11,520496,0.00178194,84.31734018
5458,出擊,11,520507,0.00178194,84.31912212
5459,卡位,11,520518,0.00178194,84.32090406
5460,可觀,11,520529,0.00178194,84.32268599
5461,台大,11,520540,0.00178194,84.32446793
5462,台視,11,520551,0.00178194,84.32624987
5463,台語,11,520562,0.00178194,84.32803180
5464,孕,11,520573,0.00178194,84.32981374
5465,市值,11,520584,0.00178194,84.33159568
5466,市議員,11,520595,0.00178194,84.33337761
5467,打扮,11,520606,0.00178194,84.33515955
5468,打敗,11,520617,0.00178194,84.33694148
5469,本周,11,520628,0.00178194,84.33872342
5470,正如,11,520639,0.00178194,84.34050536
5471,民心,11,520650,0.00178194,84.34228729
5472,目睹,11,520661,0.00178194,84.34406923
5473,交代,11,520672,0.00178194,84.34585117
5474,休假,11,520683,0.00178194,84.34763310
5475,任期,11,520694,0.00178194,84.34941504
5476,光是,11,520705,0.00178194,84.35119698
5477,先前,11,520716,0.00178194,84.35297891
5478,全民,11,520727,0.00178194,84.35476085
5479,全年,11,520738,0.00178194,84.35654278
5480,共鳴,11,520749,0.00178194,84.35832472
5481,冰,11,520760,0.00178194,84.36010666
5482,印證,11,520771,0.00178194,84.36188859
5483,吉普車,11,520782,0.00178194,84.36367053
5484,各地,11,520793,0.00178194,84.36545247
5485,名片,11,520804,0.00178194,84.36723440
5486,合計,11,520815,0.00178194,84.36901634
5487,回復,11,520826,0.00178194,84.37079828
5488,回想,11,520837,0.00178194,84.37258021
5489,在場,11,520848,0.00178194,84.37436215
5490,好友,11,520859,0.00178194,84.37614408
5491,安慰,11,520870,0.00178194,84.37792602
5492,忙碌,11,520881,0.00178194,84.37970796
5493,成人,11,520892,0.00178194,84.38148989
5494,托比亞斯,11,520903,0.00178194,84.38327183
5495,曲子,11,520914,0.00178194,84.38505377
5496,有名,11,520925,0.00178194,84.38683570
5497,死刑,11,520936,0.00178194,84.38861764
5498,死海,11,520947,0.00178194,84.39039957
5499,江,11,520958,0.00178194,84.39218151
5500,老百姓,11,520969,0.00178194,84.39396345
5501,耳朵,11,520980,0.00178194,84.39574538
5502,自排,11,520991,0.00178194,84.39752732
5503,舟,11,521002,0.00178194,84.39930926
5504,住處,11,521013,0.00178194,84.40109119
5505,何孝齊,11,521024,0.00178194,84.40287313
5506,作業系統,11,521035,0.00178194,84.40465507
5507,低廉,11,521046,0.00178194,84.40643700
5508,判定,11,521057,0.00178194,84.40821894
5509,妊娠,11,521068,0.00178194,84.41000087
5510,屁股,11,521079,0.00178194,84.41178281
5511,尾,11,521090,0.00178194,84.41356475
5512,弟弟,11,521101,0.00178194,84.41534668
5513,忍不住,11,521112,0.00178194,84.41712862
5514,扶持,11,521123,0.00178194,84.41891056
5515,改用,11,521134,0.00178194,84.42069249
5516,改選,11,521145,0.00178194,84.42247443
5517,更多,11,521156,0.00178194,84.42425637
5518,李秀村,11,521167,0.00178194,84.42603830
5519,李奧貝納,11,521178,0.00178194,84.42782024
5520,步行,11,521189,0.00178194,84.42960217
5521,沙灘,11,521200,0.00178194,84.43138411
5522,沈重,11,521211,0.00178194,84.43316605
5523,災難,11,521222,0.00178194,84.43494798
5524,秀,11,521233,0.00178194,84.43672992
5525,罕見,11,521244,0.00178194,84.43851186
5526,迄,11,521255,0.00178194,84.44029379
5527,迄今,11,521266,0.00178194,84.44207573
5528,並未,11,521277,0.00178194,84.44385767
5529,事故,11,521288,0.00178194,84.44563960
5530,亞,11,521299,0.00178194,84.44742154
5531,享用,11,521310,0.00178194,84.44920347
5532,來不及,11,521321,0.00178194,84.45098541
5533,佩服,11,521332,0.00178194,84.45276735
5534,兩棲,11,521343,0.00178194,84.45454928
5535,受託人,11,521354,0.00178194,84.45633122
5536,命名,11,521365,0.00178194,84.45811316
5537,定居,11,521376,0.00178194,84.45989509
5538,官司,11,521387,0.00178194,84.46167703
5539,宜蘭,11,521398,0.00178194,84.46345897
5540,延後,11,521409,0.00178194,84.46524090
5541,弦,11,521420,0.00178194,84.46702284
5542,往年,11,521431,0.00178194,84.46880477
5543,往事,11,521442,0.00178194,84.47058671
5544,征,11,521453,0.00178194,84.47236865
5545,彼,11,521464,0.00178194,84.47415058
5546,怪物,11,521475,0.00178194,84.47593252
5547,性感,11,521486,0.00178194,84.47771446
5548,承攬,11,521497,0.00178194,84.47949639
5549,拒,11,521508,0.00178194,84.48127833
5550,抵抗,11,521519,0.00178194,84.48306027
5551,昂貴,11,521530,0.00178194,84.48484220
5552,果,11,521541,0.00178194,84.48662414
5553,果酸,11,521552,0.00178194,84.48840607
5554,武則天,11,521563,0.00178194,84.49018801
5555,歧視,11,521574,0.00178194,84.49196995
5556,法治,11,521585,0.00178194,84.49375188
5557,直徑,11,521596,0.00178194,84.49553382
5558,直覺,11,521607,0.00178194,84.49731576
5559,股本,11,521618,0.00178194,84.49909769
5560,花卉,11,521629,0.00178194,84.50087963
5561,返回,11,521640,0.00178194,84.50266156
5562,長江,11,521651,0.00178194,84.50444350
5563,長鼻猴,11,521662,0.00178194,84.50622544
5564,便當,11,521673,0.00178194,84.50800737
5565,保健,11,521684,0.00178194,84.50978931
5566,前夕,11,521695,0.00178194,84.51157125
5567,前者,11,521706,0.00178194,84.51335318
5568,勁,11,521717,0.00178194,84.51513512
5569,叛逆,11,521728,0.00178194,84.51691706
5570,品嘗,11,521739,0.00178194,84.51869899
5571,哈薩克,11,521750,0.00178194,84.52048093
5572,姿,11,521761,0.00178194,84.52226286
5573,姚,11,521772,0.00178194,84.52404480
5574,威士忌,11,521783,0.00178194,84.52582674
5575,宣言,11,521794,0.00178194,84.52760867
5576,封閉,11,521805,0.00178194,84.52939061
5577,屋主,11,521816,0.00178194,84.53117255
5578,建材,11,521827,0.00178194,84.53295448
5579,建築業,11,521838,0.00178194,84.53473642
5580,挖,11,521849,0.00178194,84.53651836
5581,指稱,11,521860,0.00178194,84.53830029
5582,施政,11,521871,0.00178194,84.54008223
5583,春暉,11,521882,0.00178194,84.54186416
5584,架設,11,521893,0.00178194,84.54364610
5585,查看,11,521904,0.00178194,84.54542804
5586,洋裝,11,521915,0.00178194,84.54720997
5587,流暢,11,521926,0.00178194,84.54899191
5588,洗澡,11,521937,0.00178194,84.55077385
5589,炫,11,521948,0.00178194,84.55255578
5590,相比,11,521959,0.00178194,84.55433772
5591,祈禱,11,521970,0.00178194,84.55611966
5592,秒鐘,11,521981,0.00178194,84.55790159
5593,秋,11,521992,0.00178194,84.55968353
5594,突顯,11,522003,0.00178194,84.56146546
5595,胡蘿蔔,11,522014,0.00178194,84.56324740
5596,胎,11,522025,0.00178194,84.56502934
5597,致富,11,522036,0.00178194,84.56681127
5598,軌道,11,522047,0.00178194,84.56859321
5599,郁慕明,11,522058,0.00178194,84.57037515
5600,重建,11,522069,0.00178194,84.57215708
5601,重疊,11,522080,0.00178194,84.57393902
5602,音樂會,11,522091,0.00178194,84.57572096
5603,香料,11,522102,0.00178194,84.57750289
5604,乘客,11,522113,0.00178194,84.57928483
5605,倆,11,522124,0.00178194,84.58106676
5606,借用,11,522135,0.00178194,84.58284870
5607,俱樂部,11,522146,0.00178194,84.58463064
5608,修飾,11,522157,0.00178194,84.58641257
5609,兼任,11,522168,0.00178194,84.58819451
5610,剛剛,11,522179,0.00178194,84.58997645
5611,埃及,11,522190,0.00178194,84.59175838
5612,拿起,11,522201,0.00178194,84.59354032
5613,時光,11,522212,0.00178194,84.59532226
5614,時裝,11,522223,0.00178194,84.59710419
5615,柴油,11,522234,0.00178194,84.59888613
5616,格局,11,522245,0.00178194,84.60066806
5617,真相,11,522256,0.00178194,84.60245000
5618,真菌,11,522267,0.00178194,84.60423194
5619,矩形,11,522278,0.00178194,84.60601387
5620,秘訣,11,522289,0.00178194,84.60779581
5621,窄,11,522300,0.00178194,84.60957775
5622,粉,11,522311,0.00178194,84.61135968
5623,粉霜,11,522322,0.00178194,84.61314162
5624,紡織,11,522333,0.00178194,84.61492355
5625,素質,11,522344,0.00178194,84.61670549
5626,胸部,11,522355,0.00178194,84.61848743
5627,能源,11,522366,0.00178194,84.62026936
5628,脊椎,11,522377,0.00178194,84.62205130
5629,航運,11,522388,0.00178194,84.62383324
5630,茶,11,522399,0.00178194,84.62561517
5631,茶匙,11,522410,0.00178194,84.62739711
5632,蚊,11,522421,0.00178194,84.62917905
5633,記住,11,522432,0.00178194,84.63096098
5634,豈,11,522443,0.00178194,84.63274292
5635,逃避,11,522454,0.00178194,84.63452485
5636,追溯,11,522465,0.00178194,84.63630679
5637,除去,11,522476,0.00178194,84.63808873
5638,馬索,11,522487,0.00178194,84.63987066
5639,骨骼,11,522498,0.00178194,84.64165260
5640,做出,11,522509,0.00178194,84.64343454
5641,偷偷,11,522520,0.00178194,84.64521647
5642,務必,11,522531,0.00178194,84.64699841
5643,參選,11,522542,0.00178194,84.64878035
5644,基隆,11,522553,0.00178194,84.65056228
5645,執政,11,522564,0.00178194,84.65234422
5646,寂寞,11,522575,0.00178194,84.65412615
5647,宿舍,11,522586,0.00178194,84.65590809
5648,密,11,522597,0.00178194,84.65769003
5649,專屬,11,522608,0.00178194,84.65947196
5650,將領,11,522619,0.00178194,84.66125390
5651,彩妝,11,522630,0.00178194,84.66303584
5652,患,11,522641,0.00178194,84.66481777
5653,控,11,522652,0.00178194,84.66659971
5654,捲,11,522663,0.00178194,84.66838165
5655,探,11,522674,0.00178194,84.67016358
5656,採集,11,522685,0.00178194,84.67194552
5657,教訓,11,522696,0.00178194,84.67372745
5658,教練團,11,522707,0.00178194,84.67550939
5659,啟用,11,522718,0.00178194,84.67729133
5660,啟示,11,522729,0.00178194,84.67907326
5661,旋風,11,522740,0.00178194,84.68085520
5662,殺手,11,522751,0.00178194,84.68263714
5663,清運,11,522762,0.00178194,84.68441907
5664,球賽,11,522773,0.00178194,84.68620101
5665,理所當然,11,522784,0.00178194,84.68798295
5666,盛名,11,522795,0.00178194,84.68976488
5667,眼皮,11,522806,0.00178194,84.69154682
5668,眼前,11,522817,0.00178194,84.69332875
5669,處女座,11,522828,0.00178194,84.69511069
5670,術,11,522839,0.00178194,84.69689263
5671,被提名人,11,522850,0.00178194,84.69867456
5672,規律,11,522861,0.00178194,84.70045650
5673,貨物,11,522872,0.00178194,84.70223844
5674,郭,11,522883,0.00178194,84.70402037
5675,野生,11,522894,0.00178194,84.70580231
5676,陵墓,11,522905,0.00178194,84.70758425
5677,雪,11,522916,0.00178194,84.70936618
5678,喝采,11,522927,0.00178194,84.71114812
5679,圍繞,11,522938,0.00178194,84.71293005
5680,媒介,11,522949,0.00178194,84.71471199
5681,復仇,11,522960,0.00178194,84.71649393
5682,惠嘉,11,522971,0.00178194,84.71827586
5683,愉悅,11,522982,0.00178194,84.72005780
5684,提箱,11,522993,0.00178194,84.72183974
5685,揚,11,523004,0.00178194,84.72362167
5686,期刊,11,523015,0.00178194,84.72540361
5687,殘,11,523026,0.00178194,84.72718554
5688,游牧,11,523037,0.00178194,84.72896748
5689,無聊,11,523048,0.00178194,84.73074942
5690,登場,11,523059,0.00178194,84.73253135
5691,發行量,11,523070,0.00178194,84.73431329
5692,發售,11,523081,0.00178194,84.73609523
5693,稅收,11,523092,0.00178194,84.73787716
5694,稅前盈利,11,523103,0.00178194,84.73965910
5695,菁英,11,523114,0.00178194,84.74144104
5696,華爾街,11,523125,0.00178194,84.74322297
5697,視場,11,523136,0.00178194,84.74500491
5698,象隊,11,523147,0.00178194,84.74678684
5699,貴族,11,523158,0.00178194,84.74856878
5700,越來越,11,523169,0.00178194,84.75035072
5701,開刀,11,523180,0.00178194,84.75213265
5702,飲用,11,523191,0.00178194,84.75391459
5703,黃金基金,11,523202,0.00178194,84.75569653
5704,傳出,11,523213,0.00178194,84.75747846
5705,傳輸線,11,523224,0.00178194,84.75926040
5706,募集,11,523235,0.00178194,84.76104234
5707,匯入,11,523246,0.00178194,84.76282427
5708,嫁,11,523257,0.00178194,84.76460621
5709,媳婦,11,523268,0.00178194,84.76638814
5710,感到,11,523279,0.00178194,84.76817008
5711,感慨,11,523290,0.00178194,84.76995202
5712,會同,11,523301,0.00178194,84.77173395
5713,會見,11,523312,0.00178194,84.77351589
5714,會面,11,523323,0.00178194,84.77529783
5715,會談,11,523334,0.00178194,84.77707976
5716,極限,11,523345,0.00178194,84.77886170
5717,源頭,11,523356,0.00178194,84.78064364
5718,準確,11,523367,0.00178194,84.78242557
5719,煙,11,523378,0.00178194,84.78420751
5720,瑕疵,11,523389,0.00178194,84.78598944
5721,睫毛膏,11,523400,0.00178194,84.78777138
5722,禁忌,11,523411,0.00178194,84.78955332
5723,經前症候群,11,523422,0.00178194,84.79133525
5724,經銷商,11,523433,0.00178194,84.79311719
5725,腦部,11,523444,0.00178194,84.79489913
5726,腦溢血,11,523455,0.00178194,84.79668106
5727,董事會,11,523466,0.00178194,84.79846300
5728,號稱,11,523477,0.00178194,84.80024494
5729,補償費,11,523488,0.00178194,84.80202687
5730,解脫,11,523499,0.00178194,84.80380881
5731,解釋令,11,523510,0.00178194,84.80559074
5732,詩人,11,523521,0.00178194,84.80737268
5733,誠洲,11,523532,0.00178194,84.80915462
5734,農地,11,523543,0.00178194,84.81093655
5735,過世,11,523554,0.00178194,84.81271849
5736,隔壁,11,523565,0.00178194,84.81450043
5737,雷伊納,11,523576,0.00178194,84.81628236
5738,雷射,11,523587,0.00178194,84.81806430
5739,飽,11,523598,0.00178194,84.81984624
5740,寧靜,11,523609,0.00178194,84.82162817
5741,實在是,11,523620,0.00178194,84.82341011
5742,對付,11,523631,0.00178194,84.82519204
5743,對策,11,523642,0.00178194,84.82697398
5744,彰化銀行,11,523653,0.00178194,84.82875592
5745,慣,11,523664,0.00178194,84.83053785
5746,敲,11,523675,0.00178194,84.83231979
5747,旗,11,523686,0.00178194,84.83410173
5748,演唱會,11,523697,0.00178194,84.83588366
5749,演說,11,523708,0.00178194,84.83766560
5750,演練,11,523719,0.00178194,84.83944753
5751,熊,11,523730,0.00178194,84.84122947
5752,福建省,11,523741,0.00178194,84.84301141
5753,精靈,11,523752,0.00178194,84.84479334
5754,綠,11,523763,0.00178194,84.84657528
5755,緊密,11,523774,0.00178194,84.84835722
5756,網址,11,523785,0.00178194,84.85013915
5757,膏藥,11,523796,0.00178194,84.85192109
5758,製片,11,523807,0.00178194,84.85370303
5759,語音,11,523818,0.00178194,84.85548496
5760,說不定,11,523829,0.00178194,84.85726690
5761,鳴,11,523840,0.00178194,84.85904883
5762,劇烈,11,523851,0.00178194,84.86083077
5763,劇團,11,523862,0.00178194,84.86261271
5764,劉泰英,11,523873,0.00178194,84.86439464
5765,噴,11,523884,0.00178194,84.86617658
5766,寬度,11,523895,0.00178194,84.86795852
5767,幢,11,523906,0.00178194,84.86974045
5768,徵詢,11,523917,0.00178194,84.87152239
5769,憂心,11,523928,0.00178194,84.87330433
5770,摩根史坦利,11,523939,0.00178194,84.87508626
5771,摩擦,11,523950,0.00178194,84.87686820
5772,模仿,11,523961,0.00178194,84.87865013
5773,潘,11,523972,0.00178194,84.88043207
5774,編織,11,523983,0.00178194,84.88221401
5775,蔓延,11,523994,0.00178194,84.88399594
5776,調節,11,524005,0.00178194,84.88577788
5777,調製,11,524016,0.00178194,84.88755982
5778,賣座,11,524027,0.00178194,84.88934175
5779,適時,11,524038,0.00178194,84.89112369
5780,鄰,11,524049,0.00178194,84.89290563
5781,震,11,524060,0.00178194,84.89468756
5782,儘,11,524071,0.00178194,84.89646950
5783,學童,11,524082,0.00178194,84.89825143
5784,橋,11,524093,0.00178194,84.90003337
5785,機房,11,524104,0.00178194,84.90181531
5786,歷程,11,524115,0.00178194,84.90359724
5787,澳門,11,524126,0.00178194,84.90537918
5788,積欠,11,524137,0.00178194,84.90716112
5789,蕭萬長,11,524148,0.00178194,84.90894305
5790,靜,11,524159,0.00178194,84.91072499
5791,頭銜,11,524170,0.00178194,84.91250693
5792,頭髮,11,524181,0.00178194,84.91428886
5793,營造業,11,524192,0.00178194,84.91607080
5794,爵士,11,524203,0.00178194,84.91785273
5795,總共,11,524214,0.00178194,84.91963467
5796,聲稱,11,524225,0.00178194,84.92141661
5797,聯繫,11,524236,0.00178194,84.92319854
5798,舉動,11,524247,0.00178194,84.92498048
5799,賺取,11,524258,0.00178194,84.92676242
5800,購屋,11,524269,0.00178194,84.92854435
5801,邁,11,524280,0.00178194,84.93032629
5802,隱藏,11,524291,0.00178194,84.93210823
5803,鮮豔,11,524302,0.00178194,84.93389016
5804,點名,11,524313,0.00178194,84.93567210
5805,黛咪摩兒,11,524324,0.00178194,84.93745403
5806,嚮往,11,524335,0.00178194,84.93923597
5807,覆蓋,11,524346,0.00178194,84.94101791
5808,魏,11,524357,0.00178194,84.94279984
5809,繪,11,524368,0.00178194,84.94458178
5810,繪製,11,524379,0.00178194,84.94636372
5811,羅馬,11,524390,0.00178194,84.94814565
5812,藝,11,524401,0.00178194,84.94992759
5813,藝術節,11,524412,0.00178194,84.95170952
5814,蹲,11,524423,0.00178194,84.95349146
5815,辭職,11,524434,0.00178194,84.95527340
5816,關聯,11,524445,0.00178194,84.95705533
5817,寶,11,524456,0.00178194,84.95883727
5818,寶貴,11,524467,0.00178194,84.96061921
5819,繽紛,11,524478,0.00178194,84.96240114
5820,蘇有朋,11,524489,0.00178194,84.96418308
5821,蘇聯,11,524500,0.00178194,84.96596502
5822,觸,11,524511,0.00178194,84.96774695
5823,議程,11,524522,0.00178194,84.96952889
5824,鐘,11,524533,0.00178194,84.97131082
5825,屬下,11,524544,0.00178194,84.97309276
5826,護盤,11,524555,0.00178194,84.97487470
5827,鐵路,11,524566,0.00178194,84.97665663
5828,襯,11,524577,0.00178194,84.97843857
5829,髒,11,524588,0.00178194,84.98022051
5830,曬,11,524599,0.00178194,84.98200244
5831,顯示器,11,524610,0.00178194,84.98378438
5832,罐,11,524621,0.00178194,84.98556632
5833,鑽,11,524632,0.00178194,84.98734825
5834,一口氣,10,524642,0.00161994,84.98896819
5835,人生觀,10,524652,0.00161994,84.99058814
5836,人質,10,524662,0.00161994,84.99220808
5837,下注,10,524672,0.00161994,84.99382802
5838,上去,10,524682,0.00161994,84.99544796
5839,上學,10,524692,0.00161994,84.99706790
5840,口碑,10,524702,0.00161994,84.99868785
5841,大阪,10,524712,0.00161994,85.00030779
5842,大蒜,10,524722,0.00161994,85.00192773
5843,大舉,10,524732,0.00161994,85.00354767
5844,女孩子,10,524742,0.00161994,85.00516762
5845,子民,10,524752,0.00161994,85.00678756
5846,子宮頸,10,524762,0.00161994,85.00840750
5847,小狗,10,524772,0.00161994,85.01002744
5848,小胖,10,524782,0.00161994,85.01164738
5849,小幅,10,524792,0.00161994,85.01326733
5850,小鎮,10,524802,0.00161994,85.01488727
5851,山頭,10,524812,0.00161994,85.01650721
5852,山藥,10,524822,0.00161994,85.01812715
5853,才華,10,524832,0.00161994,85.01974709
5854,不小心,10,524842,0.00161994,85.02136704
5855,不止,10,524852,0.00161994,85.02298698
5856,不明,10,524862,0.00161994,85.02460692
5857,不得了,10,524872,0.00161994,85.02622686
5858,不顧,10,524882,0.00161994,85.02784681
5859,中校,10,524892,0.00161994,85.02946675
5860,中國時報,10,524902,0.00161994,85.03108669
5861,中港路,10,524912,0.00161994,85.03270663
5862,元素,10,524922,0.00161994,85.03432657
5863,內銷,10,524932,0.00161994,85.03594652
5864,公斤米,10,524942,0.00161994,85.03756646
5865,公司債,10,524952,0.00161994,85.03918640
5866,公共場所,10,524962,0.00161994,85.04080634
5867,公會,10,524972,0.00161994,85.04242628
5868,分析家,10,524982,0.00161994,85.04404623
5869,切除,10,524992,0.00161994,85.04566617
5870,化身,10,525002,0.00161994,85.04728611
5871,化纖廠,10,525012,0.00161994,85.04890605
5872,天生,10,525022,0.00161994,85.05052600
5873,天真,10,525032,0.00161994,85.05214594
5874,少見,10,525042,0.00161994,85.05376588
5875,尺碼,10,525052,0.00161994,85.05538582
5876,巴克侯,10,525062,0.00161994,85.05700576
5877,心理學,10,525072,0.00161994,85.05862571
5878,心愛,10,525082,0.00161994,85.06024565
5879,手上,10,525092,0.00161994,85.06186559
5880,手腳,10,525102,0.00161994,85.06348553
5881,手續費,10,525112,0.00161994,85.06510547
5882,木下,10,525122,0.00161994,85.06672542
5883,木屋,10,525132,0.00161994,85.06834536
5884,欠,10,525142,0.00161994,85.06996530
5885,比照,10,525152,0.00161994,85.07158524
5886,水利會,10,525162,0.00161994,85.07320519
5887,水腫,10,525172,0.00161994,85.07482513
5888,火車站,10,525182,0.00161994,85.07644507
5889,王永慶,10,525192,0.00161994,85.07806501
5890,王進輝,10,525202,0.00161994,85.07968495
5891,主持人,10,525212,0.00161994,85.08130490
5892,主軸,10,525222,0.00161994,85.08292484
5893,代理權,10,525232,0.00161994,85.08454478
5894,充裕,10,525242,0.00161994,85.08616472
5895,出頭,10,525252,0.00161994,85.08778466
5896,加護中心,10,525262,0.00161994,85.08940461
5897,功學社,10,525272,0.00161994,85.09102455
5898,包圍,10,525282,0.00161994,85.09264449
5899,包袱,10,525292,0.00161994,85.09426443
5900,台股,10,525302,0.00161994,85.09588438
5901,台獨,10,525312,0.00161994,85.09750432
5902,外人,10,525322,0.00161994,85.09912426
5903,外星人,10,525332,0.00161994,85.10074420
5904,失控,10,525342,0.00161994,85.10236414
5905,失誤,10,525352,0.00161994,85.10398409
5906,奶粉,10,525362,0.00161994,85.10560403
5907,巨人,10,525372,0.00161994,85.10722397
5908,巨星,10,525382,0.00161994,85.10884391
5909,巧,10,525392,0.00161994,85.11046385
5910,市場派,10,525402,0.00161994,85.11208380
5911,布拉姆斯,10,525412,0.00161994,85.11370374
5912,平安,10,525422,0.00161994,85.11532368
5913,汁,10,525432,0.00161994,85.11694362
5914,玉山銀行,10,525442,0.00161994,85.11856356
5915,白髮,10,525452,0.00161994,85.12018351
5916,皮膚炎,10,525462,0.00161994,85.12180345
5917,交接,10,525472,0.00161994,85.12342339
5918,休息室,10,525482,0.00161994,85.12504333
5919,任命,10,525492,0.00161994,85.12666328
5920,光華隊,10,525502,0.00161994,85.12828322
5921,光源,10,525512,0.00161994,85.12990316
5922,先天,10,525522,0.00161994,85.13152310
5923,全身,10,525532,0.00161994,85.13314304
5924,全國,10,525542,0.00161994,85.13476299
5925,吉田,10,525552,0.00161994,85.13638293
5926,同胞,10,525562,0.00161994,85.13800287
5927,回合,10,525572,0.00161994,85.13962281
5928,地毯,10,525582,0.00161994,85.14124275
5929,多寡,10,525592,0.00161994,85.14286270
5930,好吃,10,525602,0.00161994,85.14448264
5931,字眼,10,525612,0.00161994,85.14610258
5932,安置,10,525622,0.00161994,85.14772252
5933,安撫,10,525632,0.00161994,85.14934247
5934,收取,10,525642,0.00161994,85.15096241
5935,收看,10,525652,0.00161994,85.15258235
5936,收穫,10,525662,0.00161994,85.15420229
5937,早產,10,525672,0.00161994,85.15582223
5938,曲目,10,525682,0.00161994,85.15744218
5939,次長,10,525692,0.00161994,85.15906212
5940,汗,10,525702,0.00161994,85.16068206
5941,百姓,10,525712,0.00161994,85.16230200
5942,老年癡呆症,10,525722,0.00161994,85.16392194
5943,自稱,10,525732,0.00161994,85.16554189
5944,色系,10,525742,0.00161994,85.16716183
5945,色素斑,10,525752,0.00161994,85.16878177
5946,艾敬,10,525762,0.00161994,85.17040171
5947,伴侶,10,525772,0.00161994,85.17202166
5948,伴奏,10,525782,0.00161994,85.17364160
5949,何必,10,525792,0.00161994,85.17526154
5950,作料,10,525802,0.00161994,85.17688148
5951,克制,10,525812,0.00161994,85.17850142
5952,助長,10,525822,0.00161994,85.18012137
5953,即日,10,525832,0.00161994,85.18174131
5954,吵,10,525842,0.00161994,85.18336125
5955,完畢,10,525852,0.00161994,85.18498119
5956,扭轉,10,525862,0.00161994,85.18660113
5957,李連,10,525872,0.00161994,85.18822108
5958,村子,10,525882,0.00161994,85.18984102
5959,求學,10,525892,0.00161994,85.19146096
5960,汽門,10,525902,0.00161994,85.19308090
5961,甫,10,525912,0.00161994,85.19470085
5962,良,10,525922,0.00161994,85.19632079
5963,良性,10,525932,0.00161994,85.19794073
5964,見解,10,525942,0.00161994,85.19956067
5965,角力,10,525952,0.00161994,85.20118061
5966,貝比魯斯,10,525962,0.00161994,85.20280056
5967,車系,10,525972,0.00161994,85.20442050
5968,巡防艦,10,525982,0.00161994,85.20604044
5969,巡邏,10,525992,0.00161994,85.20766038
5970,事先,10,526002,0.00161994,85.20928032
5971,些許,10,526012,0.00161994,85.21090027
5972,亞克丹司,10,526022,0.00161994,85.21252021
5973,佳作,10,526032,0.00161994,85.21414015
5974,來訪,10,526042,0.00161994,85.21576009
5975,併,10,526052,0.00161994,85.21738004
5976,刻板,10,526062,0.00161994,85.21899998
5977,卓越,10,526072,0.00161994,85.22061992
5978,取出,10,526082,0.00161994,85.22223986
5979,坦承,10,526092,0.00161994,85.22385980
5980,委託人,10,526102,0.00161994,85.22547975
5981,孟克,10,526112,0.00161994,85.22709969
5982,幸好,10,526122,0.00161994,85.22871963
5983,拉丁,10,526132,0.00161994,85.23033957
5984,抬,10,526142,0.00161994,85.23195951
5985,旺盛,10,526152,0.00161994,85.23357946
5986,服,10,526162,0.00161994,85.23519940
5987,武裝,10,526172,0.00161994,85.23681934
5988,油桐花,10,526182,0.00161994,85.23843928
5989,治安,10,526192,0.00161994,85.24005923
5990,爭論,10,526202,0.00161994,85.24167917
5991,物資,10,526212,0.00161994,85.24329911
5992,物體,10,526222,0.00161994,85.24491905
5993,玩具,10,526232,0.00161994,85.24653899
5994,直升機,10,526242,0.00161994,85.24815894
5995,社交,10,526252,0.00161994,85.24977888
5996,空檔,10,526262,0.00161994,85.25139882
5997,肥胖,10,526272,0.00161994,85.25301876
5998,股指,10,526282,0.00161994,85.25463870
5999,芭樂票,10,526292,0.00161994,85.25625865
6000,花旗,10,526302,0.00161994,85.25787859
6001,表徵,10,526312,0.00161994,85.25949853
6002,迎,10,526322,0.00161994,85.26111847
6003,迎合,10,526332,0.00161994,85.26273841
6004,邱正雄,10,526342,0.00161994,85.26435836
6005,金牛座,10,526352,0.00161994,85.26597830
6006,金融業,10,526362,0.00161994,85.26759824
6007,阻止,10,526372,0.00161994,85.26921818
6008,附加,10,526382,0.00161994,85.27083813
6009,信件,10,526392,0.00161994,85.27245807
6010,勇者,10,526402,0.00161994,85.27407801
6011,南韓,10,526412,0.00161994,85.27569795
6012,客機,10,526422,0.00161994,85.27731789
6013,屋子,10,526432,0.00161994,85.27893784
6014,後遺症,10,526442,0.00161994,85.28055778
6015,指南,10,526452,0.00161994,85.28217772
6016,柱,10,526462,0.00161994,85.28379766
6017,查緝,10,526472,0.00161994,85.28541760
6018,洞,10,526482,0.00161994,85.28703755
6019,洗淨,10,526492,0.00161994,85.28865749
6020,洽詢,10,526502,0.00161994,85.29027743
6021,相容性,10,526512,0.00161994,85.29189737
6022,研討會,10,526522,0.00161994,85.29351732
6023,研習,10,526532,0.00161994,85.29513726
6024,穿梭,10,526542,0.00161994,85.29675720
6025,約談,10,526552,0.00161994,85.29837714
6026,美女,10,526562,0.00161994,85.29999708
6027,美方,10,526572,0.00161994,85.30161703
6028,美格,10,526582,0.00161994,85.30323697
6029,胚胎,10,526592,0.00161994,85.30485691
6030,英商,10,526602,0.00161994,85.30647685
6031,要素,10,526612,0.00161994,85.30809679
6032,訂定,10,526622,0.00161994,85.30971674
6033,軍官,10,526632,0.00161994,85.31133668
6034,軍隊,10,526642,0.00161994,85.31295662
6035,重奏,10,526652,0.00161994,85.31457656
6036,風水,10,526662,0.00161994,85.31619651
6037,風光,10,526672,0.00161994,85.31781645
6038,食材,10,526682,0.00161994,85.31943639
6039,食療,10,526692,0.00161994,85.32105633
6040,倒閉,10,526702,0.00161994,85.32267627
6041,俱,10,526712,0.00161994,85.32429622
6042,個案,10,526722,0.00161994,85.32591616
6043,兼顧,10,526732,0.00161994,85.32753610
6044,哩,10,526742,0.00161994,85.32915604
6045,埋,10,526752,0.00161994,85.33077598
6046,家鄉,10,526762,0.00161994,85.33239593
6047,射,10,526772,0.00161994,85.33401587
6048,射手座,10,526782,0.00161994,85.33563581
6049,座談會,10,526792,0.00161994,85.33725575
6050,悄悄,10,526802,0.00161994,85.33887570
6051,拿出,10,526812,0.00161994,85.34049564
6052,振興,10,526822,0.00161994,85.34211558
6053,桃園市,10,526832,0.00161994,85.34373552
6054,海拔,10,526842,0.00161994,85.34535546
6055,海豚,10,526852,0.00161994,85.34697541
6056,特有,10,526862,0.00161994,85.34859535
6057,真主黨,10,526872,0.00161994,85.35021529
6058,租用,10,526882,0.00161994,85.35183523
6059,秘書,10,526892,0.00161994,85.35345517
6060,笑話,10,526902,0.00161994,85.35507512
6061,純真,10,526912,0.00161994,85.35669506
6062,納,10,526922,0.00161994,85.35831500
6063,逃逸,10,526932,0.00161994,85.35993494
6064,郝柏村,10,526942,0.00161994,85.36155489
6065,骨質,10,526952,0.00161994,85.36317483
6066,高清愿,10,526962,0.00161994,85.36479477
6067,高齡,10,526972,0.00161994,85.36641471
6068,停滯,10,526982,0.00161994,85.36803465
6069,假使,10,526992,0.00161994,85.36965460
6070,動向,10,527002,0.00161994,85.37127454
6071,參展,10,527012,0.00161994,85.37289448
6072,商家,10,527022,0.00161994,85.37451442
6073,商圈,10,527032,0.00161994,85.37613436
6074,商標,10,527042,0.00161994,85.37775431
6075,國中,10,527052,0.00161994,85.37937425
6076,國內外,10,527062,0.00161994,85.38099419
6077,國家主席,10,527072,0.00161994,85.38261413
6078,堅定,10,527082,0.00161994,85.38423408
6079,執照,10,527092,0.00161994,85.38585402
6080,培里,10,527102,0.00161994,85.38747396
6081,培訓,10,527112,0.00161994,85.38909390
6082,婦人,10,527122,0.00161994,85.39071384
6083,寄望,10,527132,0.00161994,85.39233379
6084,崇高,10,527142,0.00161994,85.39395373
6085,常用,10,527152,0.00161994,85.39557367
6086,常見,10,527162,0.00161994,85.39719361
6087,強行,10,527172,0.00161994,85.39881355
6088,彩,10,527182,0.00161994,85.40043350
6089,現狀,10,527192,0.00161994,85.40205344
6090,現貨,10,527202,0.00161994,85.40367338
6091,瓶頸,10,527212,0.00161994,85.40529332
6092,疏忽,10,527222,0.00161994,85.40691327
6093,痕跡,10,527232,0.00161994,85.40853321
6094,盛大,10,527242,0.00161994,85.41015315
6095,眼淚,10,527252,0.00161994,85.41177309
6096,票券,10,527262,0.00161994,85.41339303
6097,細緻,10,527272,0.00161994,85.41501298
6098,組裝,10,527282,0.00161994,85.41663292
6099,習性,10,527292,0.00161994,85.41825286
6100,處女,10,527302,0.00161994,85.41987280
6101,被迫,10,527312,0.00161994,85.42149274
6102,袋,10,527322,0.00161994,85.42311269
6103,規避,10,527332,0.00161994,85.42473263
6104,許登男,10,527342,0.00161994,85.42635257
6105,這時,10,527352,0.00161994,85.42797251
6106,連絡,10,527362,0.00161994,85.42959245
6107,速率,10,527372,0.00161994,85.43121240
6108,釣,10,527382,0.00161994,85.43283234
6109,陳兆宏,10,527392,0.00161994,85.43445228
6110,陳宏文,10,527402,0.00161994,85.43607222
6111,陳俊榮,10,527412,0.00161994,85.43769217
6112,陸委會,10,527422,0.00161994,85.43931211
6113,陷阱,10,527432,0.00161994,85.44093205
6114,雪梨交響樂團,10,527442,0.00161994,85.44255199
6115,麥金塔,10,527452,0.00161994,85.44417193
6116,傘,10,527462,0.00161994,85.44579188
6117,剩餘,10,527472,0.00161994,85.44741182
6118,報表,10,527482,0.00161994,85.44903176
6119,尊,10,527492,0.00161994,85.45065170
6120,就會,10,527502,0.00161994,85.45227164
6121,揮,10,527512,0.00161994,85.45389159
6122,散戶,10,527522,0.00161994,85.45551153
6123,普,10,527532,0.00161994,85.45713147
6124,景物,10,527542,0.00161994,85.45875141
6125,期許,10,527552,0.00161994,85.46037136
6126,椎,10,527562,0.00161994,85.46199130
6127,棉紡業,10,527572,0.00161994,85.46361124
6128,款項,10,527582,0.00161994,85.46523118
6129,殘留,10,527592,0.00161994,85.46685112
6130,游泳池,10,527602,0.00161994,85.46847107
6131,渡假,10,527612,0.00161994,85.47009101
6132,湊,10,527622,0.00161994,85.47171095
6133,減免,10,527632,0.00161994,85.47333089
6134,測量,10,527642,0.00161994,85.47495083
6135,無助,10,527652,0.00161994,85.47657078
6136,猶,10,527662,0.00161994,85.47819072
6137,猶豫,10,527672,0.00161994,85.47981066
6138,發放,10,527682,0.00161994,85.48143060
6139,發表會,10,527692,0.00161994,85.48305055
6140,盜壘,10,527702,0.00161994,85.48467049
6141,短線,10,527712,0.00161994,85.48629043
6142,絨毛膜,10,527722,0.00161994,85.48791037
6143,紫,10,527732,0.00161994,85.48953031
6144,善良,10,527742,0.00161994,85.49115026
6145,華航,10,527752,0.00161994,85.49277020
6146,華麗,10,527762,0.00161994,85.49439014
6147,視線,10,527772,0.00161994,85.49601008
6148,買下,10,527782,0.00161994,85.49763002
6149,買盤,10,527792,0.00161994,85.49924997
6150,超級電腦,10,527802,0.00161994,85.50086991
6151,跑步,10,527812,0.00161994,85.50248985
6152,開業,10,527822,0.00161994,85.50410979
6153,階級,10,527832,0.00161994,85.50572974
6154,陽台,10,527842,0.00161994,85.50734968
6155,雲林,10,527852,0.00161994,85.50896962
6156,飯館,10,527862,0.00161994,85.51058956
6157,黃大洲,10,527872,0.00161994,85.51220950
6158,傳真,10,527882,0.00161994,85.51382945
6159,傷亡,10,527892,0.00161994,85.51544939
6160,傷口,10,527902,0.00161994,85.51706933
6161,匯,10,527912,0.00161994,85.51868927
6162,填,10,527922,0.00161994,85.52030921
6163,媽,10,527932,0.00161994,85.52192916
6164,搖,10,527942,0.00161994,85.52354910
6165,新新人類,10,527952,0.00161994,85.52516904
6166,暖,10,527962,0.00161994,85.52678898
6167,滑落,10,527972,0.00161994,85.52840893
6168,瑜伽,10,527982,0.00161994,85.53002887
6169,當今,10,527992,0.00161994,85.53164881
6170,碰撞,10,528002,0.00161994,85.53326875
6171,經期,10,528012,0.00161994,85.53488869
6172,置身,10,528022,0.00161994,85.53650864
6173,罩杯,10,528032,0.00161994,85.53812858
6174,義務,10,528042,0.00161994,85.53974852
6175,腮紅,10,528052,0.00161994,85.54136846
6176,腳踏車,10,528062,0.00161994,85.54298840
6177,葉君璋,10,528072,0.00161994,85.54460835
6178,誠,10,528082,0.00161994,85.54622829
6179,資本額,10,528092,0.00161994,85.54784823
6180,資訊業,10,528102,0.00161994,85.54946817
6181,路透社,10,528112,0.00161994,85.55108812
6182,過癮,10,528122,0.00161994,85.55270806
6183,電信,10,528132,0.00161994,85.55432800
6184,電纜,10,528142,0.00161994,85.55594794
6185,預先,10,528152,0.00161994,85.55756788
6186,圖片,10,528162,0.00161994,85.55918783
6187,圖表,10,528172,0.00161994,85.56080777
6188,察覺,10,528182,0.00161994,85.56242771
6189,嶄新,10,528192,0.00161994,85.56404765
6190,廖福本,10,528202,0.00161994,85.56566759
6191,弊案,10,528212,0.00161994,85.56728754
6192,彰化市,10,528222,0.00161994,85.56890748
6193,態,10,528232,0.00161994,85.57052742
6194,截然不同,10,528242,0.00161994,85.57214736
6195,敲定,10,528252,0.00161994,85.57376731
6196,構圖,10,528262,0.00161994,85.57538725
6197,歌唱,10,528272,0.00161994,85.57700719
6198,歌聲,10,528282,0.00161994,85.57862713
6199,演技,10,528292,0.00161994,85.58024707
6200,演戲,10,528302,0.00161994,85.58186702
6201,盡情,10,528312,0.00161994,85.58348696
6202,精美,10,528322,0.00161994,85.58510690
6203,精密,10,528332,0.00161994,85.58672684
6204,罰,10,528342,0.00161994,85.58834678
6205,語氣,10,528352,0.00161994,85.58996673
6206,誘因,10,528362,0.00161994,85.59158667
6207,賓士車,10,528372,0.00161994,85.59320661
6208,賓館,10,528382,0.00161994,85.59482655
6209,趙少康,10,528392,0.00161994,85.59644649
6210,酸痛,10,528402,0.00161994,85.59806644
6211,銀幕,10,528412,0.00161994,85.59968638
6212,鼻子,10,528422,0.00161994,85.60130632
6213,僵直性脊椎炎,10,528432,0.00161994,85.60292626
6214,價值觀,10,528442,0.00161994,85.60454621
6215,嘲笑,10,528452,0.00161994,85.60616615
6216,嘴唇,10,528462,0.00161994,85.60778609
6217,層出不窮,10,528472,0.00161994,85.60940603
6218,廢物,10,528482,0.00161994,85.61102597
6219,廟會,10,528492,0.00161994,85.61264592
6220,摩根概念股,10,528502,0.00161994,85.61426586
6221,數額,10,528512,0.00161994,85.61588580
6222,暴,10,528522,0.00161994,85.61750574
6223,暴露,10,528532,0.00161994,85.61912568
6224,澎湖,10,528542,0.00161994,85.62074563
6225,熱愛,10,528552,0.00161994,85.62236557
6226,窮,10,528562,0.00161994,85.62398551
6227,範疇,10,528572,0.00161994,85.62560545
6228,締造,10,528582,0.00161994,85.62722540
6229,膚質,10,528592,0.00161994,85.62884534
6230,談談,10,528602,0.00161994,85.63046528
6231,踏,10,528612,0.00161994,85.63208522
6232,輝煌,10,528622,0.00161994,85.63370516
6233,醋,10,528632,0.00161994,85.63532511
6234,學名,10,528642,0.00161994,85.63694505
6235,學年,10,528652,0.00161994,85.63856499
6236,戰神,10,528662,0.00161994,85.64018493
6237,戰略,10,528672,0.00161994,85.64180487
6238,擔當,10,528682,0.00161994,85.64342482
6239,橫,10,528692,0.00161994,85.64504476
6240,機緣,10,528702,0.00161994,85.64666470
6241,濃度,10,528712,0.00161994,85.64828464
6242,激情,10,528722,0.00161994,85.64990459
6243,獨自,10,528732,0.00161994,85.65152453
6244,膨脹,10,528742,0.00161994,85.65314447
6245,蕭,10,528752,0.00161994,85.65476441
6246,謂,10,528762,0.00161994,85.65638435
6247,踴躍,10,528772,0.00161994,85.65800430
6248,辨認,10,528782,0.00161994,85.65962424
6249,遵守,10,528792,0.00161994,85.66124418
6250,雕刻,10,528802,0.00161994,85.66286412
6251,餐飲,10,528812,0.00161994,85.66448406
6252,濱中,10,528822,0.00161994,85.66610401
6253,獲勝,10,528832,0.00161994,85.66772395
6254,環繞,10,528842,0.00161994,85.66934389
6255,矯正,10,528852,0.00161994,85.67096383
6256,縱使,10,528862,0.00161994,85.67258378
6257,臉上,10,528872,0.00161994,85.67420372
6258,隱憂,10,528882,0.00161994,85.67582366
6259,點子,10,528892,0.00161994,85.67744360
6260,擺設,10,528902,0.00161994,85.67906354
6261,檯面,10,528912,0.00161994,85.68068349
6262,轉型,10,528922,0.00161994,85.68230343
6263,雙重,10,528932,0.00161994,85.68392337
6264,顏行書,10,528942,0.00161994,85.68554331
6265,簽署,10,528952,0.00161994,85.68716325
6266,繪圖,10,528962,0.00161994,85.68878320
6267,羅大中,10,528972,0.00161994,85.69040314
6268,羅繼志,10,528982,0.00161994,85.69202308
6269,繳納,10,528992,0.00161994,85.69364302
6270,鏡,10,529002,0.00161994,85.69526297
6271,懸掛,10,529012,0.00161994,85.69688291
6272,籃板球,10,529022,0.00161994,85.69850285
6273,艦隊,10,529032,0.00161994,85.70012279
6274,蘇啟,10,529042,0.00161994,85.70174273
6275,警,10,529052,0.00161994,85.70336268
6276,警戒,10,529062,0.00161994,85.70498262
6277,警艇,10,529072,0.00161994,85.70660256
6278,贏得,10,529082,0.00161994,85.70822250
6279,轟動,10,529092,0.00161994,85.70984244
6280,籠罩,10,529102,0.00161994,85.71146239
6281,讀友,10,529112,0.00161994,85.71308233
6282,髒亂,10,529122,0.00161994,85.71470227
6283,變形,10,529132,0.00161994,85.71632221
6284,顯露,10,529142,0.00161994,85.71794216
6285,體貼,10,529152,0.00161994,85.71956210
6286,體溫,10,529162,0.00161994,85.72118204
6287,鹽田,10,529172,0.00161994,85.72280198
6288,觀景窗,10,529182,0.00161994,85.72442192
6289,一陣,9,529191,0.00145795,85.72587987
6290,一銀,9,529200,0.00145795,85.72733782
6291,人心,9,529209,0.00145795,85.72879577
6292,人文,9,529218,0.00145795,85.73025372
6293,人次,9,529227,0.00145795,85.73171166
6294,入門,9,529236,0.00145795,85.73316961
6295,下滑,9,529245,0.00145795,85.73462756
6296,上前,9,529254,0.00145795,85.73608551
6297,上癮,9,529263,0.00145795,85.73754345
6298,也要,9,529272,0.00145795,85.73900140
6299,土城,9,529281,0.00145795,85.74045935
6300,土星,9,529290,0.00145795,85.74191730
6301,大股東,9,529299,0.00145795,85.74337525
6302,大陸隊,9,529308,0.00145795,85.74483319
6303,大學生,9,529317,0.00145795,85.74629114
6304,大戰,9,529326,0.00145795,85.74774909
6305,大餐,9,529335,0.00145795,85.74920704
6306,子彈,9,529344,0.00145795,85.75066499
6307,小生,9,529353,0.00145795,85.75212293
6308,小型,9,529362,0.00145795,85.75358088
6309,小偷,9,529371,0.00145795,85.75503883
6310,山坡地,9,529380,0.00145795,85.75649678
6311,不一,9,529389,0.00145795,85.75795473
6312,不凡,9,529398,0.00145795,85.75941267
6313,不可或缺,9,529407,0.00145795,85.76087062
6314,不信,9,529416,0.00145795,85.76232857
6315,不舒服,9,529425,0.00145795,85.76378652
6316,不彰,9,529434,0.00145795,85.76524447
6317,中外,9,529443,0.00145795,85.76670241
6318,中和,9,529452,0.00145795,85.76816036
6319,中樞,9,529461,0.00145795,85.76961831
6320,允諾,9,529470,0.00145795,85.77107626
6321,公有地,9,529479,0.00145795,85.77253421
6322,分為,9,529488,0.00145795,85.77399215
6323,切入,9,529497,0.00145795,85.77545010
6324,切割,9,529506,0.00145795,85.77690805
6325,反潛,9,529515,0.00145795,85.77836600
6326,心思,9,529524,0.00145795,85.77982394
6327,心臟病,9,529533,0.00145795,85.78128189
6328,文攻武嚇,9,529542,0.00145795,85.78273984
6329,文案,9,529551,0.00145795,85.78419779
6330,木製家具,9,529560,0.00145795,85.78565574
6331,比喻,9,529569,0.00145795,85.78711368
6332,火力,9,529578,0.00145795,85.78857163
6333,火山,9,529587,0.00145795,85.79002958
6334,火災,9,529596,0.00145795,85.79148753
6335,火腿,9,529605,0.00145795,85.79294548
6336,牛奶,9,529614,0.00145795,85.79440342
6337,王作榮,9,529623,0.00145795,85.79586137
6338,主宰,9,529632,0.00145795,85.79731932
6339,充沛,9,529641,0.00145795,85.79877727
6340,充實,9,529650,0.00145795,85.80023522
6341,出巡,9,529659,0.00145795,85.80169316
6342,出事,9,529668,0.00145795,85.80315111
6343,包容,9,529677,0.00145795,85.80460906
6344,北方,9,529686,0.00145795,85.80606701
6345,半數,9,529695,0.00145795,85.80752496
6346,可行性,9,529704,0.00145795,85.80898290
6347,台斤,9,529713,0.00145795,85.81044085
6348,外省,9,529722,0.00145795,85.81189880
6349,巧克力,9,529731,0.00145795,85.81335675
6350,市中心,9,529740,0.00145795,85.81481469
6351,市政府,9,529749,0.00145795,85.81627264
6352,布魯斯威利,9,529758,0.00145795,85.81773059
6353,本益比,9,529767,0.00145795,85.81918854
6354,本能,9,529776,0.00145795,85.82064649
6355,本週,9,529785,0.00145795,85.82210443
6356,正義,9,529794,0.00145795,85.82356238
6357,母帶,9,529803,0.00145795,85.82502033
6358,民謠,9,529812,0.00145795,85.82647828
6359,生效,9,529821,0.00145795,85.82793623
6360,田嬰,9,529830,0.00145795,85.82939417
6361,白冰冰,9,529839,0.00145795,85.83085212
6362,交談,9,529848,0.00145795,85.83231007
6363,交響樂團,9,529857,0.00145795,85.83376802
6364,亦是,9,529866,0.00145795,85.83522597
6365,光碟片,9,529875,0.00145795,85.83668391
6366,先民,9,529884,0.00145795,85.83814186
6367,全新,9,529893,0.00145795,85.83959981
6368,冰淇淋,9,529902,0.00145795,85.84105776
6369,同伴,9,529911,0.00145795,85.84251571
6370,同居,9,529920,0.00145795,85.84397365
6371,同情,9,529929,0.00145795,85.84543160
6372,吃飯,9,529938,0.00145795,85.84688955
6373,回味,9,529947,0.00145795,85.84834750
6374,回流,9,529956,0.00145795,85.84980544
6375,回陽人,9,529965,0.00145795,85.85126339
6376,回響,9,529974,0.00145795,85.85272134
6377,地下室,9,529983,0.00145795,85.85417929
6378,地震,9,529992,0.00145795,85.85563724
6379,字母,9,530001,0.00145795,85.85709518
6380,存款準備率,9,530010,0.00145795,85.85855313
6381,安德遜,9,530019,0.00145795,85.86001108
6382,成功者,9,530028,0.00145795,85.86146903
6383,成就感,9,530037,0.00145795,85.86292698
6384,成龍,9,530046,0.00145795,85.86438492
6385,成績單,9,530055,0.00145795,85.86584287
6386,收回,9,530064,0.00145795,85.86730082
6387,收拾,9,530073,0.00145795,85.86875877
6388,收場,9,530082,0.00145795,85.87021672
6389,早日,9,530091,0.00145795,85.87167466
6390,死者,9,530100,0.00145795,85.87313261
6391,汐止,9,530109,0.00145795,85.87459056
6392,百分點,9,530118,0.00145795,85.87604851
6393,百貨業,9,530127,0.00145795,85.87750646
6394,老實,9,530136,0.00145795,85.87896440
6395,考古學家,9,530145,0.00145795,85.88042235
6396,肉質,9,530154,0.00145795,85.88188030
6397,自來水公司,9,530163,0.00145795,85.88333825
6398,自裁,9,530172,0.00145795,85.88479620
6399,自認,9,530181,0.00145795,85.88625414
6400,西洋棋,9,530190,0.00145795,85.88771209
6401,低檔,9,530199,0.00145795,85.88917004
6402,佈置,9,530208,0.00145795,85.89062799
6403,克萊斯勒,9,530217,0.00145795,85.89208593
6404,兵力,9,530226,0.00145795,85.89354388
6405,兵役課,9,530235,0.00145795,85.89500183
6406,冷漠,9,530244,0.00145795,85.89645978
6407,別府,9,530253,0.00145795,85.89791773
6408,判,9,530262,0.00145795,85.89937567
6409,刪除,9,530271,0.00145795,85.90083362
6410,卵巢,9,530280,0.00145795,85.90229157
6411,呈報,9,530289,0.00145795,85.90374952
6412,君,9,530298,0.00145795,85.90520747
6413,吻合,9,530307,0.00145795,85.90666541
6414,吸引力,9,530316,0.00145795,85.90812336
6415,妥善,9,530325,0.00145795,85.90958131
6416,巫術,9,530334,0.00145795,85.91103926
6417,志工,9,530343,0.00145795,85.91249721
6418,扯,9,530352,0.00145795,85.91395515
6419,投保,9,530361,0.00145795,85.91541310
6420,投機,9,530370,0.00145795,85.91687105
6421,改制,9,530379,0.00145795,85.91832900
6422,束,9,530388,0.00145795,85.91978695
6423,李奧,9,530397,0.00145795,85.92124489
6424,沖,9,530406,0.00145795,85.92270284
6425,沖洗,9,530415,0.00145795,85.92416079
6426,牡羊,9,530424,0.00145795,85.92561874
6427,狂,9,530433,0.00145795,85.92707668
6428,男主角,9,530442,0.00145795,85.92853463
6429,男裝,9,530451,0.00145795,85.92999258
6430,肝,9,530460,0.00145795,85.93145053
6431,身影,9,530469,0.00145795,85.93290848
6432,車門,9,530478,0.00145795,85.93436642
6433,車程,9,530487,0.00145795,85.93582437
6434,邪惡,9,530496,0.00145795,85.93728232
6435,防範,9,530505,0.00145795,85.93874027
6436,阮義忠,9,530514,0.00145795,85.94019822
6437,乳酪,9,530523,0.00145795,85.94165616
6438,佳績,9,530532,0.00145795,85.94311411
6439,制定,9,530541,0.00145795,85.94457206
6440,卓著,9,530550,0.00145795,85.94603001
6441,取樣術,9,530559,0.00145795,85.94748796
6442,取締,9,530568,0.00145795,85.94894590
6443,受不了,9,530577,0.00145795,85.95040385
6444,受害者,9,530586,0.00145795,85.95186180
6445,咒文,9,530595,0.00145795,85.95331975
6446,和尚,9,530604,0.00145795,85.95477770
6447,周六,9,530613,0.00145795,85.95623564
6448,奔,9,530622,0.00145795,85.95769359
6449,姓名,9,530631,0.00145795,85.95915154
6450,孟拓亞,9,530640,0.00145795,85.96060949
6451,季野,9,530649,0.00145795,85.96206743
6452,定價,9,530658,0.00145795,85.96352538
6453,幸福隊,9,530667,0.00145795,85.96498333
6454,府,9,530676,0.00145795,85.96644128
6455,延誤,9,530685,0.00145795,85.96789923
6456,征服,9,530694,0.00145795,85.96935717
6457,房市,9,530703,0.00145795,85.97081512
6458,承接,9,530712,0.00145795,85.97227307
6459,招牌,9,530721,0.00145795,85.97373102
6460,抽取,9,530730,0.00145795,85.97518897
6461,抽獎,9,530739,0.00145795,85.97664691
6462,放下,9,530748,0.00145795,85.97810486
6463,放映,9,530757,0.00145795,85.97956281
6464,放款,9,530766,0.00145795,85.98102076
6465,服務台,9,530775,0.00145795,85.98247871
6466,林志穎,9,530784,0.00145795,85.98393665
6467,林朝煌,9,530793,0.00145795,85.98539460
6468,林榮三,9,530802,0.00145795,85.98685255
6469,注,9,530811,0.00145795,85.98831050
6470,河流,9,530820,0.00145795,85.98976845
6471,波及,9,530829,0.00145795,85.99122639
6472,波浪,9,530838,0.00145795,85.99268434
6473,波蘭,9,530847,0.00145795,85.99414229
6474,法辦,9,530856,0.00145795,85.99560024
6475,況且,9,530865,0.00145795,85.99705819
6476,沿途,9,530874,0.00145795,85.99851613
6477,版圖,9,530883,0.00145795,85.99997408
6478,疝氣,9,530892,0.00145795,86.00143203
6479,直選,9,530901,0.00145795,86.00288998
6480,股市穩定基金,9,530910,0.00145795,86.00434792
6481,肯,9,530919,0.00145795,86.00580587
6482,臥室,9,530928,0.00145795,86.00726382
6483,芳香,9,530937,0.00145795,86.00872177
6484,花朵,9,530946,0.00145795,86.01017972
6485,虎頭山,9,530955,0.00145795,86.01163766
6486,表決,9,530964,0.00145795,86.01309561
6487,返家,9,530973,0.00145795,86.01455356
6488,金鷹獎,9,530982,0.00145795,86.01601151
6489,長短,9,530991,0.00145795,86.01746946
6490,門市,9,531000,0.00145795,86.01892740
6491,阿公,9,531009,0.00145795,86.02038535
6492,阿旭,9,531018,0.00145795,86.02184330
6493,阿姨,9,531027,0.00145795,86.02330125
6494,阿郎,9,531036,0.00145795,86.02475920
6495,阿爾泰山,9,531045,0.00145795,86.02621714
6496,青春期,9,531054,0.00145795,86.02767509
6497,亟,9,531063,0.00145795,86.02913304
6498,信函,9,531072,0.00145795,86.03059099
6499,信徒,9,531081,0.00145795,86.03204894
6500,信箱,9,531090,0.00145795,86.03350688
6501,侵蝕,9,531099,0.00145795,86.03496483
6502,促成,9,531108,0.00145795,86.03642278
6503,削弱,9,531117,0.00145795,86.03788073
6504,前所未有,9,531126,0.00145795,86.03933867
6505,南僑,9,531135,0.00145795,86.04079662
6506,咨請,9,531144,0.00145795,86.04225457
6507,型式,9,531153,0.00145795,86.04371252
6508,城堡,9,531162,0.00145795,86.04517047
6509,姿態,9,531171,0.00145795,86.04662841
6510,孩童,9,531180,0.00145795,86.04808636
6511,巷,9,531189,0.00145795,86.04954431
6512,建物,9,531198,0.00145795,86.05100226
6513,後市,9,531207,0.00145795,86.05246021
6514,恆心,9,531216,0.00145795,86.05391815
6515,拜拜,9,531225,0.00145795,86.05537610
6516,施文彬,9,531234,0.00145795,86.05683405
6517,施明德,9,531243,0.00145795,86.05829200
6518,施振榮,9,531252,0.00145795,86.05974995
6519,查出,9,531261,0.00145795,86.06120789
6520,查閱,9,531270,0.00145795,86.06266584
6521,柏岡札,9,531279,0.00145795,86.06412379
6522,流向,9,531288,0.00145795,86.06558174
6523,流動,9,531297,0.00145795,86.06703969
6524,珊儂,9,531306,0.00145795,86.06849763
6525,皇家,9,531315,0.00145795,86.06995558
6526,研議,9,531324,0.00145795,86.07141353
6527,祈求,9,531333,0.00145795,86.07287148
6528,科幻,9,531342,0.00145795,86.07432942
6529,秋季,9,531351,0.00145795,86.07578737
6530,紅場,9,531360,0.00145795,86.07724532
6531,紅蘿蔔,9,531369,0.00145795,86.07870327
6532,缸,9,531378,0.00145795,86.08016122
6533,胃,9,531387,0.00145795,86.08161916
6534,苦瓜,9,531396,0.00145795,86.08307711
6535,英國人,9,531405,0.00145795,86.08453506
6536,英鎊,9,531414,0.00145795,86.08599301
6537,重頭戲,9,531423,0.00145795,86.08745096
6538,限量,9,531432,0.00145795,86.08890890
6539,面具,9,531441,0.00145795,86.09036685
6540,音符,9,531450,0.00145795,86.09182480
6541,音質,9,531459,0.00145795,86.09328275
6542,風行,9,531468,0.00145795,86.09474070
6543,風采,9,531477,0.00145795,86.09619864
6544,食譜,9,531486,0.00145795,86.09765659
6545,借貸,9,531495,0.00145795,86.09911454
6546,唐吉訶德,9,531504,0.00145795,86.10057249
6547,哥哥,9,531513,0.00145795,86.10203044
6548,唇部,9,531522,0.00145795,86.10348838
6549,孫,9,531531,0.00145795,86.10494633
6550,宮殿,9,531540,0.00145795,86.10640428
6551,容許,9,531549,0.00145795,86.10786223
6552,射手,9,531558,0.00145795,86.10932018
6553,師父,9,531567,0.00145795,86.11077812
6554,弱點,9,531576,0.00145795,86.11223607
6555,恐慌,9,531585,0.00145795,86.11369402
6556,挾,9,531594,0.00145795,86.11515197
6557,旁白,9,531603,0.00145795,86.11660991
6558,旅程,9,531612,0.00145795,86.11806786
6559,時間表,9,531621,0.00145795,86.11952581
6560,泰勒,9,531630,0.00145795,86.12098376
6561,浪,9,531639,0.00145795,86.12244171
6562,海底,9,531648,0.00145795,86.12389965
6563,浮潛,9,531657,0.00145795,86.12535760
6564,狹窄,9,531666,0.00145795,86.12681555
6565,班機,9,531675,0.00145795,86.12827350
6566,病媒,9,531684,0.00145795,86.12973145
6567,病痛,9,531693,0.00145795,86.13118939
6568,砲轟,9,531702,0.00145795,86.13264734
6569,神情,9,531711,0.00145795,86.13410529
6570,祝福,9,531720,0.00145795,86.13556324
6571,站上,9,531729,0.00145795,86.13702119
6572,站台,9,531738,0.00145795,86.13847913
6573,笑容,9,531747,0.00145795,86.13993708
6574,粉紅,9,531756,0.00145795,86.14139503
6575,紙牌,9,531765,0.00145795,86.14285298
6576,缺口,9,531774,0.00145795,86.14431093
6577,訊號,9,531783,0.00145795,86.14576887
6578,託,9,531792,0.00145795,86.14722682
6579,財物,9,531801,0.00145795,86.14868477
6580,起床,9,531810,0.00145795,86.15014272
6581,逆差,9,531819,0.00145795,86.15160066
6582,退化,9,531828,0.00145795,86.15305861
6583,追究,9,531837,0.00145795,86.15451656
6584,配方,9,531846,0.00145795,86.15597451
6585,配件,9,531855,0.00145795,86.15743246
6586,陣列,9,531864,0.00145795,86.15889040
6587,馬世莉,9,531873,0.00145795,86.16034835
6588,高血壓,9,531882,0.00145795,86.16180630
6589,高昂,9,531891,0.00145795,86.16326425
6590,高點,9,531900,0.00145795,86.16472220
6591,偽造,9,531909,0.00145795,86.16618014
6592,偽鈔,9,531918,0.00145795,86.16763809
6593,停車場,9,531927,0.00145795,86.16909604
6594,假象,9,531936,0.00145795,86.17055399
6595,偏偏,9,531945,0.00145795,86.17201194
6596,偏遠,9,531954,0.00145795,86.17346988
6597,副主委,9,531963,0.00145795,86.17492783
6598,副主席,9,531972,0.00145795,86.17638578
6599,副總裁,9,531981,0.00145795,86.17784373
6600,勒贖,9,531990,0.00145795,86.17930168
6601,務,9,531999,0.00145795,86.18075962
6602,參見,9,532008,0.00145795,86.18221757
6603,參與率,9,532017,0.00145795,86.18367552
6604,參賽,9,532026,0.00145795,86.18513347
6605,唱歌,9,532035,0.00145795,86.18659141
6606,問政,9,532044,0.00145795,86.18804936
6607,國民黨團,9,532053,0.00145795,86.18950731
6608,國庫,9,532062,0.00145795,86.19096526
6609,執著,9,532071,0.00145795,86.19242321
6610,娶,9,532080,0.00145795,86.19388115
6611,密室,9,532089,0.00145795,86.19533910
6612,專訪,9,532098,0.00145795,86.19679705
6613,崑曲,9,532107,0.00145795,86.19825500
6614,張聘三,9,532116,0.00145795,86.19971295
6615,強勁,9,532125,0.00145795,86.20117089
6616,強迫,9,532134,0.00145795,86.20262884
6617,得意,9,532143,0.00145795,86.20408679
6618,接掌,9,532152,0.00145795,86.20554474
6619,接著,9,532161,0.00145795,86.20700269
6620,接觸性,9,532170,0.00145795,86.20846063
6621,推行,9,532179,0.00145795,86.20991858
6622,排版,9,532188,0.00145795,86.21137653
6623,斜,9,532197,0.00145795,86.21283448
6624,晨,9,532206,0.00145795,86.21429243
6625,棄,9,532215,0.00145795,86.21575037
6626,毫無,9,532224,0.00145795,86.21720832
6627,淪,9,532233,0.00145795,86.21866627
6628,深信,9,532242,0.00145795,86.22012422
6629,深思,9,532251,0.00145795,86.22158217
6630,深處,9,532260,0.00145795,86.22304011
6631,淨,9,532269,0.00145795,86.22449806
6632,猛禽,9,532278,0.00145795,86.22595601
6633,甜點,9,532287,0.00145795,86.22741396
6634,產業界,9,532296,0.00145795,86.22887190
6635,眼鏡,9,532305,0.00145795,86.23032985
6636,移植,9,532314,0.00145795,86.23178780
6637,笨,9,532323,0.00145795,86.23324575
6638,終身,9,532332,0.00145795,86.23470370
6639,習,9,532341,0.00145795,86.23616164
6640,荷馬,9,532350,0.00145795,86.23761959
6641,處罰,9,532359,0.00145795,86.23907754
6642,覓,9,532368,0.00145795,86.24053549
6643,許東慶,9,532377,0.00145795,86.24199344
6644,貫徹,9,532386,0.00145795,86.24345138
6645,貪污,9,532395,0.00145795,86.24490933
6646,軟體業,9,532404,0.00145795,86.24636728
6647,通車,9,532413,0.00145795,86.24782523
6648,連鎖店,9,532422,0.00145795,86.24928318
6649,逛,9,532431,0.00145795,86.25074112
6650,部落,9,532440,0.00145795,86.25219907
6651,野,9,532449,0.00145795,86.25365702
6652,陳政賢,9,532458,0.00145795,86.25511497
6653,陳逸達,9,532467,0.00145795,86.25657292
6654,麻痺,9,532476,0.00145795,86.25803086
6655,備用,9,532485,0.00145795,86.25948881
6656,喜餅,9,532494,0.00145795,86.26094676
6657,單車,9,532503,0.00145795,86.26240471
6658,單調,9,532512,0.00145795,86.26386265
6659,喬治亞人壽,9,532521,0.00145795,86.26532060
6660,富裕,9,532530,0.00145795,86.26677855
6661,就讀,9,532539,0.00145795,86.26823650
6662,廁所,9,532548,0.00145795,86.26969445
6663,彭明敏,9,532557,0.00145795,86.27115239
6664,悲傷,9,532566,0.00145795,86.27261034
6665,換取,9,532575,0.00145795,86.27406829
6666,棺木,9,532584,0.00145795,86.27552624
6667,無情,9,532593,0.00145795,86.27698419
6668,無意,9,532602,0.00145795,86.27844213
6669,畫作,9,532611,0.00145795,86.27990008
6670,發動機,9,532620,0.00145795,86.28135803
6671,稍後,9,532629,0.00145795,86.28281598
6672,稍稍,9,532638,0.00145795,86.28427393
6673,筆記型電腦,9,532647,0.00145795,86.28573187
6674,結算,9,532656,0.00145795,86.28718982
6675,善用,9,532665,0.00145795,86.28864777
6676,善意,9,532674,0.00145795,86.29010572
6677,肅貪,9,532683,0.00145795,86.29156367
6678,著眼,9,532692,0.00145795,86.29302161
6679,著實,9,532701,0.00145795,86.29447956
6680,萊納,9,532710,0.00145795,86.29593751
6681,菜餚,9,532719,0.00145795,86.29739546
6682,虛弱,9,532728,0.00145795,86.29885340
6683,蛙,9,532737,0.00145795,86.30031135
6684,評選,9,532746,0.00145795,86.30176930
6685,評鑑,9,532755,0.00145795,86.30322725
6686,買方,9,532764,0.00145795,86.30468520
6687,買家,9,532773,0.00145795,86.30614314
6688,貿易商,9,532782,0.00145795,86.30760109
6689,越劇,9,532791,0.00145795,86.30905904
6690,軸距,9,532800,0.00145795,86.31051699
6691,週期,9,532809,0.00145795,86.31197494
6692,進軍,9,532818,0.00145795,86.31343288
6693,進補,9,532827,0.00145795,86.31489083
6694,郵票,9,532836,0.00145795,86.31634878
6695,鄉村,9,532845,0.00145795,86.31780673
6696,開幕戰,9,532854,0.00145795,86.31926468
6697,集合,9,532863,0.00145795,86.32072262
6698,債權,9,532872,0.00145795,86.32218057
6699,傻,9,532881,0.00145795,86.32363852
6700,廉價,9,532890,0.00145795,86.32509647
6701,意志,9,532899,0.00145795,86.32655442
6702,損害,9,532908,0.00145795,86.32801236
6703,新奇,9,532917,0.00145795,86.32947031
6704,新陳代謝,9,532926,0.00145795,86.33092826
6705,新聞稿,9,532935,0.00145795,86.33238621
6706,新鮮人,9,532944,0.00145795,86.33384416
6707,獅子王,9,532953,0.00145795,86.33530210
6708,萬物,9,532962,0.00145795,86.33676005
6709,節慶,9,532971,0.00145795,86.33821800
6710,義賣,9,532980,0.00145795,86.33967595
6711,聘,9,532989,0.00145795,86.34113389
6712,腰部,9,532998,0.00145795,86.34259184
6713,落選,9,533007,0.00145795,86.34404979
6714,葡萄牙,9,533016,0.00145795,86.34550774
6715,裡頭,9,533025,0.00145795,86.34696569
6716,試射,9,533034,0.00145795,86.34842363
6717,資本主義,9,533043,0.00145795,86.34988158
6718,資訊網,9,533052,0.00145795,86.35133953
6719,跟前,9,533061,0.00145795,86.35279748
6720,跨越,9,533070,0.00145795,86.35425543
6721,路姒子,9,533079,0.00145795,86.35571337
6722,路程,9,533088,0.00145795,86.35717132
6723,跳舞,9,533097,0.00145795,86.35862927
6724,農村,9,533106,0.00145795,86.36008722
6725,運算,9,533115,0.00145795,86.36154517
6726,遊行,9,533124,0.00145795,86.36300311
6727,道地,9,533133,0.00145795,86.36446106
6728,過量,9,533142,0.00145795,86.36591901
6729,過關,9,533151,0.00145795,86.36737696
6730,鉅額,9,533160,0.00145795,86.36883491
6731,預言,9,533169,0.00145795,86.37029285
6732,嘗,9,533178,0.00145795,86.37175080
6733,嘆,9,533187,0.00145795,86.37320875
6734,嘉義縣,9,533196,0.00145795,86.37466670
6735,塵,9,533205,0.00145795,86.37612464
6736,實務,9,533214,0.00145795,86.37758259
6737,實驗室,9,533223,0.00145795,86.37904054
6738,對照,9,533232,0.00145795,86.38049849
6739,弊,9,533241,0.00145795,86.38195644
6740,彰化縣,9,533250,0.00145795,86.38341438
6741,慢性,9,533259,0.00145795,86.38487233
6742,慣例,9,533268,0.00145795,86.38633028
6743,漫,9,533277,0.00145795,86.38778823
6744,漫長,9,533286,0.00145795,86.38924618
6745,漁民,9,533295,0.00145795,86.39070412
6746,監,9,533304,0.00145795,86.39216207
6747,窩,9,533313,0.00145795,86.39362002
6748,端午節,9,533322,0.00145795,86.39507797
6749,管教,9,533331,0.00145795,86.39653592
6750,管理局,9,533340,0.00145795,86.39799386
6751,管理處,9,533349,0.00145795,86.39945181
6752,管轄,9,533358,0.00145795,86.40090976
6753,精力,9,533367,0.00145795,86.40236771
6754,精明,9,533376,0.00145795,86.40382566
6755,精油,9,533385,0.00145795,86.40528360
6756,精英電腦,9,533394,0.00145795,86.40674155
6757,精準,9,533403,0.00145795,86.40819950
6758,網頁,9,533412,0.00145795,86.40965745
6759,維他命,9,533421,0.00145795,86.41111539
6760,舞場,9,533430,0.00145795,86.41257334
6761,蒙,9,533439,0.00145795,86.41403129
6762,認可,9,533448,0.00145795,86.41548924
6763,認清,9,533457,0.00145795,86.41694719
6764,趙,9,533466,0.00145795,86.41840513
6765,輔選,9,533475,0.00145795,86.41986308
6766,遠百,9,533484,0.00145795,86.42132103
6767,酷,9,533493,0.00145795,86.42277898
6768,閣,9,533502,0.00145795,86.42423693
6769,領悟,9,533511,0.00145795,86.42569487
6770,領標,9,533520,0.00145795,86.42715282
6771,麼,9,533529,0.00145795,86.42861077
6772,劉兆玄,9,533538,0.00145795,86.43006872
6773,寫實,9,533547,0.00145795,86.43152667
6774,廠家,9,533556,0.00145795,86.43298461
6775,敷,9,533565,0.00145795,86.43444256
6776,數學,9,533574,0.00145795,86.43590051
6777,暫停,9,533583,0.00145795,86.43735846
6778,樁,9,533592,0.00145795,86.43881641
6779,標誌,9,533601,0.00145795,86.44027435
6780,標題,9,533610,0.00145795,86.44173230
6781,潛在,9,533619,0.00145795,86.44319025
6782,潮,9,533628,0.00145795,86.44464820
6783,熟知,9,533637,0.00145795,86.44610615
6784,碼頭,9,533646,0.00145795,86.44756409
6785,穀物,9,533655,0.00145795,86.44902204
6786,編制,9,533664,0.00145795,86.45047999
6787,編號,9,533673,0.00145795,86.45193794
6788,緩,9,533682,0.00145795,86.45339588
6789,蔡,9,533691,0.00145795,86.45485383
6790,衝刺,9,533700,0.00145795,86.45631178
6791,複利,9,533709,0.00145795,86.45776973
6792,質地,9,533718,0.00145795,86.45922768
6793,遭到,9,533727,0.00145795,86.46068562
6794,遷移,9,533736,0.00145795,86.46214357
6795,儘快,9,533745,0.00145795,86.46360152
6796,導入,9,533754,0.00145795,86.46505947
6797,導向,9,533763,0.00145795,86.46651742
6798,憑藉,9,533772,0.00145795,86.46797536
6799,戰士,9,533781,0.00145795,86.46943331
6800,擅,9,533790,0.00145795,86.47089126
6801,橋樑,9,533799,0.00145795,86.47234921
6802,激發,9,533808,0.00145795,86.47380716
6803,燈籠,9,533817,0.00145795,86.47526510
6804,獨一無二,9,533826,0.00145795,86.47672305
6805,褪,9,533835,0.00145795,86.47818100
6806,諾史東,9,533844,0.00145795,86.47963895
6807,賴英照,9,533853,0.00145795,86.48109690
6808,輸送,9,533862,0.00145795,86.48255484
6809,辦事處,9,533871,0.00145795,86.48401279
6810,頭痛,9,533880,0.00145795,86.48547074
6811,餐具,9,533889,0.00145795,86.48692869
6812,優選,9,533898,0.00145795,86.48838663
6813,壓住,9,533907,0.00145795,86.48984458
6814,應用軟體,9,533916,0.00145795,86.49130253
6815,檢調,9,533925,0.00145795,86.49276048
6816,濕疹,9,533934,0.00145795,86.49421843
6817,營建業,9,533943,0.00145795,86.49567637
6818,燦爛,9,533952,0.00145795,86.49713432
6819,牆壁,9,533961,0.00145795,86.49859227
6820,獲取,9,533970,0.00145795,86.50005022
6821,獲准,9,533979,0.00145795,86.50150817
6822,環島,9,533988,0.00145795,86.50296611
6823,瞧瞧,9,533997,0.00145795,86.50442406
6824,總算,9,534006,0.00145795,86.50588201
6825,繁多,9,534015,0.00145795,86.50733996
6826,繁複,9,534024,0.00145795,86.50879791
6827,聯合報,9,534033,0.00145795,86.51025585
6828,臨時會,9,534042,0.00145795,86.51171380
6829,艱辛,9,534051,0.00145795,86.51317175
6830,艱苦,9,534060,0.00145795,86.51462970
6831,蕾絲,9,534069,0.00145795,86.51608765
6832,賽跑,9,534078,0.00145795,86.51754559
6833,邁向,9,534087,0.00145795,86.51900354
6834,鍍,9,534096,0.00145795,86.52046149
6835,鍵,9,534105,0.00145795,86.52191944
6836,鍾,9,534114,0.00145795,86.52337738
6837,顆粒,9,534123,0.00145795,86.52483533
6838,鮮明,9,534132,0.00145795,86.52629328
6839,擴散,9,534141,0.00145795,86.52775123
6840,櫃,9,534150,0.00145795,86.52920918
6841,歸屬,9,534159,0.00145795,86.53066712
6842,職員,9,534168,0.00145795,86.53212507
6843,職場,9,534177,0.00145795,86.53358302
6844,職權,9,534186,0.00145795,86.53504097
6845,臍疝氣,9,534195,0.00145795,86.53649892
6846,藏人,9,534204,0.00145795,86.53795686
6847,贅肉,9,534213,0.00145795,86.53941481
6848,蹤影,9,534222,0.00145795,86.54087276
6849,轉向,9,534231,0.00145795,86.54233071
6850,轉身,9,534240,0.00145795,86.54378866
6851,轉動,9,534249,0.00145795,86.54524660
6852,轉運,9,534258,0.00145795,86.54670455
6853,轉機,9,534267,0.00145795,86.54816250
6854,轉虧為盈,9,534276,0.00145795,86.54962045
6855,轉讓,9,534285,0.00145795,86.55107840
6856,醫界,9,534294,0.00145795,86.55253634
6857,鎮長,9,534303,0.00145795,86.55399429
6858,雙眼皮,9,534312,0.00145795,86.55545224
6859,雞,9,534321,0.00145795,86.55691019
6860,鵝,9,534330,0.00145795,86.55836814
6861,羅文基,9,534339,0.00145795,86.55982608
6862,藝術界,9,534348,0.00145795,86.56128403
6863,韻婷,9,534357,0.00145795,86.56274198
6864,類股,9,534366,0.00145795,86.56419993
6865,麗晶,9,534375,0.00145795,86.56565787
6866,嚴密,9,534384,0.00145795,86.56711582
6867,寶藏,9,534393,0.00145795,86.56857377
6868,攔截,9,534402,0.00145795,86.57003172
6869,競,9,534411,0.00145795,86.57148967
6870,籌建,9,534420,0.00145795,86.57294761
6871,籌備會,9,534429,0.00145795,86.57440556
6872,蘇澳,9,534438,0.00145795,86.57586351
6873,覺悟,9,534447,0.00145795,86.57732146
6874,議,9,534456,0.00145795,86.57877941
6875,議長,9,534465,0.00145795,86.58023735
6876,警惕,9,534474,0.00145795,86.58169530
6877,警察局,9,534483,0.00145795,86.58315325
6878,鐘頭,9,534492,0.00145795,86.58461120
6879,齡,9,534501,0.00145795,86.58606915
6880,攝影棚,9,534510,0.00145795,86.58752709
6881,攜手,9,534519,0.00145795,86.58898504
6882,歡喜,9,534528,0.00145795,86.59044299
6883,變換,9,534537,0.00145795,86.59190094
6884,癱瘓,9,534546,0.00145795,86.59335889
6885,觀望,9,534555,0.00145795,86.59481683
6886,讚賞,9,534564,0.00145795,86.59627478
6887,舖,9,534573,0.00145795,86.59773273
6888,乃是,8,534581,0.00129595,86.59902868
6889,三劍客,8,534589,0.00129595,86.60032464
6890,下手,8,534597,0.00129595,86.60162059
6891,下挫,8,534605,0.00129595,86.60291654
6892,上車,8,534613,0.00129595,86.60421250
6893,上來,8,534621,0.00129595,86.60550845
6894,土耳其,8,534629,0.00129595,86.60680440
6895,大火,8,534637,0.00129595,86.60810036
6896,大本營,8,534645,0.00129595,86.60939631
6897,大同,8,534653,0.00129595,86.61069227
6898,大事,8,534661,0.00129595,86.61198822
6899,大富翁,8,534669,0.00129595,86.61328417
6900,大圓滿法,8,534677,0.00129595,86.61458013
6901,大衛,8,534685,0.00129595,86.61587608
6902,女巫店,8,534693,0.00129595,86.61717203
6903,女性主義,8,534701,0.00129595,86.61846799
6904,女裝,8,534709,0.00129595,86.61976394
6905,子弟,8,534717,0.00129595,86.62105990
6906,工地,8,534725,0.00129595,86.62235585
6907,不失,8,534733,0.00129595,86.62365180
6908,不平,8,534741,0.00129595,86.62494776
6909,不好意思,8,534749,0.00129595,86.62624371
6910,不折不扣,8,534757,0.00129595,86.62753966
6911,不振,8,534765,0.00129595,86.62883562
6912,不時,8,534773,0.00129595,86.63013157
6913,不勝枚舉,8,534781,0.00129595,86.63142753
6914,不遠,8,534789,0.00129595,86.63272348
6915,中小企業,8,534797,0.00129595,86.63401943
6916,中油,8,534805,0.00129595,86.63531539
6917,中國銀行,8,534813,0.00129595,86.63661134
6918,公正,8,534821,0.00129595,86.63790729
6919,公路,8,534829,0.00129595,86.63920325
6920,分行,8,534837,0.00129595,86.64049920
6921,切實,8,534845,0.00129595,86.64179516
6922,反串,8,534853,0.00129595,86.64309111
6923,反抗,8,534861,0.00129595,86.64438706
6924,反撲,8,534869,0.00129595,86.64568302
6925,反擊,8,534877,0.00129595,86.64697897
6926,夫婿,8,534885,0.00129595,86.64827492
6927,心聲,8,534893,0.00129595,86.64957088
6928,心願,8,534901,0.00129595,86.65086683
6929,文化界,8,534909,0.00129595,86.65216278
6930,文革,8,534917,0.00129595,86.65345874
6931,文獻,8,534925,0.00129595,86.65475469
6932,方塊,8,534933,0.00129595,86.65605065
6933,日幣,8,534941,0.00129595,86.65734660
6934,月刊,8,534949,0.00129595,86.65864255
6935,木柵,8,534957,0.00129595,86.65993851
6936,毛澤東,8,534965,0.00129595,86.66123446
6937,水車,8,534973,0.00129595,86.66253041
6938,水流,8,534981,0.00129595,86.66382637
6939,水源,8,534989,0.00129595,86.66512232
6940,片酬,8,534997,0.00129595,86.66641828
6941,牛隻,8,535005,0.00129595,86.66771423
6942,王國,8,535013,0.00129595,86.66901018
6943,主題曲,8,535021,0.00129595,86.67030614
6944,主觀,8,535029,0.00129595,86.67160209
6945,代言人,8,535037,0.00129595,86.67289804
6946,代謝,8,535045,0.00129595,86.67419400
6947,加班,8,535053,0.00129595,86.67548995
6948,包商,8,535061,0.00129595,86.67678591
6949,卡車,8,535069,0.00129595,86.67808186
6950,台中縣,8,535077,0.00129595,86.67937781
6951,台塑,8,535085,0.00129595,86.68067377
6952,台灣省長,8,535093,0.00129595,86.68196972
6953,外圍,8,535101,0.00129595,86.68326567
6954,失智症,8,535109,0.00129595,86.68456163
6955,巨石,8,535117,0.00129595,86.68585758
6956,巧妙,8,535125,0.00129595,86.68715353
6957,市議會,8,535133,0.00129595,86.68844949
6958,平方公尺,8,535141,0.00129595,86.68974544
6959,平民,8,535149,0.00129595,86.69104140
6960,平行,8,535157,0.00129595,86.69233735
6961,平等,8,535165,0.00129595,86.69363330
6962,本地,8,535173,0.00129595,86.69492926
6963,母子,8,535181,0.00129595,86.69622521
6964,民宅,8,535189,0.00129595,86.69752116
6965,玉米,8,535197,0.00129595,86.69881712
6966,甘,8,535205,0.00129595,86.70011307
6967,生死,8,535213,0.00129595,86.70140903
6968,生活費,8,535221,0.00129595,86.70270498
6969,生魚片,8,535229,0.00129595,86.70400093
6970,生機,8,535237,0.00129595,86.70529689
6971,用功,8,535245,0.00129595,86.70659284
6972,白蘭氏,8,535253,0.00129595,86.70788879
6973,白蘭地,8,535261,0.00129595,86.70918475
6974,石碑,8,535269,0.00129595,86.71048070
6975,交易所,8,535277,0.00129595,86.71177666
6976,交易會,8,535285,0.00129595,86.71307261
6977,仲量行,8,535293,0.00129595,86.71436856
6978,任何人,8,535301,0.00129595,86.71566452
6979,企業家,8,535309,0.00129595,86.71696047
6980,先鋒,8,535317,0.00129595,86.71825642
6981,共軍,8,535325,0.00129595,86.71955238
6982,共襄盛舉,8,535333,0.00129595,86.72084833
6983,再次,8,535341,0.00129595,86.72214429
6984,再者,8,535349,0.00129595,86.72344024
6985,列出,8,535357,0.00129595,86.72473619
6986,劣勢,8,535365,0.00129595,86.72603215
6987,印表機,8,535373,0.00129595,86.72732810
6988,同等,8,535381,0.00129595,86.72862405
6989,各行各業,8,535389,0.00129595,86.72992001
6990,名人,8,535397,0.00129595,86.73121596
6991,合乎,8,535405,0.00129595,86.73251191
6992,地下停車場,8,535413,0.00129595,86.73380787
6993,地中海,8,535421,0.00129595,86.73510382
6994,地帶,8,535429,0.00129595,86.73639978
6995,地緣,8,535437,0.00129595,86.73769573
6996,好不容易,8,535445,0.00129595,86.73899168
6997,存貨,8,535453,0.00129595,86.74028764
6998,州,8,535461,0.00129595,86.74158359
6999,年收入,8,535469,0.00129595,86.74287954
7000,年終,8,535477,0.00129595,86.74417550
7001,年增率,8,535485,0.00129595,86.74547145
7002,成衣,8,535493,0.00129595,86.74676741
7003,成長性,8,535501,0.00129595,86.74806336
7004,扣,8,535509,0.00129595,86.74935931
7005,有期徒刑,8,535517,0.00129595,86.75065527
7006,灰塵,8,535525,0.00129595,86.75195122
7007,竹馬陣,8,535533,0.00129595,86.75324717
7008,考察,8,535541,0.00129595,86.75454313
7009,自主,8,535549,0.00129595,86.75583908
7010,自來水,8,535557,0.00129595,86.75713504
7011,自製,8,535565,0.00129595,86.75843099
7012,色素,8,535573,0.00129595,86.75972694
7013,色情,8,535581,0.00129595,86.76102290
7014,色調,8,535589,0.00129595,86.76231885
7015,衣物,8,535597,0.00129595,86.76361480
7016,西進,8,535605,0.00129595,86.76491076
7017,西邊,8,535613,0.00129595,86.76620671
7018,伸出,8,535621,0.00129595,86.76750266
7019,克理斯多,8,535629,0.00129595,86.76879862
7020,冷凍,8,535637,0.00129595,86.77009457
7021,別墅,8,535645,0.00129595,86.77139053
7022,利基,8,535653,0.00129595,86.77268648
7023,助攻,8,535661,0.00129595,86.77398243
7024,助陣,8,535669,0.00129595,86.77527839
7025,助理,8,535677,0.00129595,86.77657434
7026,否定,8,535685,0.00129595,86.77787029
7027,壯觀,8,535693,0.00129595,86.77916625
7028,妨礙,8,535701,0.00129595,86.78046220
7029,弄臣,8,535709,0.00129595,86.78175816
7030,快艇,8,535717,0.00129595,86.78305411
7031,戒指,8,535725,0.00129595,86.78435006
7032,抒情,8,535733,0.00129595,86.78564602
7033,投射,8,535741,0.00129595,86.78694197
7034,投標,8,535749,0.00129595,86.78823792
7035,改編曲,8,535757,0.00129595,86.78953388
7036,李綿,8,535765,0.00129595,86.79082983
7037,李慶華,8,535773,0.00129595,86.79212579
7038,步入,8,535781,0.00129595,86.79342174
7039,求婚,8,535789,0.00129595,86.79471769
7040,沙發,8,535797,0.00129595,86.79601365
7041,沙漠,8,535805,0.00129595,86.79730960
7042,沈榮宗,8,535813,0.00129595,86.79860555
7043,沉重,8,535821,0.00129595,86.79990151
7044,沐浴乳,8,535829,0.00129595,86.80119746
7045,私,8,535837,0.00129595,86.80249341
7046,私校,8,535845,0.00129595,86.80378937
7047,究,8,535853,0.00129595,86.80508532
7048,良心,8,535861,0.00129595,86.80638128
7049,身子,8,535869,0.00129595,86.80767723
7050,防衛,8,535877,0.00129595,86.80897318
7051,防禦,8,535885,0.00129595,86.81026914
7052,乖乖,8,535893,0.00129595,86.81156509
7053,亞洲人,8,535901,0.00129595,86.81286104
7054,依法,8,535909,0.00129595,86.81415700
7055,依靠,8,535917,0.00129595,86.81545295
7056,佳能,8,535925,0.00129595,86.81674891
7057,供不應求,8,535933,0.00129595,86.81804486
7058,來賓,8,535941,0.00129595,86.81934081
7059,來襲,8,535949,0.00129595,86.82063677
7060,典範,8,535957,0.00129595,86.82193272
7061,函,8,535965,0.00129595,86.82322867
7062,協定,8,535973,0.00129595,86.82452463
7063,卸粧品,8,535981,0.00129595,86.82582058
7064,受害,8,535989,0.00129595,86.82711654
7065,受訪者,8,535997,0.00129595,86.82841249
7066,呵護,8,536005,0.00129595,86.82970844
7067,呼吸道,8,536013,0.00129595,86.83100440
7068,周二,8,536021,0.00129595,86.83230035
7069,周紹棟,8,536029,0.00129595,86.83359630
7070,奇妙,8,536037,0.00129595,86.83489226
7071,妹,8,536045,0.00129595,86.83618821
7072,妹妹,8,536053,0.00129595,86.83748417
7073,定律,8,536061,0.00129595,86.83878012
7074,宛如,8,536069,0.00129595,86.84007607
7075,店頭市場,8,536077,0.00129595,86.84137203
7076,往返,8,536085,0.00129595,86.84266798
7077,忽,8,536093,0.00129595,86.84396393
7078,念舊,8,536101,0.00129595,86.84525989
7079,性交,8,536109,0.00129595,86.84655584
7080,房租,8,536117,0.00129595,86.84785179
7081,所幸,8,536125,0.00129595,86.84914775
7082,拌,8,536133,0.00129595,86.85044370
7083,拆,8,536141,0.00129595,86.85173966
7084,放進,8,536149,0.00129595,86.85303561
7085,明瞭,8,536157,0.00129595,86.85433156
7086,東北,8,536165,0.00129595,86.85562752
7087,東亞,8,536173,0.00129595,86.85692347
7088,枝,8,536181,0.00129595,86.85821942
7089,林立,8,536189,0.00129595,86.85951538
7090,板,8,536197,0.00129595,86.86081133
7091,注目,8,536205,0.00129595,86.86210729
7092,河岸,8,536213,0.00129595,86.86340324
7093,河豚,8,536221,0.00129595,86.86469919
7094,法務部,8,536229,0.00129595,86.86599515
7095,沿海,8,536237,0.00129595,86.86729110
7096,物理,8,536245,0.00129595,86.86858705
7097,盲目,8,536253,0.00129595,86.86988301
7098,直營店,8,536261,0.00129595,86.87117896
7099,社會福利,8,536269,0.00129595,86.87247492
7100,竺,8,536277,0.00129595,86.87377087
7101,肺部,8,536285,0.00129595,86.87506682
7102,股東會,8,536293,0.00129595,86.87636278
7103,肩,8,536301,0.00129595,86.87765873
7104,芭蕉,8,536309,0.00129595,86.87895468
7105,門票,8,536317,0.00129595,86.88025064
7106,門檻,8,536325,0.00129595,86.88154659
7107,阿根廷,8,536333,0.00129595,86.88284254
7108,阿嬤,8,536341,0.00129595,86.88413850
7109,阻塞,8,536349,0.00129595,86.88543445
7110,附屬,8,536357,0.00129595,86.88673041
7111,雨水,8,536365,0.00129595,86.88802636
7112,青菜,8,536373,0.00129595,86.88932231
7113,非凡,8,536381,0.00129595,86.89061827
7114,信念,8,536389,0.00129595,86.89191422
7115,保濕,8,536397,0.00129595,86.89321017
7116,冒出,8,536405,0.00129595,86.89450613
7117,前方,8,536413,0.00129595,86.89580208
7118,前妻,8,536421,0.00129595,86.89709804
7119,南北,8,536429,0.00129595,86.89839399
7120,南華早報,8,536437,0.00129595,86.89968994
7121,厚實,8,536445,0.00129595,86.90098590
7122,咱們,8,536453,0.00129595,86.90228185
7123,封面,8,536461,0.00129595,86.90357780
7124,建言,8,536469,0.00129595,86.90487376
7125,待遇,8,536477,0.00129595,86.90616971
7126,後續,8,536485,0.00129595,86.90746567
7127,急救,8,536493,0.00129595,86.90876162
7128,急遽,8,536501,0.00129595,86.91005757
7129,按摩椅,8,536509,0.00129595,86.91135353
7130,持久,8,536517,0.00129595,86.91264948
7131,拷貝,8,536525,0.00129595,86.91394543
7132,施羽,8,536533,0.00129595,86.91524139
7133,施壓,8,536541,0.00129595,86.91653734
7134,染色體,8,536549,0.00129595,86.91783329
7135,查扣,8,536557,0.00129595,86.91912925
7136,洋,8,536565,0.00129595,86.92042520
7137,洪,8,536573,0.00129595,86.92172116
7138,流露,8,536581,0.00129595,86.92301711
7139,活生生,8,536589,0.00129595,86.92431306
7140,省長,8,536597,0.00129595,86.92560902
7141,相見,8,536605,0.00129595,86.92690497
7142,眉,8,536613,0.00129595,86.92820092
7143,砂,8,536621,0.00129595,86.92949688
7144,紀江龍,8,536629,0.00129595,86.93079283
7145,美編,8,536637,0.00129595,86.93208879
7146,美學,8,536645,0.00129595,86.93338474
7147,美觀,8,536653,0.00129595,86.93468069
7148,耶路撒冷,8,536661,0.00129595,86.93597665
7149,胎盤,8,536669,0.00129595,86.93727260
7150,虐待,8,536677,0.00129595,86.93856855
7151,要件,8,536685,0.00129595,86.93986451
7152,負債,8,536693,0.00129595,86.94116046
7153,軍艦,8,536701,0.00129595,86.94245642
7154,郊區,8,536709,0.00129595,86.94375237
7155,重申,8,536717,0.00129595,86.94504832
7156,陋規,8,536725,0.00129595,86.94634428
7157,面對面,8,536733,0.00129595,86.94764023
7158,風呂,8,536741,0.00129595,86.94893618
7159,風車,8,536749,0.00129595,86.95023214
7160,飛行員,8,536757,0.00129595,86.95152809
7161,倍速,8,536765,0.00129595,86.95282405
7162,俯瞰,8,536773,0.00129595,86.95412000
7163,倒楣,8,536781,0.00129595,86.95541595
7164,唐雅君,8,536789,0.00129595,86.95671191
7165,哲學家,8,536797,0.00129595,86.95800786
7166,埔里,8,536805,0.00129595,86.95930381
7167,套餐,8,536813,0.00129595,86.96059977
7168,孫建平,8,536821,0.00129595,86.96189572
7169,家裡,8,536829,0.00129595,86.96319167
7170,宮廷,8,536837,0.00129595,86.96448763
7171,展露,8,536845,0.00129595,86.96578358
7172,弱勢,8,536853,0.00129595,86.96707954
7173,恐嚇,8,536861,0.00129595,86.96837549
7174,書面,8,536869,0.00129595,86.96967144
7175,核子,8,536877,0.00129595,86.97096740
7176,桌子,8,536885,0.00129595,86.97226335
7177,氣溫,8,536893,0.00129595,86.97355930
7178,氣憤,8,536901,0.00129595,86.97485526
7179,海面,8,536909,0.00129595,86.97615121
7180,海峽,8,536917,0.00129595,86.97744717
7181,海基會,8,536925,0.00129595,86.97874312
7182,浮,8,536933,0.00129595,86.98003907
7183,烏托邦,8,536941,0.00129595,86.98133503
7184,留任,8,536949,0.00129595,86.98263098
7185,病友,8,536957,0.00129595,86.98392693
7186,疲倦,8,536965,0.00129595,86.98522289
7187,疲憊,8,536973,0.00129595,86.98651884
7188,真誠,8,536981,0.00129595,86.98781480
7189,真實性,8,536989,0.00129595,86.98911075
7190,祖先,8,536997,0.00129595,86.99040670
7191,索,8,537005,0.00129595,86.99170266
7192,紛擾,8,537013,0.00129595,86.99299861
7193,缺陷,8,537021,0.00129595,86.99429456
7194,茱蒂,8,537029,0.00129595,86.99559052
7195,討好,8,537037,0.00129595,86.99688647
7196,財政廳長,8,537045,0.00129595,86.99818242
7197,起點,8,537053,0.00129595,86.99947838
7198,送醫,8,537061,0.00129595,87.00077433
7199,逆轉,8,537069,0.00129595,87.00207029
7200,退役,8,537077,0.00129595,87.00336624
7201,迴響,8,537085,0.00129595,87.00466219
7202,閃爍,8,537093,0.00129595,87.00595815
7203,院內感染,8,537101,0.00129595,87.00725410
7204,陣地,8,537109,0.00129595,87.00855005
7205,馬賽,8,537117,0.00129595,87.00984601
7206,骨折,8,537125,0.00129595,87.01114196
7207,高市,8,537133,0.00129595,87.01243792
7208,高明,8,537141,0.00129595,87.01373387
7209,高壓電線,8,537149,0.00129595,87.01502982
7210,動感,8,537157,0.00129595,87.01632578
7211,動搖,8,537165,0.00129595,87.01762173
7212,國科會,8,537173,0.00129595,87.01891768
7213,堆置場,8,537181,0.00129595,87.02021364
7214,基金會,8,537189,0.00129595,87.02150959
7215,崇拜,8,537197,0.00129595,87.02280555
7216,帶回,8,537205,0.00129595,87.02410150
7217,帳戶,8,537213,0.00129595,87.02539745
7218,帳號,8,537221,0.00129595,87.02669341
7219,彗星,8,537229,0.00129595,87.02798936
7220,得分,8,537237,0.00129595,87.02928531
7221,悉,8,537245,0.00129595,87.03058127
7222,情景,8,537253,0.00129595,87.03187722
7223,情懷,8,537261,0.00129595,87.03317318
7224,接口,8,537269,0.00129595,87.03446913
7225,接手,8,537277,0.00129595,87.03576508
7226,接待,8,537285,0.00129595,87.03706104
7227,接連,8,537293,0.00129595,87.03835699
7228,掛牌,8,537301,0.00129595,87.03965294
7229,推崇,8,537309,0.00129595,87.04094890
7230,排斥,8,537317,0.00129595,87.04224485
7231,救援,8,537325,0.00129595,87.04354080
7232,救護車,8,537333,0.00129595,87.04483676
7233,教法,8,537341,0.00129595,87.04613271
7234,教科書,8,537349,0.00129595,87.04742867
7235,教會,8,537357,0.00129595,87.04872462
7236,清淡,8,537365,0.00129595,87.05002057
7237,清潔隊,8,537373,0.00129595,87.05131653
7238,深遠,8,537381,0.00129595,87.05261248
7239,產值,8,537389,0.00129595,87.05390843
7240,畢業生,8,537397,0.00129595,87.05520439
7241,符像,8,537405,0.00129595,87.05650034
7242,組長,8,537413,0.00129595,87.05779630
7243,終止,8,537421,0.00129595,87.05909225
7244,脫穎而出,8,537429,0.00129595,87.06038820
7245,莫高窟,8,537437,0.00129595,87.06168416
7246,袖珍相機,8,537445,0.00129595,87.06298011
7247,責,8,537453,0.00129595,87.06427606
7248,貧富,8,537461,0.00129595,87.06557202
7249,軟弱,8,537469,0.00129595,87.06686797
7250,通往,8,537477,0.00129595,87.06816393
7251,逗,8,537485,0.00129595,87.06945988
7252,逕,8,537493,0.00129595,87.07075583
7253,造訪,8,537501,0.00129595,87.07205179
7254,陳國雄,8,537509,0.00129595,87.07334774
7255,陰吉,8,537517,0.00129595,87.07464369
7256,陶德,8,537525,0.00129595,87.07593965
7257,魚塭,8,537533,0.00129595,87.07723560
7258,傑作,8,537541,0.00129595,87.07853155
7259,傑利,8,537549,0.00129595,87.07982751
7260,單價,8,537557,0.00129595,87.08112346
7261,堪稱,8,537565,0.00129595,87.08241942
7262,寒,8,537573,0.00129595,87.08371537
7263,富有,8,537581,0.00129595,87.08501132
7264,就任,8,537589,0.00129595,87.08630728
7265,提列,8,537597,0.00129595,87.08760323
7266,提振,8,537605,0.00129595,87.08889918
7267,提議,8,537613,0.00129595,87.09019514
7268,援助,8,537621,0.00129595,87.09149109
7269,散步,8,537629,0.00129595,87.09278705
7270,斯里蘭卡,8,537637,0.00129595,87.09408300
7271,替補,8,537645,0.00129595,87.09537895
7272,期盼,8,537653,0.00129595,87.09667491
7273,棉紡,8,537661,0.00129595,87.09797086
7274,湧,8,537669,0.00129595,87.09926681
7275,減低,8,537677,0.00129595,87.10056277
7276,無趣,8,537685,0.00129595,87.10185872
7277,猶太,8,537693,0.00129595,87.10315468
7278,猶如,8,537701,0.00129595,87.10445063
7279,猴,8,537709,0.00129595,87.10574658
7280,發炎,8,537717,0.00129595,87.10704254
7281,盜,8,537725,0.00129595,87.10833849
7282,硬式磁碟機,8,537733,0.00129595,87.10963444
7283,硬度,8,537741,0.00129595,87.11093040
7284,稅前盈餘,8,537749,0.00129595,87.11222635
7285,稅率,8,537757,0.00129595,87.11352230
7286,筋骨,8,537765,0.00129595,87.11481826
7287,絕望,8,537773,0.00129595,87.11611421
7288,紫外線,8,537781,0.00129595,87.11741017
7289,絲絨,8,537789,0.00129595,87.11870612
7290,華視,8,537797,0.00129595,87.12000207
7291,華隆,8,537805,0.00129595,87.12129803
7292,著想,8,537813,0.00129595,87.12259398
7293,菜色,8,537821,0.00129595,87.12388993
7294,裁判,8,537829,0.00129595,87.12518589
7295,視力,8,537837,0.00129595,87.12648184
7296,診所,8,537845,0.00129595,87.12777780
7297,超出,8,537853,0.00129595,87.12907375
7298,跌幅,8,537861,0.00129595,87.13036970
7299,逮捕,8,537869,0.00129595,87.13166566
7300,週一,8,537877,0.00129595,87.13296161
7301,進化,8,537885,0.00129595,87.13425756
7302,郵局,8,537893,0.00129595,87.13555352
7303,開戶,8,537901,0.00129595,87.13684947
7304,開立,8,537909,0.00129595,87.13814543
7305,開張,8,537917,0.00129595,87.13944138
7306,開創,8,537925,0.00129595,87.14073733
7307,閒置,8,537933,0.00129595,87.14203329
7308,雄猴,8,537941,0.00129595,87.14332924
7309,雲南,8,537949,0.00129595,87.14462519
7310,黃色,8,537957,0.00129595,87.14592115
7311,傳言,8,537965,0.00129595,87.14721710
7312,傳來,8,537973,0.00129595,87.14851306
7313,傳承,8,537981,0.00129595,87.14980901
7314,傾倒,8,537989,0.00129595,87.15110496
7315,嗜好,8,537997,0.00129595,87.15240092
7316,奧地利,8,538005,0.00129595,87.15369687
7317,奧林匹克運動會,8,538013,0.00129595,87.15499282
7318,意料,8,538021,0.00129595,87.15628878
7319,感激,8,538029,0.00129595,87.15758473
7320,愛心,8,538037,0.00129595,87.15888068
7321,搬家,8,538045,0.00129595,87.16017664
7322,損,8,538053,0.00129595,87.16147259
7323,損壞,8,538061,0.00129595,87.16276855
7324,新聞局,8,538069,0.00129595,87.16406450
7325,新穎,8,538077,0.00129595,87.16536045
7326,楊,8,538085,0.00129595,87.16665641
7327,溜冰,8,538093,0.00129595,87.16795236
7328,獅,8,538101,0.00129595,87.16924831
7329,當下,8,538109,0.00129595,87.17054427
7330,當兵,8,538117,0.00129595,87.17184022
7331,畸型,8,538125,0.00129595,87.17313618
7332,矮,8,538133,0.00129595,87.17443213
7333,窠臼,8,538141,0.00129595,87.17572808
7334,節日,8,538149,0.00129595,87.17702404
7335,節制,8,538157,0.00129595,87.17831999
7336,經紀人,8,538165,0.00129595,87.17961594
7337,罪,8,538173,0.00129595,87.18091190
7338,聖經,8,538181,0.00129595,87.18220785
7339,落伍,8,538189,0.00129595,87.18350381
7340,號碼,8,538197,0.00129595,87.18479976
7341,解開,8,538205,0.00129595,87.18609571
7342,誠如,8,538213,0.00129595,87.18739167
7343,資源回收,8,538221,0.00129595,87.18868762
7344,跳躍,8,538229,0.00129595,87.18998357
7345,逼真,8,538237,0.00129595,87.19127953
7346,違約,8,538245,0.00129595,87.19257548
7347,過敏性,8,538253,0.00129595,87.19387143
7348,電子郵件,8,538261,0.00129595,87.19516739
7349,電波,8,538269,0.00129595,87.19646334
7350,電視劇,8,538277,0.00129595,87.19775930
7351,電壓,8,538285,0.00129595,87.19905525
7352,預定地,8,538293,0.00129595,87.20035120
7353,飽受,8,538301,0.00129595,87.20164716
7354,嘔吐,8,538309,0.00129595,87.20294311
7355,境內,8,538317,0.00129595,87.20423906
7356,寧,8,538325,0.00129595,87.20553502
7357,對外,8,538333,0.00129595,87.20683097
7358,對話方塊,8,538341,0.00129595,87.20812693
7359,歌者,8,538349,0.00129595,87.20942288
7360,漲跌,8,538357,0.00129595,87.21071883
7361,漁村,8,538365,0.00129595,87.21201479
7362,疑,8,538373,0.00129595,87.21331074
7363,稱呼,8,538381,0.00129595,87.21460669
7364,管理員,8,538389,0.00129595,87.21590265
7365,精品店,8,538397,0.00129595,87.21719860
7366,精進,8,538405,0.00129595,87.21849456
7367,緊緊,8,538413,0.00129595,87.21979051
7368,網,8,538421,0.00129595,87.22108646
7369,網域,8,538429,0.00129595,87.22238242
7370,蜿蜒,8,538437,0.00129595,87.22367837
7371,蜜蜂,8,538445,0.00129595,87.22497432
7372,製造業,8,538453,0.00129595,87.22627028
7373,說出,8,538461,0.00129595,87.22756623
7374,誘人,8,538469,0.00129595,87.22886219
7375,貌,8,538477,0.00129595,87.23015814
7376,遠東,8,538485,0.00129595,87.23145409
7377,遠景,8,538493,0.00129595,87.23275005
7378,銀行團,8,538501,0.00129595,87.23404600
7379,鳳山,8,538509,0.00129595,87.23534195
7380,噴射客機,8,538517,0.00129595,87.23663791
7381,增強,8,538525,0.00129595,87.23793386
7382,寬頻,8,538533,0.00129595,87.23922981
7383,寫照,8,538541,0.00129595,87.24052577
7384,廢除,8,538549,0.00129595,87.24182172
7385,廚師,8,538557,0.00129595,87.24311768
7386,慾望,8,538565,0.00129595,87.24441363
7387,憧憬,8,538573,0.00129595,87.24570958
7388,摩根,8,538581,0.00129595,87.24700554
7389,敵方,8,538589,0.00129595,87.24830149
7390,標準局,8,538597,0.00129595,87.24959744
7391,歐,8,538605,0.00129595,87.25089340
7392,潛,8,538613,0.00129595,87.25218935
7393,潛能,8,538621,0.00129595,87.25348531
7394,潛意識,8,538629,0.00129595,87.25478126
7395,熟識,8,538637,0.00129595,87.25607721
7396,熱心,8,538645,0.00129595,87.25737317
7397,盤勢,8,538653,0.00129595,87.25866912
7398,確立,8,538661,0.00129595,87.25996507
7399,編排,8,538669,0.00129595,87.26126103
7400,編輯器,8,538677,0.00129595,87.26255698
7401,編譯,8,538685,0.00129595,87.26385294
7402,緩緩,8,538693,0.00129595,87.26514889
7403,複合,8,538701,0.00129595,87.26644484
7404,請假,8,538709,0.00129595,87.26774080
7405,課長,8,538717,0.00129595,87.26903675
7406,調適,8,538725,0.00129595,87.27033270
7407,賭注,8,538733,0.00129595,87.27162866
7408,賣方,8,538741,0.00129595,87.27292461
7409,賣掉,8,538749,0.00129595,87.27422056
7410,賜,8,538757,0.00129595,87.27551652
7411,趣味,8,538765,0.00129595,87.27681247
7412,鄭伊健,8,538773,0.00129595,87.27810843
7413,鄭周敏,8,538781,0.00129595,87.27940438
7414,銷,8,538789,0.00129595,87.28070033
7415,銷售員,8,538797,0.00129595,87.28199629
7416,銷量,8,538805,0.00129595,87.28329224
7417,震驚,8,538813,0.00129595,87.28458819
7418,鞏固,8,538821,0.00129595,87.28588415
7419,養生,8,538829,0.00129595,87.28718010
7420,餓,8,538837,0.00129595,87.28847606
7421,駛,8,538845,0.00129595,87.28977201
7422,駕車,8,538853,0.00129595,87.29106796
7423,駕駛人,8,538861,0.00129595,87.29236392
7424,噶瑪蘭族,8,538869,0.00129595,87.29365987
7425,墾丁,8,538877,0.00129595,87.29495582
7426,戰備,8,538885,0.00129595,87.29625178
7427,操守,8,538893,0.00129595,87.29754773
7428,橘皮,8,538901,0.00129595,87.29884369
7429,樹木,8,538909,0.00129595,87.30013964
7430,機制,8,538917,0.00129595,87.30143559
7431,澳,8,538925,0.00129595,87.30273155
7432,燈光,8,538933,0.00129595,87.30402750
7433,燙,8,538941,0.00129595,87.30532345
7434,獨家,8,538949,0.00129595,87.30661941
7435,盧比,8,538957,0.00129595,87.30791536
7436,衡量,8,538965,0.00129595,87.30921131
7437,謀生,8,538973,0.00129595,87.31050727
7438,輸尿管,8,538981,0.00129595,87.31180322
7439,選取,8,538989,0.00129595,87.31309918
7440,選擇權,8,538997,0.00129595,87.31439513
7441,遲,8,539005,0.00129595,87.31569108
7442,遲遲,8,539013,0.00129595,87.31698704
7443,頸,8,539021,0.00129595,87.31828299
7444,龍祥,8,539029,0.00129595,87.31957894
7445,優碘,8,539037,0.00129595,87.32087490
7446,應當,8,539045,0.00129595,87.32217085
7447,檢,8,539053,0.00129595,87.32346681
7448,營業人,8,539061,0.00129595,87.32476276
7449,營養師,8,539069,0.00129595,87.32605871
7450,磷,8,539077,0.00129595,87.32735467
7451,縮減,8,539085,0.00129595,87.32865062
7452,總冠軍,8,539093,0.00129595,87.32994657
7453,總值,8,539101,0.00129595,87.33124253
7454,總監,8,539109,0.00129595,87.33253848
7455,總額,8,539117,0.00129595,87.33383444
7456,繁殖,8,539125,0.00129595,87.33513039
7457,聲勢,8,539133,0.00129595,87.33642634
7458,聯強,8,539141,0.00129595,87.33772230
7459,聯誼會,8,539149,0.00129595,87.33901825
7460,臀部,8,539157,0.00129595,87.34031420
7461,膽固醇,8,539165,0.00129595,87.34161016
7462,臨終,8,539173,0.00129595,87.34290611
7463,舉止,8,539181,0.00129595,87.34420207
7464,艱難,8,539189,0.00129595,87.34549802
7465,薪傳,8,539197,0.00129595,87.34679397
7466,賽車,8,539205,0.00129595,87.34808993
7467,購車,8,539213,0.00129595,87.34938588
7468,避險,8,539221,0.00129595,87.35068183
7469,邁入,8,539229,0.00129595,87.35197779
7470,醞釀,8,539237,0.00129595,87.35327374
7471,鍵盤,8,539245,0.00129595,87.35456969
7472,點心,8,539253,0.00129595,87.35586565
7473,櫃檯中心,8,539261,0.00129595,87.35716160
7474,濾水壺,8,539269,0.00129595,87.35845756
7475,瀆職,8,539277,0.00129595,87.35975351
7476,瀏覽,8,539285,0.00129595,87.36104946
7477,禮儀,8,539293,0.00129595,87.36234542
7478,竄,8,539301,0.00129595,87.36364137
7479,簡易,8,539309,0.00129595,87.36493732
7480,職責,8,539317,0.00129595,87.36623328
7481,覆,8,539325,0.00129595,87.36752923
7482,豐沛,8,539333,0.00129595,87.36882519
7483,轉進,8,539341,0.00129595,87.37012114
7484,鎖,8,539349,0.00129595,87.37141709
7485,鎮公所,8,539357,0.00129595,87.37271305
7486,雙眼,8,539365,0.00129595,87.37400900
7487,額爾濟斯河,8,539373,0.00129595,87.37530495
7488,鬆,8,539381,0.00129595,87.37660091
7489,穩固,8,539389,0.00129595,87.37789686
7490,識,8,539397,0.00129595,87.37919282
7491,證件,8,539405,0.00129595,87.38048877
7492,贈,8,539413,0.00129595,87.38178472
7493,贈送,8,539421,0.00129595,87.38308068
7494,鏈結,8,539429,0.00129595,87.38437663
7495,嚴苛,8,539437,0.00129595,87.38567258
7496,嚴厲,8,539445,0.00129595,87.38696854
7497,寶座,8,539453,0.00129595,87.38826449
7498,籌,8,539461,0.00129595,87.38956044
7499,議價,8,539469,0.00129595,87.39085640
7500,警訊,8,539477,0.00129595,87.39215235
7501,警覺,8,539485,0.00129595,87.39344831
7502,贏家,8,539493,0.00129595,87.39474426
7503,釋,8,539501,0.00129595,87.39604021
7504,麵,8,539509,0.00129595,87.39733617
7505,麵粉,8,539517,0.00129595,87.39863212
7506,黨員,8,539525,0.00129595,87.39992807
7507,黨務,8,539533,0.00129595,87.40122403
7508,黨營事業,8,539541,0.00129595,87.40251998
7509,櫻花鉤吻鮭,8,539549,0.00129595,87.40381594
7510,護理師,8,539557,0.00129595,87.40511189
7511,躍,8,539565,0.00129595,87.40640784
7512,鐵路局,8,539573,0.00129595,87.40770380
7513,響應,8,539581,0.00129595,87.40899975
7514,魔鬼,8,539589,0.00129595,87.41029570
7515,聽聽,8,539597,0.00129595,87.41159166
7516,變遷,8,539605,0.00129595,87.41288761
7517,變臉,8,539613,0.00129595,87.41418357
7518,驗,8,539621,0.00129595,87.41547952
7519,驗證,8,539629,0.00129595,87.41677547
7520,體認,8,539637,0.00129595,87.41807143
7521,廳,8,539645,0.00129595,87.41936738
7522,一夕,7,539652,0.00113396,87.42050134
7523,一個個,7,539659,0.00113396,87.42163530
7524,一模一樣,7,539666,0.00113396,87.42276926
7525,一舉,7,539673,0.00113396,87.42390322
7526,乙型,7,539680,0.00113396,87.42503718
7527,九州,7,539687,0.00113396,87.42617114
7528,了不起,7,539694,0.00113396,87.42730510
7529,人事同意權,7,539701,0.00113396,87.42843906
7530,人脈,7,539708,0.00113396,87.42957302
7531,人像,7,539715,0.00113396,87.43070698
7532,人種,7,539722,0.00113396,87.43184093
7533,入帳,7,539729,0.00113396,87.43297489
7534,力氣,7,539736,0.00113396,87.43410885
7535,力道,7,539743,0.00113396,87.43524281
7536,三義,7,539750,0.00113396,87.43637677
7537,下場,7,539757,0.00113396,87.43751073
7538,上空,7,539764,0.00113396,87.43864469
7539,上映,7,539771,0.00113396,87.43977865
7540,上層,7,539778,0.00113396,87.44091261
7541,土銀,7,539785,0.00113396,87.44204657
7542,大使,7,539792,0.00113396,87.44318053
7543,大肆,7,539799,0.00113396,87.44431449
7544,大聯盟,7,539806,0.00113396,87.44544845
7545,小孩子,7,539813,0.00113396,87.44658241
7546,小時候,7,539820,0.00113396,87.44771637
7547,小黃瓜,7,539827,0.00113396,87.44885033
7548,小腹,7,539834,0.00113396,87.44998429
7549,小額,7,539841,0.00113396,87.45111825
7550,山丘,7,539848,0.00113396,87.45225221
7551,工具機,7,539855,0.00113396,87.45338617
7552,工藝品,7,539862,0.00113396,87.45452012
7553,干涉,7,539869,0.00113396,87.45565408
7554,不小,7,539876,0.00113396,87.45678804
7555,不分,7,539883,0.00113396,87.45792200
7556,不乏,7,539890,0.00113396,87.45905596
7557,不朽,7,539897,0.00113396,87.46018992
7558,不准,7,539904,0.00113396,87.46132388
7559,不捨,7,539911,0.00113396,87.46245784
7560,不對勁,7,539918,0.00113396,87.46359180
7561,不盡,7,539925,0.00113396,87.46472576
7562,中正路,7,539932,0.00113396,87.46585972
7563,中性,7,539939,0.00113396,87.46699368
7564,中區,7,539946,0.00113396,87.46812764
7565,中國樹蟾,7,539953,0.00113396,87.46926160
7566,中提琴,7,539960,0.00113396,87.47039556
7567,中期,7,539967,0.00113396,87.47152952
7568,中華職棒,7,539974,0.00113396,87.47266348
7569,中間人,7,539981,0.00113396,87.47379744
7570,中隊,7,539988,0.00113396,87.47493140
7571,中鋒,7,539995,0.00113396,87.47606535
7572,中學,7,540002,0.00113396,87.47719931
7573,中興電工,7,540009,0.00113396,87.47833327
7574,中斷,7,540016,0.00113396,87.47946723
7575,中壢,7,540023,0.00113396,87.48060119
7576,丹麥,7,540030,0.00113396,87.48173515
7577,內側,7,540037,0.00113396,87.48286911
7578,內圈,7,540044,0.00113396,87.48400307
7579,內陸,7,540051,0.00113396,87.48513703
7580,內湖,7,540058,0.00113396,87.48627099
7581,公升,7,540065,0.00113396,87.48740495
7582,公共設施,7,540072,0.00113396,87.48853891
7583,公認,7,540079,0.00113396,87.48967287
7584,公德心,7,540086,0.00113396,87.49080683
7585,分數,7,540093,0.00113396,87.49194079
7586,化纖,7,540100,0.00113396,87.49307475
7587,升學,7,540107,0.00113396,87.49420871
7588,反倒,7,540114,0.00113396,87.49534267
7589,反觀,7,540121,0.00113396,87.49647663
7590,天才,7,540128,0.00113396,87.49761059
7591,天性,7,540135,0.00113396,87.49874454
7592,太白粉,7,540142,0.00113396,87.49987850
7593,少量,7,540149,0.00113396,87.50101246
7594,巴士,7,540156,0.00113396,87.50214642
7595,引來,7,540163,0.00113396,87.50328038
7596,手動,7,540170,0.00113396,87.50441434
7597,手塚治蟲,7,540177,0.00113396,87.50554830
7598,手槍,7,540184,0.00113396,87.50668226
7599,手稿,7,540191,0.00113396,87.50781622
7600,支隊,7,540198,0.00113396,87.50895018
7601,日文,7,540205,0.00113396,87.51008414
7602,日式,7,540212,0.00113396,87.51121810
7603,比不上,7,540219,0.00113396,87.51235206
7604,水池,7,540226,0.00113396,87.51348602
7605,火勢,7,540233,0.00113396,87.51461998
7606,火鍋,7,540240,0.00113396,87.51575394
7607,牛仔褲,7,540247,0.00113396,87.51688790
7608,王朝,7,540254,0.00113396,87.51802186
7609,王應祥,7,540261,0.00113396,87.51915582
7610,王馨平,7,540268,0.00113396,87.52028978
7611,代表會,7,540275,0.00113396,87.52142373
7612,充,7,540282,0.00113396,87.52255769
7613,出版社,7,540289,0.00113396,87.52369165
7614,出場,7,540296,0.00113396,87.52482561
7615,出路,7,540303,0.00113396,87.52595957
7616,凸,7,540310,0.00113396,87.52709353
7617,加大,7,540317,0.00113396,87.52822749
7618,加班費,7,540324,0.00113396,87.52936145
7619,加深,7,540331,0.00113396,87.53049541
7620,加碼,7,540338,0.00113396,87.53162937
7621,包皮,7,540345,0.00113396,87.53276333
7622,北美,7,540352,0.00113396,87.53389729
7623,半天,7,540359,0.00113396,87.53503125
7624,半導體業,7,540366,0.00113396,87.53616521
7625,占地,7,540373,0.00113396,87.53729917
7626,可疑,7,540380,0.00113396,87.53843313
7627,右側,7,540387,0.00113396,87.53956709
7628,召喚,7,540394,0.00113396,87.54070105
7629,召集,7,540401,0.00113396,87.54183501
7630,另類,7,540408,0.00113396,87.54296897
7631,台中港,7,540415,0.00113396,87.54410292
7632,台北市政府,7,540422,0.00113396,87.54523688
7633,台北市電腦公會,7,540429,0.00113396,87.54637084
7634,台電,7,540436,0.00113396,87.54750480
7635,台糖,7,540443,0.00113396,87.54863876
7636,台灣海峽,7,540450,0.00113396,87.54977272
7637,台灣證券交易所,7,540457,0.00113396,87.55090668
7638,外出,7,540464,0.00113396,87.55204064
7639,外向,7,540471,0.00113396,87.55317460
7640,外地,7,540478,0.00113396,87.55430856
7641,外電,7,540485,0.00113396,87.55544252
7642,外幣,7,540492,0.00113396,87.55657648
7643,失掉,7,540499,0.00113396,87.55771044
7644,奶烙,7,540506,0.00113396,87.55884440
7645,尼克,7,540513,0.00113396,87.55997836
7646,尼康,7,540520,0.00113396,87.56111232
7647,尼爾遜,7,540527,0.00113396,87.56224628
7648,布爾津,7,540534,0.00113396,87.56338024
7649,打架,7,540541,0.00113396,87.56451420
7650,本土化,7,540548,0.00113396,87.56564816
7651,本錢,7,540555,0.00113396,87.56678211
7652,未婚,7,540562,0.00113396,87.56791607
7653,正值,7,540569,0.00113396,87.56905003
7654,正視,7,540576,0.00113396,87.57018399
7655,民生,7,540583,0.00113396,87.57131795
7656,民進黨團,7,540590,0.00113396,87.57245191
7657,民營化,7,540597,0.00113396,87.57358587
7658,永子,7,540604,0.00113396,87.57471983
7659,犯錯,7,540611,0.00113396,87.57585379
7660,瓦解,7,540618,0.00113396,87.57698775
7661,生育,7,540625,0.00113396,87.57812171
7662,用力,7,540632,0.00113396,87.57925567
7663,用具,7,540639,0.00113396,87.58038963
7664,用意,7,540646,0.00113396,87.58152359
7665,甲型,7,540653,0.00113396,87.58265755
7666,白熱化,7,540660,0.00113396,87.58379151
7667,丟掉,7,540667,0.00113396,87.58492547
7668,交易日,7,540674,0.00113396,87.58605943
7669,交流道,7,540681,0.00113396,87.58719339
7670,交通局,7,540688,0.00113396,87.58832734
7671,仿,7,540695,0.00113396,87.58946130
7672,仰慕,7,540702,0.00113396,87.59059526
7673,企劃,7,540709,0.00113396,87.59172922
7674,光滑,7,540716,0.00113396,87.59286318
7675,光澤,7,540723,0.00113396,87.59399714
7676,全球資訊網,7,540730,0.00113396,87.59513110
7677,共存,7,540737,0.00113396,87.59626506
7678,共有,7,540744,0.00113396,87.59739902
7679,共計,7,540751,0.00113396,87.59853298
7680,列車,7,540758,0.00113396,87.59966694
7681,印地安人,7,540765,0.00113396,87.60080090
7682,印製,7,540772,0.00113396,87.60193486
7683,吉達許,7,540779,0.00113396,87.60306882
7684,同好,7,540786,0.00113396,87.60420278
7685,各界,7,540793,0.00113396,87.60533674
7686,名額,7,540800,0.00113396,87.60647070
7687,合力,7,540807,0.00113396,87.60760466
7688,合唱團,7,540814,0.00113396,87.60873862
7689,回國,7,540821,0.00113396,87.60987258
7690,回顧展,7,540828,0.00113396,87.61100653
7691,地下水,7,540835,0.00113396,87.61214049
7692,地下城,7,540842,0.00113396,87.61327445
7693,地下電台,7,540849,0.00113396,87.61440841
7694,地主,7,540856,0.00113396,87.61554237
7695,地利,7,540863,0.00113396,87.61667633
7696,地段,7,540870,0.00113396,87.61781029
7697,地區性,7,540877,0.00113396,87.61894425
7698,多元,7,540884,0.00113396,87.62007821
7699,多餘,7,540891,0.00113396,87.62121217
7700,好人,7,540898,0.00113396,87.62234613
7701,好奇心,7,540905,0.00113396,87.62348009
7702,如期,7,540912,0.00113396,87.62461405
7703,守則,7,540919,0.00113396,87.62574801
7704,帆船,7,540926,0.00113396,87.62688197
7705,年產量,7,540933,0.00113396,87.62801593
7706,年齡層,7,540940,0.00113396,87.62914989
7707,成功級,7,540947,0.00113396,87.63028385
7708,成敗,7,540954,0.00113396,87.63141781
7709,早晨,7,540961,0.00113396,87.63255177
7710,江山,7,540968,0.00113396,87.63368572
7711,百分比,7,540975,0.00113396,87.63481968
7712,羊,7,540982,0.00113396,87.63595364
7713,老大,7,540989,0.00113396,87.63708760
7714,老板,7,540996,0.00113396,87.63822156
7715,自主性,7,541003,0.00113396,87.63935552
7716,自由基,7,541010,0.00113396,87.64048948
7717,自然界,7,541017,0.00113396,87.64162344
7718,行李廂,7,541024,0.00113396,87.64275740
7719,行事,7,541031,0.00113396,87.64389136
7720,行號,7,541038,0.00113396,87.64502532
7721,西江月,7,541045,0.00113396,87.64615928
7722,西餐,7,541052,0.00113396,87.64729324
7723,西醫,7,541059,0.00113396,87.64842720
7724,伴隨,7,541066,0.00113396,87.64956116
7725,佛法,7,541073,0.00113396,87.65069512
7726,佛教徒,7,541080,0.00113396,87.65182908
7727,伺機,7,541087,0.00113396,87.65296304
7728,作業員,7,541094,0.00113396,87.65409700
7729,低調,7,541101,0.00113396,87.65523096
7730,余,7,541108,0.00113396,87.65636491
7731,冷水,7,541115,0.00113396,87.65749887
7732,刪減,7,541122,0.00113396,87.65863283
7733,劫,7,541129,0.00113396,87.65976679
7734,吾,7,541136,0.00113396,87.66090075
7735,呆板,7,541143,0.00113396,87.66203471
7736,呂紹嘉,7,541150,0.00113396,87.66316867
7737,告別,7,541157,0.00113396,87.66430263
7738,含糖飲料,7,541164,0.00113396,87.66543659
7739,坎沙諾,7,541171,0.00113396,87.66657055
7740,妥協,7,541178,0.00113396,87.66770451
7741,宋,7,541185,0.00113396,87.66883847
7742,尿道,7,541192,0.00113396,87.66997243
7743,技朮,7,541199,0.00113396,87.67110639
7744,技倆,7,541206,0.00113396,87.67224035
7745,抉擇,7,541213,0.00113396,87.67337431
7746,找不到,7,541220,0.00113396,87.67450827
7747,找到,7,541227,0.00113396,87.67564223
7748,更動,7,541234,0.00113396,87.67677619
7749,束縛,7,541241,0.00113396,87.67791015
7750,李卓珍,7,541248,0.00113396,87.67904410
7751,李明勳,7,541255,0.00113396,87.68017806
7752,李清棋,7,541262,0.00113396,87.68131202
7753,步槍,7,541269,0.00113396,87.68244598
7754,步調,7,541276,0.00113396,87.68357994
7755,求助,7,541283,0.00113396,87.68471390
7756,沙利,7,541290,0.00113396,87.68584786
7757,沈伯樂,7,541297,0.00113396,87.68698182
7758,汰換,7,541304,0.00113396,87.68811578
7759,育幼院,7,541311,0.00113396,87.68924974
7760,角逐,7,541318,0.00113396,87.69038370
7761,言論,7,541325,0.00113396,87.69151766
7762,赤裸,7,541332,0.00113396,87.69265162
7763,走廊,7,541339,0.00113396,87.69378558
7764,身手,7,541346,0.00113396,87.69491954
7765,身旁,7,541353,0.00113396,87.69605350
7766,車窗,7,541360,0.00113396,87.69718746
7767,車道,7,541367,0.00113396,87.69832142
7768,巡視,7,541374,0.00113396,87.69945538
7769,那個,7,541381,0.00113396,87.70058933
7770,那時候,7,541388,0.00113396,87.70172329
7771,事後,7,541395,0.00113396,87.70285725
7772,亞太地區,7,541402,0.00113396,87.70399121
7773,供稱,7,541409,0.00113396,87.70512517
7774,供應商,7,541416,0.00113396,87.70625913
7775,兩岸直航,7,541423,0.00113396,87.70739309
7776,典藏,7,541430,0.00113396,87.70852705
7777,刻度,7,541437,0.00113396,87.70966101
7778,刺,7,541444,0.00113396,87.71079497
7779,刮目相看,7,541451,0.00113396,87.71192893
7780,協奏曲,7,541458,0.00113396,87.71306289
7781,取材,7,541465,0.00113396,87.71419685
7782,取決,7,541472,0.00113396,87.71533081
7783,叔叔,7,541479,0.00113396,87.71646477
7784,受益人,7,541486,0.00113396,87.71759873
7785,受理,7,541493,0.00113396,87.71873269
7786,咖啡色,7,541500,0.00113396,87.71986665
7787,呼應,7,541507,0.00113396,87.72100061
7788,周華健,7,541514,0.00113396,87.72213457
7789,奉勸,7,541521,0.00113396,87.72326852
7790,奇異,7,541528,0.00113396,87.72440248
7791,姑娘,7,541535,0.00113396,87.72553644
7792,姐姐,7,541542,0.00113396,87.72667040
7793,姊姊,7,541549,0.00113396,87.72780436
7794,妳們,7,541556,0.00113396,87.72893832
7795,孤立,7,541563,0.00113396,87.73007228
7796,定影,7,541570,0.00113396,87.73120624
7797,官兵,7,541577,0.00113396,87.73234020
7798,居多,7,541584,0.00113396,87.73347416
7799,店面,7,541591,0.00113396,87.73460812
7800,底下,7,541598,0.00113396,87.73574208
7801,延長賽,7,541605,0.00113396,87.73687604
7802,延期,7,541612,0.00113396,87.73801000
7803,性行為,7,541619,0.00113396,87.73914396
7804,戾,7,541626,0.00113396,87.74027792
7805,所多瑪,7,541633,0.00113396,87.74141188
7806,承,7,541640,0.00113396,87.74254584
7807,承包商,7,541647,0.00113396,87.74367980
7808,承銷價,7,541654,0.00113396,87.74481376
7809,招生,7,541661,0.00113396,87.74594771
7810,拍賣會,7,541668,0.00113396,87.74708167
7811,拖延,7,541675,0.00113396,87.74821563
7812,放學,7,541682,0.00113396,87.74934959
7813,昇陽公司,7,541689,0.00113396,87.75048355
7814,服務生,7,541696,0.00113396,87.75161751
7815,東海大學,7,541703,0.00113396,87.75275147
7816,東港,7,541710,0.00113396,87.75388543
7817,東歐,7,541717,0.00113396,87.75501939
7818,林園工業區,7,541724,0.00113396,87.75615335
7819,枚,7,541731,0.00113396,87.75728731
7820,欣慰,7,541738,0.00113396,87.75842127
7821,氛圍,7,541745,0.00113396,87.75955523
7822,泥土,7,541752,0.00113396,87.76068919
7823,法國人,7,541759,0.00113396,87.76182315
7824,法新社,7,541766,0.00113396,87.76295711
7825,沿岸,7,541773,0.00113396,87.76409107
7826,泛,7,541780,0.00113396,87.76522503
7827,炎熱,7,541787,0.00113396,87.76635899
7828,爭奪,7,541794,0.00113396,87.76749295
7829,版面,7,541801,0.00113396,87.76862690
7830,版權,7,541808,0.00113396,87.76976086
7831,物料,7,541815,0.00113396,87.77089482
7832,直線,7,541822,0.00113396,87.77202878
7833,社,7,541829,0.00113396,87.77316274
7834,社工人員,7,541836,0.00113396,87.77429670
7835,空白,7,541843,0.00113396,87.77543066
7836,空運,7,541850,0.00113396,87.77656462
7837,股份,7,541857,0.00113396,87.77769858
7838,芝加哥,7,541864,0.00113396,87.77883254
7839,花草,7,541871,0.00113396,87.77996650
7840,花旗銀行,7,541878,0.00113396,87.78110046
7841,表格,7,541885,0.00113396,87.78223442
7842,近代,7,541892,0.00113396,87.78336838
7843,長榮,7,541899,0.00113396,87.78450234
7844,阿內亞,7,541906,0.00113396,87.78563630
7845,阻擋,7,541913,0.00113396,87.78677026
7846,青山,7,541920,0.00113396,87.78790422
7847,非指定用途資金,7,541927,0.00113396,87.78903818
7848,亮度,7,541934,0.00113396,87.79017214
7849,便利性,7,541941,0.00113396,87.79130609
7850,便利商店,7,541948,0.00113396,87.79244005
7851,便捷,7,541955,0.00113396,87.79357401
7852,保七,7,541962,0.00113396,87.79470797
7853,保證金,7,541969,0.00113396,87.79584193
7854,俗稱,7,541976,0.00113396,87.79697589
7855,前端,7,541983,0.00113396,87.79810985
7856,勇士隊,7,541990,0.00113396,87.79924381
7857,南京,7,541997,0.00113396,87.80037777
7858,南京東路,7,542004,0.00113396,87.80151173
7859,南港,7,542011,0.00113396,87.80264569
7860,城鎮,7,542018,0.00113396,87.80377965
7861,威嚇,7,542025,0.00113396,87.80491361
7862,宣揚,7,542032,0.00113396,87.80604757
7863,客車,7,542039,0.00113396,87.80718153
7864,帝國,7,542046,0.00113396,87.80831549
7865,帥,7,542053,0.00113396,87.80944945
7866,建中,7,542060,0.00113396,87.81058341
7867,建設局,7,542067,0.00113396,87.81171737
7868,思維,7,542074,0.00113396,87.81285132
7869,思緒,7,542081,0.00113396,87.81398528
7870,怎麼辦,7,542088,0.00113396,87.81511924
7871,拜託,7,542095,0.00113396,87.81625320
7872,挖掘,7,542102,0.00113396,87.81738716
7873,持平,7,542109,0.00113396,87.81852112
7874,指引,7,542116,0.00113396,87.81965508
7875,指控,7,542123,0.00113396,87.82078904
7876,拾,7,542130,0.00113396,87.82192300
7877,挑剔,7,542137,0.00113396,87.82305696
7878,政風室,7,542144,0.00113396,87.82419092
7879,政務委員,7,542151,0.00113396,87.82532488
7880,政策面,7,542158,0.00113396,87.82645884
7881,春季,7,542165,0.00113396,87.82759280
7882,架子,7,542172,0.00113396,87.82872676
7883,洪德旋,7,542179,0.00113396,87.82986072
7884,流傳,7,542186,0.00113396,87.83099468
7885,炭烤,7,542193,0.00113396,87.83212864
7886,珍藏,7,542200,0.00113396,87.83326260
7887,皇帝殿,7,542207,0.00113396,87.83439656
7888,皇宮,7,542214,0.00113396,87.83553051
7889,相符,7,542221,0.00113396,87.83666447
7890,砂糖,7,542228,0.00113396,87.83779843
7891,研,7,542235,0.00113396,87.83893239
7892,研究所,7,542242,0.00113396,87.84006635
7893,科長,7,542249,0.00113396,87.84120031
7894,突破性,7,542256,0.00113396,87.84233427
7895,紅酒,7,542263,0.00113396,87.84346823
7896,約束,7,542270,0.00113396,87.84460219
7897,約蘭塔,7,542277,0.00113396,87.84573615
7898,美式,7,542284,0.00113396,87.84687011
7899,美指,7,542291,0.00113396,87.84800407
7900,美聯,7,542298,0.00113396,87.84913803
7901,耐性,7,542305,0.00113396,87.85027199
7902,背包,7,542312,0.00113396,87.85140595
7903,致意,7,542319,0.00113396,87.85253991
7904,訂貨,7,542326,0.00113396,87.85367387
7905,迫使,7,542333,0.00113396,87.85480783
7906,重組,7,542340,0.00113396,87.85594179
7907,面孔,7,542347,0.00113396,87.85707575
7908,面板,7,542354,0.00113396,87.85820970
7909,風靡,7,542361,0.00113396,87.85934366
7910,食慾,7,542368,0.00113396,87.86047762
7911,香奈兒,7,542375,0.00113396,87.86161158
7912,乘員,7,542382,0.00113396,87.86274554
7913,倍增,7,542389,0.00113396,87.86387950
7914,個體,7,542396,0.00113396,87.86501346
7915,兼具,7,542403,0.00113396,87.86614742
7916,原子,7,542410,0.00113396,87.86728138
7917,原有,7,542417,0.00113396,87.86841534
7918,原作,7,542424,0.00113396,87.86954930
7919,哥,7,542431,0.00113396,87.87068326
7920,唉,7,542438,0.00113396,87.87181722
7921,夏令營,7,542445,0.00113396,87.87295118
7922,套利,7,542452,0.00113396,87.87408514
7923,套牢,7,542459,0.00113396,87.87521910
7924,套房,7,542466,0.00113396,87.87635306
7925,家事,7,542473,0.00113396,87.87748702
7926,家產,7,542480,0.00113396,87.87862098
7927,宴會,7,542487,0.00113396,87.87975494
7928,射擊,7,542494,0.00113396,87.88088889
7929,庫佛,7,542501,0.00113396,87.88202285
7930,徐,7,542508,0.00113396,87.88315681
7931,振奮,7,542515,0.00113396,87.88429077
7932,捐,7,542522,0.00113396,87.88542473
7933,挽救,7,542529,0.00113396,87.88655869
7934,挪威,7,542536,0.00113396,87.88769265
7935,時節,7,542543,0.00113396,87.88882661
7936,晉升,7,542550,0.00113396,87.88996057
7937,晉級,7,542557,0.00113396,87.89109453
7938,氧,7,542564,0.00113396,87.89222849
7939,泰瑞,7,542571,0.00113396,87.89336245
7940,海盜,7,542578,0.00113396,87.89449641
7941,浴,7,542585,0.00113396,87.89563037
7942,浴佛節,7,542592,0.00113396,87.89676433
7943,浴室,7,542599,0.00113396,87.89789829
7944,特產,7,542606,0.00113396,87.89903225
7945,特種,7,542613,0.00113396,87.90016621
7946,特權,7,542620,0.00113396,87.90130017
7947,症候群,7,542627,0.00113396,87.90243413
7948,真理,7,542634,0.00113396,87.90356808
7949,祕魯,7,542641,0.00113396,87.90470204
7950,神識,7,542648,0.00113396,87.90583600
7951,祝,7,542655,0.00113396,87.90696996
7952,站立,7,542662,0.00113396,87.90810392
7953,粉撲,7,542669,0.00113396,87.90923788
7954,紋,7,542676,0.00113396,87.91037184
7955,素,7,542683,0.00113396,87.91150580
7956,紛爭,7,542690,0.00113396,87.91263976
7957,耗費,7,542697,0.00113396,87.91377372
7958,臭氧層,7,542704,0.00113396,87.91490768
7959,航行,7,542711,0.00113396,87.91604164
7960,航空母艦,7,542718,0.00113396,87.91717560
7961,草案,7,542725,0.00113396,87.91830956
7962,討,7,542732,0.00113396,87.91944352
7963,起伏,7,542739,0.00113396,87.92057748
7964,起飛,7,542746,0.00113396,87.92171144
7965,起訴,7,542753,0.00113396,87.92284540
7966,迷你,7,542760,0.00113396,87.92397936
7967,逃離,7,542767,0.00113396,87.92511331
7968,追思,7,542774,0.00113396,87.92624727
7969,配音,7,542781,0.00113396,87.92738123
7970,馬祖,7,542788,0.00113396,87.92851519
7971,馬凱,7,542795,0.00113396,87.92964915
7972,骨幹,7,542802,0.00113396,87.93078311
7973,骨質疏鬆症,7,542809,0.00113396,87.93191707
7974,骨髓,7,542816,0.00113396,87.93305103
7975,高下,7,542823,0.00113396,87.93418499
7976,高縣,7,542830,0.00113396,87.93531895
7977,高麗菜,7,542837,0.00113396,87.93645291
7978,乾乾淨淨,7,542844,0.00113396,87.93758687
7979,副省長,7,542851,0.00113396,87.93872083
7980,副董事長,7,542858,0.00113396,87.93985479
7981,動手,7,542865,0.00113396,87.94098875
7982,動用,7,542872,0.00113396,87.94212271
7983,動作片,7,542879,0.00113396,87.94325667
7984,動脈,7,542886,0.00113396,87.94439063
7985,商人,7,542893,0.00113396,87.94552459
7986,商場,7,542900,0.00113396,87.94665855
7987,商談,7,542907,0.00113396,87.94779250
7988,唱出,7,542914,0.00113396,87.94892646
7989,國家公園,7,542921,0.00113396,87.95006042
7990,國務院,7,542928,0.00113396,87.95119438
7991,國賠,7,542935,0.00113396,87.95232834
7992,寇比司,7,542942,0.00113396,87.95346230
7993,專線,7,542949,0.00113396,87.95459626
7994,將會,7,542956,0.00113396,87.95573022
7995,崛起,7,542963,0.00113396,87.95686418
7996,常董會,7,542970,0.00113396,87.95799814
7997,康定艦,7,542977,0.00113396,87.95913210
7998,張台雄,7,542984,0.00113396,87.96026606
7999,張宇,7,542991,0.00113396,87.96140002
8000,張泰山,7,542998,0.00113396,87.96253398
8001,彩粧,7,543005,0.00113396,87.96366794
8002,得主,7,543012,0.00113396,87.96480190
8003,從小,7,543019,0.00113396,87.96593586
8004,悠久,7,543026,0.00113396,87.96706982
8005,情誼,7,543033,0.00113396,87.96820378
8006,控告,7,543040,0.00113396,87.96933774
8007,掩蓋,7,543047,0.00113396,87.97047169
8008,掃除,7,543054,0.00113396,87.97160565
8009,排定,7,543061,0.00113396,87.97273961
8010,排隊,7,543068,0.00113396,87.97387357
8011,排練,7,543075,0.00113396,87.97500753
8012,排擠,7,543082,0.00113396,87.97614149
8013,掀,7,543089,0.00113396,87.97727545
8014,教育局長,7,543096,0.00113396,87.97840941
8015,條例,7,543103,0.00113396,87.97954337
8016,條款,7,543110,0.00113396,87.98067733
8017,淡水線,7,543117,0.00113396,87.98181129
8018,清涼,7,543124,0.00113396,87.98294525
8019,清爽,7,543131,0.00113396,87.98407921
8020,清醒,7,543138,0.00113396,87.98521317
8021,淚水,7,543145,0.00113396,87.98634713
8022,深切,7,543152,0.00113396,87.98748109
8023,深坑,7,543159,0.00113396,87.98861505
8024,焉,7,543166,0.00113396,87.98974901
8025,猛�葆H,7,543173,0.00113396,87.99088297
8026,甜,7,543180,0.00113396,87.99201693
8027,產地,7,543187,0.00113396,87.99315088
8028,畢卡索,7,543194,0.00113396,87.99428484
8029,異性,7,543201,0.00113396,87.99541880
8030,疏失,7,543208,0.00113396,87.99655276
8031,盛況,7,543215,0.00113396,87.99768672
8032,盛開,7,543222,0.00113396,87.99882068
8033,祭典,7,543229,0.00113396,87.99995464
8034,粒,7,543236,0.00113396,88.00108860
8035,細小,7,543243,0.00113396,88.00222256
8036,莫名,7,543250,0.00113396,88.00335652
8037,莊,7,543257,0.00113396,88.00449048
8038,荷爾蒙,7,543264,0.00113396,88.00562444
8039,處長,7,543271,0.00113396,88.00675840
8040,蛇,7,543278,0.00113396,88.00789236
8041,訪談,7,543285,0.00113396,88.00902632
8042,責罵,7,543292,0.00113396,88.01016028
8043,貨車,7,543299,0.00113396,88.01129424
8044,貪瀆,7,543306,0.00113396,88.01242820
8045,通話,7,543313,0.00113396,88.01356216
8046,郭泰源,7,543320,0.00113396,88.01469612
8047,郭進興,7,543327,0.00113396,88.01583007
8048,陪產,7,543334,0.00113396,88.01696403
8049,陳春章,7,543341,0.00113396,88.01809799
8050,陳衍敏,7,543348,0.00113396,88.01923195
8051,陳毓棻,7,543355,0.00113396,88.02036591
8052,麥克風,7,543362,0.00113396,88.02149987
8053,傑克,7,543369,0.00113396,88.02263383
8054,創舉,7,543376,0.00113396,88.02376779
8055,勞力,7,543383,0.00113396,88.02490175
8056,勞動,7,543390,0.00113396,88.02603571
8057,喪,7,543397,0.00113396,88.02716967
8058,單品,7,543404,0.00113396,88.02830363
8059,單眼相機,7,543411,0.00113396,88.02943759
8060,單體,7,543418,0.00113396,88.03057155
8061,喲,7,543425,0.00113396,88.03170551
8062,喚醒,7,543432,0.00113396,88.03283947
8063,喻,7,543439,0.00113396,88.03397343
8064,喬丹,7,543446,0.00113396,88.03510739
8065,喬治,7,543453,0.00113396,88.03624135
8066,尊崇,7,543460,0.00113396,88.03737530
8067,尊榮,7,543467,0.00113396,88.03850926
8068,尋常,7,543474,0.00113396,88.03964322
8069,就要,7,543481,0.00113396,88.04077718
8070,幾近,7,543488,0.00113396,88.04191114
8071,廊,7,543495,0.00113396,88.04304510
8072,彭醇士,7,543502,0.00113396,88.04417906
8073,復健,7,543509,0.00113396,88.04531302
8074,提倡,7,543516,0.00113396,88.04644698
8075,揭發,7,543523,0.00113396,88.04758094
8076,換成,7,543530,0.00113396,88.04871490
8077,曾是,7,543537,0.00113396,88.04984886
8078,替代,7,543544,0.00113396,88.05098282
8079,殘酷,7,543551,0.00113396,88.05211678
8080,港元,7,543558,0.00113396,88.05325074
8081,港股,7,543565,0.00113396,88.05438470
8082,渡,7,543572,0.00113396,88.05551866
8083,渡過,7,543579,0.00113396,88.05665262
8084,減弱,7,543586,0.00113396,88.05778658
8085,湯米,7,543593,0.00113396,88.05892054
8086,焦,7,543600,0.00113396,88.06005449
8087,焦仁和,7,543607,0.00113396,88.06118845
8088,無視,7,543614,0.00113396,88.06232241
8089,無黨籍,7,543621,0.00113396,88.06345637
8090,犀利,7,543628,0.00113396,88.06459033
8091,猴群,7,543635,0.00113396,88.06572429
8092,畫出,7,543642,0.00113396,88.06685825
8093,登山,7,543649,0.00113396,88.06799221
8094,登革熱,7,543656,0.00113396,88.06912617
8095,發作,7,543663,0.00113396,88.07026013
8096,程式碼,7,543670,0.00113396,88.07139409
8097,稀少,7,543677,0.00113396,88.07252805
8098,童話,7,543684,0.00113396,88.07366201
8099,策畫,7,543691,0.00113396,88.07479597
8100,結晶,7,543698,0.00113396,88.07592993
8101,結語,7,543705,0.00113396,88.07706389
8102,絕技,7,543712,0.00113396,88.07819785
8103,萃取,7,543719,0.00113396,88.07933181
8104,菠菜,7,543726,0.00113396,88.08046577
8105,華信銀行,7,543733,0.00113396,88.08159973
8106,菲國,7,543740,0.00113396,88.08273368
8107,視角,7,543747,0.00113396,88.08386764
8108,評等,7,543754,0.00113396,88.08500160
8109,賀亮德,7,543761,0.00113396,88.08613556
8110,買超,7,543768,0.00113396,88.08726952
8111,趁機,7,543775,0.00113396,88.08840348
8112,跑車,7,543782,0.00113396,88.08953744
8113,跌勢,7,543789,0.00113396,88.09067140
8114,週二,7,543796,0.00113396,88.09180536
8115,週三,7,543803,0.00113396,88.09293932
8116,週年,7,543810,0.00113396,88.09407328
8117,進口車,7,543817,0.00113396,88.09520724
8118,進出口,7,543824,0.00113396,88.09634120
8119,進修,7,543831,0.00113396,88.09747516
8120,進程,7,543838,0.00113396,88.09860912
8121,量表,7,543845,0.00113396,88.09974308
8122,開口,7,543852,0.00113396,88.10087704
8123,開除,7,543859,0.00113396,88.10201100
8124,開機,7,543866,0.00113396,88.10314496
8125,閒,7,543873,0.00113396,88.10427892
8126,順便,7,543880,0.00113396,88.10541287
8127,順暢,7,543887,0.00113396,88.10654683
8128,黃山,7,543894,0.00113396,88.10768079
8129,黑金政治,7,543901,0.00113396,88.10881475
8130,僅是,7,543908,0.00113396,88.10994871
8131,嗯,7,543915,0.00113396,88.11108267
8132,園地,7,543922,0.00113396,88.11221663
8133,圓形,7,543929,0.00113396,88.11335059
8134,填寫,7,543936,0.00113396,88.11448455
8135,微中子,7,543943,0.00113396,88.11561851
8136,微薄,7,543950,0.00113396,88.11675247
8137,慈悲,7,543957,0.00113396,88.11788643
8138,愛惜,7,543964,0.00113396,88.11902039
8139,愛樂者,7,543971,0.00113396,88.12015435
8140,惹,7,543978,0.00113396,88.12128831
8141,慎重,7,543985,0.00113396,88.12242227
8142,搶攻,7,543992,0.00113396,88.12355623
8143,搖滾,7,543999,0.00113396,88.12469019
8144,新人獎,7,544006,0.00113396,88.12582415
8145,新力,7,544013,0.00113396,88.12695811
8146,新生,7,544020,0.00113396,88.12809206
8147,新竹科學園區,7,544027,0.00113396,88.12922602
8148,新竹縣,7,544034,0.00113396,88.13035998
8149,新海路,7,544041,0.00113396,88.13149394
8150,新莊,7,544048,0.00113396,88.13262790
8151,會計年度,7,544055,0.00113396,88.13376186
8152,會計師,7,544062,0.00113396,88.13489582
8153,業內,7,544069,0.00113396,88.13602978
8154,滅,7,544076,0.00113396,88.13716374
8155,準時,7,544083,0.00113396,88.13829770
8156,準備率,7,544090,0.00113396,88.13943166
8157,照護,7,544097,0.00113396,88.14056562
8158,照顧者,7,544104,0.00113396,88.14169958
8159,當家,7,544111,0.00113396,88.14283354
8160,睫毛刷,7,544118,0.00113396,88.14396750
8161,睹,7,544125,0.00113396,88.14510146
8162,禁令,7,544132,0.00113396,88.14623542
8163,節約,7,544139,0.00113396,88.14736938
8164,經濟成長率,7,544146,0.00113396,88.14850334
8165,綁,7,544153,0.00113396,88.14963729
8166,綁標,7,544160,0.00113396,88.15077125
8167,義邦,7,544167,0.00113396,88.15190521
8168,聖誕老人,7,544174,0.00113396,88.15303917
8169,聖誕節,7,544181,0.00113396,88.15417313
8170,腮紅刷,7,544188,0.00113396,88.15530709
8171,腫瘤,7,544195,0.00113396,88.15644105
8172,腹腔,7,544202,0.00113396,88.15757501
8173,腺毛,7,544209,0.00113396,88.15870897
8174,腦筋,7,544216,0.00113396,88.15984293
8175,落敗,7,544223,0.00113396,88.16097689
8176,董監事,7,544230,0.00113396,88.16211085
8177,裝扮,7,544237,0.00113396,88.16324481
8178,裝修,7,544244,0.00113396,88.16437877
8179,裝配,7,544251,0.00113396,88.16551273
8180,解放,7,544258,0.00113396,88.16664669
8181,解析度,7,544265,0.00113396,88.16778065
8182,解說,7,544272,0.00113396,88.16891461
8183,詳情,7,544279,0.00113396,88.17004857
8184,試算表,7,544286,0.00113396,88.17118253
8185,話語,7,544293,0.00113396,88.17231648
8186,路可包得,7,544300,0.00113396,88.17345044
8187,農,7,544307,0.00113396,88.17458440
8188,運轉,7,544314,0.00113396,88.17571836
8189,逼近,7,544321,0.00113396,88.17685232
8190,違章建築,7,544328,0.00113396,88.17798628
8191,過年,7,544335,0.00113396,88.17912024
8192,鉛管,7,544342,0.00113396,88.18025420
8193,隔天,7,544349,0.00113396,88.18138816
8194,電力,7,544356,0.00113396,88.18252212
8195,電信局,7,544363,0.00113396,88.18365608
8196,電訊,7,544370,0.00113396,88.18479004
8197,電視台,7,544377,0.00113396,88.18592400
8198,電腦遊戲,7,544384,0.00113396,88.18705796
8199,頒發,7,544391,0.00113396,88.18819192
8200,飽和,7,544398,0.00113396,88.18932588
8201,鼓,7,544405,0.00113396,88.19045984
8202,圖畫,7,544412,0.00113396,88.19159380
8203,對岸,7,544419,0.00113396,88.19272776
8204,幕後,7,544426,0.00113396,88.19386172
8205,廖俊銘,7,544433,0.00113396,88.19499567
8206,彰銀,7,544440,0.00113396,88.19612963
8207,構思,7,544447,0.00113396,88.19726359
8208,歌星,7,544454,0.00113396,88.19839755
8209,演化,7,544461,0.00113396,88.19953151
8210,滾,7,544468,0.00113396,88.20066547
8211,漢娜,7,544475,0.00113396,88.20179943
8212,瑪歌,7,544482,0.00113396,88.20293339
8213,盡速,7,544489,0.00113396,88.20406735
8214,磁碟,7,544496,0.00113396,88.20520131
8215,禍,7,544503,0.00113396,88.20633527
8216,管用,7,544510,0.00113396,88.20746923
8217,精良,7,544517,0.00113396,88.20860319
8218,緊縮,7,544524,0.00113396,88.20973715
8219,維也納,7,544531,0.00113396,88.21087111
8220,腿部,7,544538,0.00113396,88.21200507
8221,舞台劇,7,544545,0.00113396,88.21313903
8222,舞蹈家,7,544552,0.00113396,88.21427299
8223,裸露,7,544559,0.00113396,88.21540695
8224,認同卡,7,544566,0.00113396,88.21654091
8225,豪,7,544573,0.00113396,88.21767486
8226,輕巧,7,544580,0.00113396,88.21880882
8227,輕盈,7,544587,0.00113396,88.21994278
8228,辣,7,544594,0.00113396,88.22107674
8229,遠東百貨,7,544601,0.00113396,88.22221070
8230,遙遠,7,544608,0.00113396,88.22334466
8231,閥,7,544615,0.00113396,88.22447862
8232,雌猴,7,544622,0.00113396,88.22561258
8233,領主,7,544629,0.00113396,88.22674654
8234,鼻骨,7,544636,0.00113396,88.22788050
8235,儀表板,7,544643,0.00113396,88.22901446
8236,僵局,7,544650,0.00113396,88.23014842
8237,劉少奇,7,544657,0.00113396,88.23128238
8238,劉玉春,7,544664,0.00113396,88.23241634
8239,審慎,7,544671,0.00113396,88.23355030
8240,層層,7,544678,0.00113396,88.23468426
8241,廟,7,544685,0.00113396,88.23581822
8242,廣告人,7,544692,0.00113396,88.23695218
8243,彈,7,544699,0.00113396,88.23808614
8244,影印,7,544706,0.00113396,88.23922010
8245,影星,7,544713,0.00113396,88.24035405
8246,德州,7,544720,0.00113396,88.24148801
8247,徵狀,7,544727,0.00113396,88.24262197
8248,慶幸,7,544734,0.00113396,88.24375593
8249,憂鬱,7,544741,0.00113396,88.24488989
8250,摩根效應,7,544748,0.00113396,88.24602385
8251,摩羯,7,544755,0.00113396,88.24715781
8252,撲殺,7,544762,0.00113396,88.24829177
8253,撈,7,544769,0.00113396,88.24942573
8254,撕,7,544776,0.00113396,88.25055969
8255,標章,7,544783,0.00113396,88.25169365
8256,標準化,7,544790,0.00113396,88.25282761
8257,標緻,7,544797,0.00113396,88.25396157
8258,樂手,7,544804,0.00113396,88.25509553
8259,樂迷,7,544811,0.00113396,88.25622949
8260,歐洲人,7,544818,0.00113396,88.25736345
8261,熱中,7,544825,0.00113396,88.25849741
8262,熱切,7,544832,0.00113396,88.25963137
8263,熱水,7,544839,0.00113396,88.26076533
8264,熱波活水養生館,7,544846,0.00113396,88.26189928
8265,瘦小,7,544853,0.00113396,88.26303324
8266,磅,7,544860,0.00113396,88.26416720
8267,篇幅,7,544867,0.00113396,88.26530116
8268,衝入,7,544874,0.00113396,88.26643512
8269,衝撞,7,544881,0.00113396,88.26756908
8270,調高,7,544888,0.00113396,88.26870304
8271,調漲,7,544895,0.00113396,88.26983700
8272,論述,7,544902,0.00113396,88.27097096
8273,賞,7,544909,0.00113396,88.27210492
8274,賣超,7,544916,0.00113396,88.27323888
8275,賣壓,7,544923,0.00113396,88.27437284
8276,質料,7,544930,0.00113396,88.27550680
8277,適中,7,544937,0.00113396,88.27664076
8278,鄧小平,7,544944,0.00113396,88.27777472
8279,養分,7,544951,0.00113396,88.27890868
8280,餘額,7,544958,0.00113396,88.28004264
8281,駕,7,544965,0.00113396,88.28117660
8282,黎姿,7,544972,0.00113396,88.28231056
8283,劑,7,544979,0.00113396,88.28344452
8284,憲政,7,544986,0.00113396,88.28457847
8285,據悉,7,544993,0.00113396,88.28571243
8286,操,7,545000,0.00113396,88.28684639
8287,操行,7,545007,0.00113396,88.28798035
8288,撿,7,545014,0.00113396,88.28911431
8289,擔憂,7,545021,0.00113396,88.29024827
8290,整整,7,545028,0.00113396,88.29138223
8291,橡皮,7,545035,0.00113396,88.29251619
8292,機動性,7,545042,0.00113396,88.29365015
8293,機票,7,545049,0.00113396,88.29478411
8294,濃縮,7,545056,0.00113396,88.29591807
8295,激起,7,545063,0.00113396,88.29705203
8296,獨立號,7,545070,0.00113396,88.29818599
8297,盧梭,7,545077,0.00113396,88.29931995
8298,篩選,7,545084,0.00113396,88.30045391
8299,縣議員,7,545091,0.00113396,88.30158787
8300,膩,7,545098,0.00113396,88.30272183
8301,蕭條,7,545105,0.00113396,88.30385579
8302,諾琳,7,545112,0.00113396,88.30498975
8303,賴來焜,7,545119,0.00113396,88.30612371
8304,辦公桌,7,545126,0.00113396,88.30725766
8305,選拔,7,545133,0.00113396,88.30839162
8306,選股,7,545140,0.00113396,88.30952558
8307,遲早,7,545147,0.00113396,88.31065954
8308,遺失,7,545154,0.00113396,88.31179350
8309,遺傳,7,545161,0.00113396,88.31292746
8310,遺體,7,545168,0.00113396,88.31406142
8311,雕塑,7,545175,0.00113396,88.31519538
8312,雕像,7,545182,0.00113396,88.31632934
8313,靜電,7,545189,0.00113396,88.31746330
8314,頭家,7,545196,0.00113396,88.31859726
8315,餐會,7,545203,0.00113396,88.31973122
8316,默契,7,545210,0.00113396,88.32086518
8317,優比速,7,545217,0.00113396,88.32199914
8318,儲存格,7,545224,0.00113396,88.32313310
8319,應酬,7,545231,0.00113396,88.32426706
8320,戲院,7,545238,0.00113396,88.32540102
8321,戴笠,7,545245,0.00113396,88.32653498
8322,濫用,7,545252,0.00113396,88.32766894
8323,營隊,7,545259,0.00113396,88.32880290
8324,營養品,7,545266,0.00113396,88.32993685
8325,療效,7,545273,0.00113396,88.33107081
8326,總幹事,7,545280,0.00113396,88.33220477
8327,繁華,7,545287,0.00113396,88.33333873
8328,聯手,7,545294,0.00113396,88.33447269
8329,聯誼,7,545301,0.00113396,88.33560665
8330,聳立,7,545308,0.00113396,88.33674061
8331,臉頰,7,545315,0.00113396,88.33787457
8332,薑,7,545322,0.00113396,88.33900853
8333,賽馬,7,545329,0.00113396,88.34014249
8334,購置,7,545336,0.00113396,88.34127645
8335,輿論,7,545343,0.00113396,88.34241041
8336,隱,7,545350,0.00113396,88.34354437
8337,隸屬,7,545357,0.00113396,88.34467833
8338,韓,7,545364,0.00113396,88.34581229
8339,擷取,7,545371,0.00113396,88.34694625
8340,歸納,7,545378,0.00113396,88.34808021
8341,濾鏡,7,545385,0.00113396,88.34921417
8342,禮堂,7,545392,0.00113396,88.35034813
8343,禮遇,7,545399,0.00113396,88.35148209
8344,禮貌,7,545406,0.00113396,88.35261604
8345,簡介,7,545413,0.00113396,88.35375000
8346,簡短,7,545420,0.00113396,88.35488396
8347,翻身,7,545427,0.00113396,88.35601792
8348,藏家,7,545434,0.00113396,88.35715188
8349,藉助,7,545441,0.00113396,88.35828584
8350,轉投資,7,545448,0.00113396,88.35941980
8351,轉運中心,7,545455,0.00113396,88.36055376
8352,醫藥,7,545462,0.00113396,88.36168772
8353,鎮民,7,545469,0.00113396,88.36282168
8354,離島,7,545476,0.00113396,88.36395564
8355,離譜,7,545483,0.00113396,88.36508960
8356,雜誌社,7,545490,0.00113396,88.36622356
8357,雞精,7,545497,0.00113396,88.36735752
8358,攀,7,545504,0.00113396,88.36849148
8359,瀕臨,7,545511,0.00113396,88.36962544
8360,羅克海,7,545518,0.00113396,88.37075940
8361,藝壇,7,545525,0.00113396,88.37189336
8362,藤製家具,7,545532,0.00113396,88.37302732
8363,藥品,7,545539,0.00113396,88.37416127
8364,譚老師,7,545546,0.00113396,88.37529523
8365,贊成,7,545553,0.00113396,88.37642919
8366,關節炎,7,545560,0.00113396,88.37756315
8367,關說,7,545567,0.00113396,88.37869711
8368,鬍鬚張,7,545574,0.00113396,88.37983107
8369,懸載,7,545581,0.00113396,88.38096503
8370,爐,7,545588,0.00113396,88.38209899
8371,競爭者,7,545595,0.00113396,88.38323295
8372,競標,7,545602,0.00113396,88.38436691
8373,籌辦,7,545609,0.00113396,88.38550087
8374,籃板,7,545616,0.00113396,88.38663483
8375,蘇貞昌,7,545623,0.00113396,88.38776879
8376,蘇富比,7,545630,0.00113396,88.38890275
8377,觸角,7,545637,0.00113396,88.39003671
8378,議事,7,545644,0.00113396,88.39117067
8379,鹹,7,545651,0.00113396,88.39230463
8380,攝氏,7,545658,0.00113396,88.39343859
8381,攝取量,7,545665,0.00113396,88.39457255
8382,攝影節,7,545672,0.00113396,88.39570651
8383,灌溉,7,545679,0.00113396,88.39684046
8384,護理,7,545686,0.00113396,88.39797442
8385,魔術胸罩,7,545693,0.00113396,88.39910838
8386,彎曲,7,545700,0.00113396,88.40024234
8387,權限,7,545707,0.00113396,88.40137630
8388,權貴,7,545714,0.00113396,88.40251026
8389,疊,7,545721,0.00113396,88.40364422
8390,襯托,7,545728,0.00113396,88.40477818
8391,鑑定,7,545735,0.00113396,88.40591214
8392,戀愛,7,545742,0.00113396,88.40704610
8393,變革,7,545749,0.00113396,88.40818006
8394,驗收,7,545756,0.00113396,88.40931402
8395,體型,7,545763,0.00113396,88.41044798
8396,體格,7,545770,0.00113396,88.41158194
8397,體現,7,545777,0.00113396,88.41271590
8398,體積,7,545784,0.00113396,88.41384986
8399,鱗片,7,545791,0.00113396,88.41498382
8400,讓分,7,545798,0.00113396,88.41611778
8401,鹽埔,7,545805,0.00113396,88.41725174
8402,一股,6,545811,0.00097197,88.41822370
8403,一席之地,6,545817,0.00097197,88.41919567
8404,一旁,6,545823,0.00097197,88.42016763
8405,一群,6,545829,0.00097197,88.42113960
8406,一齊,6,545835,0.00097197,88.42211156
8407,乙二醇醚,6,545841,0.00097197,88.42308353
8408,七股,6,545847,0.00097197,88.42405549
8409,二次大戰,6,545853,0.00097197,88.42502746
8410,二局,6,545859,0.00097197,88.42599942
8411,人性化,6,545865,0.00097197,88.42697139
8412,人群,6,545871,0.00097197,88.42794335
8413,入伍,6,545877,0.00097197,88.42891532
8414,刀子,6,545883,0.00097197,88.42988728
8415,力士,6,545889,0.00097197,88.43085925
8416,力求,6,545895,0.00097197,88.43183121
8417,三角形,6,545901,0.00097197,88.43280318
8418,三峽,6,545907,0.00097197,88.43377515
8419,三商虎,6,545913,0.00097197,88.43474711
8420,下台,6,545919,0.00097197,88.43571908
8421,下次,6,545925,0.00097197,88.43669104
8422,下課,6,545931,0.00097197,88.43766301
8423,上天,6,545937,0.00097197,88.43863497
8424,上半場,6,545943,0.00097197,88.43960694
8425,上司,6,545949,0.00097197,88.44057890
8426,上流,6,545955,0.00097197,88.44155087
8427,上限,6,545961,0.00097197,88.44252283
8428,上尉,6,545967,0.00097197,88.44349480
8429,上等,6,545973,0.00097197,88.44446676
8430,上網,6,545979,0.00097197,88.44543873
8431,口號,6,545985,0.00097197,88.44641069
8432,士,6,545991,0.00097197,88.44738266
8433,士林分局,6,545997,0.00097197,88.44835462
8434,大分縣,6,546003,0.00097197,88.44932659
8435,大甲,6,546009,0.00097197,88.45029856
8436,大專,6,546015,0.00097197,88.45127052
8437,大部分,6,546021,0.00097197,88.45224249
8438,大提琴,6,546027,0.00097197,88.45321445
8439,大牌,6,546033,0.00097197,88.45418642
8440,大廈,6,546039,0.00097197,88.45515838
8441,大夥,6,546045,0.00097197,88.45613035
8442,大榮,6,546051,0.00097197,88.45710231
8443,大增,6,546057,0.00097197,88.45807428
8444,大體,6,546063,0.00097197,88.45904624
8445,子宮沖洗術,6,546069,0.00097197,88.46001821
8446,小心翼翼,6,546075,0.00097197,88.46099017
8447,小鳥,6,546081,0.00097197,88.46196214
8448,小管,6,546087,0.00097197,88.46293410
8449,山頂,6,546093,0.00097197,88.46390607
8450,工具列,6,546099,0.00097197,88.46487803
8451,工場,6,546105,0.00097197,88.46585000
8452,工資,6,546111,0.00097197,88.46682197
8453,干預,6,546117,0.00097197,88.46779393
8454,不二法門,6,546123,0.00097197,88.46876590
8455,不在乎,6,546129,0.00097197,88.46973786
8456,不相容,6,546135,0.00097197,88.47070983
8457,不若,6,546141,0.00097197,88.47168179
8458,不規則,6,546147,0.00097197,88.47265376
8459,不須,6,546153,0.00097197,88.47362572
8460,不經意,6,546159,0.00097197,88.47459769
8461,不遺餘力,6,546165,0.00097197,88.47556965
8462,不應,6,546171,0.00097197,88.47654162
8463,不銹鋼,6,546177,0.00097197,88.47751358
8464,中小企業主,6,546183,0.00097197,88.47848555
8465,中小學,6,546189,0.00097197,88.47945751
8466,中山分局,6,546195,0.00097197,88.48042948
8467,中山路,6,546201,0.00097197,88.48140144
8468,中日,6,546207,0.00097197,88.48237341
8469,中止,6,546213,0.00097197,88.48334537
8470,中石化,6,546219,0.00097197,88.48431734
8471,中信,6,546225,0.00097197,88.48528931
8472,中南部,6,546231,0.00097197,88.48626127
8473,中國畫,6,546237,0.00097197,88.48723324
8474,中國結,6,546243,0.00097197,88.48820520
8475,中陰,6,546249,0.00097197,88.48917717
8476,中華隊,6,546255,0.00097197,88.49014913
8477,中興百貨,6,546261,0.00097197,88.49112110
8478,中鋼,6,546267,0.00097197,88.49209306
8479,中藥,6,546273,0.00097197,88.49306503
8480,中纖,6,546279,0.00097197,88.49403699
8481,互助,6,546285,0.00097197,88.49500896
8482,互惠,6,546291,0.00097197,88.49598092
8483,五星級,6,546297,0.00097197,88.49695289
8484,仇,6,546303,0.00097197,88.49792485
8485,仍舊,6,546309,0.00097197,88.49889682
8486,內科,6,546315,0.00097197,88.49986878
8487,公民,6,546321,0.00097197,88.50084075
8488,公演,6,546327,0.00097197,88.50181272
8489,公爵,6,546333,0.00097197,88.50278468
8490,公職,6,546339,0.00097197,88.50375665
8491,分公司,6,546345,0.00097197,88.50472861
8492,分割,6,546351,0.00097197,88.50570058
8493,分擔,6,546357,0.00097197,88.50667254
8494,分攤,6,546363,0.00097197,88.50764451
8495,切碎,6,546369,0.00097197,88.50861647
8496,勾勒,6,546375,0.00097197,88.50958844
8497,化妝,6,546381,0.00097197,88.51056040
8498,化學品,6,546387,0.00097197,88.51153237
8499,午,6,546393,0.00097197,88.51250433
8500,升任,6,546399,0.00097197,88.51347630
8501,反射式,6,546405,0.00097197,88.51444826
8502,反轉,6,546411,0.00097197,88.51542023
8503,天災,6,546417,0.00097197,88.51639219
8504,天候,6,546423,0.00097197,88.51736416
8505,巴斯克,6,546429,0.00097197,88.51833613
8506,引人注目,6,546435,0.00097197,88.51930809
8507,引領,6,546441,0.00097197,88.52028006
8508,心疼,6,546447,0.00097197,88.52125202
8509,心理學家,6,546453,0.00097197,88.52222399
8510,心意,6,546459,0.00097197,88.52319595
8511,心跳,6,546465,0.00097197,88.52416792
8512,心境,6,546471,0.00097197,88.52513988
8513,心頭,6,546477,0.00097197,88.52611185
8514,支持者,6,546483,0.00097197,88.52708381
8515,支柱,6,546489,0.00097197,88.52805578
8516,支流,6,546495,0.00097197,88.52902774
8517,文人畫,6,546501,0.00097197,88.52999971
8518,文書,6,546507,0.00097197,88.53097167
8519,日日,6,546513,0.00097197,88.53194364
8520,日夜,6,546519,0.00097197,88.53291560
8521,木乃伊,6,546525,0.00097197,88.53388757
8522,比利時,6,546531,0.00097197,88.53485953
8523,毛巾,6,546537,0.00097197,88.53583150
8524,水公司,6,546543,0.00097197,88.53680347
8525,水域,6,546549,0.00097197,88.53777543
8526,水野真紀,6,546555,0.00097197,88.53874740
8527,火箭,6,546561,0.00097197,88.53971936
8528,片段,6,546567,0.00097197,88.54069133
8529,片商,6,546573,0.00097197,88.54166329
8530,牛排,6,546579,0.00097197,88.54263526
8531,王金平,6,546585,0.00097197,88.54360722
8532,王浩,6,546591,0.00097197,88.54457919
8533,王牌,6,546597,0.00097197,88.54555115
8534,主計處,6,546603,0.00097197,88.54652312
8535,主意,6,546609,0.00097197,88.54749508
8536,付款,6,546615,0.00097197,88.54846705
8537,代打,6,546621,0.00097197,88.54943901
8538,代名詞,6,546627,0.00097197,88.55041098
8539,冬季,6,546633,0.00097197,88.55138294
8540,出版品,6,546639,0.00097197,88.55235491
8541,出品,6,546645,0.00097197,88.55332688
8542,出風口,6,546651,0.00097197,88.55429884
8543,出海,6,546657,0.00097197,88.55527081
8544,加盟店,6,546663,0.00097197,88.55624277
8545,加裝,6,546669,0.00097197,88.55721474
8546,加權,6,546675,0.00097197,88.55818670
8547,功用,6,546681,0.00097197,88.55915867
8548,功臣,6,546687,0.00097197,88.56013063
8549,包裹,6,546693,0.00097197,88.56110260
8550,北二高,6,546699,0.00097197,88.56207456
8551,北橫公路,6,546705,0.00097197,88.56304653
8552,北縣,6,546711,0.00097197,88.56401849
8553,去處,6,546717,0.00097197,88.56499046
8554,可口,6,546723,0.00097197,88.56596242
8555,可悲,6,546729,0.00097197,88.56693439
8556,可謂,6,546735,0.00097197,88.56790635
8557,古人,6,546741,0.00097197,88.56887832
8558,右邊,6,546747,0.00097197,88.56985028
8559,台中人,6,546753,0.00097197,88.57082225
8560,台北市警局,6,546759,0.00097197,88.57179422
8561,台詞,6,546765,0.00097197,88.57276618
8562,台鹽,6,546771,0.00097197,88.57373815
8563,外科,6,546777,0.00097197,88.57471011
8564,外移,6,546783,0.00097197,88.57568208
8565,外部,6,546789,0.00097197,88.57665404
8566,外貿協會,6,546795,0.00097197,88.57762601
8567,失事,6,546801,0.00097197,88.57859797
8568,失業,6,546807,0.00097197,88.57956994
8569,尼克森,6,546813,0.00097197,88.58054190
8570,尼羅鱷魚,6,546819,0.00097197,88.58151387
8571,巨額,6,546825,0.00097197,88.58248583
8572,市況,6,546831,0.00097197,88.58345780
8573,市集,6,546837,0.00097197,88.58442976
8574,布置,6,546843,0.00097197,88.58540173
8575,幼,6,546849,0.00097197,88.58637369
8576,幼稚園,6,546855,0.00097197,88.58734566
8577,必備,6,546861,0.00097197,88.58831763
8578,打點,6,546867,0.00097197,88.58928959
8579,本事,6,546873,0.00097197,88.59026156
8580,本體,6,546879,0.00097197,88.59123352
8581,正規,6,546885,0.00097197,88.59220549
8582,母雞,6,546891,0.00097197,88.59317745
8583,民族主義,6,546897,0.00097197,88.59414942
8584,永久,6,546903,0.00097197,88.59512138
8585,永續,6,546909,0.00097197,88.59609335
8586,氾濫,6,546915,0.00097197,88.59706531
8587,犯規,6,546921,0.00097197,88.59803728
8588,瓜分,6,546927,0.00097197,88.59900924
8589,生計,6,546933,0.00097197,88.59998121
8590,由此,6,546939,0.00097197,88.60095317
8591,由此可見,6,546945,0.00097197,88.60192514
8592,申購,6,546951,0.00097197,88.60289710
8593,白金,6,546957,0.00097197,88.60386907
8594,目的地,6,546963,0.00097197,88.60484104
8595,目擊者叢書自然博物館,6,546969,0.00097197,88.60581300
8596,石子,6,546975,0.00097197,88.60678497
8597,立法委員,6,546981,0.00097197,88.60775693
8598,立案,6,546987,0.00097197,88.60872890
8599,交付,6,546993,0.00097197,88.60970086
8600,交保,6,546999,0.00097197,88.61067283
8601,交會,6,547005,0.00097197,88.61164479
8602,交際,6,547011,0.00097197,88.61261676
8603,伙伴,6,547017,0.00097197,88.61358872
8604,份子,6,547023,0.00097197,88.61456069
8605,光景,6,547029,0.00097197,88.61553265
8606,光榮,6,547035,0.00097197,88.61650462
8607,光顧,6,547041,0.00097197,88.61747658
8608,兇,6,547047,0.00097197,88.61844855
8609,先天性,6,547053,0.00097197,88.61942051
8610,先行,6,547059,0.00097197,88.62039248
8611,全面性,6,547065,0.00097197,88.62136444
8612,全程,6,547071,0.00097197,88.62233641
8613,全數,6,547077,0.00097197,88.62330838
8614,再造,6,547083,0.00097197,88.62428034
8615,冰箱,6,547089,0.00097197,88.62525231
8616,印象派,6,547095,0.00097197,88.62622427
8617,危害,6,547101,0.00097197,88.62719624
8618,同性戀,6,547107,0.00097197,88.62816820
8619,同級,6,547113,0.00097197,88.62914017
8620,同類,6,547119,0.00097197,88.63011213
8621,各自,6,547125,0.00097197,88.63108410
8622,回報,6,547131,0.00097197,88.63205606
8623,地名,6,547137,0.00097197,88.63302803
8624,在在,6,547143,0.00097197,88.63399999
8625,多功能,6,547149,0.00097197,88.63497196
8626,多多,6,547155,0.00097197,88.63594392
8627,多年來,6,547161,0.00097197,88.63691589
8628,多是,6,547167,0.00097197,88.63788785
8629,好玩,6,547173,0.00097197,88.63885982
8630,好看,6,547179,0.00097197,88.63983179
8631,存放,6,547185,0.00097197,88.64080375
8632,存錢,6,547191,0.00097197,88.64177572
8633,守衛,6,547197,0.00097197,88.64274768
8634,宅,6,547203,0.00097197,88.64371965
8635,安全感,6,547209,0.00097197,88.64469161
8636,安非他命,6,547215,0.00097197,88.64566358
8637,安眠藥,6,547221,0.00097197,88.64663554
8638,寺廟,6,547227,0.00097197,88.64760751
8639,屹立,6,547233,0.00097197,88.64857947
8640,年長,6,547239,0.00097197,88.64955144
8641,成名,6,547245,0.00097197,88.65052340
8642,扛,6,547251,0.00097197,88.65149537
8643,收受,6,547257,0.00097197,88.65246733
8644,收賄,6,547263,0.00097197,88.65343930
8645,早年,6,547269,0.00097197,88.65441126
8646,有機物,6,547275,0.00097197,88.65538323
8647,朱茵,6,547281,0.00097197,88.65635519
8648,此次,6,547287,0.00097197,88.65732716
8649,死去,6,547293,0.00097197,88.65829913
8650,竹,6,547299,0.00097197,88.65927109
8651,竹北市,6,547305,0.00097197,88.66024306
8652,米羅,6,547311,0.00097197,88.66121502
8653,羊毛,6,547317,0.00097197,88.66218699
8654,老二,6,547323,0.00097197,88.66315895
8655,老家,6,547329,0.00097197,88.66413092
8656,老牌,6,547335,0.00097197,88.66510288
8657,耳目一新,6,547341,0.00097197,88.66607485
8658,耳洞,6,547347,0.00097197,88.66704681
8659,自己人,6,547353,0.00097197,88.66801878
8660,自動櫃員機,6,547359,0.00097197,88.66899074
8661,自營商,6,547365,0.00097197,88.66996271
8662,血液循環,6,547371,0.00097197,88.67093467
8663,行人,6,547377,0.00097197,88.67190664
8664,西南,6,547383,0.00097197,88.67287860
8665,住址,6,547389,0.00097197,88.67385057
8666,估算,6,547395,0.00097197,88.67482254
8667,佔有,6,547401,0.00097197,88.67579450
8668,似曾相識,6,547407,0.00097197,88.67676647
8669,作物,6,547413,0.00097197,88.67773843
8670,作息,6,547419,0.00097197,88.67871040
8671,低頭,6,547425,0.00097197,88.67968236
8672,兌,6,547431,0.00097197,88.68065433
8673,免疫力,6,547437,0.00097197,88.68162629
8674,冷卻,6,547443,0.00097197,88.68259826
8675,冷氣機,6,547449,0.00097197,88.68357022
8676,判讀,6,547455,0.00097197,88.68454219
8677,即刻,6,547461,0.00097197,88.68551415
8678,吞,6,547467,0.00097197,88.68648612
8679,否決,6,547473,0.00097197,88.68745808
8680,呎,6,547479,0.00097197,88.68843005
8681,呆帳,6,547485,0.00097197,88.68940201
8682,吳大羽,6,547491,0.00097197,88.69037398
8683,呂玉川,6,547497,0.00097197,88.69134595
8684,君子,6,547503,0.00097197,88.69231791
8685,吸毒,6,547509,0.00097197,88.69328988
8686,吸膠,6,547515,0.00097197,88.69426184
8687,含蓄,6,547521,0.00097197,88.69523381
8688,坊間,6,547527,0.00097197,88.69620577
8689,妥,6,547533,0.00097197,88.69717774
8690,完備,6,547539,0.00097197,88.69814970
8691,宋恭源,6,547545,0.00097197,88.69912167
8692,志願,6,547551,0.00097197,88.70009363
8693,快門速度轉盤,6,547557,0.00097197,88.70106560
8694,快感,6,547563,0.00097197,88.70203756
8695,戒酒,6,547569,0.00097197,88.70300953
8696,抄,6,547575,0.00097197,88.70398149
8697,抗藥性,6,547581,0.00097197,88.70495346
8698,技法,6,547587,0.00097197,88.70592542
8699,把關,6,547593,0.00097197,88.70689739
8700,折磨,6,547599,0.00097197,88.70786935
8701,扮,6,547605,0.00097197,88.70884132
8702,投顧,6,547611,0.00097197,88.70981329
8703,改成,6,547617,0.00097197,88.71078525
8704,李連杰,6,547623,0.00097197,88.71175722
8705,李義弘,6,547629,0.00097197,88.71272918
8706,杜老爺,6,547635,0.00097197,88.71370115
8707,杜茲,6,547641,0.00097197,88.71467311
8708,杜絕,6,547647,0.00097197,88.71564508
8709,沙龍,6,547653,0.00097197,88.71661704
8710,決賽,6,547659,0.00097197,88.71758901
8711,沐,6,547665,0.00097197,88.71856097
8712,沒事,6,547671,0.00097197,88.71953294
8713,沒關係,6,547677,0.00097197,88.72050490
8714,狂熱,6,547683,0.00097197,88.72147687
8715,男生,6,547689,0.00097197,88.72244883
8716,男鞋,6,547695,0.00097197,88.72342080
8717,盯,6,547701,0.00097197,88.72439276
8718,私立,6,547707,0.00097197,88.72536473
8719,秀麗,6,547713,0.00097197,88.72633670
8720,肝炎,6,547719,0.00097197,88.72730866
8721,肝病,6,547725,0.00097197,88.72828063
8722,肝臟,6,547731,0.00097197,88.72925259
8723,見性成佛,6,547737,0.00097197,88.73022456
8724,見狀,6,547743,0.00097197,88.73119652
8725,見識,6,547749,0.00097197,88.73216849
8726,見證,6,547755,0.00097197,88.73314045
8727,角質,6,547761,0.00097197,88.73411242
8728,走入,6,547767,0.00097197,88.73508438
8729,走動,6,547773,0.00097197,88.73605635
8730,足跡,6,547779,0.00097197,88.73702831
8731,身段,6,547785,0.00097197,88.73800028
8732,車內循環,6,547791,0.00097197,88.73897224
8733,車外空氣,6,547797,0.00097197,88.73994421
8734,車站,6,547803,0.00097197,88.74091617
8735,車種,6,547809,0.00097197,88.74188814
8736,辛勞,6,547815,0.00097197,88.74286011
8737,里昂,6,547821,0.00097197,88.74383207
8738,里長,6,547827,0.00097197,88.74480404
8739,防治,6,547833,0.00097197,88.74577600
8740,防空,6,547839,0.00097197,88.74674797
8741,防盜,6,547845,0.00097197,88.74771993
8742,乖,6,547851,0.00097197,88.74869190
8743,乳房,6,547857,0.00097197,88.74966386
8744,供需,6,547863,0.00097197,88.75063583
8745,來來百貨,6,547869,0.00097197,88.75160779
8746,來到,6,547875,0.00097197,88.75257976
8747,刷上,6,547881,0.00097197,88.75355172
8748,刷毛,6,547887,0.00097197,88.75452369
8749,協理,6,547893,0.00097197,88.75549565
8750,卸粧,6,547899,0.00097197,88.75646762
8751,受制,6,547905,0.00097197,88.75743958
8752,味全龍,6,547911,0.00097197,88.75841155
8753,周末,6,547917,0.00097197,88.75938351
8754,坦白,6,547923,0.00097197,88.76035548
8755,奉,6,547929,0.00097197,88.76132745
8756,奇特,6,547935,0.00097197,88.76229941
8757,奔走,6,547941,0.00097197,88.76327138
8758,孤單,6,547947,0.00097197,88.76424334
8759,定論,6,547953,0.00097197,88.76521531
8760,官邸,6,547959,0.00097197,88.76618727
8761,宜宏,6,547965,0.00097197,88.76715924
8762,宜姍,6,547971,0.00097197,88.76813120
8763,岩石,6,547977,0.00097197,88.76910317
8764,帖,6,547983,0.00097197,88.77007513
8765,幸福豹,6,547989,0.00097197,88.77104710
8766,弦群,6,547995,0.00097197,88.77201906
8767,往生室,6,548001,0.00097197,88.77299103
8768,所得稅,6,548007,0.00097197,88.77396299
8769,承租,6,548013,0.00097197,88.77493496
8770,拉抬,6,548019,0.00097197,88.77590692
8771,拉長,6,548025,0.00097197,88.77687889
8772,拉開,6,548031,0.00097197,88.77785086
8773,抹,6,548037,0.00097197,88.77882282
8774,招募,6,548043,0.00097197,88.77979479
8775,拔除,6,548049,0.00097197,88.78076675
8776,拋棄,6,548055,0.00097197,88.78173872
8777,抵抗力,6,548061,0.00097197,88.78271068
8778,抬頭,6,548067,0.00097197,88.78368265
8779,明證,6,548073,0.00097197,88.78465461
8780,明碁,6,548079,0.00097197,88.78562658
8781,昇陽,6,548085,0.00097197,88.78659854
8782,東方酒店,6,548091,0.00097197,88.78757051
8783,果菜公司,6,548097,0.00097197,88.78854247
8784,林務局,6,548103,0.00097197,88.78951444
8785,林瑞圖,6,548109,0.00097197,88.79048640
8786,林豐正,6,548115,0.00097197,88.79145837
8787,板凳,6,548121,0.00097197,88.79243033
8788,武術,6,548127,0.00097197,88.79340230
8789,法術,6,548133,0.00097197,88.79437426
8790,法會,6,548139,0.00097197,88.79534623
8791,油漆,6,548145,0.00097197,88.79631820
8792,沿線,6,548151,0.00097197,88.79729016
8793,爬行,6,548157,0.00097197,88.79826213
8794,爭議性,6,548163,0.00097197,88.79923409
8795,牧師,6,548169,0.00097197,88.80020606
8796,牧場,6,548175,0.00097197,88.80117802
8797,物美價廉,6,548181,0.00097197,88.80214999
8798,玩具總動員,6,548187,0.00097197,88.80312195
8799,玩笑,6,548193,0.00097197,88.80409392
8800,玩意兒,6,548199,0.00097197,88.80506588
8801,知覺,6,548205,0.00097197,88.80603785
8802,秉持,6,548211,0.00097197,88.80700981
8803,空地,6,548217,0.00097197,88.80798178
8804,肥,6,548223,0.00097197,88.80895374
8805,肥胖症,6,548229,0.00097197,88.80992571
8806,股票型,6,548235,0.00097197,88.81089767
8807,花旗貴賓銀行,6,548241,0.00097197,88.81186964
8808,初學者,6,548247,0.00097197,88.81284161
8809,表明,6,548253,0.00097197,88.81381357
8810,金石,6,548259,0.00097197,88.81478554
8811,金字塔,6,548265,0.00097197,88.81575750
8812,金色,6,548271,0.00097197,88.81672947
8813,阿,6,548277,0.00097197,88.81770143
8814,阿布蕭,6,548283,0.00097197,88.81867340
8815,阿龍,6,548289,0.00097197,88.81964536
8816,阻隔,6,548295,0.00097197,88.82061733
8817,附加價值,6,548301,0.00097197,88.82158929
8818,附贈,6,548307,0.00097197,88.82256126
8819,信託法,6,548313,0.00097197,88.82353322
8820,侵害,6,548319,0.00097197,88.82450519
8821,保有,6,548325,0.00097197,88.82547715
8822,保衛,6,548331,0.00097197,88.82644912
8823,保險金額,6,548337,0.00097197,88.82742108
8824,俗,6,548343,0.00097197,88.82839305
8825,係數,6,548349,0.00097197,88.82936502
8826,削減,6,548355,0.00097197,88.83033698
8827,前世,6,548361,0.00097197,88.83130895
8828,前任,6,548367,0.00097197,88.83228091
8829,南方澳,6,548373,0.00097197,88.83325288
8830,南向,6,548379,0.00097197,88.83422484
8831,南投,6,548385,0.00097197,88.83519681
8832,南高雄,6,548391,0.00097197,88.83616877
8833,厚度,6,548397,0.00097197,88.83714074
8834,姜,6,548403,0.00097197,88.83811270
8835,威權,6,548409,0.00097197,88.83908467
8836,室內,6,548415,0.00097197,88.84005663
8837,客房,6,548421,0.00097197,88.84102860
8838,客氣,6,548427,0.00097197,88.84200056
8839,封鎖,6,548433,0.00097197,88.84297253
8840,幽默感,6,548439,0.00097197,88.84394449
8841,建國黨,6,548445,0.00097197,88.84491646
8842,建構,6,548451,0.00097197,88.84588842
8843,建築師,6,548457,0.00097197,88.84686039
8844,後天,6,548463,0.00097197,88.84783236
8845,後盾,6,548469,0.00097197,88.84880432
8846,後悔,6,548475,0.00097197,88.84977629
8847,後院,6,548481,0.00097197,88.85074825
8848,後顧之憂,6,548487,0.00097197,88.85172022
8849,怨,6,548493,0.00097197,88.85269218
8850,怨言,6,548499,0.00097197,88.85366415
8851,扁,6,548505,0.00097197,88.85463611
8852,拼命,6,548511,0.00097197,88.85560808
8853,拼圖,6,548517,0.00097197,88.85658004
8854,持穩,6,548523,0.00097197,88.85755201
8855,指揮家,6,548529,0.00097197,88.85852397
8856,政治人物,6,548535,0.00097197,88.85949594
8857,政壇,6,548541,0.00097197,88.86046790
8858,春節,6,548547,0.00097197,88.86143987
8859,星期天,6,548553,0.00097197,88.86241183
8860,柯達公司,6,548559,0.00097197,88.86338380
8861,柏林,6,548565,0.00097197,88.86435577
8862,流出,6,548571,0.00097197,88.86532773
8863,流汗,6,548577,0.00097197,88.86629970
8864,流動性,6,548583,0.00097197,88.86727166
8865,流產,6,548589,0.00097197,88.86824363
8866,洞窟,6,548595,0.00097197,88.86921559
8867,洗禮,6,548601,0.00097197,88.87018756
8868,派出,6,548607,0.00097197,88.87115952
8869,派出所,6,548613,0.00097197,88.87213149
8870,狩獵,6,548619,0.00097197,88.87310345
8871,界定,6,548625,0.00097197,88.87407542
8872,界線,6,548631,0.00097197,88.87504738
8873,皇帝,6,548637,0.00097197,88.87601935
8874,相提並論,6,548643,0.00097197,88.87699131
8875,相遇,6,548649,0.00097197,88.87796328
8876,相鄰,6,548655,0.00097197,88.87893524
8877,研商,6,548661,0.00097197,88.87990721
8878,研讀,6,548667,0.00097197,88.88087917
8879,科克船長,6,548673,0.00097197,88.88185114
8880,穿插,6,548679,0.00097197,88.88282311
8881,紅黑色,6,548685,0.00097197,88.88379507
8882,紀念品,6,548691,0.00097197,88.88476704
8883,美洲,6,548697,0.00097197,88.88573900
8884,美籍,6,548703,0.00097197,88.88671097
8885,美譽,6,548709,0.00097197,88.88768293
8886,耐用,6,548715,0.00097197,88.88865490
8887,背部,6,548721,0.00097197,88.88962686
8888,胡瓜,6,548727,0.00097197,88.89059883
8889,致福,6,548733,0.00097197,88.89157079
8890,致福電子,6,548739,0.00097197,88.89254276
8891,范,6,548745,0.00097197,88.89351472
8892,范達美,6,548751,0.00097197,88.89448669
8893,英呎,6,548757,0.00097197,88.89545865
8894,要領,6,548763,0.00097197,88.89643062
8895,計算機,6,548769,0.00097197,88.89740258
8896,計價,6,548775,0.00097197,88.89837455
8897,軍用,6,548781,0.00097197,88.89934652
8898,軍備,6,548787,0.00097197,88.90031848
8899,迫切,6,548793,0.00097197,88.90129045
8900,重型機車,6,548799,0.00097197,88.90226241
8901,重挫,6,548805,0.00097197,88.90323438
8902,重現,6,548811,0.00097197,88.90420634
8903,重劃區,6,548817,0.00097197,88.90517831
8904,陌生人,6,548823,0.00097197,88.90615027
8905,面天樹蛙,6,548829,0.00097197,88.90712224
8906,音效卡,6,548835,0.00097197,88.90809420
8907,音樂廳,6,548841,0.00097197,88.90906617
8908,音響迷,6,548847,0.00097197,88.91003813
8909,風騷,6,548853,0.00097197,88.91101010
8910,飛航,6,548859,0.00097197,88.91198206
8911,首要,6,548865,0.00097197,88.91295403
8912,首席,6,548871,0.00097197,88.91392599
8913,首都,6,548877,0.00097197,88.91489796
8914,香菜,6,548883,0.00097197,88.91586993
8915,香檳,6,548889,0.00097197,88.91684189
8916,借牌,6,548895,0.00097197,88.91781386
8917,修道院,6,548901,0.00097197,88.91878582
8918,倫理,6,548907,0.00097197,88.91975779
8919,剝奪,6,548913,0.00097197,88.92072975
8920,原意,6,548919,0.00097197,88.92170172
8921,原諒,6,548925,0.00097197,88.92267368
8922,唐,6,548931,0.00097197,88.92364565
8923,哭鬧,6,548937,0.00097197,88.92461761
8924,員額,6,548943,0.00097197,88.92558958
8925,孫君,6,548949,0.00097197,88.92656154
8926,宮,6,548955,0.00097197,88.92753351
8927,射出,6,548961,0.00097197,88.92850547
8928,展售,6,548967,0.00097197,88.92947744
8929,差點,6,548973,0.00097197,88.93044940
8930,座椅,6,548979,0.00097197,88.93142137
8931,座落,6,548985,0.00097197,88.93239333
8932,座談,6,548991,0.00097197,88.93336530
8933,徐美華,6,548997,0.00097197,88.93433727
8934,息息相關,6,549003,0.00097197,88.93530923
8935,捕捉率,6,549009,0.00097197,88.93628120
8936,捕蟲葉,6,549015,0.00097197,88.93725316
8937,時效,6,549021,0.00097197,88.93822513
8938,時報鷹,6,549027,0.00097197,88.93919709
8939,書本,6,549033,0.00097197,88.94016906
8940,書商,6,549039,0.00097197,88.94114102
8941,書畫,6,549045,0.00097197,88.94211299
8942,核定,6,549051,0.00097197,88.94308495
8943,核價,6,549057,0.00097197,88.94405692
8944,案情,6,549063,0.00097197,88.94502888
8945,框,6,549069,0.00097197,88.94600085
8946,格子,6,549075,0.00097197,88.94697281
8947,殊,6,549081,0.00097197,88.94794478
8948,殊榮,6,549087,0.00097197,88.94891674
8949,浪潮,6,549093,0.00097197,88.94988871
8950,消,6,549099,0.00097197,88.95086068
8951,消防,6,549105,0.00097197,88.95183264
8952,消防隊,6,549111,0.00097197,88.95280461
8953,消耗,6,549117,0.00097197,88.95377657
8954,涉,6,549123,0.00097197,88.95474854
8955,涉案,6,549129,0.00097197,88.95572050
8956,浮動,6,549135,0.00097197,88.95669247
8957,浮濫,6,549141,0.00097197,88.95766443
8958,特意,6,549147,0.00097197,88.95863640
8959,特賣會,6,549153,0.00097197,88.95960836
8960,班次,6,549159,0.00097197,88.96058033
8961,病毒,6,549165,0.00097197,88.96155229
8962,疼愛,6,549171,0.00097197,88.96252426
8963,真空,6,549177,0.00097197,88.96349622
8964,砸,6,549183,0.00097197,88.96446819
8965,祕密,6,549189,0.00097197,88.96544015
8966,神話,6,549195,0.00097197,88.96641212
8967,租金,6,549201,0.00097197,88.96738409
8968,租稅,6,549207,0.00097197,88.96835605
8969,粉刺,6,549213,0.00097197,88.96932802
8970,紡拓會,6,549219,0.00097197,88.97029998
8971,紗廠,6,549225,0.00097197,88.97127195
8972,索引,6,549231,0.00097197,88.97224391
8973,索取,6,549237,0.00097197,88.97321588
8974,索性,6,549243,0.00097197,88.97418784
8975,紐澳,6,549249,0.00097197,88.97515981
8976,納稅人,6,549255,0.00097197,88.97613177
8977,缺席,6,549261,0.00097197,88.97710374
8978,脂,6,549267,0.00097197,88.97807570
8979,脅迫,6,549273,0.00097197,88.97904767
8980,航,6,549279,0.00097197,88.98001963
8981,荔枝,6,549285,0.00097197,88.98099160
8982,衰老,6,549291,0.00097197,88.98196356
8983,衰竭,6,549297,0.00097197,88.98293553
8984,記錄片,6,549303,0.00097197,88.98390749
8985,起出,6,549309,0.00097197,88.98487946
8986,起步,6,549315,0.00097197,88.98585143
8987,迷信,6,549321,0.00097197,88.98682339
8988,退票,6,549327,0.00097197,88.98779536
8989,退場,6,549333,0.00097197,88.98876732
8990,追捕,6,549339,0.00097197,88.98973929
8991,追殺,6,549345,0.00097197,88.99071125
8992,追尋,6,549351,0.00097197,88.99168322
8993,追趕,6,549357,0.00097197,88.99265518
8994,酒家,6,549363,0.00097197,88.99362715
8995,配發,6,549369,0.00097197,88.99459911
8996,配對,6,549375,0.00097197,88.99557108
8997,閃,6,549381,0.00097197,88.99654304
8998,院方,6,549387,0.00097197,88.99751501
8999,馬虎,6,549393,0.00097197,88.99848697
9000,馬惜珍,6,549399,0.00097197,88.99945894
9001,馬達加斯加,6,549405,0.00097197,89.00043090
9002,高大,6,549411,0.00097197,89.00140287
9003,高曼,6,549417,0.00097197,89.00237484
9004,高雄港,6,549423,0.00097197,89.00334680
9005,高幹,6,549429,0.00097197,89.00431877
9006,高潮,6,549435,0.00097197,89.00529073
9007,高聳,6,549441,0.00097197,89.00626270
9008,鬥,6,549447,0.00097197,89.00723466
9009,做成,6,549453,0.00097197,89.00820663
9010,做愛,6,549459,0.00097197,89.00917859
9011,偵查,6,549465,0.00097197,89.01015056
9012,偵查員,6,549471,0.00097197,89.01112252
9013,偏好,6,549477,0.00097197,89.01209449
9014,副市長,6,549483,0.00097197,89.01306645
9015,動盪,6,549489,0.00097197,89.01403842
9016,參數,6,549495,0.00097197,89.01501038
9017,商社,6,549501,0.00097197,89.01598235
9018,售出,6,549507,0.00097197,89.01695431
9019,國父紀念館,6,549513,0.00097197,89.01792628
9020,國民黨籍,6,549519,0.00097197,89.01889824
9021,國度,6,549525,0.00097197,89.01987021
9022,國家音樂廳,6,549531,0.00097197,89.02084218
9023,國營,6,549537,0.00097197,89.02181414
9024,基本款,6,549543,0.00097197,89.02278611
9025,基準,6,549549,0.00097197,89.02375807
9026,基督,6,549555,0.00097197,89.02473004
9027,堵路,6,549561,0.00097197,89.02570200
9028,執法,6,549567,0.00097197,89.02667397
9029,執業,6,549573,0.00097197,89.02764593
9030,崗位,6,549579,0.00097197,89.02861790
9031,巢,6,549585,0.00097197,89.02958986
9032,張忠傑,6,549591,0.00097197,89.03056183
9033,張進豐,6,549597,0.00097197,89.03153379
9034,張開,6,549603,0.00097197,89.03250576
9035,張雅琴,6,549609,0.00097197,89.03347772
9036,強弱,6,549615,0.00097197,89.03444969
9037,得獎,6,549621,0.00097197,89.03542165
9038,從業人員,6,549627,0.00097197,89.03639362
9039,悠閒,6,549633,0.00097197,89.03736559
9040,情趣,6,549639,0.00097197,89.03833755
9041,惟覺老和尚,6,549645,0.00097197,89.03930952
9042,探尋,6,549651,0.00097197,89.04028148
9043,探險,6,549657,0.00097197,89.04125345
9044,掩,6,549663,0.00097197,89.04222541
9045,掉落,6,549669,0.00097197,89.04319738
9046,推波助瀾,6,549675,0.00097197,89.04416934
9047,推陳出新,6,549681,0.00097197,89.04514131
9048,推論,6,549687,0.00097197,89.04611327
9049,掙扎,6,549693,0.00097197,89.04708524
9050,採行,6,549699,0.00097197,89.04805720
9051,採礦權,6,549705,0.00097197,89.04902917
9052,排水溝,6,549711,0.00097197,89.05000113
9053,排放,6,549717,0.00097197,89.05097310
9054,掀背車,6,549723,0.00097197,89.05194506
9055,救人,6,549729,0.00097197,89.05291703
9056,教學用槍,6,549735,0.00097197,89.05388900
9057,晚宴,6,549741,0.00097197,89.05486096
9058,毫克,6,549747,0.00097197,89.05583293
9059,液,6,549753,0.00097197,89.05680489
9060,清洗,6,549759,0.00097197,89.05777686
9061,清邁,6,549765,0.00097197,89.05874882
9062,淑平,6,549771,0.00097197,89.05972079
9063,淚,6,549777,0.00097197,89.06069275
9064,深厚,6,549783,0.00097197,89.06166472
9065,牽,6,549789,0.00097197,89.06263668
9066,猜,6,549795,0.00097197,89.06360865
9067,理想國,6,549801,0.00097197,89.06458061
9068,現代舞,6,549807,0.00097197,89.06555258
9069,產物,6,549813,0.00097197,89.06652454
9070,產品線,6,549819,0.00097197,89.06749651
9071,畢,6,549825,0.00097197,89.06846847
9072,盛傳,6,549831,0.00097197,89.06944044
9073,眾生,6,549837,0.00097197,89.07041240
9074,統一企業,6,549843,0.00097197,89.07138437
9075,統一發票,6,549849,0.00097197,89.07235634
9076,統一獅,6,549855,0.00097197,89.07332830
9077,細膩,6,549861,0.00097197,89.07430027
9078,終生,6,549867,0.00097197,89.07527223
9079,終極,6,549873,0.00097197,89.07624420
9080,終端,6,549879,0.00097197,89.07721616
9081,習慣性,6,549885,0.00097197,89.07818813
9082,脫落,6,549891,0.00097197,89.07916009
9083,船公司,6,549897,0.00097197,89.08013206
9084,莎朗史東,6,549903,0.00097197,89.08110402
9085,莎翁,6,549909,0.00097197,89.08207599
9086,莎劇,6,549915,0.00097197,89.08304795
9087,莫內,6,549921,0.00097197,89.08401992
9088,荷蘭村,6,549927,0.00097197,89.08499188
9089,處方,6,549933,0.00097197,89.08596385
9090,被動,6,549939,0.00097197,89.08693581
9091,被覆,6,549945,0.00097197,89.08790778
9092,規費,6,549951,0.00097197,89.08887975
9093,訝異,6,549957,0.00097197,89.08985171
9094,許可,6,549963,0.00097197,89.09082368
9095,設計者,6,549969,0.00097197,89.09179564
9096,貫穿,6,549975,0.00097197,89.09276761
9097,貨主,6,549981,0.00097197,89.09373957
9098,貪,6,549987,0.00097197,89.09471154
9099,軟頂,6,549993,0.00097197,89.09568350
9100,通勤,6,549999,0.00097197,89.09665547
9101,通盤,6,550005,0.00097197,89.09762743
9102,連日,6,550011,0.00097197,89.09859940
9103,連連,6,550017,0.00097197,89.09957136
9104,逝,6,550023,0.00097197,89.10054333
9105,造福,6,550029,0.00097197,89.10151529
9106,透明化,6,550035,0.00097197,89.10248726
9107,逛街,6,550041,0.00097197,89.10345922
9108,郭金生,6,550047,0.00097197,89.10443119
9109,野生動物,6,550053,0.00097197,89.10540315
9110,閉,6,550059,0.00097197,89.10637512
9111,陳世卿,6,550065,0.00097197,89.10734709
9112,陸,6,550071,0.00097197,89.10831905
9113,陰莖,6,550077,0.00097197,89.10929102
9114,頂多,6,550083,0.00097197,89.11026298
9115,鳥類,6,550089,0.00097197,89.11123495
9116,麻木,6,550095,0.00097197,89.11220691
9117,備受,6,550101,0.00097197,89.11317888
9118,創刊,6,550107,0.00097197,89.11415084
9119,勞工黨,6,550113,0.00097197,89.11512281
9120,喜宴,6,550119,0.00097197,89.11609477
9121,喪生,6,550125,0.00097197,89.11706674
9122,單字,6,550131,0.00097197,89.11803870
9123,喬治亞,6,550137,0.00097197,89.11901067
9124,喉嚨,6,550143,0.00097197,89.11998263
9125,報到,6,550149,0.00097197,89.12095460
9126,報社,6,550155,0.00097197,89.12192656
9127,報業,6,550161,0.00097197,89.12289853
9128,廂,6,550167,0.00097197,89.12387050
9129,彭淑嬅,6,550173,0.00097197,89.12484246
9130,復出,6,550179,0.00097197,89.12581443
9131,惡劣,6,550185,0.00097197,89.12678639
9132,惡魔,6,550191,0.00097197,89.12775836
9133,悲,6,550197,0.00097197,89.12873032
9134,悲哀,6,550203,0.00097197,89.12970229
9135,悲慘,6,550209,0.00097197,89.13067425
9136,悶,6,550215,0.00097197,89.13164622
9137,掌聲,6,550221,0.00097197,89.13261818
9138,插花,6,550227,0.00097197,89.13359015
9139,提領,6,550233,0.00097197,89.13456211
9140,揭曉,6,550239,0.00097197,89.13553408
9141,敦化南路,6,550245,0.00097197,89.13650604
9142,散播,6,550251,0.00097197,89.13747801
9143,普通話,6,550257,0.00097197,89.13844997
9144,智慧財產權,6,550263,0.00097197,89.13942194
9145,曾子,6,550269,0.00097197,89.14039391
9146,棉,6,550275,0.00097197,89.14136587
9147,殖民,6,550281,0.00097197,89.14233784
9148,滋潤,6,550287,0.00097197,89.14330980
9149,無異,6,550293,0.00097197,89.14428177
9150,無謂,6,550299,0.00097197,89.14525373
9151,畫風,6,550305,0.00097197,89.14622570
9152,痠痛,6,550311,0.00097197,89.14719766
9153,發送,6,550317,0.00097197,89.14816963
9154,盜壘王,6,550323,0.00097197,89.14914159
9155,稅源,6,550329,0.00097197,89.15011356
9156,窘境,6,550335,0.00097197,89.15108552
9157,筆觸,6,550341,0.00097197,89.15205749
9158,結識,6,550347,0.00097197,89.15302945
9159,善緣,6,550353,0.00097197,89.15400142
9160,菁,6,550359,0.00097197,89.15497338
9161,華仔,6,550365,0.00097197,89.15594535
9162,華府,6,550371,0.00097197,89.15691731
9163,著迷,6,550377,0.00097197,89.15788928
9164,虛,6,550383,0.00097197,89.15886125
9165,訴,6,550389,0.00097197,89.15983321
9166,訴說,6,550395,0.00097197,89.16080518
9167,診,6,550401,0.00097197,89.16177714
9168,超視,6,550407,0.00097197,89.16274911
9169,跑道,6,550413,0.00097197,89.16372107
9170,進退,6,550419,0.00097197,89.16469304
9171,鄉民,6,550425,0.00097197,89.16566500
9172,鈉,6,550431,0.00097197,89.16663697
9173,開水,6,550437,0.00097197,89.16760893
9174,開出,6,550443,0.00097197,89.16858090
9175,開打,6,550449,0.00097197,89.16955286
9176,開標,6,550455,0.00097197,89.17052483
9177,開盤,6,550461,0.00097197,89.17149679
9178,開頭,6,550467,0.00097197,89.17246876
9179,間隔,6,550473,0.00097197,89.17344072
9180,階,6,550479,0.00097197,89.17441269
9181,階梯,6,550485,0.00097197,89.17538466
9182,集結,6,550491,0.00097197,89.17635662
9183,集集線,6,550497,0.00097197,89.17732859
9184,雇主,6,550503,0.00097197,89.17830055
9185,雲門,6,550509,0.00097197,89.17927252
9186,韌性,6,550515,0.00097197,89.18024448
9187,飲水,6,550521,0.00097197,89.18121645
9188,黃永松,6,550527,0.00097197,89.18218841
9189,黃忠賢,6,550533,0.00097197,89.18316038
9190,黑眼圈,6,550539,0.00097197,89.18413234
9191,亂七八糟,6,550545,0.00097197,89.18510431
9192,傳送點,6,550551,0.00097197,89.18607627
9193,傳授,6,550557,0.00097197,89.18704824
9194,傳劍,6,550563,0.00097197,89.18802020
9195,傾,6,550569,0.00097197,89.18899217
9196,傾聽,6,550575,0.00097197,89.18996413
9197,傷痕,6,550581,0.00097197,89.19093610
9198,募款,6,550587,0.00097197,89.19190807
9199,匯流排,6,550593,0.00097197,89.19288003
9200,塞,6,550599,0.00097197,89.19385200
9201,塞車,6,550605,0.00097197,89.19482396
9202,嫌疑,6,550611,0.00097197,89.19579593
9203,媲美,6,550617,0.00097197,89.19676789
9204,意念,6,550623,0.00097197,89.19773986
9205,意涵,6,550629,0.00097197,89.19871182
9206,意圖,6,550635,0.00097197,89.19968379
9207,意境,6,550641,0.00097197,89.20065575
9208,感觸,6,550647,0.00097197,89.20162772
9209,想必,6,550653,0.00097197,89.20259968
9210,想想看,6,550659,0.00097197,89.20357165
9211,愛沙尼亞,6,550665,0.00097197,89.20454361
9212,愛滋病毒,6,550671,0.00097197,89.20551558
9213,搭建,6,550677,0.00097197,89.20648754
9214,搬遷,6,550683,0.00097197,89.20745951
9215,搜索,6,550689,0.00097197,89.20843147
9216,搖頭,6,550695,0.00097197,89.20940344
9217,斟酌,6,550701,0.00097197,89.21037541
9218,會計,6,550707,0.00097197,89.21134737
9219,會議室,6,550713,0.00097197,89.21231934
9220,業力,6,550719,0.00097197,89.21329130
9221,業主,6,550725,0.00097197,89.21426327
9222,楊桂森,6,550731,0.00097197,89.21523523
9223,溝,6,550737,0.00097197,89.21620720
9224,滅亡,6,550743,0.00097197,89.21717916
9225,滑,6,550749,0.00097197,89.21815113
9226,溪流,6,550755,0.00097197,89.21912309
9227,照相,6,550761,0.00097197,89.22009506
9228,煞車,6,550767,0.00097197,89.22106702
9229,當事人,6,550773,0.00097197,89.22203899
9230,當紅,6,550779,0.00097197,89.22301095
9231,盞,6,550785,0.00097197,89.22398292
9232,碎,6,550791,0.00097197,89.22495488
9233,碰面,6,550797,0.00097197,89.22592685
9234,碉堡,6,550803,0.00097197,89.22689882
9235,禁用,6,550809,0.00097197,89.22787078
9236,罪惡,6,550815,0.00097197,89.22884275
9237,腥味,6,550821,0.00097197,89.22981471
9238,腫脹,6,550827,0.00097197,89.23078668
9239,腦細胞,6,550833,0.00097197,89.23175864
9240,落地,6,550839,0.00097197,89.23273061
9241,葬,6,550845,0.00097197,89.23370257
9242,蛾摩拉,6,550851,0.00097197,89.23467454
9243,蜂窩,6,550857,0.00097197,89.23564650
9244,補強,6,550863,0.00097197,89.23661847
9245,裝設,6,550869,0.00097197,89.23759043
9246,裕隆隊,6,550875,0.00097197,89.23856240
9247,解嚴,6,550881,0.00097197,89.23953436
9248,解讀,6,550887,0.00097197,89.24050633
9249,詩意,6,550893,0.00097197,89.24147829
9250,誠實,6,550899,0.00097197,89.24245026
9251,誠懇,6,550905,0.00097197,89.24342222
9252,詭異,6,550911,0.00097197,89.24439419
9253,詬病,6,550917,0.00097197,89.24536616
9254,資遣,6,550923,0.00097197,89.24633812
9255,資歷,6,550929,0.00097197,89.24731009
9256,遊樂區,6,550935,0.00097197,89.24828205
9257,遊樂器,6,550941,0.00097197,89.24925402
9258,遊覽,6,550947,0.00097197,89.25022598
9259,達維特,6,550953,0.00097197,89.25119795
9260,違憲,6,550959,0.00097197,89.25216991
9261,遇上,6,550965,0.00097197,89.25314188
9262,過多,6,550971,0.00097197,89.25411384
9263,過熱,6,550977,0.00097197,89.25508581
9264,鉛,6,550983,0.00097197,89.25605777
9265,電梯,6,550989,0.00097197,89.25702974
9266,電報,6,550995,0.00097197,89.25800170
9267,零點五,6,551001,0.00097197,89.25897367
9268,預約,6,551007,0.00097197,89.25994563
9269,預設,6,551013,0.00097197,89.26091760
9270,預備,6,551019,0.00097197,89.26188957
9271,頒,6,551025,0.00097197,89.26286153
9272,僑泰建設,6,551031,0.00097197,89.26383350
9273,厭惡,6,551037,0.00097197,89.26480546
9274,嘉義市,6,551043,0.00097197,89.26577743
9275,團長,6,551049,0.00097197,89.26674939
9276,圖象,6,551055,0.00097197,89.26772136
9277,壽險,6,551061,0.00097197,89.26869332
9278,寧願,6,551067,0.00097197,89.26966529
9279,實用性,6,551073,0.00097197,89.27063725
9280,實例,6,551079,0.00097197,89.27160922
9281,實惠,6,551085,0.00097197,89.27258118
9282,對談,6,551091,0.00097197,89.27355315
9283,廖,6,551097,0.00097197,89.27452511
9284,廖繼春,6,551103,0.00097197,89.27549708
9285,弊端,6,551109,0.00097197,89.27646904
9286,態勢,6,551115,0.00097197,89.27744101
9287,截止,6,551121,0.00097197,89.27841298
9288,截然,6,551127,0.00097197,89.27938494
9289,摔,6,551133,0.00097197,89.28035691
9290,撤銷,6,551139,0.00097197,89.28132887
9291,摧毀,6,551145,0.00097197,89.28230084
9292,敲擊,6,551151,0.00097197,89.28327280
9293,暢通,6,551157,0.00097197,89.28424477
9294,暢遊,6,551163,0.00097197,89.28521673
9295,榮總,6,551169,0.00097197,89.28618870
9296,槍枝,6,551175,0.00097197,89.28716066
9297,演藝圈,6,551181,0.00097197,89.28813263
9298,漂白,6,551187,0.00097197,89.28910459
9299,漫步,6,551193,0.00097197,89.29007656
9300,漁港,6,551199,0.00097197,89.29104852
9301,盡力,6,551205,0.00097197,89.29202049
9302,盡快,6,551211,0.00097197,89.29299245
9303,磁區,6,551217,0.00097197,89.29396442
9304,磁碟片,6,551223,0.00097197,89.29493638
9305,碟片,6,551229,0.00097197,89.29590835
9306,福特,6,551235,0.00097197,89.29688032
9307,管理者,6,551241,0.00097197,89.29785228
9308,管線,6,551247,0.00097197,89.29882425
9309,精神病,6,551253,0.00097197,89.29979621
9310,精密度,6,551259,0.00097197,89.30076818
9311,精髓,6,551265,0.00097197,89.30174014
9312,維繫,6,551271,0.00097197,89.30271211
9313,膈膜,6,551277,0.00097197,89.30368407
9314,臺北,6,551283,0.00097197,89.30465604
9315,蒙太奇,6,551289,0.00097197,89.30562800
9316,裸,6,551295,0.00097197,89.30659997
9317,誤差,6,551301,0.00097197,89.30757193
9318,誤解,6,551307,0.00097197,89.30854390
9319,豪斯登堡,6,551313,0.00097197,89.30951586
9320,趙一龍,6,551319,0.00097197,89.31048783
9321,趙無極,6,551325,0.00097197,89.31145979
9322,趕上,6,551331,0.00097197,89.31243176
9323,趕工,6,551337,0.00097197,89.31340373
9324,趕往,6,551343,0.00097197,89.31437569
9325,輕微,6,551349,0.00097197,89.31534766
9326,遠大,6,551355,0.00097197,89.31631962
9327,遙控,6,551361,0.00097197,89.31729159
9328,遞,6,551367,0.00097197,89.31826355
9329,遞補,6,551373,0.00097197,89.31923552
9330,銀色,6,551379,0.00097197,89.32020748
9331,銀行業,6,551385,0.00097197,89.32117945
9332,銅管,6,551391,0.00097197,89.32215141
9333,鼻孔,6,551397,0.00097197,89.32312338
9334,劉華秋,6,551403,0.00097197,89.32409534
9335,增多,6,551409,0.00097197,89.32506731
9336,增資,6,551415,0.00097197,89.32603927
9337,寬廣,6,551421,0.00097197,89.32701124
9338,審議,6,551427,0.00097197,89.32798320
9339,廢標,6,551433,0.00097197,89.32895517
9340,廣州,6,551439,0.00097197,89.32992713
9341,廣告片,6,551445,0.00097197,89.33089910
9342,廣告物,6,551451,0.00097197,89.33187107
9343,廣告界,6,551457,0.00097197,89.33284303
9344,廣東話,6,551463,0.00097197,89.33381500
9345,廠棚,6,551469,0.00097197,89.33478696
9346,彈藥,6,551475,0.00097197,89.33575893
9347,影集,6,551481,0.00097197,89.33673089
9348,徵文,6,551487,0.00097197,89.33770286
9349,慶典,6,551493,0.00097197,89.33867482
9350,慶賀,6,551499,0.00097197,89.33964679
9351,憂,6,551505,0.00097197,89.34061875
9352,摩根指數概念股,6,551511,0.00097197,89.34159072
9353,撒,6,551517,0.00097197,89.34256268
9354,敵,6,551523,0.00097197,89.34353465
9355,敵意,6,551529,0.00097197,89.34450661
9356,數位化,6,551535,0.00097197,89.34547858
9357,暫緩,6,551541,0.00097197,89.34645054
9358,標籤,6,551547,0.00097197,89.34742251
9359,歐式,6,551553,0.00097197,89.34839448
9360,歐盟,6,551559,0.00097197,89.34936644
9361,潔淨,6,551565,0.00097197,89.35033841
9362,熱衷,6,551571,0.00097197,89.35131037
9363,熱誠,6,551577,0.00097197,89.35228234
9364,瘦身,6,551583,0.00097197,89.35325430
9365,盤商,6,551589,0.00097197,89.35422627
9366,編舞家,6,551595,0.00097197,89.35519823
9367,編劇,6,551601,0.00097197,89.35617020
9368,緣故,6,551607,0.00097197,89.35714216
9369,緞帶,6,551613,0.00097197,89.35811413
9370,罷免,6,551619,0.00097197,89.35908609
9371,蔬果,6,551625,0.00097197,89.36005806
9372,蔡特龍,6,551631,0.00097197,89.36103002
9373,蔥,6,551637,0.00097197,89.36200199
9374,複製,6,551643,0.00097197,89.36297395
9375,諒解,6,551649,0.00097197,89.36394592
9376,談論,6,551655,0.00097197,89.36491789
9377,請願,6,551661,0.00097197,89.36588985
9378,諸如,6,551667,0.00097197,89.36686182
9379,課堂,6,551673,0.00097197,89.36783378
9380,調子,6,551679,0.00097197,89.36880575
9381,調升,6,551685,0.00097197,89.36977771
9382,調查員,6,551691,0.00097197,89.37074968
9383,調酒,6,551697,0.00097197,89.37172164
9384,調解,6,551703,0.00097197,89.37269361
9385,豬母水,6,551709,0.00097197,89.37366557
9386,賣力,6,551715,0.00097197,89.37463754
9387,賣點,6,551721,0.00097197,89.37560950
9388,踏入,6,551727,0.00097197,89.37658147
9389,輪迴,6,551733,0.00097197,89.37755343
9390,輪椅,6,551739,0.00097197,89.37852540
9391,適宜,6,551745,0.00097197,89.37949736
9392,適脈旺錠,6,551751,0.00097197,89.38046933
9393,鋪,6,551757,0.00097197,89.38144129
9394,養成,6,551763,0.00097197,89.38241326
9395,駐地,6,551769,0.00097197,89.38338523
9396,駕馭,6,551775,0.00097197,89.38435719
9397,髮,6,551781,0.00097197,89.38532916
9398,髮型,6,551787,0.00097197,89.38630112
9399,魯肉飯,6,551793,0.00097197,89.38727309
9400,魯迅,6,551799,0.00097197,89.38824505
9401,學費,6,551805,0.00097197,89.38921702
9402,戰車,6,551811,0.00097197,89.39018898
9403,戰區,6,551817,0.00097197,89.39116095
9404,據報,6,551823,0.00097197,89.39213291
9405,操縱,6,551829,0.00097197,89.39310488
9406,整容,6,551835,0.00097197,89.39407684
9407,整備,6,551841,0.00097197,89.39504881
9408,整數,6,551847,0.00097197,89.39602077
9409,樹葉,6,551853,0.00097197,89.39699274
9410,機械業,6,551859,0.00097197,89.39796470
9411,機箱,6,551865,0.00097197,89.39893667
9412,歷練,6,551871,0.00097197,89.39990864
9413,激,6,551877,0.00097197,89.40088060
9414,燉,6,551883,0.00097197,89.40185257
9415,獨裁,6,551889,0.00097197,89.40282453
9416,磨,6,551895,0.00097197,89.40379650
9417,積水,6,551901,0.00097197,89.40476846
9418,積架,6,551907,0.00097197,89.40574043
9419,積蓄,6,551913,0.00097197,89.40671239
9420,積壓,6,551919,0.00097197,89.40768436
9421,糖尿病,6,551925,0.00097197,89.40865632
9422,興盛,6,551931,0.00097197,89.40962829
9423,蕭芳芳,6,551937,0.00097197,89.41060025
9424,融洽,6,551943,0.00097197,89.41157222
9425,親人,6,551949,0.00097197,89.41254418
9426,親愛,6,551955,0.00097197,89.41351615
9427,蹂躪,6,551961,0.00097197,89.41448811
9428,輸血,6,551967,0.00097197,89.41546008
9429,輸卵管,6,551973,0.00097197,89.41643205
9430,辨別,6,551979,0.00097197,89.41740401
9431,辦事,6,551985,0.00097197,89.41837598
9432,遵循,6,551991,0.00097197,89.41934794
9433,選任,6,551997,0.00097197,89.42031991
9434,選定,6,552003,0.00097197,89.42129187
9435,遲疑,6,552009,0.00097197,89.42226384
9436,遺忘,6,552015,0.00097197,89.42323580
9437,錯失,6,552021,0.00097197,89.42420777
9438,錢財,6,552027,0.00097197,89.42517973
9439,鋼板,6,552033,0.00097197,89.42615170
9440,鋼鐵,6,552039,0.00097197,89.42712366
9441,錫,6,552045,0.00097197,89.42809563
9442,隨心所欲,6,552051,0.00097197,89.42906759
9443,隨緣,6,552057,0.00097197,89.43003956
9444,靜止,6,552063,0.00097197,89.43101152
9445,頸部,6,552069,0.00097197,89.43198349
9446,館長,6,552075,0.00097197,89.43295545
9447,龍頭,6,552081,0.00097197,89.43392742
9448,嚇人,6,552087,0.00097197,89.43489939
9449,壓抑,6,552093,0.00097197,89.43587135
9450,戲曲,6,552099,0.00097197,89.43684332
9451,戲碼,6,552105,0.00097197,89.43781528
9452,濫墾,6,552111,0.00097197,89.43878725
9453,營造廠,6,552117,0.00097197,89.43975921
9454,獲利率,6,552123,0.00097197,89.44073118
9455,獲選,6,552129,0.00097197,89.44170314
9456,環保標章,6,552135,0.00097197,89.44267511
9457,療法,6,552141,0.00097197,89.44364707
9458,瞪,6,552147,0.00097197,89.44461904
9459,瞧,6,552153,0.00097197,89.44559100
9460,縮,6,552159,0.00097197,89.44656297
9461,縫,6,552165,0.00097197,89.44753493
9462,總體,6,552171,0.00097197,89.44850690
9463,縱,6,552177,0.00097197,89.44947886
9464,繁,6,552183,0.00097197,89.45045083
9465,聲浪,6,552189,0.00097197,89.45142280
9466,聲請,6,552195,0.00097197,89.45239476
9467,聯外道路,6,552201,0.00097197,89.45336673
9468,聯邦,6,552207,0.00097197,89.45433869
9469,聯席會,6,552213,0.00097197,89.45531066
9470,臉色,6,552219,0.00097197,89.45628262
9471,臨時動議,6,552225,0.00097197,89.45725459
9472,謎題,6,552231,0.00097197,89.45822655
9473,謝森中,6,552237,0.00097197,89.45919852
9474,轄,6,552243,0.00097197,89.46017048
9475,邁錫尼,6,552249,0.00097197,89.46114245
9476,鍾正行,6,552255,0.00097197,89.46211441
9477,隱含,6,552261,0.00097197,89.46308638
9478,鮮花,6,552267,0.00097197,89.46405834
9479,點將筆,6,552273,0.00097197,89.46503031
9480,點綴,6,552279,0.00097197,89.46600227
9481,點燃,6,552285,0.00097197,89.46697424
9482,叢生,6,552291,0.00097197,89.46794620
9483,擴增,6,552297,0.00097197,89.46891817
9484,殯儀館,6,552303,0.00097197,89.46989014
9485,癒合,6,552309,0.00097197,89.47086210
9486,簡便,6,552315,0.00097197,89.47183407
9487,簡章,6,552321,0.00097197,89.47280603
9488,簡樸,6,552327,0.00097197,89.47377800
9489,糧,6,552333,0.00097197,89.47474996
9490,翻案,6,552339,0.00097197,89.47572193
9491,翻閱,6,552345,0.00097197,89.47669389
9492,翻譯,6,552351,0.00097197,89.47766586
9493,職業賭場,6,552357,0.00097197,89.47863782
9494,謹,6,552363,0.00097197,89.47960979
9495,豐年祭,6,552369,0.00097197,89.48058175
9496,豐收,6,552375,0.00097197,89.48155372
9497,豐滿,6,552381,0.00097197,89.48252568
9498,蹤,6,552387,0.00097197,89.48349765
9499,轉運站,6,552393,0.00097197,89.48446961
9500,轉彎,6,552399,0.00097197,89.48544158
9501,醬油,6,552405,0.00097197,89.48641355
9502,釐清,6,552411,0.00097197,89.48738551
9503,雙打,6,552417,0.00097197,89.48835748
9504,雙唇,6,552423,0.00097197,89.48932944
9505,鬆弛,6,552429,0.00097197,89.49030141
9506,鬆綁,6,552435,0.00097197,89.49127337
9507,魏坤榮,6,552441,0.00097197,89.49224534
9508,懲處,6,552447,0.00097197,89.49321730
9509,懶,6,552453,0.00097197,89.49418927
9510,攀升,6,552459,0.00097197,89.49516123
9511,羅,6,552465,0.00097197,89.49613320
9512,羅介人,6,552471,0.00097197,89.49710516
9513,羅世幸,6,552477,0.00097197,89.49807713
9514,羅奇,6,552483,0.00097197,89.49904909
9515,藝術學院,6,552489,0.00097197,89.50002106
9516,藥液,6,552495,0.00097197,89.50099302
9517,藥劑,6,552501,0.00097197,89.50196499
9518,譏諷,6,552507,0.00097197,89.50293696
9519,鏢師,6,552513,0.00097197,89.50390892
9520,關門,6,552519,0.00097197,89.50488089
9521,關係企業,6,552525,0.00097197,89.50585285
9522,關掉,6,552531,0.00097197,89.50682482
9523,關稅,6,552537,0.00097197,89.50779678
9524,關鍵性,6,552543,0.00097197,89.50876875
9525,難度,6,552549,0.00097197,89.50974071
9526,難題,6,552555,0.00097197,89.51071268
9527,類比,6,552561,0.00097197,89.51168464
9528,籌委會,6,552567,0.00097197,89.51265661
9529,籌備委員,6,552573,0.00097197,89.51362857
9530,籌備處,6,552579,0.00097197,89.51460054
9531,耀眼,6,552585,0.00097197,89.51557250
9532,蘇,6,552591,0.00097197,89.51654447
9533,蘇格蘭,6,552597,0.00097197,89.51751643
9534,警力,6,552603,0.00097197,89.51848840
9535,警政署,6,552609,0.00097197,89.51946036
9536,釋迦牟尼佛,6,552615,0.00097197,89.52043233
9537,闡述,6,552621,0.00097197,89.52140430
9538,闡揚,6,552627,0.00097197,89.52237626
9539,麵條,6,552633,0.00097197,89.52334823
9540,黨職,6,552639,0.00097197,89.52432019
9541,攝影機,6,552645,0.00097197,89.52529216
9542,爛,6,552651,0.00097197,89.52626412
9543,續任,6,552657,0.00097197,89.52723609
9544,覽,6,552663,0.00097197,89.52820805
9545,轟炸機,6,552669,0.00097197,89.52918002
9546,霸,6,552675,0.00097197,89.53015198
9547,露出,6,552681,0.00097197,89.53112395
9548,顧及,6,552687,0.00097197,89.53209591
9549,顧慮,6,552693,0.00097197,89.53306788
9550,儼然,6,552699,0.00097197,89.53403984
9551,囊括,6,552705,0.00097197,89.53501181
9552,攤位,6,552711,0.00097197,89.53598377
9553,攤販,6,552717,0.00097197,89.53695574
9554,權利金,6,552723,0.00097197,89.53792771
9555,歡笑,6,552729,0.00097197,89.53889967
9556,聽見,6,552735,0.00097197,89.53987164
9557,戀情,6,552741,0.00097197,89.54084360
9558,顯得,6,552747,0.00097197,89.54181557
9559,顯影液,6,552753,0.00097197,89.54278753
9560,驚險,6,552759,0.00097197,89.54375950
9561,體操,6,552765,0.00097197,89.54473146
9562,羈押,6,552771,0.00097197,89.54570343
9563,靈,6,552777,0.00097197,89.54667539
9564,靈敏,6,552783,0.00097197,89.54764736
9565,鑲,6,552789,0.00097197,89.54861932
9566,讚嘆,6,552795,0.00097197,89.54959129
9567,驢,6,552801,0.00097197,89.55056325
9568,啥,6,552807,0.00097197,89.55153522
9569,一心一意,5,552812,0.00080997,89.55234519
9570,一共,5,552817,0.00080997,89.55315516
9571,一成不變,5,552822,0.00080997,89.55396513
9572,一色紗英,5,552827,0.00080997,89.55477510
9573,一行人,5,552832,0.00080997,89.55558507
9574,一步步,5,552837,0.00080997,89.55639505
9575,一段,5,552842,0.00080997,89.55720502
9576,一時之間,5,552847,0.00080997,89.55801499
9577,一絲,5,552852,0.00080997,89.55882496
9578,一窩蜂,5,552857,0.00080997,89.55963493
9579,一覽無遺,5,552862,0.00080997,89.56044490
9580,丁,5,552867,0.00080997,89.56125487
9581,七股鄉,5,552872,0.00080997,89.56206484
9582,二氧化碳,5,552877,0.00080997,89.56287481
9583,人和,5,552882,0.00080997,89.56368479
9584,人造,5,552887,0.00080997,89.56449476
9585,入口處,5,552892,0.00080997,89.56530473
9586,入場券,5,552897,0.00080997,89.56611470
9587,入會,5,552902,0.00080997,89.56692467
9588,入境,5,552907,0.00080997,89.56773464
9589,八里,5,552912,0.00080997,89.56854461
9590,八點檔,5,552917,0.00080997,89.56935458
9591,刁難,5,552922,0.00080997,89.57016455
9592,三桃爐,5,552927,0.00080997,89.57097452
9593,下山,5,552932,0.00080997,89.57178450
9594,上次,5,552937,0.00080997,89.57259447
9595,上線,5,552942,0.00080997,89.57340444
9596,上檔,5,552947,0.00080997,89.57421441
9597,亡,5,552952,0.00080997,89.57502438
9598,口才,5,552957,0.00080997,89.57583435
9599,口頭,5,552962,0.00080997,89.57664432
9600,土地銀行,5,552967,0.00080997,89.57745429
9601,士官,5,552972,0.00080997,89.57826426
9602,大功告成,5,552977,0.00080997,89.57907424
9603,大亨,5,552982,0.00080997,89.57988421
9604,大眾化,5,552987,0.00080997,89.58069418
9605,大陸球員,5,552992,0.00080997,89.58150415
9606,大街小巷,5,552997,0.00080997,89.58231412
9607,大象,5,553002,0.00080997,89.58312409
9608,大廠,5,553007,0.00080997,89.58393406
9609,大權,5,553012,0.00080997,89.58474403
9610,大廳,5,553017,0.00080997,89.58555400
9611,女人味,5,553022,0.00080997,89.58636398
9612,女王,5,553027,0.00080997,89.58717395
9613,女婿,5,553032,0.00080997,89.58798392
9614,小人物,5,553037,0.00080997,89.58879389
9615,小子,5,553042,0.00080997,89.58960386
9616,小白獅王,5,553047,0.00080997,89.59041383
9617,小伙子,5,553052,0.00080997,89.59122380
9618,小便,5,553057,0.00080997,89.59203377
9619,小品,5,553062,0.00080997,89.59284374
9620,小徑,5,553067,0.00080997,89.59365371
9621,小野,5,553072,0.00080997,89.59446369
9622,小麥,5,553077,0.00080997,89.59527366
9623,小說家,5,553082,0.00080997,89.59608363
9624,小羅,5,553087,0.00080997,89.59689360
9625,山上,5,553092,0.00080997,89.59770357
9626,山谷,5,553097,0.00080997,89.59851354
9627,山坡,5,553102,0.00080997,89.59932351
9628,山脈,5,553107,0.00080997,89.60013348
9629,工作室,5,553112,0.00080997,89.60094345
9630,工研院,5,553117,0.00080997,89.60175343
9631,工商界,5,553122,0.00080997,89.60256340
9632,工期,5,553127,0.00080997,89.60337337
9633,工程款,5,553132,0.00080997,89.60418334
9634,工業化,5,553137,0.00080997,89.60499331
9635,工業局長,5,553142,0.00080997,89.60580328
9636,不一致,5,553147,0.00080997,89.60661325
9637,不了了之,5,553152,0.00080997,89.60742322
9638,不出,5,553157,0.00080997,89.60823319
9639,不甘,5,553162,0.00080997,89.60904316
9640,不休,5,553167,0.00080997,89.60985314
9641,不快,5,553172,0.00080997,89.61066311
9642,不爭,5,553177,0.00080997,89.61147308
9643,不知所措,5,553182,0.00080997,89.61228305
9644,不知情,5,553187,0.00080997,89.61309302
9645,不便宜,5,553192,0.00080997,89.61390299
9646,不為,5,553197,0.00080997,89.61471296
9647,不約而同,5,553202,0.00080997,89.61552293
9648,不高興,5,553207,0.00080997,89.61633290
9649,不乾淨,5,553212,0.00080997,89.61714288
9650,不問,5,553217,0.00080997,89.61795285
9651,不得已,5,553222,0.00080997,89.61876282
9652,不啻,5,553227,0.00080997,89.61957279
9653,不單,5,553232,0.00080997,89.62038276
9654,中央山脈,5,553237,0.00080997,89.62119273
9655,中央黨部,5,553242,0.00080997,89.62200270
9656,中立,5,553247,0.00080997,89.62281267
9657,中信局,5,553252,0.00080997,89.62362264
9658,中南海,5,553257,0.00080997,89.62443262
9659,中秋節,5,553262,0.00080997,89.62524259
9660,中原,5,553267,0.00080997,89.62605256
9661,中國時報開卷版,5,553272,0.00080997,89.62686253
9662,中國菜,5,553277,0.00080997,89.62767250
9663,中國概念股,5,553282,0.00080997,89.62848247
9664,中華民族,5,553287,0.00080997,89.62929244
9665,中華航空,5,553292,0.00080997,89.63010241
9666,中華經濟研究院,5,553297,0.00080997,89.63091238
9667,中華職籃,5,553302,0.00080997,89.63172235
9668,中影,5,553307,0.00080997,89.63253233
9669,中興新村,5,553312,0.00080997,89.63334230
9670,尹立人,5,553317,0.00080997,89.63415227
9671,互信,5,553322,0.00080997,89.63496224
9672,五官,5,553327,0.00080997,89.63577221
9673,五顏六色,5,553332,0.00080997,89.63658218
9674,仁愛公園,5,553337,0.00080997,89.63739215
9675,元首,5,553342,0.00080997,89.63820212
9676,內行,5,553347,0.00080997,89.63901209
9677,內政,5,553352,0.00080997,89.63982207
9678,內需,5,553357,0.00080997,89.64063204
9679,內褲,5,553362,0.00080997,89.64144201
9680,內斂,5,553367,0.00080997,89.64225198
9681,內臟,5,553372,0.00080997,89.64306195
9682,六合彩,5,553377,0.00080997,89.64387192
9683,公立,5,553382,0.00080997,89.64468189
9684,公有,5,553387,0.00080997,89.64549186
9685,公務人員,5,553392,0.00080997,89.64630183
9686,公廁,5,553397,0.00080997,89.64711181
9687,公然,5,553402,0.00080997,89.64792178
9688,公職人員,5,553407,0.00080997,89.64873175
9689,凶手,5,553412,0.00080997,89.64954172
9690,分歧,5,553417,0.00080997,89.65035169
9691,分量,5,553422,0.00080997,89.65116166
9692,勾起,5,553427,0.00080997,89.65197163
9693,化驗,5,553432,0.00080997,89.65278160
9694,午夜,5,553437,0.00080997,89.65359157
9695,午後,5,553442,0.00080997,89.65440154
9696,反向,5,553447,0.00080997,89.65521152
9697,反攻,5,553452,0.00080997,89.65602149
9698,反差,5,553457,0.00080997,89.65683146
9699,反效果,5,553462,0.00080997,89.65764143
9700,反覆浴,5,553467,0.00080997,89.65845140
9701,天母,5,553472,0.00080997,89.65926137
9702,天花板,5,553477,0.00080997,89.66007134
9703,天馬行空,5,553482,0.00080997,89.66088131
9704,天麻,5,553487,0.00080997,89.66169128
9705,天賦,5,553492,0.00080997,89.66250126
9706,太保,5,553497,0.00080997,89.66331123
9707,巴巴爾郡,5,553502,0.00080997,89.66412120
9708,巴比松畫派,5,553507,0.00080997,89.66493117
9709,引入,5,553512,0.00080997,89.66574114
9710,心目,5,553517,0.00080997,89.66655111
9711,心事,5,553522,0.00080997,89.66736108
9712,心胸,5,553527,0.00080997,89.66817105
9713,戈蘭高地,5,553532,0.00080997,89.66898102
9714,手肘,5,553537,0.00080997,89.66979100
9715,手套,5,553542,0.00080997,89.67060097
9716,手勢,5,553547,0.00080997,89.67141094
9717,手鉤,5,553552,0.00080997,89.67222091
9718,文化大學,5,553557,0.00080997,89.67303088
9719,文武場,5,553562,0.00080997,89.67384085
9720,文物公園,5,553567,0.00080997,89.67465082
9721,文華,5,553572,0.00080997,89.67546079
9722,文壇,5,553577,0.00080997,89.67627076
9723,文藝,5,553582,0.00080997,89.67708073
9724,日商,5,553587,0.00080997,89.67789071
9725,木材,5,553592,0.00080997,89.67870068
9726,比值,5,553597,0.00080997,89.67951065
9727,毛皮,5,553602,0.00080997,89.68032062
9728,毛衣,5,553607,0.00080997,89.68113059
9729,毛筆,5,553612,0.00080997,89.68194056
9730,水處,5,553617,0.00080997,89.68275053
9731,水量,5,553622,0.00080997,89.68356050
9732,水溫,5,553627,0.00080997,89.68437047
9733,水管,5,553632,0.00080997,89.68518045
9734,水銀電池,5,553637,0.00080997,89.68599042
9735,父子,5,553642,0.00080997,89.68680039
9736,牛油,5,553647,0.00080997,89.68761036
9737,牛郎星,5,553652,0.00080997,89.68842033
9738,牛宿一,5,553657,0.00080997,89.68923030
9739,牛鈴,5,553662,0.00080997,89.69004027
9740,牛頭,5,553667,0.00080997,89.69085024
9741,王介安,5,553672,0.00080997,89.69166021
9742,世俗,5,553677,0.00080997,89.69247018
9743,世家,5,553682,0.00080997,89.69328016
9744,丕變,5,553687,0.00080997,89.69409013
9745,主任委員,5,553692,0.00080997,89.69490010
9746,主食,5,553697,0.00080997,89.69571007
9747,主播,5,553702,0.00080997,89.69652004
9748,代表作,5,553707,0.00080997,89.69733001
9749,充電,5,553712,0.00080997,89.69813998
9750,兄弟象隊,5,553717,0.00080997,89.69894995
9751,凹陷,5,553722,0.00080997,89.69975992
9752,出入口,5,553727,0.00080997,89.70056990
9753,出手,5,553732,0.00080997,89.70137987
9754,出發點,5,553737,0.00080997,89.70218984
9755,出資,5,553742,0.00080997,89.70299981
9756,出遊,5,553747,0.00080997,89.70380978
9757,出境,5,553752,0.00080997,89.70461975
9758,刊載,5,553757,0.00080997,89.70542972
9759,加盟者,5,553762,0.00080997,89.70623969
9760,加緊,5,553767,0.00080997,89.70704966
9761,加劇,5,553772,0.00080997,89.70785964
9762,功能表,5,553777,0.00080997,89.70866961
9763,功率,5,553782,0.00080997,89.70947958
9764,北企,5,553787,0.00080997,89.71028955
9765,北河三星,5,553792,0.00080997,89.71109952
9766,占有率,5,553797,0.00080997,89.71190949
9767,卯,5,553802,0.00080997,89.71271946
9768,去掉,5,553807,0.00080997,89.71352943
9769,可笑,5,553812,0.00080997,89.71433940
9770,可期,5,553817,0.00080997,89.71514937
9771,可貴,5,553822,0.00080997,89.71595935
9772,可憐,5,553827,0.00080997,89.71676932
9773,古今,5,553832,0.00080997,89.71757929
9774,古物,5,553837,0.00080997,89.71838926
9775,古蹟,5,553842,0.00080997,89.71919923
9776,右手,5,553847,0.00080997,89.72000920
9777,史料,5,553852,0.00080997,89.72081917
9778,台胞,5,553857,0.00080997,89.72162914
9779,台聚,5,553862,0.00080997,89.72243911
9780,四川,5,553867,0.00080997,89.72324909
9781,四輪,5,553872,0.00080997,89.72405906
9782,囚犯,5,553877,0.00080997,89.72486903
9783,外太空,5,553882,0.00080997,89.72567900
9784,外加,5,553887,0.00080997,89.72648897
9785,外包,5,553892,0.00080997,89.72729894
9786,外省籍,5,553897,0.00080997,89.72810891
9787,外海,5,553902,0.00080997,89.72891888
9788,外圈,5,553907,0.00080997,89.72972885
9789,外籍,5,553912,0.00080997,89.73053883
9790,失真,5,553917,0.00080997,89.73134880
9791,失業率,5,553922,0.00080997,89.73215877
9792,失落,5,553927,0.00080997,89.73296874
9793,失蹤,5,553932,0.00080997,89.73377871
9794,奴隸,5,553937,0.00080997,89.73458868
9795,左邊,5,553942,0.00080997,89.73539865
9796,布魯頌,5,553947,0.00080997,89.73620862
9797,平民化,5,553952,0.00080997,89.73701859
9798,平息,5,553957,0.00080997,89.73782856
9799,平劇,5,553962,0.00080997,89.73863854
9800,必要性,5,553967,0.00080997,89.73944851
9801,打折,5,553972,0.00080997,89.74025848
9802,打拼,5,553977,0.00080997,89.74106845
9803,打球,5,553982,0.00080997,89.74187842
9804,打電話,5,553987,0.00080997,89.74268839
9805,打擾,5,553992,0.00080997,89.74349836
9806,扒手,5,553997,0.00080997,89.74430833
9807,斥資,5,554002,0.00080997,89.74511830
9808,本文,5,554007,0.00080997,89.74592828
9809,本季,5,554012,0.00080997,89.74673825
9810,本壘,5,554017,0.00080997,89.74754822
9811,未上市,5,554022,0.00080997,89.74835819
9812,未曾,5,554027,0.00080997,89.74916816
9813,末端,5,554032,0.00080997,89.74997813
9814,正副總統,5,554037,0.00080997,89.75078810
9815,民生東路,5,554042,0.00080997,89.75159807
9816,民生法案,5,554047,0.00080997,89.75240804
9817,民怨,5,554052,0.00080997,89.75321802
9818,民意代表,5,554057,0.00080997,89.75402799
9819,民藝,5,554062,0.00080997,89.75483796
9820,民權東西路,5,554067,0.00080997,89.75564793
9821,永和市,5,554072,0.00080997,89.75645790
9822,瓦斯,5,554077,0.00080997,89.75726787
9823,用法,5,554082,0.00080997,89.75807784
9824,甩,5,554087,0.00080997,89.75888781
9825,田園,5,554092,0.00080997,89.75969778
9826,由來,5,554097,0.00080997,89.76050775
9827,申領,5,554102,0.00080997,89.76131773
9828,白手起家,5,554107,0.00080997,89.76212770
9829,白瓊安,5,554112,0.00080997,89.76293767
9830,白鰭豚,5,554117,0.00080997,89.76374764
9831,皮夾,5,554122,0.00080997,89.76455761
9832,皮革,5,554127,0.00080997,89.76536758
9833,石油,5,554132,0.00080997,89.76617755
9834,石碇鄉,5,554137,0.00080997,89.76698752
9835,交情,5,554142,0.00080997,89.76779749
9836,交通部長,5,554147,0.00080997,89.76860747
9837,交集,5,554152,0.00080997,89.76941744
9838,交戰,5,554157,0.00080997,89.77022741
9839,仿效,5,554162,0.00080997,89.77103738
9840,伊朗,5,554167,0.00080997,89.77184735
9841,休,5,554172,0.00080997,89.77265732
9842,任內,5,554177,0.00080997,89.77346729
9843,任用,5,554182,0.00080997,89.77427726
9844,光陰,5,554187,0.00080997,89.77508723
9845,光臨,5,554192,0.00080997,89.77589720
9846,先機,5,554197,0.00080997,89.77670718
9847,全案,5,554202,0.00080997,89.77751715
9848,全盤,5,554207,0.00080997,89.77832712
9849,共用,5,554212,0.00080997,89.77913709
9850,冰冷,5,554217,0.00080997,89.77994706
9851,冰雪,5,554222,0.00080997,89.78075703
9852,划算,5,554227,0.00080997,89.78156700
9853,危險性,5,554232,0.00080997,89.78237697
9854,吉林路,5,554237,0.00080997,89.78318694
9855,吉爾祿,5,554242,0.00080997,89.78399692
9856,同心協力,5,554247,0.00080997,89.78480689
9857,同理,5,554252,0.00080997,89.78561686
9858,同夥,5,554257,0.00080997,89.78642683
9859,各國,5,554262,0.00080997,89.78723680
9860,向上,5,554267,0.00080997,89.78804677
9861,向心力,5,554272,0.00080997,89.78885674
9862,名士,5,554277,0.00080997,89.78966671
9863,名將,5,554282,0.00080997,89.79047668
9864,名聲,5,554287,0.00080997,89.79128666
9865,合利號,5,554292,0.00080997,89.79209663
9866,合庫,5,554297,0.00080997,89.79290660
9867,合唱,5,554302,0.00080997,89.79371657
9868,合資,5,554307,0.00080997,89.79452654
9869,合辦,5,554312,0.00080997,89.79533651
9870,吃力,5,554317,0.00080997,89.79614648
9871,吃完,5,554322,0.00080997,89.79695645
9872,吃掉,5,554327,0.00080997,89.79776642
9873,吃飽,5,554332,0.00080997,89.79857639
9874,因緣,5,554337,0.00080997,89.79938637
9875,回教,5,554342,0.00080997,89.80019634
9876,地獄,5,554347,0.00080997,89.80100631
9877,在職,5,554352,0.00080997,89.80181628
9878,好感,5,554357,0.00080997,89.80262625
9879,好轉,5,554362,0.00080997,89.80343622
9880,如出一轍,5,554367,0.00080997,89.80424619
9881,字串,5,554372,0.00080997,89.80505616
9882,字型,5,554377,0.00080997,89.80586613
9883,存款戶,5,554382,0.00080997,89.80667611
9884,守住,5,554387,0.00080997,89.80748608
9885,守護神,5,554392,0.00080997,89.80829605
9886,安全帽,5,554397,0.00080997,89.80910602
9887,安東尼,5,554402,0.00080997,89.80991599
9888,安迪,5,554407,0.00080997,89.81072596
9889,尖刀,5,554412,0.00080997,89.81153593
9890,尖銳,5,554417,0.00080997,89.81234590
9891,年年,5,554422,0.00080997,89.81315587
9892,年金,5,554427,0.00080997,89.81396585
9893,年限,5,554432,0.00080997,89.81477582
9894,年費,5,554437,0.00080997,89.81558579
9895,年鑑,5,554442,0.00080997,89.81639576
9896,成形,5,554447,0.00080997,89.81720573
9897,收押,5,554452,0.00080997,89.81801570
9898,早晚,5,554457,0.00080997,89.81882567
9899,旨,5,554462,0.00080997,89.81963564
9900,曲調,5,554467,0.00080997,89.82044561
9901,有線電視,5,554472,0.00080997,89.82125558
9902,有錢,5,554477,0.00080997,89.82206556
9903,朱高正,5,554482,0.00080997,89.82287553
9904,此種,5,554487,0.00080997,89.82368550
9905,汗水,5,554492,0.00080997,89.82449547
9906,江仲豪,5,554497,0.00080997,89.82530544
9907,池塘,5,554502,0.00080997,89.82611541
9908,灰姑娘,5,554507,0.00080997,89.82692538
9909,灰暗,5,554512,0.00080997,89.82773535
9910,灰燼,5,554517,0.00080997,89.82854532
9911,百年,5,554522,0.00080997,89.82935530
9912,百老匯,5,554527,0.00080997,89.83016527
9913,考試委員,5,554532,0.00080997,89.83097524
9914,肉類,5,554537,0.00080997,89.83178521
9915,自助,5,554542,0.00080997,89.83259518
9916,自家,5,554547,0.00080997,89.83340515
9917,自救會,5,554552,0.00080997,89.83421512
9918,自創,5,554557,0.00080997,89.83502509
9919,自衛,5,554562,0.00080997,89.83583506
9920,舌頭,5,554567,0.00080997,89.83664504
9921,行家,5,554572,0.00080997,89.83745501
9922,西方人,5,554577,0.00080997,89.83826498
9923,西西,5,554582,0.00080997,89.83907495
9924,西湖渡假村,5,554587,0.00080997,89.83988492
9925,西藏人,5,554592,0.00080997,89.84069489
9926,串聯,5,554597,0.00080997,89.84150486
9927,住進,5,554602,0.00080997,89.84231483
9928,佛像,5,554607,0.00080997,89.84312480
9929,佛學,5,554612,0.00080997,89.84393477
9930,何妨,5,554617,0.00080997,89.84474475
9931,估,5,554622,0.00080997,89.84555472
9932,估價,5,554627,0.00080997,89.84636469
9933,伸縮,5,554632,0.00080997,89.84717466
9934,佔領,5,554637,0.00080997,89.84798463
9935,作出,5,554642,0.00080997,89.84879460
9936,作案,5,554647,0.00080997,89.84960457
9937,作夢,5,554652,0.00080997,89.85041454
9938,伯恩斯坦,5,554657,0.00080997,89.85122451
9939,低潮,5,554662,0.00080997,89.85203449
9940,低頻,5,554667,0.00080997,89.85284446
9941,免不了,5,554672,0.00080997,89.85365443
9942,免除,5,554677,0.00080997,89.85446440
9943,免稅,5,554682,0.00080997,89.85527437
9944,判刑,5,554687,0.00080997,89.85608434
9945,判斷力,5,554692,0.00080997,89.85689431
9946,利弊,5,554697,0.00080997,89.85770428
9947,吳宇森,5,554702,0.00080997,89.85851425
9948,吳君如,5,554707,0.00080997,89.85932422
9949,吳秉天,5,554712,0.00080997,89.86013420
9950,告發,5,554717,0.00080997,89.86094417
9951,告發單,5,554722,0.00080997,89.86175414
9952,吸入,5,554727,0.00080997,89.86256411
9953,吸氣,5,554732,0.00080997,89.86337408
9954,吵架,5,554737,0.00080997,89.86418405
9955,含意,5,554742,0.00080997,89.86499402
9956,困惑,5,554747,0.00080997,89.86580399
9957,址,5,554752,0.00080997,89.86661396
9958,壯麗,5,554757,0.00080997,89.86742394
9959,夾子,5,554762,0.00080997,89.86823391
9960,妓女,5,554767,0.00080997,89.86904388
9961,宏福,5,554772,0.00080997,89.86985385
9962,尿片,5,554777,0.00080997,89.87066382
9963,尿失禁,5,554782,0.00080997,89.87147379
9964,庇蔭,5,554787,0.00080997,89.87228376
9965,抄截,5,554792,0.00080997,89.87309373
9966,抗拒,5,554797,0.00080997,89.87390370
9967,抗衡,5,554802,0.00080997,89.87471368
9968,技,5,554807,0.00080997,89.87552365
9969,批准,5,554812,0.00080997,89.87633362
9970,扳回,5,554817,0.00080997,89.87714359
9971,扳掣,5,554822,0.00080997,89.87795356
9972,抒發,5,554827,0.00080997,89.87876353
9973,折合,5,554832,0.00080997,89.87957350
9974,投球,5,554837,0.00080997,89.88038347
9975,投資局,5,554842,0.00080997,89.88119344
9976,投稿,5,554847,0.00080997,89.88200341
9977,抑鬱症者,5,554852,0.00080997,89.88281339
9978,改為,5,554857,0.00080997,89.88362336
9979,改頭換面,5,554862,0.00080997,89.88443333
9980,攻讀,5,554867,0.00080997,89.88524330
9981,束手無策,5,554872,0.00080997,89.88605327
9982,李奴,5,554877,0.00080997,89.88686324
9983,李德威,5,554882,0.00080997,89.88767321
9984,李聰富,5,554887,0.00080997,89.88848318
9985,村落,5,554892,0.00080997,89.88929315
9986,杜象,5,554897,0.00080997,89.89010313
9987,每次,5,554902,0.00080997,89.89091310
9988,每每,5,554907,0.00080997,89.89172307
9989,沈,5,554912,0.00080997,89.89253304
9990,沈澱,5,554917,0.00080997,89.89334301
9991,沈默,5,554922,0.00080997,89.89415298
9992,汪董,5,554927,0.00080997,89.89496295
9993,決戰,5,554932,0.00080997,89.89577292
9994,沒用,5,554937,0.00080997,89.89658289
9995,沒落,5,554942,0.00080997,89.89739287
9996,狂牛病,5,554947,0.00080997,89.89820284
9997,男孩子,5,554952,0.00080997,89.89901281
9998,男星,5,554957,0.00080997,89.89982278
9999,育,5,554962,0.00080997,89.90063275
10000,貝多芬,5,554967,0.00080997,89.90144272
10001,走低,5,554972,0.00080997,89.90225269
10002,辛烷值,5,554977,0.00080997,89.90306266
10003,防水性,5,554982,0.00080997,89.90387263
10004,防火,5,554987,0.00080997,89.90468260
10005,防護,5,554992,0.00080997,89.90549258
10006,防曬,5,554997,0.00080997,89.90630255
10007,乳頭,5,555002,0.00080997,89.90711252
10008,乳霜,5,555007,0.00080997,89.90792249
10009,亞洲象,5,555012,0.00080997,89.90873246
10010,亞特蘭大奧運,5,555017,0.00080997,89.90954243
10011,依歸,5,555022,0.00080997,89.91035240
10012,佳樂水,5,555027,0.00080997,89.91116237
10013,供奉,5,555032,0.00080997,89.91197234
10014,例行,5,555037,0.00080997,89.91278232
10015,併發,5,555042,0.00080997,89.91359229
10016,併購,5,555047,0.00080997,89.91440226
10017,兒女,5,555052,0.00080997,89.91521223
10018,兩倍,5,555057,0.00080997,89.91602220
10019,到來,5,555062,0.00080997,89.91683217
10020,到案,5,555067,0.00080997,89.91764214
10021,到場,5,555072,0.00080997,89.91845211
10022,制服,5,555077,0.00080997,89.91926208
10023,制訂,5,555082,0.00080997,89.92007206
10024,制衡,5,555087,0.00080997,89.92088203
10025,協辦,5,555092,0.00080997,89.92169200
10026,卸下,5,555097,0.00080997,89.92250197
10027,取向,5,555102,0.00080997,89.92331194
10028,受虐,5,555107,0.00080997,89.92412191
10029,受益,5,555112,0.00080997,89.92493188
10030,味全隊,5,555117,0.00080997,89.92574185
10031,周日,5,555122,0.00080997,89.92655182
10032,周詳,5,555127,0.00080997,89.92736179
10033,命案,5,555132,0.00080997,89.92817177
10034,固定利率,5,555137,0.00080997,89.92898174
10035,坡,5,555142,0.00080997,89.92979171
10036,夜長夢多,5,555147,0.00080997,89.93060168
10037,夜間,5,555152,0.00080997,89.93141165
10038,奉獻,5,555157,0.00080997,89.93222162
10039,奇異果,5,555162,0.00080997,89.93303159
10040,奈何,5,555167,0.00080997,89.93384156
10041,奔跑,5,555172,0.00080997,89.93465153
10042,姐,5,555177,0.00080997,89.93546151
10043,孤獨,5,555182,0.00080997,89.93627148
10044,宗,5,555187,0.00080997,89.93708145
10045,定案,5,555192,0.00080997,89.93789142
10046,官僚,5,555197,0.00080997,89.93870139
10047,宜德,5,555202,0.00080997,89.93951136
10048,岸邊,5,555207,0.00080997,89.94032133
10049,店頭,5,555212,0.00080997,89.94113130
10050,底線,5,555217,0.00080997,89.94194127
10051,延緩,5,555222,0.00080997,89.94275124
10052,忠孝東路,5,555227,0.00080997,89.94356122
10053,念念不忘,5,555232,0.00080997,89.94437119
10054,房舍,5,555237,0.00080997,89.94518116
10055,所在地,5,555242,0.00080997,89.94599113
10056,承盤,5,555247,0.00080997,89.94680110
10057,承銷人,5,555252,0.00080997,89.94761107
10058,抽屜,5,555257,0.00080997,89.94842104
10059,抽離,5,555262,0.00080997,89.94923101
10060,抽驗,5,555267,0.00080997,89.95004098
10061,抵擋,5,555272,0.00080997,89.95085096
10062,拚命,5,555277,0.00080997,89.95166093
10063,易智言,5,555282,0.00080997,89.95247090
10064,明明,5,555287,0.00080997,89.95328087
10065,昇,5,555292,0.00080997,89.95409084
10066,服務處,5,555297,0.00080997,89.95490081
10067,服裝店,5,555302,0.00080997,89.95571078
10068,東山,5,555307,0.00080997,89.95652075
10069,東方人,5,555312,0.00080997,89.95733072
10070,東北方,5,555317,0.00080997,89.95814070
10071,東吉島,5,555322,0.00080997,89.95895067
10072,東岸,5,555327,0.00080997,89.95976064
10073,東邊,5,555332,0.00080997,89.96057061
10074,果實,5,555337,0.00080997,89.96138058
10075,果蠅,5,555342,0.00080997,89.96219055
10076,林子敬,5,555347,0.00080997,89.96300052
10077,林水木,5,555352,0.00080997,89.96381049
10078,林承生,5,555357,0.00080997,89.96462046
10079,杯葛,5,555362,0.00080997,89.96543043
10080,松山機場,5,555367,0.00080997,89.96624041
10081,泌乳激素,5,555372,0.00080997,89.96705038
10082,波折,5,555377,0.00080997,89.96786035
10083,法定,5,555382,0.00080997,89.96867032
10084,法定空地,5,555387,0.00080997,89.96948029
10085,法務部長,5,555392,0.00080997,89.97029026
10086,法國史特拉斯堡打擊樂團,5,555397,0.00080997,89.97110023
10087,油門,5,555402,0.00080997,89.97191020
10088,油然而生,5,555407,0.00080997,89.97272017
10089,治癒,5,555412,0.00080997,89.97353015
10090,炎,5,555417,0.00080997,89.97434012
10091,炎夏,5,555422,0.00080997,89.97515009
10092,爭鬥,5,555427,0.00080997,89.97596006
10093,玩法,5,555432,0.00080997,89.97677003
10094,玩耍,5,555437,0.00080997,89.97758000
10095,玩偶,5,555442,0.00080997,89.97838997
10096,直播,5,555447,0.00080997,89.97919994
10097,社教館,5,555452,0.00080997,89.98000991
10098,空前,5,555457,0.00080997,89.98081989
10099,空隙,5,555462,0.00080997,89.98162986
10100,空襲,5,555467,0.00080997,89.98243983
10101,花束,5,555472,0.00080997,89.98324980
10102,花園,5,555477,0.00080997,89.98405977
10103,花蓮縣,5,555482,0.00080997,89.98486974
10104,初中,5,555487,0.00080997,89.98567971
10105,表單,5,555492,0.00080997,89.98648968
10106,表態,5,555497,0.00080997,89.98729965
10107,返國,5,555502,0.00080997,89.98810962
10108,近海,5,555507,0.00080997,89.98891960
10109,邱,5,555512,0.00080997,89.98972957
10110,金牛,5,555517,0.00080997,89.99053954
10111,金銀花,5,555522,0.00080997,89.99134951
10112,金龜,5,555527,0.00080997,89.99215948
10113,長相,5,555532,0.00080997,89.99296945
10114,長處,5,555537,0.00080997,89.99377942
10115,長程,5,555542,0.00080997,89.99458939
10116,門診,5,555547,0.00080997,89.99539936
10117,阿拉巴馬州,5,555552,0.00080997,89.99620934
10118,阿拉伯,5,555557,0.00080997,89.99701931
10119,阿玲,5,555562,0.00080997,89.99782928
10120,阿爾卑斯,5,555567,0.00080997,89.99863925
10121,附上,5,555572,0.00080997,89.99944922
10122,附錄,5,555577,0.00080997,90.00025919
10123,雨季,5,555582,0.00080997,90.00106916
10124,雨傘,5,555587,0.00080997,90.00187913
10125,青,5,555592,0.00080997,90.00268910
10126,非主流,5,555597,0.00080997,90.00349908
10127,非經濟因素,5,555602,0.00080997,90.00430905
10128,信譽,5,555607,0.00080997,90.00511902
10129,侵佔,5,555612,0.00080997,90.00592899
10130,侵襲,5,555617,0.00080997,90.00673896
10131,侯斯,5,555622,0.00080997,90.00754893
10132,侯寬仁,5,555627,0.00080997,90.00835890
10133,保送,5,555632,0.00080997,90.00916887
10134,保險公司,5,555637,0.00080997,90.00997884
10135,促,5,555642,0.00080997,90.01078881
10136,俗語,5,555647,0.00080997,90.01159879
10137,俗諺,5,555652,0.00080997,90.01240876
10138,剎那,5,555657,0.00080997,90.01321873
10139,前身,5,555662,0.00080997,90.01402870
10140,前晚,5,555667,0.00080997,90.01483867
10141,前線,5,555672,0.00080997,90.01564864
10142,前輩,5,555677,0.00080997,90.01645861
10143,勉勵,5,555682,0.00080997,90.01726858
10144,南下,5,555687,0.00080997,90.01807855
10145,南投縣,5,555692,0.00080997,90.01888853
10146,南亞,5,555697,0.00080997,90.01969850
10147,南海,5,555702,0.00080997,90.02050847
10148,品嚐,5,555707,0.00080997,90.02131844
10149,哈納斯湖,5,555712,0.00080997,90.02212841
10150,哈薩克人,5,555717,0.00080997,90.02293838
10151,垂涎,5,555722,0.00080997,90.02374835
10152,姚孟嘉,5,555727,0.00080997,90.02455832
10153,客串,5,555732,0.00080997,90.02536829
10154,客層,5,555737,0.00080997,90.02617826
10155,客廳,5,555742,0.00080997,90.02698824
10156,巷道,5,555747,0.00080997,90.02779821
10157,帝王,5,555752,0.00080997,90.02860818
10158,建屋出售,5,555757,0.00080997,90.02941815
10159,建照,5,555762,0.00080997,90.03022812
10160,後現代,5,555767,0.00080997,90.03103809
10161,後現代主義,5,555772,0.00080997,90.03184806
10162,後勤,5,555777,0.00080997,90.03265803
10163,急忙,5,555782,0.00080997,90.03346800
10164,急診室的春天,5,555787,0.00080997,90.03427798
10165,恰好,5,555792,0.00080997,90.03508795
10166,按下,5,555797,0.00080997,90.03589792
10167,按部就班,5,555802,0.00080997,90.03670789
10168,挑逗,5,555807,0.00080997,90.03751786
10169,挑釁,5,555812,0.00080997,90.03832783
10170,政見會,5,555817,0.00080997,90.03913780
10171,政界,5,555822,0.00080997,90.03994777
10172,政務,5,555827,0.00080997,90.04075774
10173,故鄉,5,555832,0.00080997,90.04156772
10174,故障,5,555837,0.00080997,90.04237769
10175,施政報告,5,555842,0.00080997,90.04318766
10176,春雨,5,555847,0.00080997,90.04399763
10177,染上,5,555852,0.00080997,90.04480760
10178,查明,5,555857,0.00080997,90.04561757
10179,查理,5,555862,0.00080997,90.04642754
10180,查證,5,555867,0.00080997,90.04723751
10181,毒素,5,555872,0.00080997,90.04804748
10182,毒液,5,555877,0.00080997,90.04885745
10183,洋溢,5,555882,0.00080997,90.04966743
10184,洪建德,5,555887,0.00080997,90.05047740
10185,流血,5,555892,0.00080997,90.05128737
10186,流利,5,555897,0.00080997,90.05209734
10187,流浪,5,555902,0.00080997,90.05290731
10188,流域,5,555907,0.00080997,90.05371728
10189,流量,5,555912,0.00080997,90.05452725
10190,活性,5,555917,0.00080997,90.05533722
10191,洽談,5,555922,0.00080997,90.05614719
10192,為止,5,555927,0.00080997,90.05695717
10193,炭琴,5,555932,0.00080997,90.05776714
10194,炸,5,555937,0.00080997,90.05857711
10195,狠狠,5,555942,0.00080997,90.05938708
10196,珊瑚博覽館,5,555947,0.00080997,90.06019705
10197,畏,5,555952,0.00080997,90.06100702
10198,皇室,5,555957,0.00080997,90.06181699
10199,省民,5,555962,0.00080997,90.06262696
10200,相連,5,555967,0.00080997,90.06343693
10201,相傳,5,555972,0.00080997,90.06424691
10202,眉頭,5,555977,0.00080997,90.06505688
10203,看到,5,555982,0.00080997,90.06586685
10204,砂石,5,555987,0.00080997,90.06667682
10205,研發部,5,555992,0.00080997,90.06748679
10206,研擬,5,555997,0.00080997,90.06829676
10207,祇,5,556002,0.00080997,90.06910673
10208,穿過,5,556007,0.00080997,90.06991670
10209,突如其來,5,556012,0.00080997,90.07072667
10210,突變,5,556017,0.00080997,90.07153664
10211,紅包,5,556022,0.00080997,90.07234662
10212,紀律,5,556027,0.00080997,90.07315659
10213,約定,5,556032,0.00080997,90.07396656
10214,美工,5,556037,0.00080997,90.07477653
10215,美美,5,556042,0.00080997,90.07558650
10216,美夢,5,556047,0.00080997,90.07639647
10217,美滿,5,556052,0.00080997,90.07720644
10218,美樂啤酒,5,556057,0.00080997,90.07801641
10219,美聯社,5,556062,0.00080997,90.07882638
10220,耶穌,5,556067,0.00080997,90.07963636
10221,茅草屋,5,556072,0.00080997,90.08044633
10222,苦力,5,556077,0.00080997,90.08125630
10223,苦心,5,556082,0.00080997,90.08206627
10224,苦難,5,556087,0.00080997,90.08287624
10225,要角,5,556092,0.00080997,90.08368621
10226,迥異,5,556097,0.00080997,90.08449618
10227,重生,5,556102,0.00080997,90.08530615
10228,重型,5,556107,0.00080997,90.08611612
10229,重量級,5,556112,0.00080997,90.08692609
10230,限定,5,556117,0.00080997,90.08773607
10231,限期,5,556122,0.00080997,90.08854604
10232,風力,5,556127,0.00080997,90.08935601
10233,風風雨雨,5,556132,0.00080997,90.09016598
10234,風雲,5,556137,0.00080997,90.09097595
10235,飛天,5,556142,0.00080997,90.09178592
10236,首飾,5,556147,0.00080997,90.09259589
10237,倍數,5,556152,0.00080997,90.09340586
10238,借重,5,556157,0.00080997,90.09421583
10239,修正案,5,556162,0.00080997,90.09502581
10240,修剪,5,556167,0.00080997,90.09583578
10241,修習,5,556172,0.00080997,90.09664575
10242,俾格米人,5,556177,0.00080997,90.09745572
10243,倫,5,556182,0.00080997,90.09826569
10244,准許,5,556187,0.00080997,90.09907566
10245,剛才,5,556192,0.00080997,90.09988563
10246,原住民委員會,5,556197,0.00080997,90.10069560
10247,原訂,5,556202,0.00080997,90.10150557
10248,原創,5,556207,0.00080997,90.10231555
10249,哭泣,5,556212,0.00080997,90.10312552
10250,唇線筆,5,556217,0.00080997,90.10393549
10251,埋伏,5,556222,0.00080997,90.10474546
10252,孫子,5,556227,0.00080997,90.10555543
10253,家居,5,556232,0.00080997,90.10636540
10254,家畜,5,556237,0.00080997,90.10717537
10255,容器,5,556242,0.00080997,90.10798534
10256,容顏,5,556247,0.00080997,90.10879531
10257,島嶼,5,556252,0.00080997,90.10960528
10258,差異性,5,556257,0.00080997,90.11041526
10259,差價,5,556262,0.00080997,90.11122523
10260,庭,5,556267,0.00080997,90.11203520
10261,徒弟,5,556272,0.00080997,90.11284517
10262,恥,5,556277,0.00080997,90.11365514
10263,恐龍,5,556282,0.00080997,90.11446511
10264,恭敬心,5,556287,0.00080997,90.11527508
10265,恩怨,5,556292,0.00080997,90.11608505
10266,拿取,5,556297,0.00080997,90.11689502
10267,挾持,5,556302,0.00080997,90.11770500
10268,振,5,556307,0.00080997,90.11851497
10269,捕魚,5,556312,0.00080997,90.11932494
10270,捐贈,5,556317,0.00080997,90.12013491
10271,挽回,5,556322,0.00080997,90.12094488
10272,挫敗,5,556327,0.00080997,90.12175485
10273,效力,5,556332,0.00080997,90.12256482
10274,旁人,5,556337,0.00080997,90.12337479
10275,時下,5,556342,0.00080997,90.12418476
10276,時日,5,556347,0.00080997,90.12499474
10277,書展,5,556352,0.00080997,90.12580471
10278,根源,5,556357,0.00080997,90.12661468
10279,梳,5,556362,0.00080997,90.12742465
10280,梳洗,5,556367,0.00080997,90.12823462
10281,桌面,5,556372,0.00080997,90.12904459
10282,栽,5,556377,0.00080997,90.12985456
10283,栽培,5,556382,0.00080997,90.13066453
10284,殷宗文,5,556387,0.00080997,90.13147450
10285,氣色,5,556392,0.00080997,90.13228447
10286,氣派,5,556397,0.00080997,90.13309445
10287,氣餒,5,556402,0.00080997,90.13390442
10288,氣囊,5,556407,0.00080997,90.13471439
10289,消防隊員,5,556412,0.00080997,90.13552436
10290,浸,5,556417,0.00080997,90.13633433
10291,海水,5,556422,0.00080997,90.13714430
10292,海洛因磚,5,556427,0.00080997,90.13795427
10293,海運,5,556432,0.00080997,90.13876424
10294,海灣,5,556437,0.00080997,90.13957421
10295,涉入,5,556442,0.00080997,90.14038419
10296,浴佛,5,556447,0.00080997,90.14119416
10297,浩威,5,556452,0.00080997,90.14200413
10298,烙乾,5,556457,0.00080997,90.14281410
10299,烏鴉,5,556462,0.00080997,90.14362407
10300,特力,5,556467,0.00080997,90.14443404
10301,特例,5,556472,0.00080997,90.14524401
10302,特稿,5,556477,0.00080997,90.14605398
10303,班尼,5,556482,0.00080997,90.14686395
10304,留下來,5,556487,0.00080997,90.14767393
10305,留住,5,556492,0.00080997,90.14848390
10306,病床,5,556497,0.00080997,90.14929387
10307,真人,5,556502,0.00080997,90.15010384
10308,真心,5,556507,0.00080997,90.15091381
10309,真空管,5,556512,0.00080997,90.15172378
10310,真愛一世情,5,556517,0.00080997,90.15253375
10311,破除,5,556522,0.00080997,90.15334372
10312,租約,5,556527,0.00080997,90.15415369
10313,秦,5,556532,0.00080997,90.15496366
10314,站崗,5,556537,0.00080997,90.15577364
10315,笑聲,5,556542,0.00080997,90.15658361
10316,紋理,5,556547,0.00080997,90.15739358
10317,紋路,5,556552,0.00080997,90.15820355
10318,素養,5,556557,0.00080997,90.15901352
10319,純樸,5,556562,0.00080997,90.15982349
10320,純攝影,5,556567,0.00080997,90.16063346
10321,納稅,5,556572,0.00080997,90.16144343
10322,納粹,5,556577,0.00080997,90.16225340
10323,缺憾,5,556582,0.00080997,90.16306338
10324,翁豐堉,5,556587,0.00080997,90.16387335
10325,耕作,5,556592,0.00080997,90.16468332
10326,耕耘,5,556597,0.00080997,90.16549329
10327,耗損,5,556602,0.00080997,90.16630326
10328,脆,5,556607,0.00080997,90.16711323
10329,脈絡,5,556612,0.00080997,90.16792320
10330,能耐,5,556617,0.00080997,90.16873317
10331,航程,5,556622,0.00080997,90.16954314
10332,荒廢,5,556627,0.00080997,90.17035311
10333,茲,5,556632,0.00080997,90.17116309
10334,茶藝館,5,556637,0.00080997,90.17197306
10335,衷,5,556642,0.00080997,90.17278303
10336,衷心,5,556647,0.00080997,90.17359300
10337,財力,5,556652,0.00080997,90.17440297
10338,起火,5,556657,0.00080997,90.17521294
10339,逆勢,5,556662,0.00080997,90.17602291
10340,迷失,5,556667,0.00080997,90.17683288
10341,迷你車,5,556672,0.00080997,90.17764285
10342,逃亡,5,556677,0.00080997,90.17845283
10343,逃走,5,556682,0.00080997,90.17926280
10344,追平,5,556687,0.00080997,90.18007277
10345,酒店,5,556692,0.00080997,90.18088274
10346,酒杯,5,556697,0.00080997,90.18169271
10347,酒醉,5,556702,0.00080997,90.18250268
10348,釘,5,556707,0.00080997,90.18331265
10349,閃燈,5,556712,0.00080997,90.18412262
10350,陣頭,5,556717,0.00080997,90.18493259
10351,馬丁,5,556722,0.00080997,90.18574257
10352,馬杜斯,5,556727,0.00080997,90.18655254
10353,骨董,5,556732,0.00080997,90.18736251
10354,高官,5,556737,0.00080997,90.18817248
10355,高林,5,556742,0.00080997,90.18898245
10356,高空,5,556747,0.00080997,90.18979242
10357,高超,5,556752,0.00080997,90.19060239
10358,高漲,5,556757,0.00080997,90.19141236
10359,高爾夫球,5,556762,0.00080997,90.19222233
10360,高醫,5,556767,0.00080997,90.19303230
10361,高麗,5,556772,0.00080997,90.19384228
10362,乾旱,5,556777,0.00080997,90.19465225
10363,停工,5,556782,0.00080997,90.19546222
10364,做為,5,556787,0.00080997,90.19627219
10365,健康劑,5,556792,0.00080997,90.19708216
10366,偵察,5,556797,0.00080997,90.19789213
10367,偷懶,5,556802,0.00080997,90.19870210
10368,偷竊,5,556807,0.00080997,90.19951207
10369,偏低,5,556812,0.00080997,90.20032204
10370,偏重,5,556817,0.00080997,90.20113202
10371,副主任,5,556822,0.00080997,90.20194199
10372,副議長,5,556827,0.00080997,90.20275196
10373,勒令,5,556832,0.00080997,90.20356193
10374,勘察,5,556837,0.00080997,90.20437190
10375,動不動,5,556842,0.00080997,90.20518187
10376,動亂,5,556847,0.00080997,90.20599184
10377,參賽者,5,556852,0.00080997,90.20680181
10378,商務,5,556857,0.00080997,90.20761178
10379,商業區,5,556862,0.00080997,90.20842176
10380,唱盤,5,556867,0.00080997,90.20923173
10381,問世,5,556872,0.00080997,90.21004170
10382,國父,5,556877,0.00080997,90.21085167
10383,國片,5,556882,0.00080997,90.21166164
10384,域,5,556887,0.00080997,90.21247161
10385,堅固,5,556892,0.00080997,90.21328158
10386,基石,5,556897,0.00080997,90.21409155
10387,基督教,5,556902,0.00080997,90.21490152
10388,執行長,5,556907,0.00080997,90.21571149
10389,執勤,5,556912,0.00080997,90.21652147
10390,孰,5,556917,0.00080997,90.21733144
10391,宿命,5,556922,0.00080997,90.21814141
10392,密閉式,5,556927,0.00080997,90.21895138
10393,專利權,5,556932,0.00080997,90.21976135
10394,專政,5,556937,0.00080997,90.22057132
10395,專業性,5,556942,0.00080997,90.22138129
10396,專精,5,556947,0.00080997,90.22219126
10397,崎嶇,5,556952,0.00080997,90.22300123
10398,帶走,5,556957,0.00080997,90.22381121
10399,張學友,5,556962,0.00080997,90.22462118
10400,強度,5,556967,0.00080997,90.22543115
10401,強硬派,5,556972,0.00080997,90.22624112
10402,強暴,5,556977,0.00080997,90.22705109
10403,彩繪,5,556982,0.00080997,90.22786106
10404,得票,5,556987,0.00080997,90.22867103
10405,得標,5,556992,0.00080997,90.22948100
10406,從未,5,556997,0.00080997,90.23029097
10407,探究,5,557002,0.00080997,90.23110095
10408,接洽,5,557007,0.00080997,90.23191092
10409,掃,5,557012,0.00080997,90.23272089
10410,掃描器,5,557017,0.00080997,90.23353086
10411,推案,5,557022,0.00080997,90.23434083
10412,推銷員,5,557027,0.00080997,90.23515080
10413,推翻,5,557032,0.00080997,90.23596077
10414,掙脫,5,557037,0.00080997,90.23677074
10415,捨,5,557042,0.00080997,90.23758071
10416,捨棄,5,557047,0.00080997,90.23839068
10417,敗壞,5,557052,0.00080997,90.23920066
10418,啟阜建設,5,557057,0.00080997,90.24001063
10419,敏捷,5,557062,0.00080997,90.24082060
10420,梯子,5,557067,0.00080997,90.24163057
10421,梯次,5,557072,0.00080997,90.24244054
10422,梅,5,557077,0.00080997,90.24325051
10423,條文,5,557082,0.00080997,90.24406048
10424,殺出,5,557087,0.00080997,90.24487045
10425,毫無疑問,5,557092,0.00080997,90.24568042
10426,淡淡,5,557097,0.00080997,90.24649040
10427,清單,5,557102,0.00080997,90.24730037
10428,清澈,5,557107,0.00080997,90.24811034
10429,清償,5,557112,0.00080997,90.24892031
10430,混淆,5,557117,0.00080997,90.24973028
10431,混凝土,5,557122,0.00080997,90.25054025
10432,淘子,5,557127,0.00080997,90.25135022
10433,深受,5,557132,0.00080997,90.25216019
10434,烹飪,5,557137,0.00080997,90.25297016
10435,牽制,5,557142,0.00080997,90.25378013
10436,理查三世,5,557147,0.00080997,90.25459011
10437,現年,5,557152,0.00080997,90.25540008
10438,瓷器,5,557157,0.00080997,90.25621005
10439,甜蜜,5,557162,0.00080997,90.25702002
10440,盛裝,5,557167,0.00080997,90.25782999
10441,眾神,5,557172,0.00080997,90.25863996
10442,眼袋,5,557177,0.00080997,90.25944993
10443,眼窩,5,557182,0.00080997,90.26025990
10444,眼簾,5,557187,0.00080997,90.26106987
10445,眺望,5,557192,0.00080997,90.26187985
10446,票選,5,557197,0.00080997,90.26268982
10447,祭品,5,557202,0.00080997,90.26349979
10448,窒息,5,557207,0.00080997,90.26430976
10449,第二春,5,557212,0.00080997,90.26511973
10450,第四台,5,557217,0.00080997,90.26592970
10451,粗獷,5,557222,0.00080997,90.26673967
10452,細紋,5,557227,0.00080997,90.26754964
10453,細密,5,557232,0.00080997,90.26835961
10454,細微,5,557237,0.00080997,90.26916959
10455,組件,5,557242,0.00080997,90.26997956
10456,終端電阻,5,557247,0.00080997,90.27078953
10457,終點,5,557252,0.00080997,90.27159950
10458,脫水,5,557257,0.00080997,90.27240947
10459,處置,5,557262,0.00080997,90.27321944
10460,蛋皮,5,557267,0.00080997,90.27402941
10461,袋子,5,557272,0.00080997,90.27483938
10462,許信良,5,557277,0.00080997,90.27564935
10463,軟片匣,5,557282,0.00080997,90.27645932
10464,通用,5,557287,0.00080997,90.27726930
10465,通信,5,557292,0.00080997,90.27807927
10466,通航,5,557297,0.00080997,90.27888924
10467,通通,5,557302,0.00080997,90.27969921
10468,通關,5,557307,0.00080997,90.28050918
10469,透視,5,557312,0.00080997,90.28131915
10470,部署,5,557317,0.00080997,90.28212912
10471,都市計劃,5,557322,0.00080997,90.28293909
10472,都要,5,557327,0.00080997,90.28374906
10473,野花,5,557332,0.00080997,90.28455904
10474,陳其邁,5,557337,0.00080997,90.28536901
10475,陳美鳳,5,557342,0.00080997,90.28617898
10476,陳唐山,5,557347,0.00080997,90.28698895
10477,陳書田,5,557352,0.00080997,90.28779892
10478,陰霾,5,557357,0.00080997,90.28860889
10479,陶曼,5,557362,0.00080997,90.28941886
10480,陶醉,5,557367,0.00080997,90.29022883
10481,陶器,5,557372,0.00080997,90.29103880
10482,頂級,5,557377,0.00080997,90.29184878
10483,魚類,5,557382,0.00080997,90.29265875
10484,麥肯茲,5,557387,0.00080997,90.29346872
10485,麥金塔電腦,5,557392,0.00080997,90.29427869
10486,傢伙,5,557397,0.00080997,90.29508866
10487,備長炭,5,557402,0.00080997,90.29589863
10488,凱楠,5,557407,0.00080997,90.29670860
10489,創造力,5,557412,0.00080997,90.29751857
10490,勞委會,5,557417,0.00080997,90.29832854
10491,勞累,5,557422,0.00080997,90.29913851
10492,勝投,5,557427,0.00080997,90.29994849
10493,勝訴,5,557432,0.00080997,90.30075846
10494,博,5,557437,0.00080997,90.30156843
10495,博仔,5,557442,0.00080997,90.30237840
10496,喝水,5,557447,0.00080997,90.30318837
10497,喘,5,557452,0.00080997,90.30399834
10498,單身,5,557457,0.00080997,90.30480831
10499,單能,5,557462,0.00080997,90.30561828
10500,單單,5,557467,0.00080997,90.30642825
10501,唾棄,5,557472,0.00080997,90.30723823
10502,喚,5,557477,0.00080997,90.30804820
10503,圍捕,5,557482,0.00080997,90.30885817
10504,媒體業,5,557487,0.00080997,90.30966814
10505,孳生,5,557492,0.00080997,90.31047811
10506,富邦銀行,5,557497,0.00080997,90.31128808
10507,尊貴,5,557502,0.00080997,90.31209805
10508,尋覓,5,557507,0.00080997,90.31290802
10509,幾乎是,5,557512,0.00080997,90.31371799
10510,彭慕仁,5,557517,0.00080997,90.31452797
10511,復古,5,557522,0.00080997,90.31533794
10512,復興,5,557527,0.00080997,90.31614791
10513,復興北路,5,557532,0.00080997,90.31695788
10514,惠普,5,557537,0.00080997,90.31776785
10515,惱人,5,557542,0.00080997,90.31857782
10516,插曲,5,557547,0.00080997,90.31938779
10517,提起,5,557552,0.00080997,90.32019776
10518,提攜,5,557557,0.00080997,90.32100773
10519,握手,5,557562,0.00080997,90.32181770
10520,揭開,5,557567,0.00080997,90.32262768
10521,換來,5,557572,0.00080997,90.32343765
10522,換算,5,557577,0.00080997,90.32424762
10523,散會,5,557582,0.00080997,90.32505759
10524,斑駁,5,557587,0.00080997,90.32586756
10525,晶圓,5,557592,0.00080997,90.32667753
10526,景況,5,557597,0.00080997,90.32748750
10527,景致,5,557602,0.00080997,90.32829747
10528,智能,5,557607,0.00080997,90.32910744
10529,朝氣,5,557612,0.00080997,90.32991742
10530,棕色,5,557617,0.00080997,90.33072739
10531,椅,5,557622,0.00080997,90.33153736
10532,棲息,5,557627,0.00080997,90.33234733
10533,植,5,557632,0.00080997,90.33315730
10534,棚,5,557637,0.00080997,90.33396727
10535,殘骸物,5,557642,0.00080997,90.33477724
10536,渡海,5,557647,0.00080997,90.33558721
10537,湧入,5,557652,0.00080997,90.33639718
10538,湖濱中學,5,557657,0.00080997,90.33720715
10539,焦距,5,557662,0.00080997,90.33801713
10540,無可奈何,5,557667,0.00080997,90.33882710
10541,無知,5,557672,0.00080997,90.33963707
10542,無限住人,5,557677,0.00080997,90.34044704
10543,無瑕,5,557682,0.00080997,90.34125701
10544,無鉛汽油,5,557687,0.00080997,90.34206698
10545,無誤,5,557692,0.00080997,90.34287695
10546,無論如何,5,557697,0.00080997,90.34368692
10547,牌子,5,557702,0.00080997,90.34449689
10548,牌照,5,557707,0.00080997,90.34530687
10549,猶太人,5,557712,0.00080997,90.34611684
10550,猩猩,5,557717,0.00080997,90.34692681
10551,畫法,5,557722,0.00080997,90.34773678
10552,畫展,5,557727,0.00080997,90.34854675
10553,畫像,5,557732,0.00080997,90.34935672
10554,畫質,5,557737,0.00080997,90.35016669
10555,痘子,5,557742,0.00080997,90.35097666
10556,登上,5,557747,0.00080997,90.35178663
10557,發生率,5,557752,0.00080997,90.35259661
10558,發抖,5,557757,0.00080997,90.35340658
10559,發函,5,557762,0.00080997,90.35421655
10560,發情期,5,557767,0.00080997,90.35502652
10561,發掘,5,557772,0.00080997,90.35583649
10562,發揚光大,5,557777,0.00080997,90.35664646
10563,發酵,5,557782,0.00080997,90.35745643
10564,發燒友,5,557787,0.00080997,90.35826640
10565,盜版,5,557792,0.00080997,90.35907637
10566,短缺,5,557797,0.00080997,90.35988634
10567,稅前淨利,5,557802,0.00080997,90.36069632
10568,稀,5,557807,0.00080997,90.36150629
10569,等到,5,557812,0.00080997,90.36231626
10570,等候,5,557817,0.00080997,90.36312623
10571,筆直,5,557822,0.00080997,90.36393620
10572,結怨,5,557827,0.00080997,90.36474617
10573,結緣,5,557832,0.00080997,90.36555614
10574,絕非,5,557837,0.00080997,90.36636611
10575,紫色,5,557842,0.00080997,90.36717608
10576,絲,5,557847,0.00080997,90.36798606
10577,華特,5,557852,0.00080997,90.36879603
10578,華納,5,557857,0.00080997,90.36960600
10579,華銀,5,557862,0.00080997,90.37041597
10580,華懋廣告,5,557867,0.00080997,90.37122594
10581,著稱,5,557872,0.00080997,90.37203591
10582,街上,5,557877,0.00080997,90.37284588
10583,裁員,5,557882,0.00080997,90.37365585
10584,註定,5,557887,0.00080997,90.37446582
10585,註明,5,557892,0.00080997,90.37527580
10586,評定,5,557897,0.00080997,90.37608577
10587,評審委員,5,557902,0.00080997,90.37689574
10588,詐欺,5,557907,0.00080997,90.37770571
10589,詐領,5,557912,0.00080997,90.37851568
10590,診治,5,557917,0.00080997,90.37932565
10591,貶,5,557922,0.00080997,90.38013562
10592,超收,5,557927,0.00080997,90.38094559
10593,超級市場,5,557932,0.00080997,90.38175556
10594,跌破,5,557937,0.00080997,90.38256553
10595,跌停,5,557942,0.00080997,90.38337551
10596,軸,5,557947,0.00080997,90.38418548
10597,辜成允,5,557952,0.00080997,90.38499545
10598,逮,5,557957,0.00080997,90.38580542
10599,逮獲,5,557962,0.00080997,90.38661539
10600,週日,5,557967,0.00080997,90.38742536
10601,鄉愁,5,557972,0.00080997,90.38823533
10602,鄉親,5,557977,0.00080997,90.38904530
10603,鄉鎮,5,557982,0.00080997,90.38985527
10604,量販店,5,557987,0.00080997,90.39066525
10605,鈑金,5,557992,0.00080997,90.39147522
10606,開門,5,557997,0.00080997,90.39228519
10607,開源節流,5,558002,0.00080997,90.39309516
10608,開槍,5,558007,0.00080997,90.39390513
10609,開銷,5,558012,0.00080997,90.39471510
10610,雄偉,5,558017,0.00080997,90.39552507
10611,集會,5,558022,0.00080997,90.39633504
10612,集體報名,5,558027,0.00080997,90.39714501
10613,順道,5,558032,0.00080997,90.39795499
10614,飲用水,5,558037,0.00080997,90.39876496
10615,飲品,5,558042,0.00080997,90.39957493
10616,黃昆輝,5,558047,0.00080997,90.40038490
10617,黑馬,5,558052,0.00080997,90.40119487
10618,黑幫,5,558057,0.00080997,90.40200484
10619,亂源,5,558062,0.00080997,90.40281481
10620,傳訊,5,558067,0.00080997,90.40362478
10621,傳導,5,558072,0.00080997,90.40443475
10622,傾訴,5,558077,0.00080997,90.40524472
10623,傷心,5,558082,0.00080997,90.40605470
10624,傷腦筋,5,558087,0.00080997,90.40686467
10625,匯兌,5,558092,0.00080997,90.40767464
10626,匯集,5,558097,0.00080997,90.40848461
10627,匯豐銀行,5,558102,0.00080997,90.40929458
10628,嗜,5,558107,0.00080997,90.41010455
10629,圓石,5,558112,0.00080997,90.41091452
10630,塗抹,5,558117,0.00080997,90.41172449
10631,奧迪,5,558122,0.00080997,90.41253446
10632,媽祖,5,558127,0.00080997,90.41334444
10633,微細,5,558132,0.00080997,90.41415441
10634,意外事故,5,558137,0.00080997,90.41496438
10635,意象,5,558142,0.00080997,90.41577435
10636,愛好,5,558147,0.00080997,90.41658432
10637,愛滋病患,5,558152,0.00080997,90.41739429
10638,愛盟,5,558157,0.00080997,90.41820426
10639,搞笑,5,558162,0.00080997,90.41901423
10640,搜,5,558167,0.00080997,90.41982420
10641,搶走,5,558172,0.00080997,90.42063417
10642,搶救,5,558177,0.00080997,90.42144415
10643,搶眼,5,558182,0.00080997,90.42225412
10644,搖身一變,5,558187,0.00080997,90.42306409
10645,搖籃,5,558192,0.00080997,90.42387406
10646,新任,5,558197,0.00080997,90.42468403
10647,新林,5,558202,0.00080997,90.42549400
10648,新郎,5,558207,0.00080997,90.42630397
10649,新喜美,5,558212,0.00080997,90.42711394
10650,新聞界,5,558217,0.00080997,90.42792391
10651,新增,5,558222,0.00080997,90.42873389
10652,新潮,5,558227,0.00080997,90.42954386
10653,業務經理,5,558232,0.00080997,90.43035383
10654,業態,5,558237,0.00080997,90.43116380
10655,極致,5,558242,0.00080997,90.43197377
10656,楊梅鎮,5,558247,0.00080997,90.43278374
10657,煞,5,558252,0.00080997,90.43359371
10658,瑞基特,5,558257,0.00080997,90.43440368
10659,當日,5,558262,0.00080997,90.43521365
10660,當地人,5,558267,0.00080997,90.43602363
10661,當成,5,558272,0.00080997,90.43683360
10662,當做,5,558277,0.00080997,90.43764357
10663,當務之急,5,558282,0.00080997,90.43845354
10664,睪丸,5,558287,0.00080997,90.43926351
10665,碰觸,5,558292,0.00080997,90.44007348
10666,禁,5,558297,0.00080997,90.44088345
10667,萬仁,5,558302,0.00080997,90.44169342
10668,節稅,5,558307,0.00080997,90.44250339
10669,經貿特區,5,558312,0.00080997,90.44331336
10670,經濟學,5,558317,0.00080997,90.44412334
10671,綁架案,5,558322,0.00080997,90.44493331
10672,置放,5,558327,0.00080997,90.44574328
10673,置產,5,558332,0.00080997,90.44655325
10674,義工,5,558337,0.00080997,90.44736322
10675,聖彼得堡,5,558342,0.00080997,90.44817319
10676,聖荷西,5,558347,0.00080997,90.44898316
10677,腸,5,558352,0.00080997,90.44979313
10678,腸子,5,558357,0.00080997,90.45060310
10679,腳背,5,558362,0.00080997,90.45141308
10680,腹地,5,558367,0.00080997,90.45222305
10681,腹股溝,5,558372,0.00080997,90.45303302
10682,腦子,5,558377,0.00080997,90.45384299
10683,落成,5,558382,0.00080997,90.45465296
10684,落差,5,558387,0.00080997,90.45546293
10685,葛斯丹,5,558392,0.00080997,90.45627290
10686,葡萄農,5,558397,0.00080997,90.45708287
10687,董氏基金會,5,558402,0.00080997,90.45789284
10688,裝甲車,5,558407,0.00080997,90.45870282
10689,解放軍,5,558412,0.00080997,90.45951279
10690,解析,5,558417,0.00080997,90.46032276
10691,解約,5,558422,0.00080997,90.46113273
10692,解剖,5,558427,0.00080997,90.46194270
10693,解套,5,558432,0.00080997,90.46275267
10694,詳盡,5,558437,0.00080997,90.46356264
10695,試探,5,558442,0.00080997,90.46437261
10696,試試看,5,558447,0.00080997,90.46518258
10697,詩歌,5,558452,0.00080997,90.46599255
10698,資策會,5,558457,0.00080997,90.46680253
10699,資遣費,5,558462,0.00080997,90.46761250
10700,跡,5,558467,0.00080997,90.46842247
10701,跟著,5,558472,0.00080997,90.46923244
10702,跟隨,5,558477,0.00080997,90.47004241
10703,跨出,5,558482,0.00080997,90.47085238
10704,跨足,5,558487,0.00080997,90.47166235
10705,跨進,5,558492,0.00080997,90.47247232
10706,路上,5,558497,0.00080997,90.47328229
10707,路徑,5,558502,0.00080997,90.47409227
10708,載入,5,558507,0.00080997,90.47490224
10709,農銀,5,558512,0.00080997,90.47571221
10710,運動場,5,558517,0.00080997,90.47652218
10711,運輸車,5,558522,0.00080997,90.47733215
10712,遊艇,5,558527,0.00080997,90.47814212
10713,遊樂,5,558532,0.00080997,90.47895209
10714,遊覽車,5,558537,0.00080997,90.47976206
10715,道歉,5,558542,0.00080997,90.48057203
10716,逼迫,5,558547,0.00080997,90.48138201
10717,遇到,5,558552,0.00080997,90.48219198
10718,過分,5,558557,0.00080997,90.48300195
10719,過往,5,558562,0.00080997,90.48381192
10720,過後,5,558567,0.00080997,90.48462189
10721,過剩,5,558572,0.00080997,90.48543186
10722,遍佈,5,558577,0.00080997,90.48624183
10723,酬勞,5,558582,0.00080997,90.48705180
10724,鉛筆,5,558587,0.00080997,90.48786177
10725,雷克斯,5,558592,0.00080997,90.48867174
10726,雷諾,5,558597,0.00080997,90.48948172
10727,電流,5,558602,0.00080997,90.49029169
10728,電腦動畫,5,558607,0.00080997,90.49110166
10729,電解質,5,558612,0.00080997,90.49191163
10730,電路,5,558617,0.00080997,90.49272160
10731,電路板,5,558622,0.00080997,90.49353157
10732,電磁,5,558627,0.00080997,90.49434154
10733,電線,5,558632,0.00080997,90.49515151
10734,零星,5,558637,0.00080997,90.49596148
10735,預售屋,5,558642,0.00080997,90.49677146
10736,飾板,5,558647,0.00080997,90.49758143
10737,馳騁,5,558652,0.00080997,90.49839140
10738,鼓風機,5,558657,0.00080997,90.49920137
10739,嘉泥公司,5,558662,0.00080997,90.50001134
10740,團費,5,558667,0.00080997,90.50082131
10741,壽司飯,5,558672,0.00080997,90.50163128
10742,夥,5,558677,0.00080997,90.50244125
10743,嫖客,5,558682,0.00080997,90.50325122
10744,實況,5,558687,0.00080997,90.50406119
10745,實績,5,558692,0.00080997,90.50487117
10746,對作,5,558697,0.00080997,90.50568114
10747,對焦,5,558702,0.00080997,90.50649111
10748,對準,5,558707,0.00080997,90.50730108
10749,廖大,5,558712,0.00080997,90.50811105
10750,彰顯,5,558717,0.00080997,90.50892102
10751,慘烈,5,558722,0.00080997,90.50973099
10752,截至,5,558727,0.00080997,90.51054096
10753,撤,5,558732,0.00080997,90.51135093
10754,暢談,5,558737,0.00080997,90.51216091
10755,榮獲,5,558742,0.00080997,90.51297088
10756,構築,5,558747,0.00080997,90.51378085
10757,歌劇院,5,558752,0.00080997,90.51459082
10758,演藝,5,558757,0.00080997,90.51540079
10759,滾滾,5,558762,0.00080997,90.51621076
10760,滴,5,558767,0.00080997,90.51702073
10761,漠,5,558772,0.00080997,90.51783070
10762,漠視,5,558777,0.00080997,90.51864067
10763,漢人,5,558782,0.00080997,90.51945065
10764,滿滿,5,558787,0.00080997,90.52026062
10765,漆,5,558792,0.00080997,90.52107059
10766,漸入佳境,5,558797,0.00080997,90.52188056
10767,漁業,5,558802,0.00080997,90.52269053
10768,熔煉,5,558807,0.00080997,90.52350050
10769,瑣事,5,558812,0.00080997,90.52431047
10770,甄選,5,558817,0.00080997,90.52512044
10771,瘋,5,558822,0.00080997,90.52593041
10772,監理處,5,558827,0.00080997,90.52674038
10773,監獄,5,558832,0.00080997,90.52755036
10774,福本豐,5,558837,0.00080997,90.52836033
10775,福和國中,5,558842,0.00080997,90.52917030
10776,福益,5,558847,0.00080997,90.52998027
10777,稱讚,5,558852,0.00080997,90.53079024
10778,算命,5,558857,0.00080997,90.53160021
10779,精巧,5,558862,0.00080997,90.53241018
10780,精神科,5,558867,0.00080997,90.53322015
10781,綠卡,5,558872,0.00080997,90.53403012
10782,綠堤街,5,558877,0.00080997,90.53484010
10783,網路上癮症,5,558882,0.00080997,90.53565007
10784,聚酯紗,5,558887,0.00080997,90.53646004
10785,腐敗,5,558892,0.00080997,90.53727001
10786,舔,5,558897,0.00080997,90.53807998
10787,蒙恬認識王,5,558902,0.00080997,90.53888995
10788,蒲公英,5,558907,0.00080997,90.53969992
10789,蒸,5,558912,0.00080997,90.54050989
10790,裴瑞斯,5,558917,0.00080997,90.54131986
10791,認出,5,558922,0.00080997,90.54212984
10792,誤會,5,558927,0.00080997,90.54293981
10793,說服力,5,558932,0.00080997,90.54374978
10794,說詞,5,558937,0.00080997,90.54455975
10795,賓得士,5,558942,0.00080997,90.54536972
10796,輔助港,5,558947,0.00080997,90.54617969
10797,輕子,5,558952,0.00080997,90.54698966
10798,輕重,5,558957,0.00080997,90.54779963
10799,遠方,5,558962,0.00080997,90.54860960
10800,遜色,5,558967,0.00080997,90.54941957
10801,酵素,5,558972,0.00080997,90.55022955
10802,酷熱,5,558977,0.00080997,90.55103952
10803,銀行員,5,558982,0.00080997,90.55184949
10804,銀根,5,558987,0.00080997,90.55265946
10805,銅貨,5,558992,0.00080997,90.55346943
10806,銅線,5,558997,0.00080997,90.55427940
10807,銅環,5,559002,0.00080997,90.55508937
10808,閣揆同意權,5,559007,0.00080997,90.55589934
10809,餅,5,559012,0.00080997,90.55670931
10810,餅乾,5,559017,0.00080997,90.55751929
10811,鳳山市,5,559022,0.00080997,90.55832926
10812,儀表控台,5,559027,0.00080997,90.55913923
10813,價碼,5,559032,0.00080997,90.55994920
10814,劇院,5,559037,0.00080997,90.56075917
10815,劉楚明,5,559042,0.00080997,90.56156914
10816,劉曉慶,5,559047,0.00080997,90.56237911
10817,劍,5,559052,0.00080997,90.56318908
10818,嘲諷,5,559057,0.00080997,90.56399905
10819,墳墓,5,559062,0.00080997,90.56480903
10820,層峰,5,559067,0.00080997,90.56561900
10821,廢液,5,559072,0.00080997,90.56642897
10822,廣東,5,559077,0.00080997,90.56723894
10823,廣豐,5,559082,0.00080997,90.56804891
10824,廠長,5,559087,0.00080997,90.56885888
10825,彈奏,5,559092,0.00080997,90.56966885
10826,徵,5,559097,0.00080997,90.57047882
10827,徵求,5,559102,0.00080997,90.57128879
10828,徵象,5,559107,0.00080997,90.57209876
10829,慫恿,5,559112,0.00080997,90.57290874
10830,摩根史坦利指數,5,559117,0.00080997,90.57371871
10831,撲,5,559122,0.00080997,90.57452868
10832,撐傘,5,559127,0.00080997,90.57533865
10833,撫慰,5,559132,0.00080997,90.57614862
10834,敵對,5,559137,0.00080997,90.57695859
10835,暫時性,5,559142,0.00080997,90.57776856
10836,樣式,5,559147,0.00080997,90.57857853
10837,樣品,5,559152,0.00080997,90.57938850
10838,樣樣,5,559157,0.00080997,90.58019848
10839,標準型,5,559162,0.00080997,90.58100845
10840,樓層,5,559167,0.00080997,90.58181842
10841,樓蘭女,5,559172,0.00080997,90.58262839
10842,樊潔兮,5,559177,0.00080997,90.58343836
10843,毅力,5,559182,0.00080997,90.58424833
10844,毅然,5,559187,0.00080997,90.58505830
10845,毆打,5,559192,0.00080997,90.58586827
10846,熱忱,5,559197,0.00080997,90.58667824
10847,熱身賽,5,559202,0.00080997,90.58748821
10848,熱度,5,559207,0.00080997,90.58829819
10849,熱帶,5,559212,0.00080997,90.58910816
10850,熱敷,5,559217,0.00080997,90.58991813
10851,皺,5,559222,0.00080997,90.59072810
10852,確知,5,559227,0.00080997,90.59153807
10853,稽查,5,559232,0.00080997,90.59234804
10854,練錫銘,5,559237,0.00080997,90.59315801
10855,緣份,5,559242,0.00080997,90.59396798
10856,膜,5,559247,0.00080997,90.59477795
10857,蓮,5,559252,0.00080997,90.59558793
10858,蓮花,5,559257,0.00080997,90.59639790
10859,蔣經國,5,559262,0.00080997,90.59720787
10860,蔡仁堅,5,559267,0.00080997,90.59801784
10861,蔡慶源,5,559272,0.00080997,90.59882781
10862,蔡鐘雄,5,559277,0.00080997,90.59963778
10863,衛兵,5,559282,0.00080997,90.60044775
10864,衝勁,5,559287,0.00080997,90.60125772
10865,複製品,5,559292,0.00080997,90.60206769
10866,談不上,5,559297,0.00080997,90.60287767
10867,談吐,5,559302,0.00080997,90.60368764
10868,調味,5,559307,0.00080997,90.60449761
10869,調配,5,559312,0.00080997,90.60530758
10870,調理,5,559317,0.00080997,90.60611755
10871,豬肉,5,559322,0.00080997,90.60692752
10872,豬腳,5,559327,0.00080997,90.60773749
10873,賠錢,5,559332,0.00080997,90.60854746
10874,賤,5,559337,0.00080997,90.60935743
10875,質問,5,559342,0.00080997,90.61016740
10876,踏出,5,559347,0.00080997,90.61097738
10877,踏進,5,559352,0.00080997,90.61178735
10878,輪胎,5,559357,0.00080997,90.61259732
10879,遮,5,559362,0.00080997,90.61340729
10880,遷徙,5,559367,0.00080997,90.61421726
10881,鄭進丁,5,559372,0.00080997,90.61502723
10882,震動,5,559377,0.00080997,90.61583720
10883,養殖,5,559382,0.00080997,90.61664717
10884,養鵝場,5,559387,0.00080997,90.61745714
10885,駐軍,5,559392,0.00080997,90.61826712
10886,駕駛座,5,559397,0.00080997,90.61907709
10887,黎明,5,559402,0.00080997,90.61988706
10888,墨,5,559407,0.00080997,90.62069703
10889,墨西哥,5,559412,0.00080997,90.62150700
10890,凝視,5,559417,0.00080997,90.62231697
10891,噩夢,5,559422,0.00080997,90.62312694
10892,壇,5,559427,0.00080997,90.62393691
10893,奮力,5,559432,0.00080997,90.62474688
10894,學子,5,559437,0.00080997,90.62555686
10895,學會,5,559442,0.00080997,90.62636683
10896,學業,5,559447,0.00080997,90.62717680
10897,導引,5,559452,0.00080997,90.62798677
10898,導管,5,559457,0.00080997,90.62879674
10899,憲兵,5,559462,0.00080997,90.62960671
10900,戰事,5,559467,0.00080997,90.63041668
10901,擁護,5,559472,0.00080997,90.63122665
10902,整齊,5,559477,0.00080997,90.63203662
10903,橙,5,559482,0.00080997,90.63284659
10904,橙色,5,559487,0.00080997,90.63365657
10905,樹立,5,559492,0.00080997,90.63446654
10906,樹枝,5,559497,0.00080997,90.63527651
10907,橄欖油,5,559502,0.00080997,90.63608648
10908,橡膠,5,559507,0.00080997,90.63689645
10909,機能性,5,559512,0.00080997,90.63770642
10910,濃郁,5,559517,0.00080997,90.63851639
10911,濃烈,5,559522,0.00080997,90.63932636
10912,激增,5,559527,0.00080997,90.64013633
10913,燈火,5,559532,0.00080997,90.64094631
10914,燃,5,559537,0.00080997,90.64175628
10915,獨處,5,559542,0.00080997,90.64256625
10916,磨練,5,559547,0.00080997,90.64337622
10917,窺,5,559552,0.00080997,90.64418619
10918,縣黨部,5,559557,0.00080997,90.64499616
10919,臻,5,559562,0.00080997,90.64580613
10920,興高采烈,5,559567,0.00080997,90.64661610
10921,融,5,559572,0.00080997,90.64742607
10922,褲子,5,559577,0.00080997,90.64823604
10923,褫奪公權,5,559582,0.00080997,90.64904602
10924,親吻,5,559587,0.00080997,90.64985599
10925,謀殺,5,559592,0.00080997,90.65066596
10926,貓,5,559597,0.00080997,90.65147593
10927,賴米,5,559602,0.00080997,90.65228590
10928,辦公,5,559607,0.00080997,90.65309587
10929,辦公大樓,5,559612,0.00080997,90.65390584
10930,選單,5,559617,0.00080997,90.65471581
10931,選擇性,5,559622,0.00080997,90.65552578
10932,遼闊,5,559627,0.00080997,90.65633576
10933,遺留,5,559632,0.00080997,90.65714573
10934,鋼筋,5,559637,0.00080997,90.65795570
10935,鋼絲,5,559642,0.00080997,90.65876567
10936,錄影,5,559647,0.00080997,90.65957564
10937,隨身,5,559652,0.00080997,90.66038561
10938,隨意,5,559657,0.00080997,90.66119558
10939,靜音,5,559662,0.00080997,90.66200555
10940,頸子,5,559667,0.00080997,90.66281552
10941,頭疼,5,559672,0.00080997,90.66362550
10942,頭頂,5,559677,0.00080997,90.66443547
10943,餐敘,5,559682,0.00080997,90.66524544
10944,駱駝,5,559687,0.00080997,90.66605541
10945,默默,5,559692,0.00080997,90.66686538
10946,龍隊,5,559697,0.00080997,90.66767535
10947,優待,5,559702,0.00080997,90.66848532
10948,優霸盃,5,559707,0.00080997,90.66929529
10949,壓縮比,5,559712,0.00080997,90.67010526
10950,嬰幼兒,5,559717,0.00080997,90.67091523
10951,應徵,5,559722,0.00080997,90.67172521
10952,戲水,5,559727,0.00080997,90.67253518
10953,戲劇性,5,559732,0.00080997,90.67334515
10954,戲謔,5,559737,0.00080997,90.67415512
10955,曙光,5,559742,0.00080997,90.67496509
10956,檜木,5,559747,0.00080997,90.67577506
10957,營利事業所得稅,5,559752,0.00080997,90.67658503
10958,爵士樂,5,559757,0.00080997,90.67739500
10959,環泥,5,559762,0.00080997,90.67820497
10960,環保團體,5,559767,0.00080997,90.67901495
10961,環節,5,559772,0.00080997,90.67982492
10962,癌,5,559777,0.00080997,90.68063489
10963,糟,5,559782,0.00080997,90.68144486
10964,縮水,5,559787,0.00080997,90.68225483
10965,總書記,5,559792,0.00080997,90.68306480
10966,總數,5,559797,0.00080997,90.68387477
10967,縱向,5,559802,0.00080997,90.68468474
10968,繁瑣,5,559807,0.00080997,90.68549471
10969,翼,5,559812,0.00080997,90.68630469
10970,聲響,5,559817,0.00080997,90.68711466
10971,聯合內閣,5,559822,0.00080997,90.68792463
10972,舉足輕重,5,559827,0.00080997,90.68873460
10973,薪,5,559832,0.00080997,90.68954457
10974,薄弱,5,559837,0.00080997,90.69035454
10975,講求,5,559842,0.00080997,90.69116451
10976,講座,5,559847,0.00080997,90.69197448
10977,謝隆盛,5,559852,0.00080997,90.69278445
10978,謝獻堂,5,559857,0.00080997,90.69359442
10979,趨向,5,559862,0.00080997,90.69440440
10980,轄區,5,559867,0.00080997,90.69521437
10981,還好,5,559872,0.00080997,90.69602434
10982,邀約,5,559877,0.00080997,90.69683431
10983,醜,5,559882,0.00080997,90.69764428
10984,隱約,5,559887,0.00080997,90.69845425
10985,雖是,5,559892,0.00080997,90.69926422
10986,鮮少,5,559897,0.00080997,90.70007419
10987,黏液,5,559902,0.00080997,90.70088416
10988,點滴,5,559907,0.00080997,90.70169414
10989,點頭,5,559912,0.00080997,90.70250411
10990,叢林,5,559917,0.00080997,90.70331408
10991,擴,5,559922,0.00080997,90.70412405
10992,擲,5,559927,0.00080997,90.70493402
10993,櫃檯,5,559932,0.00080997,90.70574399
10994,檸檬,5,559937,0.00080997,90.70655396
10995,歸還,5,559942,0.00080997,90.70736393
10996,歸類,5,559947,0.00080997,90.70817390
10997,瀑布,5,559952,0.00080997,90.70898388
10998,簡潔,5,559957,0.00080997,90.70979385
10999,織品,5,559962,0.00080997,90.71060382
11000,翹,5,559967,0.00080997,90.71141379
11001,藍天,5,559972,0.00080997,90.71222376
11002,轉趨,5,559977,0.00080997,90.71303373
11003,醬料,5,559982,0.00080997,90.71384370
11004,闔,5,559987,0.00080997,90.71465367
11005,闖,5,559992,0.00080997,90.71546364
11006,離職,5,559997,0.00080997,90.71627361
11007,雜,5,560002,0.00080997,90.71708359
11008,雜毛,5,560007,0.00080997,90.71789356
11009,雜音,5,560012,0.00080997,90.71870353
11010,雙子宮,5,560017,0.00080997,90.71951350
11011,雙胞胎,5,560022,0.00080997,90.72032347
11012,雙腳,5,560027,0.00080997,90.72113344
11013,雙腿,5,560032,0.00080997,90.72194341
11014,雙親,5,560037,0.00080997,90.72275338
11015,雙贏,5,560042,0.00080997,90.72356335
11016,雞肉,5,560047,0.00080997,90.72437333
11017,題字,5,560052,0.00080997,90.72518330
11018,懷比藝術聯盟,5,560057,0.00080997,90.72599327
11019,瀕,5,560062,0.00080997,90.72680324
11020,穩定性,5,560067,0.00080997,90.72761321
11021,簽下,5,560072,0.00080997,90.72842318
11022,簽報,5,560077,0.00080997,90.72923315
11023,繪畫主義者,5,560082,0.00080997,90.73004312
11024,羅本立,5,560087,0.00080997,90.73085309
11025,羅茲威爾事件,5,560092,0.00080997,90.73166306
11026,藝術商,5,560097,0.00080997,90.73247304
11027,藥膜面,5,560102,0.00080997,90.73328301
11028,蟻巢,5,560107,0.00080997,90.73409298
11029,識別,5,560112,0.00080997,90.73490295
11030,證書,5,560117,0.00080997,90.73571292
11031,辭去,5,560122,0.00080997,90.73652289
11032,辭呈,5,560127,0.00080997,90.73733286
11033,關頭,5,560132,0.00080997,90.73814283
11034,難關,5,560137,0.00080997,90.73895280
11035,韻,5,560142,0.00080997,90.73976278
11036,韻律舞,5,560147,0.00080997,90.74057275
11037,類固醇,5,560152,0.00080997,90.74138272
11038,騙,5,560157,0.00080997,90.74219269
11039,嚴重性,5,560162,0.00080997,90.74300266
11040,寶島,5,560167,0.00080997,90.74381263
11041,瀰漫,5,560172,0.00080997,90.74462260
11042,癥結,5,560177,0.00080997,90.74543257
11043,競技,5,560182,0.00080997,90.74624254
11044,競賽類,5,560187,0.00080997,90.74705252
11045,蘇文雄,5,560192,0.00080997,90.74786249
11046,蘇俄,5,560197,0.00080997,90.74867246
11047,蘊含,5,560202,0.00080997,90.74948243
11048,警局,5,560207,0.00080997,90.75029240
11049,警報,5,560212,0.00080997,90.75110237
11050,警覺性,5,560217,0.00080997,90.75191234
11051,贏球,5,560222,0.00080997,90.75272231
11052,鐘表,5,560227,0.00080997,90.75353228
11053,騷擾,5,560232,0.00080997,90.75434225
11054,黨工,5,560237,0.00080997,90.75515223
11055,黨政,5,560242,0.00080997,90.75596220
11056,黨章,5,560247,0.00080997,90.75677217
11057,懼,5,560252,0.00080997,90.75758214
11058,攝影工作者,5,560257,0.00080997,90.75839211
11059,攜,5,560262,0.00080997,90.75920208
11060,櫻島,5,560267,0.00080997,90.76001205
11061,欄,5,560272,0.00080997,90.76082202
11062,欄位,5,560277,0.00080997,90.76163199
11063,灌,5,560282,0.00080997,90.76244197
11064,纏鬥,5,560287,0.00080997,90.76325194
11065,蠟燭,5,560292,0.00080997,90.76406191
11066,譴責,5,560297,0.00080997,90.76487188
11067,護,5,560302,0.00080997,90.76568185
11068,護理人員,5,560307,0.00080997,90.76649182
11069,護漁,5,560312,0.00080997,90.76730179
11070,躋身,5,560317,0.00080997,90.76811176
11071,辯論,5,560322,0.00080997,90.76892173
11072,鐵質,5,560327,0.00080997,90.76973171
11073,霸王,5,560332,0.00080997,90.77054168
11074,響起,5,560337,0.00080997,90.77135165
11075,魔頭,5,560342,0.00080997,90.77216162
11076,權證,5,560347,0.00080997,90.77297159
11077,灑,5,560352,0.00080997,90.77378156
11078,聽取,5,560357,0.00080997,90.77459153
11079,聽起來,5,560362,0.00080997,90.77540150
11080,饕客,5,560367,0.00080997,90.77621147
11081,竊盜,5,560372,0.00080997,90.77702144
11082,纖維,5,560377,0.00080997,90.77783142
11083,蘿蔔,5,560382,0.00080997,90.77864139
11084,顯見,5,560387,0.00080997,90.77945136
11085,罐頭,5,560392,0.00080997,90.78026133
11086,鹼性,5,560397,0.00080997,90.78107130
11087,鹽水,5,560402,0.00080997,90.78188127
11088,觀音山,5,560407,0.00080997,90.78269124
11089,觀想,5,560412,0.00080997,90.78350121
11090,觀摩,5,560417,0.00080997,90.78431118
11091,纜車,5,560422,0.00080997,90.78512116
11092,鑽研,5,560427,0.00080997,90.78593113
11093,佼佼者,5,560432,0.00080997,90.78674110
11094,挹注,5,560437,0.00080997,90.78755107
11095,鈀,5,560442,0.00080997,90.78836104
11096,飆漲,5,560447,0.00080997,90.78917101
11097,一大早,4,560451,0.00064798,90.78981899
11098,一干,4,560455,0.00064798,90.79046696
11099,一手,4,560459,0.00064798,90.79111494
11100,一回事,4,560463,0.00064798,90.79176292
11101,一早,4,560467,0.00064798,90.79241090
11102,一系列,4,560471,0.00064798,90.79305887
11103,一剎那,4,560475,0.00064798,90.79370685
11104,一般而言,4,560479,0.00064798,90.79435483
11105,一般來說,4,560483,0.00064798,90.79500280
11106,一般性,4,560487,0.00064798,90.79565078
11107,一開始,4,560491,0.00064798,90.79629876
11108,一塊,4,560495,0.00064798,90.79694673
11109,一環,4,560499,0.00064798,90.79759471
11110,一舉兩得,4,560503,0.00064798,90.79824269
11111,一體成型,4,560507,0.00064798,90.79889066
11112,七大工業國,4,560511,0.00064798,90.79953864
11113,人民黨,4,560515,0.00064798,90.80018662
11114,人生樂,4,560519,0.00064798,90.80083459
11115,人為,4,560523,0.00064798,90.80148257
11116,人腦,4,560527,0.00064798,90.80213055
11117,人道,4,560531,0.00064798,90.80277852
11118,入學,4,560535,0.00064798,90.80342650
11119,八德路,4,560539,0.00064798,90.80407448
11120,力捷,4,560543,0.00064798,90.80472246
11121,力霸,4,560547,0.00064798,90.80537043
11122,十二項建設,4,560551,0.00064798,90.80601841
11123,十全十美,4,560555,0.00064798,90.80666639
11124,三分球,4,560559,0.00064798,90.80731436
11125,三角,4,560563,0.00064798,90.80796234
11126,三重市,4,560567,0.00064798,90.80861032
11127,三振,4,560571,0.00064798,90.80925829
11128,三壘,4,560575,0.00064798,90.80990627
11129,下一步,4,560579,0.00064798,90.81055425
11130,下半身,4,560583,0.00064798,90.81120222
11131,下榻,4,560587,0.00064798,90.81185020
11132,下層,4,560591,0.00064798,90.81249818
11133,上旬,4,560595,0.00064798,90.81314615
11134,上當,4,560599,0.00064798,90.81379413
11135,上載,4,560603,0.00064798,90.81444211
11136,千佛洞,4,560607,0.00064798,90.81509008
11137,千翔保全,4,560611,0.00064798,90.81573806
11138,口水,4,560615,0.00064798,90.81638604
11139,口吻,4,560619,0.00064798,90.81703402
11140,口香糖,4,560623,0.00064798,90.81768199
11141,土石,4,560627,0.00064798,90.81832997
11142,土壤,4,560631,0.00064798,90.81897795
11143,夕,4,560635,0.00064798,90.81962592
11144,夕陽,4,560639,0.00064798,90.82027390
11145,大大小小,4,560643,0.00064798,90.82092188
11146,大同小異,4,560647,0.00064798,90.82156985
11147,大成,4,560651,0.00064798,90.82221783
11148,大老,4,560655,0.00064798,90.82286581
11149,大村灣,4,560659,0.00064798,90.82351378
11150,大抵,4,560663,0.00064798,90.82416176
11151,大東,4,560667,0.00064798,90.82480974
11152,大法官,4,560671,0.00064798,90.82545771
11153,大峽谷,4,560675,0.00064798,90.82610569
11154,大馬,4,560679,0.00064798,90.82675367
11155,大部份,4,560683,0.00064798,90.82740165
11156,大陸劇,4,560687,0.00064798,90.82804962
11157,大麥,4,560691,0.00064798,90.82869760
11158,大跌,4,560695,0.00064798,90.82934558
11159,大道,4,560699,0.00064798,90.82999355
11160,大腿,4,560703,0.00064798,90.83064153
11161,大環境,4,560707,0.00064798,90.83128951
11162,大聲,4,560711,0.00064798,90.83193748
11163,大賽,4,560715,0.00064798,90.83258546
11164,大藏省,4,560719,0.00064798,90.83323344
11165,大鵬灣國家風景區,4,560723,0.00064798,90.83388141
11166,大顯身手,4,560727,0.00064798,90.83452939
11167,大狒狒,4,560731,0.00064798,90.83517737
11168,女王蜂,4,560735,0.00064798,90.83582534
11169,女巫,4,560739,0.00064798,90.83647332
11170,子公司,4,560743,0.00064798,90.83712130
11171,子宮腔,4,560747,0.00064798,90.83776927
11172,子宮頸癌,4,560751,0.00064798,90.83841725
11173,子視窗,4,560755,0.00064798,90.83906523
11174,小吃,4,560759,0.00064798,90.83971321
11175,小行星,4,560763,0.00064798,90.84036118
11176,小島,4,560767,0.00064798,90.84100916
11177,小販,4,560771,0.00064798,90.84165714
11178,小喇叭,4,560775,0.00064798,90.84230511
11179,小腸,4,560779,0.00064798,90.84295309
11180,小澤辰男,4,560783,0.00064798,90.84360107
11181,小覷,4,560787,0.00064798,90.84424904
11182,山地,4,560791,0.00064798,90.84489702
11183,山林,4,560795,0.00064798,90.84554500
11184,山勢,4,560799,0.00064798,90.84619297
11185,山路,4,560803,0.00064798,90.84684095
11186,山道,4,560807,0.00064798,90.84748893
11187,川芎,4,560811,0.00064798,90.84813690
11188,工作量,4,560815,0.00064798,90.84878488
11189,工程人員,4,560819,0.00064798,90.84943286
11190,工程顧問公司,4,560823,0.00064798,90.85008084
11191,工總,4,560827,0.00064798,90.85072881
11192,工讀生,4,560831,0.00064798,90.85137679
11193,己身,4,560835,0.00064798,90.85202477
11194,弓,4,560839,0.00064798,90.85267274
11195,不力,4,560843,0.00064798,90.85332072
11196,不公,4,560847,0.00064798,90.85396870
11197,不方便,4,560851,0.00064798,90.85461667
11198,不可開交,4,560855,0.00064798,90.85526465
11199,不外,4,560859,0.00064798,90.85591263
11200,不平等,4,560863,0.00064798,90.85656060
11201,不全,4,560867,0.00064798,90.85720858
11202,不自然,4,560871,0.00064798,90.85785656
11203,不自覺,4,560875,0.00064798,90.85850453
11204,不似,4,560879,0.00064798,90.85915251
11205,不改,4,560883,0.00064798,90.85980049
11206,不放心,4,560887,0.00064798,90.86044846
11207,不治,4,560891,0.00064798,90.86109644
11208,不保,4,560895,0.00064798,90.86174442
11209,不差,4,560899,0.00064798,90.86239240
11210,不弱,4,560903,0.00064798,90.86304037
11211,不起眼,4,560907,0.00064798,90.86368835
11212,不退,4,560911,0.00064798,90.86433633
11213,不務正業,4,560915,0.00064798,90.86498430
11214,不通,4,560919,0.00064798,90.86563228
11215,不善,4,560923,0.00064798,90.86628026
11216,不義,4,560927,0.00064798,90.86692823
11217,不遜,4,560931,0.00064798,90.86757621
11218,不墜,4,560935,0.00064798,90.86822419
11219,不懈,4,560939,0.00064798,90.86887216
11220,不賴,4,560943,0.00064798,90.86952014
11221,不穩,4,560947,0.00064798,90.87016812
11222,中友百貨,4,560951,0.00064798,90.87081609
11223,中古,4,560955,0.00064798,90.87146407
11224,中古屋,4,560959,0.00064798,90.87211205
11225,中台禪寺,4,560963,0.00064798,90.87276002
11226,中外野,4,560967,0.00064798,90.87340800
11227,中亞,4,560971,0.00064798,90.87405598
11228,中型,4,560975,0.00064798,90.87470396
11229,中度,4,560979,0.00064798,90.87535193
11230,中指,4,560983,0.00064798,90.87599991
11231,中風,4,560987,0.00064798,90.87664789
11232,中國商銀,4,560991,0.00064798,90.87729586
11233,中產階級,4,560995,0.00064798,90.87794384
11234,中途,4,560999,0.00064798,90.87859182
11235,中陰教法,4,561003,0.00064798,90.87923979
11236,中等,4,561007,0.00064798,90.87988777
11237,中廣,4,561011,0.00064798,90.88053575
11238,中繼,4,561015,0.00064798,90.88118372
11239,丰采,4,561019,0.00064798,90.88183170
11240,丹皮,4,561023,0.00064798,90.88247968
11241,五花八門,4,561027,0.00064798,90.88312765
11242,仁愛路,4,561031,0.00064798,90.88377563
11243,元富,4,561035,0.00064798,90.88442361
11244,內分泌,4,561039,0.00064798,90.88507159
11245,內政部長,4,561043,0.00064798,90.88571956
11246,內情,4,561047,0.00064798,90.88636754
11247,內線,4,561051,0.00064798,90.88701552
11248,六角形,4,561055,0.00064798,90.88766349
11249,六輕,4,561059,0.00064798,90.88831147
11250,公子,4,561063,0.00064798,90.88895945
11251,公司法,4,561067,0.00064798,90.88960742
11252,公平會,4,561071,0.00064798,90.89025540
11253,公用程式,4,561075,0.00064798,90.89090338
11254,公共工程委員會,4,561079,0.00064798,90.89155135
11255,公共建設,4,561083,0.00064798,90.89219933
11256,公車專用道,4,561087,0.00064798,90.89284731
11257,公務,4,561091,0.00064798,90.89349528
11258,公眾,4,561095,0.00064798,90.89414326
11259,分化,4,561099,0.00064798,90.89479124
11260,分手,4,561103,0.00064798,90.89543921
11261,分出,4,561107,0.00064798,90.89608719
11262,分局長,4,561111,0.00064798,90.89673517
11263,分泌物,4,561115,0.00064798,90.89738315
11264,分庭抗禮,4,561119,0.00064798,90.89803112
11265,分組,4,561123,0.00064798,90.89867910
11266,勾引,4,561127,0.00064798,90.89932708
11267,勾出,4,561131,0.00064798,90.89997505
11268,化石,4,561135,0.00064798,90.90062303
11269,化妝品,4,561139,0.00064798,90.90127101
11270,升格,4,561143,0.00064798,90.90191898
11271,升遷,4,561147,0.00064798,90.90256696
11272,卅,4,561151,0.00064798,90.90321494
11273,厄運,4,561155,0.00064798,90.90386291
11274,友情,4,561159,0.00064798,90.90451089
11275,友善,4,561163,0.00064798,90.90515887
11276,及早,4,561167,0.00064798,90.90580684
11277,及格,4,561171,0.00064798,90.90645482
11278,反射波,4,561175,0.00064798,90.90710280
11279,反駁,4,561179,0.00064798,90.90775078
11280,反艦,4,561183,0.00064798,90.90839875
11281,天方夜譚,4,561187,0.00064798,90.90904673
11282,天使,4,561191,0.00064798,90.90969471
11283,天時,4,561195,0.00064798,90.91034268
11284,天葬,4,561199,0.00064798,90.91099066
11285,天葬台,4,561203,0.00064798,90.91163864
11286,太大,4,561207,0.00064798,90.91228661
11287,太多,4,561211,0.00064798,90.91293459
11288,太空,4,561215,0.00064798,90.91358257
11289,太空艙商店,4,561219,0.00064798,90.91423054
11290,太電,4,561223,0.00064798,90.91487852
11291,夭折,4,561227,0.00064798,90.91552650
11292,孔,4,561231,0.00064798,90.91617447
11293,尺,4,561235,0.00064798,90.91682245
11294,巴赫,4,561239,0.00064798,90.91747043
11295,幻化,4,561243,0.00064798,90.91811840
11296,引爆,4,561247,0.00064798,90.91876638
11297,心安,4,561251,0.00064798,90.91941436
11298,心血來潮,4,561255,0.00064798,90.92006234
11299,心室,4,561259,0.00064798,90.92071031
11300,心動,4,561263,0.00064798,90.92135829
11301,戶籍,4,561267,0.00064798,90.92200627
11302,手下,4,561271,0.00064798,90.92265424
11303,手掌,4,561275,0.00064798,90.92330222
11304,支氣管炎,4,561279,0.00064798,90.92395020
11305,支配,4,561283,0.00064798,90.92459817
11306,文字檔,4,561287,0.00064798,90.92524615
11307,文宣部,4,561291,0.00064798,90.92589413
11308,方力脩,4,561295,0.00064798,90.92654210
11309,方才,4,561299,0.00064798,90.92719008
11310,方位,4,561303,0.00064798,90.92783806
11311,方芳芳,4,561307,0.00064798,90.92848603
11312,方程式編輯器,4,561311,0.00064798,90.92913401
11313,日本樹蛙,4,561315,0.00064798,90.92978199
11314,日立,4,561319,0.00064798,90.93042997
11315,日程,4,561323,0.00064798,90.93107794
11316,日間,4,561327,0.00064798,90.93172592
11317,日新月異,4,561331,0.00064798,90.93237390
11318,月底,4,561335,0.00064798,90.93302187
11319,月表,4,561339,0.00064798,90.93366985
11320,木柵線,4,561343,0.00064798,90.93431783
11321,木馬,4,561347,0.00064798,90.93496580
11322,木管,4,561351,0.00064798,90.93561378
11323,木箱,4,561355,0.00064798,90.93626176
11324,止跌,4,561359,0.00064798,90.93690973
11325,比方說,4,561363,0.00064798,90.93755771
11326,比起來,4,561367,0.00064798,90.93820569
11327,比對,4,561371,0.00064798,90.93885366
11328,比爾蓋茲,4,561375,0.00064798,90.93950164
11329,比數,4,561379,0.00064798,90.94014962
11330,毛虎,4,561383,0.00064798,90.94079759
11331,水位,4,561387,0.00064798,90.94144557
11332,水深,4,561391,0.00064798,90.94209355
11333,水痘,4,561395,0.00064798,90.94274153
11334,水漲船高,4,561399,0.00064798,90.94338950
11335,水墨畫,4,561403,0.00064798,90.94403748
11336,水龍頭,4,561407,0.00064798,90.94468546
11337,火柴,4,561411,0.00064798,90.94533343
11338,牛仔,4,561415,0.00064798,90.94598141
11339,牛乳,4,561419,0.00064798,90.94662939
11340,王先登,4,561423,0.00064798,90.94727736
11341,王牌威龍,4,561427,0.00064798,90.94792534
11342,王銘源,4,561431,0.00064798,90.94857332
11343,世界性,4,561435,0.00064798,90.94922129
11344,世界貿易組織,4,561439,0.00064798,90.94986927
11345,世華,4,561443,0.00064798,90.95051725
11346,主任秘書,4,561447,0.00064798,90.95116522
11347,主投,4,561451,0.00064798,90.95181320
11348,主攻,4,561455,0.00064798,90.95246118
11349,主治,4,561459,0.00064798,90.95310915
11350,主婦,4,561463,0.00064798,90.95375713
11351,主視窗,4,561467,0.00064798,90.95440511
11352,主嫌,4,561471,0.00064798,90.95505309
11353,主資訊區,4,561475,0.00064798,90.95570106
11354,主廚,4,561479,0.00064798,90.95634904
11355,主編,4,561483,0.00064798,90.95699702
11356,乏,4,561487,0.00064798,90.95764499
11357,以身作則,4,561491,0.00064798,90.95829297
11358,以國,4,561495,0.00064798,90.95894095
11359,代工,4,561499,0.00064798,90.95958892
11360,兄弟象,4,561503,0.00064798,90.96023690
11361,兄弟隊,4,561507,0.00064798,90.96088488
11362,兄長,4,561511,0.00064798,90.96153285
11363,出世,4,561515,0.00064798,90.96218083
11364,出示,4,561519,0.00064798,90.96282881
11365,出名,4,561523,0.00064798,90.96347678
11366,出血,4,561527,0.00064798,90.96412476
11367,出奇,4,561531,0.00064798,90.96477274
11368,出版商,4,561535,0.00064798,90.96542072
11369,出書,4,561539,0.00064798,90.96606869
11370,出海口,4,561543,0.00064798,90.96671667
11371,出清,4,561547,0.00064798,90.96736465
11372,出眾,4,561551,0.00064798,90.96801262
11373,出團,4,561555,0.00064798,90.96866060
11374,出線,4,561559,0.00064798,90.96930858
11375,出賣,4,561563,0.00064798,90.96995655
11376,凸出,4,561567,0.00064798,90.97060453
11377,加持,4,561571,0.00064798,90.97125251
11378,加減,4,561575,0.00064798,90.97190048
11379,加賽,4,561579,0.00064798,90.97254846
11380,功不可沒,4,561583,0.00064798,90.97319644
11381,包皮炎,4,561587,0.00064798,90.97384441
11382,包涵,4,561591,0.00064798,90.97449239
11383,匆匆,4,561595,0.00064798,90.97514037
11384,北投,4,561599,0.00064798,90.97578834
11385,北高航線,4,561603,0.00064798,90.97643632
11386,北歐,4,561607,0.00064798,90.97708430
11387,北邊,4,561611,0.00064798,90.97773228
11388,半成品,4,561615,0.00064798,90.97838025
11389,半原木屋,4,561619,0.00064798,90.97902823
11390,半蹲,4,561623,0.00064798,90.97967621
11391,卡內基,4,561627,0.00064798,90.98032418
11392,可否,4,561631,0.00064798,90.98097216
11393,可見一斑,4,561635,0.00064798,90.98162014
11394,可樂,4,561639,0.00064798,90.98226811
11395,可靠,4,561643,0.00064798,90.98291609
11396,古森斯,4,561647,0.00064798,90.98356407
11397,召,4,561651,0.00064798,90.98421204
11398,叩,4,561655,0.00064798,90.98486002
11399,史東,4,561659,0.00064798,90.98550800
11400,史塔克斯,4,561663,0.00064798,90.98615597
11401,史實,4,561667,0.00064798,90.98680395
11402,台大醫院,4,561671,0.00064798,90.98745193
11403,台北人,4,561675,0.00064798,90.98809991
11404,台北地檢署,4,561679,0.00064798,90.98874788
11405,台港,4,561683,0.00064798,90.98939586
11406,台塑企業,4,561687,0.00064798,90.99004384
11407,台新,4,561691,0.00064798,90.99069181
11408,台銀,4,561695,0.00064798,90.99133979
11409,外力,4,561699,0.00064798,90.99198777
11410,外交部長,4,561703,0.00064798,90.99263574
11411,外島,4,561707,0.00064798,90.99328372
11412,外勤,4,561711,0.00064798,90.99393170
11413,外匯,4,561715,0.00064798,90.99457967
11414,外頭,4,561719,0.00064798,90.99522765
11415,外購,4,561723,0.00064798,90.99587563
11416,失傳,4,561727,0.00064798,90.99652360
11417,尼洛,4,561731,0.00064798,90.99717158
11418,巨型,4,561735,0.00064798,90.99781956
11419,巧合,4,561739,0.00064798,90.99846753
11420,左營,4,561743,0.00064798,90.99911551
11421,市郊,4,561747,0.00064798,90.99976349
11422,布萊斯,4,561751,0.00064798,91.00041147
11423,平方公里,4,561755,0.00064798,91.00105944
11424,平臺,4,561759,0.00064798,91.00170742
11425,必能,4,561763,0.00064798,91.00235540
11426,打通,4,561767,0.00064798,91.00300337
11427,打造,4,561771,0.00064798,91.00365135
11428,打麻將,4,561775,0.00064798,91.00429933
11429,打擊率,4,561779,0.00064798,91.00494730
11430,打聽,4,561783,0.00064798,91.00559528
11431,扒,4,561787,0.00064798,91.00624326
11432,本國,4,561791,0.00064798,91.00689123
11433,本業,4,561795,0.00064798,91.00753921
11434,本覺,4,561799,0.00064798,91.00818719
11435,未免,4,561803,0.00064798,91.00883516
11436,正反,4,561807,0.00064798,91.00948314
11437,正負,4,561811,0.00064798,91.01013112
11438,正軌,4,561815,0.00064798,91.01077909
11439,正常人,4,561819,0.00064798,91.01142707
11440,正統,4,561823,0.00064798,91.01207505
11441,正經,4,561827,0.00064798,91.01272303
11442,母奶,4,561831,0.00064798,91.01337100
11443,母豬,4,561835,0.00064798,91.01401898
11444,母體,4,561839,0.00064798,91.01466696
11445,民生報,4,561843,0.00064798,91.01531493
11446,民航局長,4,561847,0.00064798,91.01596291
11447,民情,4,561851,0.00064798,91.01661089
11448,永和國小,4,561855,0.00064798,91.01725886
11449,永恆,4,561859,0.00064798,91.01790684
11450,永然法律事務所,4,561863,0.00064798,91.01855482
11451,犯案,4,561867,0.00064798,91.01920279
11452,玄,4,561871,0.00064798,91.01985077
11453,玉山,4,561875,0.00064798,91.02049875
11454,玉里鎮,4,561879,0.00064798,91.02114672
11455,甘納,4,561883,0.00064798,91.02179470
11456,生平,4,561887,0.00064798,91.02244268
11457,生前,4,561891,0.00064798,91.02309066
11458,生活圈,4,561895,0.00064798,91.02373863
11459,生起,4,561899,0.00064798,91.02438661
11460,用心良苦,4,561903,0.00064798,91.02503459
11461,用水,4,561907,0.00064798,91.02568256
11462,用車,4,561911,0.00064798,91.02633054
11463,用餐,4,561915,0.00064798,91.02697852
11464,田野,4,561919,0.00064798,91.02762649
11465,田寮河,4,561923,0.00064798,91.02827447
11466,白先勇,4,561927,0.00064798,91.02892245
11467,白板,4,561931,0.00064798,91.02957042
11468,白楊,4,561935,0.00064798,91.03021840
11469,白獅,4,561939,0.00064798,91.03086638
11470,白領樹蛙,4,561943,0.00064798,91.03151435
11471,白頭翁,4,561947,0.00064798,91.03216233
11472,白襪,4,561951,0.00064798,91.03281031
11473,皮毛,4,561955,0.00064798,91.03345828
11474,皮包,4,561959,0.00064798,91.03410626
11475,皮料,4,561963,0.00064798,91.03475424
11476,皮草,4,561967,0.00064798,91.03540222
11477,皮椅,4,561971,0.00064798,91.03605019
11478,皮膚科,4,561975,0.00064798,91.03669817
11479,皮鞋,4,561979,0.00064798,91.03734615
11480,目不暇給,4,561983,0.00064798,91.03799412
11481,目地,4,561987,0.00064798,91.03864210
11482,石化,4,561991,0.00064798,91.03929008
11483,石塊,4,561995,0.00064798,91.03993805
11484,石質,4,561999,0.00064798,91.04058603
11485,立法院長,4,562003,0.00064798,91.04123401
11486,立益,4,562007,0.00064798,91.04188198
11487,交待,4,562011,0.00064798,91.04252996
11488,仿冒,4,562015,0.00064798,91.04317794
11489,伊斯,4,562019,0.00064798,91.04382591
11490,休克,4,562023,0.00064798,91.04447389
11491,休閒鞋,4,562027,0.00064798,91.04512187
11492,休養,4,562031,0.00064798,91.04576985
11493,仰,4,562035,0.00064798,91.04641782
11494,仰角,4,562039,0.00064798,91.04706580
11495,仰賴,4,562043,0.00064798,91.04771378
11496,企盼,4,562047,0.00064798,91.04836175
11497,企研所,4,562051,0.00064798,91.04900973
11498,光華商場,4,562055,0.00064798,91.04965771
11499,光纖電纜,4,562059,0.00064798,91.05030568
11500,兇嫌,4,562063,0.00064798,91.05095366
11501,兆,4,562067,0.00064798,91.05160164
11502,先是,4,562071,0.00064798,91.05224961
11503,全心,4,562075,0.00064798,91.05289759
11504,全方位,4,562079,0.00064798,91.05354557
11505,全省,4,562083,0.00064798,91.05419354
11506,全家,4,562087,0.00064798,91.05484152
11507,全球性,4,562091,0.00064798,91.05548950
11508,全壘打王,4,562095,0.00064798,91.05613747
11509,共同點,4,562099,0.00064798,91.05678545
11510,共和國,4,562103,0.00064798,91.05743343
11511,共商,4,562107,0.00064798,91.05808141
11512,共通點,4,562111,0.00064798,91.05872938
11513,冰塊,4,562115,0.00064798,91.05937736
11514,列管,4,562119,0.00064798,91.06002534
11515,刑,4,562123,0.00064798,91.06067331
11516,刑事,4,562127,0.00064798,91.06132129
11517,印度人,4,562131,0.00064798,91.06196927
11518,危,4,562135,0.00064798,91.06261724
11519,危及,4,562139,0.00064798,91.06326522
11520,吊,4,562143,0.00064798,91.06391320
11521,名門,4,562147,0.00064798,91.06456117
11522,名氣,4,562151,0.00064798,91.06520915
11523,名畫,4,562155,0.00064798,91.06585713
11524,名貴,4,562159,0.00064798,91.06650510
11525,合作社,4,562163,0.00064798,91.06715308
11526,合宜,4,562167,0.00064798,91.06780106
11527,吃重,4,562171,0.00064798,91.06844903
11528,吃驚,4,562175,0.00064798,91.06909701
11529,回檔,4,562179,0.00064798,91.06974499
11530,回籠,4,562183,0.00064798,91.07039297
11531,回贖,4,562187,0.00064798,91.07104094
11532,地政科,4,562191,0.00064798,91.07168892
11533,地域,4,562195,0.00064798,91.07233690
11534,地球村,4,562199,0.00064798,91.07298487
11535,地熱,4,562203,0.00064798,91.07363285
11536,地盤,4,562207,0.00064798,91.07428083
11537,多年,4,562211,0.00064798,91.07492880
11538,多能工,4,562215,0.00064798,91.07557678
11539,夸克,4,562219,0.00064798,91.07622476
11540,妄,4,562223,0.00064798,91.07687273
11541,好用,4,562227,0.00064798,91.07752071
11542,好笑,4,562231,0.00064798,91.07816869
11543,好學,4,562235,0.00064798,91.07881666
11544,字樣,4,562239,0.00064798,91.07946464
11545,存檔,4,562243,0.00064798,91.08011262
11546,存糧,4,562247,0.00064798,91.08076060
11547,安東尼愛德華,4,562251,0.00064798,91.08140857
11548,安檢,4,562255,0.00064798,91.08205655
11549,寺,4,562259,0.00064798,91.08270453
11550,尖,4,562263,0.00064798,91.08335250
11551,年少,4,562267,0.00064798,91.08400048
11552,年老,4,562271,0.00064798,91.08464846
11553,年息,4,562275,0.00064798,91.08529643
11554,式微,4,562279,0.00064798,91.08594441
11555,式樣,4,562283,0.00064798,91.08659239
11556,成交價,4,562287,0.00064798,91.08724036
11557,成年人,4,562291,0.00064798,91.08788834
11558,托,4,562295,0.00064798,91.08853632
11559,收到,4,562299,0.00064798,91.08918429
11560,收納,4,562303,0.00064798,91.08983227
11561,收視率,4,562307,0.00064798,91.09048025
11562,收斂,4,562311,0.00064798,91.09112822
11563,早早,4,562315,0.00064798,91.09177620
11564,早產兒,4,562319,0.00064798,91.09242418
11565,早盤,4,562323,0.00064798,91.09307216
11566,有心人,4,562327,0.00064798,91.09372013
11567,有用,4,562331,0.00064798,91.09436811
11568,有目共睹,4,562335,0.00064798,91.09501609
11569,有恆,4,562339,0.00064798,91.09566406
11570,有益,4,562343,0.00064798,91.09631204
11571,有錢人,4,562347,0.00064798,91.09696002
11572,朱,4,562351,0.00064798,91.09760799
11573,朱延平,4,562355,0.00064798,91.09825597
11574,朱朝亮,4,562359,0.00064798,91.09890395
11575,次日,4,562363,0.00064798,91.09955192
11576,汗顏,4,562367,0.00064798,91.10019990
11577,江八點,4,562371,0.00064798,91.10084788
11578,江核心,4,562375,0.00064798,91.10149585
11579,江湖,4,562379,0.00064798,91.10214383
11580,江蘇,4,562383,0.00064798,91.10279181
11581,汎德,4,562387,0.00064798,91.10343979
11582,灰,4,562391,0.00064798,91.10408776
11583,灰色,4,562395,0.00064798,91.10473574
11584,羽毛球,4,562399,0.00064798,91.10538372
11585,老人會,4,562403,0.00064798,91.10603169
11586,老子,4,562407,0.00064798,91.10667967
11587,老友,4,562411,0.00064798,91.10732765
11588,老年,4,562415,0.00064798,91.10797562
11589,老美,4,562419,0.00064798,91.10862360
11590,老闆娘,4,562423,0.00064798,91.10927158
11591,考生,4,562427,0.00064798,91.10991955
11592,考究,4,562431,0.00064798,91.11056753
11593,考核,4,562435,0.00064798,91.11121551
11594,耳語,4,562439,0.00064798,91.11186348
11595,肉眼,4,562443,0.00064798,91.11251146
11596,肌腱,4,562447,0.00064798,91.11315944
11597,自由車,4,562451,0.00064798,91.11380741
11598,自如,4,562455,0.00064798,91.11445539
11599,自居,4,562459,0.00064798,91.11510337
11600,自拍機,4,562463,0.00064798,91.11575135
11601,自排車,4,562467,0.00064798,91.11639932
11602,自備,4,562471,0.00064798,91.11704730
11603,自圓其說,4,562475,0.00064798,91.11769528
11604,自滿,4,562479,0.00064798,91.11834325
11605,自營,4,562483,0.00064798,91.11899123
11606,色球,4,562487,0.00064798,91.11963921
11607,血本無歸,4,562491,0.00064798,91.12028718
11608,血流,4,562495,0.00064798,91.12093516
11609,血清,4,562499,0.00064798,91.12158314
11610,血壓,4,562503,0.00064798,91.12223111
11611,行水區,4,562507,0.00064798,91.12287909
11612,行李廂蓋,4,562511,0.00064798,91.12352707
11613,行員,4,562515,0.00064798,91.12417504
11614,行頭,4,562519,0.00064798,91.12482302
11615,行蹤,4,562523,0.00064798,91.12547100
11616,衣領,4,562527,0.00064798,91.12611898
11617,衣櫥,4,562531,0.00064798,91.12676695
11618,西北,4,562535,0.00064798,91.12741493
11619,西服,4,562539,0.00064798,91.12806291
11620,西南方,4,562543,0.00064798,91.12871088
11621,西區,4,562547,0.00064798,91.12935886
11622,西裝,4,562551,0.00064798,91.13000684
11623,西德,4,562555,0.00064798,91.13065481
11624,串連,4,562559,0.00064798,91.13130279
11625,位居,4,562563,0.00064798,91.13195077
11626,住房率,4,562567,0.00064798,91.13259874
11627,住房費率,4,562571,0.00064798,91.13324672
11628,住家,4,562575,0.00064798,91.13389470
11629,佛寺,4,562579,0.00064798,91.13454267
11630,何旭初,4,562583,0.00064798,91.13519065
11631,何處,4,562587,0.00064798,91.13583863
11632,何嘗,4,562591,0.00064798,91.13648660
11633,伸展操,4,562595,0.00064798,91.13713458
11634,佔有率,4,562599,0.00064798,91.13778256
11635,作多,4,562603,0.00064798,91.13843054
11636,你愛她,4,562607,0.00064798,91.13907851
11637,伯菲特,4,562611,0.00064798,91.13972649
11638,低估,4,562615,0.00064798,91.14037447
11639,低溫,4,562619,0.00064798,91.14102244
11640,佈告欄,4,562623,0.00064798,91.14167042
11641,克力士,4,562627,0.00064798,91.14231840
11642,克里夫,4,562631,0.00064798,91.14296637
11643,克里斯多福,4,562635,0.00064798,91.14361435
11644,克羅瑪塔,4,562639,0.00064798,91.14426233
11645,冷汗,4,562643,0.00064798,91.14491030
11646,冷落,4,562647,0.00064798,91.14555828
11647,冷戰,4,562651,0.00064798,91.14620626
11648,判處,4,562655,0.00064798,91.14685423
11649,利馬,4,562659,0.00064798,91.14750221
11650,助手,4,562663,0.00064798,91.14815019
11651,呆,4,562667,0.00064798,91.14879816
11652,吳天章,4,562671,0.00064798,91.14944614
11653,吳作棟,4,562675,0.00064798,91.15009412
11654,吳興國,4,562679,0.00064798,91.15074210
11655,吹風機,4,562683,0.00064798,91.15139007
11656,吻戲,4,562687,0.00064798,91.15203805
11657,吸納,4,562691,0.00064798,91.15268603
11658,吶喊,4,562695,0.00064798,91.15333400
11659,含義,4,562699,0.00064798,91.15398198
11660,吟唱,4,562703,0.00064798,91.15462996
11661,坎城影展,4,562707,0.00064798,91.15527793
11662,壯碩,4,562711,0.00064798,91.15592591
11663,妝,4,562715,0.00064798,91.15657389
11664,妙用,4,562719,0.00064798,91.15722186
11665,妥當,4,562723,0.00064798,91.15786984
11666,完投,4,562727,0.00064798,91.15851782
11667,完整性,4,562731,0.00064798,91.15916579
11668,宏觀,4,562735,0.00064798,91.15981377
11669,序曲,4,562739,0.00064798,91.16046175
11670,忘掉,4,562743,0.00064798,91.16110973
11671,忘懷,4,562747,0.00064798,91.16175770
11672,快板,4,562751,0.00064798,91.16240568
11673,快砲,4,562755,0.00064798,91.16305366
11674,戒除,4,562759,0.00064798,91.16370163
11675,抄台,4,562763,0.00064798,91.16434961
11676,抄襲,4,562767,0.00064798,91.16499759
11677,技術人員,4,562771,0.00064798,91.16564556
11678,技術性,4,562775,0.00064798,91.16629354
11679,技術面,4,562779,0.00064798,91.16694152
11680,扭倒,4,562783,0.00064798,91.16758949
11681,找找看,4,562787,0.00064798,91.16823747
11682,投降,4,562791,0.00064798,91.16888545
11683,投票率,4,562795,0.00064798,91.16953342
11684,抑或,4,562799,0.00064798,91.17018140
11685,抑鬱,4,562803,0.00064798,91.17082938
11686,改名,4,562807,0.00064798,91.17147735
11687,改建,4,562811,0.00064798,91.17212533
11688,改採,4,562815,0.00064798,91.17277331
11689,李永然,4,562819,0.00064798,91.17342129
11690,李清河,4,562823,0.00064798,91.17406926
11691,李嘉誠,4,562827,0.00064798,91.17471724
11692,杏仁核,4,562831,0.00064798,91.17536522
11693,杏林,4,562835,0.00064798,91.17601319
11694,村莊,4,562839,0.00064798,91.17666117
11695,杜梅,4,562843,0.00064798,91.17730915
11696,杜紫宸,4,562847,0.00064798,91.17795712
11697,杜福明,4,562851,0.00064798,91.17860510
11698,步伐,4,562855,0.00064798,91.17925308
11699,沙拉,4,562859,0.00064798,91.17990105
11700,沙拉油,4,562863,0.00064798,91.18054903
11701,沙拉醬,4,562867,0.00064798,91.18119701
11702,沙皇,4,562871,0.00064798,91.18184498
11703,沙勒,4,562875,0.00064798,91.18249296
11704,沈迷,4,562879,0.00064798,91.18314094
11705,沈著,4,562883,0.00064798,91.18378892
11706,沈醉,4,562887,0.00064798,91.18443689
11707,沉,4,562891,0.00064798,91.18508487
11708,沉穩,4,562895,0.00064798,91.18573285
11709,決定權,4,562899,0.00064798,91.18638082
11710,沐浴,4,562903,0.00064798,91.18702880
11711,沒入,4,562907,0.00064798,91.18767678
11712,汽車旅館,4,562911,0.00064798,91.18832475
11713,汽缸,4,562915,0.00064798,91.18897273
11714,灶,4,562919,0.00064798,91.18962071
11715,災,4,562923,0.00064798,91.19026868
11716,男朋友,4,562927,0.00064798,91.19091666
11717,私生子,4,562931,0.00064798,91.19156464
11718,系統化,4,562935,0.00064798,91.19221261
11719,谷,4,562939,0.00064798,91.19286059
11720,豆皮,4,562943,0.00064798,91.19350857
11721,貝,4,562947,0.00064798,91.19415654
11722,走豆箍,4,562951,0.00064798,91.19480452
11723,走紅,4,562955,0.00064798,91.19545250
11724,走訪,4,562959,0.00064798,91.19610048
11725,足足,4,562963,0.00064798,91.19674845
11726,身世,4,562967,0.00064798,91.19739643
11727,車長,4,562971,0.00064798,91.19804441
11728,車迷,4,562975,0.00064798,91.19869238
11729,車頂,4,562979,0.00064798,91.19934036
11730,辛勤,4,562983,0.00064798,91.19998834
11731,辛蒂,4,562987,0.00064798,91.20063631
11732,辛辣,4,562991,0.00064798,91.20128429
11733,那裏,4,562995,0.00064798,91.20193227
11734,防水,4,562999,0.00064798,91.20258024
11735,防線,4,563003,0.00064798,91.20322822
11736,阪神,4,563007,0.00064798,91.20387620
11737,事前,4,563011,0.00064798,91.20452417
11738,亞太藝術中心,4,563015,0.00064798,91.20517215
11739,亞伊,4,563019,0.00064798,91.20582013
11740,京崑,4,563023,0.00064798,91.20646810
11741,佯裝,4,563027,0.00064798,91.20711608
11742,依存度,4,563031,0.00064798,91.20776406
11743,依循,4,563035,0.00064798,91.20841204
11744,侍者,4,563039,0.00064798,91.20906001
11745,佳餚,4,563043,0.00064798,91.20970799
11746,使出,4,563047,0.00064798,91.21035597
11747,供養,4,563051,0.00064798,91.21100394
11748,例證,4,563055,0.00064798,91.21165192
11749,來台,4,563059,0.00064798,91.21229990
11750,來生,4,563063,0.00064798,91.21294787
11751,來來去去,4,563067,0.00064798,91.21359585
11752,來來飯店,4,563071,0.00064798,91.21424383
11753,來電,4,563075,0.00064798,91.21489180
11754,併入,4,563079,0.00064798,91.21553978
11755,侏儸紀公園,4,563083,0.00064798,91.21618776
11756,兩者,4,563087,0.00064798,91.21683573
11757,典雅,4,563091,0.00064798,91.21748371
11758,刻不容緩,4,563095,0.00064798,91.21813169
11759,刻印,4,563099,0.00064798,91.21877967
11760,刻劃,4,563103,0.00064798,91.21942764
11761,刺青,4,563107,0.00064798,91.22007562
11762,刺殺,4,563111,0.00064798,91.22072360
11763,刮傷,4,563115,0.00064798,91.22137157
11764,制裁,4,563119,0.00064798,91.22201955
11765,卸除,4,563123,0.00064798,91.22266753
11766,受阻,4,563127,0.00064798,91.22331550
11767,受苦,4,563131,0.00064798,91.22396348
11768,受挫,4,563135,0.00064798,91.22461146
11769,受訪,4,563139,0.00064798,91.22525943
11770,受精卵,4,563143,0.00064798,91.22590741
11771,味覺,4,563147,0.00064798,91.22655539
11772,咖啡館,4,563151,0.00064798,91.22720336
11773,呼叫器,4,563155,0.00064798,91.22785134
11774,呼聲,4,563159,0.00064798,91.22849932
11775,和信鯨,4,563163,0.00064798,91.22914729
11776,和高,4,563167,0.00064798,91.22979527
11777,和睦,4,563171,0.00064798,91.23044325
11778,和解,4,563175,0.00064798,91.23109123
11779,和緩,4,563179,0.00064798,91.23173920
11780,周一,4,563183,0.00064798,91.23238718
11781,周刊,4,563187,0.00064798,91.23303516
11782,周旋,4,563191,0.00064798,91.23368313
11783,周潤發,4,563195,0.00064798,91.23433111
11784,命題,4,563199,0.00064798,91.23497909
11785,奉命,4,563203,0.00064798,91.23562706
11786,奔馳,4,563207,0.00064798,91.23627504
11787,委任,4,563211,0.00064798,91.23692302
11788,委曲,4,563215,0.00064798,91.23757099
11789,委屈,4,563219,0.00064798,91.23821897
11790,委託書,4,563223,0.00064798,91.23886695
11791,姑,4,563227,0.00064798,91.23951492
11792,孟加拉虎,4,563231,0.00064798,91.24016290
11793,定點,4,563235,0.00064798,91.24081088
11794,官警,4,563239,0.00064798,91.24145886
11795,宙斯,4,563243,0.00064798,91.24210683
11796,尚鋒,4,563247,0.00064798,91.24275481
11797,屆滿,4,563251,0.00064798,91.24340279
11798,幸虧,4,563255,0.00064798,91.24405076
11799,府會,4,563259,0.00064798,91.24469874
11800,底部,4,563263,0.00064798,91.24534672
11801,延遲,4,563267,0.00064798,91.24599469
11802,延攬,4,563271,0.00064798,91.24664267
11803,往昔,4,563275,0.00064798,91.24729065
11804,征戰,4,563279,0.00064798,91.24793862
11805,怪異,4,563283,0.00064798,91.24858660
11806,怡仁綜合醫院,4,563287,0.00064798,91.24923458
11807,性命,4,563291,0.00064798,91.24988255
11808,性情,4,563295,0.00064798,91.25053053
11809,性慾,4,563299,0.00064798,91.25117851
11810,性騷擾,4,563303,0.00064798,91.25182648
11811,房次,4,563307,0.00064798,91.25247446
11812,房客,4,563311,0.00064798,91.25312244
11813,房產,4,563315,0.00064798,91.25377042
11814,拉高,4,563319,0.00064798,91.25441839
11815,拒收,4,563323,0.00064798,91.25506637
11816,拒繳,4,563327,0.00064798,91.25571435
11817,招呼,4,563331,0.00064798,91.25636232
11818,招待,4,563335,0.00064798,91.25701030
11819,拙,4,563339,0.00064798,91.25765828
11820,拍出,4,563343,0.00064798,91.25830625
11821,拍賣公司,4,563347,0.00064798,91.25895423
11822,抵消,4,563351,0.00064798,91.25960221
11823,抱住,4,563355,0.00064798,91.26025018
11824,抱負,4,563359,0.00064798,91.26089816
11825,放水,4,563363,0.00064798,91.26154614
11826,放話,4,563367,0.00064798,91.26219411
11827,於事無補,4,563371,0.00064798,91.26284209
11828,昏倒,4,563375,0.00064798,91.26349007
11829,服務人員,4,563379,0.00064798,91.26413804
11830,服從,4,563383,0.00064798,91.26478602
11831,朋,4,563387,0.00064798,91.26543400
11832,東元,4,563391,0.00064798,91.26608198
11833,果真,4,563395,0.00064798,91.26672995
11834,果菜市場,4,563399,0.00064798,91.26737793
11835,枝頭,4,563403,0.00064798,91.26802591
11836,林久子,4,563407,0.00064798,91.26867388
11837,林子寬,4,563411,0.00064798,91.26932186
11838,林百亨,4,563415,0.00064798,91.26996984
11839,林妙如,4,563419,0.00064798,91.27061781
11840,林妙娟,4,563423,0.00064798,91.27126579
11841,林易增,4,563427,0.00064798,91.27191377
11842,林書賢,4,563431,0.00064798,91.27256174
11843,林學正,4,563435,0.00064798,91.27320972
11844,林韻如,4,563439,0.00064798,91.27385770
11845,板橋市,4,563443,0.00064798,91.27450567
11846,松江路,4,563447,0.00064798,91.27515365
11847,欣欣客運,4,563451,0.00064798,91.27580163
11848,欣羨,4,563455,0.00064798,91.27644961
11849,武文杰,4,563459,0.00064798,91.27709758
11850,武功,4,563463,0.00064798,91.27774556
11851,武藝,4,563467,0.00064798,91.27839354
11852,注視,4,563471,0.00064798,91.27904151
11853,波段,4,563475,0.00064798,91.27968949
11854,波斯,4,563479,0.00064798,91.28033747
11855,法力,4,563483,0.00064798,91.28098544
11856,法律服務社,4,563487,0.00064798,91.28163342
11857,油桐,4,563491,0.00064798,91.28228140
11858,油鍋,4,563495,0.00064798,91.28292937
11859,況,4,563499,0.00064798,91.28357735
11860,沿用,4,563503,0.00064798,91.28422533
11861,治療師,4,563507,0.00064798,91.28487330
11862,炎炎,4,563511,0.00064798,91.28552128
11863,炒鍋,4,563515,0.00064798,91.28616926
11864,炙熱,4,563519,0.00064798,91.28681723
11865,爭吵,4,563523,0.00064798,91.28746521
11866,爭執,4,563527,0.00064798,91.28811319
11867,爭辯,4,563531,0.00064798,91.28876117
11868,版畫,4,563535,0.00064798,91.28940914
11869,玫瑰花,4,563539,0.00064798,91.29005712
11870,盲點,4,563543,0.00064798,91.29070510
11871,直言,4,563547,0.00064798,91.29135307
11872,直球,4,563551,0.00064798,91.29200105
11873,直銷,4,563555,0.00064798,91.29264903
11874,直屬,4,563559,0.00064798,91.29329700
11875,知曉,4,563563,0.00064798,91.29394498
11876,知識份子,4,563567,0.00064798,91.29459296
11877,社長,4,563571,0.00064798,91.29524093
11878,空閒,4,563575,0.00064798,91.29588891
11879,空談,4,563579,0.00064798,91.29653689
11880,空頭,4,563583,0.00064798,91.29718486
11881,糾結,4,563587,0.00064798,91.29783284
11882,肺炎,4,563591,0.00064798,91.29848082
11883,股友,4,563595,0.00064798,91.29912880
11884,股友社,4,563599,0.00064798,91.29977677
11885,股價淨值比,4,563603,0.00064798,91.30042475
11886,芹菜,4,563607,0.00064798,91.30107273
11887,花色,4,563611,0.00064798,91.30172070
11888,花車,4,563615,0.00064798,91.30236868
11889,花花綠綠,4,563619,0.00064798,91.30301666
11890,花海,4,563623,0.00064798,91.30366463
11891,花紋,4,563627,0.00064798,91.30431261
11892,花藝,4,563631,0.00064798,91.30496059
11893,初夏,4,563635,0.00064798,91.30560856
11894,表揚,4,563639,0.00064798,91.30625654
11895,表款,4,563643,0.00064798,91.30690452
11896,表象,4,563647,0.00064798,91.30755249
11897,近似,4,563651,0.00064798,91.30820047
11898,邱昇,4,563655,0.00064798,91.30884845
11899,金氏世界紀錄博物館,4,563659,0.00064798,91.30949642
11900,金主,4,563663,0.00064798,91.31014440
11901,金門縣,4,563667,0.00064798,91.31079238
11902,金馬,4,563671,0.00064798,91.31144036
11903,金馬獎,4,563675,0.00064798,91.31208833
11904,金牌,4,563679,0.00064798,91.31273631
11905,金黃色,4,563683,0.00064798,91.31338429
11906,金鼎獎,4,563687,0.00064798,91.31403226
11907,金幣,4,563691,0.00064798,91.31468024
11908,金融產業,4,563695,0.00064798,91.31532822
11909,金屬中心,4,563699,0.00064798,91.31597619
11910,金屬線材成型機,4,563703,0.00064798,91.31662417
11911,金權政治,4,563707,0.00064798,91.31727215
11912,長者,4,563711,0.00064798,91.31792012
11913,長城,4,563715,0.00064798,91.31856810
11914,長紅,4,563719,0.00064798,91.31921608
11915,長笛,4,563723,0.00064798,91.31986405
11916,長途,4,563727,0.00064798,91.32051203
11917,長榮航空,4,563731,0.00064798,91.32116001
11918,長褲,4,563735,0.00064798,91.32180798
11919,長營公司,4,563739,0.00064798,91.32245596
11920,門窗,4,563743,0.00064798,91.32310394
11921,阿布基奎,4,563747,0.00064798,91.32375192
11922,阿富汗,4,563751,0.00064798,91.32439989
11923,阿媽,4,563755,0.00064798,91.32504787
11924,阿諾史瓦辛格,4,563759,0.00064798,91.32569585
11925,阻抗值,4,563763,0.00064798,91.32634382
11926,附著,4,563767,0.00064798,91.32699180
11927,青銅,4,563771,0.00064798,91.32763978
11928,青銅器,4,563775,0.00064798,91.32828775
11929,青澀,4,563779,0.00064798,91.32893573
11930,非洲象,4,563783,0.00064798,91.32958371
11931,非理性,4,563787,0.00064798,91.33023168
11932,亮光,4,563791,0.00064798,91.33087966
11933,亮相,4,563795,0.00064798,91.33152764
11934,信服,4,563799,0.00064798,91.33217561
11935,信封,4,563803,0.00064798,91.33282359
11936,信息,4,563807,0.00064798,91.33347157
11937,信義路,4,563811,0.00064798,91.33411955
11938,侵略,4,563815,0.00064798,91.33476752
11939,侵擾,4,563819,0.00064798,91.33541550
11940,保母,4,563823,0.00064798,91.33606348
11941,保全,4,563827,0.00064798,91.33671145
11942,保住,4,563831,0.00064798,91.33735943
11943,保佑,4,563835,0.00064798,91.33800741
11944,保特瓶,4,563839,0.00064798,91.33865538
11945,保管,4,563843,0.00064798,91.33930336
11946,保險人,4,563847,0.00064798,91.33995134
11947,保險桿,4,563851,0.00064798,91.34059931
11948,保羅,4,563855,0.00064798,91.34124729
11949,俟,4,563859,0.00064798,91.34189527
11950,侮辱,4,563863,0.00064798,91.34254324
11951,俐落,4,563867,0.00064798,91.34319122
11952,前言,4,563871,0.00064798,91.34383920
11953,前所未見,4,563875,0.00064798,91.34448717
11954,前陣子,4,563879,0.00064798,91.34513515
11955,南西,4,563883,0.00064798,91.34578313
11956,南風,4,563887,0.00064798,91.34643111
11957,南迴,4,563891,0.00064798,91.34707908
11958,南迴線,4,563895,0.00064798,91.34772706
11959,南區,4,563899,0.00064798,91.34837504
11960,南管,4,563903,0.00064798,91.34902301
11961,品種,4,563907,0.00064798,91.34967099
11962,品管,4,563911,0.00064798,91.35031897
11963,哈佛大學,4,563915,0.00064798,91.35096694
11964,哈里遜教授,4,563919,0.00064798,91.35161492
11965,哈維爾,4,563923,0.00064798,91.35226290
11966,型號,4,563927,0.00064798,91.35291087
11967,契合,4,563931,0.00064798,91.35355885
11968,奏效,4,563935,0.00064798,91.35420683
11969,姜毅英,4,563939,0.00064798,91.35485480
11970,威,4,563943,0.00064798,91.35550278
11971,宣誓,4,563947,0.00064798,91.35615076
11972,宣導,4,563951,0.00064798,91.35679874
11973,室內樂,4,563955,0.00064798,91.35744671
11974,客源,4,563959,0.00064798,91.35809469
11975,屋頂,4,563963,0.00064798,91.35874267
11976,屋簷,4,563967,0.00064798,91.35939064
11977,度過,4,563971,0.00064798,91.36003862
11978,建國,4,563975,0.00064798,91.36068660
11979,建設性,4,563979,0.00064798,91.36133457
11980,後衛,4,563983,0.00064798,91.36198255
11981,怒,4,563987,0.00064798,91.36263053
11982,急迫,4,563991,0.00064798,91.36327850
11983,怨恨,4,563995,0.00064798,91.36392648
11984,恰,4,563999,0.00064798,91.36457446
11985,恫嚇,4,564003,0.00064798,91.36522243
11986,拜日式,4,564007,0.00064798,91.36587041
11987,挖出,4,564011,0.00064798,91.36651839
11988,挖角,4,564015,0.00064798,91.36716636
11989,持卡人,4,564019,0.00064798,91.36781434
11990,指派,4,564023,0.00064798,91.36846232
11991,指揮部,4,564027,0.00064798,91.36911030
11992,指認,4,564031,0.00064798,91.36975827
11993,指導性,4,564035,0.00064798,91.37040625
11994,拯救,4,564039,0.00064798,91.37105423
11995,括約肌,4,564043,0.00064798,91.37170220
11996,挑出,4,564047,0.00064798,91.37235018
11997,挑高,4,564051,0.00064798,91.37299816
11998,政見,4,564055,0.00064798,91.37364613
11999,政商,4,564059,0.00064798,91.37429411
12000,政經,4,564063,0.00064798,91.37494209
12001,施台生,4,564067,0.00064798,91.37559006
12002,施治明,4,564071,0.00064798,91.37623804
12003,施順利,4,564075,0.00064798,91.37688602
12004,映,4,564079,0.00064798,91.37753399
12005,映入,4,564083,0.00064798,91.37818197
12006,星期一,4,564087,0.00064798,91.37882995
12007,星期五,4,564091,0.00064798,91.37947793
12008,星期六,4,564095,0.00064798,91.38012590
12009,星期日,4,564099,0.00064798,91.38077388
12010,星際大戰,4,564103,0.00064798,91.38142186
12011,染,4,564107,0.00064798,91.38206983
12012,柔情,4,564111,0.00064798,91.38271781
12013,某人,4,564115,0.00064798,91.38336579
12014,某種,4,564119,0.00064798,91.38401376
12015,架勢,4,564123,0.00064798,91.38466174
12016,查塔爾休由克,4,564127,0.00064798,91.38530972
12017,查察,4,564131,0.00064798,91.38595769
12018,查辦,4,564135,0.00064798,91.38660567
12019,柏油,4,564139,0.00064798,91.38725365
12020,柏金斯,4,564143,0.00064798,91.38790162
12021,段落,4,564147,0.00064798,91.38854960
12022,泉源,4,564151,0.00064798,91.38919758
12023,洋基隊,4,564155,0.00064798,91.38984555
12024,洞穴,4,564159,0.00064798,91.39049353
12025,洞悉,4,564163,0.00064798,91.39114151
12026,洗滌,4,564167,0.00064798,91.39178949
12027,活化,4,564171,0.00064798,91.39243746
12028,活塞,4,564175,0.00064798,91.39308544
12029,派遣,4,564179,0.00064798,91.39373342
12030,狠,4,564183,0.00064798,91.39438139
12031,珍珠,4,564187,0.00064798,91.39502937
12032,疤痕,4,564191,0.00064798,91.39567735
12033,盆地,4,564195,0.00064798,91.39632532
12034,省公路局,4,564199,0.00064798,91.39697330
12035,省思,4,564203,0.00064798,91.39762128
12036,省政府,4,564207,0.00064798,91.39826925
12037,相中,4,564211,0.00064798,91.39891723
12038,相近,4,564215,0.00064798,91.39956521
12039,相通,4,564219,0.00064798,91.40021318
12040,相會,4,564223,0.00064798,91.40086116
12041,相像,4,564227,0.00064798,91.40150914
12042,相機,4,564231,0.00064798,91.40215711
12043,眉刷,4,564235,0.00064798,91.40280509
12044,看上,4,564239,0.00064798,91.40345307
12045,看管,4,564243,0.00064798,91.40410105
12046,看護,4,564247,0.00064798,91.40474902
12047,盼,4,564251,0.00064798,91.40539700
12048,盼望,4,564255,0.00064798,91.40604498
12049,研究生,4,564259,0.00064798,91.40669295
12050,研討,4,564263,0.00064798,91.40734093
12051,砍,4,564267,0.00064798,91.40798891
12052,祈福,4,564271,0.00064798,91.40863688
12053,科學班,4,564275,0.00064798,91.40928486
12054,紅海,4,564279,0.00064798,91.40993284
12055,紅綠燈,4,564283,0.00064798,91.41058081
12056,紅衛兵,4,564287,0.00064798,91.41122879
12057,紅襪,4,564291,0.00064798,91.41187677
12058,紅襪隊,4,564295,0.00064798,91.41252474
12059,紀念表,4,564299,0.00064798,91.41317272
12060,紀念碑,4,564303,0.00064798,91.41382070
12061,紀欣,4,564307,0.00064798,91.41446868
12062,約翰,4,564311,0.00064798,91.41511665
12063,約翰走路,4,564315,0.00064798,91.41576463
12064,約翰屈伏塔,4,564319,0.00064798,91.41641261
12065,美不勝收,4,564323,0.00064798,91.41706058
12066,美妙,4,564327,0.00064798,91.41770856
12067,美格科技,4,564331,0.00064798,91.41835654
12068,美術史,4,564335,0.00064798,91.41900451
12069,美語,4,564339,0.00064798,91.41965249
12070,美聯道瓊社,4,564343,0.00064798,91.42030047
12071,耐磨,4,564347,0.00064798,91.42094844
12072,耶,4,564351,0.00064798,91.42159642
12073,耶和華,4,564355,0.00064798,91.42224440
12074,胡椒粉,4,564359,0.00064798,91.42289237
12075,致死,4,564363,0.00064798,91.42354035
12076,致祭,4,564367,0.00064798,91.42418833
12077,致勝,4,564371,0.00064798,91.42483630
12078,致敬,4,564375,0.00064798,91.42548428
12079,范成炬,4,564379,0.00064798,91.42613226
12080,茅寮,4,564383,0.00064798,91.42678024
12081,苦苦,4,564387,0.00064798,91.42742821
12082,苦戰,4,564391,0.00064798,91.42807619
12083,苦頭,4,564395,0.00064798,91.42872417
12084,茄子,4,564399,0.00064798,91.42937214
12085,茂密,4,564403,0.00064798,91.43002012
12086,苗栗市,4,564407,0.00064798,91.43066810
12087,苗栗縣,4,564411,0.00064798,91.43131607
12088,英兩,4,564415,0.00064798,91.43196405
12089,茁壯,4,564419,0.00064798,91.43261203
12090,衍生物,4,564423,0.00064798,91.43326000
12091,計時,4,564427,0.00064798,91.43390798
12092,計謀,4,564431,0.00064798,91.43455596
12093,訂戶,4,564435,0.00064798,91.43520393
12094,訂閱,4,564439,0.00064798,91.43585191
12095,軍閥,4,564443,0.00064798,91.43649989
12096,迪士尼樂園,4,564447,0.00064798,91.43714787
12097,重力,4,564451,0.00064798,91.43779584
12098,重拾,4,564455,0.00064798,91.43844382
12099,重整,4,564459,0.00064798,91.43909180
12100,限度,4,564463,0.00064798,91.43973977
12101,面紗,4,564467,0.00064798,91.44038775
12102,面額,4,564471,0.00064798,91.44103573
12103,革除,4,564475,0.00064798,91.44168370
12104,音詩,4,564479,0.00064798,91.44233168
12105,音樂節,4,564483,0.00064798,91.44297966
12106,風俗,4,564487,0.00064798,91.44362763
12107,風度,4,564491,0.00064798,91.44427561
12108,風扇,4,564495,0.00064798,91.44492359
12109,風景區,4,564499,0.00064798,91.44557156
12110,風範,4,564503,0.00064798,91.44621954
12111,飛天獎,4,564507,0.00064798,91.44686752
12112,飛身,4,564511,0.00064798,91.44751549
12113,飛翔,4,564515,0.00064798,91.44816347
12114,食指,4,564519,0.00064798,91.44881145
12115,首映,4,564523,0.00064798,91.44945943
12116,首相,4,564527,0.00064798,91.45010740
12117,香江,4,564531,0.00064798,91.45075538
12118,香草,4,564535,0.00064798,91.45140336
12119,倖免,4,564539,0.00064798,91.45205133
12120,借款,4,564543,0.00064798,91.45269931
12121,借鏡,4,564547,0.00064798,91.45334729
12122,倚重,4,564551,0.00064798,91.45399526
12123,倒入,4,564555,0.00064798,91.45464324
12124,個位數,4,564559,0.00064798,91.45529122
12125,倘,4,564563,0.00064798,91.45593919
12126,修行者,4,564567,0.00064798,91.45658717
12127,修復,4,564571,0.00064798,91.45723515
12128,修補,4,564575,0.00064798,91.45788312
12129,倫敦大學,4,564579,0.00064798,91.45853110
12130,冥想,4,564583,0.00064798,91.45917908
12131,凍結,4,564587,0.00064798,91.45982705
12132,剖開,4,564591,0.00064798,91.46047503
12133,剝,4,564595,0.00064798,91.46112301
12134,原文,4,564599,0.00064798,91.46177099
12135,原定,4,564603,0.00064798,91.46241896
12136,原貌,4,564607,0.00064798,91.46306694
12137,哩程,4,564611,0.00064798,91.46371492
12138,唇刷,4,564615,0.00064798,91.46436289
12139,唇周,4,564619,0.00064798,91.46501087
12140,唇膏,4,564623,0.00064798,91.46565885
12141,埋葬,4,564627,0.00064798,91.46630682
12142,套件,4,564631,0.00064798,91.46695480
12143,宰殺,4,564635,0.00064798,91.46760278
12144,家用,4,564639,0.00064798,91.46825075
12145,家門,4,564643,0.00064798,91.46889873
12146,家喻戶曉,4,564647,0.00064798,91.46954671
12147,家園,4,564651,0.00064798,91.47019468
12148,家境,4,564655,0.00064798,91.47084266
12149,展覽會,4,564659,0.00064798,91.47149064
12150,峽谷,4,564663,0.00064798,91.47213862
12151,峰,4,564667,0.00064798,91.47278659
12152,峰安,4,564671,0.00064798,91.47343457
12153,差勁,4,564675,0.00064798,91.47408255
12154,席次,4,564679,0.00064798,91.47473052
12155,師資,4,564683,0.00064798,91.47537850
12156,徐生明,4,564687,0.00064798,91.47602648
12157,徐成焜,4,564691,0.00064798,91.47667445
12158,徐勝樹,4,564695,0.00064798,91.47732243
12159,恣意,4,564699,0.00064798,91.47797041
12160,恥辱,4,564703,0.00064798,91.47861838
12161,拳,4,564707,0.00064798,91.47926636
12162,拳擊,4,564711,0.00064798,91.47991434
12163,拿捏,4,564715,0.00064798,91.48056231
12164,捕捉卡,4,564719,0.00064798,91.48121029
12165,捆綁,4,564723,0.00064798,91.48185827
12166,捉住,4,564727,0.00064798,91.48250624
12167,挽,4,564731,0.00064798,91.48315422
12168,挪用,4,564735,0.00064798,91.48380220
12169,挫,4,564739,0.00064798,91.48445018
12170,效能表,4,564743,0.00064798,91.48509815
12171,旅途,4,564747,0.00064798,91.48574613
12172,旅館業,4,564751,0.00064798,91.48639411
12173,時速,4,564755,0.00064798,91.48704208
12174,時程,4,564759,0.00064798,91.48769006
12175,時勢,4,564763,0.00064798,91.48833804
12176,晃動,4,564767,0.00064798,91.48898601
12177,書包,4,564771,0.00064798,91.48963399
12178,書寫,4,564775,0.00064798,91.49028197
12179,案發,4,564779,0.00064798,91.49092994
12180,根部,4,564783,0.00064798,91.49157792
12181,梳粧��,4,564787,0.00064798,91.49222590
12182,桌椅,4,564791,0.00064798,91.49287387
12183,栽種,4,564795,0.00064798,91.49352185
12184,柴可夫斯基,4,564799,0.00064798,91.49416983
12185,殷切,4,564803,0.00064798,91.49481781
12186,殷勤,4,564807,0.00064798,91.49546578
12187,氣味,4,564811,0.00064798,91.49611376
12188,氣泡,4,564815,0.00064798,91.49676174
12189,氣體,4,564819,0.00064798,91.49740971
12190,氧氣,4,564823,0.00064798,91.49805769
12191,消沉,4,564827,0.00064798,91.49870567
12192,消弭,4,564831,0.00064798,91.49935364
12193,消息面,4,564835,0.00064798,91.50000162
12194,消售,4,564839,0.00064798,91.50064960
12195,消基會,4,564843,0.00064798,91.50129757
12196,消極,4,564847,0.00064798,91.50194555
12197,海岸線,4,564851,0.00064798,91.50259353
12198,海風,4,564855,0.00064798,91.50324150
12199,海倫,4,564859,0.00064798,91.50388948
12200,海峽兩岸,4,564863,0.00064798,91.50453746
12201,海帶,4,564867,0.00064798,91.50518543
12202,海德格,4,564871,0.00064798,91.50583341
12203,涉嫌人,4,564875,0.00064798,91.50648139
12204,浮游,4,564879,0.00064798,91.50712937
12205,浮雕,4,564883,0.00064798,91.50777734
12206,浩大,4,564887,0.00064798,91.50842532
12207,浩劫,4,564891,0.00064798,91.50907330
12208,烘烤,4,564895,0.00064798,91.50972127
12209,特技,4,564899,0.00064798,91.51036925
12210,特約,4,564903,0.00064798,91.51101723
12211,特級,4,564907,0.00064798,91.51166520
12212,特製,4,564911,0.00064798,91.51231318
12213,特寫,4,564915,0.00064798,91.51296116
12214,狹隘,4,564919,0.00064798,91.51360913
12215,班底,4,564923,0.00064798,91.51425711
12216,留念,4,564927,0.00064798,91.51490509
12217,疾,4,564931,0.00064798,91.51555306
12218,病因,4,564935,0.00064798,91.51620104
12219,病狀,4,564939,0.00064798,91.51684902
12220,病患者,4,564943,0.00064798,91.51749699
12221,益智,4,564947,0.00064798,91.51814497
12222,真切,4,564951,0.00064798,91.51879295
12223,真假,4,564955,0.00064798,91.51944093
12224,真愛一生,4,564959,0.00064798,91.52008890
12225,真義,4,564963,0.00064798,91.52073688
12226,真跡,4,564967,0.00064798,91.52138486
12227,真龍殿,4,564971,0.00064798,91.52203283
12228,破口大罵,4,564975,0.00064798,91.52268081
12229,破案,4,564979,0.00064798,91.52332879
12230,破裂,4,564983,0.00064798,91.52397676
12231,破碎,4,564987,0.00064798,91.52462474
12232,破解,4,564991,0.00064798,91.52527272
12233,祖,4,564995,0.00064798,91.52592069
12234,祖父,4,564999,0.00064798,91.52656867
12235,祖國,4,565003,0.00064798,91.52721665
12236,祖產,4,565007,0.00064798,91.52786462
12237,神明,4,565011,0.00064798,91.52851260
12238,神通,4,565015,0.00064798,91.52916058
12239,神廟,4,565019,0.00064798,91.52980856
12240,秤,4,565023,0.00064798,91.53045653
12241,粉紅色,4,565027,0.00064798,91.53110451
12242,粉質,4,565031,0.00064798,91.53175249
12243,紡纖股,4,565035,0.00064798,91.53240046
12244,紊亂,4,565039,0.00064798,91.53304844
12245,純正,4,565043,0.00064798,91.53369642
12246,紐頓,4,565047,0.00064798,91.53434439
12247,紙條,4,565051,0.00064798,91.53499237
12248,紙幣,4,565055,0.00064798,91.53564035
12249,翅膀,4,565059,0.00064798,91.53628832
12250,翁,4,565063,0.00064798,91.53693630
12251,脂肪酸,4,565067,0.00064798,91.53758428
12252,胸口,4,565071,0.00064798,91.53823225
12253,臭味,4,565075,0.00064798,91.53888023
12254,航太工業,4,565079,0.00064798,91.53952821
12255,航商,4,565083,0.00064798,91.54017618
12256,航發中心,4,565087,0.00064798,91.54082416
12257,航廈,4,565091,0.00064798,91.54147214
12258,航艦,4,565095,0.00064798,91.54212012
12259,荒涼,4,565099,0.00064798,91.54276809
12260,草叢,4,565103,0.00064798,91.54341607
12261,茵,4,565107,0.00064798,91.54406405
12262,討厭,4,565111,0.00064798,91.54471202
12263,討論群,4,565115,0.00064798,91.54536000
12264,訊軌,4,565119,0.00064798,91.54600798
12265,財源,4,565123,0.00064798,91.54665595
12266,起身,4,565127,0.00064798,91.54730393
12267,起初,4,565131,0.00064798,91.54795191
12268,起家,4,565135,0.00064798,91.54859988
12269,起舞,4,565139,0.00064798,91.54924786
12270,送出,4,565143,0.00064798,91.54989584
12271,逆,4,565147,0.00064798,91.55054381
12272,迷惑,4,565151,0.00064798,91.55119179
12273,退燒藥,4,565155,0.00064798,91.55183977
12274,迴避,4,565159,0.00064798,91.55248775
12275,迴轉,4,565163,0.00064798,91.55313572
12276,逃生,4,565167,0.00064798,91.55378370
12277,逃稅,4,565171,0.00064798,91.55443168
12278,逃竄,4,565175,0.00064798,91.55507965
12279,追價,4,565179,0.00064798,91.55572763
12280,追緝,4,565183,0.00064798,91.55637561
12281,酒館,4,565187,0.00064798,91.55702358
12282,配上,4,565191,0.00064798,91.55767156
12283,配股,4,565195,0.00064798,91.55831954
12284,酌量,4,565199,0.00064798,91.55896751
12285,閃閃,4,565203,0.00064798,91.55961549
12286,閃電,4,565207,0.00064798,91.56026347
12287,院子,4,565211,0.00064798,91.56091144
12288,陣陣,4,565215,0.00064798,91.56155942
12289,除舊布新,4,565219,0.00064798,91.56220740
12290,馬公,4,565223,0.00064798,91.56285537
12291,馬尼拉,4,565227,0.00064798,91.56350335
12292,馬克斯,4,565231,0.00064798,91.56415133
12293,馬兒,4,565235,0.00064798,91.56479931
12294,馬達,4,565239,0.00064798,91.56544728
12295,骨盆,4,565243,0.00064798,91.56609526
12296,骨盆腔,4,565247,0.00064798,91.56674324
12297,骨科,4,565251,0.00064798,91.56739121
12298,高人,4,565255,0.00064798,91.56803919
12299,高尚,4,565259,0.00064798,91.56868717
12300,高原,4,565263,0.00064798,91.56933514
12301,高高,4,565267,0.00064798,91.56998312
12302,高速鋼,4,565271,0.00064798,91.57063110
12303,高湯,4,565275,0.00064798,91.57127907
12304,高雅,4,565279,0.00064798,91.57192705
12305,高雄市政府,4,565283,0.00064798,91.57257503
12306,高雄地院,4,565287,0.00064798,91.57322300
12307,高爾,4,565291,0.00064798,91.57387098
12308,高薪,4,565295,0.00064798,91.57451896
12309,鬥志,4,565299,0.00064798,91.57516694
12310,乾杯,4,565303,0.00064798,91.57581491
12311,停業,4,565307,0.00064798,91.57646289
12312,假冒,4,565311,0.00064798,91.57711087
12313,做多,4,565315,0.00064798,91.57775884
12314,做好,4,565319,0.00064798,91.57840682
12315,健身,4,565323,0.00064798,91.57905480
12316,健身房,4,565327,0.00064798,91.57970277
12317,健保,4,565331,0.00064798,91.58035075
12318,側目,4,565335,0.00064798,91.58099873
12319,側面,4,565339,0.00064798,91.58164670
12320,偏愛,4,565343,0.00064798,91.58229468
12321,副召集人,4,565347,0.00064798,91.58294266
12322,副局長,4,565351,0.00064798,91.58359063
12323,副秘書長,4,565355,0.00064798,91.58423861
12324,副總,4,565359,0.00064798,91.58488659
12325,動動,4,565363,0.00064798,91.58553456
12326,動彈不得,4,565367,0.00064798,91.58618254
12327,動聽,4,565371,0.00064798,91.58683052
12328,參閱,4,565375,0.00064798,91.58747850
12329,參選人,4,565379,0.00064798,91.58812647
12330,參議員,4,565383,0.00064798,91.58877445
12331,商業司,4,565387,0.00064798,91.58942243
12332,問卷,4,565391,0.00064798,91.59007040
12333,問候,4,565395,0.00064798,91.59071838
12334,唯美,4,565399,0.00064798,91.59136636
12335,唯獨,4,565403,0.00064798,91.59201433
12336,售後服務,4,565407,0.00064798,91.59266231
12337,圈答,4,565411,0.00064798,91.59331029
12338,國大黨團,4,565415,0.00064798,91.59395826
12339,國大護土委員會,4,565419,0.00064798,91.59460624
12340,國手,4,565423,0.00064798,91.59525422
12341,國建,4,565427,0.00064798,91.59590219
12342,國界,4,565431,0.00064798,91.59655017
12343,國家劇院,4,565435,0.00064798,91.59719815
12344,國庫券,4,565439,0.00064798,91.59784612
12345,國情報告,4,565443,0.00064798,91.59849410
12346,國貿局,4,565447,0.00064798,91.59914208
12347,國聖里,4,565451,0.00064798,91.59979006
12348,堅守,4,565455,0.00064798,91.60043803
12349,堅信,4,565459,0.00064798,91.60108601
12350,堅實,4,565463,0.00064798,91.60173399
12351,堆放,4,565467,0.00064798,91.60238196
12352,基廷,4,565471,0.00064798,91.60302994
12353,基隆市,4,565475,0.00064798,91.60367792
12354,基隆港,4,565479,0.00064798,91.60432589
12355,基調,4,565483,0.00064798,91.60497387
12356,執導,4,565487,0.00064798,91.60562185
12357,婦科,4,565491,0.00064798,91.60626982
12358,寄來,4,565495,0.00064798,91.60691780
12359,寄宿,4,565499,0.00064798,91.60756578
12360,宿,4,565503,0.00064798,91.60821375
12361,專長,4,565507,0.00064798,91.60886173
12362,專員,4,565511,0.00064798,91.60950971
12363,專程,4,565515,0.00064798,91.61015769
12364,專業化,4,565519,0.00064798,91.61080566
12365,專號,4,565523,0.00064798,91.61145364
12366,常務,4,565527,0.00064798,91.61210162
12367,常態,4,565531,0.00064798,91.61274959
12368,帶原者,4,565535,0.00064798,91.61339757
12369,帶進,4,565539,0.00064798,91.61404555
12370,帳冊,4,565543,0.00064798,91.61469352
12371,帳棚,4,565547,0.00064798,91.61534150
12372,康,4,565551,0.00064798,91.61598948
12373,康定級巡防艦,4,565555,0.00064798,91.61663745
12374,康雷,4,565559,0.00064798,91.61728543
12375,張永昌,4,565563,0.00064798,91.61793341
12376,張芳俊,4,565567,0.00064798,91.61858138
12377,張聲鎮,4,565571,0.00064798,91.61922936
12378,張鈺,4,565575,0.00064798,91.61987734
12379,強權,4,565579,0.00064798,91.62052531
12380,得不償失,4,565583,0.00064798,91.62117329
12381,得天獨厚,4,565587,0.00064798,91.62182127
12382,得手,4,565591,0.00064798,91.62246925
12383,得逞,4,565595,0.00064798,91.62311722
12384,得罪,4,565599,0.00064798,91.62376520
12385,從政,4,565603,0.00064798,91.62441318
12386,徠卡,4,565607,0.00064798,91.62506115
12387,悠揚,4,565611,0.00064798,91.62570913
12388,情有獨鍾,4,565615,0.00064798,91.62635711
12389,情歌,4,565619,0.00064798,91.62700508
12390,情緒性,4,565623,0.00064798,91.62765306
12391,情緒智力,4,565627,0.00064798,91.62830104
12392,情慾,4,565631,0.00064798,91.62894901
12393,惟覺,4,565635,0.00064798,91.62959699
12394,控制元件,4,565639,0.00064798,91.63024497
12395,捲入,4,565643,0.00064798,91.63089294
12396,探望,4,565647,0.00064798,91.63154092
12397,探訪,4,565651,0.00064798,91.63218890
12398,接眼部,4,565655,0.00064798,91.63283688
12399,接單,4,565659,0.00064798,91.63348485
12400,接替,4,565663,0.00064798,91.63413283
12401,接棒,4,565667,0.00064798,91.63478081
12402,掩埋,4,565671,0.00064798,91.63542878
12403,掩護,4,565675,0.00064798,91.63607676
12404,掉入,4,565679,0.00064798,91.63672474
12405,掃描,4,565683,0.00064798,91.63737271
12406,掃黑,4,565687,0.00064798,91.63802069
12407,掛帥,4,565691,0.00064798,91.63866867
12408,推荐,4,565695,0.00064798,91.63931664
12409,推進,4,565699,0.00064798,91.63996462
12410,推敲,4,565703,0.00064798,91.64061260
12411,推選,4,565707,0.00064798,91.64126057
12412,採撿,4,565711,0.00064798,91.64190855
12413,排水系統,4,565715,0.00064798,91.64255653
12414,排氣量,4,565719,0.00064798,91.64320450
12415,排線,4,565723,0.00064798,91.64385248
12416,掏出,4,565727,0.00064798,91.64450046
12417,教條,4,565731,0.00064798,91.64514844
12418,敘,4,565735,0.00064798,91.64579641
12419,晚清,4,565739,0.00064798,91.64644439
12420,晤談,4,565743,0.00064798,91.64709237
12421,梁岱琦,4,565747,0.00064798,91.64774034
12422,梅子,4,565751,0.00064798,91.64838832
12423,梅林,4,565755,0.00064798,91.64903630
12424,梅爾,4,565759,0.00064798,91.64968427
12425,殺害,4,565763,0.00064798,91.65033225
12426,殺掉,4,565767,0.00064798,91.65098023
12427,液體,4,565771,0.00064798,91.65162820
12428,淡水河,4,565775,0.00064798,91.65227618
12429,淡薄,4,565779,0.00064798,91.65292416
12430,清白,4,565783,0.00064798,91.65357213
12431,清苦,4,565787,0.00064798,91.65422011
12432,淋漓盡致,4,565791,0.00064798,91.65486809
12433,淑蘭,4,565795,0.00064798,91.65551606
12434,淹,4,565799,0.00064798,91.65616404
12435,深色,4,565803,0.00064798,91.65681202
12436,深層,4,565807,0.00064798,91.65746000
12437,牽引,4,565811,0.00064798,91.65810797
12438,牽扯,4,565815,0.00064798,91.65875595
12439,球速,4,565819,0.00064798,91.65940393
12440,理智,4,565823,0.00064798,91.66005190
12441,理會,4,565827,0.00064798,91.66069988
12442,理察．史特勞斯,4,565831,0.00064798,91.66134786
12443,理監事,4,565835,0.00064798,91.66199583
12444,現有,4,565839,0.00064798,91.66264381
12445,現鈔,4,565843,0.00064798,91.66329179
12446,甜美,4,565847,0.00064798,91.66393976
12447,產婦,4,565851,0.00064798,91.66458774
12448,產業工會,4,565855,0.00064798,91.66523572
12449,產檢,4,565859,0.00064798,91.66588369
12450,略微,4,565863,0.00064798,91.66653167
12451,異味,4,565867,0.00064798,91.66717965
12452,異軍突起,4,565871,0.00064798,91.66782763
12453,異議,4,565875,0.00064798,91.66847560
12454,疏鬆,4,565879,0.00064798,91.66912358
12455,痊癒,4,565883,0.00064798,91.66977156
12456,盒,4,565887,0.00064798,91.67041953
12457,盒子,4,565891,0.00064798,91.67106751
12458,盛情,4,565895,0.00064798,91.67171549
12459,眷屬,4,565899,0.00064798,91.67236346
12460,眼中,4,565903,0.00064798,91.67301144
12461,眼眶,4,565907,0.00064798,91.67365942
12462,眼線筆,4,565911,0.00064798,91.67430739
12463,眼霜,4,565915,0.00064798,91.67495537
12464,祥和,4,565919,0.00064798,91.67560335
12465,票價,4,565923,0.00064798,91.67625132
12466,移交,4,565927,0.00064798,91.67689930
12467,第一季,4,565931,0.00064798,91.67754728
12468,第二次世界大戰,4,565935,0.00064798,91.67819525
12469,統治者,4,565939,0.00064798,91.67884323
12470,統籌,4,565943,0.00064798,91.67949121
12471,紮實,4,565947,0.00064798,91.68013919
12472,紹興酒,4,565951,0.00064798,91.68078716
12473,細長,4,565955,0.00064798,91.68143514
12474,細細,4,565959,0.00064798,91.68208312
12475,細部,4,565963,0.00064798,91.68273109
12476,組員,4,565967,0.00064798,91.68337907
12477,羞,4,565971,0.00064798,91.68402705
12478,羞辱,4,565975,0.00064798,91.68467502
12479,翌,4,565979,0.00064798,91.68532300
12480,翌日,4,565983,0.00064798,91.68597098
12481,聆賞,4,565987,0.00064798,91.68661895
12482,脫胎換骨,4,565991,0.00064798,91.68726693
12483,脫穎,4,565995,0.00064798,91.68791491
12484,船艦,4,565999,0.00064798,91.68856288
12485,莎士比亞,4,566003,0.00064798,91.68921086
12486,莫名其妙,4,566007,0.00064798,91.68985884
12487,荷田,4,566011,0.00064798,91.69050682
12488,處女作,4,566015,0.00064798,91.69115479
12489,處世,4,566019,0.00064798,91.69180277
12490,規章,4,566023,0.00064798,91.69245075
12491,訪問團,4,566027,0.00064798,91.69309872
12492,許宗力,4,566031,0.00064798,91.69374670
12493,許許多多,4,566035,0.00064798,91.69439468
12494,設籍,4,566039,0.00064798,91.69504265
12495,責怪,4,566043,0.00064798,91.69569063
12496,貨源,4,566047,0.00064798,91.69633861
12497,貪婪,4,566051,0.00064798,91.69698658
12498,貧,4,566055,0.00064798,91.69763456
12499,貧血,4,566059,0.00064798,91.69828254
12500,軟硬體,4,566063,0.00064798,91.69893051
12501,這項,4,566067,0.00064798,91.69957849
12502,逍遙,4,566071,0.00064798,91.70022647
12503,通古斯加,4,566075,0.00064798,91.70087444
12504,通訊錄,4,566079,0.00064798,91.70152242
12505,通貨膨脹率,4,566083,0.00064798,91.70217040
12506,通暢,4,566087,0.00064798,91.70281838
12507,通緝犯,4,566091,0.00064798,91.70346635
12508,通膨,4,566095,0.00064798,91.70411433
12509,連上,4,566099,0.00064798,91.70476231
12510,連綿,4,566103,0.00064798,91.70541028
12511,連鎖書店,4,566107,0.00064798,91.70605826
12512,速食,4,566111,0.00064798,91.70670624
12513,逝世,4,566115,0.00064798,91.70735421
12514,透光,4,566119,0.00064798,91.70800219
12515,逛逛,4,566123,0.00064798,91.70865017
12516,途中,4,566127,0.00064798,91.70929814
12517,部長級,4,566131,0.00064798,91.70994612
12518,部編本,4,566135,0.00064798,91.71059410
12519,郭邦道,4,566139,0.00064798,91.71124207
12520,郭為藩,4,566143,0.00064798,91.71189005
12521,都有,4,566147,0.00064798,91.71253803
12522,都會區,4,566151,0.00064798,91.71318600
12523,野心,4,566155,0.00064798,91.71383398
12524,閉幕,4,566159,0.00064798,91.71448196
12525,陳由豪,4,566163,0.00064798,91.71512994
12526,陳志揚,4,566167,0.00064798,91.71577791
12527,陳定川,4,566171,0.00064798,91.71642589
12528,陳金讓,4,566175,0.00064798,91.71707387
12529,陳家林,4,566179,0.00064798,91.71772184
12530,陳淑貞,4,566183,0.00064798,91.71836982
12531,陳富美,4,566187,0.00064798,91.71901780
12532,陳義信,4,566191,0.00064798,91.71966577
12533,陳福成,4,566195,0.00064798,91.72031375
12534,陳樹,4,566199,0.00064798,91.72096173
12535,陳錫斌,4,566203,0.00064798,91.72160970
12536,陳懷三,4,566207,0.00064798,91.72225768
12537,陸地,4,566211,0.00064798,91.72290566
12538,陸官,4,566215,0.00064798,91.72355363
12539,陸橋,4,566219,0.00064798,91.72420161
12540,陰,4,566223,0.00064798,91.72484959
12541,陰暗,4,566227,0.00064798,91.72549757
12542,陰謀,4,566231,0.00064798,91.72614554
12543,陶瓷,4,566235,0.00064798,91.72679352
12544,雪梨市,4,566239,0.00064798,91.72744150
12545,雪蛤膏,4,566243,0.00064798,91.72808947
12546,頂端,4,566247,0.00064798,91.72873745
12547,頂樓,4,566251,0.00064798,91.72938543
12548,鳥兒,4,566255,0.00064798,91.73003340
12549,麥可喬丹,4,566259,0.00064798,91.73068138
12550,麥志炳,4,566263,0.00064798,91.73132936
12551,麥當勞,4,566267,0.00064798,91.73197733
12552,凱悅,4,566271,0.00064798,91.73262531
12553,割,4,566275,0.00064798,91.73327329
12554,割據,4,566279,0.00064798,91.73392126
12555,創設,4,566283,0.00064798,91.73456924
12556,創造性,4,566287,0.00064798,91.73521722
12557,創造者,4,566291,0.00064798,91.73586519
12558,創傷,4,566295,0.00064798,91.73651317
12559,勞,4,566299,0.00064798,91.73716115
12560,勞動力,4,566303,0.00064798,91.73780913
12561,勝率,4,566307,0.00064798,91.73845710
12562,博得,4,566311,0.00064798,91.73910508
12563,喧鬧,4,566315,0.00064798,91.73975306
12564,喜見達,4,566319,0.00064798,91.74040103
12565,喪命,4,566323,0.00064798,91.74104901
12566,單月,4,566327,0.00064798,91.74169699
12567,單打,4,566331,0.00064798,91.74234496
12568,喟嘆,4,566335,0.00064798,91.74299294
12569,喬埃思,4,566339,0.00064798,91.74364092
12570,圍堵,4,566343,0.00064798,91.74428889
12571,圍牆,4,566347,0.00064798,91.74493687
12572,報刊,4,566351,0.00064798,91.74558485
12573,報警,4,566355,0.00064798,91.74623282
12574,寒冷,4,566359,0.00064798,91.74688080
12575,寒暄,4,566363,0.00064798,91.74752878
12576,富人,4,566367,0.00064798,91.74817676
12577,彭郁晶,4,566371,0.00064798,91.74882473
12578,復活,4,566375,0.00064798,91.74947271
12579,復活節,4,566379,0.00064798,91.75012069
12580,循線,4,566383,0.00064798,91.75076866
12581,惡性,4,566387,0.00064798,91.75141664
12582,惡性競爭,4,566391,0.00064798,91.75206462
12583,惡業,4,566395,0.00064798,91.75271259
12584,揍,4,566399,0.00064798,91.75336057
12585,插入式,4,566403,0.00064798,91.75400855
12586,插花課,4,566407,0.00064798,91.75465652
12587,提防,4,566411,0.00064798,91.75530450
12588,提報,4,566415,0.00064798,91.75595248
12589,提款,4,566419,0.00064798,91.75660045
12590,提琴,4,566423,0.00064798,91.75724843
12591,揮手,4,566427,0.00064798,91.75789641
12592,揮霍,4,566431,0.00064798,91.75854438
12593,援手,4,566435,0.00064798,91.75919236
12594,換掉,4,566439,0.00064798,91.75984034
12595,揚聲器,4,566443,0.00064798,91.76048832
12596,敦化北路,4,566447,0.00064798,91.76113629
12597,敦煌,4,566451,0.00064798,91.76178427
12598,散佈,4,566455,0.00064798,91.76243225
12599,散熱,4,566459,0.00064798,91.76308022
12600,斑點,4,566463,0.00064798,91.76372820
12601,斯,4,566467,0.00064798,91.76437618
12602,晶圓廠,4,566471,0.00064798,91.76502415
12603,景像,4,566475,0.00064798,91.76567213
12604,景點,4,566479,0.00064798,91.76632011
12605,暑,4,566483,0.00064798,91.76696808
12606,智,4,566487,0.00064798,91.76761606
12607,智慧型,4,566491,0.00064798,91.76826404
12608,曾文溪,4,566495,0.00064798,91.76891201
12609,曾任,4,566499,0.00064798,91.76955999
12610,曾碧娟,4,566503,0.00064798,91.77020797
12611,替換,4,566507,0.00064798,91.77085595
12612,期滿,4,566511,0.00064798,91.77150392
12613,棲地,4,566515,0.00064798,91.77215190
12614,植物灣,4,566519,0.00064798,91.77279988
12615,欺負,4,566523,0.00064798,91.77344785
12616,殘障,4,566527,0.00064798,91.77409583
12617,殘暴,4,566531,0.00064798,91.77474381
12618,殘餘,4,566535,0.00064798,91.77539178
12619,港人,4,566539,0.00064798,91.77603976
12620,港務局,4,566543,0.00064798,91.77668774
12621,港區,4,566547,0.00064798,91.77733571
12622,減班,4,566551,0.00064798,91.77798369
12623,減退,4,566555,0.00064798,91.77863167
12624,湖水,4,566559,0.00064798,91.77927964
12625,湖南,4,566563,0.00064798,91.77992762
12626,湯姆斯盃,4,566567,0.00064798,91.78057560
12627,湯匙,4,566571,0.00064798,91.78122357
12628,滋補,4,566575,0.00064798,91.78187155
12629,滋養,4,566579,0.00064798,91.78251953
12630,焚化廠,4,566583,0.00064798,91.78316751
12631,焦頭爛額,4,566587,0.00064798,91.78381548
12632,無力感,4,566591,0.00064798,91.78446346
12633,無所不在,4,566595,0.00064798,91.78511144
12634,無非,4,566599,0.00064798,91.78575941
12635,無暇,4,566603,0.00064798,91.78640739
12636,無緣,4,566607,0.00064798,91.78705537
12637,煮飯,4,566611,0.00064798,91.78770334
12638,煮熟,4,566615,0.00064798,91.78835132
12639,牌位,4,566619,0.00064798,91.78899930
12640,猴子,4,566623,0.00064798,91.78964727
12641,琳琅滿目,4,566627,0.00064798,91.79029525
12642,琳瑯滿目,4,566631,0.00064798,91.79094323
12643,琥碧戈柏,4,566635,0.00064798,91.79159120
12644,畫布,4,566639,0.00064798,91.79223918
12645,畫畫,4,566643,0.00064798,91.79288716
12646,番麥,4,566647,0.00064798,91.79353513
12647,番號,4,566651,0.00064798,91.79418311
12648,痛心,4,566655,0.00064798,91.79483109
12649,痛恨,4,566659,0.00064798,91.79547907
12650,發行人,4,566663,0.00064798,91.79612704
12651,發芽,4,566667,0.00064798,91.79677502
12652,發音,4,566671,0.00064798,91.79742300
12653,發病,4,566675,0.00064798,91.79807097
12654,發財,4,566679,0.00064798,91.79871895
12655,發電,4,566683,0.00064798,91.79936693
12656,發電機,4,566687,0.00064798,91.80001490
12657,發霉,4,566691,0.00064798,91.80066288
12658,硬化,4,566695,0.00064798,91.80131086
12659,硬撐,4,566699,0.00064798,91.80195883
12660,稅後純益,4,566703,0.00064798,91.80260681
12661,稅款,4,566707,0.00064798,91.80325479
12662,稀世,4,566711,0.00064798,91.80390276
12663,稀奇,4,566715,0.00064798,91.80455074
12664,策劃,4,566719,0.00064798,91.80519872
12665,筆刷,4,566723,0.00064798,91.80584670
12666,筆跡,4,566727,0.00064798,91.80649467
12667,筆墨,4,566731,0.00064798,91.80714265
12668,答復,4,566735,0.00064798,91.80779063
12669,結交,4,566739,0.00064798,91.80843860
12670,結實,4,566743,0.00064798,91.80908658
12671,絕大多數,4,566747,0.00064798,91.80973456
12672,絕佳,4,566751,0.00064798,91.81038253
12673,絕美,4,566755,0.00064798,91.81103051
12674,絕種,4,566759,0.00064798,91.81167849
12675,紫竹調,4,566763,0.00064798,91.81232646
12676,給付,4,566767,0.00064798,91.81297444
12677,給與,4,566771,0.00064798,91.81362242
12678,善加,4,566775,0.00064798,91.81427039
12679,善後,4,566779,0.00064798,91.81491837
12680,腕,4,566783,0.00064798,91.81556635
12681,腎補納,4,566787,0.00064798,91.81621432
12682,舒展,4,566791,0.00064798,91.81686230
12683,萍,4,566795,0.00064798,91.81751028
12684,華盛頓,4,566799,0.00064798,91.81815826
12685,華僑銀行,4,566803,0.00064798,91.81880623
12686,華寶,4,566807,0.00064798,91.81945421
12687,著火,4,566811,0.00064798,91.82010219
12688,菌尿症,4,566815,0.00064798,91.82075016
12689,菜名,4,566819,0.00064798,91.82139814
12690,虛冷,4,566823,0.00064798,91.82204612
12691,裁減,4,566827,0.00064798,91.82269409
12692,視野率,4,566831,0.00064798,91.82334207
12693,詠捷,4,566835,0.00064798,91.82399005
12694,証明,4,566839,0.00064798,91.82463802
12695,訴諸,4,566843,0.00064798,91.82528600
12696,貼切,4,566847,0.00064798,91.82593398
12697,貼心,4,566851,0.00064798,91.82658195
12698,貼紙,4,566855,0.00064798,91.82722993
12699,費時,4,566859,0.00064798,91.82787791
12700,費率,4,566863,0.00064798,91.82852589
12701,賀伯颱風,4,566867,0.00064798,91.82917386
12702,貿易額,4,566871,0.00064798,91.82982184
12703,貿然,4,566875,0.00064798,91.83046982
12704,越野吉普車,4,566879,0.00064798,91.83111779
12705,超人,4,566883,0.00064798,91.83176577
12706,超乎,4,566887,0.00064798,91.83241375
12707,超市,4,566891,0.00064798,91.83306172
12708,超特,4,566895,0.00064798,91.83370970
12709,超特主機,4,566899,0.00064798,91.83435768
12710,超然,4,566903,0.00064798,91.83500565
12711,超薦法,4,566907,0.00064798,91.83565363
12712,跑掉,4,566911,0.00064798,91.83630161
12713,辜汪會談,4,566915,0.00064798,91.83694958
12714,週轉,4,566919,0.00064798,91.83759756
12715,進食,4,566923,0.00064798,91.83824554
12716,郵寄,4,566927,0.00064798,91.83889351
12717,郵箱,4,566931,0.00064798,91.83954149
12718,鄉長,4,566935,0.00064798,91.84018947
12719,開支,4,566939,0.00064798,91.84083745
12720,開展,4,566943,0.00064798,91.84148542
12721,開徵,4,566947,0.00064798,91.84213340
12722,開膛手,4,566951,0.00064798,91.84278138
12723,開墾,4,566955,0.00064798,91.84342935
12724,開闊,4,566959,0.00064798,91.84407733
12725,開鑿,4,566963,0.00064798,91.84472531
12726,間斷,4,566967,0.00064798,91.84537328
12727,陽,4,566971,0.00064798,91.84602126
12728,陽性,4,566975,0.00064798,91.84666924
12729,陽春,4,566979,0.00064798,91.84731721
12730,雅虎,4,566983,0.00064798,91.84796519
12731,雅卿,4,566987,0.00064798,91.84861317
12732,雄厚,4,566991,0.00064798,91.84926114
12733,集訓,4,566995,0.00064798,91.84990912
12734,雇用,4,566999,0.00064798,91.85055710
12735,雲林地院,4,567003,0.00064798,91.85120507
12736,雲霧,4,567007,0.00064798,91.85185305
12737,韌帶,4,567011,0.00064798,91.85250103
12738,順勢,4,567015,0.00064798,91.85314901
12739,順應,4,567019,0.00064798,91.85379698
12740,須要,4,567023,0.00064798,91.85444496
12741,黃山畫派,4,567027,0.00064798,91.85509294
12742,黃昏,4,567031,0.00064798,91.85574091
12743,黃河,4,567035,0.00064798,91.85638889
12744,黃金劇場,4,567039,0.00064798,91.85703687
12745,黃國樑,4,567043,0.00064798,91.85768484
12746,黃華成,4,567047,0.00064798,91.85833282
12747,黃銘欽,4,567051,0.00064798,91.85898080
12748,黑市,4,567055,0.00064798,91.85962877
12749,黑幼龍,4,567059,0.00064798,91.86027675
12750,黑胡椒粉,4,567063,0.00064798,91.86092473
12751,黑道當家,4,567067,0.00064798,91.86157270
12752,亂馬,4,567071,0.00064798,91.86222068
12753,亂象,4,567075,0.00064798,91.86286866
12754,債務人,4,567079,0.00064798,91.86351664
12755,傳神,4,567083,0.00064798,91.86416461
12756,傳送器,4,567087,0.00064798,91.86481259
12757,傳教士,4,567091,0.00064798,91.86546057
12758,傳喚,4,567095,0.00064798,91.86610854
12759,傳輸量,4,567099,0.00064798,91.86675652
12760,催促,4,567103,0.00064798,91.86740450
12761,勤勞,4,567107,0.00064798,91.86805247
12762,圓融,4,567111,0.00064798,91.86870045
12763,塑,4,567115,0.00064798,91.86934843
12764,塑像,4,567119,0.00064798,91.86999640
12765,塑膠家具,4,567123,0.00064798,91.87064438
12766,塔頂,4,567127,0.00064798,91.87129236
12767,奧地利人,4,567131,0.00064798,91.87194033
12768,奧妙,4,567135,0.00064798,91.87258831
12769,奧林匹亞,4,567139,0.00064798,91.87323629
12770,奧斯卡,4,567143,0.00064798,91.87388426
12771,幹道,4,567147,0.00064798,91.87453224
12772,廉,4,567151,0.00064798,91.87518022
12773,微小,4,567155,0.00064798,91.87582820
12774,微米,4,567159,0.00064798,91.87647617
12775,微妙,4,567163,0.00064798,91.87712415
12776,微風,4,567167,0.00064798,91.87777213
12777,微粒,4,567171,0.00064798,91.87842010
12778,微微,4,567175,0.00064798,91.87906808
12779,意指,4,567179,0.00064798,91.87971606
12780,意想不到,4,567183,0.00064798,91.88036403
12781,意謂,4,567187,0.00064798,91.88101201
12782,感人,4,567191,0.00064798,91.88165999
12783,感光度,4,567195,0.00064798,91.88230796
12784,感度,4,567199,0.00064798,91.88295594
12785,感恩,4,567203,0.00064798,91.88360392
12786,感傷,4,567207,0.00064798,91.88425189
12787,感想,4,567211,0.00064798,91.88489987
12788,感應,4,567215,0.00064798,91.88554785
12789,愛琴海,4,567219,0.00064798,91.88619583
12790,愛意,4,567223,0.00064798,91.88684380
12791,愛爾蘭,4,567227,0.00064798,91.88749178
12792,愁,4,567231,0.00064798,91.88813976
12793,搬運,4,567235,0.00064798,91.88878773
12794,搏,4,567239,0.00064798,91.88943571
12795,損傷,4,567243,0.00064798,91.89008369
12796,搶先,4,567247,0.00064798,91.89073166
12797,搶劫,4,567251,0.00064798,91.89137964
12798,搶孤,4,567255,0.00064798,91.89202762
12799,搶種,4,567259,0.00064798,91.89267559
12800,搶購,4,567263,0.00064798,91.89332357
12801,搖動,4,567267,0.00064798,91.89397155
12802,敬佩,4,567271,0.00064798,91.89461952
12803,敬重,4,567275,0.00064798,91.89526750
12804,新店市,4,567279,0.00064798,91.89591548
12805,新建,4,567283,0.00064798,91.89656345
12806,新春,4,567287,0.00064798,91.89721143
12807,新偕中,4,567291,0.00064798,91.89785941
12808,新聞周刊,4,567295,0.00064798,91.89850739
12809,新纖,4,567299,0.00064798,91.89915536
12810,暈開,4,567303,0.00064798,91.89980334
12811,會心,4,567307,0.00064798,91.90045132
12812,會客,4,567311,0.00064798,91.90109929
12813,會報,4,567315,0.00064798,91.90174727
12814,楊致遠,4,567319,0.00064798,91.90239525
12815,溢散,4,567323,0.00064798,91.90304322
12816,溶入,4,567327,0.00064798,91.90369120
12817,溝渠,4,567331,0.00064798,91.90433918
12818,溺斃,4,567335,0.00064798,91.90498715
12819,溫熱,4,567339,0.00064798,91.90563513
12820,滑雪,4,567343,0.00064798,91.90628311
12821,滑稽,4,567347,0.00064798,91.90693108
12822,準車主,4,567351,0.00064798,91.90757906
12823,溪,4,567355,0.00064798,91.90822704
12824,煎,4,567359,0.00064798,91.90887501
12825,煙霧,4,567363,0.00064798,91.90952299
12826,煩,4,567367,0.00064798,91.91017097
12827,煩躁,4,567371,0.00064798,91.91081895
12828,照明,4,567375,0.00064798,91.91146692
12829,照料,4,567379,0.00064798,91.91211490
12830,瑕,4,567383,0.00064798,91.91276288
12831,瑞典,4,567387,0.00064798,91.91341085
12832,當代傳奇,4,567391,0.00064798,91.91405883
12833,當面,4,567395,0.00064798,91.91470681
12834,痰,4,567399,0.00064798,91.91535478
12835,督促,4,567403,0.00064798,91.91600276
12836,督導,4,567407,0.00064798,91.91665074
12837,碰巧,4,567411,0.00064798,91.91729871
12838,節儉,4,567415,0.00064798,91.91794669
12839,經血,4,567419,0.00064798,91.91859467
12840,經紀,4,567423,0.00064798,91.91924264
12841,經濟學家,4,567427,0.00064798,91.91989062
12842,罪惡感,4,567431,0.00064798,91.92053860
12843,罪嫌,4,567435,0.00064798,91.92118658
12844,義大利人,4,567439,0.00064798,91.92183455
12845,義大利麵,4,567443,0.00064798,91.92248253
12846,義不容辭,4,567447,0.00064798,91.92313051
12847,群居,4,567451,0.00064798,91.92377848
12848,聖誕,4,567455,0.00064798,91.92442646
12849,聘雇,4,567459,0.00064798,91.92507444
12850,聘請,4,567463,0.00064798,91.92572241
12851,肆無忌憚,4,567467,0.00064798,91.92637039
12852,腳部,4,567471,0.00064798,91.92701837
12853,腫,4,567475,0.00064798,91.92766634
12854,腹痛,4,567479,0.00064798,91.92831432
12855,腹瀉,4,567483,0.00064798,91.92896230
12856,腦下垂體,4,567487,0.00064798,91.92961027
12857,腦海,4,567491,0.00064798,91.93025825
12858,落馬,4,567495,0.00064798,91.93090623
12859,落淚,4,567499,0.00064798,91.93155420
12860,落腳,4,567503,0.00064798,91.93220218
12861,落幕,4,567507,0.00064798,91.93285016
12862,葉片,4,567511,0.00064798,91.93349814
12863,葡萄園,4,567515,0.00064798,91.93414611
12864,董監改選,4,567519,0.00064798,91.93479409
12865,蛻變,4,567523,0.00064798,91.93544207
12866,補充品,4,567527,0.00064798,91.93609004
12867,補品,4,567531,0.00064798,91.93673802
12868,補貼,4,567535,0.00064798,91.93738600
12869,裝上,4,567539,0.00064798,91.93803397
12870,裝卸,4,567543,0.00064798,91.93868195
12871,裝飾性,4,567547,0.00064798,91.93932993
12872,裝飾品,4,567551,0.00064798,91.93997790
12873,裕隆汽車,4,567555,0.00064798,91.94062588
12874,解任,4,567559,0.00064798,91.94127386
12875,試婚,4,567563,0.00064798,91.94192183
12876,試辦,4,567567,0.00064798,91.94256981
12877,詼諧,4,567571,0.00064798,91.94321779
12878,誠品書店,4,567575,0.00064798,91.94386577
12879,話劇,4,567579,0.00064798,91.94451374
12880,詭譎,4,567583,0.00064798,91.94516172
12881,詹姆士,4,567587,0.00064798,91.94580970
12882,資料夾,4,567591,0.00064798,91.94645767
12883,跟蹤,4,567595,0.00064798,91.94710565
12884,路姒子公司,4,567599,0.00064798,91.94775363
12885,路邊,4,567603,0.00064798,91.94840160
12886,跳動,4,567607,0.00064798,91.94904958
12887,跳票,4,567611,0.00064798,91.94969756
12888,跳脫,4,567615,0.00064798,91.95034553
12889,較量,4,567619,0.00064798,91.95099351
12890,農作物,4,567623,0.00064798,91.95164149
12891,農產品,4,567627,0.00064798,91.95228946
12892,農莊,4,567631,0.00064798,91.95293744
12893,運算元,4,567635,0.00064798,91.95358542
12894,遊走,4,567639,0.00064798,91.95423339
12895,遊玩,4,567643,0.00064798,91.95488137
12896,遊戲軟體,4,567647,0.00064798,91.95552935
12897,遊騎兵,4,567651,0.00064798,91.95617733
12898,達新,4,567655,0.00064798,91.95682530
12899,違背,4,567659,0.00064798,91.95747328
12900,遇見,4,567663,0.00064798,91.95812126
12901,遏止,4,567667,0.00064798,91.95876923
12902,過夜,4,567671,0.00064798,91.95941721
12903,過渡,4,567675,0.00064798,91.96006519
12904,過境,4,567679,0.00064798,91.96071316
12905,遑論,4,567683,0.00064798,91.96136114
12906,鉀,4,567687,0.00064798,91.96200912
12907,鉛中毒,4,567691,0.00064798,91.96265709
12908,隔山畫館,4,567695,0.00064798,91.96330507
12909,雷雨,4,567699,0.00064798,91.96395305
12910,雷達,4,567703,0.00064798,91.96460102
12911,雷蒙,4,567707,0.00064798,91.96524900
12912,電子佈告欄,4,567711,0.00064798,91.96589698
12913,電阻,4,567715,0.00064798,91.96654495
12914,電信法,4,567719,0.00064798,91.96719293
12915,電信總局,4,567723,0.00064798,91.96784091
12916,電視政見會,4,567727,0.00064798,91.96848889
12917,電視節目,4,567731,0.00064798,91.96913686
12918,電視遊樂器,4,567735,0.00064798,91.96978484
12919,電視機,4,567739,0.00064798,91.97043282
12920,電腦主機,4,567743,0.00064798,91.97108079
12921,電話線,4,567747,0.00064798,91.97172877
12922,零售,4,567751,0.00064798,91.97237675
12923,預告,4,567755,0.00064798,91.97302472
12924,預訂,4,567759,0.00064798,91.97367270
12925,預售,4,567763,0.00064798,91.97432068
12926,飼養,4,567767,0.00064798,91.97496865
12927,馴,4,567771,0.00064798,91.97561663
12928,像樣,4,567775,0.00064798,91.97626461
12929,僑,4,567779,0.00064798,91.97691258
12930,圖林根,4,567783,0.00064798,91.97756056
12931,墓,4,567787,0.00064798,91.97820854
12932,奪魁,4,567791,0.00064798,91.97885652
12933,實地,4,567795,0.00064798,91.97950449
12934,實作,4,567799,0.00064798,91.98015247
12935,實物,4,567803,0.00064798,91.98080045
12936,實習,4,567807,0.00064798,91.98144842
12937,實驗性,4,567811,0.00064798,91.98209640
12938,實體,4,567815,0.00064798,91.98274438
12939,對不對,4,567819,0.00064798,91.98339235
12940,對峙,4,567823,0.00064798,91.98404033
12941,對等,4,567827,0.00064798,91.98468831
12942,幕僚,4,567831,0.00064798,91.98533628
12943,廖正豪,4,567835,0.00064798,91.98598426
12944,廖敏雄,4,567839,0.00064798,91.98663224
12945,廖鴻基,4,567843,0.00064798,91.98728021
12946,慢跑鞋,4,567847,0.00064798,91.98792819
12947,慘重,4,567851,0.00064798,91.98857617
12948,摔倒,4,567855,0.00064798,91.98922414
12949,撤退,4,567859,0.00064798,91.98987212
12950,摸彩,4,567863,0.00064798,91.99052010
12951,摧殘,4,567867,0.00064798,91.99116808
12952,旗袍,4,567871,0.00064798,91.99181605
12953,暢銷書,4,567875,0.00064798,91.99246403
12954,榮譽,4,567879,0.00064798,91.99311201
12955,演奏者,4,567883,0.00064798,91.99375998
12956,漩渦,4,567887,0.00064798,91.99440796
12957,漏夜,4,567891,0.00064798,91.99505594
12958,漢尼伯,4,567895,0.00064798,91.99570391
12959,漢唐樂府,4,567899,0.00064798,91.99635189
12960,漢聲精選圖畫書第四輯,4,567903,0.00064798,91.99699987
12961,滯留,4,567907,0.00064798,91.99764784
12962,漆黑,4,567911,0.00064798,91.99829582
12963,漲勢,4,567915,0.00064798,91.99894380
12964,漣漪,4,567919,0.00064798,91.99959177
12965,滲入,4,567923,0.00064798,92.00023975
12966,熊掌,4,567927,0.00064798,92.00088773
12967,熄滅,4,567931,0.00064798,92.00153571
12968,瑣碎,4,567935,0.00064798,92.00218368
12969,監交,4,567939,0.00064798,92.00283166
12970,監委,4,567943,0.00064798,92.00347964
12971,睡眠,4,567947,0.00064798,92.00412761
12972,磁片,4,567951,0.00064798,92.00477559
12973,碳化鎢,4,567955,0.00064798,92.00542357
12974,碩士,4,567959,0.00064798,92.00607154
12975,福利社,4,567963,0.00064798,92.00671952
12976,福祉,4,567967,0.00064798,92.00736750
12977,福音,4,567971,0.00064798,92.00801547
12978,福斯,4,567975,0.00064798,92.00866345
12979,福華飯店,4,567979,0.00064798,92.00931143
12980,稱為,4,567983,0.00064798,92.00995940
12981,端倪,4,567987,0.00064798,92.01060738
12982,管風琴,4,567991,0.00064798,92.01125536
12983,精打細算,4,567995,0.00064798,92.01190333
12984,精益求精,4,567999,0.00064798,92.01255131
12985,精選,4,568003,0.00064798,92.01319929
12986,綜藝夜總會,4,568007,0.00064798,92.01384727
12987,綜觀,4,568011,0.00064798,92.01449524
12988,綠化,4,568015,0.00064798,92.01514322
12989,緊繃,4,568019,0.00064798,92.01579120
12990,網球,4,568023,0.00064798,92.01643917
12991,網絡報紙,4,568027,0.00064798,92.01708715
12992,網羅,4,568031,0.00064798,92.01773513
12993,維拉斯貴茲,4,568035,0.00064798,92.01838310
12994,聚落,4,568039,0.00064798,92.01903108
12995,聚酯絲,4,568043,0.00064798,92.01967906
12996,膀胱炎,4,568047,0.00064798,92.02032703
12997,與否,4,568051,0.00064798,92.02097501
12998,與會者,4,568055,0.00064798,92.02162299
12999,舞團,4,568059,0.00064798,92.02227096
13000,裴家騏,4,568063,0.00064798,92.02291894
13001,裸體,4,568067,0.00064798,92.02356692
13002,製造廠,4,568071,0.00064798,92.02421490
13003,製程,4,568075,0.00064798,92.02486287
13004,認股,4,568079,0.00064798,92.02551085
13005,誓,4,568083,0.00064798,92.02615883
13006,誓言,4,568087,0.00064798,92.02680680
13007,誤判,4,568091,0.00064798,92.02745478
13008,說明書,4,568095,0.00064798,92.02810276
13009,輕而易舉,4,568099,0.00064798,92.02875073
13010,輕柔,4,568103,0.00064798,92.02939871
13011,遠眺,4,568107,0.00064798,92.03004669
13012,遜,4,568111,0.00064798,92.03069466
13013,酷愛,4,568115,0.00064798,92.03134264
13014,銀髮族,4,568119,0.00064798,92.03199062
13015,鉻,4,568123,0.00064798,92.03263859
13016,銜,4,568127,0.00064798,92.03328657
13017,閣下,4,568131,0.00064798,92.03393455
13018,領軍,4,568135,0.00064798,92.03458252
13019,骯髒,4,568139,0.00064798,92.03523050
13020,骰子,4,568143,0.00064798,92.03587848
13021,鼻,4,568147,0.00064798,92.03652646
13022,鼻咽癌,4,568151,0.00064798,92.03717443
13023,齊全,4,568155,0.00064798,92.03782241
13024,齊聚一堂,4,568159,0.00064798,92.03847039
13025,僵化,4,568163,0.00064798,92.03911836
13026,劇種,4,568167,0.00064798,92.03976634
13027,劉春生,4,568171,0.00064798,92.04041432
13028,劉國平,4,568175,0.00064798,92.04106229
13029,劉鈺波,4,568179,0.00064798,92.04171027
13030,增值,4,568183,0.00064798,92.04235825
13031,墜毀,4,568187,0.00064798,92.04300622
13032,墮落,4,568191,0.00064798,92.04365420
13033,嬉戲,4,568195,0.00064798,92.04430218
13034,寬大,4,568199,0.00064798,92.04495015
13035,寬容,4,568203,0.00064798,92.04559813
13036,審判,4,568207,0.00064798,92.04624611
13037,審定,4,568211,0.00064798,92.04689408
13038,審查委員,4,568215,0.00064798,92.04754206
13039,審計,4,568219,0.00064798,92.04819004
13040,審理,4,568223,0.00064798,92.04883802
13041,寫入,4,568227,0.00064798,92.04948599
13042,寫真,4,568231,0.00064798,92.05013397
13043,廢紙,4,568235,0.00064798,92.05078195
13044,廢墟,4,568239,0.00064798,92.05142992
13045,廝殺,4,568243,0.00064798,92.05207790
13046,影射,4,568247,0.00064798,92.05272588
13047,影像雜誌,4,568251,0.00064798,92.05337385
13048,影歌星,4,568255,0.00064798,92.05402183
13049,德州理工,4,568259,0.00064798,92.05466981
13050,慕提,4,568263,0.00064798,92.05531778
13051,憂愁,4,568267,0.00064798,92.05596576
13052,慾望城國,4,568271,0.00064798,92.05661374
13053,撥出,4,568275,0.00064798,92.05726171
13054,撮合,4,568279,0.00064798,92.05790969
13055,播音,4,568283,0.00064798,92.05855767
13056,敵軍,4,568287,0.00064798,92.05920565
13057,敷臉,4,568291,0.00064798,92.05985362
13058,暴增,4,568295,0.00064798,92.06050160
13059,樞紐,4,568299,0.00064798,92.06114958
13060,標竿,4,568303,0.00064798,92.06179755
13061,標高,4,568307,0.00064798,92.06244553
13062,標單,4,568311,0.00064798,92.06309351
13063,模組化,4,568315,0.00064798,92.06374148
13064,樂壇,4,568319,0.00064798,92.06438946
13065,樂聲,4,568323,0.00064798,92.06503744
13066,歐姆,4,568327,0.00064798,92.06568541
13067,歐陸,4,568331,0.00064798,92.06633339
13068,歐斯特,4,568335,0.00064798,92.06698137
13069,歎,4,568339,0.00064798,92.06762934
13070,潑,4,568343,0.00064798,92.06827732
13071,澆鑄,4,568347,0.00064798,92.06892530
13072,潛逃,4,568351,0.00064798,92.06957327
13073,潛藏,4,568355,0.00064798,92.07022125
13074,澎,4,568359,0.00064798,92.07086923
13075,澎湖人,4,568363,0.00064798,92.07151721
13076,潤澤,4,568367,0.00064798,92.07216518
13077,熬夜,4,568371,0.00064798,92.07281316
13078,獎學金,4,568375,0.00064798,92.07346114
13079,獎勵,4,568379,0.00064798,92.07410911
13080,瘤,4,568383,0.00064798,92.07475709
13081,盤尼西林,4,568387,0.00064798,92.07540507
13082,盤面,4,568391,0.00064798,92.07605304
13083,確信,4,568395,0.00064798,92.07670102
13084,確是,4,568399,0.00064798,92.07734900
13085,窮人,4,568403,0.00064798,92.07799697
13086,窮苦,4,568407,0.00064798,92.07864495
13087,糊,4,568411,0.00064798,92.07929293
13088,線上,4,568415,0.00064798,92.07994090
13089,線材,4,568419,0.00064798,92.08058888
13090,膜拜,4,568423,0.00064798,92.08123686
13091,膝,4,568427,0.00064798,92.08188484
13092,膝蓋,4,568431,0.00064798,92.08253281
13093,蔡萬才,4,568435,0.00064798,92.08318079
13094,蔡萬霖,4,568439,0.00064798,92.08382877
13095,蔡福財,4,568443,0.00064798,92.08447674
13096,衛生紙,4,568447,0.00064798,92.08512472
13097,衛視中文台,4,568451,0.00064798,92.08577270
13098,褐樹蛙,4,568455,0.00064798,92.08642067
13099,複雜性,4,568459,0.00064798,92.08706865
13100,請問,4,568463,0.00064798,92.08771663
13101,請領,4,568467,0.00064798,92.08836460
13102,課徵,4,568471,0.00064798,92.08901258
13103,調和,4,568475,0.00064798,92.08966056
13104,調動,4,568479,0.00064798,92.09030853
13105,調解委員會,4,568483,0.00064798,92.09095651
13106,論點,4,568487,0.00064798,92.09160449
13107,賠償金,4,568491,0.00064798,92.09225246
13108,賞心悅目,4,568495,0.00064798,92.09290044
13109,賭城,4,568499,0.00064798,92.09354842
13110,賭場,4,568503,0.00064798,92.09419640
13111,質數,4,568507,0.00064798,92.09484437
13112,趣味性,4,568511,0.00064798,92.09549235
13113,踏實,4,568515,0.00064798,92.09614033
13114,輪流,4,568519,0.00064798,92.09678830
13115,輪調,4,568523,0.00064798,92.09743628
13116,適用性,4,568527,0.00064798,92.09808426
13117,鄰邦,4,568531,0.00064798,92.09873223
13118,鄭,4,568535,0.00064798,92.09938021
13119,鄭志龍,4,568539,0.00064798,92.10002819
13120,鄭雅嬪,4,568543,0.00064798,92.10067616
13121,鄭寶清,4,568547,0.00064798,92.10132414
13122,鄧,4,568551,0.00064798,92.10197212
13123,鄧笑文,4,568555,0.00064798,92.10262009
13124,醇,4,568559,0.00064798,92.10326807
13125,銷售率,4,568563,0.00064798,92.10391605
13126,鋁帷幕牆,4,568567,0.00064798,92.10456402
13127,閱,4,568571,0.00064798,92.10521200
13128,震盪,4,568575,0.00064798,92.10585998
13129,黎巴嫩,4,568579,0.00064798,92.10650796
13130,儒家,4,568583,0.00064798,92.10715593
13131,儘早,4,568587,0.00064798,92.10780391
13132,儘速,4,568591,0.00064798,92.10845189
13133,劑量,4,568595,0.00064798,92.10909986
13134,噸位,4,568599,0.00064798,92.10974784
13135,奮勇,4,568603,0.00064798,92.11039582
13136,學界,4,568607,0.00064798,92.11104379
13137,學科,4,568611,0.00064798,92.11169177
13138,學家,4,568615,0.00064798,92.11233975
13139,學歷,4,568619,0.00064798,92.11298772
13140,導彈,4,568623,0.00064798,92.11363570
13141,憲,4,568627,0.00064798,92.11428368
13142,戰友,4,568631,0.00064798,92.11493165
13143,戰火,4,568635,0.00064798,92.11557963
13144,戰局,4,568639,0.00064798,92.11622761
13145,戰況,4,568643,0.00064798,92.11687559
13146,戰勝,4,568647,0.00064798,92.11752356
13147,戰戰兢兢,4,568651,0.00064798,92.11817154
13148,擅自,4,568655,0.00064798,92.11881952
13149,擁擠,4,568659,0.00064798,92.11946749
13150,擋住,4,568663,0.00064798,92.12011547
13151,擇,4,568667,0.00064798,92.12076345
13152,擔,4,568671,0.00064798,92.12141142
13153,擔負,4,568675,0.00064798,92.12205940
13154,整建,4,568679,0.00064798,92.12270738
13155,整修,4,568683,0.00064798,92.12335535
13156,曉,4,568687,0.00064798,92.12400333
13157,樹幹,4,568691,0.00064798,92.12465131
13158,機位,4,568695,0.00064798,92.12529928
13159,機動,4,568699,0.00064798,92.12594726
13160,機械式,4,568703,0.00064798,92.12659524
13161,機場飯店,4,568707,0.00064798,92.12724321
13162,機隊,4,568711,0.00064798,92.12789119
13163,濃湯,4,568715,0.00064798,92.12853917
13164,濃濃,4,568719,0.00064798,92.12918715
13165,澳洲人,4,568723,0.00064798,92.12983512
13166,激動,4,568727,0.00064798,92.13048310
13167,燈塔,4,568731,0.00064798,92.13113108
13168,燕子,4,568735,0.00064798,92.13177905
13169,獨大,4,568739,0.00064798,92.13242703
13170,獨居,4,568743,0.00064798,92.13307501
13171,磨損,4,568747,0.00064798,92.13372298
13172,築,4,568751,0.00064798,92.13437096
13173,縛,4,568755,0.00064798,92.13501894
13174,縣政府,4,568759,0.00064798,92.13566691
13175,縣議會,4,568763,0.00064798,92.13631489
13176,蕩,4,568767,0.00064798,92.13696287
13177,蕭衡倩,4,568771,0.00064798,92.13761084
13178,融化,4,568775,0.00064798,92.13825882
13179,融資公司,4,568779,0.00064798,92.13890680
13180,褪色,4,568783,0.00064798,92.13955478
13181,親朋好友,4,568787,0.00064798,92.14020275
13182,親筆,4,568791,0.00064798,92.14085073
13183,諺語,4,568795,0.00064798,92.14149871
13184,諮詢委員會,4,568799,0.00064798,92.14214668
13185,諾貝爾獎,4,568803,0.00064798,92.14279466
13186,賴有亮,4,568807,0.00064798,92.14344264
13187,賴俊銘,4,568811,0.00064798,92.14409061
13188,遵照,4,568815,0.00064798,92.14473859
13189,選手村,4,568819,0.00064798,92.14538657
13190,選戰,4,568823,0.00064798,92.14603454
13191,遺物,4,568827,0.00064798,92.14668252
13192,遺漏,4,568831,0.00064798,92.14733050
13193,錯愕,4,568835,0.00064798,92.14797847
13194,錢復,4,568839,0.00064798,92.14862645
13195,錢琪琛,4,568843,0.00064798,92.14927443
13196,鋼,4,568847,0.00064798,92.14992240
13197,鋼琴家,4,568851,0.00064798,92.15057038
13198,錄音師,4,568855,0.00064798,92.15121836
13199,錄製,4,568859,0.00064798,92.15186634
13200,隨從,4,568863,0.00064798,92.15251431
13201,靜脈,4,568867,0.00064798,92.15316229
13202,靜態,4,568871,0.00064798,92.15381027
13203,頻尿,4,568875,0.00064798,92.15445824
13204,頻傳,4,568879,0.00064798,92.15510622
13205,駱毓芬,4,568883,0.00064798,92.15575420
13206,龍之湯,4,568887,0.00064798,92.15640217
13207,龍邦建設,4,568891,0.00064798,92.15705015
13208,龍響,4,568895,0.00064798,92.15769813
13209,優厚,4,568899,0.00064798,92.15834610
13210,優格,4,568903,0.00064798,92.15899408
13211,儲備,4,568907,0.00064798,92.15964206
13212,嚐試,4,568911,0.00064798,92.16029003
13213,壓力差,4,568915,0.00064798,92.16093801
13214,壓迫感,4,568919,0.00064798,92.16158599
13215,壓軸,4,568923,0.00064798,92.16223396
13216,幫派,4,568927,0.00064798,92.16288194
13217,應否,4,568931,0.00064798,92.16352992
13218,應對,4,568935,0.00064798,92.16417790
13219,應邀,4,568939,0.00064798,92.16482587
13220,應變,4,568943,0.00064798,92.16547385
13221,擊中,4,568947,0.00064798,92.16612183
13222,擊落,4,568951,0.00064798,92.16676980
13223,擬訂,4,568955,0.00064798,92.16741778
13224,擱淺,4,568959,0.00064798,92.16806576
13225,檢調單位,4,568963,0.00064798,92.16871373
13226,濱南工業區,4,568967,0.00064798,92.16936171
13227,濫,4,568971,0.00064798,92.17000969
13228,營養午餐,4,568975,0.00064798,92.17065766
13229,牆上,4,568979,0.00064798,92.17130564
13230,獲知,4,568983,0.00064798,92.17195362
13231,獲贈,4,568987,0.00064798,92.17260159
13232,環保局長,4,568991,0.00064798,92.17324957
13233,環境影響評估,4,568995,0.00064798,92.17389755
13234,瞬息萬變,4,568999,0.00064798,92.17454553
13235,瞧見,4,569003,0.00064798,92.17519350
13236,縫合,4,569007,0.00064798,92.17584148
13237,總理府,4,569011,0.00064798,92.17648946
13238,總編輯,4,569015,0.00064798,92.17713743
13239,總質詢,4,569019,0.00064798,92.17778541
13240,縱橫,4,569023,0.00064798,92.17843339
13241,繁殖期,4,569027,0.00064798,92.17908136
13242,聲寶,4,569031,0.00064798,92.17972934
13243,聲譽,4,569035,0.00064798,92.18037732
13244,臂,4,569039,0.00064798,92.18102529
13245,臉孔,4,569043,0.00064798,92.18167327
13246,膾炙人口,4,569047,0.00064798,92.18232125
13247,臨近,4,569051,0.00064798,92.18296922
13248,臨界點,4,569055,0.00064798,92.18361720
13249,臨時股東會,4,569059,0.00064798,92.18426518
13250,舉重,4,569063,0.00064798,92.18491315
13251,艱困,4,569067,0.00064798,92.18556113
13252,薄薄,4,569071,0.00064798,92.18620911
13253,薑汁,4,569075,0.00064798,92.18685709
13254,講授,4,569079,0.00064798,92.18750506
13255,謝文和,4,569083,0.00064798,92.18815304
13256,謝長廷,4,569087,0.00064798,92.18880102
13257,謝雲沐,4,569091,0.00064798,92.18944899
13258,購入,4,569095,0.00064798,92.19009697
13259,購併,4,569099,0.00064798,92.19074495
13260,購買力,4,569103,0.00064798,92.19139292
13261,輾轉,4,569107,0.00064798,92.19204090
13262,避震器,4,569111,0.00064798,92.19268888
13263,鍥而不捨,4,569115,0.00064798,92.19333685
13264,鍋爐,4,569119,0.00064798,92.19398483
13265,鍛鍊,4,569123,0.00064798,92.19463281
13266,隱形,4,569127,0.00064798,92.19528078
13267,隱私,4,569131,0.00064798,92.19592876
13268,隱性,4,569135,0.00064798,92.19657674
13269,隱然,4,569139,0.00064798,92.19722472
13270,鮮奶油,4,569143,0.00064798,92.19787269
13271,鮮味,4,569147,0.00064798,92.19852067
13272,黝黑,4,569151,0.00064798,92.19916865
13273,壘壁陣四,4,569155,0.00064798,92.19981662
13274,擺出,4,569159,0.00064798,92.20046460
13275,擺動,4,569163,0.00064798,92.20111258
13276,斷絕,4,569167,0.00064798,92.20176055
13277,斷層,4,569171,0.00064798,92.20240853
13278,朦朧,4,569175,0.00064798,92.20305651
13279,櫃子,4,569179,0.00064798,92.20370448
13280,歸來,4,569183,0.00064798,92.20435246
13281,糧商,4,569187,0.00064798,92.20500044
13282,翻開,4,569191,0.00064798,92.20564841
13283,職訓,4,569195,0.00064798,92.20629639
13284,豐盛,4,569199,0.00064798,92.20694437
13285,轉任,4,569203,0.00064798,92.20759234
13286,轉達,4,569207,0.00064798,92.20824032
13287,醫學界,4,569211,0.00064798,92.20888830
13288,鎮定,4,569215,0.00064798,92.20953628
13289,鎮靜,4,569219,0.00064798,92.21018425
13290,闖關,4,569223,0.00064798,92.21083223
13291,離家,4,569227,0.00064798,92.21148021
13292,雜草,4,569231,0.00064798,92.21212818
13293,雙子,4,569235,0.00064798,92.21277616
13294,雙向,4,569239,0.00064798,92.21342414
13295,雙邊,4,569243,0.00064798,92.21407211
13296,騎兵,4,569247,0.00064798,92.21472009
13297,鬆懈,4,569251,0.00064798,92.21536807
13298,魏東和,4,569255,0.00064798,92.21601604
13299,壟斷,4,569259,0.00064798,92.21666402
13300,龐均太,4,569263,0.00064798,92.21731200
13301,懷抱,4,569267,0.00064798,92.21795997
13302,瀝青,4,569271,0.00064798,92.21860795
13303,爆震,4,569275,0.00064798,92.21925593
13304,礙,4,569279,0.00064798,92.21990391
13305,繩子,4,569283,0.00064798,92.22055188
13306,羅北安,4,569287,0.00064798,92.22119986
13307,羅德曼,4,569291,0.00064798,92.22184784
13308,藥材,4,569295,0.00064798,92.22249581
13309,藥師,4,569299,0.00064798,92.22314379
13310,藥膜,4,569303,0.00064798,92.22379177
13311,譜寫,4,569307,0.00064798,92.22443974
13312,識破,4,569311,0.00064798,92.22508772
13313,證券公司,4,569315,0.00064798,92.22573570
13314,證物,4,569319,0.00064798,92.22638367
13315,證悟,4,569323,0.00064798,92.22703165
13316,贈與稅,4,569327,0.00064798,92.22767963
13317,贈獎,4,569331,0.00064798,92.22832760
13318,贊同,4,569335,0.00064798,92.22897558
13319,辭掉,4,569339,0.00064798,92.22962356
13320,鏡片,4,569343,0.00064798,92.23027153
13321,關連,4,569347,0.00064798,92.23091951
13322,關渡平原,4,569351,0.00064798,92.23156749
13323,關聯性,4,569355,0.00064798,92.23221547
13324,難民營,4,569359,0.00064798,92.23286344
13325,難事,4,569363,0.00064798,92.23351142
13326,霧,4,569367,0.00064798,92.23415940
13327,霧峰,4,569371,0.00064798,92.23480737
13328,韻律,4,569375,0.00064798,92.23545535
13329,麒麟啤酒,4,569379,0.00064798,92.23610333
13330,麗晶酒店,4,569383,0.00064798,92.23675130
13331,勸告,4,569387,0.00064798,92.23739928
13332,勸退,4,569391,0.00064798,92.23804726
13333,寶物,4,569395,0.00064798,92.23869523
13334,寶麗金,4,569399,0.00064798,92.23934321
13335,懸,4,569403,0.00064798,92.23999119
13336,懸殊,4,569407,0.00064798,92.24063916
13337,懺摩法,4,569411,0.00064798,92.24128714
13338,癢,4,569415,0.00064798,92.24193512
13339,籌組,4,569419,0.00064798,92.24258309
13340,繼承人,4,569423,0.00064798,92.24323107
13341,蘋果派,4,569427,0.00064798,92.24387905
13342,蘋果聯盟,4,569431,0.00064798,92.24452703
13343,蘇澳廠,4,569435,0.00064798,92.24517500
13344,蘇澳鎮公所,4,569439,0.00064798,92.24582298
13345,議事錄,4,569443,0.00064798,92.24647096
13346,議論,4,569447,0.00064798,92.24711893
13347,警網,4,569451,0.00064798,92.24776691
13348,警衛,4,569455,0.00064798,92.24841489
13349,釋惟覺,4,569459,0.00064798,92.24906286
13350,鐘表店,4,569463,0.00064798,92.24971084
13351,騰龍,4,569467,0.00064798,92.25035882
13352,鹹味,4,569471,0.00064798,92.25100679
13353,黨中央,4,569475,0.00064798,92.25165477
13354,黨主席,4,569479,0.00064798,92.25230275
13355,黨綱,4,569483,0.00064798,92.25295072
13356,攝影人,4,569487,0.00064798,92.25359870
13357,攝影師,4,569491,0.00064798,92.25424668
13358,纏,4,569495,0.00064798,92.25489466
13359,蠟,4,569499,0.00064798,92.25554263
13360,護土,4,569503,0.00064798,92.25619061
13361,護身符,4,569507,0.00064798,92.25683859
13362,贓物,4,569511,0.00064798,92.25748656
13363,辯護,4,569515,0.00064798,92.25813454
13364,鐵衣,4,569519,0.00064798,92.25878252
13365,鐵定,4,569523,0.00064798,92.25943049
13366,鐵拳,4,569527,0.00064798,92.26007847
13367,霸菱,4,569531,0.00064798,92.26072645
13368,響亮,4,569535,0.00064798,92.26137442
13369,顧名思義,4,569539,0.00064798,92.26202240
13370,顧忌,4,569543,0.00064798,92.26267038
13371,驅趕,4,569547,0.00064798,92.26331835
13372,魔術,4,569551,0.00064798,92.26396633
13373,權責,4,569555,0.00064798,92.26461431
13374,權數,4,569559,0.00064798,92.26526228
13375,權衡,4,569563,0.00064798,92.26591026
13376,歡,4,569567,0.00064798,92.26655824
13377,歡送,4,569571,0.00064798,92.26720622
13378,歡愉,4,569575,0.00064798,92.26785419
13379,灘,4,569579,0.00064798,92.26850217
13380,癮,4,569583,0.00064798,92.26915015
13381,籠,4,569587,0.00064798,92.26979812
13382,讀書人,4,569591,0.00064798,92.27044610
13383,鑄件,4,569595,0.00064798,92.27109408
13384,顫抖,4,569599,0.00064798,92.27174205
13385,髒髒,4,569603,0.00064798,92.27239003
13386,攪拌,4,569607,0.00064798,92.27303801
13387,纖細,4,569611,0.00064798,92.27368598
13388,變奏,4,569615,0.00064798,92.27433396
13389,變現性,4,569619,0.00064798,92.27498194
13390,顯赫,4,569623,0.00064798,92.27562991
13391,顯影劑,4,569627,0.00064798,92.27627789
13392,驚動,4,569631,0.00064798,92.27692587
13393,驚慌,4,569635,0.00064798,92.27757385
13394,驚慌失措,4,569639,0.00064798,92.27822182
13395,體內,4,569643,0.00064798,92.27886980
13396,體悟,4,569647,0.00064798,92.27951778
13397,體健休閒,4,569651,0.00064798,92.28016575
13398,體檢,4,569655,0.00064798,92.28081373
13399,體總,4,569659,0.00064798,92.28146171
13400,艷,4,569663,0.00064798,92.28210968
13401,釀,4,569667,0.00064798,92.28275766
13402,釀造,4,569671,0.00064798,92.28340564
13403,靈巧,4,569675,0.00064798,92.28405361
13404,鷹俠,4,569679,0.00064798,92.28470159
13405,鷹隊,4,569683,0.00064798,92.28534957
13406,鹽份,4,569687,0.00064798,92.28599754
13407,蠻橫,4,569691,0.00064798,92.28664552
13408,觀眾席,4,569695,0.00064798,92.28729350
13409,觀感,4,569699,0.00064798,92.28794147
13410,觀察力,4,569703,0.00064798,92.28858945
13411,鑲嵌,4,569707,0.00064798,92.28923743
13412,鑰,4,569711,0.00064798,92.28988541
13413,讚揚,4,569715,0.00064798,92.29053338
13414,鑽石,4,569719,0.00064798,92.29118136
13415,紓困,4,569723,0.00064798,92.29182934
13416,紓緩,4,569727,0.00064798,92.29247731
13417,胺基酸,4,569731,0.00064798,92.29312529
13418,一天天,3,569734,0.00048598,92.29361127
13419,一世,3,569737,0.00048598,92.29409725
13420,一件,3,569740,0.00048598,92.29458324
13421,一如,3,569743,0.00048598,92.29506922
13422,一波波,3,569746,0.00048598,92.29555520
13423,一氣呵成,3,569749,0.00048598,92.29604119
13424,一副,3,569752,0.00048598,92.29652717
13425,一清二楚,3,569755,0.00048598,92.29701315
13426,一朝一夕,3,569758,0.00048598,92.29749913
13427,一絲不掛,3,569761,0.00048598,92.29798512
13428,一視同仁,3,569764,0.00048598,92.29847110
13429,一睹,3,569767,0.00048598,92.29895708
13430,一窺,3,569770,0.00048598,92.29944306
13431,一點一滴,3,569773,0.00048598,92.29992905
13432,一蹶不振,3,569776,0.00048598,92.30041503
13433,一覽表,3,569779,0.00048598,92.30090101
13434,一襲,3,569782,0.00048598,92.30138699
13435,丁遠超,3,569785,0.00048598,92.30187298
13436,二元,3,569788,0.00048598,92.30235896
13437,二手,3,569791,0.00048598,92.30284494
13438,二代艦,3,569794,0.00048598,92.30333093
13439,二次世界大戰,3,569797,0.00048598,92.30381691
13440,二壘手,3,569800,0.00048598,92.30430289
13441,人大委員長,3,569803,0.00048598,92.30478887
13442,人工心臟,3,569806,0.00048598,92.30527486
13443,人手,3,569809,0.00048598,92.30576084
13444,人行陸橋,3,569812,0.00048598,92.30624682
13445,人身,3,569815,0.00048598,92.30673280
13446,人造花,3,569818,0.00048598,92.30721879
13447,人禍,3,569821,0.00048598,92.30770477
13448,人影,3,569824,0.00048598,92.30819075
13449,人頭,3,569827,0.00048598,92.30867673
13450,人聲,3,569830,0.00048598,92.30916272
13451,入浴,3,569833,0.00048598,92.30964870
13452,入場,3,569836,0.00048598,92.31013468
13453,力行,3,569839,0.00048598,92.31062066
13454,力行路,3,569842,0.00048598,92.31110665
13455,力圖,3,569845,0.00048598,92.31159263
13456,十一郎,3,569848,0.00048598,92.31207861
13457,十二生肖,3,569851,0.00048598,92.31256460
13458,十之八九,3,569854,0.00048598,92.31305058
13459,十字軍,3,569857,0.00048598,92.31353656
13460,三民商圈,3,569860,0.00048598,92.31402254
13461,三民路,3,569863,0.00048598,92.31450853
13462,三和村,3,569866,0.00048598,92.31499451
13463,三芝,3,569869,0.00048598,92.31548049
13464,三星,3,569872,0.00048598,92.31596647
13465,三商行,3,569875,0.00048598,92.31645246
13466,三富,3,569878,0.00048598,92.31693844
13467,三溫暖,3,569881,0.00048598,92.31742442
13468,三餐,3,569884,0.00048598,92.31791040
13469,下一代,3,569887,0.00048598,92.31839639
13470,下令,3,569890,0.00048598,92.31888237
13471,下半場,3,569893,0.00048598,92.31936835
13472,下市,3,569896,0.00048598,92.31985433
13473,下車,3,569899,0.00048598,92.32034032
13474,下放,3,569902,0.00048598,92.32082630
13475,下垂,3,569905,0.00048598,92.32131228
13476,下葬,3,569908,0.00048598,92.32179827
13477,下載,3,569911,0.00048598,92.32228425
13478,下屬,3,569914,0.00048598,92.32277023
13479,上下班,3,569917,0.00048598,92.32325621
13480,上下游,3,569920,0.00048598,92.32374220
13481,上上下下,3,569923,0.00048598,92.32422818
13482,上手,3,569926,0.00048598,92.32471416
13483,上片,3,569929,0.00048598,92.32520014
13484,上色,3,569932,0.00048598,92.32568613
13485,上衣,3,569935,0.00048598,92.32617211
13486,上陣,3,569938,0.00048598,92.32665809
13487,上野公園,3,569941,0.00048598,92.32714407
13488,上街,3,569944,0.00048598,92.32763006
13489,上訴,3,569947,0.00048598,92.32811604
13490,丸十家具,3,569950,0.00048598,92.32860202
13491,凡是,3,569953,0.00048598,92.32908800
13492,久久,3,569956,0.00048598,92.32957399
13493,久而久之,3,569959,0.00048598,92.33005997
13494,久遠,3,569962,0.00048598,92.33054595
13495,于彭,3,569965,0.00048598,92.33103194
13496,千辛萬苦,3,569968,0.00048598,92.33151792
13497,口口聲聲,3,569971,0.00048598,92.33200390
13498,口令,3,569974,0.00048598,92.33248988
13499,口舌,3,569977,0.00048598,92.33297587
13500,口徑,3,569980,0.00048598,92.33346185
13501,土地增值稅,3,569983,0.00048598,92.33394783
13502,土邦主,3,569986,0.00048598,92.33443381
13503,土城市,3,569989,0.00048598,92.33491980
13504,土庫,3,569992,0.00048598,92.33540578
13505,土庫國小,3,569995,0.00048598,92.33589176
13506,土婆,3,569998,0.00048598,92.33637774
13507,士林,3,570001,0.00048598,92.33686373
13508,士林區,3,570004,0.00048598,92.33734971
13509,大一,3,570007,0.00048598,92.33783569
13510,大不了,3,570010,0.00048598,92.33832168
13511,大日子,3,570013,0.00048598,92.33880766
13512,大王,3,570016,0.00048598,92.33929364
13513,大甲溪,3,570019,0.00048598,92.33977962
13514,大亨也瘋狂,3,570022,0.00048598,92.34026561
13515,大利,3,570025,0.00048598,92.34075159
13516,大快朵頤,3,570028,0.00048598,92.34123757
13517,大兒子,3,570031,0.00048598,92.34172355
13518,大典,3,570034,0.00048598,92.34220954
13519,大相逕庭,3,570037,0.00048598,92.34269552
13520,大致上,3,570040,0.00048598,92.34318150
13521,大英圖書館,3,570043,0.00048598,92.34366748
13522,大理石,3,570046,0.00048598,92.34415347
13523,大略,3,570049,0.00048598,92.34463945
13524,大陸人,3,570052,0.00048598,92.34512543
13525,大華證券公司,3,570055,0.00048598,92.34561141
13526,大義,3,570058,0.00048598,92.34609740
13527,大腦,3,570061,0.00048598,92.34658338
13528,大夥兒,3,570064,0.00048598,92.34706936
13529,大漢,3,570067,0.00048598,92.34755535
13530,大餅,3,570070,0.00048598,92.34804133
13531,大衛營國際俱樂部,3,570073,0.00048598,92.34852731
13532,大樹鄉,3,570076,0.00048598,92.34901329
13533,大鋼,3,570079,0.00048598,92.34949928
13534,大鵬旅遊,3,570082,0.00048598,92.34998526
13535,大寶法王,3,570085,0.00048598,92.35047124
13536,大辮子的誘惑,3,570088,0.00048598,92.35095722
13537,女人四十,3,570091,0.00048598,92.35144321
13538,女方,3,570094,0.00048598,92.35192919
13539,女主人,3,570097,0.00048598,92.35241517
13540,女伴,3,570100,0.00048598,92.35290115
13541,女郎,3,570103,0.00048598,92.35338714
13542,子孫,3,570106,0.00048598,92.35387312
13543,子宮肌瘤,3,570109,0.00048598,92.35435910
13544,小尾巴,3,570112,0.00048598,92.35484508
13545,小男孩,3,570115,0.00048598,92.35533107
13546,小型化,3,570118,0.00048598,92.35581705
13547,小看,3,570121,0.00048598,92.35630303
13548,小提琴家,3,570124,0.00048598,92.35678902
13549,小港區,3,570127,0.00048598,92.35727500
13550,小黃瓜泥,3,570130,0.00048598,92.35776098
13551,小腿,3,570133,0.00048598,92.35824696
13552,小編,3,570136,0.00048598,92.35873295
13553,山羊,3,570139,0.00048598,92.35921893
13554,山老鼠,3,570142,0.00048598,92.35970491
13555,山野,3,570145,0.00048598,92.36019089
13556,山溝,3,570148,0.00048598,92.36067688
13557,山巒,3,570151,0.00048598,92.36116286
13558,川劇,3,570154,0.00048598,92.36164884
13559,工務局長,3,570157,0.00048598,92.36213482
13560,工業革命,3,570160,0.00048598,92.36262081
13561,工蜂,3,570163,0.00048598,92.36310679
13562,已久,3,570166,0.00048598,92.36359277
13563,干,3,570169,0.00048598,92.36407876
13564,才智,3,570172,0.00048598,92.36456474
13565,才藝,3,570175,0.00048598,92.36505072
13566,不二,3,570178,0.00048598,92.36553670
13567,不分區立委,3,570181,0.00048598,92.36602269
13568,不以,3,570184,0.00048598,92.36650867
13569,不以為然,3,570187,0.00048598,92.36699465
13570,不孕症,3,570190,0.00048598,92.36748063
13571,不由得,3,570193,0.00048598,92.36796662
13572,不同凡響,3,570196,0.00048598,92.36845260
13573,不同意,3,570199,0.00048598,92.36893858
13574,不因,3,570202,0.00048598,92.36942456
13575,不死,3,570205,0.00048598,92.36991055
13576,不妥,3,570208,0.00048598,92.37039653
13577,不忍,3,570211,0.00048598,92.37088251
13578,不肖,3,570214,0.00048598,92.37136849
13579,不來,3,570217,0.00048598,92.37185448
13580,不知名,3,570220,0.00048598,92.37234046
13581,不客氣,3,570223,0.00048598,92.37282644
13582,不為所動,3,570226,0.00048598,92.37331243
13583,不相上下,3,570229,0.00048598,92.37379841
13584,不容忽視,3,570232,0.00048598,92.37428439
13585,不悅,3,570235,0.00048598,92.37477037
13586,不將,3,570238,0.00048598,92.37525636
13587,不強,3,570241,0.00048598,92.37574234
13588,不得而知,3,570244,0.00048598,92.37622832
13589,不理,3,570247,0.00048598,92.37671430
13590,不喜,3,570250,0.00048598,92.37720029
13591,不復,3,570253,0.00048598,92.37768627
13592,不減,3,570256,0.00048598,92.37817225
13593,不愁,3,570259,0.00048598,92.37865823
13594,不慎,3,570262,0.00048598,92.37914422
13595,不虞,3,570265,0.00048598,92.37963020
13596,不解,3,570268,0.00048598,92.38011618
13597,不厭,3,570271,0.00048598,92.38060216
13598,不敷,3,570274,0.00048598,92.38108815
13599,不擇手段,3,570277,0.00048598,92.38157413
13600,中下旬,3,570280,0.00048598,92.38206011
13601,中下游,3,570283,0.00048598,92.38254610
13602,中山北路,3,570286,0.00048598,92.38303208
13603,中山樓,3,570289,0.00048598,92.38351806
13604,中工,3,570292,0.00048598,92.38400404
13605,中台文教基金會,3,570295,0.00048598,92.38449003
13606,中央政府,3,570298,0.00048598,92.38497601
13607,中央研究院,3,570301,0.00048598,92.38546199
13608,中央處理器,3,570304,0.00048598,92.38594797
13609,中市,3,570307,0.00048598,92.38643396
13610,中正高中,3,570310,0.00048598,92.38691994
13611,中企,3,570313,0.00048598,92.38740592
13612,中東危機,3,570316,0.00048598,92.38789190
13613,中科院,3,570319,0.00048598,92.38837789
13614,中時周刊,3,570322,0.00048598,92.38886387
13615,中國童話,3,570325,0.00048598,92.38934985
13616,中堅,3,570328,0.00048598,92.38983584
13617,中場,3,570331,0.00048598,92.39032182
13618,中暑,3,570334,0.00048598,92.39080780
13619,中短程,3,570337,0.00048598,92.39129378
13620,中華開發,3,570340,0.00048598,92.39177977
13621,中距離,3,570343,0.00048598,92.39226575
13622,中福,3,570346,0.00048598,92.39275173
13623,中膈膜,3,570349,0.00048598,92.39323771
13624,中頻,3,570352,0.00048598,92.39372370
13625,中餐,3,570355,0.00048598,92.39420968
13626,中環公司,3,570358,0.00048598,92.39469566
13627,中聯信託公司,3,570361,0.00048598,92.39518164
13628,中醫師,3,570364,0.00048598,92.39566763
13629,中壢市公所,3,570367,0.00048598,92.39615361
13630,中壢休息站,3,570370,0.00048598,92.39663959
13631,尹啟銘,3,570373,0.00048598,92.39712557
13632,互通,3,570376,0.00048598,92.39761156
13633,互補,3,570379,0.00048598,92.39809754
13634,五花肉,3,570382,0.00048598,92.39858352
13635,仍未,3,570385,0.00048598,92.39906951
13636,元大證券,3,570388,0.00048598,92.39955549
13637,元長鄉,3,570391,0.00048598,92.40004147
13638,內文,3,570394,0.00048598,92.40052745
13639,內含,3,570397,0.00048598,92.40101344
13640,內定,3,570400,0.00048598,92.40149942
13641,內視鏡,3,570403,0.00048598,92.40198540
13642,內裝,3,570406,0.00048598,92.40247138
13643,內墊,3,570409,0.00048598,92.40295737
13644,內幕,3,570412,0.00048598,92.40344335
13645,六月政改,3,570415,0.00048598,92.40392933
13646,六道,3,570418,0.00048598,92.40441531
13647,六道淨化法,3,570421,0.00048598,92.40490130
13648,公司派,3,570424,0.00048598,92.40538728
13649,公平法,3,570427,0.00048598,92.40587326
13650,公式,3,570430,0.00048598,92.40635924
13651,公帑,3,570433,0.00048598,92.40684523
13652,公家機關,3,570436,0.00048598,92.40733121
13653,公益,3,570439,0.00048598,92.40781719
13654,公婆,3,570442,0.00048598,92.40830318
13655,公教,3,570445,0.00048598,92.40878916
13656,公開化,3,570448,0.00048598,92.40927514
13657,公聽會,3,570451,0.00048598,92.40976112
13658,分支,3,570454,0.00048598,92.41024711
13659,分貝,3,570457,0.00048598,92.41073309
13660,分居,3,570460,0.00048598,92.41121907
13661,分期,3,570463,0.00048598,92.41170505
13662,分隊,3,570466,0.00048598,92.41219104
13663,分辦,3,570469,0.00048598,92.41267702
13664,分鏡,3,570472,0.00048598,92.41316300
13665,切勿,3,570475,0.00048598,92.41364898
13666,切合,3,570478,0.00048598,92.41413497
13667,切身,3,570481,0.00048598,92.41462095
13668,切記,3,570484,0.00048598,92.41510693
13669,切除術,3,570487,0.00048598,92.41559292
13670,勻稱,3,570490,0.00048598,92.41607890
13671,勾,3,570493,0.00048598,92.41656488
13672,勾結,3,570496,0.00048598,92.41705086
13673,午后,3,570499,0.00048598,92.41753685
13674,升值,3,570502,0.00048598,92.41802283
13675,友誼,3,570505,0.00048598,92.41850881
13676,反制,3,570508,0.00048598,92.41899479
13677,反派,3,570511,0.00048598,92.41948078
13678,反面,3,570514,0.00048598,92.41996676
13679,反射率,3,570517,0.00048598,92.42045274
13680,反悔,3,570520,0.00048598,92.42093872
13681,反諷,3,570523,0.00048598,92.42142471
13682,天下電子,3,570526,0.00048598,92.42191069
13683,天天日報,3,570529,0.00048598,92.42239667
13684,天王,3,570532,0.00048598,92.42288265
13685,天主教徒,3,570535,0.00048598,92.42336864
13686,天份,3,570538,0.00048598,92.42385462
13687,天后宮,3,570541,0.00048598,92.42434060
13688,天經地義,3,570544,0.00048598,92.42482659
13689,天線,3,570547,0.00048598,92.42531257
13690,天蠍座,3,570550,0.00048598,92.42579855
13691,夫,3,570553,0.00048598,92.42628453
13692,太子,3,570556,0.00048598,92.42677052
13693,太小,3,570559,0.00048598,92.42725650
13694,太平,3,570562,0.00048598,92.42774248
13695,太平洋房屋,3,570565,0.00048598,92.42822846
13696,太平洋崇光百貨,3,570568,0.00048598,92.42871445
13697,太過,3,570571,0.00048598,92.42920043
13698,少不了,3,570574,0.00048598,92.42968641
13699,少主,3,570577,0.00048598,92.43017239
13700,尺度,3,570580,0.00048598,92.43065838
13701,尺幅,3,570583,0.00048598,92.43114436
13702,巴比基,3,570586,0.00048598,92.43163034
13703,巴西,3,570589,0.00048598,92.43211632
13704,巴塞隆納,3,570592,0.00048598,92.43260231
13705,幻象,3,570595,0.00048598,92.43308829
13706,幻象牆,3,570598,0.00048598,92.43357427
13707,幻燈片,3,570601,0.00048598,92.43406026
13708,幻覺,3,570604,0.00048598,92.43454624
13709,引以為傲,3,570607,0.00048598,92.43503222
13710,引擎蓋,3,570610,0.00048598,92.43551820
13711,引薦,3,570613,0.00048598,92.43600419
13712,心灰意冷,3,570616,0.00048598,92.43649017
13713,心防,3,570619,0.00048598,92.43697615
13714,心服口服,3,570622,0.00048598,92.43746213
13715,心型,3,570625,0.00048598,92.43794812
13716,心急如焚,3,570628,0.00048598,92.43843410
13717,心路歷程,3,570631,0.00048598,92.43892008
13718,心儀,3,570634,0.00048598,92.43940606
13719,心曠神怡,3,570637,0.00048598,92.43989205
13720,戶頭,3,570640,0.00048598,92.44037803
13721,手工藝品,3,570643,0.00048598,92.44086401
13722,手排,3,570646,0.00048598,92.44134999
13723,手袋,3,570649,0.00048598,92.44183598
13724,手部,3,570652,0.00048598,92.44232196
13725,支領,3,570655,0.00048598,92.44280794
13726,支撐點,3,570658,0.00048598,92.44329393
13727,文大培,3,570661,0.00048598,92.44377991
13728,文筆,3,570664,0.00048598,92.44426589
13729,文溫德斯,3,570667,0.00048598,92.44475187
13730,文憑,3,570670,0.00048598,92.44523786
13731,文藝界,3,570673,0.00048598,92.44572384
13732,方向盤,3,570676,0.00048598,92.44620982
13733,方興未艾,3,570679,0.00048598,92.44669580
13734,日元,3,570682,0.00048598,92.44718179
13735,日用品,3,570685,0.00048598,92.44766777
13736,日產,3,570688,0.00048598,92.44815375
13737,日照,3,570691,0.00048598,92.44863973
13738,曰,3,570694,0.00048598,92.44912572
13739,月台,3,570697,0.00048598,92.44961170
13740,月產能,3,570700,0.00048598,92.45009768
13741,木村,3,570703,0.00048598,92.45058367
13742,木雕,3,570706,0.00048598,92.45106965
13743,止痛劑,3,570709,0.00048598,92.45155563
13744,毋,3,570712,0.00048598,92.45204161
13745,比起,3,570715,0.00048598,92.45252760
13746,比爾．蓋茲,3,570718,0.00048598,92.45301358
13747,比價,3,570721,0.00048598,92.45349956
13748,比薩,3,570724,0.00048598,92.45398554
13749,毛孔,3,570727,0.00048598,92.45447153
13750,毛根,3,570730,0.00048598,92.45495751
13751,毛毯,3,570733,0.00048598,92.45544349
13752,水土,3,570736,0.00048598,92.45592947
13753,水中,3,570739,0.00048598,92.45641546
13754,水利,3,570742,0.00048598,92.45690144
13755,水利會法,3,570745,0.00048598,92.45738742
13756,水枕,3,570748,0.00048598,92.45787340
13757,水果刀,3,570751,0.00048598,92.45835939
13758,水缸,3,570754,0.00048598,92.45884537
13759,水梨,3,570757,0.00048598,92.45933135
13760,水瓶座,3,570760,0.00048598,92.45981734
13761,水晶,3,570763,0.00048598,92.46030332
13762,水道,3,570766,0.00048598,92.46078930
13763,水電,3,570769,0.00048598,92.46127528
13764,水墨畫家,3,570772,0.00048598,92.46176127
13765,火車頭,3,570775,0.00048598,92.46224725
13766,火炎山,3,570778,0.00048598,92.46273323
13767,火苗,3,570781,0.00048598,92.46321921
13768,火場,3,570784,0.00048598,92.46370520
13769,爪,3,570787,0.00048598,92.46419118
13770,父老,3,570790,0.00048598,92.46467716
13771,父親節,3,570793,0.00048598,92.46516314
13772,牙刷,3,570796,0.00048598,92.46564913
13773,牛仔布,3,570799,0.00048598,92.46613511
13774,牛皮,3,570802,0.00048598,92.46662109
13775,牛羊,3,570805,0.00048598,92.46710707
13776,牛津,3,570808,0.00048598,92.46759306
13777,王一斐,3,570811,0.00048598,92.46807904
13778,王仁孚,3,570814,0.00048598,92.46856502
13779,王文忠,3,570817,0.00048598,92.46905101
13780,王正文,3,570820,0.00048598,92.46953699
13781,王后,3,570823,0.00048598,92.47002297
13782,王位,3,570826,0.00048598,92.47050895
13783,王俊郎,3,570829,0.00048598,92.47099494
13784,王純瑞,3,570832,0.00048598,92.47148092
13785,王條圳,3,570835,0.00048598,92.47196690
13786,王船,3,570838,0.00048598,92.47245288
13787,王龍寶,3,570841,0.00048598,92.47293887
13788,世外桃源,3,570844,0.00048598,92.47342485
13789,世間,3,570847,0.00048598,92.47391083
13790,世雅,3,570850,0.00048598,92.47439681
13791,主人翁,3,570853,0.00048598,92.47488280
13792,主政,3,570856,0.00048598,92.47536878
13793,主要是,3,570859,0.00048598,92.47585476
13794,主教,3,570862,0.00048598,92.47634075
13795,主資訊,3,570865,0.00048598,92.47682673
13796,主管級,3,570868,0.00048598,92.47731271
13797,主層,3,570871,0.00048598,92.47779869
13798,主顧,3,570874,0.00048598,92.47828468
13799,乍,3,570877,0.00048598,92.47877066
13800,乏人問津,3,570880,0.00048598,92.47925664
13801,付清,3,570883,0.00048598,92.47974262
13802,付費,3,570886,0.00048598,92.48022861
13803,付費頻道,3,570889,0.00048598,92.48071459
13804,付諸,3,570892,0.00048598,92.48120057
13805,代步,3,570895,0.00048598,92.48168655
13806,代表人,3,570898,0.00048598,92.48217254
13807,代表團,3,570901,0.00048598,92.48265852
13808,仙人掌,3,570904,0.00048598,92.48314450
13809,仙境,3,570907,0.00048598,92.48363048
13810,充血,3,570910,0.00048598,92.48411647
13811,充當,3,570913,0.00048598,92.48460245
13812,兄,3,570916,0.00048598,92.48508843
13813,冬至,3,570919,0.00048598,92.48557442
13814,凹凸,3,570922,0.00048598,92.48606040
13815,凹進,3,570925,0.00048598,92.48654638
13816,出口商,3,570928,0.00048598,92.48703236
13817,出土,3,570931,0.00048598,92.48751835
13818,出乎意料,3,570934,0.00048598,92.48800433
13819,出自,3,570937,0.00048598,92.48849031
13820,出沒,3,570940,0.00048598,92.48897629
13821,出走,3,570943,0.00048598,92.48946228
13822,出具,3,570946,0.00048598,92.48994826
13823,出招,3,570949,0.00048598,92.49043424
13824,出油,3,570952,0.00048598,92.49092022
13825,出脫,3,570955,0.00048598,92.49140621
13826,出道,3,570958,0.00048598,92.49189219
13827,出價,3,570961,0.00048598,92.49237817
13828,出廠,3,570964,0.00048598,92.49286415
13829,出戰,3,570967,0.00048598,92.49335014
13830,加工絲,3,570970,0.00048598,92.49383612
13831,加成,3,570973,0.00048598,92.49432210
13832,加快,3,570976,0.00048598,92.49480809
13833,加進,3,570979,0.00048598,92.49529407
13834,加蓋,3,570982,0.00048598,92.49578005
13835,加價,3,570985,0.00048598,92.49626603
13836,功德,3,570988,0.00048598,92.49675202
13837,包心白菜,3,570991,0.00048598,92.49723800
13838,包包,3,570994,0.00048598,92.49772398
13839,包青天,3,570997,0.00048598,92.49820996
13840,包羅萬象,3,571000,0.00048598,92.49869595
13841,北京中華民族園,3,571003,0.00048598,92.49918193
13842,北京市,3,571006,0.00048598,92.49966791
13843,北河二星,3,571009,0.00048598,92.50015389
13844,北門街,3,571012,0.00048598,92.50063988
13845,北美半導體工業協會,3,571015,0.00048598,92.50112586
13846,北美洲,3,571018,0.00048598,92.50161184
13847,北海道,3,571021,0.00048598,92.50209783
13848,北側,3,571024,0.00048598,92.50258381
13849,北區,3,571027,0.00048598,92.50306979
13850,北橫,3,571030,0.00048598,92.50355577
13851,半夜,3,571033,0.00048598,92.50404176
13852,半島,3,571036,0.00048598,92.50452774
13853,卡士威,3,571039,0.00048598,92.50501372
13854,卡特,3,571042,0.00048598,92.50549970
13855,卡斯特,3,571045,0.00048598,92.50598569
13856,占岸輪,3,571048,0.00048598,92.50647167
13857,去路,3,571051,0.00048598,92.50695765
13858,可人,3,571054,0.00048598,92.50744363
13859,可口可樂,3,571057,0.00048598,92.50792962
13860,可用,3,571060,0.00048598,92.50841560
13861,可信度,3,571063,0.00048598,92.50890158
13862,可轉換公司債,3,571066,0.00048598,92.50938756
13863,古氏赤蛙,3,571069,0.00048598,92.50987355
13864,叮嚀,3,571072,0.00048598,92.51035953
13865,司,3,571075,0.00048598,92.51084551
13866,司令,3,571078,0.00048598,92.51133150
13867,司法官,3,571081,0.00048598,92.51181748
13868,另一半,3,571084,0.00048598,92.51230346
13869,只會,3,571087,0.00048598,92.51278944
13870,史威尼,3,571090,0.00048598,92.51327543
13871,史恩康納萊,3,571093,0.00048598,92.51376141
13872,史雲菲德,3,571096,0.00048598,92.51424739
13873,史樂皮,3,571099,0.00048598,92.51473337
13874,台中火車站,3,571102,0.00048598,92.51521936
13875,台中市政府,3,571105,0.00048598,92.51570534
13876,台中區,3,571108,0.00048598,92.51619132
13877,台北時間,3,571111,0.00048598,92.51667730
13878,台南縣長,3,571114,0.00048598,92.51716329
13879,台胞證,3,571117,0.00048598,92.51764927
13880,台苯,3,571120,0.00048598,92.51813525
13881,台海危機,3,571123,0.00048598,92.51862123
13882,台翔,3,571126,0.00048598,92.51910722
13883,台階,3,571129,0.00048598,92.51959320
13884,台塑集團,3,571132,0.00048598,92.52007918
13885,台橡,3,571135,0.00048598,92.52056517
13886,台糖公司,3,571138,0.00048598,92.52105115
13887,台灣大學,3,571141,0.00048598,92.52153713
13888,台灣股市,3,571144,0.00048598,92.52202311
13889,台灣問題,3,571147,0.00048598,92.52250910
13890,台灣微軟,3,571150,0.00048598,92.52299508
13891,四方,3,571153,0.00048598,92.52348106
13892,四流巨星藝術節,3,571156,0.00048598,92.52396704
13893,四相,3,571159,0.00048598,92.52445303
13894,四面八方,3,571162,0.00048598,92.52493901
13895,四條派,3,571165,0.00048598,92.52542499
13896,外地人,3,571168,0.00048598,92.52591097
13897,外省人,3,571171,0.00048598,92.52639696
13898,外婆,3,571174,0.00048598,92.52688294
13899,外傘頂洲,3,571177,0.00048598,92.52736892
13900,外資概念股,3,571180,0.00048598,92.52785491
13901,外語,3,571183,0.00048598,92.52834089
13902,外貌,3,571186,0.00048598,92.52882687
13903,外賓,3,571189,0.00048598,92.52931285
13904,失之交臂,3,571192,0.00048598,92.52979884
13905,失敗者,3,571195,0.00048598,92.53028482
13906,失意,3,571198,0.00048598,92.53077080
13907,失調,3,571201,0.00048598,92.53125678
13908,失衡,3,571204,0.00048598,92.53174277
13909,失靈,3,571207,0.00048598,92.53222875
13910,奶脹,3,571210,0.00048598,92.53271473
13911,尼泊爾,3,571213,0.00048598,92.53320071
13912,巨變,3,571216,0.00048598,92.53368670
13913,左手,3,571219,0.00048598,92.53417268
13914,左方,3,571222,0.00048598,92.53465866
13915,左岸咖啡館,3,571225,0.00048598,92.53514464
13916,左派,3,571228,0.00048598,92.53563063
13917,左訓中心,3,571231,0.00048598,92.53611661
13918,左側,3,571234,0.00048598,92.53660259
13919,市有地,3,571237,0.00048598,92.53708858
13920,市政,3,571240,0.00048598,92.53757456
13921,市警,3,571243,0.00048598,92.53806054
13922,市警局,3,571246,0.00048598,92.53854652
13923,布局,3,571249,0.00048598,92.53903251
13924,布希,3,571252,0.00048598,92.53951849
13925,布里科斯基,3,571255,0.00048598,92.54000447
13926,布拉格,3,571258,0.00048598,92.54049045
13927,布料,3,571261,0.00048598,92.54097644
13928,布袋,3,571264,0.00048598,92.54146242
13929,布農族,3,571267,0.00048598,92.54194840
13930,平反,3,571270,0.00048598,92.54243438
13931,平白,3,571273,0.00048598,92.54292037
13932,平地,3,571276,0.00048598,92.54340635
13933,平行處理,3,571279,0.00048598,92.54389233
13934,平坦,3,571282,0.00048598,92.54437831
13935,平埔,3,571285,0.00048598,92.54486430
13936,平常心,3,571288,0.00048598,92.54535028
13937,平淡,3,571291,0.00048598,92.54583626
13938,平鎮市,3,571294,0.00048598,92.54632225
13939,幼蟲,3,571297,0.00048598,92.54680823
13940,打仗,3,571300,0.00048598,92.54729421
13941,打出,3,571303,0.00048598,92.54778019
13942,打交道,3,571306,0.00048598,92.54826618
13943,打字,3,571309,0.00048598,92.54875216
13944,打字室,3,571312,0.00048598,92.54923814
13945,打官司,3,571315,0.00048598,92.54972412
13946,打拚,3,571318,0.00048598,92.55021011
13947,打消,3,571321,0.00048598,92.55069609
13948,打鬥,3,571324,0.00048598,92.55118207
13949,打動,3,571327,0.00048598,92.55166805
13950,打探,3,571330,0.00048598,92.55215404
13951,打結,3,571333,0.00048598,92.55264002
13952,打進,3,571336,0.00048598,92.55312600
13953,打鼓佬,3,571339,0.00048598,92.55361198
13954,旦,3,571342,0.00048598,92.55409797
13955,本島,3,571345,0.00048598,92.55458395
13956,未上市股票,3,571348,0.00048598,92.55506993
13957,未完成,3,571351,0.00048598,92.55555592
13958,末稍,3,571354,0.00048598,92.55604190
13959,正比,3,571357,0.00048598,92.55652788
13960,正當性,3,571360,0.00048598,92.55701386
13961,民氣,3,571363,0.00048598,92.55749985
13962,民粹,3,571366,0.00048598,92.55798583
13963,民調,3,571369,0.00048598,92.55847181
13964,永光化學,3,571372,0.00048598,92.55895779
13965,犯人,3,571375,0.00048598,92.55944378
13966,玉面戰神,3,571378,0.00048598,92.55992976
13967,玉翔公司,3,571381,0.00048598,92.56041574
13968,瓦,3,571384,0.00048598,92.56090172
13969,甘苦,3,571387,0.00048598,92.56138771
13970,生力軍,3,571390,0.00048598,92.56187369
13971,生子,3,571393,0.00048598,92.56235967
13972,生性,3,571396,0.00048598,92.56284566
13973,生活照,3,571399,0.00048598,92.56333164
13974,生根,3,571402,0.00048598,92.56381762
13975,生產期,3,571405,0.00048598,92.56430360
13976,生產量,3,571408,0.00048598,92.56478959
13977,生殖,3,571411,0.00048598,92.56527557
13978,生殖器官,3,571414,0.00048598,92.56576155
13979,用戶端,3,571417,0.00048598,92.56624753
13980,用處,3,571420,0.00048598,92.56673352
13981,用量,3,571423,0.00048598,92.56721950
13982,田紀雲,3,571426,0.00048598,92.56770548
13983,田都元帥,3,571429,0.00048598,92.56819146
13984,由此可知,3,571432,0.00048598,92.56867745
13985,由衷,3,571435,0.00048598,92.56916343
13986,白日夢,3,571438,0.00048598,92.56964941
13987,白光,3,571441,0.00048598,92.57013539
13988,白衣天使,3,571444,0.00048598,92.57062138
13989,白河鄉,3,571447,0.00048598,92.57110736
13990,白虎,3,571450,0.00048598,92.57159334
13991,白宮,3,571453,0.00048598,92.57207933
13992,白紙,3,571456,0.00048598,92.57256531
13993,白酒,3,571459,0.00048598,92.57305129
13994,白雪,3,571462,0.00048598,92.57353727
13995,白雪公主,3,571465,0.00048598,92.57402326
13996,白費,3,571468,0.00048598,92.57450924
13997,白種人,3,571471,0.00048598,92.57499522
13998,白蘿蔔,3,571474,0.00048598,92.57548120
13999,皮帶,3,571477,0.00048598,92.57596719
14000,皮球,3,571480,0.00048598,92.57645317
14001,皮膚病,3,571483,0.00048598,92.57693915
14002,皮襖,3,571486,0.00048598,92.57742513
14003,矛,3,571489,0.00048598,92.57791112
14004,石化原料,3,571492,0.00048598,92.57839710
14005,石屋,3,571495,0.00048598,92.57888308
14006,石窟,3,571498,0.00048598,92.57936906
14007,石碇,3,571501,0.00048598,92.57985505
14008,立足,3,571504,0.00048598,92.58034103
14009,立院黨團,3,571507,0.00048598,92.58082701
14010,丟棄,3,571510,0.00048598,92.58131300
14011,丟臉,3,571513,0.00048598,92.58179898
14012,交力林,3,571516,0.00048598,92.58228496
14013,交叉,3,571519,0.00048598,92.58277094
14014,交手,3,571522,0.00048598,92.58325693
14015,交出,3,571525,0.00048598,92.58374291
14016,交易員,3,571528,0.00048598,92.58422889
14017,交易量,3,571531,0.00048598,92.58471487
14018,交涉,3,571534,0.00048598,92.58520086
14019,交接典禮,3,571537,0.00048598,92.58568684
14020,交貨,3,571540,0.00048598,92.58617282
14021,交通處,3,571543,0.00048598,92.58665880
14022,交通處長,3,571546,0.00048598,92.58714479
14023,交通銀行,3,571549,0.00048598,92.58763077
14024,交換檔,3,571552,0.00048598,92.58811675
14025,交融,3,571555,0.00048598,92.58860274
14026,交錯,3,571558,0.00048598,92.58908872
14027,交錯式,3,571561,0.00048598,92.58957470
14028,交響,3,571564,0.00048598,92.59006068
14029,亦步亦趨,3,571567,0.00048598,92.59054667
14030,仿古,3,571570,0.00048598,92.59103265
14031,仿製,3,571573,0.00048598,92.59151863
14032,伊里亞德,3,571576,0.00048598,92.59200461
14033,伊拉克,3,571579,0.00048598,92.59249060
14034,伍,3,571582,0.00048598,92.59297658
14035,休瓦特,3,571585,0.00048598,92.59346256
14036,休閒車,3,571588,0.00048598,92.59394854
14037,休閒服,3,571591,0.00048598,92.59443453
14038,休學,3,571594,0.00048598,92.59492051
14039,休憩,3,571597,0.00048598,92.59540649
14040,伏擊,3,571600,0.00048598,92.59589247
14041,件事,3,571603,0.00048598,92.59637846
14042,件數,3,571606,0.00048598,92.59686444
14043,任天堂六十四,3,571609,0.00048598,92.59735042
14044,任事,3,571612,0.00048598,92.59783641
14045,任教,3,571615,0.00048598,92.59832239
14046,企業化,3,571618,0.00048598,92.59880837
14047,企業主,3,571621,0.00048598,92.59929435
14048,企業網路,3,571624,0.00048598,92.59978034
14049,企劃案,3,571627,0.00048598,92.60026632
14050,企劃部,3,571630,0.00048598,92.60075230
14051,光明面,3,571633,0.00048598,92.60123828
14052,光亮,3,571636,0.00048598,92.60172427
14053,光圈值,3,571639,0.00048598,92.60221025
14054,光復,3,571642,0.00048598,92.60269623
14055,光華,3,571645,0.00048598,92.60318221
14056,光影,3,571648,0.00048598,92.60366820
14057,光頭,3,571651,0.00048598,92.60415418
14058,兇手,3,571654,0.00048598,92.60464016
14059,全力以赴,3,571657,0.00048598,92.60512614
14060,全文檢索,3,571660,0.00048598,92.60561213
14061,全是,3,571663,0.00048598,92.60609811
14062,全副武裝,3,571666,0.00048598,92.60658409
14063,共犯,3,571669,0.00048598,92.60707008
14064,共同體,3,571672,0.00048598,92.60755606
14065,共通,3,571675,0.00048598,92.60804204
14066,再生紙,3,571678,0.00048598,92.60852802
14067,再接再厲,3,571681,0.00048598,92.60901401
14068,列席,3,571684,0.00048598,92.60949999
14069,列寧,3,571687,0.00048598,92.60998597
14070,列舉,3,571690,0.00048598,92.61047195
14071,刑事組長,3,571693,0.00048598,92.61095794
14072,刑責,3,571696,0.00048598,92.61144392
14073,刑警隊,3,571699,0.00048598,92.61192990
14074,划不來,3,571702,0.00048598,92.61241588
14075,匈牙利,3,571705,0.00048598,92.61290187
14076,印刷廠,3,571708,0.00048598,92.61338785
14077,印刷機,3,571711,0.00048598,92.61387383
14078,印第安,3,571714,0.00048598,92.61435982
14079,危急,3,571717,0.00048598,92.61484580
14080,吉姆,3,571720,0.00048598,92.61533178
14081,同日而語,3,571723,0.00048598,92.61581776
14082,同名同姓,3,571726,0.00048598,92.61630375
14083,同安段,3,571729,0.00048598,92.61678973
14084,同志,3,571732,0.00048598,92.61727571
14085,同級車,3,571735,0.00048598,92.61776169
14086,同樂,3,571738,0.00048598,92.61824768
14087,各式,3,571741,0.00048598,92.61873366
14088,各類,3,571744,0.00048598,92.61921964
14089,向日葵,3,571747,0.00048598,92.61970562
14090,名山,3,571750,0.00048598,92.62019161
14091,名冊,3,571753,0.00048598,92.62067759
14092,名列前茅,3,571756,0.00048598,92.62116357
14093,名曲,3,571759,0.00048598,92.62164955
14094,名言,3,571762,0.00048598,92.62213554
14095,名家,3,571765,0.00048598,92.62262152
14096,名著,3,571768,0.00048598,92.62310750
14097,名間鄉,3,571771,0.00048598,92.62359349
14098,名號,3,571774,0.00048598,92.62407947
14099,名醫,3,571777,0.00048598,92.62456545
14100,合作金庫,3,571780,0.00048598,92.62505143
14101,合作案,3,571783,0.00048598,92.62553742
14102,合法化,3,571786,0.00048598,92.62602340
14103,合建分售,3,571789,0.00048598,92.62650938
14104,合眾國際社,3,571792,0.00048598,92.62699536
14105,合組,3,571795,0.00048598,92.62748135
14106,合群,3,571798,0.00048598,92.62796733
14107,合資公司,3,571801,0.00048598,92.62845331
14108,吃水,3,571804,0.00048598,92.62893929
14109,吃喝玩樂,3,571807,0.00048598,92.62942528
14110,吃虧,3,571810,0.00048598,92.62991126
14111,因子,3,571813,0.00048598,92.63039724
14112,回函,3,571816,0.00048598,92.63088322
14113,回呼函式,3,571819,0.00048598,92.63136921
14114,回信,3,571822,0.00048598,92.63185519
14115,回春,3,571825,0.00048598,92.63234117
14116,回音,3,571828,0.00048598,92.63282716
14117,回首,3,571831,0.00048598,92.63331314
14118,回饋金,3,571834,0.00048598,92.63379912
14119,地上權,3,571837,0.00048598,92.63428510
14120,地方政府,3,571840,0.00048598,92.63477109
14121,地光明,3,571843,0.00048598,92.63525707
14122,地址簿,3,571846,0.00048598,92.63574305
14123,地表,3,571849,0.00048598,92.63622903
14124,地基,3,571852,0.00048598,92.63671502
14125,地產,3,571855,0.00048598,92.63720100
14126,地標,3,571858,0.00048598,92.63768698
14127,地鐵,3,571861,0.00048598,92.63817296
14128,在押,3,571864,0.00048598,92.63865895
14129,在於,3,571867,0.00048598,92.63914493
14130,在逃,3,571870,0.00048598,92.63963091
14131,多多少少,3,571873,0.00048598,92.64011690
14132,多此一舉,3,571876,0.00048598,92.64060288
14133,多角化,3,571879,0.00048598,92.64108886
14134,多采多姿,3,571882,0.00048598,92.64157484
14135,多貢人,3,571885,0.00048598,92.64206083
14136,多媒體資料庫,3,571888,0.00048598,92.64254681
14137,多媒體電腦,3,571891,0.00048598,92.64303279
14138,多項,3,571894,0.00048598,92.64351877
14139,多樣,3,571897,0.00048598,92.64400476
14140,多變,3,571900,0.00048598,92.64449074
14141,妄想,3,571903,0.00048598,92.64497672
14142,好久,3,571906,0.00048598,92.64546270
14143,好不好,3,571909,0.00048598,92.64594869
14144,好手,3,571912,0.00048598,92.64643467
14145,好似,3,571915,0.00048598,92.64692065
14146,好事,3,571918,0.00048598,92.64740663
14147,好朋友,3,571921,0.00048598,92.64789262
14148,好運,3,571924,0.00048598,92.64837860
14149,如下,3,571927,0.00048598,92.64886458
14150,如魚得水,3,571930,0.00048598,92.64935057
14151,如願,3,571933,0.00048598,92.64983655
14152,字形,3,571936,0.00048598,92.65032253
14153,字條,3,571939,0.00048598,92.65080851
14154,字畫,3,571942,0.00048598,92.65129450
14155,存放比率,3,571945,0.00048598,92.65178048
14156,存活率,3,571948,0.00048598,92.65226646
14157,存託憑證,3,571951,0.00048598,92.65275244
14158,守門人,3,571954,0.00048598,92.65323843
14159,守望相助,3,571957,0.00048598,92.65372441
14160,安然,3,571960,0.00048598,92.65421039
14161,安逸,3,571963,0.00048598,92.65469637
14162,安寧,3,571966,0.00048598,92.65518236
14163,安樂,3,571969,0.00048598,92.65566834
14164,安樂死,3,571972,0.00048598,92.65615432
14165,安徽,3,571975,0.00048598,92.65664030
14166,安穩,3,571978,0.00048598,92.65712629
14167,年利率,3,571981,0.00048598,92.65761227
14168,年長者,3,571984,0.00048598,92.65809825
14169,年終獎金,3,571987,0.00048598,92.65858424
14170,年華,3,571990,0.00048598,92.65907022
14171,年頭,3,571993,0.00048598,92.65955620
14172,年營收額,3,571996,0.00048598,92.66004218
14173,年營業額,3,571999,0.00048598,92.66052817
14174,成千上萬,3,572002,0.00048598,92.66101415
14175,成軍,3,572005,0.00048598,92.66150013
14176,成熟度,3,572008,0.00048598,92.66198611
14177,扣除,3,572011,0.00048598,92.66247210
14178,托斯卡尼尼,3,572014,0.00048598,92.66295808
14179,托爾斯泰,3,572017,0.00048598,92.66344406
14180,收入性,3,572020,0.00048598,92.66393004
14181,收成,3,572023,0.00048598,92.66441603
14182,收放自如,3,572026,0.00048598,92.66490201
14183,收音機,3,572029,0.00048598,92.66538799
14184,收視群,3,572032,0.00048598,92.66587397
14185,收集品,3,572035,0.00048598,92.66635996
14186,早先,3,572038,0.00048598,92.66684594
14187,早安,3,572041,0.00048598,92.66733192
14188,曲作,3,572044,0.00048598,92.66781791
14189,曲折,3,572047,0.00048598,92.66830389
14190,有心人士,3,572050,0.00048598,92.66878987
14191,有史以來,3,572053,0.00048598,92.66927585
14192,有如,3,572056,0.00048598,92.66976184
14193,有害,3,572059,0.00048598,92.67024782
14194,有驚無險,3,572062,0.00048598,92.67073380
14195,朱宗慶打擊樂團,3,572065,0.00048598,92.67121978
14196,朱道平,3,572068,0.00048598,92.67170577
14197,次序,3,572071,0.00048598,92.67219175
14198,次要,3,572074,0.00048598,92.67267773
14199,此起彼落,3,572077,0.00048598,92.67316371
14200,死因,3,572080,0.00048598,92.67364970
14201,死巷,3,572083,0.00048598,92.67413568
14202,汙染源,3,572086,0.00048598,92.67462166
14203,江李體制,3,572089,0.00048598,92.67510765
14204,江英村,3,572092,0.00048598,92.67559363
14205,池水,3,572095,0.00048598,92.67607961
14206,污垢,3,572098,0.00048598,92.67656559
14207,百合,3,572101,0.00048598,92.67705158
14208,百帝,3,572104,0.00048598,92.67753756
14209,百般,3,572107,0.00048598,92.67802354
14210,竹東,3,572110,0.00048598,92.67850952
14211,竹崎,3,572113,0.00048598,92.67899551
14212,竹湖,3,572116,0.00048598,92.67948149
14213,竹籐家具,3,572119,0.00048598,92.67996747
14214,米酒,3,572122,0.00048598,92.68045345
14215,米飯,3,572125,0.00048598,92.68093944
14216,羊角,3,572128,0.00048598,92.68142542
14217,羽田,3,572131,0.00048598,92.68191140
14218,老人家,3,572134,0.00048598,92.68239738
14219,老天,3,572137,0.00048598,92.68288337
14220,老太太,3,572140,0.00048598,92.68336935
14221,老少,3,572143,0.00048598,92.68385533
14222,老手,3,572146,0.00048598,92.68434132
14223,老兄,3,572149,0.00048598,92.68482730
14224,老外,3,572152,0.00048598,92.68531328
14225,老同學,3,572155,0.00048598,92.68579926
14226,老年痴呆症,3,572158,0.00048598,92.68628525
14227,老氣,3,572161,0.00048598,92.68677123
14228,考上,3,572164,0.00048598,92.68725721
14229,考古,3,572167,0.00048598,92.68774319
14230,考證,3,572170,0.00048598,92.68822918
14231,耳熟能詳,3,572173,0.00048598,92.68871516
14232,耳環,3,572176,0.00048598,92.68920114
14233,肉絲,3,572179,0.00048598,92.68968712
14234,自力救濟,3,572182,0.00048598,92.69017311
14235,自由自在,3,572185,0.00048598,92.69065909
14236,自由派,3,572188,0.00048598,92.69114507
14237,自白,3,572191,0.00048598,92.69163105
14238,自成,3,572194,0.00048598,92.69211704
14239,自行車,3,572197,0.00048598,92.69260302
14240,自助餐式福利制度,3,572200,0.00048598,92.69308900
14241,自命,3,572203,0.00048598,92.69357499
14242,自拔,3,572206,0.00048598,92.69406097
14243,自信心,3,572209,0.00048598,92.69454695
14244,自律,3,572212,0.00048598,92.69503293
14245,自律公約,3,572215,0.00048598,92.69551892
14246,自省,3,572218,0.00048598,92.69600490
14247,自首,3,572221,0.00048598,92.69649088
14248,自尊,3,572224,0.00048598,92.69697686
14249,自尊心,3,572227,0.00048598,92.69746285
14250,自豪,3,572230,0.00048598,92.69794883
14251,至上,3,572233,0.00048598,92.69843481
14252,舌,3,572236,0.00048598,92.69892079
14253,艾克曼,3,572239,0.00048598,92.69940678
14254,艾迪墨菲,3,572242,0.00048598,92.69989276
14255,艾莉絲,3,572245,0.00048598,92.70037874
14256,艾醇,3,572248,0.00048598,92.70086473
14257,血肉,3,572251,0.00048598,92.70135071
14258,血型,3,572254,0.00048598,92.70183669
14259,血案,3,572257,0.00048598,92.70232267
14260,血球,3,572260,0.00048598,92.70280866
14261,血統,3,572263,0.00048598,92.70329464
14262,行凶,3,572266,0.00048598,92.70378062
14263,行李,3,572269,0.00048598,92.70426660
14264,行政院新聞局,3,572272,0.00048598,92.70475259
14265,行徑,3,572275,0.00048598,92.70523857
14266,行進,3,572278,0.00048598,92.70572455
14267,行照,3,572281,0.00048598,92.70621053
14268,行路,3,572284,0.00048598,92.70669652
14269,行囊,3,572287,0.00048598,92.70718250
14270,西片,3,572290,0.00048598,92.70766848
14271,西瓜,3,572293,0.00048598,92.70815446
14272,西伯利亞,3,572296,0.00048598,92.70864045
14273,西岸,3,572299,0.00048598,92.70912643
14274,西洋,3,572302,0.00048598,92.70961241
14275,西雅圖,3,572305,0.00048598,92.71009840
14276,西餐廳,3,572308,0.00048598,92.71058438
14277,西螺鎮,3,572311,0.00048598,92.71107036
14278,西藥,3,572314,0.00048598,92.71155634
14279,住友商事,3,572317,0.00048598,92.71204233
14280,住民,3,572320,0.00048598,92.71252831
14281,佇足,3,572323,0.00048598,92.71301429
14282,佗,3,572326,0.00048598,92.71350027
14283,佛洛伊德,3,572329,0.00048598,92.71398626
14284,佛教界,3,572332,0.00048598,92.71447224
14285,佛斯特,3,572335,0.00048598,92.71495822
14286,何國華,3,572338,0.00048598,92.71544420
14287,何清輝,3,572341,0.00048598,92.71593019
14288,佐,3,572344,0.00048598,92.71641617
14289,佐丹奴,3,572347,0.00048598,92.71690215
14290,佐證,3,572350,0.00048598,92.71738813
14291,伺服,3,572353,0.00048598,92.71787412
14292,伸直,3,572356,0.00048598,92.71836010
14293,伸張,3,572359,0.00048598,92.71884608
14294,佔地,3,572362,0.00048598,92.71933207
14295,佔據,3,572365,0.00048598,92.71981805
14296,但書,3,572368,0.00048598,92.72030403
14297,佣金,3,572371,0.00048598,92.72079001
14298,作曲,3,572374,0.00048598,92.72127600
14299,作秀,3,572377,0.00048598,92.72176198
14300,作祟,3,572380,0.00048598,92.72224796
14301,作畫,3,572383,0.00048598,92.72273394
14302,你我,3,572386,0.00048598,92.72321993
14303,伯達拉,3,572389,0.00048598,92.72370591
14304,低等,3,572392,0.00048598,92.72419189
14305,余陳月瑛,3,572395,0.00048598,92.72467787
14306,佈署,3,572398,0.00048598,92.72516386
14307,克里姆林宮,3,572401,0.00048598,92.72564984
14308,克拉克,3,572404,0.00048598,92.72613582
14309,克勒斯科,3,572407,0.00048598,92.72662181
14310,克雷斯,3,572410,0.00048598,92.72710779
14311,克魯格國家公園,3,572413,0.00048598,92.72759377
14312,克蘭詩,3,572416,0.00048598,92.72807975
14313,冷冷,3,572419,0.00048598,92.72856574
14314,冷氣房,3,572422,0.00048598,92.72905172
14315,冷酷,3,572425,0.00048598,92.72953770
14316,冷藏,3,572428,0.00048598,92.73002368
14317,冷藏庫,3,572431,0.00048598,92.73050967
14318,別出心裁,3,572434,0.00048598,92.73099565
14319,別有洞天,3,572437,0.00048598,92.73148163
14320,別針,3,572440,0.00048598,92.73196761
14321,利率期貨,3,572443,0.00048598,92.73245360
14322,利器,3,572446,0.00048598,92.73293958
14323,刪,3,572449,0.00048598,92.73342556
14324,助力,3,572452,0.00048598,92.73391154
14325,助選,3,572455,0.00048598,92.73439753
14326,即席,3,572458,0.00048598,92.73488351
14327,即興,3,572461,0.00048598,92.73536949
14328,卵子,3,572464,0.00048598,92.73585548
14329,呆滯,3,572467,0.00048598,92.73634146
14330,吳中書,3,572470,0.00048598,92.73682744
14331,吳美雲,3,572473,0.00048598,92.73731342
14332,吳家麗,3,572476,0.00048598,92.73779941
14333,吳祥木,3,572479,0.00048598,92.73828539
14334,吳榮錄,3,572482,0.00048598,92.73877137
14335,呈遞,3,572485,0.00048598,92.73925735
14336,呈獻,3,572488,0.00048598,92.73974334
14337,呂龍雄,3,572491,0.00048598,92.74022932
14338,告假,3,572494,0.00048598,92.74071530
14339,吸塵器,3,572497,0.00048598,92.74120128
14340,吵雜,3,572500,0.00048598,92.74168727
14341,吼叫,3,572503,0.00048598,92.74217325
14342,困局,3,572506,0.00048598,92.74265923
14343,坎城,3,572509,0.00048598,92.74314521
14344,坐落,3,572512,0.00048598,92.74363120
14345,壯大,3,572515,0.00048598,92.74411718
14346,妙樂,3,572518,0.00048598,92.74460316
14347,孝順,3,572521,0.00048598,92.74508915
14348,完全性,3,572524,0.00048598,92.74557513
14349,宋時選,3,572527,0.00048598,92.74606111
14350,宏偉,3,572530,0.00048598,92.74654709
14351,宏國隊,3,572533,0.00048598,92.74703308
14352,宏福隊,3,572536,0.00048598,92.74751906
14353,局限,3,572539,0.00048598,92.74800504
14354,局部性,3,572542,0.00048598,92.74849102
14355,巫俊秀,3,572545,0.00048598,92.74897701
14356,希特勒,3,572548,0.00048598,92.74946299
14357,床位,3,572551,0.00048598,92.74994897
14358,床單,3,572554,0.00048598,92.75043495
14359,弟,3,572557,0.00048598,92.75092094
14360,形同,3,572560,0.00048598,92.75140692
14361,形體,3,572563,0.00048598,92.75189290
14362,彷如,3,572566,0.00048598,92.75237889
14363,忘我,3,572569,0.00048598,92.75286487
14364,忌諱,3,572572,0.00048598,92.75335085
14365,忍耐,3,572575,0.00048598,92.75383683
14366,快快,3,572578,0.00048598,92.75432282
14367,戒備,3,572581,0.00048598,92.75480880
14368,技術移民,3,572584,0.00048598,92.75529478
14369,扭傷,3,572587,0.00048598,92.75578076
14370,扼腕,3,572590,0.00048598,92.75626675
14371,找回,3,572593,0.00048598,92.75675273
14372,折價,3,572596,0.00048598,92.75723871
14373,折價券,3,572599,0.00048598,92.75772469
14374,折舊,3,572602,0.00048598,92.75821068
14375,扮裝,3,572605,0.00048598,92.75869666
14376,投下,3,572608,0.00048598,92.75918264
14377,投票日,3,572611,0.00048598,92.75966862
14378,投開票所,3,572614,0.00048598,92.76015461
14379,投機客,3,572617,0.00048598,92.76064059
14380,投籃,3,572620,0.00048598,92.76112657
14381,抑鬱症,3,572623,0.00048598,92.76161256
14382,改寫,3,572626,0.00048598,92.76209854
14383,改觀,3,572629,0.00048598,92.76258452
14384,攻防戰,3,572632,0.00048598,92.76307050
14385,攻訐,3,572635,0.00048598,92.76355649
14386,旱,3,572638,0.00048598,92.76404247
14387,更年期,3,572641,0.00048598,92.76452845
14388,李文智,3,572644,0.00048598,92.76501443
14389,李文雄,3,572647,0.00048598,92.76550042
14390,李文興,3,572650,0.00048598,92.76598640
14391,李光耀,3,572653,0.00048598,92.76647238
14392,李成祿,3,572656,0.00048598,92.76695836
14393,李志希,3,572659,0.00048598,92.76744435
14394,李保田,3,572662,0.00048598,92.76793033
14395,李進勇,3,572665,0.00048598,92.76841631
14396,李順德,3,572668,0.00048598,92.76890229
14397,李煥,3,572671,0.00048598,92.76938828
14398,李瑞木,3,572674,0.00048598,92.76987426
14399,李瑞環,3,572677,0.00048598,92.77036024
14400,村人,3,572680,0.00048598,92.77084623
14401,杜培,3,572683,0.00048598,92.77133221
14402,步步,3,572686,0.00048598,92.77181819
14403,步徑,3,572689,0.00048598,92.77230417
14404,求售,3,572692,0.00048598,92.77279016
14405,求職,3,572695,0.00048598,92.77327614
14406,沙里曼,3,572698,0.00048598,92.77376212
14407,沙洲,3,572701,0.00048598,92.77424810
14408,沙崙,3,572704,0.00048598,92.77473409
14409,沙盤推演,3,572707,0.00048598,92.77522007
14410,沈浸,3,572710,0.00048598,92.77570605
14411,沈寂,3,572713,0.00048598,92.77619203
14412,沈痛,3,572716,0.00048598,92.77667802
14413,沈穩,3,572719,0.00048598,92.77716400
14414,沉浸,3,572722,0.00048598,92.77764998
14415,決斷力,3,572725,0.00048598,92.77813596
14416,決議案,3,572728,0.00048598,92.77862195
14417,汰舊換新,3,572731,0.00048598,92.77910793
14418,沒人,3,572734,0.00048598,92.77959391
14419,沒完沒了,3,572737,0.00048598,92.78007990
14420,汽車文化,3,572740,0.00048598,92.78056588
14421,汽車業,3,572743,0.00048598,92.78105186
14422,汽油添加劑,3,572746,0.00048598,92.78153784
14423,汶萊,3,572749,0.00048598,92.78202383
14424,灼傷,3,572752,0.00048598,92.78250981
14425,災害,3,572755,0.00048598,92.78299579
14426,牢,3,572758,0.00048598,92.78348177
14427,牢記,3,572761,0.00048598,92.78396776
14428,狂想,3,572764,0.00048598,92.78445374
14429,男妓,3,572767,0.00048598,92.78493972
14430,私交,3,572770,0.00048598,92.78542570
14431,私自,3,572773,0.00048598,92.78591169
14432,私房錢,3,572776,0.00048598,92.78639767
14433,秀姑巒溪,3,572779,0.00048598,92.78688365
14434,究辦,3,572782,0.00048598,92.78736964
14435,系主任,3,572785,0.00048598,92.78785562
14436,肝硬化,3,572788,0.00048598,92.78834160
14437,肛門,3,572791,0.00048598,92.78882758
14438,肚,3,572794,0.00048598,92.78931357
14439,良知,3,572797,0.00048598,92.78979955
14440,良善,3,572800,0.00048598,92.79028553
14441,良機,3,572803,0.00048598,92.79077151
14442,角頭,3,572806,0.00048598,92.79125750
14443,言行,3,572809,0.00048598,92.79174348
14444,言談,3,572812,0.00048598,92.79222946
14445,貝托魯奇,3,572815,0.00048598,92.79271544
14446,貝克,3,572818,0.00048598,92.79320143
14447,貝殼,3,572821,0.00048598,92.79368741
14448,赤,3,572824,0.00048598,92.79417339
14449,走回,3,572827,0.00048598,92.79465937
14450,走馬看花,3,572830,0.00048598,92.79514536
14451,身姿,3,572833,0.00048598,92.79563134
14452,身後,3,572836,0.00048598,92.79611732
14453,身歷其境,3,572839,0.00048598,92.79660331
14454,身體力行,3,572842,0.00048598,92.79708929
14455,車行,3,572845,0.00048598,92.79757527
14456,車行地下道,3,572848,0.00048598,92.79806125
14457,車陣,3,572851,0.00048598,92.79854724
14458,車隊,3,572854,0.00048598,92.79903322
14459,車資,3,572857,0.00048598,92.79951920
14460,車漆,3,572860,0.00048598,92.80000518
14461,車壇,3,572863,0.00048598,92.80049117
14462,車頭,3,572866,0.00048598,92.80097715
14463,辛,3,572869,0.00048598,92.80146313
14464,迅,3,572872,0.00048598,92.80194911
14465,巡防艦隊,3,572875,0.00048598,92.80243510
14466,邪,3,572878,0.00048598,92.80292108
14467,那種,3,572881,0.00048598,92.80340706
14468,里斯本,3,572884,0.00048598,92.80389304
14469,里程,3,572887,0.00048598,92.80437903
14470,里程碑,3,572890,0.00048598,92.80486501
14471,防水氣密提箱,3,572893,0.00048598,92.80535099
14472,防火纖維,3,572896,0.00048598,92.80583698
14473,防颱,3,572899,0.00048598,92.80632296
14474,乳汁,3,572902,0.00048598,92.80680894
14475,乳癌,3,572905,0.00048598,92.80729492
14476,事務所,3,572908,0.00048598,92.80778091
14477,事態,3,572911,0.00048598,92.80826689
14478,事端,3,572914,0.00048598,92.80875287
14479,事蹟,3,572917,0.00048598,92.80923885
14480,亞太空運中心,3,572920,0.00048598,92.80972484
14481,亞東,3,572923,0.00048598,92.81021082
14482,亞泥,3,572926,0.00048598,92.81069680
14483,亞洲杯,3,572929,0.00048598,92.81118278
14484,享年,3,572932,0.00048598,92.81166877
14485,京都,3,572935,0.00048598,92.81215475
14486,使用手冊,3,572938,0.00048598,92.81264073
14487,使用率,3,572941,0.00048598,92.81312672
14488,使用權,3,572944,0.00048598,92.81361270
14489,供詞,3,572947,0.00048598,92.81409868
14490,例行賽,3,572950,0.00048598,92.81458466
14491,來函,3,572953,0.00048598,92.81507065
14492,來往,3,572956,0.00048598,92.81555663
14493,來看,3,572959,0.00048598,92.81604261
14494,來得及,3,572962,0.00048598,92.81652859
14495,來勢洶洶,3,572965,0.00048598,92.81701458
14496,來說,3,572968,0.00048598,92.81750056
14497,來龍去脈,3,572971,0.00048598,92.81798654
14498,佩戴,3,572974,0.00048598,92.81847252
14499,兩岸關係,3,572977,0.00048598,92.81895851
14500,兩性關係,3,572980,0.00048598,92.81944449
14501,兩極,3,572983,0.00048598,92.81993047
14502,具象,3,572986,0.00048598,92.82041645
14503,其間,3,572989,0.00048598,92.82090244
14504,典故,3,572992,0.00048598,92.82138842
14505,券商,3,572995,0.00048598,92.82187440
14506,刷頭,3,572998,0.00048598,92.82236039
14507,到時候,3,573001,0.00048598,92.82284637
14508,到頭來,3,573004,0.00048598,92.82333235
14509,刮痕,3,573007,0.00048598,92.82381833
14510,制止,3,573010,0.00048598,92.82430432
14511,制伏,3,573013,0.00048598,92.82479030
14512,制式,3,573016,0.00048598,92.82527628
14513,協,3,573019,0.00048598,92.82576226
14514,協力,3,573022,0.00048598,92.82624825
14515,協調會,3,573025,0.00048598,92.82673423
14516,卷軸,3,573028,0.00048598,92.82722021
14517,取名,3,573031,0.00048598,92.82770619
14518,取回,3,573034,0.00048598,92.82819218
14519,取而代之,3,573037,0.00048598,92.82867816
14520,受孕,3,573040,0.00048598,92.82916414
14521,受刑人,3,573043,0.00048598,92.82965012
14522,受災戶,3,573046,0.00048598,92.83013611
14523,受訓,3,573049,0.00048598,92.83062209
14524,受創,3,573052,0.00048598,92.83110807
14525,受罰,3,573055,0.00048598,92.83159406
14526,受熱,3,573058,0.00048598,92.83208004
14527,味噌,3,573061,0.00048598,92.83256602
14528,咖啡因,3,573064,0.00048598,92.83305200
14529,呻吟,3,573067,0.00048598,92.83353799
14530,咒,3,573070,0.00048598,92.83402397
14531,和式,3,573073,0.00048598,92.83450995
14532,和局,3,573076,0.00048598,92.83499593
14533,和新,3,573079,0.00048598,92.83548192
14534,和煦,3,573082,0.00048598,92.83596790
14535,周正之,3,573085,0.00048598,92.83645388
14536,周全,3,573088,0.00048598,92.83693986
14537,周星馳,3,573091,0.00048598,92.83742585
14538,周處,3,573094,0.00048598,92.83791183
14539,固守,3,573097,0.00048598,92.83839781
14540,固執,3,573100,0.00048598,92.83888380
14541,垃圾車,3,573103,0.00048598,92.83936978
14542,垃圾掩埋場,3,573106,0.00048598,92.83985576
14543,垃圾場,3,573109,0.00048598,92.84034174
14544,坦尚尼亞,3,573112,0.00048598,92.84082773
14545,夜歸,3,573115,0.00048598,92.84131371
14546,奉安,3,573118,0.00048598,92.84179969
14547,奈洛比國家公園,3,573121,0.00048598,92.84228567
14548,委,3,573124,0.00048598,92.84277166
14549,始末,3,573127,0.00048598,92.84325764
14550,始作俑者,3,573130,0.00048598,92.84374362
14551,孟,3,573133,0.00048598,92.84422960
14552,孟買,3,573136,0.00048598,92.84471559
14553,孟廣,3,573139,0.00048598,92.84520157
14554,孤,3,573142,0.00048598,92.84568755
14555,孤兒,3,573145,0.00048598,92.84617353
14556,季刊,3,573148,0.00048598,92.84665952
14557,宗教性,3,573151,0.00048598,92.84714550
14558,定名,3,573154,0.00048598,92.84763148
14559,定期定額信託,3,573157,0.00048598,92.84811747
14560,定影液,3,573160,0.00048598,92.84860345
14561,定儲,3,573163,0.00048598,92.84908943
14562,官位,3,573166,0.00048598,92.84957541
14563,宜佳,3,573169,0.00048598,92.85006140
14564,尚可,3,573172,0.00048598,92.85054738
14565,尚克勞德范達美,3,573175,0.00048598,92.85103336
14566,屈臣氏,3,573178,0.00048598,92.85151934
14567,屈居,3,573181,0.00048598,92.85200533
14568,岳父,3,573184,0.00048598,92.85249131
14569,店員,3,573187,0.00048598,92.85297729
14570,店家,3,573190,0.00048598,92.85346327
14571,底盤,3,573193,0.00048598,92.85394926
14572,延請,3,573196,0.00048598,92.85443524
14573,往日,3,573199,0.00048598,92.85492122
14574,往前,3,573202,0.00048598,92.85540720
14575,忠誠,3,573205,0.00048598,92.85589319
14576,念書,3,573208,0.00048598,92.85637917
14577,怪事,3,573211,0.00048598,92.85686515
14578,怡,3,573214,0.00048598,92.85735114
14579,性病,3,573217,0.00048598,92.85783712
14580,性感帶,3,573220,0.00048598,92.85832310
14581,或多或少,3,573223,0.00048598,92.85880908
14582,房門,3,573226,0.00048598,92.85929507
14583,所致,3,573229,0.00048598,92.85978105
14584,所說,3,573232,0.00048598,92.86026703
14585,承建,3,573235,0.00048598,92.86075301
14586,承德路,3,573238,0.00048598,92.86123900
14587,承銷,3,573241,0.00048598,92.86172498
14588,拉丁美洲,3,573244,0.00048598,92.86221096
14589,拉努拉,3,573247,0.00048598,92.86269694
14590,拉近,3,573250,0.00048598,92.86318293
14591,拉桿,3,573253,0.00048598,92.86366891
14592,拉斯維加斯,3,573256,0.00048598,92.86415489
14593,拉赫曼尼諾夫,3,573259,0.00048598,92.86464088
14594,拉鋸戰,3,573262,0.00048598,92.86512686
14595,拌勻,3,573265,0.00048598,92.86561284
14596,拂,3,573268,0.00048598,92.86609882
14597,招三聖宮,3,573271,0.00048598,92.86658481
14598,招手,3,573274,0.00048598,92.86707079
14599,招考,3,573277,0.00048598,92.86755677
14600,招來,3,573280,0.00048598,92.86804275
14601,招致,3,573283,0.00048598,92.86852874
14602,招攬,3,573286,0.00048598,92.86901472
14603,披,3,573289,0.00048598,92.86950070
14604,披薩,3,573292,0.00048598,92.86998668
14605,披露,3,573295,0.00048598,92.87047267
14606,拋開,3,573298,0.00048598,92.87095865
14607,抽水,3,573301,0.00048598,92.87144463
14608,抽水機,3,573304,0.00048598,92.87193061
14609,抽查,3,573307,0.00048598,92.87241660
14610,抽菸,3,573310,0.00048598,92.87290258
14611,抽搐,3,573313,0.00048598,92.87338856
14612,拐杖,3,573316,0.00048598,92.87387455
14613,拍拍,3,573319,0.00048598,92.87436053
14614,拍賣場,3,573322,0.00048598,92.87484651
14615,拍戲,3,573325,0.00048598,92.87533249
14616,抵制,3,573328,0.00048598,92.87581848
14617,抵押,3,573331,0.00048598,92.87630446
14618,拘,3,573334,0.00048598,92.87679044
14619,拘束,3,573337,0.00048598,92.87727642
14620,拘泥,3,573340,0.00048598,92.87776241
14621,拖吊,3,573343,0.00048598,92.87824839
14622,拖車,3,573346,0.00048598,92.87873437
14623,拖拖拉拉,3,573349,0.00048598,92.87922035
14624,拖累,3,573352,0.00048598,92.87970634
14625,拆穿,3,573355,0.00048598,92.88019232
14626,拆款,3,573358,0.00048598,92.88067830
14627,放水燈,3,573361,0.00048598,92.88116428
14628,放射,3,573364,0.00048598,92.88165027
14629,放射線,3,573367,0.00048598,92.88213625
14630,放眼,3,573370,0.00048598,92.88262223
14631,放縱,3,573373,0.00048598,92.88310822
14632,昔,3,573376,0.00048598,92.88359420
14633,昆布,3,573379,0.00048598,92.88408018
14634,昂,3,573382,0.00048598,92.88456616
14635,明月,3,573385,0.00048598,92.88505215
14636,明媚,3,573388,0.00048598,92.88553813
14637,明暗,3,573391,0.00048598,92.88602411
14638,昏,3,573394,0.00048598,92.88651009
14639,昏睡,3,573397,0.00048598,92.88699608
14640,昇華,3,573400,0.00048598,92.88748206
14641,服飾店,3,573403,0.00048598,92.88796804
14642,杭州,3,573406,0.00048598,92.88845402
14643,枋寮,3,573409,0.00048598,92.88894001
14644,東山島,3,573412,0.00048598,92.88942599
14645,東方介德,3,573415,0.00048598,92.88991197
14646,東石西運,3,573418,0.00048598,92.89039795
14647,東企,3,573421,0.00048598,92.89088394
14648,東西方,3,573424,0.00048598,92.89136992
14649,東南,3,573427,0.00048598,92.89185590
14650,東南方,3,573430,0.00048598,92.89234189
14651,東映公司,3,573433,0.00048598,92.89282787
14652,東家,3,573436,0.00048598,92.89331385
14653,東莞,3,573439,0.00048598,92.89379983
14654,東部鐵路改善計畫,3,573442,0.00048598,92.89428582
14655,果菜,3,573445,0.00048598,92.89477180
14656,林子翼,3,573448,0.00048598,92.89525778
14657,林中禮,3,573451,0.00048598,92.89574376
14658,林仲秋,3,573454,0.00048598,92.89622975
14659,林亨能,3,573457,0.00048598,92.89671573
14660,林柏榕,3,573460,0.00048598,92.89720171
14661,林郝配,3,573463,0.00048598,92.89768769
14662,林意誠,3,573466,0.00048598,92.89817368
14663,林德雄,3,573469,0.00048598,92.89865966
14664,板子,3,573472,0.00048598,92.89914564
14665,板橋市公所,3,573475,0.00048598,92.89963163
14666,松子,3,573478,0.00048598,92.90011761
14667,松山分局長,3,573481,0.00048598,92.90060359
14668,欣欣,3,573484,0.00048598,92.90108957
14669,欣欣向榮,3,573487,0.00048598,92.90157556
14670,欣喜,3,573490,0.00048598,92.90206154
14671,欣然,3,573493,0.00048598,92.90254752
14672,武三級,3,573496,0.00048598,92.90303350
14673,武打,3,573499,0.00048598,92.90351949
14674,武器店,3,573502,0.00048598,92.90400547
14675,武嚇,3,573505,0.00048598,92.90449145
14676,歧見,3,573508,0.00048598,92.90497743
14677,注定,3,573511,0.00048598,92.90546342
14678,泳裝,3,573514,0.00048598,92.90594940
14679,泌尿,3,573517,0.00048598,92.90643538
14680,泥,3,573520,0.00048598,92.90692136
14681,泥巴,3,573523,0.00048598,92.90740735
14682,泥濘,3,573526,0.00048598,92.90789333
14683,泥淖,3,573529,0.00048598,92.90837931
14684,河川,3,573532,0.00048598,92.90886530
14685,河段,3,573535,0.00048598,92.90935128
14686,河道,3,573538,0.00048598,92.90983726
14687,河灘,3,573541,0.00048598,92.91032324
14688,沾染,3,573544,0.00048598,92.91080923
14689,沼澤,3,573547,0.00048598,92.91129521
14690,波音公司,3,573550,0.00048598,92.91178119
14691,波修瓦劇院,3,573553,0.00048598,92.91226717
14692,波特,3,573556,0.00048598,92.91275316
14693,波德斯,3,573559,0.00048598,92.91323914
14694,波樂克斯,3,573562,0.00048598,92.91372512
14695,法文,3,573565,0.00048598,92.91421110
14696,法制室,3,573568,0.00048598,92.91469709
14697,法則,3,573571,0.00048598,92.91518307
14698,法律系,3,573574,0.00048598,92.91566905
14699,法紀,3,573577,0.00048598,92.91615503
14700,法師,3,573580,0.00048598,92.91664102
14701,法國菜,3,573583,0.00048598,92.91712700
14702,法術壇,3,573586,0.00048598,92.91761298
14703,法寶,3,573589,0.00048598,92.91809897
14704,法蘭克福,3,573592,0.00048598,92.91858495
14705,油性,3,573595,0.00048598,92.91907093
14706,油炸,3,573598,0.00048598,92.91955691
14707,油價,3,573601,0.00048598,92.92004290
14708,油箱,3,573604,0.00048598,92.92052888
14709,油墨,3,573607,0.00048598,92.92101486
14710,油膩,3,573610,0.00048598,92.92150084
14711,泗水,3,573613,0.00048598,92.92198683
14712,沿革,3,573616,0.00048598,92.92247281
14713,沿路,3,573619,0.00048598,92.92295879
14714,治病,3,573622,0.00048598,92.92344477
14715,治國,3,573625,0.00048598,92.92393076
14716,治療壇,3,573628,0.00048598,92.92441674
14717,泡沫經濟,3,573631,0.00048598,92.92490272
14718,泡棉,3,573634,0.00048598,92.92538871
14719,泡菜,3,573637,0.00048598,92.92587469
14720,泛舟,3,573640,0.00048598,92.92636067
14721,炒熱,3,573643,0.00048598,92.92684665
14722,炙手可熱,3,573646,0.00048598,92.92733264
14723,爬上,3,573649,0.00048598,92.92781862
14724,爬山,3,573652,0.00048598,92.92830460
14725,爬滿,3,573655,0.00048598,92.92879058
14726,爭相,3,573658,0.00048598,92.92927657
14727,爭稅,3,573661,0.00048598,92.92976255
14728,爭奪戰,3,573664,0.00048598,92.93024853
14729,爭端,3,573667,0.00048598,92.93073451
14730,版稅,3,573670,0.00048598,92.93122050
14731,牧民,3,573673,0.00048598,92.93170648
14732,物主,3,573676,0.00048598,92.93219246
14733,物以類聚,3,573679,0.00048598,92.93267844
14734,物件導向,3,573682,0.00048598,92.93316443
14735,物理學,3,573685,0.00048598,92.93365041
14736,物超所值,3,573688,0.00048598,92.93413639
14737,玩石者,3,573691,0.00048598,92.93462238
14738,玩車,3,573694,0.00048598,92.93510836
14739,玫瑰卡,3,573697,0.00048598,92.93559434
14740,盲,3,573700,0.00048598,92.93608032
14741,盲人,3,573703,0.00048598,92.93656631
14742,盲從,3,573706,0.00048598,92.93705229
14743,直達,3,573709,0.00048598,92.93753827
14744,直營,3,573712,0.00048598,92.93802425
14745,知本,3,573715,0.00048598,92.93851024
14746,知性,3,573718,0.00048598,92.93899622
14747,知悉,3,573721,0.00048598,92.93948220
14748,知情,3,573724,0.00048598,92.93996818
14749,社會局,3,573727,0.00048598,92.94045417
14750,社會性,3,573730,0.00048598,92.94094015
14751,社會科,3,573733,0.00048598,92.94142613
14752,社會黨,3,573736,0.00048598,92.94191211
14753,空降,3,573739,0.00048598,92.94239810
14754,空降部隊,3,573742,0.00048598,92.94288408
14755,糾正,3,573745,0.00048598,92.94337006
14756,糾纏,3,573748,0.00048598,92.94385605
14757,肥大,3,573751,0.00048598,92.94434203
14758,肥皂,3,573754,0.00048598,92.94482801
14759,肥厚,3,573757,0.00048598,92.94531399
14760,股民,3,573760,0.00048598,92.94579998
14761,股票行,3,573763,0.00048598,92.94628596
14762,股價指數,3,573766,0.00048598,92.94677194
14763,肯尼斯．瑞林,3,573769,0.00048598,92.94725792
14764,肯亞,3,573772,0.00048598,92.94774391
14765,芭蕾,3,573775,0.00048598,92.94822989
14766,芽菜,3,573778,0.00048598,92.94871587
14767,花生,3,573781,0.00048598,92.94920185
14768,花招,3,573784,0.00048598,92.94968784
14769,花花公子,3,573787,0.00048598,92.95017382
14770,花時間,3,573790,0.00048598,92.95065980
14771,花紋海豚,3,573793,0.00048598,92.95114579
14772,花鳥,3,573796,0.00048598,92.95163177
14773,花樣,3,573799,0.00048598,92.95211775
14774,花蓮中小企銀,3,573802,0.00048598,92.95260373
14775,花邊,3,573805,0.00048598,92.95308972
14776,初生,3,573808,0.00048598,92.95357570
14777,初始,3,573811,0.00048598,92.95406168
14778,初衷,3,573814,0.00048598,92.95454766
14779,初選,3,573817,0.00048598,92.95503365
14780,初賽,3,573820,0.00048598,92.95551963
14781,表列,3,573823,0.00048598,92.95600561
14782,表弟媳,3,573826,0.00048598,92.95649159
14783,表展,3,573829,0.00048598,92.95697758
14784,表率,3,573832,0.00048598,92.95746356
14785,迎面,3,573835,0.00048598,92.95794954
14786,近況,3,573838,0.00048598,92.95843552
14787,近郊,3,573841,0.00048598,92.95892151
14788,邱文宗,3,573844,0.00048598,92.95940749
14789,邱坤良,3,573847,0.00048598,92.95989347
14790,邱繼炳,3,573850,0.00048598,92.96037946
14791,采,3,573853,0.00048598,92.96086544
14792,金克洛斯,3,573856,0.00048598,92.96135142
14793,金科玉律,3,573859,0.00048598,92.96183740
14794,金針,3,573862,0.00048598,92.96232339
14795,金援,3,573865,0.00048598,92.96280937
14796,金滔,3,573868,0.00048598,92.96329535
14797,金融局,3,573871,0.00048598,92.96378133
14798,金融圈,3,573874,0.00048598,92.96426732
14799,金屬家具,3,573877,0.00048598,92.96475330
14800,長子,3,573880,0.00048598,92.96523928
14801,長方形,3,573883,0.00048598,92.96572526
14802,長江三峽,3,573886,0.00048598,92.96621125
14803,長庚醫院,3,573889,0.00048598,92.96669723
14804,長榮假期,3,573892,0.00048598,92.96718321
14805,長億,3,573895,0.00048598,92.96766919
14806,長輩,3,573898,0.00048598,92.96815518
14807,門戶,3,573901,0.00048598,92.96864116
14808,阿里山,3,573904,0.00048598,92.96912714
14809,阿里山森林鐵路,3,573907,0.00048598,92.96961313
14810,阿貴師,3,573910,0.00048598,92.97009911
14811,阿爾卑斯山,3,573913,0.00048598,92.97058509
14812,阿爾泰,3,573916,0.00048598,92.97107107
14813,阿諾,3,573919,0.00048598,92.97155706
14814,阿藍尼亞,3,573922,0.00048598,92.97204304
14815,阻,3,573925,0.00048598,92.97252902
14816,阻攻,3,573928,0.00048598,92.97301500
14817,附有,3,573931,0.00048598,92.97350099
14818,附帶,3,573934,0.00048598,92.97398697
14819,附設,3,573937,0.00048598,92.97447295
14820,雨量,3,573940,0.00048598,92.97495893
14821,青年節,3,573943,0.00048598,92.97544492
14822,青島,3,573946,0.00048598,92.97593090
14823,青蛙,3,573949,0.00048598,92.97641688
14824,非正式,3,573952,0.00048598,92.97690287
14825,俏麗,3,573955,0.00048598,92.97738885
14826,保育類,3,573958,0.00048598,92.97787483
14827,保時捷,3,573961,0.00048598,92.97836081
14828,保密,3,573964,0.00048598,92.97884680
14829,保証,3,573967,0.00048598,92.97933278
14830,保險司,3,573970,0.00048598,92.97981876
14831,保險櫃,3,573973,0.00048598,92.98030474
14832,保鮮,3,573976,0.00048598,92.98079073
14833,保鮮盒,3,573979,0.00048598,92.98127671
14834,保護靴,3,573982,0.00048598,92.98176269
14835,保護膜,3,573985,0.00048598,92.98224867
14836,俗名,3,573988,0.00048598,92.98273466
14837,俄,3,573991,0.00048598,92.98322064
14838,俄國人,3,573994,0.00048598,92.98370662
14839,俞,3,573997,0.00048598,92.98419260
14840,削價,3,574000,0.00048598,92.98467859
14841,前日,3,574003,0.00048598,92.98516457
14842,前程,3,574006,0.00048598,92.98565055
14843,南半球,3,574009,0.00048598,92.98613654
14844,南威爾斯大學,3,574012,0.00048598,92.98662252
14845,南美洲,3,574015,0.00048598,92.98710850
14846,南轅北轍,3,574018,0.00048598,92.98759448
14847,南邊,3,574021,0.00048598,92.98808047
14848,厚厚,3,574024,0.00048598,92.98856645
14849,厚重,3,574027,0.00048598,92.98905243
14850,哀傷,3,574030,0.00048598,92.98953841
14851,咸,3,574033,0.00048598,92.99002440
14852,品格,3,574036,0.00048598,92.99051038
14853,品諾,3,574039,0.00048598,92.99099636
14854,哈佛,3,574042,0.00048598,92.99148234
14855,哈為克,3,574045,0.00048598,92.99196833
14856,哈納斯河,3,574048,0.00048598,92.99245431
14857,咫尺,3,574051,0.00048598,92.99294029
14858,囿,3,574054,0.00048598,92.99342627
14859,垂,3,574057,0.00048598,92.99391226
14860,型別,3,574060,0.00048598,92.99439824
14861,城池,3,574063,0.00048598,92.99488422
14862,城牆,3,574066,0.00048598,92.99537021
14863,垮,3,574069,0.00048598,92.99585619
14864,契約書,3,574072,0.00048598,92.99634217
14865,娃娃,3,574075,0.00048598,92.99682815
14866,威利在那裡,3,574078,0.00048598,92.99731414
14867,宣洩,3,574081,0.00048598,92.99780012
14868,宣紙,3,574084,0.00048598,92.99828610
14869,室內運動會,3,574087,0.00048598,92.99877208
14870,封套,3,574090,0.00048598,92.99925807
14871,屏風,3,574093,0.00048598,92.99974405
14872,帥氣,3,574096,0.00048598,93.00023003
14873,建弘,3,574099,0.00048598,93.00071601
14874,建成,3,574102,0.00048598,93.00120200
14875,建設課,3,574105,0.00048598,93.00168798
14876,建設廳長,3,574108,0.00048598,93.00217396
14877,建置,3,574111,0.00048598,93.00265994
14878,建管處長,3,574114,0.00048598,93.00314593
14879,建管單位,3,574117,0.00048598,93.00363191
14880,建築執照,3,574120,0.00048598,93.00411789
14881,建築廢棄物,3,574123,0.00048598,93.00460388
14882,後山,3,574126,0.00048598,93.00508986
14883,後代,3,574129,0.00048598,93.00557584
14884,後現代理論,3,574132,0.00048598,93.00606182
14885,後期,3,574135,0.00048598,93.00654781
14886,怒氣,3,574138,0.00048598,93.00703379
14887,思源路,3,574141,0.00048598,93.00751977
14888,急切,3,574144,0.00048598,93.00800575
14889,急促,3,574147,0.00048598,93.00849174
14890,恍,3,574150,0.00048598,93.00897772
14891,恆久,3,574153,0.00048598,93.00946370
14892,恃,3,574156,0.00048598,93.00994968
14893,扁平化,3,574159,0.00048598,93.01043567
14894,拜票,3,574162,0.00048598,93.01092165
14895,按鍵,3,574165,0.00048598,93.01140763
14896,持之以恆,3,574168,0.00048598,93.01189362
14897,指日可待,3,574171,0.00048598,93.01237960
14898,指甲,3,574174,0.00048598,93.01286558
14899,指甲油,3,574177,0.00048598,93.01335156
14900,指印,3,574180,0.00048598,93.01383755
14901,指教,3,574183,0.00048598,93.01432353
14902,指點,3,574186,0.00048598,93.01480951
14903,拾回,3,574189,0.00048598,93.01529549
14904,政府軍,3,574192,0.00048598,93.01578148
14905,政治局,3,574195,0.00048598,93.01626746
14906,政治面,3,574198,0.00048598,93.01675344
14907,政治家,3,574201,0.00048598,93.01723942
14908,政爭,3,574204,0.00048598,93.01772541
14909,政策性,3,574207,0.00048598,93.01821139
14910,施予,3,574210,0.00048598,93.01869737
14911,施展,3,574213,0.00048598,93.01918335
14912,既是,3,574216,0.00048598,93.01966934
14913,春秋,3,574219,0.00048598,93.02015532
14914,春風,3,574222,0.00048598,93.02064130
14915,春夏季,3,574225,0.00048598,93.02112729
14916,春假,3,574228,0.00048598,93.02161327
14917,映照,3,574231,0.00048598,93.02209925
14918,是非,3,574234,0.00048598,93.02258523
14919,星光,3,574237,0.00048598,93.02307122
14920,星島日報,3,574240,0.00048598,93.02355720
14921,星球,3,574243,0.00048598,93.02404318
14922,柿子,3,574246,0.00048598,93.02452916
14923,柔和,3,574249,0.00048598,93.02501515
14924,柔軟度,3,574252,0.00048598,93.02550113
14925,架式,3,574255,0.00048598,93.02598711
14926,柯再添,3,574258,0.00048598,93.02647309
14927,柯達,3,574261,0.00048598,93.02695908
14928,查案,3,574264,0.00048598,93.02744506
14929,查處,3,574267,0.00048598,93.02793104
14930,毒化物,3,574270,0.00048598,93.02841702
14931,毒死,3,574273,0.00048598,93.02890301
14932,毒性物質,3,574276,0.00048598,93.02938899
14933,氟氯碳化物,3,574279,0.00048598,93.02987497
14934,泉,3,574282,0.00048598,93.03036096
14935,洋娃娃,3,574285,0.00048598,93.03084694
14936,洋酒,3,574288,0.00048598,93.03133292
14937,洪東煒,3,574291,0.00048598,93.03181890
14938,洪啟發,3,574294,0.00048598,93.03230489
14939,流亡,3,574297,0.00048598,93.03279087
14940,流行界,3,574300,0.00048598,93.03327685
14941,流行館,3,574303,0.00048598,93.03376283
14942,流逝,3,574306,0.00048598,93.03424882
14943,流線,3,574309,0.00048598,93.03473480
14944,津,3,574312,0.00048598,93.03522078
14945,津秀昭,3,574315,0.00048598,93.03570676
14946,洗練,3,574318,0.00048598,93.03619275
14947,洗臉,3,574321,0.00048598,93.03667873
14948,活門,3,574324,0.00048598,93.03716471
14949,活動量,3,574327,0.00048598,93.03765070
14950,活著,3,574330,0.00048598,93.03813668
14951,活靈活現,3,574333,0.00048598,93.03862266
14952,洩,3,574336,0.00048598,93.03910864
14953,為例,3,574339,0.00048598,93.03959463
14954,玻璃屋,3,574342,0.00048598,93.04008061
14955,玻璃窗,3,574345,0.00048598,93.04056659
14956,珍珠港,3,574348,0.00048598,93.04105257
14957,珍愛,3,574351,0.00048598,93.04153856
14958,界限,3,574354,0.00048598,93.04202454
14959,界面,3,574357,0.00048598,93.04251052
14960,皆是,3,574360,0.00048598,93.04299650
14961,盈,3,574363,0.00048598,93.04348249
14962,盆景,3,574366,0.00048598,93.04396847
14963,省下,3,574369,0.00048598,93.04445445
14964,省方,3,574372,0.00048598,93.04494043
14965,省市政府,3,574375,0.00048598,93.04542642
14966,省事,3,574378,0.00048598,93.04591240
14967,省時,3,574381,0.00048598,93.04639838
14968,省產,3,574384,0.00048598,93.04688437
14969,省略,3,574387,0.00048598,93.04737035
14970,省道,3,574390,0.00048598,93.04785633
14971,省議會,3,574393,0.00048598,93.04834231
14972,省黨部,3,574396,0.00048598,93.04882830
14973,省屬,3,574399,0.00048598,93.04931428
14974,相左,3,574402,0.00048598,93.04980026
14975,相仿,3,574405,0.00048598,93.05028624
14976,相約,3,574408,0.00048598,93.05077223
14977,相隔,3,574411,0.00048598,93.05125821
14978,相聚,3,574414,0.00048598,93.05174419
14979,相識,3,574417,0.00048598,93.05223017
14980,相戀,3,574420,0.00048598,93.05271616
14981,眉型,3,574423,0.00048598,93.05320214
14982,眉筆,3,574426,0.00048598,93.05368812
14983,看守,3,574429,0.00048598,93.05417410
14984,看店,3,574432,0.00048598,93.05466009
14985,看重,3,574435,0.00048598,93.05514607
14986,看清,3,574438,0.00048598,93.05563205
14987,看頭,3,574441,0.00048598,93.05611804
14988,研究人員,3,574444,0.00048598,93.05660402
14989,研究者,3,574447,0.00048598,93.05709000
14990,研究部,3,574450,0.00048598,93.05757598
14991,研修,3,574453,0.00048598,93.05806197
14992,研發人員,3,574456,0.00048598,93.05854795
14993,砍伐,3,574459,0.00048598,93.05903393
14994,科林斯,3,574462,0.00048598,93.05951991
14995,科學化,3,574465,0.00048598,93.06000590
14996,科學園區,3,574468,0.00048598,93.06049188
14997,秋高氣爽,3,574471,0.00048598,93.06097786
14998,穿戴,3,574474,0.00048598,93.06146384
14999,突,3,574477,0.00048598,93.06194983
15000,突起,3,574480,0.00048598,93.06243581
15001,突發,3,574483,0.00048598,93.06292179
15002,紅心,3,574486,0.00048598,93.06340778
15003,紅外線,3,574489,0.00048598,93.06389376
15004,紅肉,3,574492,0.00048598,93.06437974
15005,紅豆,3,574495,0.00048598,93.06486572
15006,紅腫,3,574498,0.00048598,93.06535171
15007,紅潤,3,574501,0.00048598,93.06583769
15008,紅樹,3,574504,0.00048598,93.06632367
15009,紅燈,3,574507,0.00048598,93.06680965
15010,紅點,3,574510,0.00048598,93.06729564
15011,紀念性,3,574513,0.00048598,93.06778162
15012,美人誌,3,574516,0.00048598,93.06826760
15013,美紅,3,574519,0.00048598,93.06875358
15014,美國在台協會,3,574522,0.00048598,93.06923957
15015,美術課,3,574525,0.00048598,93.06972555
15016,美規車,3,574528,0.00048598,93.07021153
15017,美滿服務中心,3,574531,0.00048598,93.07069751
15018,美樂達,3,574534,0.00048598,93.07118350
15019,耐力,3,574537,0.00048598,93.07166948
15020,耐力賽,3,574540,0.00048598,93.07215546
15021,胚芽,3,574543,0.00048598,93.07264145
15022,胃炎,3,574546,0.00048598,93.07312743
15023,胃酸,3,574549,0.00048598,93.07361341
15024,背水一戰,3,574552,0.00048598,93.07409939
15025,背叛,3,574555,0.00048598,93.07458538
15026,背負,3,574558,0.00048598,93.07507136
15027,背帶,3,574561,0.00048598,93.07555734
15028,胡,3,574564,0.00048598,93.07604332
15029,胡仙,3,574567,0.00048598,93.07652931
15030,胡志明市,3,574570,0.00048598,93.07701529
15031,胡迪,3,574573,0.00048598,93.07750127
15032,胡憲彰,3,574576,0.00048598,93.07798725
15033,致使,3,574579,0.00048598,93.07847324
15034,范寬,3,574582,0.00048598,93.07895922
15035,茅,3,574585,0.00048598,93.07944520
15036,茅草,3,574588,0.00048598,93.07993118
15037,若要,3,574591,0.00048598,93.08041717
15038,茂盛公司,3,574594,0.00048598,93.08090315
15039,茉莉花,3,574597,0.00048598,93.08138913
15040,英俊,3,574600,0.00048598,93.08187512
15041,英勇,3,574603,0.00048598,93.08236110
15042,英群企業,3,574606,0.00048598,93.08284708
15043,英製,3,574609,0.00048598,93.08333306
15044,苯胺,3,574612,0.00048598,93.08381905
15045,計時器,3,574615,0.00048598,93.08430503
15046,計票,3,574618,0.00048598,93.08479101
15047,計價款,3,574621,0.00048598,93.08527699
15048,訂出,3,574624,0.00048598,93.08576298
15049,訂位,3,574627,0.00048598,93.08624896
15050,訂桌,3,574630,0.00048598,93.08673494
15051,訂做,3,574633,0.00048598,93.08722092
15052,訂婚,3,574636,0.00048598,93.08770691
15053,訂票,3,574639,0.00048598,93.08819289
15054,貞,3,574642,0.00048598,93.08867887
15055,貞操,3,574645,0.00048598,93.08916486
15056,軍力,3,574648,0.00048598,93.08965084
15057,軍系,3,574651,0.00048598,93.09013682
15058,軍警,3,574654,0.00048598,93.09062280
15059,軌跡,3,574657,0.00048598,93.09110879
15060,迪雅玆,3,574660,0.00048598,93.09159477
15061,迭,3,574663,0.00048598,93.09208075
15062,迫害,3,574666,0.00048598,93.09256673
15063,重任,3,574669,0.00048598,93.09305272
15064,重返,3,574672,0.00048598,93.09353870
15065,重振,3,574675,0.00048598,93.09402468
15066,重症,3,574678,0.00048598,93.09451066
15067,重播,3,574681,0.00048598,93.09499665
15068,重蹈,3,574684,0.00048598,93.09548263
15069,降溫,3,574687,0.00048598,93.09596861
15070,面面俱到,3,574690,0.00048598,93.09645459
15071,革命性,3,574693,0.00048598,93.09694058
15072,革新,3,574696,0.00048598,93.09742656
15073,音階,3,574699,0.00048598,93.09791254
15074,音響界,3,574702,0.00048598,93.09839853
15075,頁數,3,574705,0.00048598,93.09888451
15076,風向球,3,574708,0.00048598,93.09937049
15077,風和日麗,3,574711,0.00048598,93.09985647
15078,風浪,3,574714,0.00048598,93.10034246
15079,風起雲湧,3,574717,0.00048598,93.10082844
15080,風寒,3,574720,0.00048598,93.10131442
15081,風琴手,3,574723,0.00048598,93.10180040
15082,飛利浦,3,574726,0.00048598,93.10228639
15083,飛利普,3,574729,0.00048598,93.10277237
15084,飛沫,3,574732,0.00048598,93.10325835
15085,飛越,3,574735,0.00048598,93.10374433
15086,飛碟,3,574738,0.00048598,93.10423032
15087,食量,3,574741,0.00048598,93.10471630
15088,食補,3,574744,0.00048598,93.10520228
15089,首任,3,574747,0.00048598,93.10568826
15090,首位,3,574750,0.00048598,93.10617425
15091,首府,3,574753,0.00048598,93.10666023
15092,首肯,3,574756,0.00048598,93.10714621
15093,首演,3,574759,0.00048598,93.10763220
15094,香陣,3,574762,0.00048598,93.10811818
15095,香甜,3,574765,0.00048598,93.10860416
15096,香港聯合報,3,574768,0.00048598,93.10909014
15097,香煙,3,574771,0.00048598,93.10957613
15098,亳,3,574774,0.00048598,93.11006211
15099,借助,3,574777,0.00048598,93.11054809
15100,借提,3,574780,0.00048598,93.11103407
15101,倒數,3,574783,0.00048598,93.11152006
15102,倡導,3,574786,0.00048598,93.11200604
15103,個人化,3,574789,0.00048598,93.11249202
15104,個性化,3,574792,0.00048598,93.11297800
15105,個頭,3,574795,0.00048598,93.11346399
15106,候鳥,3,574798,0.00048598,93.11394997
15107,倘佯,3,574801,0.00048598,93.11443595
15108,修持,3,574804,0.00048598,93.11492193
15109,倪芳榮,3,574807,0.00048598,93.11540792
15110,倫大,3,574810,0.00048598,93.11589390
15111,倫飛,3,574813,0.00048598,93.11637988
15112,兼差,3,574816,0.00048598,93.11686587
15113,凌群,3,574819,0.00048598,93.11735185
15114,准,3,574822,0.00048598,93.11783783
15115,剖析,3,574825,0.00048598,93.11832381
15116,剔除,3,574828,0.00048598,93.11880980
15117,剛性,3,574831,0.00048598,93.11929578
15118,剝落,3,574834,0.00048598,93.11978176
15119,匪夷所思,3,574837,0.00048598,93.12026774
15120,原子筆,3,574840,0.00048598,93.12075373
15121,原木屋,3,574843,0.00048598,93.12123971
15122,原告,3,574846,0.00048598,93.12172569
15123,原味,3,574849,0.00048598,93.12221167
15124,原油,3,574852,0.00048598,93.12269766
15125,原則性,3,574855,0.00048598,93.12318364
15126,原型車,3,574858,0.00048598,93.12366962
15127,原是,3,574861,0.00048598,93.12415561
15128,原動力,3,574864,0.00048598,93.12464159
15129,原產,3,574867,0.00048598,93.12512757
15130,原野,3,574870,0.00048598,93.12561355
15131,原畫,3,574873,0.00048598,93.12609954
15132,原稿,3,574876,0.00048598,93.12658552
15133,唐一寧,3,574879,0.00048598,93.12707150
15134,唐文龍,3,574882,0.00048598,93.12755748
15135,唐代,3,574885,0.00048598,93.12804347
15136,唐娜,3,574888,0.00048598,93.12852945
15137,唐納,3,574891,0.00048598,93.12901543
15138,哼,3,574894,0.00048598,93.12950141
15139,哥倫比亞大學,3,574897,0.00048598,93.12998740
15140,哥斯大黎加,3,574900,0.00048598,93.13047338
15141,哲思,3,574903,0.00048598,93.13095936
15142,哺乳,3,574906,0.00048598,93.13144534
15143,員林鎮,3,574909,0.00048598,93.13193133
15144,哪兒,3,574912,0.00048598,93.13241731
15145,唇筆,3,574915,0.00048598,93.13290329
15146,唇鬚,3,574918,0.00048598,93.13338928
15147,哽咽,3,574921,0.00048598,93.13387526
15148,埋藏,3,574924,0.00048598,93.13436124
15149,夏威夷,3,574927,0.00048598,93.13484722
15150,夏鑄九,3,574930,0.00048598,93.13533321
15151,孫兒,3,574933,0.00048598,93.13581919
15152,害羞,3,574936,0.00048598,93.13630517
15153,家教,3,574939,0.00048598,93.13679115
15154,家電業,3,574942,0.00048598,93.13727714
15155,宴會廳,3,574945,0.00048598,93.13776312
15156,容積,3,574948,0.00048598,93.13824910
15157,射殺,3,574951,0.00048598,93.13873508
15158,射精,3,574954,0.00048598,93.13922107
15159,峭壁,3,574957,0.00048598,93.13970705
15160,峽,3,574960,0.00048598,93.14019303
15161,峻國集團,3,574963,0.00048598,93.14067901
15162,峰值,3,574966,0.00048598,93.14116500
15163,差額,3,574969,0.00048598,93.14165098
15164,席捲,3,574972,0.00048598,93.14213696
15165,庭園,3,574975,0.00048598,93.14262295
15166,座機,3,574978,0.00048598,93.14310893
15167,徐旭東,3,574981,0.00048598,93.14359491
15168,徐徐,3,574984,0.00048598,93.14408089
15169,徐鴻進,3,574987,0.00048598,93.14456688
15170,恐懼感,3,574990,0.00048598,93.14505286
15171,恭喜,3,574993,0.00048598,93.14553884
15172,恩,3,574996,0.00048598,93.14602482
15173,悍衛戰士,3,574999,0.00048598,93.14651081
15174,拳王,3,575002,0.00048598,93.14699679
15175,拳頭,3,575005,0.00048598,93.14748277
15176,拿手,3,575008,0.00048598,93.14796875
15177,挾帶,3,575011,0.00048598,93.14845474
15178,振動,3,575014,0.00048598,93.14894072
15179,捕殺,3,575017,0.00048598,93.14942670
15180,捏成,3,575020,0.00048598,93.14991269
15181,捐血,3,575023,0.00048598,93.15039867
15182,捐助,3,575026,0.00048598,93.15088465
15183,捐款,3,575029,0.00048598,93.15137063
15184,捍衛,3,575032,0.00048598,93.15185662
15185,效用,3,575035,0.00048598,93.15234260
15186,旁觀者,3,575038,0.00048598,93.15282858
15187,旅行社,3,575041,0.00048598,93.15331456
15188,旅店,3,575044,0.00048598,93.15380055
15189,旅遊局,3,575047,0.00048598,93.15428653
15190,旅遊業,3,575050,0.00048598,93.15477251
15191,時分,3,575053,0.00048598,93.15525849
15192,時序,3,575056,0.00048598,93.15574448
15193,時宜,3,575059,0.00048598,93.15623046
15194,時數,3,575062,0.00048598,93.15671644
15195,書房,3,575065,0.00048598,93.15720242
15196,書法家,3,575068,0.00048598,93.15768841
15197,書桌,3,575071,0.00048598,93.15817439
15198,朗,3,575074,0.00048598,93.15866037
15199,校方,3,575077,0.00048598,93.15914636
15200,校門,3,575080,0.00048598,93.15963234
15201,核心程式,3,575083,0.00048598,93.16011832
15202,核桃,3,575086,0.00048598,93.16060430
15203,核發,3,575089,0.00048598,93.16109029
15204,核算,3,575092,0.00048598,93.16157627
15205,根除性,3,575095,0.00048598,93.16206225
15206,根基,3,575098,0.00048598,93.16254823
15207,根深柢固,3,575101,0.00048598,93.16303422
15208,栩栩如生,3,575104,0.00048598,93.16352020
15209,桌上,3,575107,0.00048598,93.16400618
15210,桌球,3,575110,0.00048598,93.16449216
15211,株,3,575113,0.00048598,93.16497815
15212,氣功,3,575116,0.00048598,93.16546413
15213,氧化,3,575119,0.00048598,93.16595011
15214,浪頭,3,575122,0.00048598,93.16643609
15215,消化酵素,3,575125,0.00048598,93.16692208
15216,消夜,3,575128,0.00048598,93.16740806
15217,消毒,3,575131,0.00048598,93.16789404
15218,消退,3,575134,0.00048598,93.16838003
15219,消逝,3,575137,0.00048598,93.16886601
15220,浸入,3,575140,0.00048598,93.16935199
15221,海外基金公司,3,575143,0.00048598,93.16983797
15222,海貝,3,575146,0.00048598,93.17032396
15223,海岸山脈,3,575149,0.00048598,93.17080994
15224,海軍陸戰隊,3,575152,0.00048598,93.17129592
15225,海森堡,3,575155,0.00048598,93.17178190
15226,海寧希,3,575158,0.00048598,93.17226789
15227,海濱,3,575161,0.00048598,93.17275387
15228,浙江,3,575164,0.00048598,93.17323985
15229,涉足,3,575167,0.00048598,93.17372583
15230,浮誇,3,575170,0.00048598,93.17421182
15231,烤箱,3,575173,0.00048598,93.17469780
15232,烈,3,575176,0.00048598,93.17518378
15233,烏克蘭,3,575179,0.00048598,93.17566977
15234,烏龜,3,575182,0.00048598,93.17615575
15235,特立獨行,3,575185,0.00048598,93.17664173
15236,特洛伊戰爭,3,575188,0.00048598,93.17712771
15237,特異,3,575191,0.00048598,93.17761370
15238,特惠,3,575194,0.00048598,93.17809968
15239,特戰,3,575197,0.00048598,93.17858566
15240,班表,3,575200,0.00048598,93.17907164
15241,班長,3,575203,0.00048598,93.17955763
15242,班級,3,575206,0.00048598,93.18004361
15243,琉球,3,575209,0.00048598,93.18052959
15244,珠,3,575212,0.00048598,93.18101557
15245,疾苦,3,575215,0.00048598,93.18150156
15246,病菌,3,575218,0.00048598,93.18198754
15247,病態,3,575221,0.00048598,93.18247352
15248,疲,3,575224,0.00048598,93.18295950
15249,疲軟,3,575227,0.00048598,93.18344549
15250,疼惜,3,575230,0.00048598,93.18393147
15251,盎然,3,575233,0.00048598,93.18441745
15252,真性,3,575236,0.00048598,93.18490344
15253,真情,3,575239,0.00048598,93.18538942
15254,真善美,3,575242,0.00048598,93.18587540
15255,真菌園,3,575245,0.00048598,93.18636138
15256,真話,3,575248,0.00048598,93.18684737
15257,砲,3,575251,0.00048598,93.18733335
15258,神似,3,575254,0.00048598,93.18781933
15259,神性,3,575257,0.00048598,93.18830531
15260,神采,3,575260,0.00048598,93.18879130
15261,神采奕奕,3,575263,0.00048598,93.18927728
15262,神經質,3,575266,0.00048598,93.18976326
15263,神農溪,3,575269,0.00048598,93.19024924
15264,秘方,3,575272,0.00048598,93.19073523
15265,笑笑,3,575275,0.00048598,93.19122121
15266,粉碎,3,575278,0.00048598,93.19170719
15267,素色,3,575281,0.00048598,93.19219317
15268,素食,3,575284,0.00048598,93.19267916
15269,素描,3,575287,0.00048598,93.19316514
15270,索回,3,575290,0.00048598,93.19365112
15271,純淨,3,575293,0.00048598,93.19413711
15272,紐約時報,3,575296,0.00048598,93.19462309
15273,紙張,3,575299,0.00048598,93.19510907
15274,缺貨,3,575302,0.00048598,93.19559505
15275,缺損,3,575305,0.00048598,93.19608104
15276,翁虹,3,575308,0.00048598,93.19656702
15277,耆老,3,575311,0.00048598,93.19705300
15278,耿健輝,3,575314,0.00048598,93.19753898
15279,脂粉,3,575317,0.00048598,93.19802497
15280,胸腔,3,575320,0.00048598,93.19851095
15281,胸罩,3,575323,0.00048598,93.19899693
15282,胸襟,3,575326,0.00048598,93.19948291
15283,脈,3,575329,0.00048598,93.19996890
15284,臭,3,575332,0.00048598,93.20045488
15285,航空公司,3,575335,0.00048598,93.20094086
15286,航空城,3,575338,0.00048598,93.20142685
15287,航空業,3,575341,0.00048598,93.20191283
15288,荒謬,3,575344,0.00048598,93.20239881
15289,草莓,3,575347,0.00048598,93.20288479
15290,茶館,3,575350,0.00048598,93.20337078
15291,衰,3,575353,0.00048598,93.20385676
15292,衰弱,3,575356,0.00048598,93.20434274
15293,記述,3,575359,0.00048598,93.20482872
15294,討債,3,575362,0.00048598,93.20531471
15295,財產權,3,575365,0.00048598,93.20580069
15296,財稅,3,575368,0.00048598,93.20628667
15297,起士粉,3,575371,0.00048598,93.20677265
15298,起立,3,575374,0.00048598,93.20725864
15299,起先,3,575377,0.00048598,93.20774462
15300,起色,3,575380,0.00048598,93.20823060
15301,起訖點,3,575383,0.00048598,93.20871658
15302,起動,3,575386,0.00048598,93.20920257
15303,起訴書,3,575389,0.00048598,93.20968855
15304,起跑點,3,575392,0.00048598,93.21017453
15305,起源,3,575395,0.00048598,93.21066052
15306,起落,3,575398,0.00048598,93.21114650
15307,軒尼詩干邑白蘭地,3,575401,0.00048598,93.21163248
15308,送來,3,575404,0.00048598,93.21211846
15309,迷思,3,575407,0.00048598,93.21260445
15310,迷糊,3,575410,0.00048598,93.21309043
15311,迷戀,3,575413,0.00048598,93.21357641
15312,退回,3,575416,0.00048598,93.21406239
15313,退縮,3,575419,0.00048598,93.21454838
15314,退避三舍,3,575422,0.00048598,93.21503436
15315,退黨,3,575425,0.00048598,93.21552034
15316,迴,3,575428,0.00048598,93.21600632
15317,迴旋,3,575431,0.00048598,93.21649231
15318,逃命,3,575434,0.00048598,93.21697829
15319,逃脫,3,575437,0.00048598,93.21746427
15320,逃漏稅,3,575440,0.00048598,93.21795025
15321,追擊,3,575443,0.00048598,93.21843624
15322,追繳,3,575446,0.00048598,93.21892222
15323,酒商,3,575449,0.00048598,93.21940820
15324,酒瓶,3,575452,0.00048598,93.21989419
15325,酒會,3,575455,0.00048598,93.22038017
15326,酒癮,3,575458,0.00048598,93.22086615
15327,配色,3,575461,0.00048598,93.22135213
15328,配角,3,575464,0.00048598,93.22183812
15329,配料,3,575467,0.00048598,93.22232410
15330,閃光燈,3,575470,0.00048598,93.22281008
15331,閃亮,3,575473,0.00048598,93.22329606
15332,陣式,3,575476,0.00048598,93.22378205
15333,除汙設備,3,575479,0.00048598,93.22426803
15334,除役,3,575482,0.00048598,93.22475401
15335,除掉,3,575485,0.00048598,93.22523999
15336,隻身,3,575488,0.00048598,93.22572598
15337,馬利斯,3,575491,0.00048598,93.22621196
15338,馬里歐,3,575494,0.00048598,93.22669794
15339,骨端,3,575497,0.00048598,93.22718392
15340,高人一等,3,575500,0.00048598,93.22766991
15341,高中生,3,575503,0.00048598,93.22815589
15342,高田賢三,3,575506,0.00048598,93.22864187
15343,高級汽油,3,575509,0.00048598,93.22912786
15344,高深,3,575512,0.00048598,93.22961384
15345,高等,3,575515,0.00048598,93.23009982
15346,高華街,3,575518,0.00048598,93.23058580
15347,高雄人,3,575521,0.00048598,93.23107179
15348,高跟鞋,3,575524,0.00048598,93.23155777
15349,高論,3,575527,0.00048598,93.23204375
15350,高燒,3,575530,0.00048598,93.23252973
15351,乾草,3,575533,0.00048598,93.23301572
15352,停下來,3,575536,0.00048598,93.23350170
15353,停泊,3,575539,0.00048598,93.23398768
15354,停損,3,575542,0.00048598,93.23447366
15355,停歇,3,575545,0.00048598,93.23495965
15356,停頓,3,575548,0.00048598,93.23544563
15357,停擺,3,575551,0.00048598,93.23593161
15358,偌大,3,575554,0.00048598,93.23641760
15359,做生意,3,575557,0.00048598,93.23690358
15360,做菜,3,575560,0.00048598,93.23738956
15361,做夢,3,575563,0.00048598,93.23787554
15362,偉,3,575566,0.00048598,93.23836153
15363,偉人,3,575569,0.00048598,93.23884751
15364,健行,3,575572,0.00048598,93.23933349
15365,健保局,3,575575,0.00048598,93.23981947
15366,健美,3,575578,0.00048598,93.24030546
15367,健寶園,3,575581,0.00048598,93.24079144
15368,偵,3,575584,0.00048598,93.24127742
15369,側重,3,575587,0.00048598,93.24176340
15370,偷工減料,3,575590,0.00048598,93.24224939
15371,偏向,3,575593,0.00048598,93.24273537
15372,偏僻,3,575596,0.00048598,93.24322135
15373,兜風,3,575599,0.00048598,93.24370733
15374,兜售,3,575602,0.00048598,93.24419332
15375,剪裁,3,575605,0.00048598,93.24467930
15376,副本,3,575608,0.00048598,93.24516528
15377,副總司令,3,575611,0.00048598,93.24565127
15378,副總理,3,575614,0.00048598,93.24613725
15379,務實外交,3,575617,0.00048598,93.24662323
15380,動土,3,575620,0.00048598,93.24710921
15381,動物性,3,575623,0.00048598,93.24759520
15382,動容,3,575626,0.00048598,93.24808118
15383,動植物,3,575629,0.00048598,93.24856716
15384,區區,3,575632,0.00048598,93.24905314
15385,參謀總長,3,575635,0.00048598,93.24953913
15386,商船,3,575638,0.00048598,93.25002511
15387,商業化,3,575641,0.00048598,93.25051109
15388,唱片界,3,575644,0.00048598,93.25099707
15389,問號,3,575647,0.00048598,93.25148306
15390,唸書,3,575650,0.00048598,93.25196904
15391,國土,3,575653,0.00048598,93.25245502
15392,國民樂派,3,575656,0.00048598,93.25294100
15393,國立藝專,3,575659,0.00048598,93.25342699
15394,國防部長,3,575662,0.00048598,93.25391297
15395,國軍,3,575665,0.00048598,93.25439895
15396,國家風景區,3,575668,0.00048598,93.25488494
15397,國家級,3,575671,0.00048598,93.25537092
15398,國泰人壽,3,575674,0.00048598,93.25585690
15399,國務卿,3,575677,0.00048598,93.25634288
15400,國眾汽車,3,575680,0.00048598,93.25682887
15401,國票,3,575683,0.00048598,93.25731485
15402,國統綱領,3,575686,0.00048598,93.25780083
15403,國債,3,575689,0.00048598,93.25828681
15404,國會大廈,3,575692,0.00048598,93.25877280
15405,國旗,3,575695,0.00048598,93.25925878
15406,國際金融卡,3,575698,0.00048598,93.25974476
15407,國際債券,3,575701,0.00048598,93.26023074
15408,國際電話,3,575704,0.00048598,93.26071673
15409,國際機場,3,575707,0.00048598,93.26120271
15410,國籍,3,575710,0.00048598,93.26168869
15411,堅決,3,575713,0.00048598,93.26217468
15412,堅果,3,575716,0.00048598,93.26266066
15413,堅硬,3,575719,0.00048598,93.26314664
15414,堅韌,3,575722,0.00048598,93.26363262
15415,堅稱,3,575725,0.00048598,93.26411861
15416,堆高機,3,575728,0.00048598,93.26460459
15417,堆置,3,575731,0.00048598,93.26509057
15418,基金經理人,3,575734,0.00048598,93.26557655
15419,基督徒,3,575737,0.00048598,93.26606254
15420,基點,3,575740,0.00048598,93.26654852
15421,堂堂,3,575743,0.00048598,93.26703450
15422,堵,3,575746,0.00048598,93.26752048
15423,執行緒,3,575749,0.00048598,93.26800647
15424,培養皿,3,575752,0.00048598,93.26849245
15425,夠不夠,3,575755,0.00048598,93.26897843
15426,夠用,3,575758,0.00048598,93.26946441
15427,奢侈,3,575761,0.00048598,93.26995040
15428,婉拒,3,575764,0.00048598,93.27043638
15429,婦幼,3,575767,0.00048598,93.27092236
15430,婦產科,3,575770,0.00048598,93.27140835
15431,婆,3,575773,0.00048598,93.27189433
15432,密閉,3,575776,0.00048598,93.27238031
15433,專人,3,575779,0.00048598,93.27286629
15434,專美於前,3,575782,0.00048598,93.27335228
15435,專責,3,575785,0.00048598,93.27383826
15436,專業人員,3,575788,0.00048598,93.27432424
15437,屠殺,3,575791,0.00048598,93.27481022
15438,崇敬,3,575794,0.00048598,93.27529621
15439,常人,3,575797,0.00048598,93.27578219
15440,常客,3,575800,0.00048598,93.27626817
15441,常是,3,575803,0.00048598,93.27675415
15442,帶入,3,575806,0.00048598,93.27724014
15443,帶出,3,575809,0.00048598,93.27772612
15444,帶頭,3,575812,0.00048598,93.27821210
15445,帳面,3,575815,0.00048598,93.27869808
15446,康乃馨,3,575818,0.00048598,93.27918407
15447,張大春,3,575821,0.00048598,93.27967005
15448,張明杰,3,575824,0.00048598,93.28015603
15449,張欣怡,3,575827,0.00048598,93.28064202
15450,張國立,3,575830,0.00048598,93.28112800
15451,張景森,3,575833,0.00048598,93.28161398
15452,張貼,3,575836,0.00048598,93.28209996
15453,張新堂,3,575839,0.00048598,93.28258595
15454,張燈結綵,3,575842,0.00048598,93.28307193
15455,張耀騰,3,575845,0.00048598,93.28355791
15456,強身,3,575848,0.00048598,93.28404389
15457,強者,3,575851,0.00048598,93.28452988
15458,強悍,3,575854,0.00048598,93.28501586
15459,強盜,3,575857,0.00048598,93.28550184
15460,強韌,3,575860,0.00048598,93.28598782
15461,強敵,3,575863,0.00048598,93.28647381
15462,從而,3,575866,0.00048598,93.28695979
15463,從容,3,575869,0.00048598,93.28744577
15464,徘徊,3,575872,0.00048598,93.28793176
15465,御用,3,575875,0.00048598,93.28841774
15466,御駕,3,575878,0.00048598,93.28890372
15467,悠然,3,575881,0.00048598,93.28938970
15468,悠遊,3,575884,0.00048598,93.28987569
15469,您好,3,575887,0.00048598,93.29036167
15470,情色片,3,575890,0.00048598,93.29084765
15471,情色電影,3,575893,0.00048598,93.29133363
15472,情結,3,575896,0.00048598,93.29181962
15473,情義,3,575899,0.00048598,93.29230560
15474,情操,3,575902,0.00048598,93.29279158
15475,情願,3,575905,0.00048598,93.29327756
15476,控訴,3,575908,0.00048598,93.29376355
15477,捲片,3,575911,0.00048598,93.29424953
15478,探病,3,575914,0.00048598,93.29473551
15479,接收端,3,575917,0.00048598,93.29522149
15480,接住,3,575920,0.00048598,93.29570748
15481,接到,3,575923,0.00048598,93.29619346
15482,接班,3,575926,0.00048598,93.29667944
15483,接班人,3,575929,0.00048598,93.29716543
15484,接種,3,575932,0.00048598,93.29765141
15485,接管,3,575935,0.00048598,93.29813739
15486,接續,3,575938,0.00048598,93.29862337
15487,捷徑,3,575941,0.00048598,93.29910936
15488,捷運公司,3,575944,0.00048598,93.29959534
15489,捧場,3,575947,0.00048598,93.30008132
15490,掃帚,3,575950,0.00048598,93.30056730
15491,推介,3,575953,0.00048598,93.30105329
15492,推向,3,575956,0.00048598,93.30153927
15493,推卸,3,575959,0.00048598,93.30202525
15494,推派,3,575962,0.00048598,93.30251123
15495,推算,3,575965,0.00048598,93.30299722
15496,推諉,3,575968,0.00048598,93.30348320
15497,推擠,3,575971,0.00048598,93.30396918
15498,推舉,3,575974,0.00048598,93.30445516
15499,推斷,3,575977,0.00048598,93.30494115
15500,推薦優良雜誌獎,3,575980,0.00048598,93.30542713
15501,掙,3,575983,0.00048598,93.30591311
15502,排行,3,575986,0.00048598,93.30639910
15503,排尿,3,575989,0.00048598,93.30688508
15504,排序,3,575992,0.00048598,93.30737106
15505,排便,3,575995,0.00048598,93.30785704
15506,排氣,3,575998,0.00048598,93.30834303
15507,排程,3,576001,0.00048598,93.30882901
15508,排演,3,576004,0.00048598,93.30931499
15509,掀背,3,576007,0.00048598,93.30980097
15510,捨不得,3,576010,0.00048598,93.31028696
15511,敝人,3,576013,0.00048598,93.31077294
15512,救出,3,576016,0.00048598,93.31125892
15513,救生,3,576019,0.00048598,93.31174490
15514,救回,3,576022,0.00048598,93.31223089
15515,教改,3,576025,0.00048598,93.31271687
15516,教育部長,3,576028,0.00048598,93.31320285
15517,敗仗,3,576031,0.00048598,93.31368884
15518,敗血症,3,576034,0.00048598,93.31417482
15519,敗戰,3,576037,0.00048598,93.31466080
15520,啟,3,576040,0.00048598,93.31514678
15521,敏感度,3,576043,0.00048598,93.31563277
15522,敘利亞,3,576046,0.00048598,93.31611875
15523,晚報,3,576049,0.00048598,93.31660473
15524,晚期,3,576052,0.00048598,93.31709071
15525,晚會,3,576055,0.00048598,93.31757670
15526,望安鄉,3,576058,0.00048598,93.31806268
15527,械,3,576061,0.00048598,93.31854866
15528,梨園,3,576064,0.00048598,93.31903464
15529,殺人,3,576067,0.00048598,93.31952063
15530,殺蟲劑,3,576070,0.00048598,93.32000661
15531,毫升,3,576073,0.00048598,93.32049259
15532,涼爽,3,576076,0.00048598,93.32097857
15533,淡粧,3,576079,0.00048598,93.32146456
15534,添加物,3,576082,0.00048598,93.32195054
15535,添購,3,576085,0.00048598,93.32243652
15536,淺色,3,576088,0.00048598,93.32292251
15537,淺顯,3,576091,0.00048598,93.32340849
15538,清一色,3,576094,0.00048598,93.32389447
15539,清水,3,576097,0.00048598,93.32438045
15540,清淨,3,576100,0.00048598,93.32486644
15541,清湯,3,576103,0.00048598,93.32535242
15542,清華廣告,3,576106,0.00048598,93.32583840
15543,清運公司,3,576109,0.00048598,93.32632438
15544,淋巴球,3,576112,0.00048598,93.32681037
15545,淹水,3,576115,0.00048598,93.32729635
15546,淹沒,3,576118,0.00048598,93.32778233
15547,混合性,3,576121,0.00048598,93.32826831
15548,混混,3,576124,0.00048598,93.32875430
15549,涵養,3,576127,0.00048598,93.32924028
15550,深沈,3,576130,0.00048598,93.32972626
15551,深怕,3,576133,0.00048598,93.33021224
15552,深思熟慮,3,576136,0.00048598,93.33069823
15553,深淵,3,576139,0.00048598,93.33118421
15554,深感,3,576142,0.00048598,93.33167019
15555,深愛,3,576145,0.00048598,93.33215618
15556,淨土,3,576148,0.00048598,93.33264216
15557,淨利,3,576151,0.00048598,93.33312814
15558,烹煮,3,576154,0.00048598,93.33361412
15559,球技,3,576157,0.00048598,93.33410011
15560,球型,3,576160,0.00048598,93.33458609
15561,球星,3,576163,0.00048598,93.33507207
15562,球探,3,576166,0.00048598,93.33555805
15563,球路,3,576169,0.00048598,93.33604404
15564,理睬,3,576172,0.00048598,93.33653002
15565,理察布魯克斯,3,576175,0.00048598,93.33701600
15566,現存,3,576178,0.00048598,93.33750198
15567,現役,3,576181,0.00048598,93.33798797
15568,現身說法,3,576184,0.00048598,93.33847395
15569,現階段,3,576187,0.00048598,93.33895993
15570,瓶子,3,576190,0.00048598,93.33944591
15571,瓷,3,576193,0.00048598,93.33993190
15572,畢業證書,3,576196,0.00048598,93.34041788
15573,異同,3,576199,0.00048598,93.34090386
15574,異曲同工,3,576202,0.00048598,93.34138985
15575,異見,3,576205,0.00048598,93.34187583
15576,異樣,3,576208,0.00048598,93.34236181
15577,痕,3,576211,0.00048598,93.34284779
15578,盛宴,3,576214,0.00048598,93.34333378
15579,眾所周知,3,576217,0.00048598,93.34381976
15580,眼見,3,576220,0.00048598,93.34430574
15581,眼晴,3,576223,0.00048598,93.34479172
15582,祭,3,576226,0.00048598,93.34527771
15583,祭出,3,576229,0.00048598,93.34576369
15584,移往,3,576232,0.00048598,93.34624967
15585,移送書,3,576235,0.00048598,93.34673565
15586,笨拙,3,576238,0.00048598,93.34722164
15587,笛子,3,576241,0.00048598,93.34770762
15588,第一次世界大戰,3,576244,0.00048598,93.34819360
15589,第一步,3,576247,0.00048598,93.34867959
15590,第七艦隊,3,576250,0.00048598,93.34916557
15591,第三地,3,576253,0.00048598,93.34965155
15592,第三國,3,576256,0.00048598,93.35013753
15593,第四號交響曲,3,576259,0.00048598,93.35062352
15594,符石,3,576262,0.00048598,93.35110950
15595,粗魯,3,576265,0.00048598,93.35159548
15596,統,3,576268,0.00048598,93.35208146
15597,統一發包中心,3,576271,0.00048598,93.35256745
15598,統一隊,3,576274,0.00048598,93.35305343
15599,統統,3,576277,0.00048598,93.35353941
15600,組團,3,576280,0.00048598,93.35402539
15601,累累,3,576283,0.00048598,93.35451138
15602,翌年,3,576286,0.00048598,93.35499736
15603,脫皮,3,576289,0.00048598,93.35548334
15604,脫班,3,576292,0.00048598,93.35596932
15605,船長,3,576295,0.00048598,93.35645531
15606,船隻,3,576298,0.00048598,93.35694129
15607,船塢,3,576301,0.00048598,93.35742727
15608,莊隆昌,3,576304,0.00048598,93.35791326
15609,荷花,3,576307,0.00048598,93.35839924
15610,處理場,3,576310,0.00048598,93.35888522
15611,被愛,3,576313,0.00048598,93.35937120
15612,規矩,3,576316,0.00048598,93.35985719
15613,訪查,3,576319,0.00048598,93.36034317
15614,許久,3,576322,0.00048598,93.36082915
15615,許可證,3,576325,0.00048598,93.36131513
15616,許建群,3,576328,0.00048598,93.36180112
15617,許耕榮,3,576331,0.00048598,93.36228710
15618,許添財,3,576334,0.00048598,93.36277308
15619,許滿足,3,576337,0.00048598,93.36325906
15620,設計群,3,576340,0.00048598,93.36374505
15621,設想,3,576343,0.00048598,93.36423103
15622,責無旁貸,3,576346,0.00048598,93.36471701
15623,貨品,3,576349,0.00048598,93.36520299
15624,貨真價實,3,576352,0.00048598,93.36568898
15625,貨運,3,576355,0.00048598,93.36617496
15626,貧苦,3,576358,0.00048598,93.36666094
15627,貧瘠,3,576361,0.00048598,93.36714693
15628,軟化,3,576364,0.00048598,93.36763291
15629,軟碟機,3,576367,0.00048598,93.36811889
15630,通風,3,576370,0.00048598,93.36860487
15631,通訊室,3,576373,0.00048598,93.36909086
15632,連串,3,576376,0.00048598,93.36957684
15633,連夜,3,576379,0.00048598,93.37006282
15634,連敗,3,576382,0.00048598,93.37054880
15635,連勝,3,576385,0.00048598,93.37103479
15636,連署,3,576388,0.00048598,93.37152077
15637,連載,3,576391,0.00048598,93.37200675
15638,連德信,3,576394,0.00048598,93.37249273
15639,連震東,3,576397,0.00048598,93.37297872
15640,造化,3,576400,0.00048598,93.37346470
15641,造形,3,576403,0.00048598,93.37395068
15642,造價,3,576406,0.00048598,93.37443667
15643,透支,3,576409,0.00048598,93.37492265
15644,部屬,3,576412,0.00048598,93.37540863
15645,郭南宏,3,576415,0.00048598,93.37589461
15646,郭婉容,3,576418,0.00048598,93.37638060
15647,都市人,3,576421,0.00048598,93.37686658
15648,野菜,3,576424,0.00048598,93.37735256
15649,陳光雄,3,576427,0.00048598,93.37783854
15650,陳安治,3,576430,0.00048598,93.37832453
15651,陳免,3,576433,0.00048598,93.37881051
15652,陳帝國,3,576436,0.00048598,93.37929649
15653,陳政忠,3,576439,0.00048598,93.37978247
15654,陳玲蘭,3,576442,0.00048598,93.38026846
15655,陳國華,3,576445,0.00048598,93.38075444
15656,陳清泉,3,576448,0.00048598,93.38124042
15657,陳淑惠,3,576451,0.00048598,93.38172640
15658,陳盛,3,576454,0.00048598,93.38221239
15659,陳揆淼,3,576457,0.00048598,93.38269837
15660,陳漢杰,3,576460,0.00048598,93.38318435
15661,陳耀圻,3,576463,0.00048598,93.38367034
15662,陰部,3,576466,0.00048598,93.38415632
15663,雀仔園,3,576469,0.00048598,93.38464230
15664,雪霸國家公園,3,576472,0.00048598,93.38512828
15665,章節,3,576475,0.00048598,93.38561427
15666,竟是,3,576478,0.00048598,93.38610025
15667,頂果欽哲仁波切,3,576481,0.00048598,93.38658623
15668,頃,3,576484,0.00048598,93.38707221
15669,魚子醬,3,576487,0.00048598,93.38755820
15670,魚史館,3,576490,0.00048598,93.38804418
15671,魚粉,3,576493,0.00048598,93.38853016
15672,鹿港,3,576496,0.00048598,93.38901614
15673,麥克,3,576499,0.00048598,93.38950213
15674,麥凱,3,576502,0.00048598,93.38998811
15675,麥魁爾,3,576505,0.00048598,93.39047409
15676,傍,3,576508,0.00048598,93.39096007
15677,備份,3,576511,0.00048598,93.39144606
15678,備妥,3,576514,0.00048598,93.39193204
15679,備忘錄,3,576517,0.00048598,93.39241802
15680,備註,3,576520,0.00048598,93.39290401
15681,傑克．尼克斯,3,576523,0.00048598,93.39338999
15682,傑克遜港灣,3,576526,0.00048598,93.39387597
15683,凱悅飯店,3,576529,0.00048598,93.39436195
15684,凱爾,3,576532,0.00048598,93.39484794
15685,凱薩琳,3,576535,0.00048598,93.39533392
15686,創刊號,3,576538,0.00048598,93.39581990
15687,創作品,3,576541,0.00048598,93.39630588
15688,創始,3,576544,0.00048598,93.39679187
15689,創業家,3,576547,0.00048598,93.39727785
15690,勞工退休金,3,576550,0.00048598,93.39776383
15691,勞退基金,3,576553,0.00048598,93.39824981
15692,勝任,3,576556,0.00048598,93.39873580
15693,勝地,3,576559,0.00048598,93.39922178
15694,勝利者,3,576562,0.00048598,93.39970776
15695,勝差,3,576565,0.00048598,93.40019375
15696,勝敗,3,576568,0.00048598,93.40067973
15697,勝過,3,576571,0.00048598,93.40116571
15698,勝算,3,576574,0.00048598,93.40165169
15699,博學多聞,3,576577,0.00048598,93.40213768
15700,喝醉,3,576580,0.00048598,93.40262366
15701,喘息,3,576583,0.00048598,93.40310964
15702,喜怒哀樂,3,576586,0.00048598,93.40359562
15703,喋喋不休,3,576589,0.00048598,93.40408161
15704,單子,3,576592,0.00048598,93.40456759
15705,喚起,3,576595,0.00048598,93.40505357
15706,喬伊,3,576598,0.00048598,93.40553955
15707,喬治亞理工,3,576601,0.00048598,93.40602554
15708,圍欄,3,576604,0.00048598,93.40651152
15709,報仇,3,576607,0.00048598,93.40699750
15710,報名表,3,576610,0.00048598,93.40748348
15711,報備,3,576613,0.00048598,93.40796947
15712,報廢,3,576616,0.00048598,93.40845545
15713,報關,3,576619,0.00048598,93.40894143
15714,堡壘,3,576622,0.00048598,93.40942742
15715,奠立,3,576625,0.00048598,93.40991340
15716,媚,3,576628,0.00048598,93.41039938
15717,寒風,3,576631,0.00048598,93.41088536
15718,富比士雜誌,3,576634,0.00048598,93.41137135
15719,富邦,3,576637,0.00048598,93.41185733
15720,富邦集團,3,576640,0.00048598,93.41234331
15721,富饒,3,576643,0.00048598,93.41282929
15722,富蘭克林,3,576646,0.00048598,93.41331528
15723,尊榮卡,3,576649,0.00048598,93.41380126
15724,就算,3,576652,0.00048598,93.41428724
15725,嵌入,3,576655,0.00048598,93.41477322
15726,幅員,3,576658,0.00048598,93.41525921
15727,幾年,3,576661,0.00048598,93.41574519
15728,復育,3,576664,0.00048598,93.41623117
15729,復興航空,3,576667,0.00048598,93.41671715
15730,惡作劇,3,576670,0.00048598,93.41720314
15731,惡習,3,576673,0.00048598,93.41768912
15732,惡意,3,576676,0.00048598,93.41817510
15733,悲壯,3,576679,0.00048598,93.41866109
15734,悲憫,3,576682,0.00048598,93.41914707
15735,掌心,3,576685,0.00048598,93.41963305
15736,掌管,3,576688,0.00048598,93.42011903
15737,插座,3,576691,0.00048598,93.42060502
15738,插置,3,576694,0.00048598,93.42109100
15739,揣測,3,576697,0.00048598,93.42157698
15740,提名人,3,576700,0.00048598,93.42206296
15741,提供者,3,576703,0.00048598,93.42254895
15742,提拔,3,576706,0.00048598,93.42303493
15743,提神,3,576709,0.00048598,93.42352091
15744,提煉,3,576712,0.00048598,93.42400689
15745,握持部,3,576715,0.00048598,93.42449288
15746,揭,3,576718,0.00048598,93.42497886
15747,揭幕,3,576721,0.00048598,93.42546484
15748,揮灑,3,576724,0.00048598,93.42595083
15749,援,3,576727,0.00048598,93.42643681
15750,換上,3,576730,0.00048598,93.42692279
15751,換言之,3,576733,0.00048598,93.42740877
15752,揚言,3,576736,0.00048598,93.42789476
15753,揚棄,3,576739,0.00048598,93.42838074
15754,敞開,3,576742,0.00048598,93.42886672
15755,敦化南北路,3,576745,0.00048598,93.42935270
15756,敦促,3,576748,0.00048598,93.42983869
15757,敦南店,3,576751,0.00048598,93.43032467
15758,敦珠仁波切,3,576754,0.00048598,93.43081065
15759,敦煌古典舞集,3,576757,0.00048598,93.43129663
15760,敦親睦鄰,3,576760,0.00048598,93.43178262
15761,散文,3,576763,0.00048598,93.43226860
15762,散去,3,576766,0.00048598,93.43275458
15763,散落,3,576769,0.00048598,93.43324056
15764,斯巴達,3,576772,0.00048598,93.43372655
15765,斯文,3,576775,0.00048598,93.43421253
15766,斯文豪氏蛙,3,576778,0.00048598,93.43469851
15767,普及率,3,576781,0.00048598,93.43518450
15768,普查,3,576784,0.00048598,93.43567048
15769,普寧腎,3,576787,0.00048598,93.43615646
15770,晶華酒店,3,576790,0.00048598,93.43664244
15771,景仰,3,576793,0.00048598,93.43712843
15772,暑期,3,576796,0.00048598,93.43761441
15773,智威湯遜,3,576799,0.00048598,93.43810039
15774,曾智偵,3,576802,0.00048598,93.43858637
15775,替代性,3,576805,0.00048598,93.43907236
15776,期交所,3,576808,0.00048598,93.43955834
15777,期勉,3,576811,0.00048598,93.44004432
15778,朝夕,3,576814,0.00048598,93.44053030
15779,朝代,3,576817,0.00048598,93.44101629
15780,棺材,3,576820,0.00048598,93.44150227
15781,棕熊,3,576823,0.00048598,93.44198825
15782,植物性,3,576826,0.00048598,93.44247423
15783,植食性,3,576829,0.00048598,93.44296022
15784,棉花,3,576832,0.00048598,93.44344620
15785,棉紡廠,3,576835,0.00048598,93.44393218
15786,殘缺,3,576838,0.00048598,93.44441817
15787,毯子,3,576841,0.00048598,93.44490415
15788,氮,3,576844,0.00048598,93.44539013
15789,氮氧化物,3,576847,0.00048598,93.44587611
15790,港星,3,576850,0.00048598,93.44636210
15791,港灣,3,576853,0.00048598,93.44684808
15792,游進,3,576856,0.00048598,93.44733406
15793,游離,3,576859,0.00048598,93.44782004
15794,渲染,3,576862,0.00048598,93.44830603
15795,湧現,3,576865,0.00048598,93.44879201
15796,湊巧,3,576868,0.00048598,93.44927799
15797,減掉,3,576871,0.00048598,93.44976397
15798,減損,3,576874,0.00048598,93.45024996
15799,減碼,3,576877,0.00048598,93.45073594
15800,湖北,3,576880,0.00048598,93.45122192
15801,湖底,3,576883,0.00048598,93.45170790
15802,湖面,3,576886,0.00048598,93.45219389
15803,湯布院,3,576889,0.00048598,93.45267987
15804,湯美森,3,576892,0.00048598,93.45316585
15805,湍急,3,576895,0.00048598,93.45365184
15806,測光系統,3,576898,0.00048598,93.45413782
15807,渾沌,3,576901,0.00048598,93.45462380
15808,渾身,3,576904,0.00048598,93.45510978
15809,渾身解數,3,576907,0.00048598,93.45559577
15810,焚燒,3,576910,0.00048598,93.45608175
15811,無妨,3,576913,0.00048598,93.45656773
15812,無私,3,576916,0.00048598,93.45705371
15813,無效,3,576919,0.00048598,93.45753970
15814,無時無刻,3,576922,0.00048598,93.45802568
15815,無能,3,576925,0.00048598,93.45851166
15816,無動於衷,3,576928,0.00048598,93.45899764
15817,無望,3,576931,0.00048598,93.45948363
15818,無微不至,3,576934,0.00048598,93.45996961
15819,無罪,3,576937,0.00048598,93.46045559
15820,無虞,3,576940,0.00048598,93.46094158
15821,無與倫比,3,576943,0.00048598,93.46142756
15822,無價,3,576946,0.00048598,93.46191354
15823,無緣無故,3,576949,0.00048598,93.46239952
15824,無礙,3,576952,0.00048598,93.46288551
15825,無權,3,576955,0.00048598,93.46337149
15826,煮菜,3,576958,0.00048598,93.46385747
15827,琵琶湖,3,576961,0.00048598,93.46434345
15828,畫室,3,576964,0.00048598,93.46482944
15829,畫集,3,576967,0.00048598,93.46531542
15830,畫圖,3,576970,0.00048598,93.46580140
15831,痙攣,3,576973,0.00048598,93.46628738
15832,痙攣症,3,576976,0.00048598,93.46677337
15833,登入,3,576979,0.00048598,93.46725935
15834,登輝,3,576982,0.00048598,93.46774533
15835,登錄,3,576985,0.00048598,93.46823131
15836,發亮,3,576988,0.00048598,93.46871730
15837,發洩,3,576991,0.00048598,93.46920328
15838,發紅,3,576994,0.00048598,93.46968926
15839,發射器,3,576997,0.00048598,93.47017525
15840,發展局長,3,577000,0.00048598,93.47066123
15841,發送端,3,577003,0.00048598,93.47114721
15842,發票,3,577006,0.00048598,93.47163319
15843,發揚,3,577009,0.00048598,93.47211918
15844,發給,3,577012,0.00048598,93.47260516
15845,發源,3,577015,0.00048598,93.47309114
15846,短路,3,577018,0.00048598,93.47357712
15847,短褲,3,577021,0.00048598,93.47406311
15848,硬朗,3,577024,0.00048598,93.47454909
15849,硬幣,3,577027,0.00048598,93.47503507
15850,硬碟機,3,577030,0.00048598,93.47552105
15851,稍早,3,577033,0.00048598,93.47600704
15852,程式化,3,577036,0.00048598,93.47649302
15853,程式設計師,3,577039,0.00048598,93.47697900
15854,稅後淨利,3,577042,0.00048598,93.47746498
15855,稅籍,3,577045,0.00048598,93.47795097
15856,稀飯,3,577048,0.00048598,93.47843695
15857,稀釋,3,577051,0.00048598,93.47892293
15858,窗口,3,577054,0.00048598,93.47940892
15859,窗戶,3,577057,0.00048598,93.47989490
15860,窗簾,3,577060,0.00048598,93.48038088
15861,童心,3,577063,0.00048598,93.48086686
15862,童書,3,577066,0.00048598,93.48135285
15863,童話故事,3,577069,0.00048598,93.48183883
15864,策,3,577072,0.00048598,93.48232481
15865,策略聯盟關係,3,577075,0.00048598,93.48281079
15866,筆記,3,577078,0.00048598,93.48329678
15867,筆記本,3,577081,0.00048598,93.48378276
15868,筆錄,3,577084,0.00048598,93.48426874
15869,結石,3,577087,0.00048598,93.48475472
15870,結帳,3,577090,0.00048598,93.48524071
15871,結盟,3,577093,0.00048598,93.48572669
15872,絕地任務,3,577096,0.00048598,93.48621267
15873,絕妙,3,577099,0.00048598,93.48669866
15874,絕對性,3,577102,0.00048598,93.48718464
15875,善事,3,577105,0.00048598,93.48767062
15876,善惡,3,577108,0.00048598,93.48815660
15877,舒舒服服,3,577111,0.00048598,93.48864259
15878,舒解,3,577114,0.00048598,93.48912857
15879,舒緩,3,577117,0.00048598,93.48961455
15880,舒適感,3,577120,0.00048598,93.49010053
15881,菸酒,3,577123,0.00048598,93.49058652
15882,華信,3,577126,0.00048598,93.49107250
15883,華夏,3,577129,0.00048598,93.49155848
15884,華裔,3,577132,0.00048598,93.49204446
15885,華碩,3,577135,0.00048598,93.49253045
15886,華衛電視台,3,577138,0.00048598,93.49301643
15887,著作,3,577141,0.00048598,93.49350241
15888,著急,3,577144,0.00048598,93.49398839
15889,萌生,3,577147,0.00048598,93.49447438
15890,菌,3,577150,0.00048598,93.49496036
15891,菲力浦,3,577153,0.00048598,93.49544634
15892,菜式,3,577156,0.00048598,93.49593233
15893,菜肴,3,577159,0.00048598,93.49641831
15894,菜圃,3,577162,0.00048598,93.49690429
15895,虛幻,3,577165,0.00048598,93.49739027
15896,虛假,3,577168,0.00048598,93.49787626
15897,裁,3,577171,0.00048598,93.49836224
15898,裁示,3,577174,0.00048598,93.49884822
15899,視察,3,577177,0.00048598,93.49933420
15900,視覺圖層服務,3,577180,0.00048598,93.49982019
15901,診察,3,577183,0.00048598,93.50030617
15902,診療室,3,577186,0.00048598,93.50079215
15903,貼身,3,577189,0.00048598,93.50127813
15904,費力,3,577192,0.00048598,93.50176412
15905,費心,3,577195,0.00048598,93.50225010
15906,費城,3,577198,0.00048598,93.50273608
15907,費曼,3,577201,0.00048598,93.50322206
15908,賀拉斯,3,577204,0.00048598,93.50370805
15909,賀爾蒙,3,577207,0.00048598,93.50419403
15910,貴重,3,577210,0.00048598,93.50468001
15911,買入,3,577213,0.00048598,93.50516600
15912,買點,3,577216,0.00048598,93.50565198
15913,貿易中心,3,577219,0.00048598,93.50613796
15914,貸款戶,3,577222,0.00048598,93.50662394
15915,越洋電話,3,577225,0.00048598,93.50710993
15916,越過,3,577228,0.00048598,93.50759591
15917,超任,3,577231,0.00048598,93.50808189
15918,超音波,3,577234,0.00048598,93.50856787
15919,超音速,3,577237,0.00048598,93.50905386
15920,超跌,3,577240,0.00048598,93.50953984
15921,超微,3,577243,0.00048598,93.51002582
15922,超載,3,577246,0.00048598,93.51051180
15923,超額,3,577249,0.00048598,93.51099779
15924,距離感,3,577252,0.00048598,93.51148377
15925,跑回,3,577255,0.00048598,93.51196975
15926,跑路,3,577258,0.00048598,93.51245574
15927,跌到,3,577261,0.00048598,93.51294172
15928,跌倒,3,577264,0.00048598,93.51342770
15929,辜濂松,3,577267,0.00048598,93.51391368
15930,週六,3,577270,0.00048598,93.51439967
15931,週四,3,577273,0.00048598,93.51488565
15932,週末,3,577276,0.00048598,93.51537163
15933,週全,3,577279,0.00048598,93.51585761
15934,週轉率,3,577282,0.00048598,93.51634360
15935,進貨,3,577285,0.00048598,93.51682958
15936,進階,3,577288,0.00048598,93.51731556
15937,郵購,3,577291,0.00048598,93.51780154
15938,鄉下人,3,577294,0.00048598,93.51828753
15939,鄉間,3,577297,0.00048598,93.51877351
15940,鄉鎮市,3,577300,0.00048598,93.51925949
15941,酥,3,577303,0.00048598,93.51974547
15942,鈕,3,577306,0.00048598,93.52023146
15943,鈣化,3,577309,0.00048598,93.52071744
15944,開工,3,577312,0.00048598,93.52120342
15945,開出來,3,577315,0.00048598,93.52168941
15946,開放式,3,577318,0.00048598,93.52217539
15947,開航,3,577321,0.00048598,93.52266137
15948,開高走低,3,577324,0.00048598,93.52314735
15949,開船,3,577327,0.00048598,93.52363334
15950,開喜草本飲料,3,577330,0.00048598,93.52411932
15951,開場,3,577333,0.00048598,93.52460530
15952,開普敦,3,577336,0.00048598,93.52509128
15953,開路,3,577339,0.00048598,93.52557727
15954,開戰,3,577342,0.00048598,93.52606325
15955,開辦,3,577345,0.00048598,93.52654923
15956,開賽,3,577348,0.00048598,93.52703521
15957,開疆闢土,3,577351,0.00048598,93.52752120
15958,間歇性,3,577354,0.00048598,93.52800718
15959,隊形,3,577357,0.00048598,93.52849316
15960,陽剛,3,577360,0.00048598,93.52897914
15961,隆重,3,577363,0.00048598,93.52946513
15962,雅,3,577366,0.00048598,93.52995111
15963,雅典城,3,577369,0.00048598,93.53043709
15964,雅虎公司,3,577372,0.00048598,93.53092308
15965,雅姿韻律世界,3,577375,0.00048598,93.53140906
15966,雅鉅公司,3,577378,0.00048598,93.53189504
15967,雇,3,577381,0.00048598,93.53238102
15968,雲南菜,3,577384,0.00048598,93.53286701
15969,項鍊,3,577387,0.00048598,93.53335299
15970,順手,3,577390,0.00048598,93.53383897
15971,飲酒,3,577393,0.00048598,93.53432495
15972,黃平洋,3,577396,0.00048598,93.53481094
15973,黃永仁,3,577399,0.00048598,93.53529692
15974,黃玉炎,3,577402,0.00048598,93.53578290
15975,黃安,3,577405,0.00048598,93.53626888
15976,黃孝棪,3,577408,0.00048598,93.53675487
15977,黃宏隆,3,577411,0.00048598,93.53724085
15978,黃宏裕,3,577414,0.00048598,93.53772683
15979,黃秀孟,3,577417,0.00048598,93.53821282
15980,黃俊英,3,577420,0.00048598,93.53869880
15981,黃春雄,3,577423,0.00048598,93.53918478
15982,黃復興,3,577426,0.00048598,93.53967076
15983,黃朝俊,3,577429,0.00048598,93.54015675
15984,黃廣琪,3,577432,0.00048598,93.54064273
15985,黃慶和,3,577435,0.00048598,93.54112871
15986,黑手,3,577438,0.00048598,93.54161469
15987,黑社會,3,577441,0.00048598,93.54210068
15988,黑胡椒,3,577444,0.00048598,93.54258666
15989,黑啤酒,3,577447,0.00048598,93.54307264
15990,黑煙,3,577450,0.00048598,93.54355862
15991,黑龍,3,577453,0.00048598,93.54404461
15992,黑曜石,3,577456,0.00048598,93.54453059
15993,亂世佳人,3,577459,0.00048598,93.54501657
15994,債券市場,3,577462,0.00048598,93.54550255
15995,傳入,3,577465,0.00048598,93.54598854
15996,傳染病,3,577468,0.00048598,93.54647452
15997,傳真機,3,577471,0.00048598,93.54696050
15998,傳教,3,577474,0.00048598,93.54744649
15999,傳教師,3,577477,0.00048598,93.54793247
16000,傳球,3,577480,0.00048598,93.54841845
16001,傾盆大雨,3,577483,0.00048598,93.54890443
16002,傾斜,3,577486,0.00048598,93.54939042
16003,傷及,3,577489,0.00048598,93.54987640
16004,傷悲,3,577492,0.00048598,93.55036238
16005,募,3,577495,0.00048598,93.55084836
16006,勤務,3,577498,0.00048598,93.55133435
16007,勤奮,3,577501,0.00048598,93.55182033
16008,匯僑,3,577504,0.00048598,93.55230631
16009,嗅覺,3,577507,0.00048598,93.55279229
16010,嗆傷,3,577510,0.00048598,93.55327828
16011,圓型,3,577513,0.00048598,93.55376426
16012,圓滑,3,577516,0.00048598,93.55425024
16013,圓潤,3,577519,0.00048598,93.55473622
16014,塞滿,3,577522,0.00048598,93.55522221
16015,塑膠袋,3,577525,0.00048598,93.55570819
16016,塑膠貨幣,3,577528,0.00048598,93.55619417
16017,填補,3,577531,0.00048598,93.55668016
16018,填滿,3,577534,0.00048598,93.55716614
16019,塊狀,3,577537,0.00048598,93.55765212
16020,奧立佛史東,3,577540,0.00048598,93.55813810
16021,奧克蘭,3,577543,0.00048598,93.55862409
16022,奧林巴斯,3,577546,0.00048598,93.55911007
16023,奧祕,3,577549,0.00048598,93.55959605
16024,奧圖,3,577552,0.00048598,93.56008203
16025,嫉妒,3,577555,0.00048598,93.56056802
16026,嫂,3,577558,0.00048598,93.56105400
16027,幹警,3,577561,0.00048598,93.56153998
16028,微處理器,3,577564,0.00048598,93.56202596
16029,微幅,3,577567,0.00048598,93.56251195
16030,微塵,3,577570,0.00048598,93.56299793
16031,微縮,3,577573,0.00048598,93.56348391
16032,愚蠢,3,577576,0.00048598,93.56396989
16033,意氣風發,3,577579,0.00048598,93.56445588
16034,意淫,3,577582,0.00048598,93.56494186
16035,慈,3,577585,0.00048598,93.56542784
16036,慈濟宮,3,577588,0.00048598,93.56591383
16037,感同身受,3,577591,0.00048598,93.56639981
16038,感官,3,577594,0.00048598,93.56688579
16039,感念,3,577597,0.00048598,93.56737177
16040,感染者,3,577600,0.00048598,93.56785776
16041,感染率,3,577603,0.00048598,93.56834374
16042,感嘆,3,577606,0.00048598,93.56882972
16043,感歎,3,577609,0.00048598,93.56931570
16044,想起,3,577612,0.00048598,93.56980169
16045,想起來,3,577615,0.00048598,93.57028767
16046,想像力,3,577618,0.00048598,93.57077365
16047,愛人,3,577621,0.00048598,93.57125963
16048,愛好者,3,577624,0.00048598,93.57174562
16049,愛慕,3,577627,0.00048598,93.57223160
16050,愛護,3,577630,0.00048598,93.57271758
16051,搞定,3,577633,0.00048598,93.57320357
16052,搭檔,3,577636,0.00048598,93.57368955
16053,搬遷費,3,577639,0.00048598,93.57417553
16054,搏鬥,3,577642,0.00048598,93.57466151
16055,搜救,3,577645,0.00048598,93.57514750
16056,搜尋引擎,3,577648,0.00048598,93.57563348
16057,搜集,3,577651,0.00048598,93.57611946
16058,損友,3,577654,0.00048598,93.57660544
16059,損毀,3,577657,0.00048598,93.57709143
16060,搶手,3,577660,0.00048598,93.57757741
16061,搶進,3,577663,0.00048598,93.57806339
16062,搖曳,3,577666,0.00048598,93.57854937
16063,搖桿,3,577669,0.00048598,93.57903536
16064,新人王,3,577672,0.00048598,93.57952134
16065,新手,3,577675,0.00048598,93.58000732
16066,新皮質,3,577678,0.00048598,93.58049330
16067,新光三越,3,577681,0.00048598,93.58097929
16068,新式,3,577684,0.00048598,93.58146527
16069,新竹縣立文化中心,3,577687,0.00048598,93.58195125
16070,新秀,3,577690,0.00048598,93.58243724
16071,新車整備中心,3,577693,0.00048598,93.58292322
16072,新知,3,577696,0.00048598,93.58340920
16073,新娘,3,577699,0.00048598,93.58389518
16074,新婚,3,577702,0.00048598,93.58438117
16075,新莊國小,3,577705,0.00048598,93.58486715
16076,新陳代謝科,3,577708,0.00048598,93.58535313
16077,新幾內亞,3,577711,0.00048598,93.58583911
16078,新款,3,577714,0.00048598,93.58632510
16079,新貴,3,577717,0.00048598,93.58681108
16080,新聞工作者,3,577720,0.00048598,93.58729706
16081,新聞局長,3,577723,0.00048598,93.58778304
16082,新聞週刊,3,577726,0.00048598,93.58826903
16083,新臺幣,3,577729,0.00048598,93.58875501
16084,新興分局,3,577732,0.00048598,93.58924099
16085,新舊,3,577735,0.00048598,93.58972697
16086,暗中,3,577738,0.00048598,93.59021296
16087,暈,3,577741,0.00048598,93.59069894
16088,會是,3,577744,0.00048598,93.59118492
16089,會員國,3,577747,0.00048598,93.59167091
16090,會師,3,577750,0.00048598,93.59215689
16091,榔頭,3,577753,0.00048598,93.59264287
16092,業務量,3,577756,0.00048598,93.59312885
16093,楚留香,3,577759,0.00048598,93.59361484
16094,極品,3,577762,0.00048598,93.59410082
16095,楊天發,3,577765,0.00048598,93.59458680
16096,楊梅,3,577768,0.00048598,93.59507278
16097,楊瑞華,3,577771,0.00048598,93.59555877
16098,楊璧睿,3,577774,0.00048598,93.59604475
16099,楓,3,577777,0.00048598,93.59653073
16100,楓紅,3,577780,0.00048598,93.59701671
16101,溢,3,577783,0.00048598,93.59750270
16102,溢乳,3,577786,0.00048598,93.59798868
16103,溢價,3,577789,0.00048598,93.59847466
16104,溶,3,577792,0.00048598,93.59896065
16105,溺,3,577795,0.00048598,93.59944663
16106,溫床,3,577798,0.00048598,93.59993261
16107,準則,3,577801,0.00048598,93.60041859
16108,準確性,3,577804,0.00048598,93.60090458
16109,溪水,3,577807,0.00048598,93.60139056
16110,溪谷,3,577810,0.00048598,93.60187654
16111,煎熬,3,577813,0.00048598,93.60236252
16112,煙消雲散,3,577816,0.00048598,93.60284851
16113,煉鋼,3,577819,0.00048598,93.60333449
16114,照射,3,577822,0.00048598,93.60382047
16115,照常,3,577825,0.00048598,93.60430645
16116,煥然一新,3,577828,0.00048598,93.60479244
16117,瑞士銀行,3,577831,0.00048598,93.60527842
16118,瑞克,3,577834,0.00048598,93.60576440
16119,當代傳奇劇場,3,577837,0.00048598,93.60625038
16120,當季,3,577840,0.00048598,93.60673637
16121,當晚,3,577843,0.00048598,93.60722235
16122,當道,3,577846,0.00048598,93.60770833
16123,當機,3,577849,0.00048598,93.60819432
16124,當歸,3,577852,0.00048598,93.60868030
16125,畸形,3,577855,0.00048598,93.60916628
16126,痲痺,3,577858,0.00048598,93.60965226
16127,盟,3,577861,0.00048598,93.61013825
16128,盟主,3,577864,0.00048598,93.61062423
16129,督訓,3,577867,0.00048598,93.61111021
16130,督察室,3,577870,0.00048598,93.61159619
16131,碰到,3,577873,0.00048598,93.61208218
16132,碰壁,3,577876,0.00048598,93.61256816
16133,碰頭,3,577879,0.00048598,93.61305414
16134,碑文,3,577882,0.00048598,93.61354012
16135,禁運,3,577885,0.00048598,93.61402611
16136,萬全,3,577888,0.00048598,93.61451209
16137,萬泰銀行,3,577891,0.00048598,93.61499807
16138,萬通銀行,3,577894,0.00048598,93.61548405
16139,窟,3,577897,0.00048598,93.61597004
16140,節節,3,577900,0.00048598,93.61645602
16141,經建,3,577903,0.00048598,93.61694200
16142,經援,3,577906,0.00048598,93.61742799
16143,經貿往來,3,577909,0.00048598,93.61791397
16144,經貿關係,3,577912,0.00048598,93.61839995
16145,綑,3,577915,0.00048598,93.61888593
16146,置入,3,577918,0.00048598,93.61937192
16147,罪行,3,577921,0.00048598,93.61985790
16148,署,3,577924,0.00048598,93.62034388
16149,群組,3,577927,0.00048598,93.62082986
16150,群落,3,577930,0.00048598,93.62131585
16151,聖,3,577933,0.00048598,93.62180183
16152,聖人,3,577936,0.00048598,93.62228781
16153,聖巴索教堂,3,577939,0.00048598,93.62277379
16154,聖地牙哥,3,577942,0.00048598,93.62325978
16155,聖詩,3,577945,0.00048598,93.62374576
16156,聖像,3,577948,0.00048598,93.62423174
16157,肆,3,577951,0.00048598,93.62471773
16158,腰痠背痛,3,577954,0.00048598,93.62520371
16159,腸道,3,577957,0.00048598,93.62568969
16160,腳程,3,577960,0.00048598,93.62617567
16161,腳踝,3,577963,0.00048598,93.62666166
16162,腳踏實地,3,577966,0.00048598,93.62714764
16163,腫痛,3,577969,0.00048598,93.62763362
16164,腹斑蛙,3,577972,0.00048598,93.62811960
16165,腹膜,3,577975,0.00048598,93.62860559
16166,腹膜鞘狀突,3,577978,0.00048598,93.62909157
16167,腹壁,3,577981,0.00048598,93.62957755
16168,腹壓,3,577984,0.00048598,93.63006353
16169,腦力,3,577987,0.00048598,93.63054952
16170,落入,3,577990,0.00048598,93.63103550
16171,落下,3,577993,0.00048598,93.63152148
16172,落井下石,3,577996,0.00048598,93.63200746
16173,落空,3,577999,0.00048598,93.63249345
16174,落網,3,578002,0.00048598,93.63297943
16175,葉耀鵬,3,578005,0.00048598,93.63346541
16176,葬禮,3,578008,0.00048598,93.63395140
16177,葛林,3,578011,0.00048598,93.63443738
16178,葛倫克蘿絲,3,578014,0.00048598,93.63492336
16179,葛瑞坎納,3,578017,0.00048598,93.63540934
16180,葛瑞契,3,578020,0.00048598,93.63589533
16181,董,3,578023,0.00048598,93.63638131
16182,蜂蜜,3,578026,0.00048598,93.63686729
16183,補足,3,578029,0.00048598,93.63735327
16184,補救,3,578032,0.00048598,93.63783926
16185,補習,3,578035,0.00048598,93.63832524
16186,補給品,3,578038,0.00048598,93.63881122
16187,裝訂廠,3,578041,0.00048598,93.63929720
16188,裝配廠,3,578044,0.00048598,93.63978319
16189,裝飾物,3,578047,0.00048598,93.64026917
16190,裕豐,3,578050,0.00048598,93.64075515
16191,解析力,3,578053,0.00048598,93.64124113
16192,解救,3,578056,0.00048598,93.64172712
16193,解散,3,578059,0.00048598,93.64221310
16194,解聘,3,578062,0.00048598,93.64269908
16195,解像力,3,578065,0.00048598,93.64318507
16196,解說員,3,578068,0.00048598,93.64367105
16197,解壓,3,578071,0.00048598,93.64415703
16198,解體,3,578074,0.00048598,93.64464301
16199,試用,3,578077,0.00048598,93.64512900
16200,試聽,3,578080,0.00048598,93.64561498
16201,誇耀,3,578083,0.00048598,93.64610096
16202,誠信,3,578086,0.00048598,93.64658694
16203,誠摯,3,578089,0.00048598,93.64707293
16204,詹惠珠,3,578092,0.00048598,93.64755891
16205,跨入,3,578095,0.00048598,93.64804489
16206,跨國,3,578098,0.00048598,93.64853087
16207,路人,3,578101,0.00048598,93.64901686
16208,路口,3,578104,0.00048598,93.64950284
16209,路面,3,578107,0.00048598,93.64998882
16210,跤,3,578110,0.00048598,93.65047481
16211,躲藏,3,578113,0.00048598,93.65096079
16212,較勁,3,578116,0.00048598,93.65144677
16213,農友,3,578119,0.00048598,93.65193275
16214,農田水利會,3,578122,0.00048598,93.65241874
16215,農舍,3,578125,0.00048598,93.65290472
16216,農曆年,3,578128,0.00048598,93.65339070
16217,運行,3,578131,0.00048598,93.65387668
16218,運河,3,578134,0.00048598,93.65436267
16219,運動家,3,578137,0.00048598,93.65484865
16220,運費,3,578140,0.00048598,93.65533463
16221,運輸機,3,578143,0.00048598,93.65582061
16222,遊民,3,578146,0.00048598,93.65630660
16223,遊園,3,578149,0.00048598,93.65679258
16224,遊說,3,578152,0.00048598,93.65727856
16225,遊蕩,3,578155,0.00048598,93.65776454
16226,道士,3,578158,0.00048598,93.65825053
16227,道別,3,578161,0.00048598,93.65873651
16228,道場,3,578164,0.00048598,93.65922249
16229,道瓊,3,578167,0.00048598,93.65970848
16230,達達尼爾海峽,3,578170,0.00048598,93.66019446
16231,違,3,578173,0.00048598,93.66068044
16232,違章,3,578176,0.00048598,93.66116642
16233,過戶,3,578179,0.00048598,93.66165241
16234,過氧化氫,3,578182,0.00048598,93.66213839
16235,過橋,3,578185,0.00048598,93.66262437
16236,遍及,3,578188,0.00048598,93.66311035
16237,遍布,3,578191,0.00048598,93.66359634
16238,逾期,3,578194,0.00048598,93.66408232
16239,鉛字,3,578197,0.00048598,93.66456830
16240,鉅,3,578200,0.00048598,93.66505428
16241,鉅細靡遺,3,578203,0.00048598,93.66554027
16242,隔絕,3,578206,0.00048598,93.66602625
16243,隔間,3,578209,0.00048598,93.66651223
16244,隕石,3,578212,0.00048598,93.66699821
16245,雷瓦,3,578215,0.00048598,93.66748420
16246,雷同,3,578218,0.00048598,93.66797018
16247,雷虎小組,3,578221,0.00048598,93.66845616
16248,雷班斯基維爾,3,578224,0.00048598,93.66894215
16249,雷電,3,578227,0.00048598,93.66942813
16250,電信公司,3,578230,0.00048598,93.66991411
16251,電扇,3,578233,0.00048598,93.67040009
16252,電動車,3,578236,0.00048598,93.67088608
16253,電視周刊,3,578239,0.00048598,93.67137206
16254,電腦家庭,3,578242,0.00048598,93.67185804
16255,電腦業,3,578245,0.00048598,93.67234402
16256,電影節,3,578248,0.00048598,93.67283001
16257,電檢,3,578251,0.00048598,93.67331599
16258,零用錢,3,578254,0.00048598,93.67380197
16259,零碎,3,578257,0.00048598,93.67428795
16260,零錢,3,578260,0.00048598,93.67477394
16261,預知,3,578263,0.00048598,93.67525992
16262,預謀,3,578266,0.00048598,93.67574590
16263,頑固,3,578269,0.00048598,93.67623188
16264,飼料,3,578272,0.00048598,93.67671787
16265,飽滿,3,578275,0.00048598,93.67720385
16266,馳,3,578278,0.00048598,93.67768983
16267,馳名,3,578281,0.00048598,93.67817582
16268,鼎,3,578284,0.00048598,93.67866180
16269,鼓吹,3,578287,0.00048598,93.67914778
16270,鼓起,3,578290,0.00048598,93.67963376
16271,像倍率,3,578293,0.00048598,93.68011975
16272,僑銀,3,578296,0.00048598,93.68060573
16273,兢兢業業,3,578299,0.00048598,93.68109171
16274,劃時代,3,578302,0.00048598,93.68157769
16275,匱乏,3,578305,0.00048598,93.68206368
16276,厭煩,3,578308,0.00048598,93.68254966
16277,嘔心瀝血,3,578311,0.00048598,93.68303564
16278,嘉泥,3,578314,0.00048598,93.68352162
16279,嘉納,3,578317,0.00048598,93.68400761
16280,團聚,3,578320,0.00048598,93.68449359
16281,圖坦卡門王,3,578323,0.00048598,93.68497957
16282,圖書,3,578326,0.00048598,93.68546556
16283,塵囂,3,578329,0.00048598,93.68595154
16284,境外航運中心,3,578332,0.00048598,93.68643752
16285,境地,3,578335,0.00048598,93.68692350
16286,墊,3,578338,0.00048598,93.68740949
16287,夥同,3,578341,0.00048598,93.68789547
16288,夢境,3,578344,0.00048598,93.68838145
16289,嫩,3,578347,0.00048598,93.68886743
16290,孵卵槽,3,578350,0.00048598,93.68935342
16291,寥寥,3,578353,0.00048598,93.68983940
16292,實話,3,578356,0.00048598,93.69032538
16293,實戰,3,578359,0.00048598,93.69081136
16294,實驗品,3,578362,0.00048598,93.69129735
16295,寢室,3,578365,0.00048598,93.69178333
16296,對話盒,3,578368,0.00048598,93.69226931
16297,屢次,3,578371,0.00048598,93.69275529
16298,幣值,3,578374,0.00048598,93.69324128
16299,彰化分局,3,578377,0.00048598,93.69372726
16300,慣用,3,578380,0.00048598,93.69421324
16301,慘不忍睹,3,578383,0.00048598,93.69469923
16302,慘遭,3,578386,0.00048598,93.69518521
16303,撇開,3,578389,0.00048598,93.69567119
16304,摘,3,578392,0.00048598,93.69615717
16305,摸索,3,578395,0.00048598,93.69664316
16306,敲打,3,578398,0.00048598,93.69712914
16307,斡旋金,3,578401,0.00048598,93.69761512
16308,榜首,3,578404,0.00048598,93.69810110
16309,榜樣,3,578407,0.00048598,93.69858709
16310,榕樹,3,578410,0.00048598,93.69907307
16311,構工,3,578413,0.00048598,93.69955905
16312,構成主義,3,578416,0.00048598,93.70004503
16313,榴槤,3,578419,0.00048598,93.70053102
16314,歌詞,3,578422,0.00048598,93.70101700
16315,歌頌,3,578425,0.00048598,93.70150298
16316,歌舞,3,578428,0.00048598,93.70198896
16317,演進,3,578431,0.00048598,93.70247495
16318,演繹,3,578434,0.00048598,93.70296093
16319,演藝人員,3,578437,0.00048598,93.70344691
16320,滾石,3,578440,0.00048598,93.70393290
16321,滾動,3,578443,0.00048598,93.70441888
16322,漏,3,578446,0.00048598,93.70490486
16323,漏氣,3,578449,0.00048598,93.70539084
16324,漂浮,3,578452,0.00048598,93.70587683
16325,漢,3,578455,0.00048598,93.70636281
16326,漢字,3,578458,0.00048598,93.70684879
16327,漢唐,3,578461,0.00048598,93.70733477
16328,滿佈,3,578464,0.00048598,93.70782076
16329,滿貫全壘打,3,578467,0.00048598,93.70830674
16330,漲停板,3,578470,0.00048598,93.70879272
16331,漫迷,3,578473,0.00048598,93.70927870
16332,滲,3,578476,0.00048598,93.70976469
16333,滲透,3,578479,0.00048598,93.71025067
16334,熊市,3,578482,0.00048598,93.71073665
16335,熊安平,3,578485,0.00048598,93.71122264
16336,熄,3,578488,0.00048598,93.71170862
16337,爾,3,578491,0.00048598,93.71219460
16338,瑪格麗特,3,578494,0.00048598,93.71268058
16339,瑪麗亞,3,578497,0.00048598,93.71316657
16340,疑似,3,578500,0.00048598,93.71365255
16341,監理單位,3,578503,0.00048598,93.71413853
16342,監察院,3,578506,0.00048598,93.71462451
16343,監察院長,3,578509,0.00048598,93.71511050
16344,瞄準,3,578512,0.00048598,93.71559648
16345,磁頭,3,578515,0.00048598,93.71608246
16346,碟,3,578518,0.00048598,93.71656844
16347,碳質,3,578521,0.00048598,93.71705443
16348,碩士班,3,578524,0.00048598,93.71754041
16349,福地,3,578527,0.00048598,93.71802639
16350,福州,3,578530,0.00048598,93.71851237
16351,福報,3,578533,0.00048598,93.71899836
16352,福斯公司,3,578536,0.00048598,93.71948434
16353,福斯汽車,3,578539,0.00048598,93.71997032
16354,稱許,3,578542,0.00048598,93.72045631
16355,管弦樂,3,578545,0.00048598,93.72094229
16356,管家,3,578548,0.00048598,93.72142827
16357,管理人,3,578551,0.00048598,93.72191425
16358,管理主義,3,578554,0.00048598,93.72240024
16359,算出,3,578557,0.00048598,93.72288622
16360,箝制,3,578560,0.00048598,93.72337220
16361,箝制性,3,578563,0.00048598,93.72385818
16362,箇,3,578566,0.00048598,93.72434417
16363,精細,3,578569,0.00048598,93.72483015
16364,精通,3,578572,0.00048598,93.72531613
16365,精湛,3,578575,0.00048598,93.72580211
16366,精業,3,578578,0.00048598,93.72628810
16367,精簡,3,578581,0.00048598,93.72677408
16368,綻放,3,578584,0.00048598,93.72726006
16369,綜合所得稅,3,578587,0.00048598,93.72774604
16370,綜藝,3,578590,0.00048598,93.72823203
16371,綜藝節目,3,578593,0.00048598,93.72871801
16372,綠油油,3,578596,0.00048598,93.72920399
16373,綠島,3,578599,0.00048598,93.72968998
16374,綠燈,3,578602,0.00048598,93.73017596
16375,綠黨,3,578605,0.00048598,93.73066194
16376,緊閉,3,578608,0.00048598,93.73114792
16377,網絡,3,578611,0.00048598,93.73163391
16378,罰鍰,3,578614,0.00048598,93.73211989
16379,翠綠,3,578617,0.00048598,93.73260587
16380,肇,3,578620,0.00048598,93.73309185
16381,肇因,3,578623,0.00048598,93.73357784
16382,與生俱來,3,578626,0.00048598,93.73406382
16383,與狼共舞,3,578629,0.00048598,93.73454980
16384,舞步,3,578632,0.00048598,93.73503578
16385,舞會,3,578635,0.00048598,93.73552177
16386,舞臺,3,578638,0.00048598,93.73600775
16387,舞廳,3,578641,0.00048598,93.73649373
16388,蓄勢待發,3,578644,0.00048598,93.73697972
16389,蓄意,3,578647,0.00048598,93.73746570
16390,蒙古,3,578650,0.00048598,93.73795168
16391,蒙古人,3,578653,0.00048598,93.73843766
16392,蒙迪安諾,3,578656,0.00048598,93.73892365
16393,蒙面,3,578659,0.00048598,93.73940963
16394,蒙特婁,3,578662,0.00048598,93.73989561
16395,蒞臨,3,578665,0.00048598,93.74038159
16396,蒜,3,578668,0.00048598,93.74086758
16397,蒸氣,3,578671,0.00048598,93.74135356
16398,蒸發,3,578674,0.00048598,93.74183954
16399,蜥蜴,3,578677,0.00048598,93.74232552
16400,蜷縮,3,578680,0.00048598,93.74281151
16401,裴,3,578683,0.00048598,93.74329749
16402,裹,3,578686,0.00048598,93.74378347
16403,裸男,3,578689,0.00048598,93.74426945
16404,製版,3,578692,0.00048598,93.74475544
16405,誦經,3,578695,0.00048598,93.74524142
16406,語法,3,578698,0.00048598,93.74572740
16407,語意學家,3,578701,0.00048598,93.74621339
16408,認同感,3,578704,0.00048598,93.74669937
16409,誤導,3,578707,0.00048598,93.74718535
16410,說穿,3,578710,0.00048598,93.74767133
16411,說說,3,578713,0.00048598,93.74815732
16412,豪氣,3,578716,0.00048598,93.74864330
16413,趙曼君,3,578719,0.00048598,93.74912928
16414,輒,3,578722,0.00048598,93.74961526
16415,輕快,3,578725,0.00048598,93.75010125
16416,輕視,3,578728,0.00048598,93.75058723
16417,輕輕鬆鬆,3,578731,0.00048598,93.75107321
16418,遠赴,3,578734,0.00048598,93.75155919
16419,遙,3,578737,0.00048598,93.75204518
16420,酸,3,578740,0.00048598,93.75253116
16421,酸性,3,578743,0.00048598,93.75301714
16422,酸洗廠,3,578746,0.00048598,93.75350312
16423,銀行法,3,578749,0.00048598,93.75398911
16424,銅板,3,578752,0.00048598,93.75447509
16425,隙,3,578755,0.00048598,93.75496107
16426,障礙物,3,578758,0.00048598,93.75544706
16427,領帶與高跟鞋,3,578761,0.00048598,93.75593304
16428,領略,3,578764,0.00048598,93.75641902
16429,領會,3,578767,0.00048598,93.75690500
16430,領銜,3,578770,0.00048598,93.75739099
16431,領導力,3,578773,0.00048598,93.75787697
16432,髦兒班,3,578776,0.00048598,93.75836295
16433,鳴叫,3,578779,0.00048598,93.75884893
16434,鳳凰,3,578782,0.00048598,93.75933492
16435,鳳梨,3,578785,0.00048598,93.75982090
16436,鼻腔,3,578788,0.00048598,93.76030688
16437,鼻頭,3,578791,0.00048598,93.76079286
16438,價金,3,578794,0.00048598,93.76127885
16439,價廉,3,578797,0.00048598,93.76176483
16440,儂儂,3,578800,0.00048598,93.76225081
16441,劇目,3,578803,0.00048598,93.76273680
16442,劇組,3,578806,0.00048598,93.76322278
16443,劉一德,3,578809,0.00048598,93.76370876
16444,劉正治,3,578812,0.00048598,93.76419474
16445,劉進興,3,578815,0.00048598,93.76468073
16446,劉麗文,3,578818,0.00048598,93.76516671
16447,劉麗珠,3,578821,0.00048598,93.76565269
16448,嘴臉,3,578824,0.00048598,93.76613867
16449,噴出,3,578827,0.00048598,93.76662466
16450,噴泉,3,578830,0.00048598,93.76711064
16451,噴灑,3,578833,0.00048598,93.76759662
16452,增訂,3,578836,0.00048598,93.76808260
16453,增設,3,578839,0.00048598,93.76856859
16454,墜落,3,578842,0.00048598,93.76905457
16455,嬌滴滴,3,578845,0.00048598,93.76954055
16456,寬容度,3,578848,0.00048598,93.77002653
16457,審定本,3,578851,0.00048598,93.77051252
16458,審查小組,3,578854,0.00048598,93.77099850
16459,審查會,3,578857,0.00048598,93.77148448
16460,審美觀,3,578860,0.00048598,93.77197047
16461,寫生,3,578863,0.00048598,93.77245645
16462,寫信,3,578866,0.00048598,93.77294243
16463,履約,3,578869,0.00048598,93.77342841
16464,廚,3,578872,0.00048598,93.77391440
16465,廣告獎,3,578875,0.00048598,93.77440038
16466,廣度,3,578878,0.00048598,93.77488636
16467,廣電法,3,578881,0.00048598,93.77537234
16468,彈頭,3,578884,0.00048598,93.77585833
16469,影后,3,578887,0.00048598,93.77634431
16470,影音,3,578890,0.00048598,93.77683029
16471,影像工作者,3,578893,0.00048598,93.77731627
16472,影像處理,3,578896,0.00048598,93.77780226
16473,影壇,3,578899,0.00048598,93.77828824
16474,德州薯條,3,578902,0.00048598,93.77877422
16475,德碁,3,578905,0.00048598,93.77926020
16476,徵兆,3,578908,0.00048598,93.77974619
16477,徵收,3,578911,0.00048598,93.78023217
16478,慧眼,3,578914,0.00048598,93.78071815
16479,慧敬,3,578917,0.00048598,93.78120414
16480,慰勞,3,578920,0.00048598,93.78169012
16481,摩根史坦利公司,3,578923,0.00048598,93.78217610
16482,摩根史坦利新興市場自由指數,3,578926,0.00048598,93.78266208
16483,摩登,3,578929,0.00048598,93.78314807
16484,撰,3,578932,0.00048598,93.78363405
16485,撕破,3,578935,0.00048598,93.78412003
16486,撕票,3,578938,0.00048598,93.78460601
16487,數位照相機,3,578941,0.00048598,93.78509200
16488,暴利,3,578944,0.00048598,93.78557798
16489,暴漲,3,578947,0.00048598,93.78606396
16490,暴躁,3,578950,0.00048598,93.78654994
16491,樣本,3,578953,0.00048598,93.78703593
16492,標本,3,578956,0.00048598,93.78752191
16493,標的物,3,578959,0.00048598,93.78800789
16494,標記,3,578962,0.00048598,93.78849387
16495,標準差,3,578965,0.00048598,93.78897986
16496,標準線,3,578968,0.00048598,93.78946584
16497,標價,3,578971,0.00048598,93.78995182
16498,模,3,578974,0.00048598,93.79043781
16499,模式化,3,578977,0.00048598,93.79092379
16500,模具,3,578980,0.00048598,93.79140977
16501,模範,3,578983,0.00048598,93.79189575
16502,樓梯間,3,578986,0.00048598,93.79238174
16503,樊潔兮舞團,3,578989,0.00048598,93.79286772
16504,樂見,3,578992,0.00048598,93.79335370
16505,樂風,3,578995,0.00048598,93.79383968
16506,樂意,3,578998,0.00048598,93.79432567
16507,樂譜,3,579001,0.00048598,93.79481165
16508,歐陽鍾美,3,579004,0.00048598,93.79529763
16509,潔,3,579007,0.00048598,93.79578361
16510,潭,3,579010,0.00048598,93.79626960
16511,潛艇,3,579013,0.00048598,93.79675558
16512,潮州鎮,3,579016,0.00048598,93.79724156
16513,潮汐,3,579019,0.00048598,93.79772755
16514,潮濕,3,579022,0.00048598,93.79821353
16515,澎湖縣,3,579025,0.00048598,93.79869951
16516,潤滑劑,3,579028,0.00048598,93.79918549
16517,熟稔,3,579031,0.00048598,93.79967148
16518,熱氣,3,579034,0.00048598,93.80015746
16519,熱線,3,579037,0.00048598,93.80064344
16520,獎品,3,579040,0.00048598,93.80112942
16521,獎牌,3,579043,0.00048598,93.80161541
16522,璀璨,3,579046,0.00048598,93.80210139
16523,盤口,3,579049,0.00048598,93.80258737
16524,盤古蟾蜍,3,579052,0.00048598,93.80307335
16525,盤查,3,579055,0.00048598,93.80355934
16526,盤旋,3,579058,0.00048598,93.80404532
16527,盤整,3,579061,0.00048598,93.80453130
16528,瞎拼,3,579064,0.00048598,93.80501728
16529,稿子,3,579067,0.00048598,93.80550327
16530,稿費,3,579070,0.00048598,93.80598925
16531,穀,3,579073,0.00048598,93.80647523
16532,稻垣,3,579076,0.00048598,93.80696122
16533,箭,3,579079,0.00048598,93.80744720
16534,箭鏃,3,579082,0.00048598,93.80793318
16535,範本,3,579085,0.00048598,93.80841916
16536,緬懷,3,579088,0.00048598,93.80890515
16537,緝私,3,579091,0.00048598,93.80939113
16538,編入,3,579094,0.00048598,93.80987711
16539,編印,3,579097,0.00048598,93.81036309
16540,編成,3,579100,0.00048598,93.81084908
16541,編製,3,579103,0.00048598,93.81133506
16542,編導,3,579106,0.00048598,93.81182104
16543,翩翩,3,579109,0.00048598,93.81230702
16544,膝部,3,579112,0.00048598,93.81279301
16545,膠布,3,579115,0.00048598,93.81327899
16546,膠帶,3,579118,0.00048598,93.81376497
16547,蔚,3,579121,0.00048598,93.81425095
16548,蔣仲苓,3,579124,0.00048598,93.81473694
16549,蔣緯國,3,579127,0.00048598,93.81522292
16550,蔡守禮,3,579130,0.00048598,93.81570890
16551,蔡忠文,3,579133,0.00048598,93.81619489
16552,蔡清彥,3,579136,0.00048598,93.81668087
16553,蔡煌瑯,3,579139,0.00048598,93.81716685
16554,蝦仁,3,579142,0.00048598,93.81765283
16555,蝌蚪,3,579145,0.00048598,93.81813882
16556,衛,3,579148,0.00048598,93.81862480
16557,衛星頻道,3,579151,0.00048598,93.81911078
16558,衝關,3,579154,0.00048598,93.81959676
16559,談心,3,579157,0.00048598,93.82008275
16560,課業,3,579160,0.00048598,93.82056873
16561,調委會,3,579163,0.00048598,93.82105471
16562,調查局長,3,579166,0.00048598,93.82154069
16563,調停,3,579169,0.00048598,93.82202668
16564,調薪,3,579172,0.00048598,93.82251266
16565,誰令你心動,3,579175,0.00048598,93.82299864
16566,賞識,3,579178,0.00048598,93.82348463
16567,賭局,3,579181,0.00048598,93.82397061
16568,賭徒,3,579184,0.00048598,93.82445659
16569,賣斷土地,3,579187,0.00048598,93.82494257
16570,質量,3,579190,0.00048598,93.82542856
16571,輩子,3,579193,0.00048598,93.82591454
16572,適切,3,579196,0.00048598,93.82640052
16573,適任,3,579199,0.00048598,93.82688650
16574,遮蓋,3,579202,0.00048598,93.82737249
16575,遨遊,3,579205,0.00048598,93.82785847
16576,遭逢,3,579208,0.00048598,93.82834445
16577,遷往,3,579211,0.00048598,93.82883043
16578,鄭石岩,3,579214,0.00048598,93.82931642
16579,鄭修二,3,579217,0.00048598,93.82980240
16580,鄧南光,3,579220,0.00048598,93.83028838
16581,鄧後,3,579223,0.00048598,93.83077436
16582,銷毀,3,579226,0.00048598,93.83126035
16583,鋪陳,3,579229,0.00048598,93.83174633
16584,鋪路,3,579232,0.00048598,93.83223231
16585,鋁合金,3,579235,0.00048598,93.83271830
16586,鋁門窗,3,579238,0.00048598,93.83320428
16587,震旦行,3,579241,0.00048598,93.83369026
16588,震怒,3,579244,0.00048598,93.83417624
16589,震撼力,3,579247,0.00048598,93.83466223
16590,鞋面,3,579250,0.00048598,93.83514821
16591,養老金,3,579253,0.00048598,93.83563419
16592,駐華,3,579256,0.00048598,93.83612017
16593,駕駛艙,3,579259,0.00048598,93.83660616
16594,鬧鐘,3,579262,0.00048598,93.83709214
16595,麩胺酸,3,579265,0.00048598,93.83757812
16596,黎南,3,579268,0.00048598,93.83806410
16597,墨魚,3,579271,0.00048598,93.83855009
16598,墨鏡,3,579274,0.00048598,93.83903607
16599,齒,3,579277,0.00048598,93.83952205
16600,齒輪,3,579280,0.00048598,93.84000803
16601,冀,3,579283,0.00048598,93.84049402
16602,噱頭,3,579286,0.00048598,93.84098000
16603,噶瑪蘭族人,3,579289,0.00048598,93.84146598
16604,壁,3,579292,0.00048598,93.84195197
16605,學徒,3,579295,0.00048598,93.84243795
16606,學術界,3,579298,0.00048598,93.84292393
16607,學期,3,579301,0.00048598,93.84340991
16608,學識,3,579304,0.00048598,93.84389590
16609,導入區,3,579307,0.00048598,93.84438188
16610,導出區,3,579310,0.00048598,93.84486786
16611,導航,3,579313,0.00048598,93.84535384
16612,導遊,3,579316,0.00048598,93.84583983
16613,憲改委員會,3,579319,0.00048598,93.84632581
16614,憾,3,579322,0.00048598,93.84681179
16615,戰國,3,579325,0.00048598,93.84729777
16616,戰亂,3,579328,0.00048598,93.84778376
16617,擅改,3,579331,0.00048598,93.84826974
16618,擄人,3,579334,0.00048598,93.84875572
16619,操心,3,579337,0.00048598,93.84924171
16620,操作元,3,579340,0.00048598,93.84972769
16621,操駕,3,579343,0.00048598,93.85021367
16622,撿拾,3,579346,0.00048598,93.85069965
16623,整地,3,579349,0.00048598,93.85118564
16624,整治,3,579352,0.00048598,93.85167162
16625,整型,3,579355,0.00048598,93.85215760
16626,整部,3,579358,0.00048598,93.85264358
16627,整備廠,3,579361,0.00048598,93.85312957
16628,整飭,3,579364,0.00048598,93.85361555
16629,整潔,3,579367,0.00048598,93.85410153
16630,曉得,3,579370,0.00048598,93.85458751
16631,樸實,3,579373,0.00048598,93.85507350
16632,橫向,3,579376,0.00048598,93.85555948
16633,橫行,3,579379,0.00048598,93.85604546
16634,樹梢,3,579382,0.00048598,93.85653144
16635,機械所,3,579385,0.00048598,93.85701743
16636,機槍,3,579388,0.00048598,93.85750341
16637,機器人,3,579391,0.00048598,93.85798939
16638,歷史畫,3,579394,0.00048598,93.85847538
16639,澡,3,579397,0.00048598,93.85896136
16640,濃重,3,579400,0.00048598,93.85944734
16641,澳幣,3,579403,0.00048598,93.85993332
16642,激昂,3,579406,0.00048598,93.86041931
16643,激怒,3,579409,0.00048598,93.86090529
16644,激賞,3,579412,0.00048598,93.86139127
16645,燉煮,3,579415,0.00048598,93.86187725
16646,燒烤,3,579418,0.00048598,93.86236324
16647,燈號,3,579421,0.00048598,93.86284922
16648,燎,3,579424,0.00048598,93.86333520
16649,燙手山芋,3,579427,0.00048598,93.86382118
16650,燜,3,579430,0.00048598,93.86430717
16651,獨占,3,579433,0.00048598,93.86479315
16652,獨樹一格,3,579436,0.00048598,93.86527913
16653,盧安達,3,579439,0.00048598,93.86576511
16654,盧國,3,579442,0.00048598,93.86625110
16655,盧燕,3,579445,0.00048598,93.86673708
16656,瞠目結舌,3,579448,0.00048598,93.86722306
16657,磨砂類,3,579451,0.00048598,93.86770905
16658,磨鍊,3,579454,0.00048598,93.86819503
16659,磚,3,579457,0.00048598,93.86868101
16660,磚塊,3,579460,0.00048598,93.86916699
16661,積勞成疾,3,579463,0.00048598,93.86965298
16662,積點制度,3,579466,0.00048598,93.87013896
16663,窺見,3,579469,0.00048598,93.87062494
16664,篤,3,579472,0.00048598,93.87111092
16665,篩檢,3,579475,0.00048598,93.87159691
16666,縣市政府,3,579478,0.00048598,93.87208289
16667,縣警局,3,579481,0.00048598,93.87256887
16668,縐襞,3,579484,0.00048598,93.87305485
16669,罹,3,579487,0.00048598,93.87354084
16670,興農段,3,579490,0.00048598,93.87402682
16671,艙,3,579493,0.00048598,93.87451280
16672,蕃茄,3,579496,0.00048598,93.87499879
16673,蕭代基,3,579499,0.00048598,93.87548477
16674,蕭崇烈,3,579502,0.00048598,93.87597075
16675,蕭新煌,3,579505,0.00048598,93.87645673
16676,褲,3,579508,0.00048598,93.87694272
16677,親手,3,579511,0.00048598,93.87742870
16678,親政會,3,579514,0.00048598,93.87791468
16679,親情,3,579517,0.00048598,93.87840066
16680,親臨,3,579520,0.00048598,93.87888665
16681,謀求,3,579523,0.00048598,93.87937263
16682,諧音,3,579526,0.00048598,93.87985861
16683,賴瑞鳳,3,579529,0.00048598,93.88034459
16684,踱,3,579532,0.00048598,93.88083058
16685,輻射,3,579535,0.00048598,93.88131656
16686,輯,3,579538,0.00048598,93.88180254
16687,辦不到,3,579541,0.00048598,93.88228852
16688,選入,3,579544,0.00048598,93.88277451
16689,選片,3,579547,0.00048598,93.88326049
16690,選出,3,579550,0.00048598,93.88374647
16691,選委會,3,579553,0.00048598,93.88423246
16692,選美,3,579556,0.00048598,93.88471844
16693,選情,3,579559,0.00048598,93.88520442
16694,選視,3,579562,0.00048598,93.88569040
16695,遲滯,3,579565,0.00048598,93.88617639
16696,遺棄,3,579568,0.00048598,93.88666237
16697,遺傳基因,3,579571,0.00048598,93.88714835
16698,遺跡,3,579574,0.00048598,93.88763433
16699,錶,3,579577,0.00048598,93.88812032
16700,錯覺,3,579580,0.00048598,93.88860630
16701,錢一飛,3,579583,0.00048598,93.88909228
16702,錢包,3,579586,0.00048598,93.88957826
16703,鋼筆,3,579589,0.00048598,93.89006425
16704,錄音座,3,579592,0.00048598,93.89055023
16705,錄音帶,3,579595,0.00048598,93.89103621
16706,錦標賽,3,579598,0.00048598,93.89152219
16707,隨口,3,579601,0.00048598,93.89200818
16708,隨行,3,579604,0.00048598,93.89249416
16709,隨波逐流,3,579607,0.00048598,93.89298014
16710,隨機,3,579610,0.00048598,93.89346613
16711,雕,3,579613,0.00048598,93.89395211
16712,靜坐,3,579616,0.00048598,93.89443809
16713,靜物,3,579619,0.00048598,93.89492407
16714,頻仍,3,579622,0.00048598,93.89541006
16715,頭上,3,579625,0.00048598,93.89589604
16716,頭城鎮,3,579628,0.00048598,93.89638202
16717,頭暈,3,579631,0.00048598,93.89686800
16718,頭緒,3,579634,0.00048598,93.89735399
16719,餐巾,3,579637,0.00048598,93.89783997
16720,餐館,3,579640,0.00048598,93.89832595
16721,餡料,3,579643,0.00048598,93.89881193
16722,駱焜祺,3,579646,0.00048598,93.89929792
16723,鴨,3,579649,0.00048598,93.89978390
16724,龍山寺,3,579652,0.00048598,93.90026988
16725,龍祥電影台,3,579655,0.00048598,93.90075586
16726,龜裂,3,579658,0.00048598,93.90124185
16727,優先權,3,579661,0.00048598,93.90172783
16728,優缺點,3,579664,0.00048598,93.90221381
16729,優勝,3,579667,0.00048598,93.90269980
16730,優勝者,3,579670,0.00048598,93.90318578
16731,優越,3,579673,0.00048598,93.90367176
16732,償,3,579676,0.00048598,93.90415774
16733,儲卵室,3,579679,0.00048598,93.90464373
16734,嚇阻,3,579682,0.00048598,93.90512971
16735,壓低,3,579685,0.00048598,93.90561569
16736,壓制,3,579688,0.00048598,93.90610167
16737,嬰兒期,3,579691,0.00048598,93.90658766
16738,嬰孩,3,579694,0.00048598,93.90707364
16739,幫手,3,579697,0.00048598,93.90755962
16740,應功偉,3,579700,0.00048598,93.90804560
16741,應有,3,579703,0.00048598,93.90853159
16742,應有盡有,3,579706,0.00048598,93.90901757
16743,戲劇化,3,579709,0.00048598,93.90950355
16744,戴弗林,3,579712,0.00048598,93.90998954
16745,戴相龍,3,579715,0.00048598,93.91047552
16746,戴運,3,579718,0.00048598,93.91096150
16747,擊倒,3,579721,0.00048598,93.91144748
16748,擠壓,3,579724,0.00048598,93.91193347
16749,擦身而過,3,579727,0.00048598,93.91241945
16750,擦拭,3,579730,0.00048598,93.91290543
16751,檔位,3,579733,0.00048598,93.91339141
16752,檢體,3,579736,0.00048598,93.91387740
16753,濱南,3,579739,0.00048598,93.91436338
16754,營利,3,579742,0.00048598,93.91484936
16755,營建署,3,579745,0.00048598,93.91533534
16756,營業稅法,3,579748,0.00048598,93.91582133
16757,營業稅籍,3,579751,0.00048598,93.91630731
16758,燦,3,579754,0.00048598,93.91679329
16759,獲致,3,579757,0.00048598,93.91727927
16760,獲報,3,579760,0.00048598,93.91776526
16761,獲釋,3,579763,0.00048598,93.91825124
16762,環河快速道路,3,579766,0.00048598,93.91873722
16763,療,3,579769,0.00048598,93.91922321
16764,療養,3,579772,0.00048598,93.91970919
16765,矯治,3,579775,0.00048598,93.92019517
16766,矯飾,3,579778,0.00048598,93.92068115
16767,簇擁,3,579781,0.00048598,93.92116714
16768,縮影,3,579784,0.00048598,93.92165312
16769,縷,3,579787,0.00048598,93.92213910
16770,縫製,3,579790,0.00048598,93.92262508
16771,總而言之,3,579793,0.00048598,93.92311107
16772,總決賽,3,579796,0.00048598,93.92359705
16773,總結,3,579799,0.00048598,93.92408303
16774,總會,3,579802,0.00048598,93.92456901
16775,總督,3,579805,0.00048598,93.92505500
16776,總資產,3,579808,0.00048598,93.92554098
16777,縱容,3,579811,0.00048598,93.92602696
16778,縱然,3,579814,0.00048598,93.92651294
16779,繁榮期,3,579817,0.00048598,93.92699893
16780,聯合國國際兒童緊急基金會,3,579820,0.00048598,93.92748491
16781,聯合稽查小組,3,579823,0.00048598,93.92797089
16782,聯安診所,3,579826,0.00048598,93.92845688
16783,聯邦快遞,3,579829,0.00048598,93.92894286
16784,聯邦調查局,3,579832,0.00048598,93.92942884
16785,聯招會,3,579835,0.00048598,93.92991482
16786,聯強國際,3,579838,0.00048598,93.93040081
16787,聯華電子,3,579841,0.00048598,93.93088679
16788,聯隊,3,579844,0.00048598,93.93137277
16789,聯署,3,579847,0.00048598,93.93185875
16790,聯賽,3,579850,0.00048598,93.93234474
16791,膽識,3,579853,0.00048598,93.93283072
16792,臨終者,3,579856,0.00048598,93.93331670
16793,臨摹,3,579859,0.00048598,93.93380268
16794,舉出,3,579862,0.00048598,93.93428867
16795,舉發,3,579865,0.00048598,93.93477465
16796,薄荷,3,579868,0.00048598,93.93526063
16797,螺旋式,3,579871,0.00048598,93.93574662
16798,講習,3,579874,0.00048598,93.93623260
16799,謊言,3,579877,0.00048598,93.93671858
16800,謠傳,3,579880,0.00048598,93.93720456
16801,謝啟大,3,579883,0.00048598,93.93769055
16802,賺進,3,579886,0.00048598,93.93817653
16803,賽格列特,3,579889,0.00048598,93.93866251
16804,購買者,3,579892,0.00048598,93.93914849
16805,趨勢線,3,579895,0.00048598,93.93963448
16806,蹈,3,579898,0.00048598,93.94012046
16807,避風港,3,579901,0.00048598,93.94060644
16808,避風頭,3,579904,0.00048598,93.94109242
16809,醣,3,579907,0.00048598,93.94157841
16810,醜陋,3,579910,0.00048598,93.94206439
16811,隱密性,3,579913,0.00048598,93.94255037
16812,隱瞞,3,579916,0.00048598,93.94303635
16813,鞠躬,3,579919,0.00048598,93.94352234
16814,韓德森,3,579922,0.00048598,93.94400832
16815,鮮奶,3,579925,0.00048598,93.94449430
16816,鮮血,3,579928,0.00048598,93.94498029
16817,鮮紅,3,579931,0.00048598,93.94546627
16818,鮮麗,3,579934,0.00048598,93.94595225
16819,點燈,3,579937,0.00048598,93.94643823
16820,叢,3,579940,0.00048598,93.94692422
16821,壘,3,579943,0.00048598,93.94741020
16822,嬸嬸,3,579946,0.00048598,93.94789618
16823,戳記,3,579949,0.00048598,93.94838216
16824,擴音器,3,579952,0.00048598,93.94886815
16825,擴廠,3,579955,0.00048598,93.94935413
16826,擾,3,579958,0.00048598,93.94984011
16827,櫃台,3,579961,0.00048598,93.95032609
16828,歸屬感,3,579964,0.00048598,93.95081208
16829,瀉,3,579967,0.00048598,93.95129806
16830,濾蕊,3,579970,0.00048598,93.95178404
16831,獵,3,579973,0.00048598,93.95227002
16832,簡陋,3,579976,0.00048598,93.95275601
16833,織女星,3,579979,0.00048598,93.95324199
16834,織物,3,579982,0.00048598,93.95372797
16835,繞道,3,579985,0.00048598,93.95421396
16836,繚繞,3,579988,0.00048598,93.95469994
16837,翻版,3,579991,0.00048598,93.95518592
16838,翻新,3,579994,0.00048598,93.95567190
16839,翻箱倒櫃,3,579997,0.00048598,93.95615789
16840,職訓中心,3,580000,0.00048598,93.95664387
16841,職業婦女,3,580003,0.00048598,93.95712985
16842,薩巴斯提奧．薩爾加多,3,580006,0.00048598,93.95761583
16843,薩伊,3,580009,0.00048598,93.95810182
16844,藉機,3,580012,0.00048598,93.95858780
16845,薰衣,3,580015,0.00048598,93.95907378
16846,蟬聯,3,580018,0.00048598,93.95955976
16847,豐,3,580021,0.00048598,93.96004575
16848,蹤跡,3,580024,0.00048598,93.96053173
16849,轉入,3,580027,0.00048598,93.96101771
16850,轉手,3,580030,0.00048598,93.96150370
16851,轉成,3,580033,0.00048598,93.96198968
16852,轉告,3,580036,0.00048598,93.96247566
16853,轉折,3,580039,0.00048598,93.96296164
16854,轉赴,3,580042,0.00048598,93.96344763
16855,轉捩點,3,580045,0.00048598,93.96393361
16856,轉嫁,3,580048,0.00048598,93.96441959
16857,轉播,3,580051,0.00048598,93.96490557
16858,醫學中心,3,580054,0.00048598,93.96539156
16859,醫學院,3,580057,0.00048598,93.96587754
16860,醫護,3,580060,0.00048598,93.96636352
16861,醬,3,580063,0.00048598,93.96684950
16862,鎖碼器,3,580066,0.00048598,93.96733549
16863,鎮海宮,3,580069,0.00048598,93.96782147
16864,闕,3,580072,0.00048598,93.96830745
16865,離型紙,3,580075,0.00048598,93.96879343
16866,離場,3,580078,0.00048598,93.96927942
16867,雜亂,3,580081,0.00048598,93.96976540
16868,雜質,3,580084,0.00048598,93.97025138
16869,雙軌,3,580087,0.00048598,93.97073737
16870,雙氧水,3,580090,0.00048598,93.97122335
16871,雙魚座,3,580093,0.00048598,93.97170933
16872,雙臂,3,580096,0.00048598,93.97219531
16873,雙邊協定,3,580099,0.00048598,93.97268130
16874,雛形,3,580102,0.00048598,93.97316728
16875,雞尾酒,3,580105,0.00048598,93.97365326
16876,雞蛋,3,580108,0.00048598,93.97413924
16877,雞湯,3,580111,0.00048598,93.97462523
16878,額頭,3,580114,0.00048598,93.97511121
16879,顏面神經,3,580117,0.00048598,93.97559719
16880,顏料,3,580120,0.00048598,93.97608317
16881,顏國卿,3,580123,0.00048598,93.97656916
16882,顏錦福,3,580126,0.00048598,93.97705514
16883,騎馬,3,580129,0.00048598,93.97754112
16884,鬆散,3,580132,0.00048598,93.97802710
16885,鵝卵石,3,580135,0.00048598,93.97851309
16886,嚥,3,580138,0.00048598,93.97899907
16887,龐斯,3,580141,0.00048598,93.97948505
16888,懷舊,3,580144,0.00048598,93.97997104
16889,攀爬,3,580147,0.00048598,93.98045702
16890,攀登,3,580150,0.00048598,93.98094300
16891,攏,3,580153,0.00048598,93.98142898
16892,曝光率,3,580156,0.00048598,93.98191497
16893,瀟灑,3,580159,0.00048598,93.98240095
16894,爆炸性,3,580162,0.00048598,93.98288693
16895,爆笑,3,580165,0.00048598,93.98337291
16896,爆發力,3,580168,0.00048598,93.98385890
16897,獸醫,3,580171,0.00048598,93.98434488
16898,禱詞,3,580174,0.00048598,93.98483086
16899,穩住,3,580177,0.00048598,93.98531684
16900,穩當,3,580180,0.00048598,93.98580283
16901,繫,3,580183,0.00048598,93.98628881
16902,繪畫主義,3,580186,0.00048598,93.98677479
16903,羅文嘉,3,580189,0.00048598,93.98726078
16904,羅百吉,3,580192,0.00048598,93.98774676
16905,羅至美,3,580195,0.00048598,93.98823274
16906,羅東,3,580198,0.00048598,93.98871872
16907,羅東鎮,3,580201,0.00048598,93.98920471
16908,羅勃特,3,580204,0.00048598,93.98969069
16909,羅柏斯,3,580207,0.00048598,93.99017667
16910,羅浮宮,3,580210,0.00048598,93.99066265
16911,羅素廣場,3,580213,0.00048598,93.99114864
16912,羅馬尼亞,3,580216,0.00048598,93.99163462
16913,羅惠馨,3,580219,0.00048598,93.99212060
16914,羅德,3,580222,0.00048598,93.99260658
16915,藩籬,3,580225,0.00048598,93.99309257
16916,藝品,3,580228,0.00048598,93.99357855
16917,藤,3,580231,0.00048598,93.99406453
16918,藤井,3,580234,0.00048598,93.99455051
16919,藥丸,3,580237,0.00048598,93.99503650
16920,藥膏,3,580240,0.00048598,93.99552248
16921,蟾蜍,3,580243,0.00048598,93.99600846
16922,譁然,3,580246,0.00048598,93.99649445
16923,識字班,3,580249,0.00048598,93.99698043
16924,證券交易所,3,580252,0.00048598,93.99746641
16925,證券業,3,580255,0.00048598,93.99795239
16926,證詞,3,580258,0.00048598,93.99843838
16927,譚,3,580261,0.00048598,93.99892436
16928,譏,3,580264,0.00048598,93.99941034
16929,贈與,3,580267,0.00048598,93.99989632
16930,蹲點,3,580270,0.00048598,94.00038231
16931,邊界,3,580273,0.00048598,94.00086829
16932,邊緣人,3,580276,0.00048598,94.00135427
16933,關愛,3,580279,0.00048598,94.00184025
16934,關鍵字,3,580282,0.00048598,94.00232624
16935,關鍵詞,3,580285,0.00048598,94.00281222
16936,難看,3,580288,0.00048598,94.00329820
16937,難能可貴,3,580291,0.00048598,94.00378418
16938,難逃,3,580294,0.00048598,94.00427017
16939,顛峰,3,580297,0.00048598,94.00475615
16940,顛簸,3,580300,0.00048598,94.00524213
16941,騙局,3,580303,0.00048598,94.00572812
16942,鯨,3,580306,0.00048598,94.00621410
16943,嚴冬,3,580309,0.00048598,94.00670008
16944,嚴正,3,580312,0.00048598,94.00718606
16945,嚴峻,3,580315,0.00048598,94.00767205
16946,嚴珮華,3,580318,0.00048598,94.00815803
16947,嚼,3,580321,0.00048598,94.00864401
16948,攔網,3,580324,0.00048598,94.00912999
16949,獻身,3,580327,0.00048598,94.00961598
16950,礦區,3,580330,0.00048598,94.01010196
16951,競爭性,3,580333,0.00048598,94.01058794
16952,競逐,3,580336,0.00048598,94.01107392
16953,籌備委員會,3,580339,0.00048598,94.01155991
16954,籌募,3,580342,0.00048598,94.01204589
16955,籌資,3,580345,0.00048598,94.01253187
16956,籌劃,3,580348,0.00048598,94.01301785
16957,籃,3,580351,0.00048598,94.01350384
16958,辮子,3,580354,0.00048598,94.01398982
16959,繼任,3,580357,0.00048598,94.01447580
16960,蘋果日報,3,580360,0.00048598,94.01496179
16961,蘇秀慧,3,580363,0.00048598,94.01544777
16962,蘇花公路,3,580366,0.00048598,94.01593375
16963,蘇格蘭人,3,580369,0.00048598,94.01641973
16964,蘇魯勃,3,580372,0.00048598,94.01690572
16965,覺者,3,580375,0.00048598,94.01739170
16966,觸犯,3,580378,0.00048598,94.01787768
16967,觸感,3,580381,0.00048598,94.01836366
16968,警紀,3,580384,0.00048598,94.01884965
16969,警覺心,3,580387,0.00048598,94.01933563
16970,贍養費,3,580390,0.00048598,94.01982161
16971,鐘樓怪人,3,580393,0.00048598,94.02030759
16972,飄逸,3,580396,0.00048598,94.02079358
16973,騷動,3,580399,0.00048598,94.02127956
16974,麵腸,3,580402,0.00048598,94.02176554
16975,黨內,3,580405,0.00048598,94.02225153
16976,黨魁,3,580408,0.00048598,94.02273751
16977,齟齬,3,580411,0.00048598,94.02322349
16978,懼怕,3,580414,0.00048598,94.02370947
16979,攝影界,3,580417,0.00048598,94.02419546
16980,攝影圈,3,580420,0.00048598,94.02468144
16981,攝影集,3,580423,0.00048598,94.02516742
16982,攝影獎,3,580426,0.00048598,94.02565340
16983,櫻木花道,3,580429,0.00048598,94.02613939
16984,櫻花,3,580432,0.00048598,94.02662537
16985,櫻桃,3,580435,0.00048598,94.02711135
16986,灌入,3,580438,0.00048598,94.02759733
16987,灌錄,3,580441,0.00048598,94.02808332
16988,灌籃,3,580444,0.00048598,94.02856930
16989,灌籃高手,3,580447,0.00048598,94.02905528
16990,襪子,3,580450,0.00048598,94.02954126
16991,護唇膏,3,580453,0.00048598,94.03002725
16992,護航,3,580456,0.00048598,94.03051323
16993,譽,3,580459,0.00048598,94.03099921
16994,躍升,3,580462,0.00048598,94.03148520
16995,轟轟烈烈,3,580465,0.00048598,94.03197118
16996,辯論會,3,580468,0.00048598,94.03245716
16997,鐵門,3,580471,0.00048598,94.03294314
16998,鐵路地下化工程,3,580474,0.00048598,94.03342913
16999,闢,3,580477,0.00048598,94.03391511
17000,霸道,3,580480,0.00048598,94.03440109
17001,霸權,3,580483,0.00048598,94.03488707
17002,霹靂馬,3,580486,0.00048598,94.03537306
17003,露營,3,580489,0.00048598,94.03585904
17004,顧客群,3,580492,0.00048598,94.03634502
17005,饗宴,3,580495,0.00048598,94.03683100
17006,驅,3,580498,0.00048598,94.03731699
17007,驅策,3,580501,0.00048598,94.03780297
17008,驅離,3,580504,0.00048598,94.03828895
17009,魔,3,580507,0.00048598,94.03877493
17010,魔力,3,580510,0.00048598,94.03926092
17011,攤牌,3,580513,0.00048598,94.03974690
17012,權值,3,580516,0.00048598,94.04023288
17013,歡呼,3,580519,0.00048598,94.04071887
17014,聽話,3,580522,0.00048598,94.04120485
17015,襲,3,580525,0.00048598,94.04169083
17016,讀寫,3,580528,0.00048598,94.04217681
17017,鑄造,3,580531,0.00048598,94.04266280
17018,鑑賞,3,580534,0.00048598,94.04314878
17019,鑑賞力,3,580537,0.00048598,94.04363476
17020,鬚,3,580540,0.00048598,94.04412074
17021,曬乾,3,580543,0.00048598,94.04460673
17022,蘸,3,580546,0.00048598,94.04509271
17023,變奏曲,3,580549,0.00048598,94.04557869
17024,變質,3,580552,0.00048598,94.04606467
17025,顯而易見,3,580555,0.00048598,94.04655066
17026,驚叫,3,580558,0.00048598,94.04703664
17027,驚嚇,3,580561,0.00048598,94.04752262
17028,體液,3,580564,0.00048598,94.04800861
17029,體節,3,580567,0.00048598,94.04849459
17030,體諒,3,580570,0.00048598,94.04898057
17031,囑,3,580573,0.00048598,94.04946655
17032,攬,3,580576,0.00048598,94.04995254
17033,矗立,3,580579,0.00048598,94.05043852
17034,罐子,3,580582,0.00048598,94.05092450
17035,讓步,3,580585,0.00048598,94.05141048
17036,釀酒葡萄,3,580588,0.00048598,94.05189647
17037,靈氣,3,580591,0.00048598,94.05238245
17038,靄,3,580594,0.00048598,94.05286843
17039,鹽基,3,580597,0.00048598,94.05335441
17040,鹽腺,3,580600,0.00048598,94.05384040
17041,鹽灘,3,580603,0.00048598,94.05432638
17042,觀禮,3,580606,0.00048598,94.05481236
17043,讚,3,580609,0.00048598,94.05529834
17044,鬱金香,3,580612,0.00048598,94.05578433
17045,庄,3,580615,0.00048598,94.05627031
17046,枷鎖,3,580618,0.00048598,94.05675629
17047,炷,3,580621,0.00048598,94.05724228
17048,捅,3,580624,0.00048598,94.05772826
17049,粘,3,580627,0.00048598,94.05821424
17050,筱瑩,3,580630,0.00048598,94.05870022
17051,蒟蒻,3,580633,0.00048598,94.05918621
17052,燁隆公司,3,580636,0.00048598,94.05967219
17053,遶境,3,580639,0.00048598,94.06015817
17054,饋,3,580642,0.00048598,94.06064415
17055,飆,3,580645,0.00048598,94.06113014
17056,碁峰公司,3,580648,0.00048598,94.06161612
17057,粧容,3,580651,0.00048598,94.06210210
17058,�y菇,3,580654,0.00048598,94.06258808
17059,�F,2,580656,0.00032399,94.06291207
17060,一日遊,2,580658,0.00032399,94.06323606
17061,一付,2,580660,0.00032399,94.06356005
17062,一目瞭然,2,580662,0.00032399,94.06388404
17063,一份,2,580664,0.00032399,94.06420803
17064,一吐為快,2,580666,0.00032399,94.06453201
17065,一地,2,580668,0.00032399,94.06485600
17066,一如往常,2,580670,0.00032399,94.06517999
17067,一年級,2,580672,0.00032399,94.06550398
17068,一江街,2,580674,0.00032399,94.06582797
17069,一串串,2,580676,0.00032399,94.06615196
17070,一步一步,2,580678,0.00032399,94.06647595
17071,一步登天,2,580680,0.00032399,94.06679993
17072,一言難盡,2,580682,0.00032399,94.06712392
17073,一刻,2,580684,0.00032399,94.06744791
17074,一波,2,580686,0.00032399,94.06777190
17075,一波三折,2,580688,0.00032399,94.06809589
17076,一致性,2,580690,0.00032399,94.06841988
17077,一家人,2,580692,0.00032399,94.06874386
17078,一根根,2,580694,0.00032399,94.06906785
17079,一馬當先,2,580696,0.00032399,94.06939184
17080,一張張,2,580698,0.00032399,94.06971583
17081,一條條,2,580700,0.00032399,94.07003982
17082,一眼,2,580702,0.00032399,94.07036381
17083,一貫化,2,580704,0.00032399,94.07068780
17084,一無所知,2,580706,0.00032399,94.07101178
17085,一絲絲,2,580708,0.00032399,94.07133577
17086,一意孤行,2,580710,0.00032399,94.07165976
17087,一會,2,580712,0.00032399,94.07198375
17088,一概,2,580714,0.00032399,94.07230774
17089,一落千丈,2,580716,0.00032399,94.07263173
17090,一路下滑,2,580718,0.00032399,94.07295571
17091,一路順風,2,580720,0.00032399,94.07327970
17092,一團亂,2,580722,0.00032399,94.07360369
17093,一線,2,580724,0.00032399,94.07392768
17094,一頭兒,2,580726,0.00032399,94.07425167
17095,一瞬間,2,580728,0.00032399,94.07457566
17096,一舉一動,2,580730,0.00032399,94.07489964
17097,一點兒,2,580732,0.00032399,94.07522363
17098,乙烯,2,580734,0.00032399,94.07554762
17099,七家灣溪,2,580736,0.00032399,94.07587161
17100,七彩,2,580738,0.00032399,94.07619560
17101,七彩仙子,2,580740,0.00032399,94.07651959
17102,九五無鉛,2,580742,0.00032399,94.07684358
17103,九德電子,2,580744,0.00032399,94.07716756
17104,了不得,2,580746,0.00032399,94.07749155
17105,二二八,2,580748,0.00032399,94.07781554
17106,二日遊,2,580750,0.00032399,94.07813953
17107,二壘,2,580752,0.00032399,94.07846352
17108,人才濟濟,2,580754,0.00032399,94.07878751
17109,人心惶惶,2,580756,0.00032399,94.07911149
17110,人世,2,580758,0.00032399,94.07943548
17111,人民日報,2,580760,0.00032399,94.07975947
17112,人民行動黨,2,580762,0.00032399,94.08008346
17113,人名,2,580764,0.00032399,94.08040745
17114,人行道,2,580766,0.00032399,94.08073144
17115,人事行政局,2,580768,0.00032399,94.08105542
17116,人事單位,2,580770,0.00032399,94.08137941
17117,人煙,2,580772,0.00032399,94.08170340
17118,人道主義,2,580774,0.00032399,94.08202739
17119,人滿為患,2,580776,0.00032399,94.08235138
17120,人牆,2,580778,0.00032399,94.08267537
17121,人體工學,2,580780,0.00032399,94.08299936
17122,人體試驗,2,580782,0.00032399,94.08332334
17123,入門級,2,580784,0.00032399,94.08364733
17124,入侵阿富汗,2,580786,0.00032399,94.08397132
17125,入超,2,580788,0.00032399,94.08429531
17126,入閣,2,580790,0.00032399,94.08461930
17127,八一七,2,580792,0.00032399,94.08494329
17128,八大行業,2,580794,0.00032399,94.08526727
17129,八仙過海,2,580796,0.00032399,94.08559126
17130,八卦山,2,580798,0.00032399,94.08591525
17131,八卦樓,2,580800,0.00032399,94.08623924
17132,刀刃,2,580802,0.00032399,94.08656323
17133,刀法,2,580804,0.00032399,94.08688722
17134,力主,2,580806,0.00032399,94.08721120
17135,力作,2,580808,0.00032399,94.08753519
17136,力爭上游,2,580810,0.00032399,94.08785918
17137,力度,2,580812,0.00032399,94.08818317
17138,力駛多油精,2,580814,0.00032399,94.08850716
17139,力鵬,2,580816,0.00032399,94.08883115
17140,力霸百貨,2,580818,0.00032399,94.08915514
17141,十二指腸潰瘍,2,580820,0.00032399,94.08947912
17142,十二星座,2,580822,0.00032399,94.08980311
17143,十大傑出青年,2,580824,0.00032399,94.09012710
17144,十五大,2,580826,0.00032399,94.09045109
17145,十字架,2,580828,0.00032399,94.09077508
17146,三字經,2,580830,0.00032399,94.09109907
17147,三言兩語,2,580832,0.00032399,94.09142305
17148,三明治,2,580834,0.00032399,94.09174704
17149,三采建設,2,580836,0.00032399,94.09207103
17150,三冠王,2,580838,0.00032399,94.09239502
17151,三星警分局,2,580840,0.00032399,94.09271901
17152,三毒,2,580842,0.00032399,94.09304300
17153,三流,2,580844,0.00032399,94.09336698
17154,三軍,2,580846,0.00032399,94.09369097
17155,三商隊,2,580848,0.00032399,94.09401496
17156,三番兩次,2,580850,0.00032399,94.09433895
17157,三聖宮,2,580852,0.00032399,94.09466294
17158,三審定讞,2,580854,0.00032399,94.09498693
17159,三黨,2,580856,0.00032399,94.09531092
17160,下午茶,2,580858,0.00032399,94.09563490
17161,下巴,2,580860,0.00032399,94.09595889
17162,下水,2,580862,0.00032399,94.09628288
17163,下肢,2,580864,0.00032399,94.09660687
17164,下海,2,580866,0.00032399,94.09693086
17165,下馬威,2,580868,0.00032399,94.09725485
17166,下探,2,580870,0.00032399,94.09757883
17167,下單,2,580872,0.00032399,94.09790282
17168,下筆,2,580874,0.00032399,94.09822681
17169,下視丘,2,580876,0.00032399,94.09855080
17170,下鄉,2,580878,0.00032399,94.09887479
17171,下意識,2,580880,0.00032399,94.09919878
17172,下腹痛,2,580882,0.00032399,94.09952277
17173,丈量,2,580884,0.00032399,94.09984675
17174,上半身,2,580886,0.00032399,94.10017074
17175,上半季,2,580888,0.00032399,94.10049473
17176,上校,2,580890,0.00032399,94.10081872
17177,上海市,2,580892,0.00032399,94.10114271
17178,上海車廠,2,580894,0.00032399,94.10146670
17179,上海商銀,2,580896,0.00032399,94.10179068
17180,上海話,2,580898,0.00032399,94.10211467
17181,上尉的女兒,2,580900,0.00032399,94.10243866
17182,上將,2,580902,0.00032399,94.10276265
17183,上進,2,580904,0.00032399,94.10308664
17184,上路,2,580906,0.00032399,94.10341063
17185,上榜,2,580908,0.00032399,94.10373461
17186,上櫃股票,2,580910,0.00032399,94.10405860
17187,上粧,2,580912,0.00032399,94.10438259
17188,上��,2,580914,0.00032399,94.10470658
17189,凡事,2,580916,0.00032399,94.10503057
17190,么妹,2,580918,0.00032399,94.10535456
17191,也就是說,2,580920,0.00032399,94.10567855
17192,也會,2,580922,0.00032399,94.10600253
17193,乞丐,2,580924,0.00032399,94.10632652
17194,乞討,2,580926,0.00032399,94.10665051
17195,于佑任,2,580928,0.00032399,94.10697450
17196,亡故,2,580930,0.00032399,94.10729849
17197,千千萬萬,2,580932,0.00032399,94.10762248
17198,千里迢迢,2,580934,0.00032399,94.10794646
17199,叉開,2,580936,0.00032399,94.10827045
17200,口述,2,580938,0.00032399,94.10859444
17201,口哨,2,580940,0.00032399,94.10891843
17202,口氣,2,580942,0.00032399,94.10924242
17203,口腔,2,580944,0.00032399,94.10956641
17204,口試,2,580946,0.00032399,94.10989039
17205,土人,2,580948,0.00032399,94.11021438
17206,土巴,2,580950,0.00032399,94.11053837
17207,土木課,2,580952,0.00032399,94.11086236
17208,土司,2,580954,0.00032399,94.11118635
17209,土瓜灣,2,580956,0.00032399,94.11151034
17210,土地分區使用管制,2,580958,0.00032399,94.11183433
17211,土地案,2,580960,0.00032399,94.11215831
17212,土安宮,2,580962,0.00032399,94.11248230
17213,土窯,2,580964,0.00032399,94.11280629
17214,士林警分局,2,580966,0.00032399,94.11313028
17215,大二,2,580968,0.00032399,94.11345427
17216,大大公司,2,580970,0.00032399,94.11377826
17217,大小便,2,580972,0.00032399,94.11410224
17218,大內鄉,2,580974,0.00032399,94.11442623
17219,大戶,2,580976,0.00032399,94.11475022
17220,大手筆,2,580978,0.00032399,94.11507421
17221,大台北,2,580980,0.00032399,94.11539820
17222,大未來畫廊,2,580982,0.00032399,94.11572219
17223,大白鯊,2,580984,0.00032399,94.11604617
17224,大同高中,2,580986,0.00032399,94.11637016
17225,大同區,2,580988,0.00032399,94.11669415
17226,大同路,2,580990,0.00032399,94.11701814
17227,大安,2,580992,0.00032399,94.11734213
17228,大安區,2,580994,0.00032399,94.11766612
17229,大安溪,2,580996,0.00032399,94.11799011
17230,大成報,2,580998,0.00032399,94.11831409
17231,大作,2,581000,0.00032399,94.11863808
17232,大里市,2,581002,0.00032399,94.11896207
17233,大阪府,2,581004,0.00032399,94.11928606
17234,大阪貿易會,2,581006,0.00032399,94.11961005
17235,大阪電通廣告,2,581008,0.00032399,94.11993404
17236,大使館,2,581010,0.00032399,94.12025802
17237,大放異彩,2,581012,0.00032399,94.12058201
17238,大雨,2,581014,0.00032399,94.12090600
17239,大便,2,581016,0.00032399,94.12122999
17240,大剌剌,2,581018,0.00032399,94.12155398
17241,大型電腦,2,581020,0.00032399,94.12187797
17242,大帝,2,581022,0.00032399,94.12220195
17243,大英博物館,2,581024,0.00032399,94.12252594
17244,大家庭,2,581026,0.00032399,94.12284993
17245,大家樂,2,581028,0.00032399,94.12317392
17246,大島正滿,2,581030,0.00032399,94.12349791
17247,大師級,2,581032,0.00032399,94.12382190
17248,大砲,2,581034,0.00032399,94.12414589
17249,大笑,2,581036,0.00032399,94.12446987
17250,大財團,2,581038,0.00032399,94.12479386
17251,大偉,2,581040,0.00032399,94.12511785
17252,大專院校,2,581042,0.00032399,94.12544184
17253,大排長龍,2,581044,0.00032399,94.12576583
17254,大眾電腦,2,581046,0.00032399,94.12608982
17255,大野,2,581048,0.00032399,94.12641380
17256,大陸市場,2,581050,0.00032399,94.12673779
17257,大陸委員會,2,581052,0.00032399,94.12706178
17258,大陸政策,2,581054,0.00032399,94.12738577
17259,大陸買盤,2,581056,0.00032399,94.12770976
17260,大麥町,2,581058,0.00032399,94.12803375
17261,大幅度,2,581060,0.00032399,94.12835774
17262,大無畏,2,581062,0.00032399,94.12868172
17263,大發利市,2,581064,0.00032399,94.12900571
17264,大筆,2,581066,0.00032399,94.12932970
17265,大費周章,2,581068,0.00032399,94.12965369
17266,大黃瓜,2,581070,0.00032399,94.12997768
17267,大亂,2,581072,0.00032399,94.13030167
17268,大園,2,581074,0.00032399,94.13062565
17269,大圓滿,2,581076,0.00032399,94.13094964
17270,大溪鎮,2,581078,0.00032399,94.13127363
17271,大腹便便,2,581080,0.00032399,94.13159762
17272,大葉高島屋,2,581082,0.00032399,94.13192161
17273,大葉高島屋百貨,2,581084,0.00032399,94.13224560
17274,大過,2,581086,0.00032399,94.13256958
17275,大旗,2,581088,0.00032399,94.13289357
17276,大綱,2,581090,0.00032399,94.13321756
17277,大韓貿易振興公社,2,581092,0.00032399,94.13354155
17278,大鵬,2,581094,0.00032399,94.13386554
17279,大鵬灣,2,581096,0.00032399,94.13418953
17280,女主持人,2,581098,0.00032399,94.13451352
17281,女男．男女,2,581100,0.00032399,94.13483750
17282,女朋友,2,581102,0.00032399,94.13516149
17283,女童,2,581104,0.00032399,94.13548548
17284,女鞋,2,581106,0.00032399,94.13580947
17285,女聲,2,581108,0.00032399,94.13613346
17286,子卡,2,581110,0.00032399,94.13645745
17287,子計畫,2,581112,0.00032399,94.13678143
17288,子宮體,2,581114,0.00032399,94.13710542
17289,孑遺,2,581116,0.00032399,94.13742941
17290,寸步難行,2,581118,0.00032399,94.13775340
17291,小女孩,2,581120,0.00032399,94.13807739
17292,小五金,2,581122,0.00032399,94.13840138
17293,小牛,2,581124,0.00032399,94.13872536
17294,小巧,2,581126,0.00032399,94.13904935
17295,小白獅,2,581128,0.00032399,94.13937334
17296,小老百姓,2,581130,0.00032399,94.13969733
17297,小弟,2,581132,0.00032399,94.14002132
17298,小動作,2,581134,0.00032399,94.14034531
17299,小開,2,581136,0.00032399,94.14066930
17300,小號,2,581138,0.00032399,94.14099328
17301,小路,2,581140,0.00032399,94.14131727
17302,小蟲,2,581142,0.00032399,94.14164126
17303,小題大作,2,581144,0.00032399,94.14196525
17304,山川,2,581146,0.00032399,94.14228924
17305,山水畫,2,581148,0.00032399,94.14261323
17306,山田,2,581150,0.00032399,94.14293721
17307,山岳,2,581152,0.00032399,94.14326120
17308,山東,2,581154,0.00032399,94.14358519
17309,山東綢,2,581156,0.00032399,94.14390918
17310,山珍,2,581158,0.00032399,94.14423317
17311,山珍海味,2,581160,0.00032399,94.14455716
17312,山風,2,581162,0.00032399,94.14488114
17313,山神,2,581164,0.00032399,94.14520513
17314,山脊,2,581166,0.00032399,94.14552912
17315,山茶花,2,581168,0.00032399,94.14585311
17316,山崩,2,581170,0.00032399,94.14617710
17317,山腰,2,581172,0.00032399,94.14650109
17318,山豬,2,581174,0.00032399,94.14682508
17319,山嶺,2,581176,0.00032399,94.14714906
17320,山邊,2,581178,0.00032399,94.14747305
17321,山麓,2,581180,0.00032399,94.14779704
17322,川,2,581182,0.00032399,94.14812103
17323,川飛,2,581184,0.00032399,94.14844502
17324,工友,2,581186,0.00032399,94.14876901
17325,工作列,2,581188,0.00032399,94.14909299
17326,工研院院長,2,581190,0.00032399,94.14941698
17327,工務,2,581192,0.00032399,94.14974097
17328,工務課,2,581194,0.00032399,94.15006496
17329,工商時報,2,581196,0.00032399,94.15038895
17330,工程界,2,581198,0.00032399,94.15071294
17331,工程費,2,581200,0.00032399,94.15103692
17332,工業技術研究院,2,581202,0.00032399,94.15136091
17333,工業時代,2,581204,0.00032399,94.15168490
17334,工業園區,2,581206,0.00032399,94.15200889
17335,工藝史,2,581208,0.00032399,94.15233288
17336,已然,2,581210,0.00032399,94.15265687
17337,巳,2,581212,0.00032399,94.15298086
17338,干戈,2,581214,0.00032399,94.15330484
17339,干貝,2,581216,0.00032399,94.15362883
17340,干城商業區,2,581218,0.00032399,94.15395282
17341,才氣,2,581220,0.00032399,94.15427681
17342,才會,2,581222,0.00032399,94.15460080
17343,才對,2,581224,0.00032399,94.15492479
17344,不了,2,581226,0.00032399,94.15524877
17345,不下,2,581228,0.00032399,94.15557276
17346,不仁,2,581230,0.00032399,94.15589675
17347,不介意,2,581232,0.00032399,94.15622074
17348,不切實際,2,581234,0.00032399,94.15654473
17349,不勻,2,581236,0.00032399,94.15686872
17350,不令,2,581238,0.00032399,94.15719271
17351,不可一世,2,581240,0.00032399,94.15751669
17352,不打緊,2,581242,0.00032399,94.15784068
17353,不甘示弱,2,581244,0.00032399,94.15816467
17354,不甘寂寞,2,581246,0.00032399,94.15848866
17355,不由自主,2,581248,0.00032399,94.15881265
17356,不在意,2,581250,0.00032399,94.15913664
17357,不守,2,581252,0.00032399,94.15946062
17358,不含糊,2,581254,0.00032399,94.15978461
17359,不妙,2,581256,0.00032399,94.16010860
17360,不走,2,581258,0.00032399,94.16043259
17361,不足為奇,2,581260,0.00032399,94.16075658
17362,不定時炸彈,2,581262,0.00032399,94.16108057
17363,不忠,2,581264,0.00032399,94.16140455
17364,不俗,2,581266,0.00032399,94.16172854
17365,不甚,2,581268,0.00032399,94.16205253
17366,不相干,2,581270,0.00032399,94.16237652
17367,不要緊,2,581272,0.00032399,94.16270051
17368,不計,2,581274,0.00032399,94.16302450
17369,不屑,2,581276,0.00032399,94.16334849
17370,不留,2,581278,0.00032399,94.16367247
17371,不衰,2,581280,0.00032399,94.16399646
17372,不接,2,581282,0.00032399,94.16432045
17373,不殺,2,581284,0.00032399,94.16464444
17374,不祥,2,581286,0.00032399,94.16496843
17375,不習,2,581288,0.00032399,94.16529242
17376,不許,2,581290,0.00032399,94.16561640
17377,不勝,2,581292,0.00032399,94.16594039
17378,不提,2,581294,0.00032399,94.16626438
17379,不敢當,2,581296,0.00032399,94.16658837
17380,不測,2,581298,0.00032399,94.16691236
17381,不渝,2,581300,0.00032399,94.16723635
17382,不絕,2,581302,0.00032399,94.16756033
17383,不給,2,581304,0.00032399,94.16788432
17384,不雅,2,581306,0.00032399,94.16820831
17385,不順,2,581308,0.00032399,94.16853230
17386,不幹,2,581310,0.00032399,94.16885629
17387,不愧,2,581312,0.00032399,94.16918028
17388,不準,2,581314,0.00032399,94.16950427
17389,不經,2,581316,0.00032399,94.16982825
17390,不虞匱乏,2,581318,0.00032399,94.17015224
17391,不遑多讓,2,581320,0.00032399,94.17047623
17392,不厭其煩,2,581322,0.00032399,94.17080022
17393,不實,2,581324,0.00032399,94.17112421
17394,不聞不問,2,581326,0.00032399,94.17144820
17395,不與,2,581328,0.00032399,94.17177218
17396,不語,2,581330,0.00032399,94.17209617
17397,不敵,2,581332,0.00032399,94.17242016
17398,不熟,2,581334,0.00032399,94.17274415
17399,不曉得,2,581336,0.00032399,94.17306814
17400,不諱言,2,581338,0.00032399,94.17339213
17401,不諳,2,581340,0.00032399,94.17371611
17402,不斷電系統,2,581342,0.00032399,94.17404010
17403,不覺,2,581344,0.00032399,94.17436409
17404,不羈,2,581346,0.00032399,94.17468808
17405,中小型,2,581348,0.00032399,94.17501207
17406,中山段,2,581350,0.00032399,94.17533606
17407,中山區,2,581352,0.00032399,94.17566005
17408,中元祭,2,581354,0.00032399,94.17598403
17409,中文化,2,581356,0.00032399,94.17630802
17410,中文光學文字辨識系統,2,581358,0.00032399,94.17663201
17411,中日隊,2,581360,0.00032399,94.17695600
17412,中台山,2,581362,0.00032399,94.17727999
17413,中央大學,2,581364,0.00032399,94.17760398
17414,中央郵局,2,581366,0.00032399,94.17792796
17415,中央電視台,2,581368,0.00032399,94.17825195
17416,中央選舉委員會,2,581370,0.00032399,94.17857594
17417,中正文化中心,2,581372,0.00032399,94.17889993
17418,中正西路,2,581374,0.00032399,94.17922392
17419,中共央行,2,581376,0.00032399,94.17954791
17420,中年人,2,581378,0.00032399,94.17987189
17421,中和市,2,581380,0.00032399,94.18019588
17422,中和高中,2,581382,0.00032399,94.18051987
17423,中油公司,2,581384,0.00032399,94.18084386
17424,中信銀,2,581386,0.00032399,94.18116785
17425,中前鋒,2,581388,0.00032399,94.18149184
17426,中研院,2,581390,0.00032399,94.18181583
17427,中秋,2,581392,0.00032399,94.18213981
17428,中國生產力中心,2,581394,0.00032399,94.18246380
17429,中國信託,2,581396,0.00032399,94.18278779
17430,中國風,2,581398,0.00032399,94.18311178
17431,中將,2,581400,0.00032399,94.18343577
17432,中庸,2,581402,0.00032399,94.18375976
17433,中控台,2,581404,0.00032399,94.18408374
17434,中港,2,581406,0.00032399,94.18440773
17435,中港晶華酒店,2,581408,0.00032399,94.18473172
17436,中華民國自由車協會,2,581410,0.00032399,94.18505571
17437,中華民國流行顏色協會,2,581412,0.00032399,94.18537970
17438,中華民國藝石協會,2,581414,0.00032399,94.18570369
17439,中華投信,2,581416,0.00032399,94.18602768
17440,中華航空公司,2,581418,0.00032399,94.18635166
17441,中華雅石協會,2,581420,0.00032399,94.18667565
17442,中華奧會,2,581422,0.00032399,94.18699964
17443,中華顧問工程公司,2,581424,0.00032399,94.18732363
17444,中菜,2,581426,0.00032399,94.18764762
17445,中間區,2,581428,0.00032399,94.18797161
17446,中意,2,581430,0.00032399,94.18829559
17447,中資,2,581432,0.00032399,94.18861958
17448,中道思想觀,2,581434,0.00032399,94.18894357
17449,中橫公路,2,581436,0.00032399,94.18926756
17450,中興,2,581438,0.00032399,94.18959155
17451,中興隊,2,581440,0.00032399,94.18991554
17452,中興號,2,581442,0.00032399,94.19023952
17453,中興路,2,581444,0.00032399,94.19056351
17454,中環,2,581446,0.00032399,94.19088750
17455,中聯信託,2,581448,0.00032399,94.19121149
17456,中韓,2,581450,0.00032399,94.19153548
17457,中醫師公會,2,581452,0.00032399,94.19185947
17458,中藥材,2,581454,0.00032399,94.19218346
17459,丹尼狄維多,2,581456,0.00032399,94.19250744
17460,丹尼斯奎德,2,581458,0.00032399,94.19283143
17461,丹佛,2,581460,0.00032399,94.19315542
17462,丹青,2,581462,0.00032399,94.19347941
17463,丹麥人,2,581464,0.00032399,94.19380340
17464,尹筱晴,2,581466,0.00032399,94.19412739
17465,予以,2,581468,0.00032399,94.19445137
17466,云,2,581470,0.00032399,94.19477536
17467,云云,2,581472,0.00032399,94.19509935
17468,井然有序,2,581474,0.00032399,94.19542334
17469,互別苗頭,2,581476,0.00032399,94.19574733
17470,互利,2,581478,0.00032399,94.19607132
17471,互爭,2,581480,0.00032399,94.19639530
17472,互設,2,581482,0.00032399,94.19671929
17473,互換,2,581484,0.00032399,94.19704328
17474,互毆,2,581486,0.00032399,94.19736727
17475,五金,2,581488,0.00032399,94.19769126
17476,五門,2,581490,0.00032399,94.19801525
17477,五星級飯店,2,581492,0.00032399,94.19833924
17478,亢奮,2,581494,0.00032399,94.19866322
17479,仁波切,2,581496,0.00032399,94.19898721
17480,仁慈,2,581498,0.00032399,94.19931120
17481,仇台,2,581500,0.00032399,94.19963519
17482,今早,2,581502,0.00032399,94.19995918
17483,今西,2,581504,0.00032399,94.20028317
17484,今夏,2,581506,0.00032399,94.20060715
17485,介壽廳,2,581508,0.00032399,94.20093114
17486,元太科技,2,581510,0.00032399,94.20125513
17487,元代,2,581512,0.00032399,94.20157912
17488,元年,2,581514,0.00032399,94.20190311
17489,元老,2,581516,0.00032399,94.20222710
17490,元帥,2,581518,0.00032399,94.20255108
17491,元宵,2,581520,0.00032399,94.20287507
17492,元富投信,2,581522,0.00032399,94.20319906
17493,內大泙泉,2,581524,0.00032399,94.20352305
17494,內地,2,581526,0.00032399,94.20384704
17495,內衣公司,2,581528,0.00032399,94.20417103
17496,內建式,2,581530,0.00032399,94.20449502
17497,內鬥,2,581532,0.00032399,94.20481900
17498,內埤海濱公園,2,581534,0.00032399,94.20514299
17499,內湖高中,2,581536,0.00032399,94.20546698
17500,內華達號,2,581538,0.00032399,94.20579097
17501,內層,2,581540,0.00032399,94.20611496
17502,內憂外患,2,581542,0.00032399,94.20643895
17503,內戰,2,581544,0.00032399,94.20676293
17504,六年國建計畫,2,581546,0.00032399,94.20708692
17505,公牛,2,581548,0.00032399,94.20741091
17506,公牛隊,2,581550,0.00032399,94.20773490
17507,公平交易法,2,581552,0.00032399,94.20805889
17508,公平性,2,581554,0.00032399,94.20838288
17509,公平會主委,2,581556,0.00032399,94.20870686
17510,公正性,2,581558,0.00032399,94.20903085
17511,公用,2,581560,0.00032399,94.20935484
17512,公立高中聯招,2,581562,0.00032399,94.20967883
17513,公共廁所,2,581564,0.00032399,94.21000282
17514,公共意外責任保險,2,581566,0.00032399,94.21032681
17515,公地,2,581568,0.00032399,94.21065080
17516,公安人員,2,581570,0.00032399,94.21097478
17517,公佈值,2,581572,0.00032399,94.21129877
17518,公私,2,581574,0.00032399,94.21162276
17519,公事,2,581576,0.00032399,94.21194675
17520,公使,2,581578,0.00032399,94.21227074
17521,公物,2,581580,0.00032399,94.21259473
17522,公家,2,581582,0.00032399,94.21291871
17523,公庫,2,581584,0.00032399,94.21324270
17524,公案,2,581586,0.00032399,94.21356669
17525,公教人員,2,581588,0.00032399,94.21389068
17526,公部門,2,581590,0.00032399,94.21421467
17527,公道,2,581592,0.00032399,94.21453866
17528,公墓,2,581594,0.00032399,94.21486265
17529,公館鄉,2,581596,0.00032399,94.21518663
17530,公糧,2,581598,0.00032399,94.21551062
17531,公證,2,581600,0.00032399,94.21583461
17532,公權力,2,581602,0.00032399,94.21615860
17533,冗長,2,581604,0.00032399,94.21648259
17534,凶嫌,2,581606,0.00032399,94.21680658
17535,分母,2,581608,0.00032399,94.21713056
17536,分紅,2,581610,0.00032399,94.21745455
17537,分校,2,581612,0.00032399,94.21777854
17538,分送,2,581614,0.00032399,94.21810253
17539,分售,2,581616,0.00032399,94.21842652
17540,分發,2,581618,0.00032399,94.21875051
17541,分駐所,2,581620,0.00032399,94.21907449
17542,分權,2,581622,0.00032399,94.21939848
17543,切忌,2,581624,0.00032399,94.21972247
17544,切削,2,581626,0.00032399,94.22004646
17545,切莫,2,581628,0.00032399,94.22037045
17546,切割線,2,581630,0.00032399,94.22069444
17547,切結書,2,581632,0.00032399,94.22101843
17548,切絲,2,581634,0.00032399,94.22134241
17549,切菜板,2,581636,0.00032399,94.22166640
17550,切開,2,581638,0.00032399,94.22199039
17551,切磋,2,581640,0.00032399,94.22231438
17552,勾畫,2,581642,0.00032399,94.22263837
17553,勾當,2,581644,0.00032399,94.22296236
17554,勾芡,2,581646,0.00032399,94.22328634
17555,化妝師,2,581648,0.00032399,94.22361033
17556,化暗為明,2,581650,0.00032399,94.22393432
17557,化學家,2,581652,0.00032399,94.22425831
17558,化纖業,2,581654,0.00032399,94.22458230
17559,化粧水,2,581656,0.00032399,94.22490629
17560,化粧包,2,581658,0.00032399,94.22523027
17561,化粧師,2,581660,0.00032399,94.22555426
17562,匹敵,2,581662,0.00032399,94.22587825
17563,午覺,2,581664,0.00032399,94.22620224
17564,升起,2,581666,0.00032399,94.22652623
17565,友台,2,581668,0.00032399,94.22685022
17566,友好,2,581670,0.00032399,94.22717421
17567,友伴,2,581672,0.00032399,94.22749819
17568,友邦,2,581674,0.00032399,94.22782218
17569,友聯,2,581676,0.00032399,94.22814617
17570,及膝,2,581678,0.00032399,94.22847016
17571,反台泥,2,581680,0.00032399,94.22879415
17572,反向訊軌,2,581682,0.00032399,94.22911814
17573,反抗軍,2,581684,0.00032399,94.22944212
17574,反叛,2,581686,0.00032399,94.22976611
17575,反叛軍,2,581688,0.00032399,94.23009010
17576,反思,2,581690,0.00032399,94.23041409
17577,反革命,2,581692,0.00032399,94.23073808
17578,反倒是,2,581694,0.00032399,94.23106207
17579,反射性,2,581696,0.00032399,94.23138605
17580,反病毒,2,581698,0.00032399,94.23171004
17581,反芻,2,581700,0.00032399,94.23203403
17582,反敗為勝,2,581702,0.00032399,94.23235802
17583,反貪污,2,581704,0.00032399,94.23268201
17584,反登陸,2,581706,0.00032399,94.23300600
17585,反感,2,581708,0.00032399,94.23332999
17586,反裝甲,2,581710,0.00032399,94.23365397
17587,反賄選,2,581712,0.00032399,94.23397796
17588,反對黨,2,581714,0.00032399,94.23430195
17589,天人,2,581716,0.00032399,94.23462594
17590,天人合一,2,581718,0.00032399,94.23494993
17591,天分,2,581720,0.00032399,94.23527392
17592,天平,2,581722,0.00032399,94.23559790
17593,天田二,2,581724,0.00032399,94.23592189
17594,天色,2,581726,0.00032399,94.23624588
17595,天災人禍,2,581728,0.00032399,94.23656987
17596,天良,2,581730,0.00032399,94.23689386
17597,天空之城,2,581732,0.00032399,94.23721785
17598,天亮,2,581734,0.00032399,94.23754183
17599,天倫,2,581736,0.00032399,94.23786582
17600,天神,2,581738,0.00032399,94.23818981
17601,天涯,2,581740,0.00032399,94.23851380
17602,天富證券投資顧問公司,2,581742,0.00032399,94.23883779
17603,天黑,2,581744,0.00032399,94.23916178
17604,天補術,2,581746,0.00032399,94.23948577
17605,天際,2,581748,0.00032399,94.23980975
17606,天價,2,581750,0.00032399,94.24013374
17607,天機,2,581752,0.00032399,94.24045773
17608,夫妻倆,2,581754,0.00032399,94.24078172
17609,太平洋戰爭,2,581756,0.00032399,94.24110571
17610,太平洋聯盟,2,581758,0.00032399,94.24142970
17611,太空人,2,581760,0.00032399,94.24175368
17612,太保市,2,581762,0.00032399,94.24207767
17613,太陽穴,2,581764,0.00032399,94.24240166
17614,太陽光,2,581766,0.00032399,94.24272565
17615,太極,2,581768,0.00032399,94.24304964
17616,太鼓,2,581770,0.00032399,94.24337363
17617,太聯不動產週報,2,581772,0.00032399,94.24369762
17618,孔子,2,581774,0.00032399,94.24402160
17619,少校,2,581776,0.00032399,94.24434559
17620,少婦,2,581778,0.00032399,94.24466958
17621,少造,2,581780,0.00032399,94.24499357
17622,尤宏,2,581782,0.00032399,94.24531756
17623,尤金．奧尼金,2,581784,0.00032399,94.24564155
17624,尤特萊,2,581786,0.00032399,94.24596553
17625,尤碧海,2,581788,0.00032399,94.24628952
17626,巴人,2,581790,0.00032399,94.24661351
17627,巴比諾,2,581792,0.00032399,94.24693750
17628,巴卡人,2,581794,0.00032399,94.24726149
17629,巴洛克風格,2,581796,0.00032399,94.24758548
17630,巴索里尼,2,581798,0.00032399,94.24790946
17631,巴勒斯坦,2,581800,0.00032399,94.24823345
17632,巴勒斯坦人,2,581802,0.00032399,94.24855744
17633,巴掌,2,581804,0.00032399,94.24888143
17634,巴塞爾表展,2,581806,0.00032399,94.24920542
17635,巴蒂摩爾,2,581808,0.00032399,94.24952941
17636,巴爾托克,2,581810,0.00032399,94.24985340
17637,巴爾的摩金鶯隊,2,581812,0.00032399,94.25017738
17638,巴爾幹半島,2,581814,0.00032399,94.25050137
17639,幻,2,581816,0.00032399,94.25082536
17640,幻想力,2,581818,0.00032399,94.25114935
17641,幻境,2,581820,0.00032399,94.25147334
17642,弔,2,581822,0.00032399,94.25179733
17643,引介,2,581824,0.00032399,94.25212131
17644,引出,2,581826,0.00032399,94.25244530
17645,引誘,2,581828,0.00032399,94.25276929
17646,引燃,2,581830,0.00032399,94.25309328
17647,引擎室,2,581832,0.00032399,94.25341727
17648,心平氣和,2,581834,0.00032399,94.25374126
17649,心甘情願,2,581836,0.00032399,94.25406524
17650,心目中,2,581838,0.00032399,94.25438923
17651,心有未甘,2,581840,0.00032399,94.25471322
17652,心血管,2,581842,0.00032399,94.25503721
17653,心志,2,581844,0.00032399,94.25536120
17654,心底,2,581846,0.00032399,94.25568519
17655,心弦,2,581848,0.00032399,94.25600918
17656,心房,2,581850,0.00032399,94.25633316
17657,心知肚明,2,581852,0.00032399,94.25665715
17658,心肺,2,581854,0.00032399,94.25698114
17659,心門,2,581856,0.00032399,94.25730513
17660,心要,2,581858,0.00032399,94.25762912
17661,心理醫生,2,581860,0.00032399,94.25795311
17662,心扉,2,581862,0.00032399,94.25827709
17663,心智科,2,581864,0.00032399,94.25860108
17664,心結,2,581866,0.00032399,94.25892507
17665,心想,2,581868,0.00032399,94.25924906
17666,心識,2,581870,0.00032399,94.25957305
17667,心裏,2,581872,0.00032399,94.25989704
17668,手下留情,2,581874,0.00032399,94.26022102
17669,手印,2,581876,0.00032399,94.26054501
17670,手持,2,581878,0.00032399,94.26086900
17671,手排車,2,581880,0.00032399,94.26119299
17672,手牽手,2,581882,0.00032399,94.26151698
17673,手術式,2,581884,0.00032399,94.26184097
17674,手掌心,2,581886,0.00032399,94.26216496
17675,手提式,2,581888,0.00032399,94.26248894
17676,手電筒,2,581890,0.00032399,94.26281293
17677,手榴彈,2,581892,0.00032399,94.26313692
17678,手語,2,581894,0.00032399,94.26346091
17679,手銬,2,581896,0.00032399,94.26378490
17680,手機,2,581898,0.00032399,94.26410889
17681,手頭,2,581900,0.00032399,94.26443287
17682,扎實,2,581902,0.00032399,94.26475686
17683,支用,2,581904,0.00032399,94.26508085
17684,支存,2,581906,0.00032399,94.26540484
17685,支持率,2,581908,0.00032399,94.26572883
17686,支架,2,581910,0.00032399,94.26605282
17687,支援人員,2,581912,0.00032399,94.26637680
17688,支應,2,581914,0.00032399,94.26670079
17689,文山,2,581916,0.00032399,94.26702478
17690,文山區,2,581918,0.00032399,94.26734877
17691,文化圈,2,581920,0.00032399,94.26767276
17692,文化資產保存法,2,581922,0.00032399,94.26799675
17693,文本,2,581924,0.00032399,94.26832074
17694,文件化,2,581926,0.00032399,94.26864472
17695,文攻,2,581928,0.00032399,94.26896871
17696,文官,2,581930,0.00032399,94.26929270
17697,文采,2,581932,0.00032399,94.26961669
17698,文書處理機,2,581934,0.00032399,94.26994068
17699,文學史,2,581936,0.00032399,94.27026467
17700,文藝片,2,581938,0.00032399,94.27058865
17701,文藝季,2,581940,0.00032399,94.27091264
17702,斗六,2,581942,0.00032399,94.27123663
17703,斗笠,2,581944,0.00032399,94.27156062
17704,斤兩,2,581946,0.00032399,94.27188461
17705,方便性,2,581948,0.00032399,94.27220860
17706,方盒,2,581950,0.00032399,94.27253259
17707,日丹諾夫,2,581952,0.00032399,94.27285657
17708,日升月鴻藝術畫廊,2,581954,0.00032399,94.27318056
17709,日月光,2,581956,0.00032399,94.27350455
17710,日本料理,2,581958,0.00032399,94.27382854
17711,日本酒,2,581960,0.00032399,94.27415253
17712,日本椰子,2,581962,0.00032399,94.27447652
17713,日軍,2,581964,0.00032399,94.27480050
17714,日益,2,581966,0.00032399,94.27512449
17715,日記本,2,581968,0.00032399,94.27544848
17716,日復一日,2,581970,0.00032399,94.27577247
17717,日經,2,581972,0.00032399,94.27609646
17718,日語,2,581974,0.00032399,94.27642045
17719,日據時期,2,581976,0.00032399,94.27674443
17720,日積月累,2,581978,0.00032399,94.27706842
17721,日籍,2,581980,0.00032399,94.27739241
17722,月光,2,581982,0.00032399,94.27771640
17723,月球,2,581984,0.00032399,94.27804039
17724,月曆,2,581986,0.00032399,94.27836438
17725,木,2,581988,0.00032399,94.27868837
17726,木耳絲,2,581990,0.00032399,94.27901235
17727,木村久美,2,581992,0.00032399,94.27933634
17728,木村拓哉,2,581994,0.00032399,94.27966033
17729,木板,2,581996,0.00032399,94.27998432
17730,木盒,2,581998,0.00032399,94.28030831
17731,木櫃,2,582000,0.00032399,94.28063230
17732,止痛,2,582002,0.00032399,94.28095628
17733,毋庸,2,582004,0.00032399,94.28128027
17734,毋須,2,582006,0.00032399,94.28160426
17735,毋需,2,582008,0.00032399,94.28192825
17736,比武,2,582010,0.00032399,94.28225224
17737,比提,2,582012,0.00032399,94.28257623
17738,比較組,2,582014,0.00032399,94.28290021
17739,比爾,2,582016,0.00032399,94.28322420
17740,比爾．詹金斯,2,582018,0.00032399,94.28354819
17741,毛毛雨,2,582020,0.00032399,94.28387218
17742,毛絨絨,2,582022,0.00032399,94.28419617
17743,水上,2,582024,0.00032399,94.28452016
17744,水手,2,582026,0.00032399,94.28484415
17745,水安村,2,582028,0.00032399,94.28516813
17746,水泥管,2,582030,0.00032399,94.28549212
17747,水肺,2,582032,0.00032399,94.28581611
17748,水門,2,582034,0.00032399,94.28614010
17749,水門案,2,582036,0.00032399,94.28646409
17750,水柱,2,582038,0.00032399,94.28678808
17751,水查某,2,582040,0.00032399,94.28711206
17752,水洗,2,582042,0.00032399,94.28743605
17753,水洗色,2,582044,0.00032399,94.28776004
17754,水氣,2,582046,0.00032399,94.28808403
17755,水桶,2,582048,0.00032399,94.28840802
17756,水壺,2,582050,0.00032399,94.28873201
17757,水蛙,2,582052,0.00032399,94.28905599
17758,水落石出,2,582054,0.00032399,94.28937998
17759,水蜜桃,2,582056,0.00032399,94.28970397
17760,水槽,2,582058,0.00032399,94.29002796
17761,水潭,2,582060,0.00032399,94.29035195
17762,水壓,2,582062,0.00032399,94.29067594
17763,水湳機場,2,582064,0.00032399,94.29099993
17764,火大,2,582066,0.00032399,94.29132391
17765,火候,2,582068,0.00032399,94.29164790
17766,火柴盒,2,582070,0.00032399,94.29197189
17767,火砲,2,582072,0.00032399,94.29229588
17768,火堆,2,582074,0.00032399,94.29261987
17769,火焰,2,582076,0.00032399,94.29294386
17770,火箭筒,2,582078,0.00032399,94.29326784
17771,火爆,2,582080,0.00032399,94.29359183
17772,火警,2,582082,0.00032399,94.29391582
17773,父女,2,582084,0.00032399,94.29423981
17774,牙,2,582086,0.00032399,94.29456380
17775,牛角,2,582088,0.00032399,94.29488779
17776,牛角形,2,582090,0.00032399,94.29521178
17777,牛隊,2,582092,0.00032399,94.29553576
17778,牛頭團,2,582094,0.00032399,94.29585975
17779,王元培,2,582096,0.00032399,94.29618374
17780,王文和,2,582098,0.00032399,94.29650773
17781,王立彬,2,582100,0.00032399,94.29683172
17782,王吟芳,2,582102,0.00032399,94.29715571
17783,王志成,2,582104,0.00032399,94.29747969
17784,王念祖,2,582106,0.00032399,94.29780368
17785,王拓,2,582108,0.00032399,94.29812767
17786,王金木,2,582110,0.00032399,94.29845166
17787,王建��,2,582112,0.00032399,94.29877565
17788,王政松,2,582114,0.00032399,94.29909964
17789,王剛,2,582116,0.00032399,94.29942362
17790,王宮,2,582118,0.00032399,94.29974761
17791,王座,2,582120,0.00032399,94.30007160
17792,王海輪,2,582122,0.00032399,94.30039559
17793,王惕吾,2,582124,0.00032399,94.30071958
17794,王淑瑛,2,582126,0.00032399,94.30104357
17795,王淑燕,2,582128,0.00032399,94.30136756
17796,王章清,2,582130,0.00032399,94.30169154
17797,王惠萍,2,582132,0.00032399,94.30201553
17798,王童,2,582134,0.00032399,94.30233952
17799,王萬紫,2,582136,0.00032399,94.30266351
17800,王漢,2,582138,0.00032399,94.30298750
17801,王維,2,582140,0.00032399,94.30331149
17802,王蒙,2,582142,0.00032399,94.30363547
17803,王薇,2,582144,0.00032399,94.30395946
17804,王麗紅,2,582146,0.00032399,94.30428345
17805,王萩惠,2,582148,0.00032399,94.30460744
17806,王顗鈞,2,582150,0.00032399,94.30493143
17807,世界末日,2,582152,0.00032399,94.30525542
17808,世界自然基金會,2,582154,0.00032399,94.30557940
17809,世界杯,2,582156,0.00032399,94.30590339
17810,世界的一天,2,582158,0.00032399,94.30622738
17811,世界觀,2,582160,0.00032399,94.30655137
17812,世華銀行,2,582162,0.00032399,94.30687536
17813,世貿中心,2,582164,0.00032399,94.30719935
17814,丘陵,2,582166,0.00032399,94.30752334
17815,主打,2,582168,0.00032399,94.30784732
17816,主旨,2,582170,0.00032399,94.30817131
17817,主見,2,582172,0.00032399,94.30849530
17818,主計長,2,582174,0.00032399,94.30881929
17819,主砲,2,582176,0.00032399,94.30914328
17820,主神,2,582178,0.00032399,94.30946727
17821,主動式,2,582180,0.00032399,94.30979125
17822,主唱,2,582182,0.00032399,94.31011524
17823,主婚,2,582184,0.00032399,94.31043923
17824,主從架構,2,582186,0.00032399,94.31076322
17825,主控,2,582188,0.00032399,94.31108721
17826,主控室,2,582190,0.00032399,94.31141120
17827,主畫面,2,582192,0.00032399,94.31173518
17828,主程式,2,582194,0.00032399,94.31205917
17829,主菜,2,582196,0.00032399,94.31238316
17830,主線,2,582198,0.00032399,94.31270715
17831,主導性,2,582200,0.00032399,94.31303114
17832,主導權,2,582202,0.00032399,94.31335513
17833,乍看,2,582204,0.00032399,94.31367912
17834,以至,2,582206,0.00032399,94.31400310
17835,以色列人,2,582208,0.00032399,94.31432709
17836,付息,2,582210,0.00032399,94.31465108
17837,付錢,2,582212,0.00032399,94.31497507
17838,仔,2,582214,0.00032399,94.31529906
17839,仕途,2,582216,0.00032399,94.31562305
17840,他國,2,582218,0.00032399,94.31594703
17841,他說,2,582220,0.00032399,94.31627102
17842,仗,2,582222,0.00032399,94.31659501
17843,代天府,2,582224,0.00032399,94.31691900
17844,代代相傳,2,582226,0.00032399,94.31724299
17845,代表隊,2,582228,0.00032399,94.31756698
17846,代訓,2,582230,0.00032399,94.31789096
17847,代理人,2,582232,0.00032399,94.31821495
17848,代辦,2,582234,0.00032399,94.31853894
17849,充任,2,582236,0.00032399,94.31886293
17850,充氣,2,582238,0.00032399,94.31918692
17851,兄妹,2,582240,0.00032399,94.31951091
17852,冬裝,2,582242,0.00032399,94.31983490
17853,出人頭地,2,582244,0.00032399,94.32015888
17854,出力,2,582246,0.00032399,94.32048287
17855,出口值,2,582248,0.00032399,94.32080686
17856,出外,2,582250,0.00032399,94.32113085
17857,出生地,2,582252,0.00032399,94.32145484
17858,出版者,2,582254,0.00032399,94.32177883
17859,出版界,2,582256,0.00032399,94.32210281
17860,出版業,2,582258,0.00032399,94.32242680
17861,出息,2,582260,0.00032399,94.32275079
17862,出租,2,582262,0.00032399,94.32307478
17863,出缺,2,582264,0.00032399,94.32339877
17864,出馬,2,582266,0.00032399,94.32372276
17865,出處,2,582268,0.00032399,94.32404675
17866,出貨值,2,582270,0.00032399,94.32437073
17867,出貨量,2,582272,0.00032399,94.32469472
17868,出報,2,582274,0.00032399,94.32501871
17869,出錯,2,582276,0.00032399,94.32534270
17870,出賽,2,582278,0.00032399,94.32566669
17871,加工業,2,582280,0.00032399,94.32599068
17872,加州大學,2,582282,0.00032399,94.32631466
17873,加色,2,582284,0.00032399,94.32663865
17874,加味茶,2,582286,0.00032399,94.32696264
17875,加法,2,582288,0.00032399,94.32728663
17876,加油站,2,582290,0.00032399,94.32761062
17877,加氣站,2,582292,0.00032399,94.32793461
17878,加起來,2,582294,0.00032399,94.32825859
17879,加高,2,582296,0.00032399,94.32858258
17880,加勒比海,2,582298,0.00032399,94.32890657
17881,加速器,2,582300,0.00032399,94.32923056
17882,加藤英司,2,582302,0.00032399,94.32955455
17883,加贈,2,582304,0.00032399,94.32987854
17884,加護病房,2,582306,0.00032399,94.33020253
17885,功成名就,2,582308,0.00032399,94.33052651
17886,功成身退,2,582310,0.00032399,94.33085050
17887,功利主義,2,582312,0.00032399,94.33117449
17888,功能鍵,2,582314,0.00032399,94.33149848
17889,功勞,2,582316,0.00032399,94.33182247
17890,包子,2,582318,0.00032399,94.33214646
17891,包克維,2,582320,0.00032399,94.33247044
17892,包庇,2,582322,0.00032399,94.33279443
17893,包辦,2,582324,0.00032399,94.33311842
17894,包攬,2,582326,0.00032399,94.33344241
17895,匆忙,2,582328,0.00032399,94.33376640
17896,北上,2,582330,0.00032399,94.33409039
17897,北斗,2,582332,0.00032399,94.33441437
17898,北半球,2,582334,0.00032399,94.33473836
17899,北平,2,582336,0.00032399,94.33506235
17900,北京軍區,2,582338,0.00032399,94.33538634
17901,北宜高速公路,2,582340,0.00032399,94.33571033
17902,北河二,2,582342,0.00032399,94.33603432
17903,北門鹽場,2,582344,0.00032399,94.33635831
17904,北非,2,582346,0.00032399,94.33668229
17905,北海,2,582348,0.00032399,94.33700628
17906,北海艦隊,2,582350,0.00032399,94.33733027
17907,北高雄,2,582352,0.00032399,94.33765426
17908,北極海,2,582354,0.00032399,94.33797825
17909,北管,2,582356,0.00032399,94.33830224
17910,仟,2,582358,0.00032399,94.33862622
17911,仟卡,2,582360,0.00032399,94.33895021
17912,半小時,2,582362,0.00032399,94.33927420
17913,半途,2,582364,0.00032399,94.33959819
17914,半途而廢,2,582366,0.00032399,94.33992218
17915,半路,2,582368,0.00032399,94.34024617
17916,半雙工,2,582370,0.00032399,94.34057015
17917,卡氏肺囊蟲肺炎,2,582372,0.00032399,94.34089414
17918,卡西歐,2,582374,0.00032399,94.34121813
17919,卡住,2,582376,0.00032399,94.34154212
17920,卡波希氏肉瘤,2,582378,0.00032399,94.34186611
17921,卡紙,2,582380,0.00032399,94.34219010
17922,卡通人物,2,582382,0.00032399,94.34251409
17923,卡通片,2,582384,0.00032399,94.34283807
17924,卡爾,2,582386,0.00032399,94.34316206
17925,卡德琳,2,582388,0.00032399,94.34348605
17926,卡螢幕,2,582390,0.00032399,94.34381004
17927,占領,2,582392,0.00032399,94.34413403
17928,占據,2,582394,0.00032399,94.34445802
17929,卯起來,2,582396,0.00032399,94.34478200
17930,可行,2,582398,0.00032399,94.34510599
17931,可言,2,582400,0.00032399,94.34542998
17932,可倫坡,2,582402,0.00032399,94.34575397
17933,可喜可賀,2,582404,0.00032399,94.34607796
17934,可惡,2,582406,0.00032399,94.34640195
17935,可塑性,2,582408,0.00032399,94.34672593
17936,可說,2,582410,0.00032399,94.34704992
17937,可靠性,2,582412,0.00032399,94.34737391
17938,古文,2,582414,0.00032399,94.34769790
17939,古希臘時期,2,582416,0.00032399,94.34802189
17940,古里溫泉,2,582418,0.00032399,94.34834588
17941,古怪,2,582420,0.00032399,94.34866987
17942,古風,2,582422,0.00032399,94.34899385
17943,古騰博格,2,582424,0.00032399,94.34931784
17944,召來,2,582426,0.00032399,94.34964183
17945,叮囑,2,582428,0.00032399,94.34996582
17946,司法院,2,582430,0.00032399,94.35028981
17947,叫苦連天,2,582432,0.00032399,94.35061380
17948,叫停,2,582434,0.00032399,94.35093778
17949,叫罵,2,582436,0.00032399,94.35126177
17950,另一次,2,582438,0.00032399,94.35158576
17951,另起爐灶,2,582440,0.00032399,94.35190975
17952,另類族群,2,582442,0.00032399,94.35223374
17953,史丹福大學,2,582444,0.00032399,94.35255773
17954,史午康,2,582446,0.00032399,94.35288172
17955,史坦布納,2,582448,0.00032399,94.35320570
17956,史坦柏格,2,582450,0.00032399,94.35352969
17957,史帝格力茲,2,582452,0.00032399,94.35385368
17958,史泰隆,2,582454,0.00032399,94.35417767
17959,史特勞斯,2,582456,0.00032399,94.35450166
17960,史都華,2,582458,0.00032399,94.35482565
17961,史欽泰,2,582460,0.00032399,94.35514963
17962,史無前例,2,582462,0.00032399,94.35547362
17963,史蒂芬史匹柏,2,582464,0.00032399,94.35579761
17964,史達林,2,582466,0.00032399,94.35612160
17965,史黛拉,2,582468,0.00032399,94.35644559
17966,台七甲,2,582470,0.00032399,94.35676958
17967,台下,2,582472,0.00032399,94.35709356
17968,台大醫學院,2,582474,0.00032399,94.35741755
17969,台中市長,2,582476,0.00032399,94.35774154
17970,台中商專,2,582478,0.00032399,94.35806553
17971,台中榮總,2,582480,0.00032399,94.35838952
17972,台火,2,582482,0.00032399,94.35871351
17973,台北市立美術館,2,582484,0.00032399,94.35903750
17974,台北市政府新聞處,2,582486,0.00032399,94.35936148
17975,台北市電腦商業同業公會,2,582488,0.00032399,94.35968547
17976,台北灰姑娘,2,582490,0.00032399,94.36000946
17977,台北電台,2,582492,0.00032399,94.36033345
17978,台北榮民總醫院,2,582494,0.00032399,94.36065744
17979,台北樹蛙,2,582496,0.00032399,94.36098143
17980,台北縣樹林焚化廠,2,582498,0.00032399,94.36130541
17981,台北攝影學會,2,582500,0.00032399,94.36162940
17982,台東縣,2,582502,0.00032399,94.36195339
17983,台肥,2,582504,0.00032399,94.36227738
17984,台金,2,582506,0.00032399,94.36260137
17985,台南人,2,582508,0.00032399,94.36292536
17986,台南市藥師公會,2,582510,0.00032399,94.36324934
17987,台資,2,582512,0.00032399,94.36357333
17988,台電公司,2,582514,0.00032399,94.36389732
17989,台聚鳳山廠,2,582516,0.00032399,94.36422131
17990,台積,2,582518,0.00032399,94.36454530
17991,台積電一廠,2,582520,0.00032399,94.36486929
17992,台糖購物中心,2,582522,0.00032399,94.36519328
17993,台灣大聯盟,2,582524,0.00032399,94.36551726
17994,台灣客,2,582526,0.00032399,94.36584125
17995,台灣省政府,2,582528,0.00032399,94.36616524
17996,台灣省議會,2,582530,0.00032399,94.36648923
17997,台灣區,2,582532,0.00032399,94.36681322
17998,台灣啤酒,2,582534,0.00032399,94.36713721
17999,台灣猛禽研究會,2,582536,0.00032399,94.36746119
18000,台灣聚和化學公司,2,582538,0.00032399,94.36778518
18001,台灣蘇澳珊瑚博覽館,2,582540,0.00032399,94.36810917
18002,四乙基鉛,2,582542,0.00032399,94.36843316
18003,四大天王,2,582544,0.00032399,94.36875715
18004,四四三聯隊,2,582546,0.00032399,94.36908114
18005,四星級,2,582548,0.00032399,94.36940512
18006,四散,2,582550,0.00032399,94.36972911
18007,四腳朝天,2,582552,0.00032399,94.37005310
18008,四輪傳動,2,582554,0.00032399,94.37037709
18009,外孕,2,582556,0.00032399,94.37070108
18010,外交部次長,2,582558,0.00032399,94.37102507
18011,外行,2,582560,0.00032399,94.37134906
18012,外放,2,582562,0.00032399,94.37167304
18013,外長,2,582564,0.00032399,94.37199703
18014,外送,2,582566,0.00032399,94.37232102
18015,外側,2,582568,0.00032399,94.37264501
18016,外患,2,582570,0.00032399,94.37296900
18017,外野,2,582572,0.00032399,94.37329299
18018,外野手,2,582574,0.00032399,94.37361697
18019,外勞加工特區,2,582576,0.00032399,94.37394096
18020,外場,2,582578,0.00032399,94.37426495
18021,外殼,2,582580,0.00032399,94.37458894
18022,外鈔,2,582582,0.00032399,94.37491293
18023,外傳,2,582584,0.00032399,94.37523692
18024,外傷,2,582586,0.00032399,94.37556090
18025,外製,2,582588,0.00032399,94.37588489
18026,外縣市,2,582590,0.00032399,94.37620888
18027,外籍人士,2,582592,0.00032399,94.37653287
18028,失分,2,582594,0.00032399,94.37685686
18029,失守,2,582596,0.00032399,94.37718085
18030,失色,2,582598,0.00032399,94.37750484
18031,失血,2,582600,0.00032399,94.37782882
18032,失利,2,582602,0.00032399,94.37815281
18033,失和,2,582604,0.00032399,94.37847680
18034,失眠,2,582606,0.00032399,94.37880079
18035,失眠症,2,582608,0.00032399,94.37912478
18036,失常,2,582610,0.00032399,94.37944877
18037,失職,2,582612,0.00032399,94.37977275
18038,失戀,2,582614,0.00032399,94.38009674
18039,奶精,2,582616,0.00032399,94.38042073
18040,孕育,2,582618,0.00032399,94.38074472
18041,尼古拉斯凱吉,2,582620,0.00032399,94.38106871
18042,尼米茲號,2,582622,0.00032399,94.38139270
18043,尼克森在中國,2,582624,0.00032399,94.38171669
18044,尼格,2,582626,0.00032399,94.38204067
18045,尼龍,2,582628,0.00032399,94.38236466
18046,巨細靡遺,2,582630,0.00032399,94.38268865
18047,巨幅,2,582632,0.00032399,94.38301264
18048,巨資,2,582634,0.00032399,94.38333663
18049,巨擘,2,582636,0.00032399,94.38366062
18050,巨蟹座,2,582638,0.00032399,94.38398460
18051,巧思,2,582640,0.00032399,94.38430859
18052,左右手,2,582642,0.00032399,94.38463258
18053,左外野,2,582644,0.00032399,94.38495657
18054,左外野手,2,582646,0.00032399,94.38528056
18055,市井小民,2,582648,0.00032399,94.38560455
18056,市內電話,2,582650,0.00032399,94.38592853
18057,市代表,2,582652,0.00032399,94.38625252
18058,市代會,2,582654,0.00032399,94.38657651
18059,市民代表,2,582656,0.00032399,94.38690050
18060,市民代表會,2,582658,0.00032399,94.38722449
18061,市民保險,2,582660,0.00032399,94.38754848
18062,市立,2,582662,0.00032399,94.38787247
18063,市立文化中心,2,582664,0.00032399,94.38819645
18064,市地重劃,2,582666,0.00032399,94.38852044
18065,市政中心,2,582668,0.00032399,94.38884443
18066,市容,2,582670,0.00032399,94.38916842
18067,市售,2,582672,0.00032399,94.38949241
18068,市場性,2,582674,0.00032399,94.38981640
18069,市街,2,582676,0.00032399,94.39014038
18070,布防,2,582678,0.00032399,94.39046437
18071,布拉瑞揚,2,582680,0.00032399,94.39078836
18072,布條,2,582682,0.00032399,94.39111235
18073,布斯光年,2,582684,0.00032399,94.39143634
18074,布萊恩,2,582686,0.00032399,94.39176033
18075,布雷肯,2,582688,0.00032399,94.39208431
18076,布雷摩頓號,2,582690,0.00032399,94.39240830
18077,布爾津河,2,582692,0.00032399,94.39273229
18078,布爾津縣,2,582694,0.00032399,94.39305628
18079,布魯姆,2,582696,0.00032399,94.39338027
18080,布蘭詩歌,2,582698,0.00032399,94.39370426
18081,布蘭達,2,582700,0.00032399,94.39402825
18082,平可夫,2,582702,0.00032399,94.39435223
18083,平平,2,582704,0.00032399,94.39467622
18084,平行訊軌,2,582706,0.00032399,94.39500021
18085,平步青雲,2,582708,0.00032399,94.39532420
18086,平和,2,582710,0.00032399,94.39564819
18087,平易近人,2,582712,0.00032399,94.39597218
18088,平常人,2,582714,0.00032399,94.39629616
18089,平順,2,582716,0.00032399,94.39662015
18090,平實,2,582718,0.00032399,94.39694414
18091,平潭,2,582720,0.00032399,94.39726813
18092,平緩,2,582722,0.00032399,94.39759212
18093,平整,2,582724,0.00032399,94.39791611
18094,平衡式,2,582726,0.00032399,94.39824009
18095,平衡感,2,582728,0.00032399,94.39856408
18096,幼小,2,582730,0.00032399,94.39888807
18097,幼童,2,582732,0.00032399,94.39921206
18098,弗瑞德,2,582734,0.00032399,94.39953605
18099,必修,2,582736,0.00032399,94.39986004
18100,必須品,2,582738,0.00032399,94.40018403
18101,打入,2,582740,0.00032399,94.40050801
18102,打手,2,582742,0.00032399,94.40083200
18103,打包,2,582744,0.00032399,94.40115599
18104,打劫,2,582746,0.00032399,94.40147998
18105,打坐,2,582748,0.00032399,94.40180397
18106,打屁,2,582750,0.00032399,94.40212796
18107,打招呼,2,582752,0.00032399,94.40245194
18108,打抱不平,2,582754,0.00032399,94.40277593
18109,打氣,2,582756,0.00032399,94.40309992
18110,打烊,2,582758,0.00032399,94.40342391
18111,打退堂鼓,2,582760,0.00032399,94.40374790
18112,打針,2,582762,0.00032399,94.40407189
18113,打掉,2,582764,0.00032399,94.40439587
18114,打魚,2,582766,0.00032399,94.40471986
18115,打發,2,582768,0.00032399,94.40504385
18116,打圓場,2,582770,0.00032399,94.40536784
18117,打頭陣,2,582772,0.00032399,94.40569183
18118,打壓,2,582774,0.00032399,94.40601582
18119,打擊樂,2,582776,0.00032399,94.40633981
18120,打獵,2,582778,0.00032399,94.40666379
18121,打轉,2,582780,0.00032399,94.40698778
18122,打贏,2,582782,0.00032399,94.40731177
18123,本土性,2,582784,0.00032399,94.40763576
18124,本地人,2,582786,0.00032399,94.40795975
18125,本色,2,582788,0.00032399,94.40828374
18126,本金,2,582790,0.00032399,94.40860772
18127,本省,2,582792,0.00032399,94.40893171
18128,本省籍,2,582794,0.00032399,94.40925570
18129,本領,2,582796,0.00032399,94.40957969
18130,未及,2,582798,0.00032399,94.40990368
18131,未成功,2,582800,0.00032399,94.41022767
18132,未成年,2,582802,0.00032399,94.41055166
18133,未成熟,2,582804,0.00032399,94.41087564
18134,未有,2,582806,0.00032399,94.41119963
18135,未決,2,582808,0.00032399,94.41152362
18136,未來車,2,582810,0.00032399,94.41184761
18137,未到,2,582812,0.00032399,94.41217160
18138,未定,2,582814,0.00032399,94.41249559
18139,未知,2,582816,0.00032399,94.41281957
18140,未料,2,582818,0.00032399,94.41314356
18141,未開發,2,582820,0.00032399,94.41346755
18142,未經,2,582822,0.00032399,94.41379154
18143,未滿,2,582824,0.00032399,94.41411553
18144,未獲,2,582826,0.00032399,94.41443952
18145,未變,2,582828,0.00032399,94.41476350
18146,末日,2,582830,0.00032399,94.41508749
18147,札什倫布寺,2,582832,0.00032399,94.41541148
18148,札芬德拉,2,582834,0.00032399,94.41573547
18149,正巧,2,582836,0.00032399,94.41605946
18150,正如同,2,582838,0.00032399,94.41638345
18151,正要,2,582840,0.00032399,94.41670744
18152,正副議長,2,582842,0.00032399,94.41703142
18153,正義里,2,582844,0.00032399,94.41735541
18154,正確性,2,582846,0.00032399,94.41767940
18155,母女,2,582848,0.00032399,94.41800339
18156,母公司,2,582850,0.00032399,94.41832738
18157,母愛,2,582852,0.00032399,94.41865137
18158,母語,2,582854,0.00032399,94.41897535
18159,民主化,2,582856,0.00032399,94.41929934
18160,民主派,2,582858,0.00032399,94.41962333
18161,民享街,2,582860,0.00032399,94.41994732
18162,民初,2,582862,0.00032399,94.42027131
18163,民紡,2,582864,0.00032399,94.42059530
18164,民族報,2,582866,0.00032399,94.42091928
18165,民智街,2,582868,0.00032399,94.42124327
18166,民進黨籍,2,582870,0.00032399,94.42156726
18167,民意機關,2,582872,0.00032399,94.42189125
18168,民興紡織,2,582874,0.00032399,94.42221524
18169,民權東路,2,582876,0.00032399,94.42253923
18170,永春高中,2,582878,0.00032399,94.42286322
18171,永無止境,2,582880,0.00032399,94.42318720
18172,永業,2,582882,0.00032399,94.42351119
18173,汁液,2,582884,0.00032399,94.42383518
18174,犯嫌,2,582886,0.00032399,94.42415917
18175,玄關,2,582888,0.00032399,94.42448316
18176,玉米粒,2,582890,0.00032399,94.42480715
18177,瓜,2,582892,0.00032399,94.42513113
18178,瓜類,2,582894,0.00032399,94.42545512
18179,瓦斯燃料系統,2,582896,0.00032399,94.42577911
18180,甘之如飴,2,582898,0.00032399,94.42610310
18181,甘尼,2,582900,0.00032399,94.42642709
18182,甘肅,2,582902,0.00032399,94.42675108
18183,甘願,2,582904,0.00032399,94.42707506
18184,生化,2,582906,0.00032399,94.42739905
18185,生父,2,582908,0.00032399,94.42772304
18186,生生不息,2,582910,0.00032399,94.42804703
18187,生存性,2,582912,0.00032399,94.42837102
18188,生物學家,2,582914,0.00032399,94.42869501
18189,生活化,2,582916,0.00032399,94.42901900
18190,生活營,2,582918,0.00032399,94.42934298
18191,生活觀,2,582920,0.00032399,94.42966697
18192,生涯規劃,2,582922,0.00032399,94.42999096
18193,生猛,2,582924,0.00032399,94.43031495
18194,生產毛額,2,582926,0.00032399,94.43063894
18195,生產者,2,582928,0.00032399,94.43096293
18196,生殖細胞癌,2,582930,0.00032399,94.43128691
18197,生殖器,2,582932,0.00032399,94.43161090
18198,生意人,2,582934,0.00032399,94.43193489
18199,生澀,2,582936,0.00032399,94.43225888
18200,用完,2,582938,0.00032399,94.43258287
18201,用場,2,582940,0.00032399,94.43290686
18202,用語,2,582942,0.00032399,94.43323084
18203,甩掉,2,582944,0.00032399,94.43355483
18204,田地,2,582946,0.00032399,94.43387882
18205,田啟元,2,582948,0.00032399,94.43420281
18206,甲午戰爭,2,582950,0.00032399,94.43452680
18207,甲板,2,582952,0.00032399,94.43485079
18208,申訴,2,582954,0.00032399,94.43517478
18209,申誡,2,582956,0.00032399,94.43549876
18210,申辦,2,582958,0.00032399,94.43582275
18211,申購者,2,582960,0.00032399,94.43614674
18212,白人教父,2,582962,0.00032399,94.43647073
18213,白白,2,582964,0.00032399,94.43679472
18214,白米,2,582966,0.00032399,94.43711871
18215,白色恐怖,2,582968,0.00032399,94.43744269
18216,白河,2,582970,0.00032399,94.43776668
18217,白花菜,2,582972,0.00032399,94.43809067
18218,白朗士,2,582974,0.00032399,94.43841466
18219,白晝,2,582976,0.00032399,94.43873865
18220,白菜,2,582978,0.00032399,94.43906264
18221,白開水運動,2,582980,0.00032399,94.43938663
18222,白雲,2,582982,0.00032399,94.43971061
18223,皮下脂肪層,2,582984,0.00032399,94.44003460
18224,皮件,2,582986,0.00032399,94.44035859
18225,皮夾子,2,582988,0.00032399,94.44068258
18226,皮特里基,2,582990,0.00032399,94.44100657
18227,皮爾,2,582992,0.00032399,94.44133056
18228,皮膜,2,582994,0.00032399,94.44165454
18229,皮質,2,582996,0.00032399,94.44197853
18230,目前為止,2,582998,0.00032399,94.44230252
18231,石化業,2,583000,0.00032399,94.44262651
18232,石灰石,2,583002,0.00032399,94.44295050
18233,石器時代,2,583004,0.00032399,94.44327449
18234,石磚,2,583006,0.00032399,94.44359847
18235,示好,2,583008,0.00032399,94.44392246
18236,示威,2,583010,0.00032399,94.44424645
18237,示警,2,583012,0.00032399,94.44457044
18238,穴道,2,583014,0.00032399,94.44489443
18239,立式,2,583016,0.00032399,94.44521842
18240,立志,2,583018,0.00032399,94.44554241
18241,立身處世,2,583020,0.00032399,94.44586639
18242,立委選舉,2,583022,0.00032399,94.44619038
18243,立定,2,583024,0.00032399,94.44651437
18244,立像,2,583026,0.00032399,94.44683836
18245,丟進,2,583028,0.00032399,94.44716235
18246,交叉口,2,583030,0.00032399,94.44748634
18247,交互,2,583032,0.00032399,94.44781032
18248,交通部觀光局,2,583034,0.00032399,94.44813431
18249,交通警察,2,583036,0.00032399,94.44845830
18250,交換器,2,583038,0.00032399,94.44878229
18251,交給,2,583040,0.00032399,94.44910628
18252,交遊,2,583042,0.00032399,94.44943027
18253,交銀,2,583044,0.00032399,94.44975425
18254,交誼廳,2,583046,0.00032399,94.45007824
18255,交織,2,583048,0.00032399,94.45040223
18256,仿若,2,583050,0.00032399,94.45072622
18257,伉儷,2,583052,0.00032399,94.45105021
18258,伙食,2,583054,0.00032399,94.45137420
18259,伊凡斯,2,583056,0.00032399,94.45169819
18260,伊東岳彥,2,583058,0.00032399,94.45202217
18261,伊健,2,583060,0.00032399,94.45234616
18262,伊犁河,2,583062,0.00032399,94.45267015
18263,伊斯法罕,2,583064,0.00032399,94.45299414
18264,伊斯特,2,583066,0.00032399,94.45331813
18265,伊斯蘭教,2,583068,0.00032399,94.45364212
18266,休止符,2,583070,0.00032399,94.45396610
18267,休兵,2,583072,0.00032399,94.45429009
18268,休享尼,2,583074,0.00032399,94.45461408
18269,休耕,2,583076,0.00032399,94.45493807
18270,休閒旅館,2,583078,0.00032399,94.45526206
18271,休會,2,583080,0.00032399,94.45558605
18272,伏,2,583082,0.00032399,94.45591003
18273,仲秋,2,583084,0.00032399,94.45623402
18274,仲夏,2,583086,0.00032399,94.45655801
18275,仰頭,2,583088,0.00032399,94.45688200
18276,企畫,2,583090,0.00032399,94.45720599
18277,企畫室,2,583092,0.00032399,94.45752998
18278,企畫部,2,583094,0.00032399,94.45785397
18279,企鵝,2,583096,0.00032399,94.45817795
18280,光怪陸離,2,583098,0.00032399,94.45850194
18281,光的生命,2,583100,0.00032399,94.45882593
18282,光采,2,583102,0.00032399,94.45914992
18283,光美,2,583104,0.00032399,94.45947391
18284,光彩,2,583106,0.00032399,94.45979790
18285,光速,2,583108,0.00032399,94.46012188
18286,光輝,2,583110,0.00032399,94.46044587
18287,光學,2,583112,0.00032399,94.46076986
18288,光環,2,583114,0.00032399,94.46109385
18289,光鮮,2,583116,0.00032399,94.46141784
18290,光譜公司,2,583118,0.00032399,94.46174183
18291,光纖,2,583120,0.00032399,94.46206581
18292,兇狠,2,583122,0.00032399,94.46238980
18293,兇猛,2,583124,0.00032399,94.46271379
18294,兇暴,2,583126,0.00032399,94.46303778
18295,先兆,2,583128,0.00032399,94.46336177
18296,先決條件,2,583130,0.00032399,94.46368576
18297,先例,2,583132,0.00032399,94.46400975
18298,先知,2,583134,0.00032399,94.46433373
18299,先發制人,2,583136,0.00032399,94.46465772
18300,全心全力,2,583138,0.00032399,94.46498171
18301,全心全意,2,583140,0.00032399,94.46530570
18302,全世界,2,583142,0.00032399,94.46562969
18303,全功能,2,583144,0.00032399,94.46595368
18304,全台,2,583146,0.00032399,94.46627766
18305,全光輝,2,583148,0.00032399,94.46660165
18306,全自動,2,583150,0.00032399,94.46692564
18307,全美,2,583152,0.00032399,94.46724963
18308,全員,2,583154,0.00032399,94.46757362
18309,全家便利商店,2,583156,0.00032399,94.46789761
18310,全海岸,2,583158,0.00032399,94.46822160
18311,全班,2,583160,0.00032399,94.46854558
18312,全國委員會,2,583162,0.00032399,94.46886957
18313,全國性,2,583164,0.00032399,94.46919356
18314,全國飯店,2,583166,0.00032399,94.46951755
18315,全國電子,2,583168,0.00032399,94.46984154
18316,全速,2,583170,0.00032399,94.47016553
18317,全場,2,583172,0.00032399,94.47048951
18318,全隊,2,583174,0.00032399,94.47081350
18319,共和黨,2,583176,0.00032399,94.47113749
18320,共度,2,583178,0.00032399,94.47146148
18321,共處,2,583180,0.00032399,94.47178547
18322,共渡,2,583182,0.00032399,94.47210946
18323,再來,2,583184,0.00032399,94.47243344
18324,再教育,2,583186,0.00032399,94.47275743
18325,再說,2,583188,0.00032399,94.47308142
18326,冰川,2,583190,0.00032399,94.47340541
18327,冰枕,2,583192,0.00032399,94.47372940
18328,冰凍,2,583194,0.00032399,94.47405339
18329,冰涼,2,583196,0.00032399,94.47437738
18330,冰糖,2,583198,0.00032399,94.47470136
18331,冰糖燕窩,2,583200,0.00032399,94.47502535
18332,列為,2,583202,0.00032399,94.47534934
18333,列強,2,583204,0.00032399,94.47567333
18334,刑事局,2,583206,0.00032399,94.47599732
18335,刑事顧問費,2,583208,0.00032399,94.47632131
18336,划船,2,583210,0.00032399,94.47664529
18337,匠,2,583212,0.00032399,94.47696928
18338,印地安人隊,2,583214,0.00032399,94.47729327
18339,印度教,2,583216,0.00032399,94.47761726
18340,印章,2,583218,0.00032399,94.47794125
18341,危難,2,583220,0.00032399,94.47826524
18342,吉米,2,583222,0.00032399,94.47858922
18343,吉利諾夫斯基,2,583224,0.00032399,94.47891321
18344,吉祥物,2,583226,0.00032399,94.47923720
18345,吉普,2,583228,0.00032399,94.47956119
18346,吉爾達,2,583230,0.00032399,94.47988518
18347,同性,2,583232,0.00032399,94.48020917
18348,同是,2,583234,0.00032399,94.48053316
18349,同情心,2,583236,0.00032399,94.48085714
18350,同等品,2,583238,0.00032399,94.48118113
18351,同路人,2,583240,0.00032399,94.48150512
18352,同輩,2,583242,0.00032399,94.48182911
18353,同儕,2,583244,0.00032399,94.48215310
18354,吊死,2,583246,0.00032399,94.48247709
18355,吊車,2,583248,0.00032399,94.48280107
18356,吊銷,2,583250,0.00032399,94.48312506
18357,吊環,2,583252,0.00032399,94.48344905
18358,吐痰,2,583254,0.00032399,94.48377304
18359,吐露,2,583256,0.00032399,94.48409703
18360,各式各樣,2,583258,0.00032399,94.48442102
18361,各派,2,583260,0.00032399,94.48474500
18362,各項,2,583262,0.00032399,94.48506899
18363,各說各話,2,583264,0.00032399,94.48539298
18364,向秋玲,2,583266,0.00032399,94.48571697
18365,名不虛傳,2,583268,0.00032399,94.48604096
18366,名片簿,2,583270,0.00032399,94.48636495
18367,名次,2,583272,0.00032399,94.48668894
18368,名作,2,583274,0.00032399,94.48701292
18369,名利,2,583276,0.00032399,94.48733691
18370,名琴,2,583278,0.00032399,94.48766090
18371,名筆,2,583280,0.00032399,94.48798489
18372,名譽,2,583282,0.00032399,94.48830888
18373,合一,2,583284,0.00032399,94.48863287
18374,合成皮料,2,583286,0.00032399,94.48895685
18375,合作者,2,583288,0.00032399,94.48928084
18376,合金,2,583290,0.00032399,94.48960483
18377,合建,2,583292,0.00032399,94.48992882
18378,合建出售,2,583294,0.00032399,94.49025281
18379,合約價,2,583296,0.00032399,94.49057680
18380,合起來,2,583298,0.00032399,94.49090078
18381,合情合理,2,583300,0.00032399,94.49122477
18382,合理化,2,583302,0.00032399,94.49154876
18383,合夥人,2,583304,0.00032399,94.49187275
18384,吃出,2,583306,0.00032399,94.49219674
18385,吃味,2,583308,0.00032399,94.49252073
18386,吃起來,2,583310,0.00032399,94.49284472
18387,吃緊,2,583312,0.00032399,94.49316870
18388,后冠,2,583314,0.00032399,94.49349269
18389,回心轉意,2,583316,0.00032399,94.49381668
18390,回事,2,583318,0.00032399,94.49414067
18391,回貶,2,583320,0.00032399,94.49446466
18392,回鄉,2,583322,0.00032399,94.49478865
18393,回憶錄,2,583324,0.00032399,94.49511263
18394,回轉,2,583326,0.00032399,94.49543662
18395,地下道,2,583328,0.00032399,94.49576061
18396,地上物,2,583330,0.00032399,94.49608460
18397,地心引力,2,583332,0.00032399,94.49640859
18398,地方官,2,583334,0.00032399,94.49673258
18399,地方版,2,583336,0.00032399,94.49705657
18400,地皮,2,583338,0.00032399,94.49738055
18401,地底,2,583340,0.00032399,94.49770454
18402,地球日,2,583342,0.00032399,94.49802853
18403,地勢,2,583344,0.00032399,94.49835252
18404,地獄巡遊,2,583346,0.00032399,94.49867651
18405,地質,2,583348,0.00032399,94.49900050
18406,地震帶,2,583350,0.00032399,94.49932448
18407,在世,2,583352,0.00032399,94.49964847
18408,多米尼克,2,583354,0.00032399,94.49997246
18409,多佛空軍基地,2,583356,0.00032399,94.50029645
18410,多事,2,583358,0.00032399,94.50062044
18411,多事之秋,2,583360,0.00032399,94.50094443
18412,多店,2,583362,0.00032399,94.50126841
18413,多彩多姿,2,583364,0.00032399,94.50159240
18414,多媒體資料,2,583366,0.00032399,94.50191639
18415,多達,2,583368,0.00032399,94.50224038
18416,多樣性,2,583370,0.00032399,94.50256437
18417,妄念,2,583372,0.00032399,94.50288836
18418,好心,2,583374,0.00032399,94.50321235
18419,好采頭,2,583376,0.00032399,94.50353633
18420,好高騖遠,2,583378,0.00032399,94.50386032
18421,好球,2,583380,0.00032399,94.50418431
18422,好評,2,583382,0.00032399,94.50450830
18423,好嗎,2,583384,0.00032399,94.50483229
18424,好漢,2,583386,0.00032399,94.50515628
18425,好聽,2,583388,0.00032399,94.50548026
18426,如意,2,583390,0.00032399,94.50580425
18427,如願以償,2,583392,0.00032399,94.50612824
18428,字典,2,583394,0.00032399,94.50645223
18429,字彙,2,583396,0.00032399,94.50677622
18430,字跡,2,583398,0.00032399,94.50710021
18431,字幕,2,583400,0.00032399,94.50742419
18432,字體,2,583402,0.00032399,94.50774818
18433,存入,2,583404,0.00032399,94.50807217
18434,存有,2,583406,0.00032399,94.50839616
18435,存活數,2,583408,0.00032399,94.50872015
18436,存款人,2,583410,0.00032399,94.50904414
18437,存款簿,2,583412,0.00032399,94.50936813
18438,存量,2,583414,0.00032399,94.50969211
18439,守軍,2,583416,0.00032399,94.51001610
18440,守財奴,2,583418,0.00032399,94.51034009
18441,守穩,2,583420,0.00032399,94.51066408
18442,守護星,2,583422,0.00032399,94.51098807
18443,宅院,2,583424,0.00032399,94.51131206
18444,安分,2,583426,0.00032399,94.51163604
18445,安可,2,583428,0.00032399,94.51196003
18446,安全度,2,583430,0.00032399,94.51228402
18447,安全島,2,583432,0.00032399,94.51260801
18448,安全帶,2,583434,0.00032399,94.51293200
18449,安危,2,583436,0.00032399,94.51325599
18450,安妮,2,583438,0.00032399,94.51357997
18451,安哥拉,2,583440,0.00032399,94.51390396
18452,安哥拉戰爭,2,583442,0.00032399,94.51422795
18453,安息,2,583444,0.00032399,94.51455194
18454,安泰,2,583446,0.00032399,94.51487593
18455,安理會,2,583448,0.00032399,94.51519992
18456,安規,2,583450,0.00032399,94.51552391
18457,安頓,2,583452,0.00032399,94.51584789
18458,安德魯,2,583454,0.00032399,94.51617188
18459,安慰劑,2,583456,0.00032399,94.51649587
18460,安養中心,2,583458,0.00032399,94.51681986
18461,安親班,2,583460,0.00032399,94.51714385
18462,尖叫,2,583462,0.00032399,94.51746784
18463,尖美,2,583464,0.00032399,94.51779182
18464,尖峰,2,583466,0.00032399,94.51811581
18465,尖端,2,583468,0.00032399,94.51843980
18466,尖豐公路,2,583470,0.00032399,94.51876379
18467,屹立不搖,2,583472,0.00032399,94.51908778
18468,年幼,2,583474,0.00032399,94.51941177
18469,年份,2,583476,0.00032399,94.51973576
18470,年成長率,2,583478,0.00032399,94.52005974
18471,年會,2,583480,0.00032399,94.52038373
18472,年節,2,583482,0.00032399,94.52070772
18473,年線,2,583484,0.00032399,94.52103171
18474,年營收,2,583486,0.00032399,94.52135570
18475,年邁,2,583488,0.00032399,94.52167969
18476,年關,2,583490,0.00032399,94.52200367
18477,成大,2,583492,0.00032399,94.52232766
18478,成功人士,2,583494,0.00032399,94.52265165
18479,成功率,2,583496,0.00032399,94.52297564
18480,成功學,2,583498,0.00032399,94.52329963
18481,成交額,2,583500,0.00032399,94.52362362
18482,成行,2,583502,0.00032399,94.52394760
18483,成衣工廠,2,583504,0.00032399,94.52427159
18484,成見,2,583506,0.00032399,94.52459558
18485,成型,2,583508,0.00032399,94.52491957
18486,成家,2,583510,0.00032399,94.52524356
18487,成淵高中,2,583512,0.00032399,94.52556755
18488,成棒,2,583514,0.00032399,94.52589154
18489,成群,2,583516,0.00032399,94.52621552
18490,成藥,2,583518,0.00032399,94.52653951
18491,扣子,2,583520,0.00032399,94.52686350
18492,扣住,2,583522,0.00032399,94.52718749
18493,扣籃,2,583524,0.00032399,94.52751148
18494,托高,2,583526,0.00032399,94.52783547
18495,托普卡普王宮,2,583528,0.00032399,94.52815945
18496,收手,2,583530,0.00032399,94.52848344
18497,收益率,2,583532,0.00032399,94.52880743
18498,收割,2,583534,0.00032399,94.52913142
18499,收費表,2,583536,0.00032399,94.52945541
18500,收銀,2,583538,0.00032399,94.52977940
18501,收銀台,2,583540,0.00032399,94.53010338
18502,收銀機,2,583542,0.00032399,94.53042737
18503,收編,2,583544,0.00032399,94.53075136
18504,收藏者,2,583546,0.00032399,94.53107535
18505,收藏界,2,583548,0.00032399,94.53139934
18506,旭,2,583550,0.00032399,94.53172333
18507,旭日,2,583552,0.00032399,94.53204732
18508,曲式,2,583554,0.00032399,94.53237130
18509,曲風,2,583556,0.00032399,94.53269529
18510,曲棍球,2,583558,0.00032399,94.53301928
18511,曲線圖,2,583560,0.00032399,94.53334327
18512,曲館燈,2,583562,0.00032399,94.53366726
18513,有一天,2,583564,0.00032399,94.53399125
18514,有心,2,583566,0.00032399,94.53431523
18515,有形,2,583568,0.00032399,94.53463922
18516,有恃無恐,2,583570,0.00032399,94.53496321
18517,有毒,2,583572,0.00032399,94.53528720
18518,有情人,2,583574,0.00032399,94.53561119
18519,有理,2,583576,0.00032399,94.53593518
18520,有備無患,2,583578,0.00032399,94.53625916
18521,有給職,2,583580,0.00032399,94.53658315
18522,有意思,2,583582,0.00032399,94.53690714
18523,有緣人,2,583584,0.00032399,94.53723113
18524,有線電視頻道,2,583586,0.00032399,94.53755512
18525,有機可乘,2,583588,0.00032399,94.53787911
18526,有聲書,2,583590,0.00032399,94.53820310
18527,有礙,2,583592,0.00032399,94.53852708
18528,朴普,2,583594,0.00032399,94.53885107
18529,朱永惠,2,583596,0.00032399,94.53917506
18530,朱志清,2,583598,0.00032399,94.53949905
18531,次子,2,583600,0.00032399,94.53982304
18532,次級,2,583602,0.00032399,94.54014703
18533,次標題,2,583604,0.00032399,94.54047101
18534,此地,2,583606,0.00032399,94.54079500
18535,此時此刻,2,583608,0.00032399,94.54111899
18536,此舉,2,583610,0.00032399,94.54144298
18537,死人,2,583612,0.00032399,94.54176697
18538,死囚,2,583614,0.00032399,94.54209096
18539,死地,2,583616,0.00032399,94.54241494
18540,死神,2,583618,0.00032399,94.54273893
18541,死掉,2,583620,0.00032399,94.54306292
18542,死難者,2,583622,0.00032399,94.54338691
18543,汗流浹背,2,583624,0.00032399,94.54371090
18544,汙水,2,583626,0.00032399,94.54403489
18545,汙染性,2,583628,0.00032399,94.54435888
18546,江河,2,583630,0.00032399,94.54468286
18547,江青,2,583632,0.00032399,94.54500685
18548,江南,2,583634,0.00032399,94.54533084
18549,江彥文,2,583636,0.00032399,94.54565483
18550,江連福,2,583638,0.00032399,94.54597882
18551,江惠惠,2,583640,0.00032399,94.54630281
18552,江詩丹頓,2,583642,0.00032399,94.54662679
18553,江蓋世,2,583644,0.00032399,94.54695078
18554,江蘇省,2,583646,0.00032399,94.54727477
18555,汐止鎮,2,583648,0.00032399,94.54759876
18556,汐止鎮長,2,583650,0.00032399,94.54792275
18557,污濁,2,583652,0.00032399,94.54824674
18558,汎德公司,2,583654,0.00032399,94.54857073
18559,灰心,2,583656,0.00032399,94.54889471
18560,灰白色,2,583658,0.00032399,94.54921870
18561,牟利,2,583660,0.00032399,94.54954269
18562,百分位,2,583662,0.00032399,94.54986668
18563,百合大草原,2,583664,0.00032399,94.55019067
18564,百年奧林匹克公園,2,583666,0.00032399,94.55051466
18565,百里香,2,583668,0.00032399,94.55083864
18566,百武彗星,2,583670,0.00032399,94.55116263
18567,百花齊放,2,583672,0.00032399,94.55148662
18568,百科全書,2,583674,0.00032399,94.55181061
18569,百葉結,2,583676,0.00032399,94.55213460
18570,竹北,2,583678,0.00032399,94.55245859
18571,竹圍海水浴場,2,583680,0.00032399,94.55278257
18572,竹筍,2,583682,0.00032399,94.55310656
18573,竹編,2,583684,0.00032399,94.55343055
18574,竹藝品,2,583686,0.00032399,94.55375454
18575,米白,2,583688,0.00032399,94.55407853
18576,米老鼠,2,583690,0.00032399,94.55440252
18577,米色,2,583692,0.00032399,94.55472651
18578,米奇老鼠,2,583694,0.00032399,94.55505049
18579,米南貿易公司,2,583696,0.00032399,94.55537448
18580,米契爾,2,583698,0.00032399,94.55569847
18581,米莉耶,2,583700,0.00032399,94.55602246
18582,米蒂亞,2,583702,0.00032399,94.55634645
18583,米糧,2,583704,0.00032399,94.55667044
18584,羊皮紙,2,583706,0.00032399,94.55699442
18585,羊群,2,583708,0.00032399,94.55731841
18586,羊膜穿刺,2,583710,0.00032399,94.55764240
18587,羽毛,2,583712,0.00032399,94.55796639
18588,老少咸宜,2,583714,0.00032399,94.55829038
18589,老生,2,583716,0.00032399,94.55861437
18590,老字號,2,583718,0.00032399,94.55893835
18591,老成,2,583720,0.00032399,94.55926234
18592,老老小小,2,583722,0.00032399,94.55958633
18593,老兵,2,583724,0.00032399,94.55991032
18594,老朋友,2,583726,0.00032399,94.56023431
18595,老弱,2,583728,0.00032399,94.56055830
18596,老弱婦孺,2,583730,0.00032399,94.56088229
18597,老將,2,583732,0.00032399,94.56120627
18598,老爺,2,583734,0.00032399,94.56153026
18599,老爺車,2,583736,0.00032399,94.56185425
18600,老實說,2,583738,0.00032399,94.56217824
18601,老歌,2,583740,0.00032399,94.56250223
18602,老鎮新生,2,583742,0.00032399,94.56282622
18603,考察團,2,583744,0.00032399,94.56315020
18604,考績,2,583746,0.00032399,94.56347419
18605,而立,2,583748,0.00032399,94.56379818
18606,而因,2,583750,0.00032399,94.56412217
18607,而後,2,583752,0.00032399,94.56444616
18608,耳機,2,583754,0.00032399,94.56477015
18609,肉冠,2,583756,0.00032399,94.56509413
18610,肌梭,2,583758,0.00032399,94.56541812
18611,肌電圖,2,583760,0.00032399,94.56574211
18612,臣服,2,583762,0.00032399,94.56606610
18613,自古以來,2,583764,0.00032399,94.56639009
18614,自甘墮落,2,583766,0.00032399,94.56671408
18615,自用,2,583768,0.00032399,94.56703807
18616,自由度,2,583770,0.00032399,94.56736205
18617,自由商圈,2,583772,0.00032399,94.56768604
18618,自由黨,2,583774,0.00032399,94.56801003
18619,自立,2,583776,0.00032399,94.56833402
18620,自助旅行,2,583778,0.00032399,94.56865801
18621,自告奮勇,2,583780,0.00032399,94.56898200
18622,自我認同,2,583782,0.00032399,94.56930598
18623,自私,2,583784,0.00032399,94.56962997
18624,自知之明,2,583786,0.00032399,94.56995396
18625,自怨自艾,2,583788,0.00032399,94.57027795
18626,自負,2,583790,0.00032399,94.57060194
18627,自耕農,2,583792,0.00032399,94.57092593
18628,自動門,2,583794,0.00032399,94.57124991
18629,自動販賣機,2,583796,0.00032399,94.57157390
18630,自掏腰包,2,583798,0.00032399,94.57189789
18631,自處,2,583800,0.00032399,94.57222188
18632,自喻,2,583802,0.00032399,94.57254587
18633,自然主義,2,583804,0.00032399,94.57286986
18634,自然科學,2,583806,0.00032399,94.57319385
18635,自然學家,2,583808,0.00032399,94.57351783
18636,自傳,2,583810,0.00032399,94.57384182
18637,自營部,2,583812,0.00032399,94.57416581
18638,自願,2,583814,0.00032399,94.57448980
18639,自戀,2,583816,0.00032399,94.57481379
18640,色漆,2,583818,0.00032399,94.57513778
18641,艾利歐,2,583820,0.00032399,94.57546176
18642,艾思加達,2,583822,0.00032399,94.57578575
18643,艾偉,2,583824,0.00032399,94.57610974
18644,艾默瑞,2,583826,0.00032399,94.57643373
18645,血尿,2,583828,0.00032399,94.57675772
18646,血流感染,2,583830,0.00032399,94.57708171
18647,血庫,2,583832,0.00032399,94.57740570
18648,血淋淋,2,583834,0.00032399,94.57772968
18649,行不通,2,583836,0.00032399,94.57805367
18650,行兇,2,583838,0.00032399,94.57837766
18651,行李箱,2,583840,0.00032399,94.57870165
18652,行車,2,583842,0.00032399,94.57902564
18653,行板,2,583844,0.00032399,94.57934963
18654,行政長官,2,583846,0.00032399,94.57967361
18655,行動力,2,583848,0.00032399,94.57999760
18656,行當,2,583850,0.00032399,94.58032159
18657,行經,2,583852,0.00032399,94.58064558
18658,行話,2,583854,0.00032399,94.58096957
18659,行賄,2,583856,0.00032399,94.58129356
18660,行跡,2,583858,0.00032399,94.58161754
18661,行銷企劃部,2,583860,0.00032399,94.58194153
18662,行憲,2,583862,0.00032399,94.58226552
18663,行醫,2,583864,0.00032399,94.58258951
18664,衣冠楚楚,2,583866,0.00032399,94.58291350
18665,衣架,2,583868,0.00032399,94.58323749
18666,西太平洋,2,583870,0.00032399,94.58356148
18667,西加,2,583872,0.00032399,94.58388546
18668,西吉,2,583874,0.00032399,94.58420945
18669,西安,2,583876,0.00032399,94.58453344
18670,西式,2,583878,0.00032399,94.58485743
18671,西行,2,583880,0.00032399,94.58518142
18672,西西里島,2,583882,0.00032399,94.58550541
18673,西佛尼奧斯,2,583884,0.00032399,94.58582939
18674,西奈,2,583886,0.00032399,94.58615338
18675,西奈半島,2,583888,0.00032399,94.58647737
18676,西恩潘,2,583890,0.00032399,94.58680136
18677,西側,2,583892,0.00032399,94.58712535
18678,西陵,2,583894,0.00032399,94.58744934
18679,西湖,2,583896,0.00032399,94.58777332
18680,西華飯店,2,583898,0.00032399,94.58809731
18681,西雅,2,583900,0.00032399,94.58842130
18682,西雅圖夜未眠,2,583902,0.00032399,94.58874529
18683,西螺休息站,2,583904,0.00032399,94.58906928
18684,西藏生死書,2,583906,0.00032399,94.58939327
18685,串列,2,583908,0.00032399,94.58971726
18686,串門,2,583910,0.00032399,94.59004124
18687,位階,2,583912,0.00032399,94.59036523
18688,位數,2,583914,0.00032399,94.59068922
18689,住友事件,2,583916,0.00032399,94.59101321
18690,住友商社,2,583918,0.00032399,94.59133720
18691,住屋,2,583920,0.00032399,94.59166119
18692,住持,2,583922,0.00032399,94.59198517
18693,住校,2,583924,0.00032399,94.59230916
18694,佇立,2,583926,0.00032399,94.59263315
18695,伴郎,2,583928,0.00032399,94.59295714
18696,佛土,2,583930,0.00032399,94.59328113
18697,佛祖,2,583932,0.00032399,94.59360512
18698,佛羅里達,2,583934,0.00032399,94.59392910
18699,佛羅里達州,2,583936,0.00032399,94.59425309
18700,何亞榮,2,583938,0.00032399,94.59457708
18701,何淑貞,2,583940,0.00032399,94.59490107
18702,何創時書法藝術文教基金會,2,583942,0.00032399,94.59522506
18703,何澄峰,2,583944,0.00032399,94.59554905
18704,何謂,2,583946,0.00032399,94.59587304
18705,何顯重,2,583948,0.00032399,94.59619702
18706,估量,2,583950,0.00032399,94.59652101
18707,伸手,2,583952,0.00032399,94.59684500
18708,伸向,2,583954,0.00032399,94.59716899
18709,伸縮式,2,583956,0.00032399,94.59749298
18710,作文章,2,583958,0.00032399,94.59781697
18711,作曲者,2,583960,0.00032399,94.59814095
18712,作弄,2,583962,0.00032399,94.59846494
18713,作東,2,583964,0.00032399,94.59878893
18714,作客,2,583966,0.00032399,94.59911292
18715,作陪,2,583968,0.00032399,94.59943691
18716,作答,2,583970,0.00032399,94.59976090
18717,作勢,2,583972,0.00032399,94.60008488
18718,作業環境,2,583974,0.00032399,94.60040887
18719,作嘔,2,583976,0.00032399,94.60073286
18720,作弊,2,583978,0.00032399,94.60105685
18721,作罷,2,583980,0.00032399,94.60138084
18722,你死我活,2,583982,0.00032399,94.60170483
18723,低空,2,583984,0.00032399,94.60202882
18724,低氣壓,2,583986,0.00032399,94.60235280
18725,伶俐,2,583988,0.00032399,94.60267679
18726,余素芳,2,583990,0.00032399,94.60300078
18727,佈局,2,583992,0.00032399,94.60332477
18728,佈陣,2,583994,0.00032399,94.60364876
18729,佈設,2,583996,0.00032399,94.60397275
18730,佈景,2,583998,0.00032399,94.60429673
18731,兌現,2,584000,0.00032399,94.60462072
18732,克力,2,584002,0.00032399,94.60494471
18733,克利夫蘭,2,584004,0.00032399,94.60526870
18734,克拉維夫,2,584006,0.00032399,94.60559269
18735,克林斯曼,2,584008,0.00032399,94.60591668
18736,克理斯多都伯依斯,2,584010,0.00032399,94.60624067
18737,克勞斯,2,584012,0.00032399,94.60656465
18738,克萊本,2,584014,0.00032399,94.60688864
18739,克雷門斯,2,584016,0.00032399,94.60721263
18740,克羅埃西亞,2,584018,0.00032399,94.60753662
18741,免刑,2,584020,0.00032399,94.60786061
18742,免得,2,584022,0.00032399,94.60818460
18743,兵役,2,584024,0.00032399,94.60850858
18744,兵法店,2,584026,0.00032399,94.60883257
18745,兵種,2,584028,0.00032399,94.60915656
18746,兵器,2,584030,0.00032399,94.60948055
18747,冷水澡,2,584032,0.00032399,94.60980454
18748,冷性,2,584034,0.00032399,94.61012853
18749,冷房,2,584036,0.00032399,94.61045251
18750,冷凍庫,2,584038,0.00032399,94.61077650
18751,冷峻,2,584040,0.00032399,94.61110049
18752,冷清,2,584042,0.00032399,94.61142448
18753,冷媒,2,584044,0.00032399,94.61174847
18754,冷飲,2,584046,0.00032399,94.61207246
18755,別開生面,2,584048,0.00032399,94.61239645
18756,判決書,2,584050,0.00032399,94.61272043
18757,判若兩人,2,584052,0.00032399,94.61304442
18758,判準,2,584054,0.00032399,94.61336841
18759,判讀力,2,584056,0.00032399,94.61369240
18760,利爪,2,584058,0.00032399,94.61401639
18761,利尿劑,2,584060,0.00032399,94.61434038
18762,利得,2,584062,0.00032399,94.61466436
18763,利澤,2,584064,0.00032399,94.61498835
18764,刪改,2,584066,0.00032399,94.61531234
18765,劫匪,2,584068,0.00032399,94.61563633
18766,助人,2,584070,0.00032399,94.61596032
18767,助漲助跌,2,584072,0.00032399,94.61628431
18768,即飲,2,584074,0.00032399,94.61660829
18769,即飲式,2,584076,0.00032399,94.61693228
18770,吝惜,2,584078,0.00032399,94.61725627
18771,吾人,2,584080,0.00032399,94.61758026
18772,吧台,2,584082,0.00032399,94.61790425
18773,吳天羅,2,584084,0.00032399,94.61822824
18774,吳文龍,2,584086,0.00032399,94.61855223
18775,吳正治,2,584088,0.00032399,94.61887621
18776,吳永輝,2,584090,0.00032399,94.61920020
18777,吳克清,2,584092,0.00032399,94.61952419
18778,吳挽瀾,2,584094,0.00032399,94.61984818
18779,吳祥堅,2,584096,0.00032399,94.62017217
18780,吳惠林,2,584098,0.00032399,94.62049616
18781,吳蕙如,2,584100,0.00032399,94.62082014
18782,吳濱洋,2,584102,0.00032399,94.62114413
18783,呂,2,584104,0.00032399,94.62146812
18784,呂明賜,2,584106,0.00032399,94.62179211
18785,呂秉原,2,584108,0.00032399,94.62211610
18786,呂美玲,2,584110,0.00032399,94.62244009
18787,吩咐,2,584112,0.00032399,94.62276407
18788,告白,2,584114,0.00032399,94.62308806
18789,告誡,2,584116,0.00032399,94.62341205
18790,吹奏,2,584118,0.00032399,94.62373604
18791,吸力,2,584120,0.00032399,94.62406003
18792,吸吐,2,584122,0.00032399,94.62438402
18793,吸附,2,584124,0.00032399,94.62470801
18794,吸風口,2,584126,0.00032399,94.62503199
18795,吸管,2,584128,0.00032399,94.62535598
18796,吼,2,584130,0.00032399,94.62567997
18797,吼叫聲,2,584132,0.00032399,94.62600396
18798,含糊,2,584134,0.00032399,94.62632795
18799,困,2,584136,0.00032399,94.62665194
18800,困窘,2,584138,0.00032399,94.62697592
18801,困頓,2,584140,0.00032399,94.62729991
18802,坊,2,584142,0.00032399,94.62762390
18803,坍方,2,584144,0.00032399,94.62794789
18804,均分,2,584146,0.00032399,94.62827188
18805,均是,2,584148,0.00032399,94.62859587
18806,坎塞柯,2,584150,0.00032399,94.62891985
18807,坐下,2,584152,0.00032399,94.62924384
18808,坐立不安,2,584154,0.00032399,94.62956783
18809,坐坐,2,584156,0.00032399,94.62989182
18810,坐進,2,584158,0.00032399,94.63021581
18811,坐鎮,2,584160,0.00032399,94.63053980
18812,壯,2,584162,0.00032399,94.63086379
18813,壯陽,2,584164,0.00032399,94.63118777
18814,壯漢,2,584166,0.00032399,94.63151176
18815,夾住,2,584168,0.00032399,94.63183575
18816,夾擊,2,584170,0.00032399,94.63215974
18817,夾雜,2,584172,0.00032399,94.63248373
18818,妨害秩序,2,584174,0.00032399,94.63280772
18819,妙方,2,584176,0.00032399,94.63313170
18820,妍雅,2,584178,0.00032399,94.63345569
18821,孝,2,584180,0.00032399,94.63377968
18822,完成度,2,584182,0.00032399,94.63410367
18823,宋妮娜,2,584184,0.00032399,94.63442766
18824,宋長志,2,584186,0.00032399,94.63475165
18825,宋健生,2,584188,0.00032399,94.63507564
18826,宏,2,584190,0.00032399,94.63539962
18827,宏大,2,584192,0.00032399,94.63572361
18828,宏和,2,584194,0.00032399,94.63604760
18829,宏洲,2,584196,0.00032399,94.63637159
18830,宏益,2,584198,0.00032399,94.63669558
18831,宏都拉斯共和國,2,584200,0.00032399,94.63701957
18832,宏電,2,584202,0.00032399,94.63734355
18833,宏碁電腦,2,584204,0.00032399,94.63766754
18834,局部曝光,2,584206,0.00032399,94.63799153
18835,屁,2,584208,0.00032399,94.63831552
18836,尿尿,2,584210,0.00032399,94.63863951
18837,尿急,2,584212,0.00032399,94.63896350
18838,尿液白血球,2,584214,0.00032399,94.63928748
18839,尿糖,2,584216,0.00032399,94.63961147
18840,尾部,2,584218,0.00032399,94.63993546
18841,尾款,2,584220,0.00032399,94.64025945
18842,尾盤,2,584222,0.00032399,94.64058344
18843,尾隨,2,584224,0.00032399,94.64090743
18844,尾翼,2,584226,0.00032399,94.64123142
18845,岔,2,584228,0.00032399,94.64155540
18846,岔路,2,584230,0.00032399,94.64187939
18847,巫峽,2,584232,0.00032399,94.64220338
18848,巫婆,2,584234,0.00032399,94.64252737
18849,希,2,584236,0.00032399,94.64285136
18850,希沙立克,2,584238,0.00032399,94.64317535
18851,希爾頓全球飯店索引,2,584240,0.00032399,94.64349933
18852,希臘化,2,584242,0.00032399,94.64382332
18853,序文,2,584244,0.00032399,94.64414731
18854,弄成,2,584246,0.00032399,94.64447130
18855,弄潮,2,584248,0.00032399,94.64479529
18856,弄髒,2,584250,0.00032399,94.64511928
18857,弟子,2,584252,0.00032399,94.64544326
18858,弟兄,2,584254,0.00032399,94.64576725
18859,形勢,2,584256,0.00032399,94.64609124
18860,彷,2,584258,0.00032399,94.64641523
18861,忘卻,2,584260,0.00032399,94.64673922
18862,忌,2,584262,0.00032399,94.64706321
18863,志信運輸,2,584264,0.00032399,94.64738720
18864,志純矽砂公司,2,584266,0.00032399,94.64771118
18865,志業,2,584268,0.00032399,94.64803517
18866,忍者龜,2,584270,0.00032399,94.64835916
18867,忍辱負重,2,584272,0.00032399,94.64868315
18868,忱,2,584274,0.00032399,94.64900714
18869,快步,2,584276,0.00032399,94.64933113
18870,快車道,2,584278,0.00032399,94.64965511
18871,快取,2,584280,0.00032399,94.64997910
18872,快門鈕,2,584282,0.00032399,94.65030309
18873,快要,2,584284,0.00032399,94.65062708
18874,快閃卡,2,584286,0.00032399,94.65095107
18875,快報,2,584288,0.00032399,94.65127506
18876,快樂夏,2,584290,0.00032399,94.65159904
18877,戒,2,584292,0.00032399,94.65192303
18878,戒心,2,584294,0.00032399,94.65224702
18879,戒嚴,2,584296,0.00032399,94.65257101
18880,戒護,2,584298,0.00032399,94.65289500
18881,我的小小急救手冊,2,584300,0.00032399,94.65321899
18882,我愛妳,2,584302,0.00032399,94.65354298
18883,抗原,2,584304,0.00032399,94.65386696
18884,抗氧化,2,584306,0.00032399,94.65419095
18885,抗稅,2,584308,0.00032399,94.65451494
18886,抗戰,2,584310,0.00032399,94.65483893
18887,抖動,2,584312,0.00032399,94.65516292
18888,技術顧問,2,584314,0.00032399,94.65548691
18889,扶,2,584316,0.00032399,94.65581089
18890,扶養費,2,584318,0.00032399,94.65613488
18891,找上,2,584320,0.00032399,94.65645887
18892,找零,2,584322,0.00032399,94.65678286
18893,批判性,2,584324,0.00032399,94.65710685
18894,批發,2,584326,0.00032399,94.65743084
18895,批評者,2,584328,0.00032399,94.65775482
18896,批評家,2,584330,0.00032399,94.65807881
18897,扳平,2,584332,0.00032399,94.65840280
18898,扳掣式,2,584334,0.00032399,94.65872679
18899,折損,2,584336,0.00032399,94.65905078
18900,折騰,2,584338,0.00032399,94.65937477
18901,投出,2,584340,0.00032399,94.65969876
18902,投信公司,2,584342,0.00032399,94.66002274
18903,投案,2,584344,0.00032399,94.66034673
18904,投宿,2,584346,0.00032399,94.66067072
18905,投產,2,584348,0.00032399,94.66099471
18906,投資案,2,584350,0.00032399,94.66131870
18907,投資報酬率,2,584352,0.00032399,94.66164269
18908,投影片,2,584354,0.00032399,94.66196667
18909,投機者,2,584356,0.00032399,94.66229066
18910,抓地力,2,584358,0.00032399,94.66261465
18911,抓狂,2,584360,0.00032399,94.66293864
18912,改正,2,584362,0.00032399,94.66326263
18913,改良型,2,584364,0.00032399,94.66358662
18914,改善獎,2,584366,0.00032399,94.66391061
18915,攻台,2,584368,0.00032399,94.66423459
18916,攻守,2,584370,0.00032399,94.66455858
18917,攻佔,2,584372,0.00032399,94.66488257
18918,攻擊力,2,584374,0.00032399,94.66520656
18919,更替,2,584376,0.00032399,94.66553055
18920,李上甲,2,584378,0.00032399,94.66585454
18921,李文忠,2,584380,0.00032399,94.66617852
18922,李世輝,2,584382,0.00032399,94.66650251
18923,李永豐,2,584384,0.00032399,94.66682650
18924,李目,2,584386,0.00032399,94.66715049
18925,李亦伸,2,584388,0.00032399,94.66747448
18926,李奇,2,584390,0.00032399,94.66779847
18927,李居明,2,584392,0.00032399,94.66812245
18928,李忠熙,2,584394,0.00032399,94.66844644
18929,李信宏,2,584396,0.00032399,94.66877043
18930,李勇男,2,584398,0.00032399,94.66909442
18931,李屏慧,2,584400,0.00032399,94.66941841
18932,李炳南,2,584402,0.00032399,94.66974240
18933,李原彰,2,584404,0.00032399,94.67006639
18934,李娟萍,2,584406,0.00032399,94.67039037
18935,李國煌,2,584408,0.00032399,94.67071436
18936,李國鼎,2,584410,0.00032399,94.67103835
18937,李連配,2,584412,0.00032399,94.67136234
18938,李婷宜,2,584414,0.00032399,94.67168633
18939,李富雄,2,584416,0.00032399,94.67201032
18940,李斯,2,584418,0.00032399,94.67233430
18941,李雲翔,2,584420,0.00032399,94.67265829
18942,李靜君,2,584422,0.00032399,94.67298228
18943,李蘭,2,584424,0.00032399,94.67330627
18944,杏林大學,2,584426,0.00032399,94.67363026
18945,村長,2,584428,0.00032399,94.67395425
18946,杜,2,584430,0.00032399,94.67427823
18947,杜威,2,584432,0.00032399,94.67460222
18948,杜富國,2,584434,0.00032399,94.67492621
18949,杜寧,2,584436,0.00032399,94.67525020
18950,杜爾,2,584438,0.00032399,94.67557419
18951,杉林鄉,2,584440,0.00032399,94.67589818
18952,步兵,2,584442,0.00032399,94.67622217
18953,每下愈況,2,584444,0.00032399,94.67654615
18954,求助函,2,584446,0.00032399,94.67687014
18955,求援,2,584448,0.00032399,94.67719413
18956,求診,2,584450,0.00032399,94.67751812
18957,沙,2,584452,0.00032399,94.67784211
18958,沙沙,2,584454,0.00032399,94.67816610
18959,沙烏地阿拉伯,2,584456,0.00032399,94.67849008
18960,沈尚良,2,584458,0.00032399,94.67881407
18961,沈英南,2,584460,0.00032399,94.67913806
18962,沈悶,2,584462,0.00032399,94.67946205
18963,沈增植,2,584464,0.00032399,94.67978604
18964,沉寂,2,584466,0.00032399,94.68011003
18965,沉默,2,584468,0.00032399,94.68043401
18966,汪俊宏,2,584470,0.00032399,94.68075800
18967,決定性,2,584472,0.00032399,94.68108199
18968,汰,2,584474,0.00032399,94.68140598
18969,沖淡,2,584476,0.00032399,94.68172997
18970,沖煞,2,584478,0.00032399,94.68205396
18971,沒收,2,584480,0.00032399,94.68237795
18972,沒信心,2,584482,0.00032399,94.68270193
18973,汽,2,584484,0.00032399,94.68302592
18974,汽水,2,584486,0.00032399,94.68334991
18975,汽鍋雞,2,584488,0.00032399,94.68367390
18976,汲汲,2,584490,0.00032399,94.68399789
18977,汲取,2,584492,0.00032399,94.68432188
18978,灼痛,2,584494,0.00032399,94.68464586
18979,災情,2,584496,0.00032399,94.68496985
18980,災禍,2,584498,0.00032399,94.68529384
18981,灸,2,584500,0.00032399,94.68561783
18982,牢牢,2,584502,0.00032399,94.68594182
18983,牡羊座,2,584504,0.00032399,94.68626581
18984,狄斯奈,2,584506,0.00032399,94.68658979
18985,狂風暴雨,2,584508,0.00032399,94.68691378
18986,狂野,2,584510,0.00032399,94.68723777
18987,狂喜,2,584512,0.00032399,94.68756176
18988,狂暴,2,584514,0.00032399,94.68788575
18989,狂飆,2,584516,0.00032399,94.68820974
18990,男女主角,2,584518,0.00032399,94.68853373
18991,男男女女,2,584520,0.00032399,94.68885771
18992,男嬰,2,584522,0.00032399,94.68918170
18993,男聲,2,584524,0.00032399,94.68950569
18994,男籃隊,2,584526,0.00032399,94.68982968
18995,私底下,2,584528,0.00032399,94.69015367
18996,秀斗,2,584530,0.00032399,94.69047766
18997,秀拉,2,584532,0.00032399,94.69080164
18998,秀美,2,584534,0.00032399,94.69112563
18999,秀氣,2,584536,0.00032399,94.69144962
19000,肖,2,584538,0.00032399,94.69177361
19001,肝毒性,2,584540,0.00032399,94.69209760
19002,肝熱,2,584542,0.00032399,94.69242159
19003,肝癌,2,584544,0.00032399,94.69274558
19004,肚皮,2,584546,0.00032399,94.69306956
19005,肚量,2,584548,0.00032399,94.69339355
19006,肚臍,2,584550,0.00032399,94.69371754
19007,育樂,2,584552,0.00032399,94.69404153
19008,良師,2,584554,0.00032399,94.69436552
19009,良莠不齊,2,584556,0.00032399,94.69468951
19010,芒果,2,584558,0.00032399,94.69501349
19011,見仁見智,2,584560,0.00032399,94.69533748
19012,見聞,2,584562,0.00032399,94.69566147
19013,角質層,2,584564,0.00032399,94.69598546
19014,言詞,2,584566,0.00032399,94.69630945
19015,豆,2,584568,0.00032399,94.69663344
19016,豆子,2,584570,0.00032399,94.69695742
19017,豆腐皮,2,584572,0.00032399,94.69728141
19018,豆類,2,584574,0.00032399,94.69760540
19019,貝珠仁波切,2,584576,0.00032399,94.69792939
19020,貝類,2,584578,0.00032399,94.69825338
19021,走下坡,2,584580,0.00032399,94.69857737
19022,走不通,2,584582,0.00032399,94.69890136
19023,走位,2,584584,0.00032399,94.69922534
19024,走走,2,584586,0.00032399,94.69954933
19025,走馬上任,2,584588,0.00032399,94.69987332
19026,走掉,2,584590,0.00032399,94.70019731
19027,走軟,2,584592,0.00032399,94.70052130
19028,走跌,2,584594,0.00032399,94.70084529
19029,足以,2,584596,0.00032399,94.70116927
19030,足助町,2,584598,0.00032399,94.70149326
19031,足球賽,2,584600,0.00032399,94.70181725
19032,身家調查,2,584602,0.00032399,94.70214124
19033,車水馬龍,2,584604,0.00032399,94.70246523
19034,車市,2,584606,0.00032399,94.70278922
19035,車次,2,584608,0.00032399,94.70311320
19036,車尾,2,584610,0.00032399,94.70343719
19037,車流,2,584612,0.00032399,94.70376118
19038,車側,2,584614,0.00032399,94.70408517
19039,車殼,2,584616,0.00032399,94.70440916
19040,車牌號碼,2,584618,0.00032399,94.70473315
19041,車鼓,2,584620,0.00032399,94.70505714
19042,車寬,2,584622,0.00032399,94.70538112
19043,車諾比爾核能電廠,2,584624,0.00032399,94.70570511
19044,車篷,2,584626,0.00032399,94.70602910
19045,車籍資料,2,584628,0.00032399,94.70635309
19046,辛亥革命,2,584630,0.00032399,94.70667708
19047,辛辛那提大眾管弦樂團,2,584632,0.00032399,94.70700107
19048,辛酸,2,584634,0.00032399,94.70732505
19049,迂迴,2,584636,0.00032399,94.70764904
19050,巡,2,584638,0.00032399,94.70797303
19051,巡防,2,584640,0.00032399,94.70829702
19052,巡官,2,584642,0.00032399,94.70862101
19053,巡航,2,584644,0.00032399,94.70894500
19054,巡禮,2,584646,0.00032399,94.70926898
19055,邦主,2,584648,0.00032399,94.70959297
19056,邦國,2,584650,0.00032399,94.70991696
19057,里民,2,584652,0.00032399,94.71024095
19058,里察森,2,584654,0.00032399,94.71056494
19059,防火建材,2,584656,0.00032399,94.71088893
19060,防制,2,584658,0.00032399,94.71121292
19061,防洪,2,584660,0.00032399,94.71153690
19062,防務,2,584662,0.00032399,94.71186089
19063,防腐劑,2,584664,0.00032399,94.71218488
19064,防彈,2,584666,0.00032399,94.71250887
19065,防震,2,584668,0.00032399,94.71283286
19066,防禦力,2,584670,0.00032399,94.71315685
19067,防禦率,2,584672,0.00032399,94.71348083
19068,防禦率王,2,584674,0.00032399,94.71380482
19069,防護員,2,584676,0.00032399,94.71412881
19070,阮正霖,2,584678,0.00032399,94.71445280
19071,阱,2,584680,0.00032399,94.71477679
19072,並列,2,584682,0.00032399,94.71510078
19073,並存,2,584684,0.00032399,94.71542476
19074,並聯,2,584686,0.00032399,94.71574875
19075,乖乖牌,2,584688,0.00032399,94.71607274
19076,乳,2,584690,0.00032399,94.71639673
19077,乳液,2,584692,0.00032399,94.71672072
19078,乳酪屋,2,584694,0.00032399,94.71704471
19079,乳酸飲料,2,584696,0.00032399,94.71736870
19080,乳齒象,2,584698,0.00032399,94.71769268
19081,乳糖,2,584700,0.00032399,94.71801667
19082,事跡,2,584702,0.00032399,94.71834066
19083,事變,2,584704,0.00032399,94.71866465
19084,些微,2,584706,0.00032399,94.71898864
19085,亞太股市,2,584708,0.00032399,94.71931263
19086,亞太銀行,2,584710,0.00032399,94.71963661
19087,亞伯拉罕,2,584712,0.00032399,94.71996060
19088,亞洲信託投資公司,2,584714,0.00032399,94.72028459
19089,亞洲盃,2,584716,0.00032399,94.72060858
19090,亞娟,2,584718,0.00032399,94.72093257
19091,亞特蘭提斯,2,584720,0.00032399,94.72125656
19092,亞培大藥廠,2,584722,0.00032399,94.72158055
19093,亞瑟,2,584724,0.00032399,94.72190453
19094,亞運,2,584726,0.00032399,94.72222852
19095,亞種,2,584728,0.00032399,94.72255251
19096,亞德,2,584730,0.00032399,94.72287650
19097,亞熱帶,2,584732,0.00032399,94.72320049
19098,亞歷山大,2,584734,0.00032399,94.72352448
19099,享樂,2,584736,0.00032399,94.72384846
19100,享譽,2,584738,0.00032399,94.72417245
19101,京,2,584740,0.00032399,94.72449644
19102,京華,2,584742,0.00032399,94.72482043
19103,佯稱,2,584744,0.00032399,94.72514442
19104,依存,2,584746,0.00032399,94.72546841
19105,依附,2,584748,0.00032399,94.72579239
19106,依稀,2,584750,0.00032399,94.72611638
19107,佳士得,2,584752,0.00032399,94.72644037
19108,佳境,2,584754,0.00032399,94.72676436
19109,使用介面,2,584756,0.00032399,94.72708835
19110,使用者介面,2,584758,0.00032399,94.72741234
19111,使勁,2,584760,0.00032399,94.72773633
19112,使領館,2,584762,0.00032399,94.72806031
19113,供水量,2,584764,0.00032399,94.72838430
19114,供桌,2,584766,0.00032399,94.72870829
19115,供貨,2,584768,0.00032399,94.72903228
19116,供給量,2,584770,0.00032399,94.72935627
19117,供過於求,2,584772,0.00032399,94.72968026
19118,供電,2,584774,0.00032399,94.73000424
19119,供需失調,2,584776,0.00032399,94.73032823
19120,供應量,2,584778,0.00032399,94.73065222
19121,例行性,2,584780,0.00032399,94.73097621
19122,來去,2,584782,0.00032399,94.73130020
19123,來信,2,584784,0.00032399,94.73162419
19124,侃侃而談,2,584786,0.00032399,94.73194817
19125,併排,2,584788,0.00032399,94.73227216
19126,侏羅紀公園,2,584790,0.00032399,94.73259615
19127,兒時,2,584792,0.00032399,94.73292014
19128,兩地,2,584794,0.00032399,94.73324413
19129,兩造,2,584796,0.00032399,94.73356812
19130,兩棲類,2,584798,0.00032399,94.73389211
19131,兩極化,2,584800,0.00032399,94.73421609
19132,兩樣,2,584802,0.00032399,94.73454008
19133,兩難,2,584804,0.00032399,94.73486407
19134,具狀,2,584806,0.00032399,94.73518806
19135,典藏品,2,584808,0.00032399,94.73551205
19136,典藏級,2,584810,0.00032399,94.73583604
19137,函文,2,584812,0.00032399,94.73616002
19138,函數,2,584814,0.00032399,94.73648401
19139,刻石,2,584816,0.00032399,94.73680800
19140,券,2,584818,0.00032399,94.73713199
19141,刷洗,2,584820,0.00032399,94.73745598
19142,刷掉,2,584822,0.00032399,94.73777997
19143,刷新,2,584824,0.00032399,94.73810395
19144,刺痛,2,584826,0.00032399,94.73842794
19145,刺激性,2,584828,0.00032399,94.73875193
19146,到校,2,584830,0.00032399,94.73907592
19147,到訪,2,584832,0.00032399,94.73939991
19148,刮刀,2,584834,0.00032399,94.73972390
19149,制服警察,2,584836,0.00032399,94.74004789
19150,制度化,2,584838,0.00032399,94.74037187
19151,制約,2,584840,0.00032399,94.74069586
19152,制高點,2,584842,0.00032399,94.74101985
19153,剁,2,584844,0.00032399,94.74134384
19154,卒,2,584846,0.00032399,94.74166783
19155,協同,2,584848,0.00032399,94.74199182
19156,協議書,2,584850,0.00032399,94.74231580
19157,卓莫,2,584852,0.00032399,94.74263979
19158,卓然,2,584854,0.00032399,94.74296378
19159,卦,2,584856,0.00032399,94.74328777
19160,卷曲,2,584858,0.00032399,94.74361176
19161,卸任,2,584860,0.00032399,94.74393575
19162,卸眼品,2,584862,0.00032399,94.74425973
19163,取用,2,584864,0.00032399,94.74458372
19164,取樣,2,584866,0.00032399,94.74490771
19165,叔,2,584868,0.00032399,94.74523170
19166,叔公,2,584870,0.00032399,94.74555569
19167,叔姪,2,584872,0.00032399,94.74587968
19168,受孕率,2,584874,0.00032399,94.74620367
19169,受益者,2,584876,0.00032399,94.74652765
19170,受測者,2,584878,0.00032399,94.74685164
19171,受雇者,2,584880,0.00032399,94.74717563
19172,受罪,2,584882,0.00032399,94.74749962
19173,受精,2,584884,0.00032399,94.74782361
19174,受邀,2,584886,0.00032399,94.74814760
19175,受難者,2,584888,0.00032399,94.74847158
19176,咖哩雞,2,584890,0.00032399,94.74879557
19177,咖啡油,2,584892,0.00032399,94.74911956
19178,咖啡精,2,584894,0.00032399,94.74944355
19179,咀嚼,2,584896,0.00032399,94.74976754
19180,呼出,2,584898,0.00032399,94.75009153
19181,呼氣,2,584900,0.00032399,94.75041552
19182,呼喊,2,584902,0.00032399,94.75073950
19183,呼喚,2,584904,0.00032399,94.75106349
19184,和平東路,2,584906,0.00032399,94.75138748
19185,和平高中,2,584908,0.00032399,94.75171147
19186,和氣,2,584910,0.00032399,94.75203546
19187,和記黃埔集團,2,584912,0.00032399,94.75235945
19188,和善,2,584914,0.00032399,94.75268343
19189,和藹,2,584916,0.00032399,94.75300742
19190,周三,2,584918,0.00032399,94.75333141
19191,周五,2,584920,0.00032399,94.75365540
19192,周公,2,584922,0.00032399,94.75397939
19193,周伯倫,2,584924,0.00032399,94.75430338
19194,周志銘,2,584926,0.00032399,94.75462736
19195,周秀月,2,584928,0.00032399,94.75495135
19196,周恩來,2,584930,0.00032399,94.75527534
19197,周勝考,2,584932,0.00032399,94.75559933
19198,周雅淑,2,584934,0.00032399,94.75592332
19199,周賜海,2,584936,0.00032399,94.75624731
19200,周燦德,2,584938,0.00032399,94.75657130
19201,周轉,2,584940,0.00032399,94.75689528
19202,周嚴,2,584942,0.00032399,94.75721927
19203,咋舌,2,584944,0.00032399,94.75754326
19204,命脈,2,584946,0.00032399,94.75786725
19205,命喪,2,584948,0.00032399,94.75819124
19206,咎,2,584950,0.00032399,94.75851523
19207,咎由自取,2,584952,0.00032399,94.75883921
19208,固定式,2,584954,0.00032399,94.75916320
19209,固票,2,584956,0.00032399,94.75948719
19210,垃圾桶,2,584958,0.00032399,94.75981118
19211,垃圾袋,2,584960,0.00032399,94.76013517
19212,垃圾量,2,584962,0.00032399,94.76045916
19213,坪林隧道,2,584964,0.00032399,94.76078314
19214,坩鍋,2,584966,0.00032399,94.76110713
19215,坦克車,2,584968,0.00032399,94.76143112
19216,夜市,2,584970,0.00032399,94.76175511
19217,夜生活,2,584972,0.00032399,94.76207910
19218,夜色,2,584974,0.00032399,94.76240309
19219,奉行,2,584976,0.00032399,94.76272708
19220,奉祀,2,584978,0.00032399,94.76305106
19221,奇形怪狀,2,584980,0.00032399,94.76337505
19222,奇效,2,584982,0.00032399,94.76369904
19223,奇格,2,584984,0.00032399,94.76402303
19224,奇觀,2,584986,0.00032399,94.76434702
19225,奈,2,584988,0.00032399,94.76467101
19226,奈邁阿,2,584990,0.00032399,94.76499499
19227,奔波,2,584992,0.00032399,94.76531898
19228,委請,2,584994,0.00032399,94.76564297
19229,妮可,2,584996,0.00032399,94.76596696
19230,妮姬,2,584998,0.00032399,94.76629095
19231,姑且,2,585000,0.00032399,94.76661494
19232,姑息養奸,2,585002,0.00032399,94.76693892
19233,姐夫,2,585004,0.00032399,94.76726291
19234,姐妹,2,585006,0.00032399,94.76758690
19235,姍,2,585008,0.00032399,94.76791089
19236,始料未及,2,585010,0.00032399,94.76823488
19237,姓氏,2,585012,0.00032399,94.76855887
19238,妯娌,2,585014,0.00032399,94.76888286
19239,妳是我今生的新娘,2,585016,0.00032399,94.76920684
19240,孟獲,2,585018,0.00032399,94.76953083
19241,孤立無援,2,585020,0.00032399,94.76985482
19242,季辛吉,2,585022,0.00032399,94.77017881
19243,定力,2,585024,0.00032399,94.77050280
19244,定存單,2,585026,0.00032399,94.77082679
19245,定音鼓,2,585028,0.00032399,94.77115077
19246,定做,2,585030,0.00032399,94.77147476
19247,定國,2,585032,0.00032399,94.77179875
19248,定理,2,585034,0.00032399,94.77212274
19249,定額,2,585036,0.00032399,94.77244673
19250,官府,2,585038,0.00032399,94.77277072
19251,官商勾結,2,585040,0.00032399,94.77309471
19252,官場,2,585042,0.00032399,94.77341869
19253,宜蘭市人,2,585044,0.00032399,94.77374268
19254,宛,2,585046,0.00032399,94.77406667
19255,尚方寶劍,2,585048,0.00032399,94.77439066
19256,尚能,2,585050,0.00032399,94.77471465
19257,尚德,2,585052,0.00032399,94.77503864
19258,尚毅夫,2,585054,0.00032399,94.77536262
19259,居功厥偉,2,585056,0.00032399,94.77568661
19260,居任,2,585058,0.00032399,94.77601060
19261,居安思危,2,585060,0.00032399,94.77633459
19262,居次,2,585062,0.00032399,94.77665858
19263,居留,2,585064,0.00032399,94.77698257
19264,岸上,2,585066,0.00032399,94.77730655
19265,岩,2,585068,0.00032399,94.77763054
19266,帕華洛帝,2,585070,0.00032399,94.77795453
19267,帕爾,2,585072,0.00032399,94.77827852
19268,幸運地,2,585074,0.00032399,94.77860251
19269,店主,2,585076,0.00032399,94.77892650
19270,府城,2,585078,0.00032399,94.77925049
19271,底片感度設定裝置,2,585080,0.00032399,94.77957447
19272,底定,2,585082,0.00032399,94.77989846
19273,底漆,2,585084,0.00032399,94.78022245
19274,延至,2,585086,0.00032399,94.78054644
19275,延伸航權,2,585088,0.00032399,94.78087043
19276,延會,2,585090,0.00032399,94.78119442
19277,延穎實業,2,585092,0.00032399,94.78151840
19278,往下,2,585094,0.00032399,94.78184239
19279,往生,2,585096,0.00032399,94.78216638
19280,往常,2,585098,0.00032399,94.78249037
19281,忠,2,585100,0.00032399,94.78281436
19282,忠姊路,2,585102,0.00032399,94.78313835
19283,怪手,2,585104,0.00032399,94.78346233
19284,怪怪,2,585106,0.00032399,94.78378632
19285,怪罪,2,585108,0.00032399,94.78411031
19286,怡人,2,585110,0.00032399,94.78443430
19287,怡仁醫院,2,585112,0.00032399,94.78475829
19288,怡和物業不動產顧問公司,2,585114,0.00032399,94.78508228
19289,怡富,2,585116,0.00032399,94.78540627
19290,怡富忍者,2,585118,0.00032399,94.78573025
19291,怡富投顧公司,2,585120,0.00032399,94.78605424
19292,怡富證券,2,585122,0.00032399,94.78637823
19293,性幻想,2,585124,0.00032399,94.78670222
19294,性伴侶,2,585126,0.00032399,94.78702621
19295,性侵害,2,585128,0.00032399,94.78735020
19296,性無能,2,585130,0.00032399,94.78767418
19297,性愛,2,585132,0.00032399,94.78799817
19298,房地產業,2,585134,0.00032399,94.78832216
19299,房東,2,585136,0.00032399,94.78864615
19300,房金炎,2,585138,0.00032399,94.78897014
19301,所有人,2,585140,0.00032399,94.78929413
19302,所有權,2,585142,0.00032399,94.78961811
19303,所有權人,2,585144,0.00032399,94.78994210
19304,所作所為,2,585146,0.00032399,94.79026609
19305,所到之處,2,585148,0.00032399,94.79059008
19306,所為,2,585150,0.00032399,94.79091407
19307,所要,2,585152,0.00032399,94.79123806
19308,所得稅法,2,585154,0.00032399,94.79156205
19309,所需,2,585156,0.00032399,94.79188603
19310,承包,2,585158,0.00032399,94.79221002
19311,承保對象,2,585160,0.00032399,94.79253401
19312,承銷商,2,585162,0.00032399,94.79285800
19313,承購,2,585164,0.00032399,94.79318199
19314,拉丁文,2,585166,0.00032399,94.79350598
19315,拉大,2,585168,0.00032399,94.79382996
19316,拉出,2,585170,0.00032399,94.79415395
19317,拉回,2,585172,0.00032399,94.79447794
19318,拉拔,2,585174,0.00032399,94.79480193
19319,拉都希氏蛙,2,585176,0.00032399,94.79512592
19320,拉傷,2,585178,0.00032399,94.79544991
19321,拄,2,585180,0.00032399,94.79577389
19322,抹殺,2,585182,0.00032399,94.79609788
19323,抹黑,2,585184,0.00032399,94.79642187
19324,抹滅,2,585186,0.00032399,94.79674586
19325,招引,2,585188,0.00032399,94.79706985
19326,招收,2,585190,0.00032399,94.79739384
19327,招待所,2,585192,0.00032399,94.79771783
19328,招徠,2,585194,0.00032399,94.79804181
19329,招牌菜,2,585196,0.00032399,94.79836580
19330,招開,2,585198,0.00032399,94.79868979
19331,招數,2,585200,0.00032399,94.79901378
19332,披索,2,585202,0.00032399,94.79933777
19333,披荊斬棘,2,585204,0.00032399,94.79966176
19334,拓荒,2,585206,0.00032399,94.79998574
19335,拓荒者,2,585208,0.00032399,94.80030973
19336,拓銷團,2,585210,0.00032399,94.80063372
19337,拔河,2,585212,0.00032399,94.80095771
19338,拔腿,2,585214,0.00032399,94.80128170
19339,拋,2,585216,0.00032399,94.80160569
19340,拋出,2,585218,0.00032399,94.80192968
19341,拋售,2,585220,0.00032399,94.80225366
19342,抽出,2,585222,0.00032399,94.80257765
19343,抽空,2,585224,0.00032399,94.80290164
19344,抽筋,2,585226,0.00032399,94.80322563
19345,抽煙,2,585228,0.00032399,94.80354962
19346,抽樣,2,585230,0.00032399,94.80387361
19347,抽檢,2,585232,0.00032399,94.80419759
19348,抽籤,2,585234,0.00032399,94.80452158
19349,押金,2,585236,0.00032399,94.80484557
19350,拐,2,585238,0.00032399,94.80516956
19351,拙劣,2,585240,0.00032399,94.80549355
19352,拍下,2,585242,0.00032399,94.80581754
19353,拍片,2,585244,0.00032399,94.80614152
19354,拍定人,2,585246,0.00032399,94.80646551
19355,拍場,2,585248,0.00032399,94.80678950
19356,拍賣物,2,585250,0.00032399,94.80711349
19357,拍檔,2,585252,0.00032399,94.80743748
19358,抵銷,2,585254,0.00032399,94.80776147
19359,抱歉,2,585256,0.00032399,94.80808546
19360,拖曳,2,585258,0.00032399,94.80840944
19361,拖長,2,585260,0.00032399,94.80873343
19362,拖垮,2,585262,0.00032399,94.80905742
19363,拖鞋,2,585264,0.00032399,94.80938141
19364,拆款利率,2,585266,0.00032399,94.80970540
19365,抬高,2,585268,0.00032399,94.81002939
19366,抬轎,2,585270,0.00032399,94.81035337
19367,放大鏡,2,585272,0.00032399,94.81067736
19368,放手,2,585274,0.00032399,94.81100135
19369,放任,2,585276,0.00032399,94.81132534
19370,放回,2,585278,0.00032399,94.81164933
19371,放牧,2,585280,0.00032399,94.81197332
19372,放哨,2,585282,0.00032399,94.81229730
19373,放砲,2,585284,0.00032399,94.81262129
19374,放慢,2,585286,0.00032399,94.81294528
19375,放榜,2,585288,0.00032399,94.81326927
19376,放鞭炮,2,585290,0.00032399,94.81359326
19377,易燃物,2,585292,0.00032399,94.81391725
19378,昆蟲,2,585294,0.00032399,94.81424124
19379,昂首,2,585296,0.00032399,94.81456522
19380,明文,2,585298,0.00032399,94.81488921
19381,明日,2,585300,0.00032399,94.81521320
19382,明光,2,585302,0.00032399,94.81553719
19383,明快,2,585304,0.00032399,94.81586118
19384,明倫高中,2,585306,0.00032399,94.81618517
19385,明朗,2,585308,0.00032399,94.81650915
19386,明朗化,2,585310,0.00032399,94.81683314
19387,明牌,2,585312,0.00032399,94.81715713
19388,明辨,2,585314,0.00032399,94.81748112
19389,明曜百貨,2,585316,0.00032399,94.81780511
19390,昇降台,2,585318,0.00032399,94.81812910
19391,昇起,2,585320,0.00032399,94.81845308
19392,昇陽聯盟,2,585322,0.00032399,94.81877707
19393,服務員,2,585324,0.00032399,94.81910106
19394,服貼,2,585326,0.00032399,94.81942505
19395,服藥,2,585328,0.00032399,94.81974904
19396,枋寮火車站,2,585330,0.00032399,94.82007303
19397,枕頭,2,585332,0.00032399,94.82039702
19398,東山再起,2,585334,0.00032399,94.82072100
19399,東方日報,2,585336,0.00032399,94.82104499
19400,東北角,2,585338,0.00032399,94.82136898
19401,東母區,2,585340,0.00032399,94.82169297
19402,東吉,2,585342,0.00032399,94.82201696
19403,東年,2,585344,0.00032399,94.82234095
19404,東京影展,2,585346,0.00032399,94.82266493
19405,東東,2,585348,0.00032399,94.82298892
19406,東芝,2,585350,0.00032399,94.82331291
19407,東非,2,585352,0.00032399,94.82363690
19408,東帝士百貨,2,585354,0.00032399,94.82396089
19409,東映,2,585356,0.00032399,94.82428488
19410,東洋,2,585358,0.00032399,94.82460886
19411,東香里,2,585360,0.00032399,94.82493285
19412,東海企研所,2,585362,0.00032399,94.82525684
19413,東側,2,585364,0.00032399,94.82558083
19414,東區職訓中心,2,585366,0.00032399,94.82590482
19415,東湖,2,585368,0.00032399,94.82622881
19416,東窗事發,2,585370,0.00032399,94.82655280
19417,東陽,2,585372,0.00032399,94.82687678
19418,東勢,2,585374,0.00032399,94.82720077
19419,東澳,2,585376,0.00032399,94.82752476
19420,東聯,2,585378,0.00032399,94.82784875
19421,東瀛,2,585380,0.00032399,94.82817274
19422,果汁,2,585382,0.00032399,94.82849673
19423,果決,2,585384,0.00032399,94.82882071
19424,果陀劇場,2,585386,0.00032399,94.82914470
19425,果陀劇團,2,585388,0.00032399,94.82946869
19426,果真如此,2,585390,0.00032399,94.82979268
19427,果報,2,585392,0.00032399,94.83011667
19428,果菜承銷人自治會,2,585394,0.00032399,94.83044066
19429,果園,2,585396,0.00032399,94.83076465
19430,果樹,2,585398,0.00032399,94.83108863
19431,果樹園,2,585400,0.00032399,94.83141262
19432,果斷,2,585402,0.00032399,94.83173661
19433,枝葉,2,585404,0.00032399,94.83206060
19434,林中偉,2,585406,0.00032399,94.83238459
19435,林仁龍,2,585408,0.00032399,94.83270858
19436,林文定,2,585410,0.00032399,94.83303256
19437,林文賢,2,585412,0.00032399,94.83335655
19438,林孝義,2,585414,0.00032399,94.83368054
19439,林宏文,2,585416,0.00032399,94.83400453
19440,林志祥,2,585418,0.00032399,94.83432852
19441,林秀美,2,585420,0.00032399,94.83465251
19442,林秀茂,2,585422,0.00032399,94.83497649
19443,林良實,2,585424,0.00032399,94.83530048
19444,林姆斯基,2,585426,0.00032399,94.83562447
19445,林宗勇,2,585428,0.00032399,94.83594846
19446,林松益,2,585430,0.00032399,94.83627245
19447,林長茂,2,585432,0.00032399,94.83659644
19448,林俊傑,2,585434,0.00032399,94.83692043
19449,林俊義,2,585436,0.00032399,94.83724441
19450,林建輝,2,585438,0.00032399,94.83756840
19451,林韋辰,2,585440,0.00032399,94.83789239
19452,林振輝,2,585442,0.00032399,94.83821638
19453,林浚南,2,585444,0.00032399,94.83854037
19454,林梓聯,2,585446,0.00032399,94.83886436
19455,林惠理,2,585448,0.00032399,94.83918834
19456,林源山,2,585450,0.00032399,94.83951233
19457,林瑜文,2,585452,0.00032399,94.83983632
19458,林萬春,2,585454,0.00032399,94.84016031
19459,林壽宏,2,585456,0.00032399,94.84048430
19460,林錦清,2,585458,0.00032399,94.84080829
19461,林鴻道,2,585460,0.00032399,94.84113227
19462,林懷民,2,585462,0.00032399,94.84145626
19463,林邊農,2,585464,0.00032399,94.84178025
19464,杯子,2,585466,0.00032399,94.84210424
19465,板屋,2,585468,0.00032399,94.84242823
19466,板橋高中,2,585470,0.00032399,94.84275222
19467,松下,2,585472,0.00032399,94.84307621
19468,松山高中,2,585474,0.00032399,94.84340019
19469,析,2,585476,0.00032399,94.84372418
19470,武官,2,585478,0.00032399,94.84404817
19471,武俠漫畫,2,585480,0.00032399,94.84437216
19472,武陵農場,2,585482,0.00032399,94.84469615
19473,武漢,2,585484,0.00032399,94.84502014
19474,注音,2,585486,0.00032399,94.84534412
19475,泌尿科,2,585488,0.00032399,94.84566811
19476,泌尿道,2,585490,0.00032399,94.84599210
19477,泌乳,2,585492,0.00032399,94.84631609
19478,泥沼,2,585494,0.00032399,94.84664008
19479,河口,2,585496,0.00032399,94.84696407
19480,河口鱷,2,585498,0.00032399,94.84728805
19481,河內,2,585500,0.00032399,94.84761204
19482,河水,2,585502,0.00032399,94.84793603
19483,河谷,2,585504,0.00032399,94.84826002
19484,河豚肉,2,585506,0.00032399,94.84858401
19485,沾取,2,585508,0.00032399,94.84890800
19486,波札那,2,585510,0.00032399,94.84923199
19487,波音,2,585512,0.00032399,94.84955597
19488,波浪的還原,2,585514,0.00032399,94.84987996
19489,波馬利,2,585516,0.00032399,94.85020395
19490,波瀾,2,585518,0.00032399,94.85052794
19491,法式,2,585520,0.00032399,94.85085193
19492,法老王,2,585522,0.00032399,94.85117592
19493,法身,2,585524,0.00032399,94.85149990
19494,法事,2,585526,0.00032399,94.85182389
19495,法制單位,2,585528,0.00032399,94.85214788
19496,法郎,2,585530,0.00032399,94.85247187
19497,法國政府,2,585532,0.00032399,94.85279586
19498,法國餐,2,585534,0.00032399,94.85311985
19499,法條,2,585536,0.00032399,94.85344383
19500,法網遊龍,2,585538,0.00032399,94.85376782
19501,法蘭克,2,585540,0.00032399,94.85409181
19502,泓,2,585542,0.00032399,94.85441580
19503,油脂費,2,585544,0.00032399,94.85473979
19504,油菜,2,585546,0.00032399,94.85506378
19505,油質,2,585548,0.00032399,94.85538777
19506,油壓,2,585550,0.00032399,94.85571175
19507,油類,2,585552,0.00032399,94.85603574
19508,泱泱,2,585554,0.00032399,94.85635973
19509,治港,2,585556,0.00032399,94.85668372
19510,治績,2,585558,0.00032399,94.85700771
19511,泡妞專家,2,585560,0.00032399,94.85733170
19512,泡沫,2,585562,0.00032399,94.85765568
19513,泡麵,2,585564,0.00032399,94.85797967
19514,泯滅,2,585566,0.00032399,94.85830366
19515,炒魷魚,2,585568,0.00032399,94.85862765
19516,爬行動物,2,585570,0.00032399,94.85895164
19517,爬進,2,585572,0.00032399,94.85927563
19518,爬樹,2,585574,0.00032399,94.85959962
19519,爭戰,2,585576,0.00032399,94.85992360
19520,爸媽,2,585578,0.00032399,94.86024759
19521,版位,2,585580,0.00032399,94.86057158
19522,牧牛,2,585582,0.00032399,94.86089557
19523,物力,2,585584,0.00032399,94.86121956
19524,物化,2,585586,0.00032399,94.86154355
19525,物件導向技術,2,585588,0.00032399,94.86186753
19526,物色,2,585590,0.00032399,94.86219152
19527,物美,2,585592,0.00032399,94.86251551
19528,物價指數,2,585594,0.00032399,94.86283950
19529,狙殺,2,585596,0.00032399,94.86316349
19530,狗娃,2,585598,0.00032399,94.86348748
19531,狗屎,2,585600,0.00032399,94.86381146
19532,玩石,2,585602,0.00032399,94.86413545
19533,玩伴,2,585604,0.00032399,94.86445944
19534,玩玩,2,585606,0.00032399,94.86478343
19535,玫瑰石,2,585608,0.00032399,94.86510742
19536,直奔,2,585610,0.00032399,94.86543141
19537,直航,2,585612,0.00032399,94.86575540
19538,直接了當,2,585614,0.00032399,94.86607938
19539,直筒褲,2,585616,0.00032399,94.86640337
19540,直腸癌,2,585618,0.00032399,94.86672736
19541,直轄市,2,585620,0.00032399,94.86705135
19542,知見,2,585622,0.00032399,94.86737534
19543,知易行難,2,585624,0.00032399,94.86769933
19544,知法,2,585626,0.00032399,94.86802331
19545,知會,2,585628,0.00032399,94.86834730
19546,矽砂,2,585630,0.00032399,94.86867129
19547,社會人士,2,585632,0.00032399,94.86899528
19548,社會局長,2,585634,0.00032399,94.86931927
19549,社會處長,2,585636,0.00032399,94.86964326
19550,社會學,2,585638,0.00032399,94.86996724
19551,社論,2,585640,0.00032399,94.87029123
19552,秉,2,585642,0.00032399,94.87061522
19553,空中巴士,2,585644,0.00032399,94.87093921
19554,空姐,2,585646,0.00032399,94.87126320
19555,空空蕩蕩,2,585648,0.00032399,94.87158719
19556,空屋,2,585650,0.00032399,94.87191118
19557,空虛,2,585652,0.00032399,94.87223516
19558,肺,2,585654,0.00032399,94.87255915
19559,肺泡,2,585656,0.00032399,94.87288314
19560,肺炎雙球菌,2,585658,0.00032399,94.87320713
19561,肺結核,2,585660,0.00032399,94.87353112
19562,肥沃,2,585662,0.00032399,94.87385511
19563,肥皂粉,2,585664,0.00032399,94.87417909
19564,肥美,2,585666,0.00032399,94.87450308
19565,肥料,2,585668,0.00032399,94.87482707
19566,肢,2,585670,0.00032399,94.87515106
19567,股性,2,585672,0.00032399,94.87547505
19568,股息,2,585674,0.00032399,94.87579904
19569,股票市場,2,585676,0.00032399,94.87612302
19570,肩負,2,585678,0.00032399,94.87644701
19571,肯辛頓,2,585680,0.00032399,94.87677100
19572,芝麻,2,585682,0.00032399,94.87709499
19573,芭蕾舞,2,585684,0.00032399,94.87741898
19574,花木,2,585686,0.00032399,94.87774297
19575,花兒,2,585688,0.00032399,94.87806696
19576,花俏,2,585690,0.00032399,94.87839094
19577,花奏,2,585692,0.00032399,94.87871493
19578,花掉,2,585694,0.00032399,94.87903892
19579,花期,2,585696,0.00032399,94.87936291
19580,花絮,2,585698,0.00032399,94.87968690
19581,花腔,2,585700,0.00032399,94.88001089
19582,花椰菜,2,585702,0.00032399,94.88033487
19583,花燈,2,585704,0.00032399,94.88065886
19584,花臉,2,585706,0.00032399,94.88098285
19585,花瓣,2,585708,0.00032399,94.88130684
19586,花藝秀,2,585710,0.00032399,94.88163083
19587,芬蘭,2,585712,0.00032399,94.88195482
19588,虎皮,2,585714,0.00032399,94.88227880
19589,虎尾鎮,2,585716,0.00032399,94.88260279
19590,虎虎生風,2,585718,0.00032399,94.88292678
19591,虎視眈眈,2,585720,0.00032399,94.88325077
19592,虎德山,2,585722,0.00032399,94.88357476
19593,初次,2,585724,0.00032399,94.88389875
19594,初吻,2,585726,0.00032399,94.88422274
19595,初審,2,585728,0.00032399,94.88454672
19596,表白,2,585730,0.00032399,94.88487071
19597,表皮,2,585732,0.00032399,94.88519470
19598,表弟,2,585734,0.00032399,94.88551869
19599,表帶,2,585736,0.00032399,94.88584268
19600,表演課,2,585738,0.00032399,94.88616667
19601,表露,2,585740,0.00032399,94.88649065
19602,迎賓區,2,585742,0.00032399,94.88681464
19603,迎請,2,585744,0.00032399,94.88713863
19604,迎戰,2,585746,0.00032399,94.88746262
19605,近視眼,2,585748,0.00032399,94.88778661
19606,近距離,2,585750,0.00032399,94.88811060
19607,近親,2,585752,0.00032399,94.88843459
19608,邵氏兄弟公司,2,585754,0.00032399,94.88875857
19609,邱芸子,2,585756,0.00032399,94.88908256
19610,邱金蘭,2,585758,0.00032399,94.88940655
19611,邱垂貞,2,585760,0.00032399,94.88973054
19612,邱茂英,2,585762,0.00032399,94.89005453
19613,邱香蘭,2,585764,0.00032399,94.89037852
19614,邱剛,2,585766,0.00032399,94.89070250
19615,邱淑宜,2,585768,0.00032399,94.89102649
19616,采風,2,585770,0.00032399,94.89135048
19617,金山,2,585772,0.00032399,94.89167447
19618,金石堂,2,585774,0.00032399,94.89199846
19619,金光閃閃,2,585776,0.00032399,94.89232245
19620,金車教育基金會,2,585778,0.00032399,94.89264643
19621,金泳三,2,585780,0.00032399,94.89297042
19622,金門海域,2,585782,0.00032399,94.89329441
19623,金哈克曼,2,585784,0.00032399,94.89361840
19624,金城武,2,585786,0.00032399,94.89394239
19625,金柑,2,585788,0.00032399,94.89426638
19626,金海岸活蝦之家,2,585790,0.00032399,94.89459037
19627,金粉,2,585792,0.00032399,94.89491435
19628,金馬國際影展,2,585794,0.00032399,94.89523834
19629,金馬路,2,585796,0.00032399,94.89556233
19630,金華火腿,2,585798,0.00032399,94.89588632
19631,金飯碗,2,585800,0.00032399,94.89621031
19632,金黃,2,585802,0.00032399,94.89653430
19633,金獅啤酒,2,585804,0.00032399,94.89685828
19634,金髮,2,585806,0.00032399,94.89718227
19635,金融分析師,2,585808,0.00032399,94.89750626
19636,金融卡,2,585810,0.00032399,94.89783025
19637,金融界,2,585812,0.00032399,94.89815424
19638,金融風暴,2,585814,0.00032399,94.89847823
19639,金融時報,2,585816,0.00032399,94.89880221
19640,金融機構,2,585818,0.00032399,94.89912620
19641,金融類股,2,585820,0.00032399,94.89945019
19642,金融黨部,2,585822,0.00032399,94.89977418
19643,金龜子,2,585824,0.00032399,94.90009817
19644,金檢,2,585826,0.00032399,94.90042216
19645,金屬片,2,585828,0.00032399,94.90074615
19646,金鶯,2,585830,0.00032399,94.90107013
19647,金權,2,585832,0.00032399,94.90139412
19648,金鷹,2,585834,0.00032399,94.90171811
19649,長人,2,585836,0.00032399,94.90204210
19650,長年,2,585838,0.00032399,94.90236609
19651,長老,2,585840,0.00032399,94.90269008
19652,長足,2,585842,0.00032399,94.90301406
19653,長青學苑,2,585844,0.00032399,94.90333805
19654,長青樹,2,585846,0.00032399,94.90366204
19655,長春路,2,585848,0.00032399,94.90398603
19656,長紅線,2,585850,0.00032399,94.90431002
19657,長航通運,2,585852,0.00032399,94.90463401
19658,長袖,2,585854,0.00032399,94.90495799
19659,長期性,2,585856,0.00032399,94.90528198
19660,長壽菸,2,585858,0.00032399,94.90560597
19661,長榮桂冠酒店,2,585860,0.00032399,94.90592996
19662,長篇,2,585862,0.00032399,94.90625395
19663,長線,2,585864,0.00032399,94.90657794
19664,門把,2,585866,0.00032399,94.90690193
19665,門前,2,585868,0.00032399,94.90722591
19666,門柱,2,585870,0.00032399,94.90754990
19667,門面,2,585872,0.00032399,94.90787389
19668,門鎖,2,585874,0.00032399,94.90819788
19669,阿水,2,585876,0.00032399,94.90852187
19670,阿托欣多,2,585878,0.00032399,94.90884586
19671,阿兵哥,2,585880,0.00032399,94.90916984
19672,阿沙力,2,585882,0.00032399,94.90949383
19673,阿拉伯數字,2,585884,0.00032399,94.90981782
19674,阿枝,2,585886,0.00032399,94.91014181
19675,阿芳,2,585888,0.00032399,94.91046580
19676,阿音,2,585890,0.00032399,94.91078979
19677,阿哥哥,2,585892,0.00032399,94.91111377
19678,阿哥號,2,585894,0.00032399,94.91143776
19679,阿健,2,585896,0.00032399,94.91176175
19680,阿彌陀佛,2,585898,0.00032399,94.91208574
19681,阻絕,2,585900,0.00032399,94.91240973
19682,阻撓,2,585902,0.00032399,94.91273372
19683,阻斷,2,585904,0.00032399,94.91305771
19684,附加卡,2,585906,0.00032399,94.91338169
19685,附加檔案,2,585908,0.00032399,94.91370568
19686,雨天,2,585910,0.00032399,94.91402967
19687,雨衣,2,585912,0.00032399,94.91435366
19688,雨果,2,585914,0.00032399,94.91467765
19689,雨過天晴,2,585916,0.00032399,94.91500164
19690,雨聲,2,585918,0.00032399,94.91532562
19691,青年守則,2,585920,0.00032399,94.91564961
19692,青江菜,2,585922,0.00032399,94.91597360
19693,青苔,2,585924,0.00032399,94.91629759
19694,青草,2,585926,0.00032399,94.91662158
19695,青椒,2,585928,0.00032399,94.91694557
19696,青黃不接,2,585930,0.00032399,94.91726956
19697,青蒜,2,585932,0.00032399,94.91759354
19698,青輔會,2,585934,0.00032399,94.91791753
19699,非比尋常,2,585936,0.00032399,94.91824152
19700,非交錯式,2,585938,0.00032399,94.91856551
19701,非洲大陸,2,585940,0.00032399,94.91888950
19702,非洲鳳仙,2,585942,0.00032399,94.91921349
19703,非病態,2,585944,0.00032399,94.91953747
19704,非揮發性記憶體,2,585946,0.00032399,94.91986146
19705,亮晶晶,2,585948,0.00032399,94.92018545
19706,亮質,2,585950,0.00032399,94.92050944
19707,信用卡中心,2,585952,0.00032399,94.92083343
19708,信用卡戶,2,585954,0.00032399,94.92115742
19709,信用金庫,2,585956,0.00032399,94.92148140
19710,信任度,2,585958,0.00032399,94.92180539
19711,信眾,2,585960,0.00032399,94.92212938
19712,信義,2,585962,0.00032399,94.92245337
19713,信義房屋,2,585964,0.00032399,94.92277736
19714,信義計畫區,2,585966,0.00032399,94.92310135
19715,信誓旦旦,2,585968,0.00032399,94.92342534
19716,侯,2,585970,0.00032399,94.92374932
19717,侯孝賢,2,585972,0.00032399,94.92407331
19718,侯冠群,2,585974,0.00032399,94.92439730
19719,侯欽宗,2,585976,0.00032399,94.92472129
19720,便士,2,585978,0.00032399,94.92504528
19721,便車,2,585980,0.00032399,94.92536927
19722,便溺,2,585982,0.00032399,94.92569325
19723,俏皮,2,585984,0.00032399,94.92601724
19724,保六總隊,2,585986,0.00032399,94.92634123
19725,保存期限,2,585988,0.00032399,94.92666522
19726,保固,2,585990,0.00032399,94.92698921
19727,保單,2,585992,0.00032399,94.92731320
19728,保險費,2,585994,0.00032399,94.92763718
19729,保齡球館,2,585996,0.00032399,94.92796117
19730,俊男,2,585998,0.00032399,94.92828516
19731,俄文,2,586000,0.00032399,94.92860915
19732,俄語,2,586002,0.00032399,94.92893314
19733,俄羅斯共和國,2,586004,0.00032399,94.92925713
19734,俞國基,2,586006,0.00032399,94.92958112
19735,侷囿,2,586008,0.00032399,94.92990510
19736,冒汗,2,586010,0.00032399,94.93022909
19737,冠軍盃,2,586012,0.00032399,94.93055308
19738,剎那間,2,586014,0.00032399,94.93087707
19739,前去,2,586016,0.00032399,94.93120106
19740,前車之鑑,2,586018,0.00032399,94.93152505
19741,前例,2,586020,0.00032399,94.93184903
19742,前前後後,2,586022,0.00032399,94.93217302
19743,前後座,2,586024,0.00032399,94.93249701
19744,前科,2,586026,0.00032399,94.93282100
19745,前移,2,586028,0.00032399,94.93314499
19746,前鋒,2,586030,0.00032399,94.93346898
19747,前頭,2,586032,0.00032399,94.93379296
19748,前瞻,2,586034,0.00032399,94.93411695
19749,前額,2,586036,0.00032399,94.93444094
19750,前襟,2,586038,0.00032399,94.93476493
19751,剋敵,2,586040,0.00032399,94.93508892
19752,勇士,2,586042,0.00032399,94.93541291
19753,勇往直前,2,586044,0.00032399,94.93573690
19754,南斗,2,586046,0.00032399,94.93606088
19755,南瓜,2,586048,0.00032399,94.93638487
19756,南河三星,2,586050,0.00032399,94.93670886
19757,南門派出所,2,586052,0.00032399,94.93703285
19758,南郊,2,586054,0.00032399,94.93735684
19759,南迴鐵路,2,586056,0.00032399,94.93768083
19760,南華路,2,586058,0.00032399,94.93800481
19761,南極,2,586060,0.00032399,94.93832880
19762,南歐,2,586062,0.00032399,94.93865279
19763,南縣,2,586064,0.00032399,94.93897678
19764,南鯤鯓,2,586066,0.00032399,94.93930077
19765,厚道,2,586068,0.00032399,94.93962476
19766,叛逃,2,586070,0.00032399,94.93994874
19767,咬傷,2,586072,0.00032399,94.94027273
19768,哀,2,586074,0.00032399,94.94059672
19769,哀愁,2,586076,0.00032399,94.94092071
19770,哀鴻遍野,2,586078,0.00032399,94.94124470
19771,咨文,2,586080,0.00032399,94.94156869
19772,哉,2,586082,0.00032399,94.94189268
19773,咦,2,586084,0.00032399,94.94221666
19774,咳,2,586086,0.00032399,94.94254065
19775,哇,2,586088,0.00032399,94.94286464
19776,咪咪,2,586090,0.00032399,94.94318863
19777,品德,2,586092,0.00032399,94.94351262
19778,哄,2,586094,0.00032399,94.94383661
19779,哄抬,2,586096,0.00032399,94.94416059
19780,哈,2,586098,0.00032399,94.94448458
19781,哈山,2,586100,0.00032399,94.94480857
19782,哈欠,2,586102,0.00032399,94.94513256
19783,哈哈,2,586104,0.00032399,94.94545655
19784,哈納斯人,2,586106,0.00032399,94.94578054
19785,哈納斯冰川,2,586108,0.00032399,94.94610453
19786,咱,2,586110,0.00032399,94.94642851
19787,咧,2,586112,0.00032399,94.94675250
19788,垂青,2,586114,0.00032399,94.94707649
19789,垂垂老矣,2,586116,0.00032399,94.94740048
19790,城邦,2,586118,0.00032399,94.94772447
19791,城島後樂園,2,586120,0.00032399,94.94804846
19792,契,2,586122,0.00032399,94.94837244
19793,契丹,2,586124,0.00032399,94.94869643
19794,奏鳴曲,2,586126,0.00032399,94.94902042
19795,娃娃臉,2,586128,0.00032399,94.94934441
19796,姚立明,2,586130,0.00032399,94.94966840
19797,威風,2,586132,0.00032399,94.94999239
19798,威斯康辛大學,2,586134,0.00032399,94.95031637
19799,威爾斯,2,586136,0.00032399,94.95064036
19800,威嚴,2,586138,0.00032399,94.95096435
19801,孩,2,586140,0.00032399,94.95128834
19802,宣,2,586142,0.00032399,94.95161233
19803,宣判,2,586144,0.00032399,94.95193632
19804,宣傳照,2,586146,0.00032399,94.95226031
19805,宣戰,2,586148,0.00032399,94.95258429
19806,宣讀,2,586150,0.00032399,94.95290828
19807,室友,2,586152,0.00032399,94.95323227
19808,客戶端,2,586154,0.00032399,94.95355626
19809,客家文化,2,586156,0.00032399,94.95388025
19810,客貨兩用車,2,586158,0.00032399,94.95420424
19811,客棧,2,586160,0.00032399,94.95452822
19812,客籍,2,586162,0.00032399,94.95485221
19813,封王,2,586164,0.00032399,94.95517620
19814,封住,2,586166,0.00032399,94.95550019
19815,封閉型,2,586168,0.00032399,94.95582418
19816,屏,2,586170,0.00032399,94.95614817
19817,屏東技術學院,2,586172,0.00032399,94.95647215
19818,屏東縣長,2,586174,0.00032399,94.95679614
19819,屍首,2,586176,0.00032399,94.95712013
19820,屋內,2,586178,0.00032399,94.95744412
19821,巷口,2,586180,0.00032399,94.95776811
19822,巷弄,2,586182,0.00032399,94.95809210
19823,帝雉,2,586184,0.00032399,94.95841609
19824,幽,2,586186,0.00032399,94.95874007
19825,幽美,2,586188,0.00032399,94.95906406
19826,幽香,2,586190,0.00032399,94.95938805
19827,幽情,2,586192,0.00032399,94.95971204
19828,幽雅,2,586194,0.00032399,94.96003603
19829,幽暗,2,586196,0.00032399,94.96036002
19830,幽靜,2,586198,0.00032399,94.96068400
19831,建功,2,586200,0.00032399,94.96100799
19832,建地,2,586202,0.00032399,94.96133198
19833,建宏,2,586204,0.00032399,94.96165597
19834,建國中學,2,586206,0.00032399,94.96197996
19835,建設公司,2,586208,0.00032399,94.96230395
19836,建管處,2,586210,0.00032399,94.96262793
19837,建蓋,2,586212,0.00032399,94.96295192
19838,建議書,2,586214,0.00032399,94.96327591
19839,待人接物,2,586216,0.00032399,94.96359990
19840,待命,2,586218,0.00032399,94.96392389
19841,待售,2,586220,0.00032399,94.96424788
19842,後人,2,586222,0.00032399,94.96457187
19843,後生,2,586224,0.00032399,94.96489585
19844,後年,2,586226,0.00032399,94.96521984
19845,後援,2,586228,0.00032399,94.96554383
19846,後視鏡,2,586230,0.00032399,94.96586782
19847,後進,2,586232,0.00032399,94.96619181
19848,後勢,2,586234,0.00032399,94.96651580
19849,後製,2,586236,0.00032399,94.96683978
19850,後製作,2,586238,0.00032399,94.96716377
19851,後頭,2,586240,0.00032399,94.96748776
19852,怒火,2,586242,0.00032399,94.96781175
19853,思忖,2,586244,0.00032399,94.96813574
19854,思惟,2,586246,0.00032399,94.96845973
19855,思量,2,586248,0.00032399,94.96878371
19856,思想家,2,586250,0.00032399,94.96910770
19857,思慮,2,586252,0.00032399,94.96943169
19858,急制,2,586254,0.00032399,94.96975568
19859,急制液,2,586256,0.00032399,94.97007967
19860,急流,2,586258,0.00032399,94.97040366
19861,急起直追,2,586260,0.00032399,94.97072765
19862,急診室,2,586262,0.00032399,94.97105163
19863,急需,2,586264,0.00032399,94.97137562
19864,急獨,2,586266,0.00032399,94.97169961
19865,急躁,2,586268,0.00032399,94.97202360
19866,怨天尤人,2,586270,0.00032399,94.97234759
19867,恍惚,2,586272,0.00032399,94.97267158
19868,恰巧,2,586274,0.00032399,94.97299556
19869,恰到好處,2,586276,0.00032399,94.97331955
19870,恰恰,2,586278,0.00032399,94.97364354
19871,恨不得,2,586280,0.00032399,94.97396753
19872,恆,2,586282,0.00032399,94.97429152
19873,恆春,2,586284,0.00032399,94.97461551
19874,恬淡,2,586286,0.00032399,94.97493950
19875,扁平,2,586288,0.00032399,94.97526348
19876,扁桃腺炎,2,586290,0.00032399,94.97558747
19877,扁蝨,2,586292,0.00032399,94.97591146
19878,挖土機,2,586294,0.00032399,94.97623545
19879,按住,2,586296,0.00032399,94.97655944
19880,按時,2,586298,0.00032399,94.97688343
19881,拼湊,2,586300,0.00032399,94.97720741
19882,拭,2,586302,0.00032399,94.97753140
19883,拭目以待,2,586304,0.00032399,94.97785539
19884,持刀,2,586306,0.00032399,94.97817938
19885,持有者,2,586308,0.00032399,94.97850337
19886,持續性,2,586310,0.00032399,94.97882736
19887,指正,2,586312,0.00032399,94.97915134
19888,指指,2,586314,0.00032399,94.97947533
19889,指紋,2,586316,0.00032399,94.97979932
19890,指骨,2,586318,0.00032399,94.98012331
19891,指揮棒,2,586320,0.00032399,94.98044730
19892,指腹,2,586322,0.00032399,94.98077129
19893,括,2,586324,0.00032399,94.98109528
19894,挑水,2,586326,0.00032399,94.98141926
19895,挑戰性,2,586328,0.00032399,94.98174325
19896,政治力,2,586330,0.00032399,94.98206724
19897,政治大學,2,586332,0.00032399,94.98239123
19898,政治性,2,586334,0.00032399,94.98271522
19899,政治險,2,586336,0.00032399,94.98303921
19900,政務次長,2,586338,0.00032399,94.98336319
19901,政務官,2,586340,0.00032399,94.98368718
19902,政敵,2,586342,0.00032399,94.98401117
19903,政績,2,586344,0.00032399,94.98433516
19904,故里,2,586346,0.00032399,94.98465915
19905,故居,2,586348,0.00032399,94.98498314
19906,故宮博物院,2,586350,0.00032399,94.98530712
19907,施受法,2,586352,0.00032399,94.98563111
19908,施肥,2,586354,0.00032399,94.98595510
19909,施暴,2,586356,0.00032399,94.98627909
19910,施燦雄,2,586358,0.00032399,94.98660308
19911,春秋戰國,2,586360,0.00032399,94.98692707
19912,春風化雨,2,586362,0.00032399,94.98725106
19913,昭告,2,586364,0.00032399,94.98757504
19914,映現,2,586366,0.00032399,94.98789903
19915,映像管,2,586368,0.00032399,94.98822302
19916,昧,2,586370,0.00032399,94.98854701
19917,星島,2,586372,0.00032399,94.98887100
19918,星級,2,586374,0.00032399,94.98919499
19919,星際奇兵,2,586376,0.00032399,94.98951897
19920,星艦迷航記,2,586378,0.00032399,94.98984296
19921,染色,2,586380,0.00032399,94.99016695
19922,染缸,2,586382,0.00032399,94.99049094
19923,柱子,2,586384,0.00032399,94.99081493
19924,柔性,2,586386,0.00032399,94.99113892
19925,柔美,2,586388,0.00032399,94.99146290
19926,柔順,2,586390,0.00032399,94.99178689
19927,枯,2,586392,0.00032399,94.99211088
19928,枯黃,2,586394,0.00032399,94.99243487
19929,枯竭,2,586396,0.00032399,94.99275886
19930,柯南,2,586398,0.00032399,94.99308285
19931,柯曼,2,586400,0.00032399,94.99340684
19932,柯雷提昂,2,586402,0.00032399,94.99373082
19933,柯錫杰,2,586404,0.00032399,94.99405481
19934,柄,2,586406,0.00032399,94.99437880
19935,柄部,2,586408,0.00032399,94.99470279
19936,查克,2,586410,0.00032399,94.99502678
19937,查核,2,586412,0.00032399,94.99535077
19938,查理十世,2,586414,0.00032399,94.99567475
19939,查理斯．巴比基,2,586416,0.00032399,94.99599874
19940,查訪,2,586418,0.00032399,94.99632273
19941,查覺,2,586420,0.00032399,94.99664672
19942,柏林國民歌劇院,2,586422,0.00032399,94.99697071
19943,柏頓,2,586424,0.00032399,94.99729470
19944,歪斜,2,586426,0.00032399,94.99761869
19945,殆,2,586428,0.00032399,94.99794267
19946,毒性,2,586430,0.00032399,94.99826666
19947,毒癮,2,586432,0.00032399,94.99859065
19948,泉水,2,586434,0.00032399,94.99891464
19949,洋文,2,586436,0.00032399,94.99923863
19950,洋投,2,586438,0.00032399,94.99956262
19951,洋芋,2,586440,0.00032399,94.99988660
19952,洋蔥盅,2,586442,0.00032399,95.00021059
19953,洪亮宇,2,586444,0.00032399,95.00053458
19954,洪茂俊,2,586446,0.00032399,95.00085857
19955,洪森陵,2,586448,0.00032399,95.00118256
19956,洪瑞河,2,586450,0.00032399,95.00150655
19957,流力學,2,586452,0.00032399,95.00183053
19958,流亡潮,2,586454,0.00032399,95.00215452
19959,流水,2,586456,0.00032399,95.00247851
19960,流行性,2,586458,0.00032399,95.00280250
19961,流行病學,2,586460,0.00032399,95.00312649
19962,流言,2,586462,0.00032399,95.00345048
19963,流放,2,586464,0.00032399,95.00377447
19964,流星,2,586466,0.00032399,95.00409845
19965,流浪漢,2,586468,0.00032399,95.00442244
19966,流連忘返,2,586470,0.00032399,95.00474643
19967,流標,2,586472,0.00032399,95.00507042
19968,流轉,2,586474,0.00032399,95.00539441
19969,洗劑,2,586476,0.00032399,95.00571840
19970,活出,2,586478,0.00032399,95.00604238
19971,活用,2,586480,0.00032399,95.00636637
19972,活動中心,2,586482,0.00032399,95.00669036
19973,活動式,2,586484,0.00032399,95.00701435
19974,活儲,2,586486,0.00032399,95.00733834
19975,洽商,2,586488,0.00032399,95.00766233
19976,派來,2,586490,0.00032399,95.00798631
19977,派員,2,586492,0.00032399,95.00831030
19978,洛曲,2,586494,0.00032399,95.00863429
19979,洛杉磯道奇隊,2,586496,0.00032399,95.00895828
19980,泵,2,586498,0.00032399,95.00928227
19981,炫目,2,586500,0.00032399,95.00960626
19982,炫耀,2,586502,0.00032399,95.00993025
19983,為人,2,586504,0.00032399,95.01025423
19984,為所欲為,2,586506,0.00032399,95.01057822
19985,為甚麼,2,586508,0.00032399,95.01090221
19986,為首,2,586510,0.00032399,95.01122620
19987,炸射,2,586512,0.00032399,95.01155019
19988,炸豬排,2,586514,0.00032399,95.01187418
19989,炸雞,2,586516,0.00032399,95.01219816
19990,牲畜,2,586518,0.00032399,95.01252215
19991,珍,2,586520,0.00032399,95.01284614
19992,珍妮,2,586522,0.00032399,95.01317013
19993,珍品,2,586524,0.00032399,95.01349412
19994,珍珠港事變,2,586526,0.00032399,95.01381811
19995,珍視,2,586528,0.00032399,95.01414209
19996,珍藏筆,2,586530,0.00032399,95.01446608
19997,甚少,2,586532,0.00032399,95.01479007
19998,畏懼,2,586534,0.00032399,95.01511406
19999,疫,2,586536,0.00032399,95.01543805
20000,皆大歡喜,2,586538,0.00032399,95.01576204
20001,皇,2,586540,0.00032399,95.01608603
20002,盈虧,2,586542,0.00032399,95.01641001
20003,盆子,2,586544,0.00032399,95.01673400
20004,省力化,2,586546,0.00032399,95.01705799
20005,省水利局,2,586548,0.00032399,95.01738198
20006,省市,2,586550,0.00032399,95.01770597
20007,省吃儉用,2,586552,0.00032399,95.01802996
20008,省住都局,2,586554,0.00032399,95.01835394
20009,省油,2,586556,0.00032399,95.01867793
20010,省政會議,2,586558,0.00032399,95.01900192
20011,省漁會,2,586560,0.00032399,95.01932591
20012,省錢,2,586562,0.00032399,95.01964990
20013,盹,2,586564,0.00032399,95.01997389
20014,相交,2,586566,0.00032399,95.02029787
20015,相依為命,2,586568,0.00032399,95.02062186
20016,相爭,2,586570,0.00032399,95.02094585
20017,相思,2,586572,0.00032399,95.02126984
20018,相乘,2,586574,0.00032399,95.02159383
20019,相框,2,586576,0.00032399,95.02191782
20020,相得益彰,2,586578,0.00032399,95.02224181
20021,相惜,2,586580,0.00032399,95.02256579
20022,相逢,2,586582,0.00032399,95.02288978
20023,相等,2,586584,0.00032399,95.02321377
20024,相距,2,586586,0.00032399,95.02353776
20025,相愛,2,586588,0.00032399,95.02386175
20026,相輔相成,2,586590,0.00032399,95.02418574
20027,相撞,2,586592,0.00032399,95.02450972
20028,相應,2,586594,0.00032399,95.02483371
20029,相驗,2,586596,0.00032399,95.02515770
20030,眉夾,2,586598,0.00032399,95.02548169
20031,眉尾,2,586600,0.00032399,95.02580568
20032,眉清目秀,2,586602,0.00032399,95.02612967
20033,看一看,2,586604,0.00032399,95.02645366
20034,看守內閣,2,586606,0.00032399,95.02677764
20035,看完,2,586608,0.00032399,95.02710163
20036,看官,2,586610,0.00032399,95.02742562
20037,看穿,2,586612,0.00032399,95.02774961
20038,看病,2,586614,0.00032399,95.02807360
20039,看淡,2,586616,0.00032399,95.02839759
20040,看報,2,586618,0.00032399,95.02872157
20041,看跌,2,586620,0.00032399,95.02904556
20042,看齊,2,586622,0.00032399,95.02936955
20043,看壞,2,586624,0.00032399,95.02969354
20044,砂子,2,586626,0.00032399,95.03001753
20045,砂金,2,586628,0.00032399,95.03034152
20046,研考會,2,586630,0.00032399,95.03066550
20047,研考會主委,2,586632,0.00032399,95.03098949
20048,研究處,2,586634,0.00032399,95.03131348
20049,研訂,2,586636,0.00032399,95.03163747
20050,砍掉,2,586638,0.00032399,95.03196146
20051,祇好,2,586640,0.00032399,95.03228545
20052,祇有,2,586642,0.00032399,95.03260944
20053,科技島,2,586644,0.00032399,95.03293342
20054,科系,2,586646,0.00032399,95.03325741
20055,科林斯地峽,2,586648,0.00032399,95.03358140
20056,秒數,2,586650,0.00032399,95.03390539
20057,穿透,2,586652,0.00032399,95.03422938
20058,突擊,2,586654,0.00032399,95.03455337
20059,突擊步槍,2,586656,0.00032399,95.03487735
20060,突擊師,2,586658,0.00032399,95.03520134
20061,突檢,2,586660,0.00032399,95.03552533
20062,紅小麥,2,586662,0.00032399,95.03584932
20063,紅木,2,586664,0.00032399,95.03617331
20064,紅卡,2,586666,0.00032399,95.03649730
20065,紅利,2,586668,0.00032399,95.03682128
20066,紅茶,2,586670,0.00032399,95.03714527
20067,紅通通,2,586672,0.00032399,95.03746926
20068,紅斑性狼瘡,2,586674,0.00032399,95.03779325
20069,紅牌,2,586676,0.00032399,95.03811724
20070,紅旗白旗阿罩颺,2,586678,0.00032399,95.03844123
20071,紅樓,2,586680,0.00032399,95.03876522
20072,紅樓夢,2,586682,0.00032399,95.03908920
20073,紅熱,2,586684,0.00032399,95.03941319
20074,紅線,2,586686,0.00032399,95.03973718
20075,紅樹林,2,586688,0.00032399,95.04006117
20076,紅磚,2,586690,0.00032399,95.04038516
20077,紅薯,2,586692,0.00032399,95.04070915
20078,紅蘿蔔絲,2,586694,0.00032399,95.04103313
20079,紅黴素,2,586696,0.00032399,95.04135712
20080,紅魽肚,2,586698,0.00032399,95.04168111
20081,紀,2,586700,0.00032399,95.04200510
20082,紀念日,2,586702,0.00032399,95.04232909
20083,紀念像,2,586704,0.00032399,95.04265308
20084,紀實,2,586706,0.00032399,95.04297706
20085,紀實攝影,2,586708,0.00032399,95.04330105
20086,約旦,2,586710,0.00032399,95.04362504
20087,約束力,2,586712,0.00032399,95.04394903
20088,約莫,2,586714,0.00032399,95.04427302
20089,美人香,2,586716,0.00032399,95.04459701
20090,美人窩,2,586718,0.00032399,95.04492100
20091,美中不足,2,586720,0.00032399,95.04524498
20092,美化獎,2,586722,0.00032399,95.04556897
20093,美加,2,586724,0.00032399,95.04589296
20094,美名,2,586726,0.00032399,95.04621695
20095,美西,2,586728,0.00032399,95.04654094
20096,美妹,2,586730,0.00032399,95.04686493
20097,美洲大陸,2,586732,0.00032399,95.04718891
20098,美洲山獅式,2,586734,0.00032399,95.04751290
20099,美軍電台,2,586736,0.00032399,95.04783689
20100,美食街,2,586738,0.00032399,95.04816088
20101,美酒,2,586740,0.00032399,95.04848487
20102,美國小姐,2,586742,0.00032399,95.04880886
20103,美國有線電視新聞網,2,586744,0.00032399,95.04913284
20104,美國波音公司,2,586746,0.00032399,95.04945683
20105,美術系,2,586748,0.00032399,95.04978082
20106,美術指導,2,586750,0.00032399,95.05010481
20107,美術商,2,586752,0.00032399,95.05042880
20108,美規,2,586754,0.00032399,95.05075279
20109,美規車型,2,586756,0.00032399,95.05107678
20110,美琳達,2,586758,0.00032399,95.05140076
20111,美意,2,586760,0.00032399,95.05172475
20112,美製,2,586762,0.00032399,95.05204874
20113,美貌,2,586764,0.00032399,95.05237273
20114,耐人尋味,2,586766,0.00032399,95.05269672
20115,耐久性,2,586768,0.00032399,95.05302071
20116,耐磨性,2,586770,0.00032399,95.05334469
20117,耶利哥,2,586772,0.00032399,95.05366868
20118,胃腸病,2,586774,0.00032399,95.05399267
20119,胃潰瘍,2,586776,0.00032399,95.05431666
20120,背心,2,586778,0.00032399,95.05464065
20121,背面,2,586780,0.00032399,95.05496464
20122,背脊,2,586782,0.00032399,95.05528863
20123,背誦,2,586784,0.00032399,95.05561261
20124,背影,2,586786,0.00032399,95.05593660
20125,胡引玉,2,586788,0.00032399,95.05626059
20126,胡幼鳳,2,586790,0.00032399,95.05658458
20127,胡志強,2,586792,0.00032399,95.05690857
20128,胡家麒,2,586794,0.00032399,95.05723256
20129,胡椒,2,586796,0.00032399,95.05755654
20130,胡椒蝦,2,586798,0.00032399,95.05788053
20131,胡蘿蔔素,2,586800,0.00032399,95.05820452
20132,致歉,2,586802,0.00032399,95.05852851
20133,致贈,2,586804,0.00032399,95.05885250
20134,范巽綠,2,586806,0.00032399,95.05917649
20135,范蠡,2,586808,0.00032399,95.05950047
20136,茅威濤,2,586810,0.00032399,95.05982446
20137,苦不堪言,2,586812,0.00032399,95.06014845
20138,苦行僧,2,586814,0.00032399,95.06047244
20139,苦味,2,586816,0.00032399,95.06079643
20140,苦惱,2,586818,0.00032399,95.06112042
20141,苦痛,2,586820,0.00032399,95.06144441
20142,苦盡甘來,2,586822,0.00032399,95.06176839
20143,若能,2,586824,0.00032399,95.06209238
20144,苗條,2,586826,0.00032399,95.06241637
20145,英年早逝,2,586828,0.00032399,95.06274036
20146,英姿,2,586830,0.00032399,95.06306435
20147,英群,2,586832,0.00032399,95.06338834
20148,虐,2,586834,0.00032399,95.06371232
20149,虐待狂,2,586836,0.00032399,95.06403631
20150,衍生性,2,586838,0.00032399,95.06436030
20151,衫,2,586840,0.00032399,95.06468429
20152,要不是,2,586842,0.00032399,95.06500828
20153,要不得,2,586844,0.00032399,95.06533227
20154,要好,2,586846,0.00032399,95.06565625
20155,要員,2,586848,0.00032399,95.06598024
20156,要脅,2,586850,0.00032399,95.06630423
20157,要務,2,586852,0.00032399,95.06662822
20158,要點,2,586854,0.00032399,95.06695221
20159,要職,2,586856,0.00032399,95.06727620
20160,計划,2,586858,0.00032399,95.06760019
20161,計次,2,586860,0.00032399,95.06792417
20162,計時賽,2,586862,0.00032399,95.06824816
20163,計較,2,586864,0.00032399,95.06857215
20164,計數,2,586866,0.00032399,95.06889614
20165,訂貨值,2,586868,0.00032399,95.06922013
20166,訂閱者,2,586870,0.00032399,95.06954412
20167,負重,2,586872,0.00032399,95.06986810
20168,軍公教,2,586874,0.00032399,95.07019209
20169,軍旅,2,586876,0.00032399,95.07051608
20170,軍售,2,586878,0.00032399,95.07084007
20171,軍種,2,586880,0.00032399,95.07116406
20172,軍營,2,586882,0.00032399,95.07148805
20173,軍職,2,586884,0.00032399,95.07181203
20174,迪吉多,2,586886,0.00032399,95.07213602
20175,迪奧,2,586888,0.00032399,95.07246001
20176,迫不及待,2,586890,0.00032399,95.07278400
20177,郊外,2,586892,0.00032399,95.07310799
20178,郎亞玲,2,586894,0.00032399,95.07343198
20179,重力式衝擊椎機,2,586896,0.00032399,95.07375597
20180,重工業,2,586898,0.00032399,95.07407995
20181,重用,2,586900,0.00032399,95.07440394
20182,重男輕女,2,586902,0.00032399,95.07472793
20183,重金屬,2,586904,0.00032399,95.07505192
20184,重逢,2,586906,0.00032399,95.07537591
20185,重塑,2,586908,0.00032399,95.07569990
20186,重溫,2,586910,0.00032399,95.07602388
20187,重劃,2,586912,0.00032399,95.07634787
20188,重演,2,586914,0.00032399,95.07667186
20189,重罰,2,586916,0.00032399,95.07699585
20190,重慶,2,586918,0.00032399,95.07731984
20191,重賞,2,586920,0.00032399,95.07764383
20192,重擊,2,586922,0.00032399,95.07796781
20193,重鎮,2,586924,0.00032399,95.07829180
20194,陋,2,586926,0.00032399,95.07861579
20195,降臨,2,586928,0.00032399,95.07893978
20196,面不改色,2,586930,0.00032399,95.07926377
20197,面目,2,586932,0.00032399,95.07958776
20198,面值,2,586934,0.00032399,95.07991175
20199,面紙,2,586936,0.00032399,95.08023573
20200,面試,2,586938,0.00032399,95.08055972
20201,音域,2,586940,0.00032399,95.08088371
20202,音場,2,586942,0.00032399,95.08120770
20203,音路,2,586944,0.00032399,95.08153169
20204,音樂台,2,586946,0.00032399,95.08185568
20205,音樂性,2,586948,0.00032399,95.08217966
20206,音箱,2,586950,0.00032399,95.08250365
20207,音調,2,586952,0.00032399,95.08282764
20208,音頻,2,586954,0.00032399,95.08315163
20209,音響部,2,586956,0.00032399,95.08347562
20210,頁碼,2,586958,0.00032399,95.08379961
20211,風中奇緣,2,586960,0.00032399,95.08412360
20212,風化,2,586962,0.00032399,95.08444758
20213,風月,2,586964,0.00032399,95.08477157
20214,風向,2,586966,0.00032399,95.08509556
20215,風帆,2,586968,0.00032399,95.08541955
20216,風雨無阻,2,586970,0.00032399,95.08574354
20217,風紀,2,586972,0.00032399,95.08606753
20218,風茹草,2,586974,0.00032399,95.08639151
20219,風評,2,586976,0.00032399,95.08671550
20220,風管,2,586978,0.00032399,95.08703949
20221,風趣,2,586980,0.00032399,95.08736348
20222,風險性,2,586982,0.00032399,95.08768747
20223,風濕,2,586984,0.00032399,95.08801146
20224,風聲,2,586986,0.00032399,95.08833544
20225,飛人,2,586988,0.00032399,95.08865943
20226,飛毛腿,2,586990,0.00032399,95.08898342
20227,飛行物,2,586992,0.00032399,95.08930741
20228,飛快,2,586994,0.00032399,95.08963140
20229,飛車,2,586996,0.00032399,95.08995539
20230,飛來飛去,2,586998,0.00032399,95.09027938
20231,飛奔,2,587000,0.00032399,95.09060336
20232,飛航情報區,2,587002,0.00032399,95.09092735
20233,飛揚,2,587004,0.00032399,95.09125134
20234,飛禽,2,587006,0.00032399,95.09157533
20235,飛過,2,587008,0.00032399,95.09189932
20236,飛馳,2,587010,0.00032399,95.09222331
20237,飛躍,2,587012,0.00032399,95.09254729
20238,食用量,2,587014,0.00032399,95.09287128
20239,食客,2,587016,0.00032399,95.09319527
20240,食補品,2,587018,0.00032399,95.09351926
20241,食蟲植物,2,587020,0.00032399,95.09384325
20242,食鹽量,2,587022,0.00032399,95.09416724
20243,首日,2,587024,0.00032399,95.09449122
20244,首季,2,587026,0.00032399,95.09481521
20245,首屆,2,587028,0.00032399,95.09513920
20246,首座,2,587030,0.00032399,95.09546319
20247,首創,2,587032,0.00032399,95.09578718
20248,首富,2,587034,0.00032399,95.09611117
20249,首領,2,587036,0.00032399,95.09643516
20250,香口膠,2,587038,0.00032399,95.09675914
20251,香格里拉,2,587040,0.00032399,95.09708313
20252,香港九七,2,587042,0.00032399,95.09740712
20253,香港電訊,2,587044,0.00032399,95.09773111
20254,香港電訊公司,2,587046,0.00032399,95.09805510
20255,香達艾克曼,2,587048,0.00032399,95.09837909
20256,香醇,2,587050,0.00032399,95.09870307
20257,乘客座,2,587052,0.00032399,95.09902706
20258,倍感,2,587054,0.00032399,95.09935105
20259,俯首稱臣,2,587056,0.00032399,95.09967504
20260,俯視,2,587058,0.00032399,95.09999903
20261,俯衝,2,587060,0.00032399,95.10032302
20262,倦,2,587062,0.00032399,95.10064700
20263,倖存,2,587064,0.00032399,95.10097099
20264,值錢,2,587066,0.00032399,95.10129498
20265,借錢,2,587068,0.00032399,95.10161897
20266,倚,2,587070,0.00032399,95.10194296
20267,倚天公司,2,587072,0.00032399,95.10226695
20268,倚天電腦公司,2,587074,0.00032399,95.10259094
20269,倚賴,2,587076,0.00032399,95.10291492
20270,倒立,2,587078,0.00032399,95.10323891
20271,倒地,2,587080,0.00032399,95.10356290
20272,倒映,2,587082,0.00032399,95.10388689
20273,倒掉,2,587084,0.00032399,95.10421088
20274,個子,2,587086,0.00032399,95.10453487
20275,個展,2,587088,0.00032399,95.10485885
20276,候補,2,587090,0.00032399,95.10518284
20277,候選,2,587092,0.00032399,95.10550683
20278,修女,2,587094,0.00032399,95.10583082
20279,修行人,2,587096,0.00032399,95.10615481
20280,修身,2,587098,0.00032399,95.10647880
20281,修法,2,587100,0.00032399,95.10680278
20282,修築,2,587102,0.00032399,95.10712677
20283,修護,2,587104,0.00032399,95.10745076
20284,俾,2,587106,0.00032399,95.10777475
20285,倫敦金屬交易所,2,587108,0.00032399,95.10809874
20286,倉促,2,587110,0.00032399,95.10842273
20287,冤,2,587112,0.00032399,95.10874672
20288,冤枉,2,587114,0.00032399,95.10907070
20289,凌空,2,587116,0.00032399,95.10939469
20290,凌厲,2,587118,0.00032399,95.10971868
20291,凌駕,2,587120,0.00032399,95.11004267
20292,准予,2,587122,0.00032399,95.11036666
20293,准將,2,587124,0.00032399,95.11069065
20294,剖面,2,587126,0.00032399,95.11101463
20295,剛果,2,587128,0.00032399,95.11133862
20296,剛直,2,587130,0.00032399,95.11166261
20297,剝削,2,587132,0.00032399,95.11198660
20298,剝掉,2,587134,0.00032399,95.11231059
20299,原子彈,2,587136,0.00032399,95.11263458
20300,原文書,2,587138,0.00032399,95.11295857
20301,原始碼,2,587140,0.00032399,95.11328255
20302,原版,2,587142,0.00032399,95.11360654
20303,原封不動,2,587144,0.00032399,95.11393053
20304,原著,2,587146,0.00032399,95.11425452
20305,原點,2,587148,0.00032399,95.11457851
20306,厝,2,587150,0.00032399,95.11490250
20307,唐福春,2,587152,0.00032399,95.11522648
20308,哥本哈根,2,587154,0.00032399,95.11555047
20309,哥倫比亞,2,587156,0.00032399,95.11587446
20310,哥倫布號,2,587158,0.00032399,95.11619845
20311,哥雅,2,587160,0.00032399,95.11652244
20312,哺乳動物,2,587162,0.00032399,95.11684643
20313,哭牆,2,587164,0.00032399,95.11717041
20314,哭聲,2,587166,0.00032399,95.11749440
20315,員林,2,587168,0.00032399,95.11781839
20316,唇形,2,587170,0.00032399,95.11814238
20317,唇周修護霜,2,587172,0.00032399,95.11846637
20318,唇筆刷,2,587174,0.00032399,95.11879036
20319,埋下,2,587176,0.00032399,95.11911435
20320,埋設,2,587178,0.00032399,95.11943833
20321,夏季賽,2,587180,0.00032399,95.11976232
20322,夏宮,2,587182,0.00032399,95.12008631
20323,夏級,2,587184,0.00032399,95.12041030
20324,夏曼可倫,2,587186,0.00032399,95.12073429
20325,套上,2,587188,0.00032399,95.12105828
20326,套用,2,587190,0.00032399,95.12138226
20327,娛樂性,2,587192,0.00032399,95.12170625
20328,娓娓,2,587194,0.00032399,95.12203024
20329,姬拉,2,587196,0.00032399,95.12235423
20330,孫中山,2,587198,0.00032399,95.12267822
20331,孫國勛,2,587200,0.00032399,95.12300221
20332,孫楨民,2,587202,0.00032399,95.12332619
20333,家用品,2,587204,0.00032399,95.12365018
20334,家庭月刊,2,587206,0.00032399,95.12397417
20335,家庭主婦,2,587208,0.00032399,95.12429816
20336,家庭背景,2,587210,0.00032399,95.12462215
20337,家管,2,587212,0.00032399,95.12494614
20338,宮澤理惠,2,587214,0.00032399,95.12527013
20339,容忍,2,587216,0.00032399,95.12559411
20340,射入,2,587218,0.00032399,95.12591810
20341,射穿,2,587220,0.00032399,95.12624209
20342,射線,2,587222,0.00032399,95.12656608
20343,展示間,2,587224,0.00032399,95.12689007
20344,展示廳,2,587226,0.00032399,95.12721406
20345,展延,2,587228,0.00032399,95.12753804
20346,展演,2,587230,0.00032399,95.12786203
20347,差事,2,587232,0.00032399,95.12818602
20348,差錯,2,587234,0.00032399,95.12851001
20349,席絲特,2,587236,0.00032399,95.12883400
20350,師大附中,2,587238,0.00032399,95.12915799
20351,庫,2,587240,0.00032399,95.12948197
20352,庭上,2,587242,0.00032399,95.12980596
20353,座右銘,2,587244,0.00032399,95.13012995
20354,座駕,2,587246,0.00032399,95.13045394
20355,座艙,2,587248,0.00032399,95.13077793
20356,弱小,2,587250,0.00032399,95.13110192
20357,徐乃麟,2,587252,0.00032399,95.13142591
20358,徐玉清,2,587254,0.00032399,95.13174989
20359,徐鳳明,2,587256,0.00032399,95.13207388
20360,恐怖感,2,587258,0.00032399,95.13239787
20361,恕,2,587260,0.00032399,95.13272186
20362,恭賀,2,587262,0.00032399,95.13304585
20363,恭維,2,587264,0.00032399,95.13336984
20364,恩愛,2,587266,0.00032399,95.13369382
20365,悔恨,2,587268,0.00032399,95.13401781
20366,悅耳,2,587270,0.00032399,95.13434180
20367,悅寶證券,2,587272,0.00032399,95.13466579
20368,悖,2,587274,0.00032399,95.13498978
20369,拳腳相向,2,587276,0.00032399,95.13531377
20370,拿去,2,587278,0.00032399,95.13563775
20371,拿回,2,587280,0.00032399,95.13596174
20372,拿走,2,587282,0.00032399,95.13628573
20373,拿破崙,2,587284,0.00032399,95.13660972
20374,拿掉,2,587286,0.00032399,95.13693371
20375,挾怨,2,587288,0.00032399,95.13725770
20376,振膜,2,587290,0.00032399,95.13758169
20377,捕撈,2,587292,0.00032399,95.13790567
20378,捕獵,2,587294,0.00032399,95.13822966
20379,捕蟲堇屬,2,587296,0.00032399,95.13855365
20380,捕蠅草,2,587298,0.00032399,95.13887764
20381,捆工,2,587300,0.00032399,95.13920163
20382,捏,2,587302,0.00032399,95.13952562
20383,捏造,2,587304,0.00032399,95.13984960
20384,捉,2,587306,0.00032399,95.14017359
20385,捉賊,2,587308,0.00032399,95.14049758
20386,捉摸,2,587310,0.00032399,95.14082157
20387,挺身而出,2,587312,0.00032399,95.14114556
20388,捐獻,2,587314,0.00032399,95.14146955
20389,挪,2,587316,0.00032399,95.14179354
20390,挪動,2,587318,0.00032399,95.14211752
20391,挫折感,2,587320,0.00032399,95.14244151
20392,效法,2,587322,0.00032399,95.14276550
20393,料子,2,587324,0.00032399,95.14308949
20394,料事如神,2,587326,0.00032399,95.14341348
20395,旅人,2,587328,0.00032399,95.14373747
20396,旅行現金卡,2,587330,0.00032399,95.14406145
20397,旅行袋,2,587332,0.00032399,95.14438544
20398,旅居,2,587334,0.00032399,95.14470943
20399,旅遊點,2,587336,0.00032399,95.14503342
20400,時代的臉,2,587338,0.00032399,95.14535741
20401,時代衛視,2,587340,0.00032399,95.14568140
20402,時有所聞,2,587342,0.00032399,95.14600538
20403,時事,2,587344,0.00032399,95.14632937
20404,時刻表,2,587346,0.00032399,95.14665336
20405,時限,2,587348,0.00032399,95.14697735
20406,時效性,2,587350,0.00032399,95.14730134
20407,時時刻刻,2,587352,0.00032399,95.14762533
20408,時報廣場,2,587354,0.00032399,95.14794932
20409,時裝展,2,587356,0.00032399,95.14827330
20410,時鐘,2,587358,0.00032399,95.14859729
20411,晒,2,587360,0.00032399,95.14892128
20412,晌午,2,587362,0.00032399,95.14924527
20413,書刊,2,587364,0.00032399,95.14956926
20414,書名,2,587366,0.00032399,95.14989325
20415,書局,2,587368,0.00032399,95.15021723
20416,書櫃,2,587370,0.00032399,95.15054122
20417,朗瑞克,2,587372,0.00032399,95.15086521
20418,朗誦,2,587374,0.00032399,95.15118920
20419,朗讀,2,587376,0.00032399,95.15151319
20420,校門口,2,587378,0.00032399,95.15183718
20421,校規,2,587380,0.00032399,95.15216116
20422,校對,2,587382,0.00032399,95.15248515
20423,校閱,2,587384,0.00032399,95.15280914
20424,核子動力潛艇,2,587386,0.00032399,95.15313313
20425,核可,2,587388,0.00032399,95.15345712
20426,核武,2,587390,0.00032399,95.15378111
20427,核桃木,2,587392,0.00032399,95.15410510
20428,核備,2,587394,0.00032399,95.15442908
20429,案山,2,587396,0.00032399,95.15475307
20430,根深蒂固,2,587398,0.00032399,95.15507706
20431,根莖,2,587400,0.00032399,95.15540105
20432,根莖類,2,587402,0.00032399,95.15572504
20433,梳理,2,587404,0.00032399,95.15604903
20434,桌上型電腦,2,587406,0.00032399,95.15637301
20435,桌巾,2,587408,0.00032399,95.15669700
20436,栽植,2,587410,0.00032399,95.15702099
20437,栽贓,2,587412,0.00032399,95.15734498
20438,柴,2,587414,0.00032399,95.15766897
20439,柴油機,2,587416,0.00032399,95.15799296
20440,柴魚片,2,587418,0.00032399,95.15831694
20441,柴電潛艦,2,587420,0.00032399,95.15864093
20442,桀,2,587422,0.00032399,95.15896492
20443,格式化,2,587424,0.00032399,95.15928891
20444,格雷維斑馬,2,587426,0.00032399,95.15961290
20445,桃,2,587428,0.00032399,95.15993689
20446,桃子,2,587430,0.00032399,95.16026088
20447,桃李,2,587432,0.00032399,95.16058486
20448,殷,2,587434,0.00032399,95.16090885
20449,氣力,2,587436,0.00032399,95.16123284
20450,氣不過,2,587438,0.00032399,95.16155683
20451,氣流,2,587440,0.00032399,95.16188082
20452,氣球帽,2,587442,0.00032399,95.16220481
20453,氣喘,2,587444,0.00032399,95.16252879
20454,氣焰,2,587446,0.00032399,95.16285278
20455,氣象館,2,587448,0.00032399,95.16317677
20456,氣數,2,587450,0.00032399,95.16350076
20457,氣韻,2,587452,0.00032399,95.16382475
20458,泰山高中,2,587454,0.00032399,95.16414874
20459,泰元鋼鐵廠,2,587456,0.00032399,95.16447272
20460,泰斗,2,587458,0.00032399,95.16479671
20461,泰安,2,587460,0.00032399,95.16512070
20462,泰瑞莎,2,587462,0.00032399,95.16544469
20463,泰爾,2,587464,0.00032399,95.16576868
20464,泰銖,2,587466,0.00032399,95.16609267
20465,浪濤,2,587468,0.00032399,95.16641666
20466,消化道,2,587470,0.00032399,95.16674064
20467,消化器官,2,587472,0.00032399,95.16706463
20468,消災,2,587474,0.00032399,95.16738862
20469,消防局,2,587476,0.00032399,95.16771261
20470,消炎,2,587478,0.00032399,95.16803660
20471,消炎藥,2,587480,0.00032399,95.16836059
20472,消暑,2,587482,0.00032399,95.16868457
20473,消費性,2,587484,0.00032399,95.16900856
20474,消費稅,2,587486,0.00032399,95.16933255
20475,消費量,2,587488,0.00032399,95.16965654
20476,消褪,2,587490,0.00032399,95.16998053
20477,海內外,2,587492,0.00032399,95.17030452
20478,海味,2,587494,0.00032399,95.17062851
20479,海波清除液,2,587496,0.00032399,95.17095249
20480,海洋公園,2,587498,0.00032399,95.17127648
20481,海軍第三軍區司令部,2,587500,0.00032399,95.17160047
20482,海島,2,587502,0.00032399,95.17192446
20483,海豹,2,587504,0.00032399,95.17224845
20484,海景,2,587506,0.00032399,95.17257244
20485,海頓,2,587508,0.00032399,95.17289642
20486,海寧希國家公園,2,587510,0.00032399,95.17322041
20487,海德公園,2,587512,0.00032399,95.17354440
20488,海德堡,2,587514,0.00032399,95.17386839
20489,海戰,2,587516,0.00032399,95.17419238
20490,海疆,2,587518,0.00032399,95.17451637
20491,海關人員,2,587520,0.00032399,95.17484035
20492,涉獵,2,587522,0.00032399,95.17516434
20493,浮上,2,587524,0.00032399,95.17548833
20494,浮游生物,2,587526,0.00032399,95.17581232
20495,浴衣,2,587528,0.00032399,95.17613631
20496,浴缸,2,587530,0.00032399,95.17646030
20497,浩瀚,2,587532,0.00032399,95.17678429
20498,烤肉,2,587534,0.00032399,95.17710827
20499,烤魚,2,587536,0.00032399,95.17743226
20500,烏心石,2,587538,0.00032399,95.17775625
20501,烏托邦島,2,587540,0.00032399,95.17808024
20502,烏孫,2,587542,0.00032399,95.17840423
20503,烏梅酒,2,587544,0.00032399,95.17872822
20504,烏黑,2,587546,0.00032399,95.17905220
20505,烏塗窟,2,587548,0.00032399,95.17937619
20506,特拉維夫,2,587550,0.00032399,95.17970018
20507,特長,2,587552,0.00032399,95.18002417
20508,特派員,2,587554,0.00032399,95.18034816
20509,特派記者,2,587556,0.00032399,95.18067215
20510,特展,2,587558,0.00032399,95.18099613
20511,特效,2,587560,0.00032399,95.18132012
20512,特賣,2,587562,0.00032399,95.18164411
20513,特戰部隊,2,587564,0.00032399,95.18196810
20514,特輯,2,587566,0.00032399,95.18229209
20515,狼,2,587568,0.00032399,95.18261608
20516,狼狽不堪,2,587570,0.00032399,95.18294007
20517,狹小,2,587572,0.00032399,95.18326405
20518,班上,2,587574,0.00032399,95.18358804
20519,班奈狄克波恩,2,587576,0.00032399,95.18391203
20520,班馬,2,587578,0.00032399,95.18423602
20521,畝,2,587580,0.00032399,95.18456001
20522,留心,2,587582,0.00032399,95.18488400
20523,留言,2,587584,0.00032399,95.18520798
20524,留傳,2,587586,0.00032399,95.18553197
20525,留置,2,587588,0.00032399,95.18585596
20526,留影,2,587590,0.00032399,95.18617995
20527,留學,2,587592,0.00032399,95.18650394
20528,病症,2,587594,0.00032399,95.18682793
20529,病逝,2,587596,0.00032399,95.18715191
20530,病徵,2,587598,0.00032399,95.18747590
20531,病蟲害,2,587600,0.00032399,95.18779989
20532,病癥,2,587602,0.00032399,95.18812388
20533,病魔,2,587604,0.00032399,95.18844787
20534,病體,2,587606,0.00032399,95.18877186
20535,疲乏,2,587608,0.00032399,95.18909585
20536,疼,2,587610,0.00032399,95.18941983
20537,疼痛感,2,587612,0.00032399,95.18974382
20538,疹子,2,587614,0.00032399,95.19006781
20539,益友,2,587616,0.00032399,95.19039180
20540,真皮,2,587618,0.00032399,95.19071579
20541,真空管機,2,587620,0.00032399,95.19103978
20542,真品,2,587622,0.00032399,95.19136376
20543,真相新聞網,2,587624,0.00032399,95.19168775
20544,真偽,2,587626,0.00032399,95.19201174
20545,真愛,2,587628,0.00032399,95.19233573
20546,真諦,2,587630,0.00032399,95.19265972
20547,眠,2,587632,0.00032399,95.19298371
20548,砰,2,587634,0.00032399,95.19330769
20549,破土,2,587636,0.00032399,95.19363168
20550,破浪,2,587638,0.00032399,95.19395567
20551,破獲,2,587640,0.00032399,95.19427966
20552,破舊,2,587642,0.00032399,95.19460365
20553,破壞力,2,587644,0.00032399,95.19492764
20554,砲火,2,587646,0.00032399,95.19525163
20555,砲兵,2,587648,0.00032399,95.19557561
20556,砲彈,2,587650,0.00032399,95.19589960
20557,祕訣,2,587652,0.00032399,95.19622359
20558,祖母,2,587654,0.00032399,95.19654758
20559,祖墳,2,587656,0.00032399,95.19687157
20560,神仙,2,587658,0.00032399,95.19719556
20561,神祇,2,587660,0.00032399,95.19751954
20562,神氣活現,2,587662,0.00032399,95.19784353
20563,神秘午夜場,2,587664,0.00032399,95.19816752
20564,神通電腦,2,587666,0.00032399,95.19849151
20565,神學,2,587668,0.00032399,95.19881550
20566,祝賀,2,587670,0.00032399,95.19913949
20567,祝融,2,587672,0.00032399,95.19946348
20568,租賃,2,587674,0.00032399,95.19978746
20569,秦一,2,587676,0.00032399,95.20011145
20570,秘,2,587678,0.00032399,95.20043544
20571,窈窕,2,587680,0.00032399,95.20075943
20572,站穩,2,587682,0.00032399,95.20108342
20573,笑料,2,587684,0.00032399,95.20140741
20574,笑鬧,2,587686,0.00032399,95.20173139
20575,粉刷,2,587688,0.00032399,95.20205538
20576,粉塵,2,587690,0.00032399,95.20237937
20577,粉嫩,2,587692,0.00032399,95.20270336
20578,紗布袋,2,587694,0.00032399,95.20302735
20579,素食者,2,587696,0.00032399,95.20335134
20580,素雅,2,587698,0.00032399,95.20367532
20581,素樸,2,587700,0.00032399,95.20399931
20582,素雞,2,587702,0.00032399,95.20432330
20583,索馬利亞,2,587704,0.00032399,95.20464729
20584,純益,2,587706,0.00032399,95.20497128
20585,紐約大學,2,587708,0.00032399,95.20529527
20586,紐約公寓,2,587710,0.00032399,95.20561926
20587,紐約洋基隊,2,587712,0.00032399,95.20594324
20588,紐舒堪布,2,587714,0.00032399,95.20626723
20589,紐澳研究中心,2,587716,0.00032399,95.20659122
20590,納骨塔,2,587718,0.00032399,95.20691521
20591,納悶,2,587720,0.00032399,95.20723920
20592,紙基,2,587722,0.00032399,95.20756319
20593,紙盤,2,587724,0.00032399,95.20788717
20594,紛,2,587726,0.00032399,95.20821116
20595,紛亂,2,587728,0.00032399,95.20853515
20596,缺氧,2,587730,0.00032399,95.20885914
20597,缺鐵性,2,587732,0.00032399,95.20918313
20598,翁啟森,2,587734,0.00032399,95.20950712
20599,耘,2,587736,0.00032399,95.20983110
20600,耕種,2,587738,0.00032399,95.21015509
20601,耗時,2,587740,0.00032399,95.21047908
20602,耗盡,2,587742,0.00032399,95.21080307
20603,耿耿於懷,2,587744,0.00032399,95.21112706
20604,能見度,2,587746,0.00032399,95.21145105
20605,能幹,2,587748,0.00032399,95.21177504
20606,胼手胝足,2,587750,0.00032399,95.21209902
20607,航站,2,587752,0.00032399,95.21242301
20608,航道,2,587754,0.00032399,95.21274700
20609,茫然,2,587756,0.00032399,95.21307099
20610,荒,2,587758,0.00032399,95.21339498
20611,荒郊,2,587760,0.00032399,95.21371897
20612,荒郊野外,2,587762,0.00032399,95.21404295
20613,草屯,2,587764,0.00032399,95.21436694
20614,草屯鎮,2,587766,0.00032399,95.21469093
20615,草木皆兵,2,587768,0.00032399,95.21501492
20616,草皮,2,587770,0.00032399,95.21533891
20617,草地,2,587772,0.00032399,95.21566290
20618,草兒,2,587774,0.00032399,95.21598688
20619,草率,2,587776,0.00032399,95.21631087
20620,草創,2,587778,0.00032399,95.21663486
20621,草帽,2,587780,0.00032399,95.21695885
20622,草蜢,2,587782,0.00032399,95.21728284
20623,草擬,2,587784,0.00032399,95.21760683
20624,茶行,2,587786,0.00032399,95.21793082
20625,茶垢,2,587788,0.00032399,95.21825480
20626,茶室,2,587790,0.00032399,95.21857879
20627,茶壺,2,587792,0.00032399,95.21890278
20628,茶會,2,587794,0.00032399,95.21922677
20629,茶葉,2,587796,0.00032399,95.21955076
20630,記事,2,587798,0.00032399,95.21987475
20631,記事本,2,587800,0.00032399,95.22019873
20632,記號,2,587802,0.00032399,95.22052272
20633,討伐,2,587804,0.00032399,95.22084671
20634,討回,2,587806,0.00032399,95.22117070
20635,討債公司,2,587808,0.00032399,95.22149469
20636,討論會,2,587810,0.00032399,95.22181868
20637,託付,2,587812,0.00032399,95.22214267
20638,訓委會,2,587814,0.00032399,95.22246665
20639,訓練班,2,587816,0.00032399,95.22279064
20640,訓練營,2,587818,0.00032399,95.22311463
20641,豹隊,2,587820,0.00032399,95.22343862
20642,財主,2,587822,0.00032399,95.22376261
20643,財政廳,2,587824,0.00032399,95.22408660
20644,財務處長,2,587826,0.00032399,95.22441058
20645,財務報表,2,587828,0.00032399,95.22473457
20646,財源滾滾,2,587830,0.00032399,95.22505856
20647,財經記者,2,587832,0.00032399,95.22538255
20648,財運,2,587834,0.00032399,95.22570654
20649,財團法人,2,587836,0.00032399,95.22603053
20650,財團法人應式文法務基金會,2,587838,0.00032399,95.22635451
20651,貢獻度,2,587840,0.00032399,95.22667850
20652,起因,2,587842,0.00032399,95.22700249
20653,起死回生,2,587844,0.00032399,95.22732648
20654,起亞,2,587846,0.00032399,95.22765047
20655,起跑,2,587848,0.00032399,95.22797446
20656,送人,2,587850,0.00032399,95.22829845
20657,送入,2,587852,0.00032399,95.22862243
20658,逆向,2,587854,0.00032399,95.22894642
20659,逆境,2,587856,0.00032399,95.22927041
20660,迷迭香,2,587858,0.00032399,95.22959440
20661,迷惘,2,587860,0.00032399,95.22991839
20662,迷路,2,587862,0.00032399,95.23024238
20663,退化性,2,587864,0.00032399,95.23056636
20664,退片,2,587866,0.00032399,95.23089035
20665,退卻,2,587868,0.00032399,95.23121434
20666,退換,2,587870,0.00032399,95.23153833
20667,退稅率,2,587872,0.00032399,95.23186232
20668,退學,2,587874,0.00032399,95.23218631
20669,退還,2,587876,0.00032399,95.23251029
20670,迴圈,2,587878,0.00032399,95.23283428
20671,逃出,2,587880,0.00032399,95.23315827
20672,逃跑,2,587882,0.00032399,95.23348226
20673,逃過一劫,2,587884,0.00032399,95.23380625
20674,逃漏,2,587886,0.00032399,95.23413024
20675,追加,2,587888,0.00032399,95.23445423
20676,追求者,2,587890,0.00032399,95.23477821
20677,追討,2,587892,0.00032399,95.23510220
20678,追問,2,587894,0.00032399,95.23542619
20679,追夢人,2,587896,0.00032399,95.23575018
20680,追隨,2,587898,0.00032399,95.23607417
20681,郡,2,587900,0.00032399,95.23639816
20682,酒水,2,587902,0.00032399,95.23672214
20683,酒吧女,2,587904,0.00032399,95.23704613
20684,酒味,2,587906,0.00032399,95.23737012
20685,配偶,2,587908,0.00032399,95.23769411
20686,配接卡,2,587910,0.00032399,95.23801810
20687,配製,2,587912,0.00032399,95.23834209
20688,酌,2,587914,0.00032399,95.23866607
20689,針孔,2,587916,0.00032399,95.23899006
20690,針織,2,587918,0.00032399,95.23931405
20691,針織衫,2,587920,0.00032399,95.23963804
20692,閃開,2,587922,0.00032399,95.23996203
20693,院線,2,587924,0.00032399,95.24028602
20694,陣亡,2,587926,0.00032399,95.24061001
20695,除此之外,2,587928,0.00032399,95.24093399
20696,除息,2,587930,0.00032399,95.24125798
20697,除草,2,587932,0.00032399,95.24158197
20698,除濕機,2,587934,0.00032399,95.24190596
20699,飢,2,587936,0.00032399,95.24222995
20700,飢渴,2,587938,0.00032399,95.24255394
20701,飢餓,2,587940,0.00032399,95.24287792
20702,馬丁尼,2,587942,0.00032399,95.24320191
20703,馬不停蹄,2,587944,0.00032399,95.24352590
20704,馬匹,2,587946,0.00032399,95.24384989
20705,馬克．韓森,2,587948,0.00032399,95.24417388
20706,馬克斯蒲朗克,2,587950,0.00032399,95.24449787
20707,馬來人,2,587952,0.00032399,95.24482185
20708,馬拉車賽,2,587954,0.00032399,95.24514584
20709,馬股,2,587956,0.00032399,95.24546983
20710,馬表,2,587958,0.00032399,95.24579382
20711,馬度,2,587960,0.00032399,95.24611781
20712,馬莎,2,587962,0.00032399,95.24644180
20713,馬堤,2,587964,0.00032399,95.24676579
20714,馬廄,2,587966,0.00032399,95.24708977
20715,馬登鶴,2,587968,0.00032399,95.24741376
20716,馬蒂斯,2,587970,0.00032399,95.24773775
20717,馬幣,2,587972,0.00032399,95.24806174
20718,馬爾薩斯,2,587974,0.00032399,95.24838573
20719,馬賽克,2,587976,0.00032399,95.24870972
20720,骨干,2,587978,0.00032399,95.24903370
20721,骨化,2,587980,0.00032399,95.24935769
20722,骨刺,2,587982,0.00032399,95.24968168
20723,高文智,2,587984,0.00032399,95.25000567
20724,高正源,2,587986,0.00032399,95.25032966
20725,高危險群,2,587988,0.00032399,95.25065365
20726,高地,2,587990,0.00032399,95.25097764
20727,高估,2,587992,0.00032399,95.25130162
20728,高利貸,2,587994,0.00032399,95.25162561
20729,高妙,2,587996,0.00032399,95.25194960
20730,高育仁,2,587998,0.00032399,95.25227359
20731,高抬貴手,2,588000,0.00032399,95.25259758
20732,高朋滿座,2,588002,0.00032399,95.25292157
20733,高空彈跳,2,588004,0.00032399,95.25324555
20734,高泉錫,2,588006,0.00032399,95.25356954
20735,高科技股,2,588008,0.00032399,95.25389353
20736,高科技業,2,588010,0.00032399,95.25421752
20737,高峰期,2,588012,0.00032399,95.25454151
20738,高效率,2,588014,0.00032399,95.25486550
20739,高眼點,2,588016,0.00032399,95.25518948
20740,高速混合機,2,588018,0.00032399,95.25551347
20741,高登,2,588020,0.00032399,95.25583746
20742,高雄市立美術館,2,588022,0.00032399,95.25616145
20743,高雄區,2,588024,0.00032399,95.25648544
20744,高雄縣長,2,588026,0.00032399,95.25680943
20745,高雄醫學院附設醫院,2,588028,0.00032399,95.25713342
20746,高爾夫球袋,2,588030,0.00032399,95.25745740
20747,高爾夫球場,2,588032,0.00032399,95.25778139
20748,高潮迭起,2,588034,0.00032399,95.25810538
20749,高蕙蘭,2,588036,0.00032399,95.25842937
20750,高職,2,588038,0.00032399,95.25875336
20751,高額,2,588040,0.00032399,95.25907735
20752,高爆燒夷曳光彈,2,588042,0.00032399,95.25940133
20753,高難度,2,588044,0.00032399,95.25972532
20754,高耀通,2,588046,0.00032399,95.26004931
20755,高齡者,2,588048,0.00032399,95.26037330
20756,鬥法,2,588050,0.00032399,95.26069729
20757,鬼,2,588052,0.00032399,95.26102128
20758,乾旦,2,588054,0.00032399,95.26134526
20759,乾坤,2,588056,0.00032399,95.26166925
20760,乾季,2,588058,0.00032399,95.26199324
20761,乾度,2,588060,0.00032399,95.26231723
20762,乾洗,2,588062,0.00032399,95.26264122
20763,乾乾,2,588064,0.00032399,95.26296521
20764,乾濕,2,588066,0.00032399,95.26328920
20765,乾癟,2,588068,0.00032399,95.26361318
20766,偽,2,588070,0.00032399,95.26393717
20767,偽陰性,2,588072,0.00032399,95.26426116
20768,偽裝,2,588074,0.00032399,95.26458515
20769,停刊,2,588076,0.00032399,95.26490914
20770,停放,2,588078,0.00032399,95.26523313
20771,停飛,2,588080,0.00032399,95.26555711
20772,停掉,2,588082,0.00032399,95.26588110
20773,停電,2,588084,0.00032399,95.26620509
20774,停靠,2,588086,0.00032399,95.26652908
20775,停職,2,588088,0.00032399,95.26685307
20776,假若,2,588090,0.00032399,95.26717706
20777,假假,2,588092,0.00032399,95.26750104
20778,假裝,2,588094,0.00032399,95.26782503
20779,假髮,2,588096,0.00032399,95.26814902
20780,做完,2,588098,0.00032399,95.26847301
20781,健,2,588100,0.00032399,95.26879700
20782,健身運動,2,588102,0.00032399,95.26912099
20783,健美操,2,588104,0.00032399,95.26944498
20784,健健康康,2,588106,0.00032399,95.26976896
20785,健將,2,588108,0.00032399,95.27009295
20786,健康舞,2,588110,0.00032399,95.27041694
20787,健檢,2,588112,0.00032399,95.27074093
20788,偶發,2,588114,0.00032399,95.27106492
20789,偕,2,588116,0.00032399,95.27138891
20790,側窗,2,588118,0.00032399,95.27171289
20791,側邊,2,588120,0.00032399,95.27203688
20792,偷香,2,588122,0.00032399,95.27236087
20793,偷窺,2,588124,0.00032399,95.27268486
20794,偏心,2,588126,0.00032399,95.27300885
20795,偏差,2,588128,0.00032399,95.27333284
20796,剪刀,2,588130,0.00032399,95.27365682
20797,剪接,2,588132,0.00032399,95.27398081
20798,剪報,2,588134,0.00032399,95.27430480
20799,剪貼,2,588136,0.00032399,95.27462879
20800,剪輯,2,588138,0.00032399,95.27495278
20801,副手,2,588140,0.00032399,95.27527677
20802,副木,2,588142,0.00032399,95.27560076
20803,副刊,2,588144,0.00032399,95.27592474
20804,副委員長,2,588146,0.00032399,95.27624873
20805,副校長,2,588148,0.00032399,95.27657272
20806,副參謀長,2,588150,0.00032399,95.27689671
20807,副教授,2,588152,0.00032399,95.27722070
20808,副處長,2,588154,0.00032399,95.27754469
20809,副廠長,2,588156,0.00032399,95.27786867
20810,副標題,2,588158,0.00032399,95.27819266
20811,勒戒病房,2,588160,0.00032399,95.27851665
20812,務實,2,588162,0.00032399,95.27884064
20813,動身,2,588164,0.00032399,95.27916463
20814,動武,2,588166,0.00032399,95.27948862
20815,動物園,2,588168,0.00032399,95.27981261
20816,動物學家,2,588170,0.00032399,95.28013659
20817,動員部,2,588172,0.00032399,95.28046058
20818,動情期,2,588174,0.00032399,95.28078457
20819,動量,2,588176,0.00032399,95.28110856
20820,動靜,2,588178,0.00032399,95.28143255
20821,匿名,2,588180,0.00032399,95.28175654
20822,區公所,2,588182,0.00032399,95.28208052
20823,區間,2,588184,0.00032399,95.28240451
20824,參予,2,588186,0.00032399,95.28272850
20825,參加者,2,588188,0.00032399,95.28305249
20826,參差,2,588190,0.00032399,95.28337648
20827,參團,2,588192,0.00032399,95.28370047
20828,參演,2,588194,0.00032399,95.28402445
20829,參與者,2,588196,0.00032399,95.28434844
20830,參雜,2,588198,0.00032399,95.28467243
20831,參觀者,2,588200,0.00032399,95.28499642
20832,曼妙,2,588202,0.00032399,95.28532041
20833,曼谷郵報,2,588204,0.00032399,95.28564440
20834,曼陀鈴,2,588206,0.00032399,95.28596839
20835,曼紐因,2,588208,0.00032399,95.28629237
20836,曼費德．克爾夫曼,2,588210,0.00032399,95.28661636
20837,商務部長,2,588212,0.00032399,95.28694035
20838,商港,2,588214,0.00032399,95.28726434
20839,商量,2,588216,0.00032399,95.28758833
20840,商學院,2,588218,0.00032399,95.28791232
20841,商職,2,588220,0.00032399,95.28823630
20842,商譽,2,588222,0.00032399,95.28856029
20843,啪,2,588224,0.00032399,95.28888428
20844,啦啦隊,2,588226,0.00032399,95.28920827
20845,啃,2,588228,0.00032399,95.28953226
20846,唱片業,2,588230,0.00032399,95.28985625
20847,唱腔,2,588232,0.00032399,95.29018023
20848,問及,2,588234,0.00032399,95.29050422
20849,問卷調查,2,588236,0.00032399,95.29082821
20850,問問,2,588238,0.00032399,95.29115220
20851,問問看,2,588240,0.00032399,95.29147619
20852,問話,2,588242,0.00032399,95.29180018
20853,問道,2,588244,0.00032399,95.29212417
20854,唯有,2,588246,0.00032399,95.29244815
20855,唯恐,2,588248,0.00032399,95.29277214
20856,唸法,2,588250,0.00032399,95.29309613
20857,唸唸有詞,2,588252,0.00032399,95.29342012
20858,圈子,2,588254,0.00032399,95.29374411
20859,圈內,2,588256,0.00032399,95.29406810
20860,圈內人,2,588258,0.00032399,95.29439208
20861,圈圈,2,588260,0.00032399,95.29471607
20862,國大工作會,2,588262,0.00032399,95.29504006
20863,國文,2,588264,0.00032399,95.29536405
20864,國民平均所得,2,588266,0.00032399,95.29568804
20865,國民生活須知,2,588268,0.00032399,95.29601203
20866,國民所得,2,588270,0.00032399,95.29633601
20867,國民政府,2,588272,0.00032399,95.29666000
20868,國立大學,2,588274,0.00032399,95.29698399
20869,國立編譯館,2,588276,0.00032399,95.29730798
20870,國安局,2,588278,0.00032399,95.29763197
20871,國安局長,2,588280,0.00032399,95.29795596
20872,國有,2,588282,0.00032399,95.29827995
20873,國防醫學中心,2,588284,0.00032399,95.29860393
20874,國是建言,2,588286,0.00032399,95.29892792
20875,國是論壇,2,588288,0.00032399,95.29925191
20876,國家廣播公司,2,588290,0.00032399,95.29957590
20877,國庫局,2,588292,0.00032399,95.29989989
20878,國泰路,2,588294,0.00032399,95.30022388
20879,國教派,2,588296,0.00032399,95.30054786
20880,國術館,2,588298,0.00032399,95.30087185
20881,國喬,2,588300,0.00032399,95.30119584
20882,國策顧問,2,588302,0.00032399,95.30151983
20883,國境,2,588304,0.00032399,95.30184382
20884,國賓瓷,2,588306,0.00032399,95.30216781
20885,國際希爾頓,2,588308,0.00032399,95.30249179
20886,國際投信,2,588310,0.00032399,95.30281578
20887,國際牌,2,588312,0.00032399,95.30313977
20888,國際網際網路,2,588314,0.00032399,95.30346376
20889,國慶日,2,588316,0.00032399,95.30378775
20890,國賠案,2,588318,0.00032399,95.30411174
20891,國難財,2,588320,0.00032399,95.30443573
20892,堅忍,2,588322,0.00032399,95.30475971
20893,堅毅,2,588324,0.00032399,95.30508370
20894,堆集,2,588326,0.00032399,95.30540769
20895,堆積,2,588328,0.00032399,95.30573168
20896,基酒,2,588330,0.00032399,95.30605567
20897,基隆市長,2,588332,0.00032399,95.30637966
20898,基隆市政府,2,588334,0.00032399,95.30670364
20899,基隆河,2,588336,0.00032399,95.30702763
20900,基業,2,588338,0.00032399,95.30735162
20901,基德福來口才訓練學校,2,588340,0.00032399,95.30767561
20902,堂皇,2,588342,0.00032399,95.30799960
20903,執意,2,588344,0.00032399,95.30832359
20904,執業者,2,588346,0.00032399,95.30864758
20905,執業牌照,2,588348,0.00032399,95.30897156
20906,培根,2,588350,0.00032399,95.30929555
20907,培植,2,588352,0.00032399,95.30961954
20908,培殖,2,588354,0.00032399,95.30994353
20909,奢望,2,588356,0.00032399,95.31026752
20910,婉約,2,588358,0.00032399,95.31059151
20911,婦,2,588360,0.00032399,95.31091549
20912,婚事,2,588362,0.00032399,95.31123948
20913,婆家,2,588364,0.00032399,95.31156347
20914,寄生蟲,2,588366,0.00032399,95.31188746
20915,寄託,2,588368,0.00032399,95.31221145
20916,寄養家庭,2,588370,0.00032399,95.31253544
20917,寂寞芳心俱樂部,2,588372,0.00032399,95.31285942
20918,密封,2,588374,0.00032399,95.31318341
20919,專一,2,588376,0.00032399,95.31350740
20920,專文,2,588378,0.00032399,95.31383139
20921,專供,2,588380,0.00032399,95.31415538
20922,專科,2,588382,0.00032399,95.31447937
20923,專書,2,588384,0.00032399,95.31480336
20924,專業人士,2,588386,0.00032399,95.31512734
20925,專業版,2,588388,0.00032399,95.31545133
20926,專賣,2,588390,0.00032399,95.31577532
20927,專職,2,588392,0.00032399,95.31609931
20928,屠妖節,2,588394,0.00032399,95.31642330
20929,崇尚,2,588396,0.00032399,95.31674729
20930,崩盤,2,588398,0.00032399,95.31707127
20931,巢穴,2,588400,0.00032399,95.31739526
20932,常年,2,588402,0.00032399,95.31771925
20933,常務董事,2,588404,0.00032399,95.31804324
20934,常理,2,588406,0.00032399,95.31836723
20935,常董,2,588408,0.00032399,95.31869122
20936,帶隊,2,588410,0.00032399,95.31901520
20937,帳目,2,588412,0.00032399,95.31933919
20938,帳蓬,2,588414,0.00032399,95.31966318
20939,康定號,2,588416,0.00032399,95.31998717
20940,康博,2,588418,0.00032399,95.32031116
20941,庸,2,588420,0.00032399,95.32063515
20942,庸庸碌碌,2,588422,0.00032399,95.32095914
20943,張三舜,2,588424,0.00032399,95.32128312
20944,張子源,2,588426,0.00032399,95.32160711
20945,張正,2,588428,0.00032399,95.32193110
20946,張志輝,2,588430,0.00032399,95.32225509
20947,張昌邦,2,588432,0.00032399,95.32257908
20948,張家豪,2,588434,0.00032399,95.32290307
20949,張庭,2,588436,0.00032399,95.32322705
20950,張啟疆,2,588438,0.00032399,95.32355104
20951,張清芳,2,588440,0.00032399,95.32387503
20952,張淑芬,2,588442,0.00032399,95.32419902
20953,張菲,2,588444,0.00032399,95.32452301
20954,張愛玲,2,588446,0.00032399,95.32484700
20955,張瑞德,2,588448,0.00032399,95.32517098
20956,張潭禮,2,588450,0.00032399,95.32549497
20957,張輝銜,2,588452,0.00032399,95.32581896
20958,強人,2,588454,0.00032399,95.32614295
20959,強光,2,588456,0.00032399,95.32646694
20960,強而有力,2,588458,0.00032399,95.32679093
20961,強攻,2,588460,0.00032399,95.32711492
20962,強制性,2,588462,0.00032399,95.32743890
20963,強押,2,588464,0.00032399,95.32776289
20964,強姦,2,588466,0.00032399,95.32808688
20965,強盛,2,588468,0.00032399,95.32841087
20966,彩度,2,588470,0.00032399,95.32873486
20967,得心應手,2,588472,0.00032399,95.32905885
20968,得宜,2,588474,0.00032399,95.32938283
20969,得意忘形,2,588476,0.00032399,95.32970682
20970,得體,2,588478,0.00032399,95.33003081
20971,從缺,2,588480,0.00032399,95.33035480
20972,從頭到尾,2,588482,0.00032399,95.33067879
20973,御,2,588484,0.00032399,95.33100278
20974,患有,2,588486,0.00032399,95.33132676
20975,患孩,2,588488,0.00032399,95.33165075
20976,患病,2,588490,0.00032399,95.33197474
20977,患得患失,2,588492,0.00032399,95.33229873
20978,患難,2,588494,0.00032399,95.33262272
20979,悠,2,588496,0.00032399,95.33294671
20980,悠游,2,588498,0.00032399,95.33327070
20981,惋惜,2,588500,0.00032399,95.33359468
20982,情色,2,588502,0.00032399,95.33391867
20983,情治單位,2,588504,0.00032399,95.33424266
20984,情侶,2,588506,0.00032399,95.33456665
20985,情急,2,588508,0.00032399,95.33489064
20986,情書,2,588510,0.00032399,95.33521463
20987,情報局,2,588512,0.00032399,95.33553861
20988,情報局長,2,588514,0.00032399,95.33586260
20989,情緒化,2,588516,0.00032399,95.33618659
20990,情調,2,588518,0.00032399,95.33651058
20991,戚瑞國,2,588520,0.00032399,95.33683457
20992,控制器,2,588522,0.00032399,95.33715856
20993,控制點,2,588524,0.00032399,95.33748255
20994,控制權,2,588526,0.00032399,95.33780653
20995,控球,2,588528,0.00032399,95.33813052
20996,控管,2,588530,0.00032399,95.33845451
20997,捲軸,2,588532,0.00032399,95.33877850
20998,探查,2,588534,0.00032399,95.33910249
20999,探視,2,588536,0.00032399,95.33942648
21000,探試,2,588538,0.00032399,95.33975046
21001,探親,2,588540,0.00032399,95.34007445
21002,接力,2,588542,0.00032399,95.34039844
21003,接在,2,588544,0.00032399,95.34072243
21004,接待人員,2,588546,0.00032399,95.34104642
21005,接納,2,588548,0.00032399,95.34137041
21006,接送,2,588550,0.00032399,95.34169439
21007,接頭,2,588552,0.00032399,95.34201838
21008,接應,2,588554,0.00032399,95.34234237
21009,接縫處,2,588556,0.00032399,95.34266636
21010,接觸性皮膚炎,2,588558,0.00032399,95.34299035
21011,捷安特公司,2,588560,0.00032399,95.34331434
21012,捷運局,2,588562,0.00032399,95.34363833
21013,捷運淡水線,2,588564,0.00032399,95.34396231
21014,捧腹大笑,2,588566,0.00032399,95.34428630
21015,掩蔽,2,588568,0.00032399,95.34461029
21016,掉以輕心,2,588570,0.00032399,95.34493428
21017,掃蕩,2,588572,0.00032399,95.34525827
21018,掛勾,2,588574,0.00032399,95.34558226
21019,掛名,2,588576,0.00032399,95.34590624
21020,掛念,2,588578,0.00032399,95.34623023
21021,掛號,2,588580,0.00032399,95.34655422
21022,推升,2,588582,0.00032399,95.34687821
21023,推估,2,588584,0.00032399,95.34720220
21024,推定,2,588586,0.00032399,95.34752619
21025,推拿,2,588588,0.00032399,95.34785017
21026,推案量,2,588590,0.00032399,95.34817416
21027,推開,2,588592,0.00032399,95.34849815
21028,授,2,588594,0.00032399,95.34882214
21029,授予,2,588596,0.00032399,95.34914613
21030,授課,2,588598,0.00032399,95.34947012
21031,採納,2,588600,0.00032399,95.34979411
21032,採樣,2,588602,0.00032399,95.35011809
21033,排水量,2,588604,0.00032399,95.35044208
21034,排片,2,588606,0.00032399,95.35076607
21035,排拒,2,588608,0.00032399,95.35109006
21036,排泄物,2,588610,0.00032399,95.35141405
21037,排洪,2,588612,0.00032399,95.35173804
21038,排氣閥,2,588614,0.00032399,95.35206202
21039,排鐵劑,2,588616,0.00032399,95.35238601
21040,掀出來,2,588618,0.00032399,95.35271000
21041,救生員,2,588620,0.00032399,95.35303399
21042,救災,2,588622,0.00032399,95.35335798
21043,救命,2,588624,0.00032399,95.35368197
21044,救治,2,588626,0.00032399,95.35400595
21045,救國團,2,588628,0.00032399,95.35432994
21046,救援王,2,588630,0.00032399,95.35465393
21047,救濟,2,588632,0.00032399,95.35497792
21048,教士,2,588634,0.00032399,95.35530191
21049,教友,2,588636,0.00032399,95.35562590
21050,教主,2,588638,0.00032399,95.35594989
21051,教育者,2,588640,0.00032399,95.35627387
21052,教育界,2,588642,0.00032399,95.35659786
21053,教育家,2,588644,0.00032399,95.35692185
21054,教育審查會,2,588646,0.00032399,95.35724584
21055,教育廳,2,588648,0.00032399,95.35756983
21056,教官,2,588650,0.00032399,95.35789382
21057,教員,2,588652,0.00032399,95.35821780
21058,教師法律手冊,2,588654,0.00032399,95.35854179
21059,教書,2,588656,0.00032399,95.35886578
21060,教職員,2,588658,0.00032399,95.35918977
21061,敗投,2,588660,0.00032399,95.35951376
21062,敗筆,2,588662,0.00032399,95.35983775
21063,啟事,2,588664,0.00032399,95.36016173
21064,敏,2,588666,0.00032399,95.36048572
21065,斜斜,2,588668,0.00032399,95.36080971
21066,旋即,2,588670,0.00032399,95.36113370
21067,晚年,2,588672,0.00032399,95.36145769
21068,曹,2,588674,0.00032399,95.36178168
21069,曹操,2,588676,0.00032399,95.36210567
21070,望塵莫及,2,588678,0.00032399,95.36242965
21071,桿菌,2,588680,0.00032399,95.36275364
21072,械鬥,2,588682,0.00032399,95.36307763
21073,棄守,2,588684,0.00032399,95.36340162
21074,棄置,2,588686,0.00032399,95.36372561
21075,梅雨,2,588688,0.00032399,95.36404960
21076,梅毒,2,588690,0.00032399,95.36437358
21077,梅格萊恩,2,588692,0.00032399,95.36469757
21078,梅蘭妮葛莉芬,2,588694,0.00032399,95.36502156
21079,梔子,2,588696,0.00032399,95.36534555
21080,梨,2,588698,0.00032399,95.36566954
21081,梨子,2,588700,0.00032399,95.36599353
21082,殺人案,2,588702,0.00032399,95.36631752
21083,殺手級,2,588704,0.00032399,95.36664150
21084,殺傷力,2,588706,0.00032399,95.36696549
21085,涼鞋,2,588708,0.00032399,95.36728948
21086,液狀,2,588710,0.00032399,95.36761347
21087,淡化,2,588712,0.00032399,95.36793746
21088,淡忘,2,588714,0.00032399,95.36826145
21089,淡季,2,588716,0.00032399,95.36858543
21090,淺嘗,2,588718,0.00032399,95.36890942
21091,清早,2,588720,0.00032399,95.36923341
21092,清冷,2,588722,0.00032399,95.36955740
21093,清明,2,588724,0.00032399,95.36988139
21094,清亮,2,588726,0.00032399,95.37020538
21095,清香,2,588728,0.00032399,95.37052936
21096,清唱劇,2,588730,0.00032399,95.37085335
21097,清掃,2,588732,0.00032399,95.37117734
21098,清清楚楚,2,588734,0.00032399,95.37150133
21099,清貧,2,588736,0.00032399,95.37182532
21100,清晰度,2,588738,0.00032399,95.37214931
21101,清朝,2,588740,0.00032399,95.37247330
21102,清廉,2,588742,0.00032399,95.37279728
21103,清境農場,2,588744,0.00032399,95.37312127
21104,清算,2,588746,0.00032399,95.37344526
21105,清潔劑,2,588748,0.00032399,95.37376925
21106,清靜,2,588750,0.00032399,95.37409324
21107,淋,2,588752,0.00032399,95.37441723
21108,淑女,2,588754,0.00032399,95.37474121
21109,淹死,2,588756,0.00032399,95.37506520
21110,混合體,2,588758,0.00032399,95.37538919
21111,混沌,2,588760,0.00032399,95.37571318
21112,淵博,2,588762,0.00032399,95.37603717
21113,淒涼,2,588764,0.00032399,95.37636116
21114,涵,2,588766,0.00032399,95.37668514
21115,淚珠,2,588768,0.00032399,95.37700913
21116,淫,2,588770,0.00032399,95.37733312
21117,深沉,2,588772,0.00032399,95.37765711
21118,深淺,2,588774,0.00032399,95.37798110
21119,深造,2,588776,0.00032399,95.37830509
21120,深陷,2,588778,0.00032399,95.37862908
21121,深澳漁港,2,588780,0.00032399,95.37895306
21122,淨法寺,2,588782,0.00032399,95.37927705
21123,淨灘,2,588784,0.00032399,95.37960104
21124,烽火佳人,2,588786,0.00032399,95.37992503
21125,爽,2,588788,0.00032399,95.38024902
21126,爽快,2,588790,0.00032399,95.38057301
21127,牽動,2,588792,0.00032399,95.38089699
21128,牽強,2,588794,0.00032399,95.38122098
21129,牽絆,2,588796,0.00032399,95.38154497
21130,牽繫,2,588798,0.00032399,95.38186896
21131,猜測,2,588800,0.00032399,95.38219295
21132,猛追,2,588802,0.00032399,95.38251694
21133,猛然,2,588804,0.00032399,95.38284092
21134,猖獗,2,588806,0.00032399,95.38316491
21135,球衣,2,588808,0.00032399,95.38348890
21136,球棒,2,588810,0.00032399,95.38381289
21137,理事,2,588812,0.00032399,95.38413688
21138,理直氣壯,2,588814,0.00032399,95.38446087
21139,理賠,2,588816,0.00032399,95.38478486
21140,理學,2,588818,0.00032399,95.38510884
21141,現款,2,588820,0.00032399,95.38543283
21142,瓶瓶罐罐,2,588822,0.00032399,95.38575682
21143,甜度,2,588824,0.00032399,95.38608081
21144,甜酒,2,588826,0.00032399,95.38640480
21145,產出,2,588828,0.00032399,95.38672879
21146,產業道路,2,588830,0.00032399,95.38705277
21147,產銷班,2,588832,0.00032399,95.38737676
21148,畢業旅行,2,588834,0.00032399,95.38770075
21149,異國,2,588836,0.00032399,95.38802474
21150,異族,2,588838,0.00032399,95.38834873
21151,異類,2,588840,0.00032399,95.38867272
21152,疏,2,588842,0.00032399,95.38899670
21153,疏通,2,588844,0.00032399,95.38932069
21154,盔甲,2,588846,0.00032399,95.38964468
21155,盛夏,2,588848,0.00032399,95.38996867
21156,盛產,2,588850,0.00032399,95.39029266
21157,盛產期,2,588852,0.00032399,95.39061665
21158,盛會,2,588854,0.00032399,95.39094064
21159,眷,2,588856,0.00032399,95.39126462
21160,眷村,2,588858,0.00032399,95.39158861
21161,眷顧,2,588860,0.00032399,95.39191260
21162,眾矢之的,2,588862,0.00032399,95.39223659
21163,眾所皆知,2,588864,0.00032399,95.39256058
21164,眼尖,2,588866,0.00032399,95.39288457
21165,眼尾,2,588868,0.00032399,95.39320855
21166,眼花撩亂,2,588870,0.00032399,95.39353254
21167,眼界,2,588872,0.00032399,95.39385653
21168,眼看,2,588874,0.00032399,95.39418052
21169,眼科,2,588876,0.00032399,95.39450451
21170,眼裡,2,588878,0.00032399,95.39482850
21171,眼影粉,2,588880,0.00032399,95.39515249
21172,眼線筆刷,2,588882,0.00032399,95.39547647
21173,硫黃,2,588884,0.00032399,95.39580046
21174,硫酸氣,2,588886,0.00032399,95.39612445
21175,祥裕電子,2,588888,0.00032399,95.39644844
21176,票源,2,588890,0.00032399,95.39677243
21177,祭祀,2,588892,0.00032399,95.39709642
21178,祭拜,2,588894,0.00032399,95.39742040
21179,祭壇,2,588896,0.00032399,95.39774439
21180,移送法辦,2,588898,0.00032399,95.39806838
21181,移靈,2,588900,0.00032399,95.39839237
21182,笠,2,588902,0.00032399,95.39871636
21183,笨重,2,588904,0.00032399,95.39904035
21184,笨蛋,2,588906,0.00032399,95.39936433
21185,笛卡,2,588908,0.00032399,95.39968832
21186,笛卡公司,2,588910,0.00032399,95.40001231
21187,第一信託,2,588912,0.00032399,95.40033630
21188,第一時間,2,588914,0.00032399,95.40066029
21189,第一銀行,2,588916,0.00032399,95.40098428
21190,第一線,2,588918,0.00032399,95.40130827
21191,第二預備金,2,588920,0.00032399,95.40163225
21192,第三人,2,588922,0.00032399,95.40195624
21193,第三季,2,588924,0.00032399,95.40228023
21194,第三屆中國兒童水墨畫展,2,588926,0.00032399,95.40260422
21195,第三號交響曲,2,588928,0.00032399,95.40292821
21196,符,2,588930,0.00032399,95.40325220
21197,符咒,2,588932,0.00032399,95.40357618
21198,粗俗,2,588934,0.00032399,95.40390017
21199,粗茶淡飯,2,588936,0.00032399,95.40422416
21200,粗淺,2,588938,0.00032399,95.40454815
21201,粗略,2,588940,0.00032399,95.40487214
21202,粗細,2,588942,0.00032399,95.40519613
21203,統一左岸咖啡館,2,588944,0.00032399,95.40552011
21204,統一超商,2,588946,0.00032399,95.40584410
21205,統獨,2,588948,0.00032399,95.40616809
21206,紹興人,2,588950,0.00032399,95.40649208
21207,細胞膜,2,588952,0.00032399,95.40681607
21208,細嫩,2,588954,0.00032399,95.40714006
21209,組工會,2,588956,0.00032399,95.40746405
21210,組合木屋,2,588958,0.00032399,95.40778803
21211,組合語言,2,588960,0.00032399,95.40811202
21212,組裝業,2,588962,0.00032399,95.40843601
21213,組態,2,588964,0.00032399,95.40876000
21214,組職,2,588966,0.00032399,95.40908399
21215,累贅,2,588968,0.00032399,95.40940798
21216,終結,2,588970,0.00032399,95.40973196
21217,羚羊,2,588972,0.00032399,95.41005595
21218,習作,2,588974,0.00032399,95.41037994
21219,習俗,2,588976,0.00032399,95.41070393
21220,習氣,2,588978,0.00032399,95.41102792
21221,聊聊天,2,588980,0.00032399,95.41135191
21222,聆聽者,2,588982,0.00032399,95.41167589
21223,脫手,2,588984,0.00032399,95.41199988
21224,脫序,2,588986,0.00032399,95.41232387
21225,脫產,2,588988,0.00032399,95.41264786
21226,脫節,2,588990,0.00032399,95.41297185
21227,舷寬,2,588992,0.00032399,95.41329584
21228,船山,2,588994,0.00032399,95.41361983
21229,船員,2,588996,0.00032399,95.41394381
21230,船舶,2,588998,0.00032399,95.41426780
21231,船隊,2,589000,0.00032399,95.41459179
21232,船艙,2,589002,0.00032399,95.41491578
21233,莞爾,2,589004,0.00032399,95.41523977
21234,莖,2,589006,0.00032399,95.41556376
21235,莫三比克,2,589008,0.00032399,95.41588774
21236,莫里哀,2,589010,0.00032399,95.41621173
21237,莒光號,2,589012,0.00032399,95.41653572
21238,莊建中,2,589014,0.00032399,95.41685971
21239,荷池,2,589016,0.00032399,95.41718370
21240,荷蘭式,2,589018,0.00032399,95.41750769
21241,蛋糕,2,589020,0.00032399,95.41783167
21242,蛋雞,2,589022,0.00032399,95.41815566
21243,術式,2,589024,0.00032399,95.41847965
21244,被害,2,589026,0.00032399,95.41880364
21245,被攝體,2,589028,0.00032399,95.41912763
21246,袖口,2,589030,0.00032399,95.41945162
21247,袋口,2,589032,0.00032399,95.41977561
21248,袋鼠,2,589034,0.00032399,95.42009959
21249,覓食,2,589036,0.00032399,95.42042358
21250,規,2,589038,0.00032399,95.42074757
21251,規畫案,2,589040,0.00032399,95.42107156
21252,規程,2,589042,0.00032399,95.42139555
21253,規模感,2,589044,0.00032399,95.42171954
21254,規勸,2,589046,0.00032399,95.42204352
21255,訪台,2,589048,0.00032399,95.42236751
21256,訪客,2,589050,0.00032399,95.42269150
21257,訪美,2,589052,0.00032399,95.42301549
21258,訪問記,2,589054,0.00032399,95.42333948
21259,訪華,2,589056,0.00032399,95.42366347
21260,訪視,2,589058,0.00032399,95.42398746
21261,訣竅,2,589060,0.00032399,95.42431144
21262,許永邦,2,589062,0.00032399,95.42463543
21263,許永傳,2,589064,0.00032399,95.42495942
21264,設有,2,589066,0.00032399,95.42528341
21265,設防,2,589068,0.00032399,95.42560740
21266,設定值,2,589070,0.00032399,95.42593139
21267,設計顧問,2,589072,0.00032399,95.42625537
21268,設宴,2,589074,0.00032399,95.42657936
21269,販,2,589076,0.00032399,95.42690335
21270,責任政治,2,589078,0.00032399,95.42722734
21271,責任感,2,589080,0.00032399,95.42755133
21272,貫串,2,589082,0.00032399,95.42787532
21273,貪官污吏,2,589084,0.00032399,95.42819930
21274,貪念,2,589086,0.00032399,95.42852329
21275,貪圖,2,589088,0.00032399,95.42884728
21276,貧乏,2,589090,0.00032399,95.42917127
21277,貧困,2,589092,0.00032399,95.42949526
21278,赦免,2,589094,0.00032399,95.42981925
21279,軟式,2,589096,0.00032399,95.43014324
21280,軟身操,2,589098,0.00032399,95.43046722
21281,軟硬,2,589100,0.00032399,95.43079121
21282,軟硬兼施,2,589102,0.00032399,95.43111520
21283,這回,2,589104,0.00032399,95.43143919
21284,這波,2,589106,0.00032399,95.43176318
21285,這邊,2,589108,0.00032399,95.43208717
21286,通用汽車,2,589110,0.00032399,95.43241115
21287,通函,2,589112,0.00032399,95.43273514
21288,通俗,2,589114,0.00032399,95.43305913
21289,通風報信,2,589116,0.00032399,95.43338312
21290,通訊平台,2,589118,0.00032399,95.43370711
21291,通貨,2,589120,0.00032399,95.43403110
21292,通報,2,589122,0.00032399,95.43435508
21293,通融,2,589124,0.00032399,95.43467907
21294,逗趣,2,589126,0.00032399,95.43500306
21295,連玉芬,2,589128,0.00032399,95.43532705
21296,連長,2,589130,0.00032399,95.43565104
21297,連接線,2,589132,0.00032399,95.43597503
21298,連桿,2,589134,0.00032399,95.43629902
21299,連鎖業者,2,589136,0.00032399,95.43662300
21300,連攝,2,589138,0.00032399,95.43694699
21301,速寫,2,589140,0.00032399,95.43727098
21302,逐年,2,589142,0.00032399,95.43759497
21303,逕自,2,589144,0.00032399,95.43791896
21304,造粒機,2,589146,0.00032399,95.43824295
21305,造模,2,589148,0.00032399,95.43856693
21306,透明色,2,589150,0.00032399,95.43889092
21307,透析,2,589152,0.00032399,95.43921491
21308,透氣,2,589154,0.00032399,95.43953890
21309,透氣性,2,589156,0.00032399,95.43986289
21310,透視法,2,589158,0.00032399,95.44018688
21311,透徹,2,589160,0.00032399,95.44051086
21312,郭守仁,2,589162,0.00032399,95.44083485
21313,郭忠坤,2,589164,0.00032399,95.44115884
21314,郭俊男,2,589166,0.00032399,95.44148283
21315,郭鶴年,2,589168,0.00032399,95.44180682
21316,都市計畫,2,589170,0.00032399,95.44213081
21317,都市計畫委員會,2,589172,0.00032399,95.44245480
21318,都市發展局,2,589174,0.00032399,95.44277878
21319,酗酒,2,589176,0.00032399,95.44310277
21320,野心勃勃,2,589178,0.00032399,95.44342676
21321,野外,2,589180,0.00032399,95.44375075
21322,野生動物保育法,2,589182,0.00032399,95.44407474
21323,野性,2,589184,0.00032399,95.44439873
21324,野戰,2,589186,0.00032399,95.44472271
21325,野餐,2,589188,0.00032399,95.44504670
21326,野鴨,2,589190,0.00032399,95.44537069
21327,野獸,2,589192,0.00032399,95.44569468
21328,野蠻,2,589194,0.00032399,95.44601867
21329,釣魚,2,589196,0.00032399,95.44634266
21330,閉路電視,2,589198,0.00032399,95.44666665
21331,陪襯,2,589200,0.00032399,95.44699063
21332,陳大豐,2,589202,0.00032399,95.44731462
21333,陳小春,2,589204,0.00032399,95.44763861
21334,陳文浩,2,589206,0.00032399,95.44796260
21335,陳月寶,2,589208,0.00032399,95.44828659
21336,陳水在,2,589210,0.00032399,95.44861058
21337,陳水旺,2,589212,0.00032399,95.44893456
21338,陳世平,2,589214,0.00032399,95.44925855
21339,陳世圯,2,589216,0.00032399,95.44958254
21340,陳永峰,2,589218,0.00032399,95.44990653
21341,陳玉葉,2,589220,0.00032399,95.45023052
21342,陳田圃,2,589222,0.00032399,95.45055451
21343,陳田錨,2,589224,0.00032399,95.45087849
21344,陳光榮,2,589226,0.00032399,95.45120248
21345,陳卓雲,2,589228,0.00032399,95.45152647
21346,陳宗霖,2,589230,0.00032399,95.45185046
21347,陳岳,2,589232,0.00032399,95.45217445
21348,陳庚金,2,589234,0.00032399,95.45249844
21349,陳金泉,2,589236,0.00032399,95.45282243
21350,陳建發,2,589238,0.00032399,95.45314641
21351,陳建勳,2,589240,0.00032399,95.45347040
21352,陳師孟,2,589242,0.00032399,95.45379439
21353,陳健治,2,589244,0.00032399,95.45411838
21354,陳婉真,2,589246,0.00032399,95.45444237
21355,陳情書,2,589248,0.00032399,95.45476636
21356,陳敏鳳,2,589250,0.00032399,95.45509034
21357,陳聆薇,2,589252,0.00032399,95.45541433
21358,陳設,2,589254,0.00032399,95.45573832
21359,陳凱歌,2,589256,0.00032399,95.45606231
21360,陳堯,2,589258,0.00032399,95.45638630
21361,陳雲上,2,589260,0.00032399,95.45671029
21362,陳榮宗,2,589262,0.00032399,95.45703427
21363,陳銀祿,2,589264,0.00032399,95.45735826
21364,陳德容,2,589266,0.00032399,95.45768225
21365,陳慶松,2,589268,0.00032399,95.45800624
21366,陳慧昊,2,589270,0.00032399,95.45833023
21367,陳慧琳,2,589272,0.00032399,95.45865422
21368,陳豐義,2,589274,0.00032399,95.45897821
21369,陸上,2,589276,0.00032399,95.45930219
21370,陸光,2,589278,0.00032399,95.45962618
21371,陸軍總部,2,589280,0.00032399,95.45995017
21372,陸路,2,589282,0.00032399,95.46027416
21373,陸戰隊,2,589284,0.00032399,95.46059815
21374,陸儼少,2,589286,0.00032399,95.46092214
21375,陰陽,2,589288,0.00032399,95.46124612
21376,陰囊,2,589290,0.00032399,95.46157011
21377,陰鬱,2,589292,0.00032399,95.46189410
21378,陶,2,589294,0.00032399,95.46221809
21379,陶器品,2,589296,0.00032399,95.46254208
21380,雀屏中選,2,589298,0.00032399,95.46286607
21381,雀斑,2,589300,0.00032399,95.46319005
21382,雪上加霜,2,589302,0.00032399,95.46351404
21383,雪山,2,589304,0.00032399,95.46383803
21384,雪梨港,2,589306,0.00032399,95.46416202
21385,雪梨塔,2,589308,0.00032399,95.46448601
21386,雪梨爵士,2,589310,0.00032399,95.46481000
21387,章法,2,589312,0.00032399,95.46513399
21388,頂部,2,589314,0.00032399,95.46545797
21389,頂替,2,589316,0.00032399,95.46578196
21390,頂層,2,589318,0.00032399,95.46610595
21391,頂點,2,589320,0.00032399,95.46642994
21392,頃刻,2,589322,0.00032399,95.46675393
21393,魚尾,2,589324,0.00032399,95.46707792
21394,魚尾紋,2,589326,0.00032399,95.46740190
21395,魚貝類,2,589328,0.00032399,95.46772589
21396,魚型,2,589330,0.00032399,95.46804988
21397,魚翅,2,589332,0.00032399,95.46837387
21398,魚乾,2,589334,0.00032399,95.46869786
21399,魚眼,2,589336,0.00032399,95.46902185
21400,魚雷艇,2,589338,0.00032399,95.46934583
21401,魚露,2,589340,0.00032399,95.46966982
21402,鳥主,2,589342,0.00032399,95.46999381
21403,鳥瞰,2,589344,0.00032399,95.47031780
21404,鹿群,2,589346,0.00032399,95.47064179
21405,麥克赫吉,2,589348,0.00032399,95.47096578
21406,麥芽糖,2,589350,0.00032399,95.47128977
21407,麥金塔軟體,2,589352,0.00032399,95.47161375
21408,麥瑞迪斯,2,589354,0.00032399,95.47193774
21409,麥道,2,589356,0.00032399,95.47226173
21410,麥寮,2,589358,0.00032399,95.47258572
21411,麥積山,2,589360,0.00032399,95.47290971
21412,麻布,2,589362,0.00032399,95.47323370
21413,麻省理工學院,2,589364,0.00032399,95.47355768
21414,麻醉,2,589366,0.00032399,95.47388167
21415,麻藥,2,589368,0.00032399,95.47420566
21416,傑,2,589370,0.00032399,95.47452965
21417,傑克．坎菲爾,2,589372,0.00032399,95.47485364
21418,傑森派屈克,2,589374,0.00032399,95.47517763
21419,最有價值球員,2,589376,0.00032399,95.47550162
21420,最佳女配角獎,2,589378,0.00032399,95.47582560
21421,最佳化,2,589380,0.00032399,95.47614959
21422,最高法院,2,589382,0.00032399,95.47647358
21423,凱西,2,589384,0.00032399,95.47679757
21424,凱林,2,589386,0.00032399,95.47712156
21425,凱旋一路,2,589388,0.00032399,95.47744555
21426,凱旋醫院,2,589390,0.00032399,95.47776953
21427,凱瑟琳,2,589392,0.00032399,95.47809352
21428,割除,2,589394,0.00032399,95.47841751
21429,割捨,2,589396,0.00032399,95.47874150
21430,割腕,2,589398,0.00032399,95.47906549
21431,創世紀,2,589400,0.00032399,95.47938948
21432,創作力,2,589402,0.00032399,95.47971346
21433,創始人,2,589404,0.00032399,95.48003745
21434,創建,2,589406,0.00032399,95.48036144
21435,創意部,2,589408,0.00032399,95.48068543
21436,創業者,2,589410,0.00032399,95.48100942
21437,勞力士,2,589412,0.00032399,95.48133341
21438,勞勃,2,589414,0.00032399,95.48165740
21439,勞軍,2,589416,0.00032399,95.48198138
21440,勞駕,2,589418,0.00032399,95.48230537
21441,勝基,2,589420,0.00032399,95.48262936
21442,勝景,2,589422,0.00032399,95.48295335
21443,勝選,2,589424,0.00032399,95.48327734
21444,博取,2,589426,0.00032399,95.48360133
21445,博新二台,2,589428,0.00032399,95.48392531
21446,喀麥隆,2,589430,0.00032399,95.48424930
21447,喧囂,2,589432,0.00032399,95.48457329
21448,喊話,2,589434,0.00032399,95.48489728
21449,喊價,2,589436,0.00032399,95.48522127
21450,喝起來,2,589438,0.00032399,95.48554526
21451,喂,2,589440,0.00032399,95.48586924
21452,喜事,2,589442,0.00032399,95.48619323
21453,喜美,2,589444,0.00032399,95.48651722
21454,喜感,2,589446,0.00032399,95.48684121
21455,喜樂,2,589448,0.00032399,95.48716520
21456,喪氣,2,589450,0.00032399,95.48748919
21457,喇叭褲,2,589452,0.00032399,95.48781318
21458,單人,2,589454,0.00032399,95.48813716
21459,單元劇,2,589456,0.00032399,95.48846115
21460,單色,2,589458,0.00032399,95.48878514
21461,單身漢,2,589460,0.00032399,95.48910913
21462,單店,2,589462,0.00032399,95.48943312
21463,單穿,2,589464,0.00032399,95.48975711
21464,單純化,2,589466,0.00032399,95.49008109
21465,單側,2,589468,0.00032399,95.49040508
21466,單程,2,589470,0.00032399,95.49072907
21467,單槽,2,589472,0.00032399,95.49105306
21468,單據,2,589474,0.00032399,95.49137705
21469,單機,2,589476,0.00032399,95.49170104
21470,單聲道,2,589478,0.00032399,95.49202502
21471,喬,2,589480,0.00032399,95.49234901
21472,喬治亞州,2,589482,0.00032399,95.49267300
21473,圍攻,2,589484,0.00032399,95.49299699
21474,圍兜,2,589486,0.00032399,95.49332098
21475,圍棋,2,589488,0.00032399,95.49364497
21476,堪用,2,589490,0.00032399,95.49396896
21477,堪薩斯,2,589492,0.00032399,95.49429294
21478,報身,2,589494,0.00032399,95.49461693
21479,報關行,2,589496,0.00032399,95.49494092
21480,報關業,2,589498,0.00032399,95.49526491
21481,奠下,2,589500,0.00032399,95.49558890
21482,媒,2,589502,0.00032399,95.49591289
21483,寒流,2,589504,0.00032399,95.49623687
21484,寒顫,2,589506,0.00032399,95.49656086
21485,富士山,2,589508,0.00032399,95.49688485
21486,富岡,2,589510,0.00032399,95.49720884
21487,富麗堂皇,2,589512,0.00032399,95.49753283
21488,寓言,2,589514,0.00032399,95.49785682
21489,尊稱,2,589516,0.00032399,95.49818080
21490,尋回,2,589518,0.00032399,95.49850479
21491,尋獲,2,589520,0.00032399,95.49882878
21492,就地,2,589522,0.00032399,95.49915277
21493,就診,2,589524,0.00032399,95.49947676
21494,就業服務中心,2,589526,0.00032399,95.49980075
21495,就緒,2,589528,0.00032399,95.50012474
21496,帽,2,589530,0.00032399,95.50044872
21497,幀,2,589532,0.00032399,95.50077271
21498,幾次,2,589534,0.00032399,95.50109670
21499,幾何,2,589536,0.00032399,95.50142069
21500,幾何形,2,589538,0.00032399,95.50174468
21501,廂房,2,589540,0.00032399,95.50206867
21502,彭山,2,589542,0.00032399,95.50239265
21503,復合,2,589544,0.00032399,95.50271664
21504,復興段,2,589546,0.00032399,95.50304063
21505,復興高中,2,589548,0.00032399,95.50336462
21506,復興鄉代會,2,589550,0.00032399,95.50368861
21507,復興路,2,589552,0.00032399,95.50401260
21508,循環期,2,589554,0.00032399,95.50433659
21509,惡性循環,2,589556,0.00032399,95.50466057
21510,惡性腫瘤,2,589558,0.00032399,95.50498456
21511,惡緣,2,589560,0.00032399,95.50530855
21512,惡質,2,589562,0.00032399,95.50563254
21513,惡質化,2,589564,0.00032399,95.50595653
21514,悲天憫人,2,589566,0.00032399,95.50628052
21515,悲痛,2,589568,0.00032399,95.50660450
21516,悲觀者,2,589570,0.00032399,95.50692849
21517,惠,2,589572,0.00032399,95.50725248
21518,惠妮休斯頓,2,589574,0.00032399,95.50757647
21519,惠特尼美術館,2,589576,0.00032399,95.50790046
21520,惰性,2,589578,0.00032399,95.50822445
21521,惻隱之心,2,589580,0.00032399,95.50854843
21522,慨,2,589582,0.00032399,95.50887242
21523,惶恐,2,589584,0.00032399,95.50919641
21524,描,2,589586,0.00032399,95.50952040
21525,描出,2,589588,0.00032399,95.50984439
21526,插手,2,589590,0.00032399,95.51016838
21527,揣,2,589592,0.00032399,95.51049237
21528,提出來,2,589594,0.00032399,95.51081635
21529,提交,2,589596,0.00032399,95.51114034
21530,提名權,2,589598,0.00032399,95.51146433
21531,提把,2,589600,0.00032399,95.51178832
21532,提要,2,589602,0.00032399,95.51211231
21533,提問,2,589604,0.00032399,95.51243630
21534,提現,2,589606,0.00032399,95.51276028
21535,提款卡,2,589608,0.00032399,95.51308427
21536,提請,2,589610,0.00032399,95.51340826
21537,提親,2,589612,0.00032399,95.51373225
21538,握有,2,589614,0.00032399,95.51405624
21539,揭露,2,589616,0.00032399,95.51438023
21540,揮別,2,589618,0.00032399,95.51470421
21541,揮毫,2,589620,0.00032399,95.51502820
21542,揪,2,589622,0.00032399,95.51535219
21543,換人,2,589624,0.00032399,95.51567618
21544,換氣,2,589626,0.00032399,95.51600017
21545,換算成,2,589628,0.00032399,95.51632416
21546,摒除,2,589630,0.00032399,95.51664815
21547,揚眉吐氣,2,589632,0.00032399,95.51697213
21548,揹,2,589634,0.00032399,95.51729612
21549,敞篷,2,589636,0.00032399,95.51762011
21550,敦南科技,2,589638,0.00032399,95.51794410
21551,散失,2,589640,0.00032399,95.51826809
21552,散布,2,589642,0.00032399,95.51859208
21553,散居,2,589644,0.00032399,95.51891606
21554,散漫,2,589646,0.00032399,95.51924005
21555,斑,2,589648,0.00032399,95.51956404
21556,斑海豚,2,589650,0.00032399,95.51988803
21557,斯達吉斯特,2,589652,0.00032399,95.52021202
21558,普級,2,589654,0.00032399,95.52053601
21559,普通車,2,589656,0.00032399,95.52085999
21560,普通股,2,589658,0.00032399,95.52118398
21561,普普,2,589660,0.00032399,95.52150797
21562,普渡,2,589662,0.00032399,95.52183196
21563,晶華,2,589664,0.00032399,95.52215595
21564,晶瑩,2,589666,0.00032399,95.52247994
21565,晶體,2,589668,0.00032399,95.52280393
21566,景氣面,2,589670,0.00032399,95.52312791
21567,景泰日認基金,2,589672,0.00032399,95.52345190
21568,景緻,2,589674,0.00032399,95.52377589
21569,智財權,2,589676,0.00032399,95.52409988
21570,智商,2,589678,0.00032399,95.52442387
21571,曾心梅,2,589680,0.00032399,95.52474786
21572,曾國藩,2,589682,0.00032399,95.52507184
21573,曾雅玲,2,589684,0.00032399,95.52539583
21574,期末報告,2,589686,0.00032399,95.52571982
21575,期貨單,2,589688,0.00032399,95.52604381
21576,朝日,2,589690,0.00032399,95.52636780
21577,朝野協商,2,589692,0.00032399,95.52669179
21578,朝聖,2,589694,0.00032399,95.52701577
21579,朝鮮半島,2,589696,0.00032399,95.52733976
21580,棕櫚,2,589698,0.00032399,95.52766375
21581,棘手,2,589700,0.00032399,95.52798774
21582,椅墊,2,589702,0.00032399,95.52831173
21583,棒球場,2,589704,0.00032399,95.52863572
21584,棒球營,2,589706,0.00032399,95.52895971
21585,棒運,2,589708,0.00032399,95.52928369
21586,棋盤,2,589710,0.00032399,95.52960768
21587,棍子,2,589712,0.00032399,95.52993167
21588,棍棒,2,589714,0.00032399,95.53025566
21589,植物園,2,589716,0.00032399,95.53057965
21590,植物學家,2,589718,0.00032399,95.53090364
21591,椎骨,2,589720,0.00032399,95.53122762
21592,棉紗,2,589722,0.00032399,95.53155161
21593,棉被,2,589724,0.00032399,95.53187560
21594,棉棒,2,589726,0.00032399,95.53219959
21595,棉絮,2,589728,0.00032399,95.53252358
21596,棉質,2,589730,0.00032399,95.53284757
21597,棚架,2,589732,0.00032399,95.53317156
21598,款子,2,589734,0.00032399,95.53349554
21599,款待,2,589736,0.00032399,95.53381953
21600,欺,2,589738,0.00032399,95.53414352
21601,欺壓,2,589740,0.00032399,95.53446751
21602,欺騙,2,589742,0.00032399,95.53479150
21603,欽佩,2,589744,0.00032399,95.53511549
21604,殘存,2,589746,0.00032399,95.53543947
21605,殘忍,2,589748,0.00032399,95.53576346
21606,殘害,2,589750,0.00032399,95.53608745
21607,殘障者,2,589752,0.00032399,95.53641144
21608,殘廢,2,589754,0.00032399,95.53673543
21609,殖利率,2,589756,0.00032399,95.53705942
21610,氮氧化合物,2,589758,0.00032399,95.53738340
21611,港口溪,2,589760,0.00032399,95.53770739
21612,港片,2,589762,0.00032399,95.53803138
21613,港鈔,2,589764,0.00032399,95.53835537
21614,港群,2,589766,0.00032399,95.53867936
21615,游牡丹,2,589768,0.00032399,95.53900335
21616,游走,2,589770,0.00032399,95.53932734
21617,游標,2,589772,0.00032399,95.53965132
21618,游擊隊,2,589774,0.00032399,95.53997531
21619,游禮崧,2,589776,0.00032399,95.54029930
21620,渡輪,2,589778,0.00032399,95.54062329
21621,湧出,2,589780,0.00032399,95.54094728
21622,湧進,2,589782,0.00032399,95.54127127
21623,渠道,2,589784,0.00032399,95.54159525
21624,渥克,2,589786,0.00032399,95.54191924
21625,渣,2,589788,0.00032399,95.54224323
21626,減肥藥,2,589790,0.00032399,95.54256722
21627,減重,2,589792,0.00032399,95.54289121
21628,減產,2,589794,0.00032399,95.54321520
21629,減稅,2,589796,0.00032399,95.54353918
21630,減資,2,589798,0.00032399,95.54386317
21631,減慢,2,589800,0.00032399,95.54418716
21632,湖泊,2,589802,0.00032399,95.54451115
21633,渦輪,2,589804,0.00032399,95.54483514
21634,湯火聖,2,589806,0.00032399,95.54515913
21635,湯尼,2,589808,0.00032399,95.54548312
21636,湯志偉,2,589810,0.00032399,95.54580710
21637,湯姆克魯斯,2,589812,0.00032399,95.54613109
21638,湯瑪斯,2,589814,0.00032399,95.54645508
21639,湯頭,2,589816,0.00032399,95.54677907
21640,渴求,2,589818,0.00032399,95.54710306
21641,渺小,2,589820,0.00032399,95.54742705
21642,測試程式,2,589822,0.00032399,95.54775103
21643,渾然忘我,2,589824,0.00032399,95.54807502
21644,滋,2,589826,0.00032399,95.54839901
21645,滋生,2,589828,0.00032399,95.54872300
21646,滋賀縣,2,589830,0.00032399,95.54904699
21647,焦急,2,589832,0.00032399,95.54937098
21648,焦能義,2,589834,0.00032399,95.54969496
21649,焦慮症,2,589836,0.00032399,95.55001895
21650,無上,2,589838,0.00032399,95.55034294
21651,無功而返,2,589840,0.00032399,95.55066693
21652,無可厚非,2,589842,0.00032399,95.55099092
21653,無名氏,2,589844,0.00032399,95.55131491
21654,無汞電池,2,589846,0.00032399,95.55163890
21655,無味,2,589848,0.00032399,95.55196288
21656,無所事事,2,589850,0.00032399,95.55228687
21657,無所適從,2,589852,0.00032399,95.55261086
21658,無所謂,2,589854,0.00032399,95.55293485
21659,無法無天,2,589856,0.00032399,95.55325884
21660,無怨無悔,2,589858,0.00032399,95.55358283
21661,無為而治,2,589860,0.00032399,95.55390681
21662,無恙,2,589862,0.00032399,95.55423080
21663,無能為力,2,589864,0.00032399,95.55455479
21664,無常,2,589866,0.00032399,95.55487878
21665,無庸置疑,2,589868,0.00032399,95.55520277
21666,無異議,2,589870,0.00032399,95.55552676
21667,無辜,2,589872,0.00032399,95.55585074
21668,無愧,2,589874,0.00032399,95.55617473
21669,無端,2,589876,0.00032399,95.55649872
21670,無遠弗屆,2,589878,0.00032399,95.55682271
21671,無憂無慮,2,589880,0.00032399,95.55714670
21672,無敵,2,589882,0.00032399,95.55747069
21673,無線電,2,589884,0.00032399,95.55779468
21674,無獨有偶,2,589886,0.00032399,95.55811866
21675,無頭蒼蠅,2,589888,0.00032399,95.55844265
21676,無償,2,589890,0.00032399,95.55876664
21677,無邊,2,589892,0.00032399,95.55909063
21678,牌告,2,589894,0.00032399,95.55941462
21679,牌告利率,2,589896,0.00032399,95.55973861
21680,牌坊,2,589898,0.00032399,95.56006259
21681,猶疑,2,589900,0.00032399,95.56038658
21682,猶豫不決,2,589902,0.00032399,95.56071057
21683,猥瑣,2,589904,0.00032399,95.56103456
21684,猥褻,2,589906,0.00032399,95.56135855
21685,琥碧,2,589908,0.00032399,95.56168254
21686,琴,2,589910,0.00032399,95.56200653
21687,琴師,2,589912,0.00032399,95.56233051
21688,甦醒,2,589914,0.00032399,95.56265450
21689,畫分,2,589916,0.00032399,95.56297849
21690,畫師,2,589918,0.00032399,95.56330248
21691,畫清,2,589920,0.00032399,95.56362647
21692,畫報,2,589922,0.00032399,95.56395046
21693,畫筆,2,589924,0.00032399,95.56427444
21694,番王,2,589926,0.00032399,95.56459843
21695,番茄汁,2,589928,0.00032399,95.56492242
21696,痛風,2,589930,0.00032399,95.56524641
21697,痛哭,2,589932,0.00032399,95.56557040
21698,痛擊,2,589934,0.00032399,95.56589439
21699,登台,2,589936,0.00032399,95.56621837
21700,登基,2,589938,0.00032399,95.56654236
21701,發包中心,2,589940,0.00032399,95.56686635
21702,發包量,2,589942,0.00032399,95.56719034
21703,發行網,2,589944,0.00032399,95.56751433
21704,發言權,2,589946,0.00032399,95.56783832
21705,發胖,2,589948,0.00032399,95.56816231
21706,發展史,2,589950,0.00032399,95.56848629
21707,發展局,2,589952,0.00032399,95.56881028
21708,發起人,2,589954,0.00032399,95.56913427
21709,發球員,2,589956,0.00032399,95.56945826
21710,發脾氣,2,589958,0.00032399,95.56978225
21711,發源地,2,589960,0.00032399,95.57010624
21712,發跡,2,589962,0.00032399,95.57043022
21713,發噱,2,589964,0.00032399,95.57075421
21714,發飆,2,589966,0.00032399,95.57107820
21715,盜賣,2,589968,0.00032399,95.57140219
21716,短小,2,589970,0.00032399,95.57172618
21717,短文,2,589972,0.00032399,95.57205017
21718,短片,2,589974,0.00032399,95.57237415
21719,短打,2,589976,0.00032399,95.57269814
21720,短期利率,2,589978,0.00032399,95.57302213
21721,稍縱即逝,2,589980,0.00032399,95.57334612
21722,程序委員會,2,589982,0.00032399,95.57367011
21723,程效良,2,589984,0.00032399,95.57399410
21724,稅法,2,589986,0.00032399,95.57431809
21725,稅金,2,589988,0.00032399,95.57464207
21726,稅前,2,589990,0.00032399,95.57496606
21727,稅後,2,589992,0.00032399,95.57529005
21728,稅捐分處,2,589994,0.00032399,95.57561404
21729,稅捐單位,2,589996,0.00032399,95.57593803
21730,稅賦,2,589998,0.00032399,95.57626202
21731,稅額,2,590000,0.00032399,95.57658600
21732,窘況,2,590002,0.00032399,95.57690999
21733,窗外有藍天,2,590004,0.00032399,95.57723398
21734,童安格,2,590006,0.00032399,95.57755797
21735,童玩,2,590008,0.00032399,95.57788196
21736,童勝男,2,590010,0.00032399,95.57820595
21737,等待夢醒時分,2,590012,0.00032399,95.57852993
21738,等量,2,590014,0.00032399,95.57885392
21739,等腰三角形,2,590016,0.00032399,95.57917791
21740,策略性,2,590018,0.00032399,95.57950190
21741,策畫人,2,590020,0.00032399,95.57982589
21742,筆法,2,590022,0.00032399,95.58014988
21743,筆桿,2,590024,0.00032399,95.58047387
21744,筆調,2,590026,0.00032399,95.58079785
21745,答詢,2,590028,0.00032399,95.58112184
21746,答謝,2,590030,0.00032399,95.58144583
21747,筋斗,2,590032,0.00032399,95.58176982
21748,粥,2,590034,0.00032399,95.58209381
21749,絞盡腦汁,2,590036,0.00032399,95.58241780
21750,絞網,2,590038,0.00032399,95.58274178
21751,結仇,2,590040,0.00032399,95.58306577
21752,結業證書,2,590042,0.00032399,95.58338976
21753,結構性,2,590044,0.00032399,95.58371375
21754,結褵,2,590046,0.00032399,95.58403774
21755,絕症,2,590048,0.00032399,95.58436173
21756,絕處逢生,2,590050,0.00032399,95.58468571
21757,絕對數字,2,590052,0.00032399,95.58500970
21758,絕緣,2,590054,0.00032399,95.58533369
21759,紫禁城,2,590056,0.00032399,95.58565768
21760,紫翠玉雷射,2,590058,0.00032399,95.58598167
21761,絲線,2,590060,0.00032399,95.58630566
21762,絲緞,2,590062,0.00032399,95.58662965
21763,絡繹,2,590064,0.00032399,95.58695363
21764,絢麗,2,590066,0.00032399,95.58727762
21765,善哉,2,590068,0.00032399,95.58760161
21766,善解人意,2,590070,0.00032399,95.58792560
21767,善變,2,590072,0.00032399,95.58824959
21768,聒噪,2,590074,0.00032399,95.58857358
21769,肅然起敬,2,590076,0.00032399,95.58889756
21770,肅穆,2,590078,0.00032399,95.58922155
21771,腔室,2,590080,0.00032399,95.58954554
21772,腋,2,590082,0.00032399,95.58986953
21773,腎炎,2,590084,0.00032399,95.59019352
21774,腎盂,2,590086,0.00032399,95.59051751
21775,脹,2,590088,0.00032399,95.59084150
21776,脾胃,2,590090,0.00032399,95.59116548
21777,腓力四世,2,590092,0.00032399,95.59148947
21778,舒伯特,2,590094,0.00032399,95.59181346
21779,舒麥克,2,590096,0.00032399,95.59213745
21780,舒暢,2,590098,0.00032399,95.59246144
21781,舒適性,2,590100,0.00032399,95.59278543
21782,菸,2,590102,0.00032399,95.59310941
21783,華文,2,590104,0.00032399,95.59343340
21784,華江高中,2,590106,0.00032399,95.59375739
21785,華東,2,590108,0.00032399,95.59408138
21786,華南,2,590110,0.00032399,95.59440537
21787,華昭,2,590112,0.00032399,95.59472936
21788,華格納,2,590114,0.00032399,95.59505334
21789,華僑高中,2,590116,0.00032399,95.59537733
21790,華德狄斯耐公司,2,590118,0.00032399,95.59570132
21791,華興街,2,590120,0.00032399,95.59602531
21792,著床,2,590122,0.00032399,95.59634930
21793,著述,2,590124,0.00032399,95.59667329
21794,著落,2,590126,0.00032399,95.59699728
21795,萊布維茲,2,590128,0.00032399,95.59732126
21796,萊辛格,2,590130,0.00032399,95.59764525
21797,萊特,2,590132,0.00032399,95.59796924
21798,萊特航空顧問,2,590134,0.00032399,95.59829323
21799,萊特航空顧問公司,2,590136,0.00032399,95.59861722
21800,萌芽,2,590138,0.00032399,95.59894121
21801,菌血症,2,590140,0.00032399,95.59926519
21802,菲利悖里斯,2,590142,0.00032399,95.59958918
21803,菜脯,2,590144,0.00032399,95.59991317
21804,菜燉牛肉,2,590146,0.00032399,95.60023716
21805,虛耗,2,590148,0.00032399,95.60056115
21806,虛張聲勢,2,590150,0.00032399,95.60088514
21807,虛無,2,590152,0.00032399,95.60120912
21808,虛構,2,590154,0.00032399,95.60153311
21809,蛙人隊,2,590156,0.00032399,95.60185710
21810,街景,2,590158,0.00032399,95.60218109
21811,街談巷議,2,590160,0.00032399,95.60250508
21812,街燈,2,590162,0.00032399,95.60282907
21813,裁定,2,590164,0.00032399,95.60315306
21814,裁撤,2,590166,0.00032399,95.60347704
21815,裂,2,590168,0.00032399,95.60380103
21816,裂痕,2,590170,0.00032399,95.60412502
21817,裂縫,2,590172,0.00032399,95.60444901
21818,視為,2,590174,0.00032399,95.60477300
21819,視窗九五,2,590176,0.00032399,95.60509699
21820,視聽,2,590178,0.00032399,95.60542097
21821,註解,2,590180,0.00032399,95.60574496
21822,註銷,2,590182,0.00032399,95.60606895
21823,詠嘆調,2,590184,0.00032399,95.60639294
21824,評分,2,590186,0.00032399,95.60671693
21825,評判,2,590188,0.00032399,95.60704092
21826,評析,2,590190,0.00032399,95.60736490
21827,評等機構,2,590192,0.00032399,95.60768889
21828,評論界,2,590194,0.00032399,95.60801288
21829,評論家,2,590196,0.00032399,95.60833687
21830,評斷,2,590198,0.00032399,95.60866086
21831,証實,2,590200,0.00032399,95.60898485
21832,訴苦,2,590202,0.00032399,95.60930884
21833,象形,2,590204,0.00032399,95.60963282
21834,象棋,2,590206,0.00032399,95.60995681
21835,貂,2,590208,0.00032399,95.61028080
21836,貼近,2,590210,0.00032399,95.61060479
21837,賀,2,590212,0.00032399,95.61092878
21838,賀天健,2,590214,0.00032399,95.61125277
21839,賀軒,2,590216,0.00032399,95.61157675
21840,賀端蕃,2,590218,0.00032399,95.61190074
21841,賀禮,2,590220,0.00032399,95.61222473
21842,貴金屬,2,590222,0.00032399,95.61254872
21843,貴氣,2,590224,0.00032399,95.61287271
21844,貴賓室,2,590226,0.00032399,95.61319670
21845,買不起,2,590228,0.00032399,95.61352068
21846,買地,2,590230,0.00032399,95.61384467
21847,買來,2,590232,0.00032399,95.61416866
21848,買票,2,590234,0.00032399,95.61449265
21849,買菜,2,590236,0.00032399,95.61481664
21850,買賣者,2,590238,0.00032399,95.61514063
21851,買權,2,590240,0.00032399,95.61546462
21852,貿協,2,590242,0.00032399,95.61578860
21853,貿易公司,2,590244,0.00032399,95.61611259
21854,貸,2,590246,0.00032399,95.61643658
21855,越界,2,590248,0.00032399,95.61676057
21856,越國,2,590250,0.00032399,95.61708456
21857,越野車,2,590252,0.00032399,95.61740855
21858,超凡,2,590254,0.00032399,95.61773253
21859,超級金吉星,2,590256,0.00032399,95.61805652
21860,超能檔案,2,590258,0.00032399,95.61838051
21861,超高建築,2,590260,0.00032399,95.61870450
21862,超現實,2,590262,0.00032399,95.61902849
21863,超脫,2,590264,0.00032399,95.61935248
21864,超買區,2,590266,0.00032399,95.61967647
21865,超量,2,590268,0.00032399,95.62000045
21866,趁勢,2,590270,0.00032399,95.62032444
21867,跑者,2,590272,0.00032399,95.62064843
21868,跑進,2,590274,0.00032399,95.62097242
21869,跑跳,2,590276,0.00032399,95.62129641
21870,跌入,2,590278,0.00032399,95.62162040
21871,跌落,2,590280,0.00032399,95.62194438
21872,跛,2,590282,0.00032399,95.62226837
21873,軸線,2,590284,0.00032399,95.62259236
21874,辜振甫,2,590286,0.00032399,95.62291635
21875,週刊,2,590288,0.00032399,95.62324034
21876,週轉金,2,590290,0.00032399,95.62356433
21877,進用,2,590292,0.00032399,95.62388831
21878,進行曲,2,590294,0.00032399,95.62421230
21879,進佔,2,590296,0.00032399,95.62453629
21880,進退兩難,2,590298,0.00032399,95.62486028
21881,進貨量,2,590300,0.00032399,95.62518427
21882,進豪公司,2,590302,0.00032399,95.62550826
21883,郵戳,2,590304,0.00032399,95.62583225
21884,鄉土,2,590306,0.00032399,95.62615623
21885,鄉代會,2,590308,0.00032399,95.62648022
21886,鄉親父老,2,590310,0.00032399,95.62680421
21887,酥派,2,590312,0.00032399,95.62712820
21888,量力而為,2,590314,0.00032399,95.62745219
21889,量販,2,590316,0.00032399,95.62777618
21890,量感,2,590318,0.00032399,95.62810016
21891,鈑件,2,590320,0.00032399,95.62842415
21892,開山住持,2,590322,0.00032399,95.62874814
21893,開火,2,590324,0.00032399,95.62907213
21894,開台媽祖,2,590326,0.00032399,95.62939612
21895,開市,2,590328,0.00032399,95.62972011
21896,開示,2,590330,0.00032399,95.63004409
21897,開具,2,590332,0.00032399,95.63036808
21898,開花,2,590334,0.00032399,95.63069207
21899,開胃菜,2,590336,0.00032399,95.63101606
21900,開革,2,590338,0.00032399,95.63134005
21901,開庭,2,590340,0.00032399,95.63166404
21902,開創性,2,590342,0.00032399,95.63198803
21903,開發人員,2,590344,0.00032399,95.63231201
21904,開發中國家,2,590346,0.00032399,95.63263600
21905,開發平台,2,590348,0.00032399,95.63295999
21906,開發商,2,590350,0.00032399,95.63328398
21907,開源,2,590352,0.00032399,95.63360797
21908,開幕式,2,590354,0.00032399,95.63393196
21909,開價,2,590356,0.00032399,95.63425594
21910,開播,2,590358,0.00032399,95.63457993
21911,開課,2,590360,0.00032399,95.63490392
21912,開懷,2,590362,0.00032399,95.63522791
21913,開議,2,590364,0.00032399,95.63555190
21914,開鑼,2,590366,0.00032399,95.63587589
21915,閒適,2,590368,0.00032399,95.63619987
21916,閒錢,2,590370,0.00032399,95.63652386
21917,隊部,2,590372,0.00032399,95.63684785
21918,隋,2,590374,0.00032399,95.63717184
21919,陽明山,2,590376,0.00032399,95.63749583
21920,陽明段,2,590378,0.00032399,95.63781982
21921,陽明高中,2,590380,0.00032399,95.63814381
21922,陽春全壘打,2,590382,0.00032399,95.63846779
21923,陽萎,2,590384,0.00032399,95.63879178
21924,隆起,2,590386,0.00032399,95.63911577
21925,隆隆,2,590388,0.00032399,95.63943976
21926,雅典娜,2,590390,0.00032399,95.63976375
21927,雅致,2,590392,0.00032399,95.64008774
21928,雅倫,2,590394,0.00032399,95.64041172
21929,雅娟,2,590396,0.00032399,95.64073571
21930,雅量,2,590398,0.00032399,95.64105970
21931,雄心,2,590400,0.00032399,95.64138369
21932,雄心萬丈,2,590402,0.00032399,95.64170768
21933,雄風,2,590404,0.00032399,95.64203167
21934,雄渾,2,590406,0.00032399,95.64235565
21935,集客力,2,590408,0.00032399,95.64267964
21936,集思廣益,2,590410,0.00032399,95.64300363
21937,集散地,2,590412,0.00032399,95.64332762
21938,雇工,2,590414,0.00032399,95.64365161
21939,雲彩,2,590416,0.00032399,95.64397560
21940,雲層,2,590418,0.00032399,95.64429959
21941,項羽,2,590420,0.00032399,95.64462357
21942,順口,2,590422,0.00032399,95.64494756
21943,順延,2,590424,0.00032399,95.64527155
21944,順從,2,590426,0.00032399,95.64559554
21945,飯局,2,590428,0.00032399,95.64591953
21946,飯後,2,590430,0.00032399,95.64624352
21947,飯粒,2,590432,0.00032399,95.64656750
21948,飲水思源,2,590434,0.00032399,95.64689149
21949,飲恨,2,590436,0.00032399,95.64721548
21950,馮幸,2,590438,0.00032399,95.64753947
21951,黃丁盛,2,590440,0.00032399,95.64786346
21952,黃土,2,590442,0.00032399,95.64818745
21953,黃文明,2,590444,0.00032399,95.64851144
21954,黃世明,2,590446,0.00032399,95.64883542
21955,黃玉珍,2,590448,0.00032399,95.64915941
21956,黃禾廣告,2,590450,0.00032399,95.64948340
21957,黃忠信,2,590452,0.00032399,95.64980739
21958,黃芸芸,2,590454,0.00032399,95.65013138
21959,黃金周,2,590456,0.00032399,95.65045537
21960,黃金檔,2,590458,0.00032399,95.65077935
21961,黃建亮,2,590460,0.00032399,95.65110334
21962,黃秋園,2,590462,0.00032399,95.65142733
21963,黃美華,2,590464,0.00032399,95.65175132
21964,黃海,2,590466,0.00032399,95.65207531
21965,黃智,2,590468,0.00032399,95.65239930
21966,黃欽勇,2,590470,0.00032399,95.65272328
21967,黃牌,2,590472,0.00032399,95.65304727
21968,黃榮華,2,590474,0.00032399,95.65337126
21969,黃種金,2,590476,0.00032399,95.65369525
21970,黃綠色,2,590478,0.00032399,95.65401924
21971,黃澄澄,2,590480,0.00032399,95.65434323
21972,黃曆,2,590482,0.00032399,95.65466722
21973,黃麗華,2,590484,0.00032399,95.65499120
21974,黃煚隆,2,590486,0.00032399,95.65531519
21975,黑函,2,590488,0.00032399,95.65563918
21976,黑桃皇后,2,590490,0.00032399,95.65596317
21977,黑盒子,2,590492,0.00032399,95.65628716
21978,黑蛇,2,590494,0.00032399,95.65661115
21979,黑斑,2,590496,0.00032399,95.65693513
21980,黑暗面,2,590498,0.00032399,95.65725912
21981,黑潮,2,590500,0.00032399,95.65758311
21982,黑糖,2,590502,0.00032399,95.65790710
21983,債主,2,590504,0.00032399,95.65823109
21984,債市,2,590506,0.00032399,95.65855508
21985,傲,2,590508,0.00032399,95.65887906
21986,傲人,2,590510,0.00032399,95.65920305
21987,傲視,2,590512,0.00032399,95.65952704
21988,傳回,2,590514,0.00032399,95.65985103
21989,傳呼,2,590516,0.00032399,95.66017502
21990,傳話,2,590518,0.00032399,95.66049901
21991,傳導器,2,590520,0.00032399,95.66082300
21992,傳聲筒,2,590522,0.00032399,95.66114698
21993,僅剩,2,590524,0.00032399,95.66147097
21994,僅管,2,590526,0.00032399,95.66179496
21995,傾家蕩產,2,590528,0.00032399,95.66211895
21996,催生,2,590530,0.00032399,95.66244294
21997,催眠,2,590532,0.00032399,95.66276693
21998,催票,2,590534,0.00032399,95.66309091
21999,傷患,2,590536,0.00032399,95.66341490
22000,勢在必得,2,590538,0.00032399,95.66373889
22001,勢利,2,590540,0.00032399,95.66406288
22002,匯出,2,590542,0.00032399,95.66438687
22003,匯市,2,590544,0.00032399,95.66471086
22004,匯款,2,590546,0.00032399,95.66503484
22005,嗓門,2,590548,0.00032399,95.66535883
22006,嗎啡,2,590550,0.00032399,95.66568282
22007,嗤之以鼻,2,590552,0.00032399,95.66600681
22008,嗚,2,590554,0.00032399,95.66633080
22009,嗅,2,590556,0.00032399,95.66665479
22010,嗆死,2,590558,0.00032399,95.66697878
22011,園丁,2,590560,0.00032399,95.66730276
22012,園方,2,590562,0.00032399,95.66762675
22013,園遊會,2,590564,0.00032399,95.66795074
22014,圓心,2,590566,0.00032399,95.66827473
22015,圓台,2,590568,0.00032399,95.66859872
22016,圓角,2,590570,0.00032399,95.66892271
22017,圓弧,2,590572,0.00032399,95.66924669
22018,圓盅,2,590574,0.00032399,95.66957068
22019,圓圈,2,590576,0.00032399,95.66989467
22020,圓寂,2,590578,0.00032399,95.67021866
22021,圓夢,2,590580,0.00032399,95.67054265
22022,圓環,2,590582,0.00032399,95.67086664
22023,圓點,2,590584,0.00032399,95.67119063
22024,塞入,2,590586,0.00032399,95.67151461
22025,塞倫蓋提國家公園,2,590588,0.00032399,95.67183860
22026,塞恩計畫,2,590590,0.00032399,95.67216259
22027,塞納河,2,590592,0.00032399,95.67248658
22028,塑膠花,2,590594,0.00032399,95.67281057
22029,塗上,2,590596,0.00032399,95.67313456
22030,塗滿,2,590598,0.00032399,95.67345854
22031,塔巴,2,590600,0.00032399,95.67378253
22032,填入,2,590602,0.00032399,95.67410652
22033,填權,2,590604,0.00032399,95.67443051
22034,奧利,2,590606,0.00032399,95.67475450
22035,奧利岡,2,590608,0.00032399,95.67507849
22036,奧美,2,590610,0.00032399,95.67540247
22037,奧美廣告,2,590612,0.00032399,95.67572646
22038,奧斯摩比,2,590614,0.00032399,95.67605045
22039,奧菲斯,2,590616,0.00032399,95.67637444
22040,奧運表,2,590618,0.00032399,95.67669843
22041,奧運會,2,590620,0.00032399,95.67702242
22042,奧福,2,590622,0.00032399,95.67734641
22043,奧賽美術館,2,590624,0.00032399,95.67767039
22044,奧蘭多,2,590626,0.00032399,95.67799438
22045,嫌疑人,2,590628,0.00032399,95.67831837
22046,嫌疑犯,2,590630,0.00032399,95.67864236
22047,媽咪,2,590632,0.00032399,95.67896635
22048,媳婦兒,2,590634,0.00032399,95.67929034
22049,幌動,2,590636,0.00032399,95.67961432
22050,幹什麼,2,590638,0.00032399,95.67993831
22051,幹事長,2,590640,0.00032399,95.68026230
22052,幹嘛,2,590642,0.00032399,95.68058629
22053,彙集,2,590644,0.00032399,95.68091028
22054,彙整,2,590646,0.00032399,95.68123427
22055,微不足道,2,590648,0.00032399,95.68155825
22056,微血管,2,590650,0.00032399,95.68188224
22057,微波爐,2,590652,0.00032399,95.68220623
22058,微軟公司,2,590654,0.00032399,95.68253022
22059,意外事件,2,590656,0.00032399,95.68285421
22060,意外險,2,590658,0.00032399,95.68317820
22061,意旨,2,590660,0.00032399,95.68350219
22062,意會,2,590662,0.00032399,95.68382617
22063,意興闌珊,2,590664,0.00032399,95.68415016
22064,慈善,2,590666,0.00032399,95.68447415
22065,慈愛,2,590668,0.00032399,95.68479814
22066,感光性,2,590670,0.00032399,95.68512213
22067,感光素,2,590672,0.00032399,95.68544612
22068,感懷,2,590674,0.00032399,95.68577010
22069,想一想,2,590676,0.00032399,95.68609409
22070,想不到,2,590678,0.00032399,95.68641808
22071,想出,2,590680,0.00032399,95.68674207
22072,想到,2,590682,0.00032399,95.68706606
22073,愛上,2,590684,0.00032399,95.68739005
22074,愛不釋手,2,590686,0.00032399,95.68771403
22075,愛河,2,590688,0.00032399,95.68803802
22076,愛迪生,2,590690,0.00032399,95.68836201
22077,愛國,2,590692,0.00032399,95.68868600
22078,愛慕虛榮,2,590694,0.00032399,95.68900999
22079,愛慾,2,590696,0.00032399,95.68933398
22080,惹火,2,590698,0.00032399,95.68965797
22081,慎,2,590700,0.00032399,95.68998195
22082,慌,2,590702,0.00032399,95.69030594
22083,慌亂,2,590704,0.00032399,95.69062993
22084,愧,2,590706,0.00032399,95.69095392
22085,搓揉,2,590708,0.00032399,95.69127791
22086,搞不好,2,590710,0.00032399,95.69160190
22087,搞怪,2,590712,0.00032399,95.69192588
22088,搞清楚,2,590714,0.00032399,95.69224987
22089,搭上,2,590716,0.00032399,95.69257386
22090,搭車,2,590718,0.00032399,95.69289785
22091,搭訕,2,590720,0.00032399,95.69322184
22092,搭配觀,2,590722,0.00032399,95.69354583
22093,搭擋,2,590724,0.00032399,95.69386981
22094,搭機,2,590726,0.00032399,95.69419380
22095,搽,2,590728,0.00032399,95.69451779
22096,搬出,2,590730,0.00032399,95.69484178
22097,搬動,2,590732,0.00032399,95.69516577
22098,搬演,2,590734,0.00032399,95.69548976
22099,搬離,2,590736,0.00032399,95.69581375
22100,搜查,2,590738,0.00032399,95.69613773
22101,搔,2,590740,0.00032399,95.69646172
22102,損益,2,590742,0.00032399,95.69678571
22103,損益表,2,590744,0.00032399,95.69710970
22104,損耗,2,590746,0.00032399,95.69743369
22105,搶位子,2,590748,0.00032399,95.69775768
22106,搶案,2,590750,0.00032399,95.69808166
22107,搶奪,2,590752,0.00032399,95.69840565
22108,搖來搖去,2,590754,0.00032399,95.69872964
22109,搖晃,2,590756,0.00032399,95.69905363
22110,搖搖頭,2,590758,0.00032399,95.69937762
22111,敬上,2,590760,0.00032399,95.69970161
22112,敬而遠之,2,590762,0.00032399,95.70002560
22113,斟,2,590764,0.00032399,95.70034958
22114,新天堂樂園,2,590766,0.00032399,95.70067357
22115,新月,2,590768,0.00032399,95.70099756
22116,新世紀,2,590770,0.00032399,95.70132155
22117,新市鎮,2,590772,0.00032399,95.70164554
22118,新民村,2,590774,0.00032399,95.70196953
22119,新生代,2,590776,0.00032399,95.70229351
22120,新生地,2,590778,0.00032399,95.70261750
22121,新生南路,2,590780,0.00032399,95.70294149
22122,新年,2,590782,0.00032399,95.70326548
22123,新車,2,590784,0.00032399,95.70358947
22124,新店高中,2,590786,0.00032399,95.70391346
22125,新版,2,590788,0.00032399,95.70423744
22126,新社部落,2,590790,0.00032399,95.70456143
22127,新型,2,590792,0.00032399,95.70488542
22128,新屋鄉,2,590794,0.00032399,95.70520941
22129,新莊高中,2,590796,0.00032399,95.70553340
22130,新港文教基金會,2,590798,0.00032399,95.70585739
22131,新進黨,2,590800,0.00032399,95.70618138
22132,新新,2,590802,0.00032399,95.70650536
22133,新壽,2,590804,0.00032399,95.70682935
22134,新聞處長,2,590806,0.00032399,95.70715334
22135,新營,2,590808,0.00032399,95.70747733
22136,新營市,2,590810,0.00032399,95.70780132
22137,新鮮事,2,590812,0.00032399,95.70812531
22138,新鮮誘惑,2,590814,0.00032399,95.70844929
22139,新舊任,2,590816,0.00032399,95.70877328
22140,新寵,2,590818,0.00032399,95.70909727
22141,暗沈,2,590820,0.00032399,95.70942126
22142,暗角,2,590822,0.00032399,95.70974525
22143,暗殺,2,590824,0.00032399,95.71006924
22144,暗喻,2,590826,0.00032399,95.71039322
22145,暗牆,2,590828,0.00032399,95.71071721
22146,暗戀,2,590830,0.00032399,95.71104120
22147,會心一笑,2,590832,0.00032399,95.71136519
22148,會客室,2,590834,0.00032399,95.71168918
22149,會勘,2,590836,0.00032399,95.71201317
22150,會勘人員,2,590838,0.00032399,95.71233716
22151,會晤,2,590840,0.00032399,95.71266114
22152,會陰,2,590842,0.00032399,95.71298513
22153,會話,2,590844,0.00032399,95.71330912
22154,榔皮,2,590846,0.00032399,95.71363311
22155,業報,2,590848,0.00032399,95.71395710
22156,業種,2,590850,0.00032399,95.71428109
22157,楚,2,590852,0.00032399,95.71460507
22158,楔,2,590854,0.00032399,95.71492906
22159,極為,2,590856,0.00032399,95.71525305
22160,極速,2,590858,0.00032399,95.71557704
22161,椰,2,590860,0.00032399,95.71590103
22162,椰樹,2,590862,0.00032399,95.71622502
22163,概,2,590864,0.00032399,95.71654900
22164,楊三郎,2,590866,0.00032399,95.71687299
22165,楊玉齡,2,590868,0.00032399,95.71719698
22166,楊守敬,2,590870,0.00032399,95.71752097
22167,楊家將,2,590872,0.00032399,95.71784496
22168,楊健夫,2,590874,0.00032399,95.71816895
22169,楊啟良,2,590876,0.00032399,95.71849294
22170,楊啟倫,2,590878,0.00032399,95.71881692
22171,楊梅鎮公所,2,590880,0.00032399,95.71914091
22172,楊慶郁,2,590882,0.00032399,95.71946490
22173,楊麗花,2,590884,0.00032399,95.71978889
22174,楊鐵,2,590886,0.00032399,95.72011288
22175,楞,2,590888,0.00032399,95.72043687
22176,楓丹白露,2,590890,0.00032399,95.72076085
22177,楓葉,2,590892,0.00032399,95.72108484
22178,歇斯底里,2,590894,0.00032399,95.72140883
22179,歇業,2,590896,0.00032399,95.72173282
22180,毀壞,2,590898,0.00032399,95.72205681
22181,溯,2,590900,0.00032399,95.72238080
22182,溶解,2,590902,0.00032399,95.72270478
22183,源源不絕,2,590904,0.00032399,95.72302877
22184,滅火,2,590906,0.00032399,95.72335276
22185,滅絕,2,590908,0.00032399,95.72367675
22186,溺水,2,590910,0.00032399,95.72400074
22187,溫水,2,590912,0.00032399,95.72432473
22188,溫度計,2,590914,0.00032399,95.72464872
22189,溫泉屋,2,590916,0.00032399,95.72497270
22190,溫泉浴,2,590918,0.00032399,95.72529669
22191,溫潤,2,590920,0.00032399,95.72562068
22192,滑水,2,590922,0.00032399,95.72594467
22193,滑水道,2,590924,0.00032399,95.72626866
22194,滑動板,2,590926,0.00032399,95.72659265
22195,滑嫩,2,590928,0.00032399,95.72691663
22196,準確度,2,590930,0.00032399,95.72724062
22197,滄海,2,590932,0.00032399,95.72756461
22198,溪北地區,2,590934,0.00032399,95.72788860
22199,溪頭,2,590936,0.00032399,95.72821259
22200,溪邊,2,590938,0.00032399,95.72853658
22201,煎餅,2,590940,0.00032399,95.72886057
22202,煙火,2,590942,0.00032399,95.72918455
22203,煙台,2,590944,0.00032399,95.72950854
22204,煩人,2,590946,0.00032399,95.72983253
22205,煉鋁,2,590948,0.00032399,95.73015652
22206,照亮,2,590950,0.00032399,95.73048051
22207,照護者,2,590952,0.00032399,95.73080450
22208,煞車燈,2,590954,0.00032399,95.73112848
22209,獅門,2,590956,0.00032399,95.73145247
22210,獅鷲堡,2,590958,0.00032399,95.73177646
22211,瑞利,2,590960,0.00032399,95.73210045
22212,瑞典克羅瑪塔打擊樂團,2,590962,0.00032399,95.73242444
22213,瑞芳,2,590964,0.00032399,95.73274843
22214,瑞相,2,590966,0.00032399,95.73307241
22215,瑞登,2,590968,0.00032399,95.73339640
22216,瑞濱海水浴場,2,590970,0.00032399,95.73372039
22217,瑜,2,590972,0.00032399,95.73404438
22218,瑜伽術,2,590974,0.00032399,95.73436837
22219,當上,2,590976,0.00032399,95.73469236
22220,瘀,2,590978,0.00032399,95.73501635
22221,痴情,2,590980,0.00032399,95.73534033
22222,督察,2,590982,0.00032399,95.73566432
22223,督察長,2,590984,0.00032399,95.73598831
22224,督察單位,2,590986,0.00032399,95.73631230
22225,睜,2,590988,0.00032399,95.73663629
22226,睥睨,2,590990,0.00032399,95.73696028
22227,碎屑,2,590992,0.00032399,95.73728426
22228,碗形,2,590994,0.00032399,95.73760825
22229,硼砂,2,590996,0.00032399,95.73793224
22230,禁菸,2,590998,0.00032399,95.73825623
22231,萬人迷,2,591000,0.00032399,95.73858022
22232,萬分,2,591002,0.00032399,95.73890421
22233,萬次,2,591004,0.00032399,95.73922819
22234,萬里,2,591006,0.00032399,95.73955218
22235,萬里長城,2,591008,0.00032399,95.73987617
22236,萬事達卡,2,591010,0.00032399,95.74020016
22237,萬事達卡國際組織,2,591012,0.00032399,95.74052415
22238,萬能,2,591014,0.00032399,95.74084814
22239,萬象,2,591016,0.00032399,95.74117213
22240,萬萬,2,591018,0.00032399,95.74149611
22241,稜角,2,591020,0.00032399,95.74182010
22242,稚嫩,2,591022,0.00032399,95.74214409
22243,稠,2,591024,0.00032399,95.74246808
22244,稠度,2,591026,0.00032399,95.74279207
22245,節度,2,591028,0.00032399,95.74311606
22246,節流,2,591030,0.00032399,95.74344004
22247,節食,2,591032,0.00032399,95.74376403
22248,經不起,2,591034,0.00032399,95.74408802
22249,經脈,2,591036,0.00032399,95.74441201
22250,經商,2,591038,0.00032399,95.74473600
22251,經得起,2,591040,0.00032399,95.74505999
22252,經絡,2,591042,0.00032399,95.74538397
22253,經貿政策,2,591044,0.00032399,95.74570796
22254,經貿額,2,591046,0.00032399,95.74603195
22255,經濟組,2,591048,0.00032399,95.74635594
22256,經驗者,2,591050,0.00032399,95.74667993
22257,綁匪,2,591052,0.00032399,95.74700392
22258,置換,2,591054,0.00032399,95.74732791
22259,置評,2,591056,0.00032399,95.74765189
22260,罪人,2,591058,0.00032399,95.74797588
22261,罪犯,2,591060,0.00032399,95.74829987
22262,罪名,2,591062,0.00032399,95.74862386
22263,罪魁禍首,2,591064,0.00032399,95.74894785
22264,義大利文,2,591066,0.00032399,95.74927184
22265,義大利菜,2,591068,0.00032399,95.74959582
22266,義務性,2,591070,0.00032399,95.74991981
22267,聖父,2,591072,0.00032399,95.75024380
22268,聖地,2,591074,0.00032399,95.75056779
22269,聖喬治,2,591076,0.00032399,95.75089178
22270,聖殿,2,591078,0.00032399,95.75121577
22271,聖瑪麗大教堂,2,591080,0.00032399,95.75153975
22272,聖誕夜,2,591082,0.00032399,95.75186374
22273,聖靈,2,591084,0.00032399,95.75218773
22274,肆意,2,591086,0.00032399,95.75251172
22275,腱鞘,2,591088,0.00032399,95.75283571
22276,腰斬,2,591090,0.00032399,95.75315970
22277,腰酸,2,591092,0.00032399,95.75348369
22278,腸炎,2,591094,0.00032399,95.75380767
22279,腸胃炎,2,591096,0.00032399,95.75413166
22280,腳下,2,591098,0.00032399,95.75445565
22281,腳印,2,591100,0.00032399,95.75477964
22282,腳尖,2,591102,0.00032399,95.75510363
22283,腳位,2,591104,0.00032399,95.75542762
22284,腳趾,2,591106,0.00032399,95.75575160
22285,腳跟,2,591108,0.00032399,95.75607559
22286,腹水,2,591110,0.00032399,95.75639958
22287,腹直肌,2,591112,0.00032399,95.75672357
22288,腹股溝疝氣,2,591114,0.00032399,95.75704756
22289,腹案,2,591116,0.00032399,95.75737155
22290,腺體,2,591118,0.00032399,95.75769554
22291,腦中,2,591120,0.00032399,95.75801952
22292,腦血管,2,591122,0.00032399,95.75834351
22293,艇,2,591124,0.00032399,95.75866750
22294,落人口實,2,591126,0.00032399,95.75899149
22295,落日,2,591128,0.00032399,95.75931548
22296,落荒而逃,2,591130,0.00032399,95.75963947
22297,落葉,2,591132,0.00032399,95.75996345
22298,落寞,2,591134,0.00032399,95.76028744
22299,落魄,2,591136,0.00032399,95.76061143
22300,落點,2,591138,0.00032399,95.76093542
22301,葉妳,2,591140,0.00032399,95.76125941
22302,葉慈,2,591142,0.00032399,95.76158340
22303,葛萊美獎,2,591144,0.00032399,95.76190738
22304,葛樂禮颱風,2,591146,0.00032399,95.76223137
22305,葡萄乾,2,591148,0.00032399,95.76255536
22306,葡萄糖,2,591150,0.00032399,95.76287935
22307,號數,2,591152,0.00032399,95.76320334
22308,蜂巢,2,591154,0.00032399,95.76352733
22309,蜂巢區,2,591156,0.00032399,95.76385132
22310,裔,2,591158,0.00032399,95.76417530
22311,補充劑,2,591160,0.00032399,95.76449929
22312,補釘,2,591162,0.00032399,95.76482328
22313,補發,2,591164,0.00032399,95.76514727
22314,補給片,2,591166,0.00032399,95.76547126
22315,補給艦,2,591168,0.00032399,95.76579525
22316,補繳,2,591170,0.00032399,95.76611923
22317,裝進,2,591172,0.00032399,95.76644322
22318,裝載,2,591174,0.00032399,95.76676721
22319,裝滿,2,591176,0.00032399,95.76709120
22320,裝櫃,2,591178,0.00032399,95.76741519
22321,裝裱,2,591180,0.00032399,95.76773918
22322,裝潢費,2,591182,0.00032399,95.76806316
22323,裡裡外外,2,591184,0.00032399,95.76838715
22324,解厄,2,591186,0.00032399,95.76871114
22325,解剖學者,2,591188,0.00032399,95.76903513
22326,解構,2,591190,0.00032399,95.76935912
22327,解釋文,2,591192,0.00032399,95.76968311
22328,詫異,2,591194,0.00032399,95.77000710
22329,該艦,2,591196,0.00032399,95.77033108
22330,詳加,2,591198,0.00032399,95.77065507
22331,試一試,2,591200,0.00032399,95.77097906
22332,試探性,2,591202,0.00032399,95.77130305
22333,試煉,2,591204,0.00032399,95.77162704
22334,試騎,2,591206,0.00032399,95.77195103
22335,詩句,2,591208,0.00032399,95.77227501
22336,詩作,2,591210,0.00032399,95.77259900
22337,詩情,2,591212,0.00032399,95.77292299
22338,詩情畫意,2,591214,0.00032399,95.77324698
22339,詩詞,2,591216,0.00032399,95.77357097
22340,詩篇,2,591218,0.00032399,95.77389496
22341,誇,2,591220,0.00032399,95.77421894
22342,誇大,2,591222,0.00032399,95.77454293
22343,詼諧曲,2,591224,0.00032399,95.77486692
22344,誠心,2,591226,0.00032399,95.77519091
22345,誠然,2,591228,0.00032399,95.77551490
22346,詢,2,591230,0.00032399,95.77583889
22347,詮釋者,2,591232,0.00032399,95.77616288
22348,詹宏志,2,591234,0.00032399,95.77648686
22349,豢養,2,591236,0.00032399,95.77681085
22350,資方,2,591238,0.00032399,95.77713484
22351,資本家,2,591240,0.00032399,95.77745883
22352,資助,2,591242,0.00032399,95.77778282
22353,資金量,2,591244,0.00032399,95.77810681
22354,資訊站,2,591246,0.00032399,95.77843079
22355,資訊廣場,2,591248,0.00032399,95.77875478
22356,資產股,2,591250,0.00032399,95.77907877
22357,資優班,2,591252,0.00032399,95.77940276
22358,賈姬,2,591254,0.00032399,95.77972675
22359,賄,2,591256,0.00032399,95.78005074
22360,賄款,2,591258,0.00032399,95.78037472
22361,跟上,2,591260,0.00032399,95.78069871
22362,跟不上,2,591262,0.00032399,95.78102270
22363,跨世紀,2,591264,0.00032399,95.78134669
22364,跨平台,2,591266,0.00032399,95.78167068
22365,跨海,2,591268,0.00032399,95.78199467
22366,跨國公司,2,591270,0.00032399,95.78231866
22367,路子,2,591272,0.00032399,95.78264264
22368,路旁,2,591274,0.00032399,95.78296663
22369,路華,2,591276,0.00032399,95.78329062
22370,路障,2,591278,0.00032399,95.78361461
22371,路樹,2,591280,0.00032399,95.78393860
22372,路權,2,591282,0.00032399,95.78426259
22373,跳下,2,591284,0.00032399,95.78458657
22374,跳升,2,591286,0.00032399,95.78491056
22375,跳板,2,591288,0.00032399,95.78523455
22376,跳進,2,591290,0.00032399,95.78555854
22377,跳進來,2,591292,0.00032399,95.78588253
22378,跪,2,591294,0.00032399,95.78620652
22379,躲避,2,591296,0.00032399,95.78653051
22380,載來,2,591298,0.00032399,95.78685449
22381,載運,2,591300,0.00032399,95.78717848
22382,農民銀行,2,591302,0.00032399,95.78750247
22383,農田,2,591304,0.00032399,95.78782646
22384,農田水利會法,2,591306,0.00032399,95.78815045
22385,農改場,2,591308,0.00032399,95.78847444
22386,農村文物公園,2,591310,0.00032399,95.78879842
22387,農林廳,2,591312,0.00032399,95.78912241
22388,農家女,2,591314,0.00032399,95.78944640
22389,農產,2,591316,0.00032399,95.78977039
22390,運回,2,591318,0.00032399,95.79009438
22391,運來,2,591320,0.00032399,95.79041837
22392,運能,2,591322,0.00032399,95.79074235
22393,運動者,2,591324,0.00032399,95.79106634
22394,運動表,2,591326,0.00032399,95.79139033
22395,運動量,2,591328,0.00032399,95.79171432
22396,運價,2,591330,0.00032399,95.79203831
22397,遊子,2,591332,0.00032399,95.79236230
22398,遊牧,2,591334,0.00032399,95.79268629
22399,遊園驚夢,2,591336,0.00032399,95.79301027
22400,遊輪,2,591338,0.00032399,95.79333426
22401,遊憩,2,591340,0.00032399,95.79365825
22402,遊戲區,2,591342,0.00032399,95.79398224
22403,遊藝,2,591344,0.00032399,95.79430623
22404,道出,2,591346,0.00032399,95.79463022
22405,道具店,2,591348,0.00032399,95.79495420
22406,道具屋,2,591350,0.00032399,95.79527819
22407,道道地地,2,591352,0.00032399,95.79560218
22408,道貌岸然,2,591354,0.00032399,95.79592617
22409,道瓊世界股票指數,2,591356,0.00032399,95.79625016
22410,道瓊社,2,591358,0.00032399,95.79657415
22411,達摩祖師,2,591360,0.00032399,95.79689813
22412,逼人太甚,2,591362,0.00032399,95.79722212
22413,違法亂紀,2,591364,0.00032399,95.79754611
22414,違建物,2,591366,0.00032399,95.79787010
22415,違紀,2,591368,0.00032399,95.79819409
22416,遐邇,2,591370,0.00032399,95.79851808
22417,遏阻,2,591372,0.00032399,95.79884207
22418,過大,2,591374,0.00032399,95.79916605
22419,過去式,2,591376,0.00032399,95.79949004
22420,過失,2,591378,0.00032399,95.79981403
22421,過份,2,591380,0.00032399,95.80013802
22422,過活,2,591382,0.00032399,95.80046201
22423,過期,2,591384,0.00032399,95.80078600
22424,過節,2,591386,0.00032399,95.80110998
22425,過橋米線,2,591388,0.00032399,95.80143397
22426,逾期放款,2,591390,0.00032399,95.80175796
22427,酬庸,2,591392,0.00032399,95.80208195
22428,酬賓,2,591394,0.00032399,95.80240594
22429,鈴聲,2,591396,0.00032399,95.80272993
22430,鉅子,2,591398,0.00032399,95.80305391
22431,鉅款,2,591400,0.00032399,95.80337790
22432,隔日,2,591402,0.00032399,95.80370189
22433,隔夜,2,591404,0.00032399,95.80402588
22434,隔開,2,591406,0.00032399,95.80434987
22435,隔鄰,2,591408,0.00032399,95.80467386
22436,隔離霜,2,591410,0.00032399,95.80499785
22437,隕越,2,591412,0.00032399,95.80532183
22438,雷克,2,591414,0.00032399,95.80564582
22439,雷射唱片,2,591416,0.00032399,95.80596981
22440,雷淇祥,2,591418,0.00032399,95.80629380
22441,雷霆先鋒,2,591420,0.00032399,95.80661779
22442,雷殛,2,591422,0.00032399,95.80694178
22443,電力公司,2,591424,0.00032399,95.80726576
22444,電子書,2,591426,0.00032399,95.80758975
22445,電子類股,2,591428,0.00032399,95.80791374
22446,電冰箱,2,591430,0.00032399,95.80823773
22447,電扶梯,2,591432,0.00032399,95.80856172
22448,電玩主機,2,591434,0.00032399,95.80888571
22449,電玩案,2,591436,0.00032399,95.80920969
22450,電視圈,2,591438,0.00032399,95.80953368
22451,電源線,2,591440,0.00032399,95.80985767
22452,電腦中心,2,591442,0.00032399,95.81018166
22453,電解,2,591444,0.00032399,95.81050565
22454,電話卡,2,591446,0.00032399,95.81082964
22455,電話號碼,2,591448,0.00032399,95.81115363
22456,電話簿,2,591450,0.00032399,95.81147761
22457,電戰,2,591452,0.00032399,95.81180160
22458,電戰系統,2,591454,0.00032399,95.81212559
22459,電機,2,591456,0.00032399,95.81244958
22460,電纜線,2,591458,0.00032399,95.81277357
22461,零存整付,2,591460,0.00032399,95.81309756
22462,零成長,2,591462,0.00032399,95.81342154
22463,零時,2,591464,0.00032399,95.81374553
22464,零售業,2,591466,0.00032399,95.81406952
22465,靶子,2,591468,0.00032399,95.81439351
22466,預委會,2,591470,0.00032399,95.81471750
22467,預拌混凝土廠,2,591472,0.00032399,95.81504149
22468,預祝,2,591474,0.00032399,95.81536548
22469,預算型,2,591476,0.00032399,95.81568946
22470,預覽,2,591478,0.00032399,95.81601345
22471,頑童,2,591480,0.00032399,95.81633744
22472,鼎昌,2,591482,0.00032399,95.81666143
22473,鼎盛,2,591484,0.00032399,95.81698542
22474,鼎鼎大名,2,591486,0.00032399,95.81730941
22475,鼓動,2,591488,0.00032399,95.81763339
22476,鼠,2,591490,0.00032399,95.81795738
22477,僕人,2,591492,0.00032399,95.81828137
22478,僑威機械股份有限公司,2,591494,0.00032399,95.81860536
22479,劃下,2,591496,0.00032399,95.81892935
22480,劃分,2,591498,0.00032399,95.81925334
22481,厭倦,2,591500,0.00032399,95.81957732
22482,嘆為觀止,2,591502,0.00032399,95.81990131
22483,嘆氣,2,591504,0.00032399,95.82022530
22484,嘉禾電影公司,2,591506,0.00032399,95.82054929
22485,嘉年華會,2,591508,0.00032399,95.82087328
22486,嘉連,2,591510,0.00032399,95.82119727
22487,嘉惠,2,591512,0.00032399,95.82152126
22488,嘉義縣立棒球場,2,591514,0.00032399,95.82184524
22489,嘉獎,2,591516,0.00032399,95.82216923
22490,嘍嘍,2,591518,0.00032399,95.82249322
22491,嘟,2,591520,0.00032399,95.82281721
22492,嘈雜,2,591522,0.00032399,95.82314120
22493,團友,2,591524,0.00032399,95.82346519
22494,團塊,2,591526,0.00032399,95.82378917
22495,圖利,2,591528,0.00032399,95.82411316
22496,圖紋,2,591530,0.00032399,95.82443715
22497,圖樣,2,591532,0.00032399,95.82476114
22498,圖騰,2,591534,0.00032399,95.82508513
22499,境遇,2,591536,0.00032399,95.82540912
22500,墓地,2,591538,0.00032399,95.82573310
22501,壽司,2,591540,0.00032399,95.82605709
22502,壽司米,2,591542,0.00032399,95.82638108
22503,壽終正寢,2,591544,0.00032399,95.82670507
22504,夢中情人,2,591546,0.00032399,95.82702906
22505,夢見,2,591548,0.00032399,95.82735305
22506,夢魘,2,591550,0.00032399,95.82767704
22507,奪回,2,591552,0.00032399,95.82800102
22508,嫩綠,2,591554,0.00032399,95.82832501
22509,孵化,2,591556,0.00032399,95.82864900
22510,寧夏分局,2,591558,0.00032399,95.82897299
22511,寡,2,591560,0.00032399,95.82929698
22512,寡頭政治,2,591562,0.00032399,95.82962097
22513,寥寥無幾,2,591564,0.00032399,95.82994495
22514,實心,2,591566,0.00032399,95.83026894
22515,實戶,2,591568,0.00032399,95.83059293
22516,實際上,2,591570,0.00032399,95.83091692
22517,實彈,2,591572,0.00032399,95.83124091
22518,實彈射擊,2,591574,0.00032399,95.83156490
22519,實彈演習,2,591576,0.00032399,95.83188888
22520,實證,2,591578,0.00032399,95.83221287
22521,實驗工廠,2,591580,0.00032399,95.83253686
22522,實驗者,2,591582,0.00032399,95.83286085
22523,實驗型,2,591584,0.00032399,95.83318484
22524,實驗飛機,2,591586,0.00032399,95.83350883
22525,實體感,2,591588,0.00032399,95.83383282
22526,對手戲,2,591590,0.00032399,95.83415680
22527,對台工作,2,591592,0.00032399,95.83448079
22528,對台政策,2,591594,0.00032399,95.83480478
22529,對位,2,591596,0.00032399,95.83512877
22530,對角線,2,591598,0.00032399,95.83545276
22531,對唱,2,591600,0.00032399,95.83577675
22532,對帳,2,591602,0.00032399,95.83610073
22533,對焦屏,2,591604,0.00032399,95.83642472
22534,對調,2,591606,0.00032399,95.83674871
22535,對錯,2,591608,0.00032399,95.83707270
22536,對應表,2,591610,0.00032399,95.83739669
22537,屢,2,591612,0.00032399,95.83772068
22538,幣,2,591614,0.00032399,95.83804466
22539,廓,2,591616,0.00032399,95.83836865
22540,廖松筠,2,591618,0.00032399,95.83869264
22541,廖學廣,2,591620,0.00032399,95.83901663
22542,彰,2,591622,0.00032399,95.83934062
22543,彰化基督教醫院,2,591624,0.00032399,95.83966461
22544,彰新路,2,591626,0.00032399,95.83998860
22545,慷慨,2,591628,0.00032399,95.84031258
22546,慢性病,2,591630,0.00032399,95.84063657
22547,慣性,2,591632,0.00032399,95.84096056
22548,慘劇,2,591634,0.00032399,95.84128455
22549,截面積,2,591636,0.00032399,95.84160854
22550,摘要,2,591638,0.00032399,95.84193253
22551,摔跤,2,591640,0.00032399,95.84225651
22552,撤除,2,591642,0.00032399,95.84258050
22553,撤換,2,591644,0.00032399,95.84290449
22554,撤資,2,591646,0.00032399,95.84322848
22555,摸彩券,2,591648,0.00032399,95.84355247
22556,摸摸,2,591650,0.00032399,95.84387646
22557,摻雜,2,591652,0.00032399,95.84420045
22558,敲入,2,591654,0.00032399,95.84452443
22559,旗幟,2,591656,0.00032399,95.84484842
22560,旗艦,2,591658,0.00032399,95.84517241
22561,暢,2,591660,0.00032399,95.84549640
22562,暢飲,2,591662,0.00032399,95.84582039
22563,榮民,2,591664,0.00032399,95.84614438
22564,榮面,2,591666,0.00032399,95.84646836
22565,榮勝,2,591668,0.00032399,95.84679235
22566,榮景,2,591670,0.00032399,95.84711634
22567,榮銜,2,591672,0.00032399,95.84744033
22568,榮膺,2,591674,0.00032399,95.84776432
22569,槍管,2,591676,0.00032399,95.84808831
22570,槍機,2,591678,0.00032399,95.84841229
22571,槌,2,591680,0.00032399,95.84873628
22572,歌曲集,2,591682,0.00032399,95.84906027
22573,歌隊,2,591684,0.00032399,95.84938426
22574,歌舞戲,2,591686,0.00032399,95.84970825
22575,歌德,2,591688,0.00032399,95.85003224
22576,演說家,2,591690,0.00032399,95.85035623
22577,演藝界,2,591692,0.00032399,95.85068021
22578,滾地球,2,591694,0.00032399,95.85100420
22579,滾落,2,591696,0.00032399,95.85132819
22580,漏洞,2,591698,0.00032399,95.85165218
22581,漂之船,2,591700,0.00032399,95.85197617
22582,漢城,2,591702,0.00032399,95.85230016
22583,漢級,2,591704,0.00032399,95.85262414
22584,漢堡,2,591706,0.00032399,95.85294813
22585,漢聲精選少年姆指文庫,2,591708,0.00032399,95.85327212
22586,滿心,2,591710,0.00032399,95.85359611
22587,滿清,2,591712,0.00032399,95.85392010
22588,滿貫,2,591714,0.00032399,95.85424409
22589,滿載,2,591716,0.00032399,95.85456807
22590,滿懷,2,591718,0.00032399,95.85489206
22591,滯留水,2,591720,0.00032399,95.85521605
22592,滯銷,2,591722,0.00032399,95.85554004
22593,漸進,2,591724,0.00032399,95.85586403
22594,漸層,2,591726,0.00032399,95.85618802
22595,漲升,2,591728,0.00032399,95.85651201
22596,漲漲跌跌,2,591730,0.00032399,95.85683599
22597,漫畫大進擊,2,591732,0.00032399,95.85715998
22598,漫遊,2,591734,0.00032399,95.85748397
22599,澈查,2,591736,0.00032399,95.85780796
22600,漁,2,591738,0.00032399,95.85813195
22601,滲透壓,2,591740,0.00032399,95.85845594
22602,熔岩原,2,591742,0.00032399,95.85877992
22603,熔煉廠,2,591744,0.00032399,95.85910391
22604,煽情,2,591746,0.00032399,95.85942790
22605,熊熊,2,591748,0.00032399,95.85975189
22606,熄火,2,591750,0.00032399,95.86007588
22607,犒賞,2,591752,0.00032399,95.86039987
22608,瑪丹娜,2,591754,0.00032399,95.86072385
22609,瑪姬,2,591756,0.00032399,95.86104784
22610,瑪家鄉,2,591758,0.00032399,95.86137183
22611,瑪莎．葛蘭姆,2,591760,0.00032399,95.86169582
22612,疑雲,2,591762,0.00032399,95.86201981
22613,疑義,2,591764,0.00032399,95.86234380
22614,疑點,2,591766,0.00032399,95.86266779
22615,盡心盡力,2,591768,0.00032399,95.86299177
22616,盡失,2,591770,0.00032399,95.86331576
22617,盡頭,2,591772,0.00032399,95.86363975
22618,監工,2,591774,0.00032399,95.86396374
22619,監牢,2,591776,0.00032399,95.86428773
22620,監院,2,591778,0.00032399,95.86461172
22621,監測,2,591780,0.00032399,95.86493570
22622,監察人,2,591782,0.00032399,95.86525969
22623,監管,2,591784,0.00032399,95.86558368
22624,瞄,2,591786,0.00032399,95.86590767
22625,睡衣,2,591788,0.00032399,95.86623166
22626,磁性,2,591790,0.00032399,95.86655565
22627,磁場,2,591792,0.00032399,95.86687963
22628,磁碟機,2,591794,0.00032399,95.86720362
22629,碧山巖,2,591796,0.00032399,95.86752761
22630,碳化,2,591798,0.00032399,95.86785160
22631,碳水化合物,2,591800,0.00032399,95.86817559
22632,福岡,2,591802,0.00032399,95.86849958
22633,福斯集團,2,591804,0.00032399,95.86882357
22634,福華,2,591806,0.00032399,95.86914755
22635,福華名品,2,591808,0.00032399,95.86947154
22636,禍不單行,2,591810,0.00032399,95.86979553
22637,禍害,2,591812,0.00032399,95.87011952
22638,種族歧視,2,591814,0.00032399,95.87044351
22639,種族隔離政策,2,591816,0.00032399,95.87076750
22640,稱不上,2,591818,0.00032399,95.87109148
22641,稱羨,2,591820,0.00032399,95.87141547
22642,稱霸,2,591822,0.00032399,95.87173946
22643,窩心,2,591824,0.00032399,95.87206345
22644,竭,2,591826,0.00032399,95.87238744
22645,端子,2,591828,0.00032399,95.87271143
22646,端莊,2,591830,0.00032399,95.87303542
22647,端視,2,591832,0.00032399,95.87335940
22648,端詳,2,591834,0.00032399,95.87368339
22649,管子,2,591836,0.00032399,95.87400738
22650,管不了,2,591838,0.00032399,95.87433137
22651,管理中心,2,591840,0.00032399,95.87465536
22652,管理股票,2,591842,0.00032399,95.87497935
22653,管理權,2,591844,0.00032399,95.87530333
22654,算命仙,2,591846,0.00032399,95.87562732
22655,算計,2,591848,0.00032399,95.87595131
22656,算算,2,591850,0.00032399,95.87627530
22657,算盤,2,591852,0.00032399,95.87659929
22658,精子,2,591854,0.00032399,95.87692328
22659,精技電腦,2,591856,0.00032399,95.87724726
22660,精采絕倫,2,591858,0.00032399,95.87757125
22661,精度,2,591860,0.00032399,95.87789524
22662,精疲力竭,2,591862,0.00032399,95.87821923
22663,精純,2,591864,0.00032399,95.87854322
22664,精密化,2,591866,0.00032399,95.87886721
22665,精液,2,591868,0.00032399,95.87919120
22666,精萃,2,591870,0.00032399,95.87951518
22667,精確度,2,591872,0.00032399,95.87983917
22668,精緻化,2,591874,0.00032399,95.88016316
22669,精雕細琢,2,591876,0.00032399,95.88048715
22670,綻,2,591878,0.00032399,95.88081114
22671,綜合性,2,591880,0.00032399,95.88113513
22672,綠巨人,2,591882,0.00032399,95.88145911
22673,綠地,2,591884,0.00032399,95.88178310
22674,綠草,2,591886,0.00032399,95.88210709
22675,綠意,2,591888,0.00032399,95.88243108
22676,綠葉,2,591890,0.00032399,95.88275507
22677,緊密度,2,591892,0.00032399,95.88307906
22678,緊接,2,591894,0.00032399,95.88340304
22679,緊湊,2,591896,0.00032399,95.88372703
22680,緊鑼密鼓,2,591898,0.00032399,95.88405102
22681,綴,2,591900,0.00032399,95.88437501
22682,網站,2,591902,0.00032399,95.88469900
22683,網域控制器,2,591904,0.00032399,95.88502299
22684,網景,2,591906,0.00032399,95.88534698
22685,綺麗,2,591908,0.00032399,95.88567096
22686,綿羊,2,591910,0.00032399,95.88599495
22687,綿延,2,591912,0.00032399,95.88631894
22688,綿密,2,591914,0.00032399,95.88664293
22689,維,2,591916,0.00032399,95.88696692
22690,維生,2,591918,0.00032399,95.88729091
22691,維克,2,591920,0.00032399,95.88761489
22692,維琪,2,591922,0.00032399,95.88793888
22693,緒,2,591924,0.00032399,95.88826287
22694,罰則,2,591926,0.00032399,95.88858686
22695,翡翠水庫,2,591928,0.00032399,95.88891085
22696,聚合,2,591930,0.00032399,95.88923484
22697,聚賭,2,591932,0.00032399,95.88955882
22698,聚寶盆,2,591934,0.00032399,95.88988281
22699,肇事,2,591936,0.00032399,95.89020680
22700,腐蝕,2,591938,0.00032399,95.89053079
22701,膈,2,591940,0.00032399,95.89085478
22702,臺北市,2,591942,0.00032399,95.89117877
22703,臺北市立婦幼醫院,2,591944,0.00032399,95.89150276
22704,臺幣,2,591946,0.00032399,95.89182674
22705,臺灣省政府,2,591948,0.00032399,95.89215073
22706,與日俱增,2,591950,0.00032399,95.89247472
22707,舞曲,2,591952,0.00032399,95.89279871
22708,舞伴,2,591954,0.00032399,95.89312270
22709,舞姿,2,591956,0.00032399,95.89344669
22710,舞動,2,591958,0.00032399,95.89377067
22711,舞龍,2,591960,0.00032399,95.89409466
22712,舞蹈系,2,591962,0.00032399,95.89441865
22713,蒙上,2,591964,0.00032399,95.89474264
22714,蒙恬科技,2,591966,0.00032399,95.89506663
22715,蒙恬筆式環境,2,591968,0.00032399,95.89539062
22716,蒙提,2,591970,0.00032399,95.89571461
22717,蒙德克斯公司,2,591972,0.00032399,95.89603859
22718,蒙德里安,2,591974,0.00032399,95.89636258
22719,蒲葵,2,591976,0.00032399,95.89668657
22720,蓋子,2,591978,0.00032399,95.89701056
22721,蓋里,2,591980,0.00032399,95.89733455
22722,蓋茲,2,591982,0.00032399,95.89765854
22723,蓋設,2,591984,0.00032399,95.89798252
22724,蒸蒸日上,2,591986,0.00032399,95.89830651
22725,蒐錄,2,591988,0.00032399,95.89863050
22726,蒐購,2,591990,0.00032399,95.89895449
22727,蒼老,2,591992,0.00032399,95.89927848
22728,蒼勁,2,591994,0.00032399,95.89960247
22729,蒼翠,2,591996,0.00032399,95.89992645
22730,蒼蠅,2,591998,0.00032399,95.90025044
22731,蜜,2,592000,0.00032399,95.90057443
22732,蜜月行情,2,592002,0.00032399,95.90089842
22733,蜻蜓,2,592004,0.00032399,95.90122241
22734,裸照,2,592006,0.00032399,95.90154640
22735,製片人,2,592008,0.00032399,95.90187039
22736,製作單位,2,592010,0.00032399,95.90219437
22737,製作群,2,592012,0.00032399,95.90251836
22738,製造者,2,592014,0.00032399,95.90284235
22739,製劑,2,592016,0.00032399,95.90316634
22740,製罐業,2,592018,0.00032399,95.90349033
22741,語音數據機,2,592020,0.00032399,95.90381432
22742,語彙,2,592022,0.00032399,95.90413830
22743,語調,2,592024,0.00032399,95.90446229
22744,認命,2,592026,0.00032399,95.90478628
22745,認捐,2,592028,0.00032399,95.90511027
22746,誤認,2,592030,0.00032399,95.90543426
22747,說明性,2,592032,0.00032399,95.90575825
22748,說教,2,592034,0.00032399,95.90608223
22749,豪雨,2,592036,0.00032399,95.90640622
22750,豪邁,2,592038,0.00032399,95.90673021
22751,賓士轎車,2,592040,0.00032399,95.90705420
22752,賓主,2,592042,0.00032399,95.90737819
22753,賓客,2,592044,0.00032399,95.90770218
22754,赫,2,592046,0.00032399,95.90802617
22755,赫赫有名,2,592048,0.00032399,95.90835015
22756,趙永清,2,592050,0.00032399,95.90867414
22757,趙無極自畫像,2,592052,0.00032399,95.90899813
22758,趙麗雲,2,592054,0.00032399,95.90932212
22759,趙蘭坤,2,592056,0.00032399,95.90964611
22760,趕走,2,592058,0.00032399,95.90997010
22761,趕到,2,592060,0.00032399,95.91029408
22762,趕赴,2,592062,0.00032399,95.91061807
22763,趕場,2,592064,0.00032399,95.91094206
22764,輔仁大學,2,592066,0.00032399,95.91126605
22765,輕忽,2,592068,0.00032399,95.91159004
22766,輕拍,2,592070,0.00032399,95.91191403
22767,輕型,2,592072,0.00032399,95.91223801
22768,輕描淡寫,2,592074,0.00032399,95.91256200
22769,輕傷,2,592076,0.00032399,95.91288599
22770,辣椒,2,592078,0.00032399,95.91320998
22771,遠比,2,592080,0.00032399,95.91353397
22772,遠東集團,2,592082,0.00032399,95.91385796
22773,遠東愛買,2,592084,0.00032399,95.91418195
22774,遠近,2,592086,0.00032399,95.91450593
22775,遠紡,2,592088,0.00032399,95.91482992
22776,遠處,2,592090,0.00032399,95.91515391
22777,遠程,2,592092,0.00032399,95.91547790
22778,遣,2,592094,0.00032399,95.91580189
22779,遙望,2,592096,0.00032399,95.91612588
22780,遞增,2,592098,0.00032399,95.91644986
22781,鄙夷,2,592100,0.00032399,95.91677385
22782,酷暑,2,592102,0.00032399,95.91709784
22783,銀白,2,592104,0.00032399,95.91742183
22784,銀行人員,2,592106,0.00032399,95.91774582
22785,銀行家,2,592108,0.00032399,95.91806981
22786,銀粒子,2,592110,0.00032399,95.91839379
22787,銀牌,2,592112,0.00032399,95.91871778
22788,銀電池,2,592114,0.00032399,95.91904177
22789,銀髮,2,592116,0.00032399,95.91936576
22790,銓敘部長,2,592118,0.00032399,95.91968975
22791,銜接,2,592120,0.00032399,95.92001374
22792,閩南,2,592122,0.00032399,95.92033773
22793,閥門,2,592124,0.00032399,95.92066171
22794,障礙區,2,592126,0.00032399,95.92098570
22795,雌雄,2,592128,0.00032399,95.92130969
22796,頗瓦法,2,592130,0.00032399,95.92163368
22797,領取,2,592132,0.00032399,95.92195767
22798,領受,2,592134,0.00032399,95.92228166
22799,領導群,2,592136,0.00032399,95.92260564
22800,餃子,2,592138,0.00032399,95.92292963
22801,駁回,2,592140,0.00032399,95.92325362
22802,鳳山分局,2,592142,0.00032399,95.92357761
22803,鼻血,2,592144,0.00032399,95.92390160
22804,齊備,2,592146,0.00032399,95.92422559
22805,齊集,2,592148,0.00032399,95.92454958
22806,億豐,2,592150,0.00032399,95.92487356
22807,僵,2,592152,0.00032399,95.92519755
22808,價值感,2,592154,0.00032399,95.92552154
22809,儉,2,592156,0.00032399,95.92584553
22810,凜冽,2,592158,0.00032399,95.92616952
22811,劇作家,2,592160,0.00032399,95.92649351
22812,劇場藝術,2,592162,0.00032399,95.92681749
22813,劈哩啪啦,2,592164,0.00032399,95.92714148
22814,劉大印,2,592166,0.00032399,95.92746547
22815,劉中昌,2,592168,0.00032399,95.92778946
22816,劉玉婷,2,592170,0.00032399,95.92811345
22817,劉吉人,2,592172,0.00032399,95.92843744
22818,劉邦,2,592174,0.00032399,95.92876142
22819,劉邦義,2,592176,0.00032399,95.92908541
22820,劉建富,2,592178,0.00032399,95.92940940
22821,劉炳偉,2,592180,0.00032399,95.92973339
22822,劉英武,2,592182,0.00032399,95.93005738
22823,劉時賢,2,592184,0.00032399,95.93038137
22824,劉國偉,2,592186,0.00032399,95.93070536
22825,劉硯田,2,592188,0.00032399,95.93102934
22826,劉華昌,2,592190,0.00032399,95.93135333
22827,劉蔡勤,2,592192,0.00032399,95.93167732
22828,劉學龍,2,592194,0.00032399,95.93200131
22829,劉墉,2,592196,0.00032399,95.93232530
22830,劍客,2,592198,0.00032399,95.93264929
22831,劍橋,2,592200,0.00032399,95.93297327
22832,嘲弄,2,592202,0.00032399,95.93329726
22833,嘿,2,592204,0.00032399,95.93362125
22834,嘩,2,592206,0.00032399,95.93394524
22835,噓,2,592208,0.00032399,95.93426923
22836,嘶喊,2,592210,0.00032399,95.93459322
22837,增大,2,592212,0.00032399,95.93491720
22838,墳場,2,592214,0.00032399,95.93524119
22839,墜,2,592216,0.00032399,95.93556518
22840,墜入,2,592218,0.00032399,95.93588917
22841,嫵媚,2,592220,0.00032399,95.93621316
22842,寬恕,2,592222,0.00032399,95.93653715
22843,寬窄,2,592224,0.00032399,95.93686114
22844,寬裕,2,592226,0.00032399,95.93718512
22845,審美,2,592228,0.00032399,95.93750911
22846,審結,2,592230,0.00032399,95.93783310
22847,寫字,2,592232,0.00032399,95.93815709
22848,寫意,2,592234,0.00032399,95.93848108
22849,寫實主義,2,592236,0.00032399,95.93880507
22850,層架,2,592238,0.00032399,95.93912905
22851,廢土,2,592240,0.00032399,95.93945304
22852,廢棄土,2,592242,0.00032399,95.93977703
22853,廢輪胎,2,592244,0.00032399,95.94010102
22854,廟宇,2,592246,0.00032399,95.94042501
22855,廣三崇光百貨,2,592248,0.00032399,95.94074900
22856,廣告公司,2,592250,0.00032399,95.94107298
22857,廣告費,2,592252,0.00032399,95.94139697
22858,廣角,2,592254,0.00032399,95.94172096
22859,廣播劇,2,592256,0.00032399,95.94204495
22860,廠方,2,592258,0.00032399,95.94236894
22861,廠區,2,592260,0.00032399,95.94269293
22862,彈丸,2,592262,0.00032399,95.94301692
22863,彈殼,2,592264,0.00032399,95.94334090
22864,影本,2,592266,0.00032399,95.94366489
22865,影城,2,592268,0.00032399,95.94398888
22866,影帝,2,592270,0.00032399,95.94431287
22867,影音光碟機,2,592272,0.00032399,95.94463686
22868,影評,2,592274,0.00032399,95.94496085
22869,影評人,2,592276,0.00032399,95.94528483
22870,影劇,2,592278,0.00032399,95.94560882
22871,影劇版,2,592280,0.00032399,95.94593281
22872,影響性,2,592282,0.00032399,95.94625680
22873,德比士,2,592284,0.00032399,95.94658079
22874,德安百貨,2,592286,0.00032399,95.94690478
22875,德性,2,592288,0.00032399,95.94722876
22876,德航,2,592290,0.00032399,95.94755275
22877,德高望重,2,592292,0.00032399,95.94787674
22878,德國車,2,592294,0.00032399,95.94820073
22879,德黑蘭,2,592296,0.00032399,95.94852472
22880,德籍,2,592298,0.00032399,95.94884871
22881,徵人啟事,2,592300,0.00032399,95.94917270
22882,徵召,2,592302,0.00032399,95.94949668
22883,慶功宴,2,592304,0.00032399,95.94982067
22884,慧,2,592306,0.00032399,95.95014466
22885,慕尼黑,2,592308,0.00032399,95.95046865
22886,憂思,2,592310,0.00032399,95.95079264
22887,憂傷,2,592312,0.00032399,95.95111663
22888,憂慮者,2,592314,0.00032399,95.95144061
22889,慰問,2,592316,0.00032399,95.95176460
22890,慰藉,2,592318,0.00032399,95.95208859
22891,慾,2,592320,0.00032399,95.95241258
22892,憎恨,2,592322,0.00032399,95.95273657
22893,摩拳擦掌,2,592324,0.00032399,95.95306056
22894,摩根史坦利新興市場指數,2,592326,0.00032399,95.95338455
22895,摩勒,2,592328,0.00032399,95.95370853
22896,摩爾,2,592330,0.00032399,95.95403252
22897,摩擦力,2,592332,0.00032399,95.95435651
22898,摹仿,2,592334,0.00032399,95.95468050
22899,撞上,2,592336,0.00032399,95.95500449
22900,撞見,2,592338,0.00032399,95.95532848
22901,撞球,2,592340,0.00032399,95.95565246
22902,撞擊點,2,592342,0.00032399,95.95597645
22903,撲滅,2,592344,0.00032399,95.95630044
22904,撐場面,2,592346,0.00032399,95.95662443
22905,撰文,2,592348,0.00032399,95.95694842
22906,撥雲見日,2,592350,0.00032399,95.95727241
22907,撕不去,2,592352,0.00032399,95.95759639
22908,撕裂,2,592354,0.00032399,95.95792038
22909,撕開,2,592356,0.00032399,95.95824437
22910,撒哈拉國際節,2,592358,0.00032399,95.95856836
22911,撮,2,592360,0.00032399,95.95889235
22912,播映,2,592362,0.00032399,95.95921634
22913,播種,2,592364,0.00032399,95.95954033
22914,撫卹金,2,592366,0.00032399,95.95986431
22915,撫養,2,592368,0.00032399,95.96018830
22916,敵隊,2,592370,0.00032399,95.96051229
22917,敵機,2,592372,0.00032399,95.96083628
22918,數不清,2,592374,0.00032399,95.96116027
22919,數位式,2,592376,0.00032399,95.96148426
22920,數位影像,2,592378,0.00032399,95.96180824
22921,數碼,2,592380,0.00032399,95.96213223
22922,數學家,2,592382,0.00032399,95.96245622
22923,數據化,2,592384,0.00032399,95.96278021
22924,暫定,2,592386,0.00032399,95.96310420
22925,暴力罪,2,592388,0.00032399,95.96342819
22926,暴風雨,2,592390,0.00032399,95.96375217
22927,暴跌,2,592392,0.00032399,95.96407616
22928,樣仔,2,592394,0.00032399,95.96440015
22929,樣板,2,592396,0.00032399,95.96472414
22930,樣媽咪產後護理之家,2,592398,0.00032399,95.96504813
22931,標租,2,592400,0.00032399,95.96537212
22932,標語,2,592402,0.00032399,95.96569611
22933,標購,2,592404,0.00032399,95.96602009
22934,模擬器,2,592406,0.00032399,95.96634408
22935,樓上,2,592408,0.00032399,95.96666807
22936,樓市,2,592410,0.00032399,95.96699206
22937,樓面,2,592412,0.00032399,95.96731605
22938,歐拉朱萬,2,592414,0.00032399,95.96764004
22939,歐洲共同市場,2,592416,0.00032399,95.96796402
22940,歐晉德,2,592418,0.00032399,95.96828801
22941,歐海勒,2,592420,0.00032399,95.96861200
22942,潑灑,2,592422,0.00032399,95.96893599
22943,澆息,2,592424,0.00032399,95.96925998
22944,潭子廠,2,592426,0.00032399,95.96958397
22945,潭邊村長,2,592428,0.00032399,95.96990795
22946,潛水人員,2,592430,0.00032399,95.97023194
22947,潛伏,2,592432,0.00032399,95.97055593
22948,潛艦艦隊,2,592434,0.00032399,95.97087992
22949,潮水,2,592436,0.00032399,95.97120391
22950,潮州,2,592438,0.00032399,95.97152790
22951,澎湃,2,592440,0.00032399,95.97185189
22952,潰爛,2,592442,0.00032399,95.97217587
22953,潤,2,592444,0.00032399,95.97249986
22954,潤滑,2,592446,0.00032399,95.97282385
22955,潤飾,2,592448,0.00032399,95.97314784
22956,潘建國,2,592450,0.00032399,95.97347183
22957,潟湖,2,592452,0.00032399,95.97379582
22958,熟人,2,592454,0.00032399,95.97411980
22959,熟悉度,2,592456,0.00032399,95.97444379
22960,熟練,2,592458,0.00032399,95.97476778
22961,熬汁,2,592460,0.00032399,95.97509177
22962,熱身運動,2,592462,0.00032399,95.97541576
22963,熱呼呼,2,592464,0.00032399,95.97573975
22964,熱炒,2,592466,0.00032399,95.97606373
22965,熱食,2,592468,0.00032399,95.97638772
22966,熱帶雨林,2,592470,0.00032399,95.97671171
22967,熱貼藥,2,592472,0.00032399,95.97703570
22968,熱敷膏,2,592474,0.00032399,95.97735969
22969,熨,2,592476,0.00032399,95.97768368
22970,獎杯,2,592478,0.00032399,95.97800767
22971,獎章,2,592480,0.00032399,95.97833165
22972,瑩,2,592482,0.00032399,95.97865564
22973,瘦子,2,592484,0.00032399,95.97897963
22974,盤中,2,592486,0.00032399,95.97930362
22975,盤桓,2,592488,0.00032399,95.97962761
22976,盤問,2,592490,0.00032399,95.97995160
22977,瞋,2,592492,0.00032399,95.98027558
22978,磋商,2,592494,0.00032399,95.98059957
22979,磅秤,2,592496,0.00032399,95.98092356
22980,確實是,2,592498,0.00032399,95.98124755
22981,確鑿,2,592500,0.00032399,95.98157154
22982,穀倉,2,592502,0.00032399,95.98189553
22983,稽核,2,592504,0.00032399,95.98221952
22984,稻子,2,592506,0.00032399,95.98254350
22985,稻米,2,592508,0.00032399,95.98286749
22986,篆刻,2,592510,0.00032399,95.98319148
22987,糊糊,2,592512,0.00032399,95.98351547
22988,練球,2,592514,0.00032399,95.98383946
22989,練習場,2,592516,0.00032399,95.98416345
22990,緘默,2,592518,0.00032399,95.98448743
22991,編曲,2,592520,0.00032399,95.98481142
22992,編務,2,592522,0.00032399,95.98513541
22993,編組,2,592524,0.00032399,95.98545940
22994,編著,2,592526,0.00032399,95.98578339
22995,編寫,2,592528,0.00032399,95.98610738
22996,編輯費,2,592530,0.00032399,95.98643136
22997,編纂,2,592532,0.00032399,95.98675535
22998,緣分,2,592534,0.00032399,95.98707934
22999,緣由,2,592536,0.00032399,95.98740333
23000,線上輔助說明,2,592538,0.00032399,95.98772732
23001,緩步,2,592540,0.00032399,95.98805131
23002,緩解,2,592542,0.00032399,95.98837530
23003,緩衝區,2,592544,0.00032399,95.98869928
23004,緲子,2,592546,0.00032399,95.98902327
23005,罷手,2,592548,0.00032399,95.98934726
23006,罷市,2,592550,0.00032399,95.98967125
23007,膠狀,2,592552,0.00032399,95.98999524
23008,膠筏,2,592554,0.00032399,95.99031923
23009,膠質,2,592556,0.00032399,95.99064321
23010,膠癮,2,592558,0.00032399,95.99096720
23011,膚,2,592560,0.00032399,95.99129119
23012,膚淺,2,592562,0.00032399,95.99161518
23013,蔗農,2,592564,0.00032399,95.99193917
23014,蔚為,2,592566,0.00032399,95.99226316
23015,蔚藍,2,592568,0.00032399,95.99258714
23016,蓮子,2,592570,0.00032399,95.99291113
23017,蓮花生大士,2,592572,0.00032399,95.99323512
23018,蔣,2,592574,0.00032399,95.99355911
23019,蔣中正,2,592576,0.00032399,95.99388310
23020,蔣孝勇,2,592578,0.00032399,95.99420709
23021,蔡元元,2,592580,0.00032399,95.99453108
23022,蔡文彬,2,592582,0.00032399,95.99485506
23023,蔡明彰,2,592584,0.00032399,95.99517905
23024,蔡明耀,2,592586,0.00032399,95.99550304
23025,蔡松雄,2,592588,0.00032399,95.99582703
23026,蔡春娉,2,592590,0.00032399,95.99615102
23027,蔡美慧,2,592592,0.00032399,95.99647501
23028,蔡登法,2,592594,0.00032399,95.99679899
23029,蔡鎮宇,2,592596,0.00032399,95.99712298
23030,蔡絜,2,592598,0.00032399,95.99744697
23031,蔡筱蘋,2,592600,0.00032399,95.99777096
23032,蝴蝶,2,592602,0.00032399,95.99809495
23033,蝶,2,592604,0.00032399,95.99841894
23034,蝦頭,2,592606,0.00032399,95.99874292
23035,蝙蝠俠,2,592608,0.00032399,95.99906691
23036,衛生廳長,2,592610,0.00032399,95.99939090
23037,衛岡動產市場週報,2,592612,0.00032399,95.99971489
23038,衛哨勤務,2,592614,0.00032399,96.00003888
23039,衛冕,2,592616,0.00032399,96.00036287
23040,衛視電影台,2,592618,0.00032399,96.00068686
23041,衛道,2,592620,0.00032399,96.00101084
23042,衛道人士,2,592622,0.00032399,96.00133483
23043,衝浪,2,592624,0.00032399,96.00165882
23044,衝破,2,592626,0.00032399,96.00198281
23045,衝程,2,592628,0.00032399,96.00230680
23046,衝鋒陷陣,2,592630,0.00032399,96.00263079
23047,衝鋒槍,2,592632,0.00032399,96.00295477
23048,衝擊力,2,592634,0.00032399,96.00327876
23049,談成,2,592636,0.00032399,96.00360275
23050,談判桌,2,592638,0.00032399,96.00392674
23051,談到,2,592640,0.00032399,96.00425073
23052,談笑,2,592642,0.00032399,96.00457472
23053,談起,2,592644,0.00032399,96.00489870
23054,談學睿,2,592646,0.00032399,96.00522269
23055,諄諄,2,592648,0.00032399,96.00554668
23056,誕辰,2,592650,0.00032399,96.00587067
23057,請願書,2,592652,0.00032399,96.00619466
23058,諸如此類,2,592654,0.00032399,96.00651865
23059,課本,2,592656,0.00032399,96.00684264
23060,調勻,2,592658,0.00032399,96.00716662
23061,調包,2,592660,0.00032399,96.00749061
23062,調皮,2,592662,0.00032399,96.00781460
23063,調任,2,592664,0.00032399,96.00813859
23064,調合,2,592666,0.00032399,96.00846258
23065,調色盤,2,592668,0.00032399,96.00878657
23066,調侃,2,592670,0.00032399,96.00911055
23067,調味奶,2,592672,0.00032399,96.00943454
23068,調查處,2,592674,0.00032399,96.00975853
23069,調控,2,592676,0.00032399,96.01008252
23070,調教,2,592678,0.00032399,96.01040651
23071,調現,2,592680,0.00032399,96.01073050
23072,調解委員,2,592682,0.00032399,96.01105449
23073,調察,2,592684,0.00032399,96.01137847
23074,調閱,2,592686,0.00032399,96.01170246
23075,調職,2,592688,0.00032399,96.01202645
23076,誰是,2,592690,0.00032399,96.01235044
23077,論及,2,592692,0.00032399,96.01267443
23078,論者,2,592694,0.00032399,96.01299842
23079,論壇,2,592696,0.00032399,96.01332240
23080,論斷,2,592698,0.00032399,96.01364639
23081,豎,2,592700,0.00032399,96.01397038
23082,豎立,2,592702,0.00032399,96.01429437
23083,豎起,2,592704,0.00032399,96.01461836
23084,豎笛,2,592706,0.00032399,96.01494235
23085,豬母水湯,2,592708,0.00032399,96.01526633
23086,豬皮,2,592710,0.00032399,96.01559032
23087,豬頭皮,2,592712,0.00032399,96.01591431
23088,賠掉,2,592714,0.00032399,96.01623830
23089,賦稅,2,592716,0.00032399,96.01656229
23090,賤價,2,592718,0.00032399,96.01688628
23091,賬,2,592720,0.00032399,96.01721027
23092,賭法,2,592722,0.00032399,96.01753425
23093,賭博罪,2,592724,0.00032399,96.01785824
23094,賢,2,592726,0.00032399,96.01818223
23095,賣弄,2,592728,0.00032399,96.01850622
23096,賣價,2,592730,0.00032399,96.01883021
23097,賣權,2,592732,0.00032399,96.01915420
23098,質押,2,592734,0.00032399,96.01947818
23099,質借,2,592736,0.00032399,96.01980217
23100,質輕,2,592738,0.00032399,96.02012616
23101,踐踏,2,592740,0.00032399,96.02045015
23102,踏上,2,592742,0.00032399,96.02077414
23103,踏青,2,592744,0.00032399,96.02109813
23104,輝映,2,592746,0.00032399,96.02142211
23105,輟,2,592748,0.00032399,96.02174610
23106,輟學,2,592750,0.00032399,96.02207009
23107,輪子,2,592752,0.00032399,96.02239408
23108,輪圈,2,592754,0.00032399,96.02271807
23109,輪番,2,592756,0.00032399,96.02304206
23110,輪緣,2,592758,0.00032399,96.02336605
23111,適巧,2,592760,0.00032399,96.02369003
23112,遮住,2,592762,0.00032399,96.02401402
23113,遮蔽,2,592764,0.00032399,96.02433801
23114,遮蔭,2,592766,0.00032399,96.02466200
23115,遮擋,2,592768,0.00032399,96.02498599
23116,遭殃,2,592770,0.00032399,96.02530998
23117,遷村,2,592772,0.00032399,96.02563396
23118,遷建,2,592774,0.00032399,96.02595795
23119,遷就,2,592776,0.00032399,96.02628194
23120,鄭重,2,592778,0.00032399,96.02660593
23121,鄭敏永,2,592780,0.00032399,96.02692992
23122,鄭榮興,2,592782,0.00032399,96.02725391
23123,鄧枝南,2,592784,0.00032399,96.02757789
23124,鄧祖琳,2,592786,0.00032399,96.02790188
23125,鄧散木,2,592788,0.00032399,96.02822587
23126,鄧邠,2,592790,0.00032399,96.02854986
23127,鄧婕,2,592792,0.00032399,96.02887385
23128,醉酒,2,592794,0.00032399,96.02919784
23129,醃,2,592796,0.00032399,96.02952183
23130,醃漬,2,592798,0.00032399,96.02984581
23131,鋅,2,592800,0.00032399,96.03016980
23132,銷售點,2,592802,0.00032399,96.03049379
23133,銷路,2,592804,0.00032399,96.03081778
23134,鋁品業者,2,592806,0.00032399,96.03114177
23135,鋁圈,2,592808,0.00032399,96.03146576
23136,銳,2,592810,0.00032399,96.03178974
23137,銳利,2,592812,0.00032399,96.03211373
23138,銳豹,2,592814,0.00032399,96.03243772
23139,銳減,2,592816,0.00032399,96.03276171
23140,鋒,2,592818,0.00032399,96.03308570
23141,震央,2,592820,0.00032399,96.03340969
23142,靠窗,2,592822,0.00032399,96.03373367
23143,靠墊,2,592824,0.00032399,96.03405766
23144,鞋櫃,2,592826,0.00032399,96.03438165
23145,頜,2,592828,0.00032399,96.03470564
23146,養育,2,592830,0.00032399,96.03502963
23147,養活,2,592832,0.00032399,96.03535362
23148,養眼,2,592834,0.00032399,96.03567761
23149,養殖業,2,592836,0.00032399,96.03600159
23150,駝,2,592838,0.00032399,96.03632558
23151,駐紮,2,592840,0.00032399,96.03664957
23152,駕輕就熟,2,592842,0.00032399,96.03697356
23153,骷髏,2,592844,0.00032399,96.03729755
23154,鬧區,2,592846,0.00032399,96.03762154
23155,魅惑,2,592848,0.00032399,96.03794552
23156,魯永昊,2,592850,0.00032399,96.03826951
23157,魯基,2,592852,0.00032399,96.03859350
23158,魯賓斯坦,2,592854,0.00032399,96.03891749
23159,鴉片,2,592856,0.00032399,96.03924148
23160,黎果雷托,2,592858,0.00032399,96.03956547
23161,黎國,2,592860,0.00032399,96.03988946
23162,墨線,2,592862,0.00032399,96.04021344
23163,凝固,2,592864,0.00032399,96.04053743
23164,凝結,2,592866,0.00032399,96.04086142
23165,凝滯,2,592868,0.00032399,96.04118541
23166,凝練,2,592870,0.00032399,96.04150940
23167,壁壘,2,592872,0.00032399,96.04183339
23168,壁壘分明,2,592874,0.00032399,96.04215737
23169,墾丁國家公園,2,592876,0.00032399,96.04248136
23170,墾管處,2,592878,0.00032399,96.04280535
23171,壅塞,2,592880,0.00032399,96.04312934
23172,奮,2,592882,0.00032399,96.04345333
23173,奮不顧身,2,592884,0.00032399,96.04377732
23174,學分,2,592886,0.00032399,96.04410130
23175,學以致用,2,592888,0.00032399,96.04442529
23176,學甲,2,592890,0.00032399,96.04474928
23177,學甲人,2,592892,0.00032399,96.04507327
23178,學甲香,2,592894,0.00032399,96.04539726
23179,學弟,2,592896,0.00032399,96.04572125
23180,學苑,2,592898,0.00032399,96.04604524
23181,學術單位,2,592900,0.00032399,96.04636922
23182,學說,2,592902,0.00032399,96.04669321
23183,導正,2,592904,0.00032399,96.04701720
23184,導至,2,592906,0.00032399,96.04734119
23185,憲兵隊,2,592908,0.00032399,96.04766518
23186,憑弔,2,592910,0.00032399,96.04798917
23187,憶,2,592912,0.00032399,96.04831315
23188,憶兒時,2,592914,0.00032399,96.04863714
23189,懊悔,2,592916,0.00032399,96.04896113
23190,懊惱,2,592918,0.00032399,96.04928512
23191,戰利品,2,592920,0.00032399,96.04960911
23192,戰院,2,592922,0.00032399,96.04993310
23193,戰鬥機,2,592924,0.00032399,96.05025708
23194,擁有者,2,592926,0.00032399,96.05058107
23195,擁腫,2,592928,0.00032399,96.05090506
23196,擋風玻璃,2,592930,0.00032399,96.05122905
23197,撼,2,592932,0.00032399,96.05155304
23198,據信,2,592934,0.00032399,96.05187703
23199,據稱,2,592936,0.00032399,96.05220102
23200,擇定,2,592938,0.00032399,96.05252500
23201,操作性,2,592940,0.00032399,96.05284899
23202,操控檯,2,592942,0.00032399,96.05317298
23203,操場,2,592944,0.00032399,96.05349697
23204,操演,2,592946,0.00032399,96.05382096
23205,操練,2,592948,0.00032399,96.05414495
23206,擔保,2,592950,0.00032399,96.05446893
23207,擔綱,2,592952,0.00032399,96.05479292
23208,整合型航空快遞轉運中心,2,592954,0.00032399,96.05511691
23209,整形外科,2,592956,0.00032399,96.05544090
23210,整套,2,592958,0.00032399,96.05576489
23211,整廠,2,592960,0.00032399,96.05608888
23212,整體性,2,592962,0.00032399,96.05641286
23213,曇花一現,2,592964,0.00032399,96.05673685
23214,暸解,2,592966,0.00032399,96.05706084
23215,樸素,2,592968,0.00032399,96.05738483
23216,橙路,2,592970,0.00032399,96.05770882
23217,橫越,2,592972,0.00032399,96.05803281
23218,橫跨,2,592974,0.00032399,96.05835680
23219,橘子,2,592976,0.00032399,96.05868078
23220,樹皮,2,592978,0.00032399,96.05900477
23221,樹根,2,592980,0.00032399,96.05932876
23222,樹脂,2,592982,0.00032399,96.05965275
23223,橄欖球,2,592984,0.00032399,96.05997674
23224,橄欖樹,2,592986,0.00032399,96.06030073
23225,橢圓,2,592988,0.00032399,96.06062471
23226,橡膠業,2,592990,0.00032399,96.06094870
23227,橋本龍太郎,2,592992,0.00032399,96.06127269
23228,機具,2,592994,0.00032399,96.06159668
23229,機型,2,592996,0.00032399,96.06192067
23230,機砲,2,592998,0.00032399,96.06224466
23231,機動利率,2,593000,0.00032399,96.06256864
23232,機密性,2,593002,0.00032399,96.06289263
23233,機械人,2,593004,0.00032399,96.06321662
23234,機智,2,593006,0.00032399,96.06354061
23235,機殼,2,593008,0.00032399,96.06386460
23236,機會點,2,593010,0.00032399,96.06418859
23237,機電,2,593012,0.00032399,96.06451258
23238,機電業,2,593014,0.00032399,96.06483656
23239,機頭,2,593016,0.00032399,96.06516055
23240,機翼,2,593018,0.00032399,96.06548454
23241,機警,2,593020,0.00032399,96.06580853
23242,歷代,2,593022,0.00032399,96.06613252
23243,歷史性,2,593024,0.00032399,96.06645651
23244,歷年,2,593026,0.00032399,96.06678049
23245,歷年來,2,593028,0.00032399,96.06710448
23246,歷時,2,593030,0.00032399,96.06742847
23247,歷歷在目,2,593032,0.00032399,96.06775246
23248,濃飛,2,593034,0.00032399,96.06807645
23249,濃稠度,2,593036,0.00032399,96.06840044
23250,濃蔭,2,593038,0.00032399,96.06872443
23251,濃霧,2,593040,0.00032399,96.06904841
23252,濁水溪,2,593042,0.00032399,96.06937240
23253,澳洲藝術家舞團,2,593044,0.00032399,96.06969639
23254,激進,2,593046,0.00032399,96.07002038
23255,激盪,2,593048,0.00032399,96.07034437
23256,熾烈,2,593050,0.00032399,96.07066836
23257,燒錄,2,593052,0.00032399,96.07099234
23258,燙菠菜,2,593054,0.00032399,96.07131633
23259,燃油,2,593056,0.00032399,96.07164032
23260,燃起,2,593058,0.00032399,96.07196431
23261,獨力,2,593060,0.00032399,96.07228830
23262,獨木舟,2,593062,0.00032399,96.07261229
23263,獨立運動,2,593064,0.00032399,96.07293627
23264,獨行,2,593066,0.00032399,96.07326026
23265,獨佔,2,593068,0.00032399,96.07358425
23266,獨來獨往,2,593070,0.00032399,96.07390824
23267,獨具,2,593072,0.00032399,96.07423223
23268,獨資,2,593074,0.00032399,96.07455622
23269,獨漏,2,593076,0.00032399,96.07488021
23270,獨樹一幟,2,593078,0.00032399,96.07520419
23271,獨鍾,2,593080,0.00032399,96.07552818
23272,獨攬,2,593082,0.00032399,96.07585217
23273,盧布,2,593084,0.00032399,96.07617616
23274,盧米埃,2,593086,0.00032399,96.07650015
23275,盧貝夫人,2,593088,0.00032399,96.07682414
23276,盧泰愚,2,593090,0.00032399,96.07714812
23277,盧基盛,2,593092,0.00032399,96.07747211
23278,盧凱恩,2,593094,0.00032399,96.07779610
23279,盧鴻毅,2,593096,0.00032399,96.07812009
23280,禦寒,2,593098,0.00032399,96.07844408
23281,積存,2,593100,0.00032399,96.07876807
23282,積怨,2,593102,0.00032399,96.07909205
23283,積澱,2,593104,0.00032399,96.07941604
23284,穆斯特,2,593106,0.00032399,96.07974003
23285,窺視,2,593108,0.00032399,96.08006402
23286,築巢,2,593110,0.00032399,96.08038801
23287,糖水,2,593112,0.00032399,96.08071200
23288,糖份,2,593114,0.00032399,96.08103599
23289,縣市長,2,593116,0.00032399,96.08135997
23290,縝密,2,593118,0.00032399,96.08168396
23291,縐紋,2,593120,0.00032399,96.08200795
23292,罹難,2,593122,0.00032399,96.08233194
23293,罹難者,2,593124,0.00032399,96.08265593
23294,膳食,2,593126,0.00032399,96.08297992
23295,興沖沖,2,593128,0.00032399,96.08330390
23296,興旺,2,593130,0.00032399,96.08362789
23297,興致勃勃,2,593132,0.00032399,96.08395188
23298,興農熊隊,2,593134,0.00032399,96.08427587
23299,蕊,2,593136,0.00032399,96.08459986
23300,蕨菜,2,593138,0.00032399,96.08492385
23301,蕭文傳,2,593140,0.00032399,96.08524783
23302,蕭邦,2,593142,0.00032399,96.08557182
23303,蕭芳頻,2,593144,0.00032399,96.08589581
23304,蕭退庵,2,593146,0.00032399,96.08621980
23305,蕭瑟,2,593148,0.00032399,96.08654379
23306,蕭薔,2,593150,0.00032399,96.08686778
23307,蕪湖,2,593152,0.00032399,96.08719177
23308,螞蟻,2,593154,0.00032399,96.08751575
23309,親口,2,593156,0.00032399,96.08783974
23310,親切感,2,593158,0.00032399,96.08816373
23311,親和力,2,593160,0.00032399,96.08848772
23312,親往,2,593162,0.00032399,96.08881171
23313,親朋,2,593164,0.00032399,96.08913570
23314,親家翁,2,593166,0.00032399,96.08945968
23315,親眼,2,593168,0.00032399,96.08978367
23316,親善,2,593170,0.00032399,96.09010766
23317,諱,2,593172,0.00032399,96.09043165
23318,謀害,2,593174,0.00032399,96.09075564
23319,諧和,2,593176,0.00032399,96.09107963
23320,諾言,2,593178,0.00032399,96.09140361
23321,諾亞,2,593180,0.00032399,96.09172760
23322,諾亞懷利,2,593182,0.00032399,96.09205159
23323,諶麗華,2,593184,0.00032399,96.09237558
23324,貓王,2,593186,0.00032399,96.09269957
23325,貓眼石,2,593188,0.00032399,96.09302356
23326,賴弘裕,2,593190,0.00032399,96.09334755
23327,賴佳寧,2,593192,0.00032399,96.09367153
23328,賴秋基,2,593194,0.00032399,96.09399552
23329,賴豊景,2,593196,0.00032399,96.09431951
23330,蹄,2,593198,0.00032399,96.09464350
23331,輯譯,2,593200,0.00032399,96.09496749
23332,輸配,2,593202,0.00032399,96.09529148
23333,辨識系統,2,593204,0.00032399,96.09561546
23334,辨識率,2,593206,0.00032399,96.09593945
23335,辨識碼,2,593208,0.00032399,96.09626344
23336,辦妥,2,593210,0.00032399,96.09658743
23337,遵,2,593212,0.00032399,96.09691142
23338,遴選,2,593214,0.00032399,96.09723541
23339,選中,2,593216,0.00032399,96.09755940
23340,選務,2,593218,0.00032399,96.09788338
23341,遲到,2,593220,0.00032399,96.09820737
23342,遲浩田,2,593222,0.00032399,96.09853136
23343,遲鈍,2,593224,0.00032399,96.09885535
23344,遲緩,2,593226,0.00032399,96.09917934
23345,醒目,2,593228,0.00032399,96.09950333
23346,醒來,2,593230,0.00032399,96.09982731
23347,錠,2,593232,0.00032399,96.10015130
23348,鋸,2,593234,0.00032399,96.10047529
23349,鋸齒狀,2,593236,0.00032399,96.10079928
23350,錯字,2,593238,0.00032399,96.10112327
23351,錯置,2,593240,0.00032399,96.10144726
23352,鋼門,2,593242,0.00032399,96.10177124
23353,鋼骨結構,2,593244,0.00032399,96.10209523
23354,鋼琴曲,2,593246,0.00032399,96.10241922
23355,鋼鐵股,2,593248,0.00032399,96.10274321
23356,錄音室,2,593250,0.00032399,96.10306720
23357,錄音機,2,593252,0.00032399,96.10339119
23358,錄影棚,2,593254,0.00032399,96.10371518
23359,錦上添花,2,593256,0.00032399,96.10403916
23360,錦繡,2,593258,0.00032399,96.10436315
23361,隧道,2,593260,0.00032399,96.10468714
23362,隨行人員,2,593262,0.00032399,96.10501113
23363,隨和,2,593264,0.00032399,96.10533512
23364,隨性,2,593266,0.00032399,96.10565911
23365,隨時隨地,2,593268,0.00032399,96.10598309
23366,隨著,2,593270,0.00032399,96.10630708
23367,險境,2,593272,0.00032399,96.10663107
23368,險灘,2,593274,0.00032399,96.10695506
23369,霖園,2,593276,0.00032399,96.10727905
23370,霍金,2,593278,0.00032399,96.10760304
23371,霍霍,2,593280,0.00032399,96.10792702
23372,霓虹燈,2,593282,0.00032399,96.10825101
23373,靜心,2,593284,0.00032399,96.10857500
23374,靜默,2,593286,0.00032399,96.10889899
23375,靦腆,2,593288,0.00032399,96.10922298
23376,鞘狀突,2,593290,0.00032399,96.10954697
23377,頸椎,2,593292,0.00032399,96.10987096
23378,頸項,2,593294,0.00032399,96.11019494
23379,頭目,2,593296,0.00032399,96.11051893
23380,頭昏,2,593298,0.00032399,96.11084292
23381,頭版,2,593300,0.00032399,96.11116691
23382,頭社村,2,593302,0.00032399,96.11149090
23383,頭前寮,2,593304,0.00032399,96.11181489
23384,頭風,2,593306,0.00032399,96.11213887
23385,頭破血流,2,593308,0.00032399,96.11246286
23386,頭飾,2,593310,0.00032399,96.11278685
23387,頹廢,2,593312,0.00032399,96.11311084
23388,餐盒,2,593314,0.00032399,96.11343483
23389,餐飲店,2,593316,0.00032399,96.11375882
23390,餐廳船,2,593318,0.00032399,96.11408280
23391,髻,2,593320,0.00032399,96.11440679
23392,鴕鳥主人俱樂部,2,593322,0.00032399,96.11473078
23393,鴕鳥肉,2,593324,0.00032399,96.11505477
23394,鴕鳥蛋,2,593326,0.00032399,96.11537876
23395,鴨肉,2,593328,0.00032399,96.11570275
23396,龍江路,2,593330,0.00032399,96.11602674
23397,龍泰陵,2,593332,0.00032399,96.11635072
23398,龍益雲,2,593334,0.00032399,96.11667471
23399,龍脈,2,593336,0.00032399,96.11699870
23400,龍蝦,2,593338,0.00032399,96.11732269
23401,龍頭老大,2,593340,0.00032399,96.11764668
23402,龍騎士,2,593342,0.00032399,96.11797067
23403,優生,2,593344,0.00032399,96.11829465
23404,優生保健科,2,593346,0.00032399,96.11861864
23405,優柔寡斷,2,593348,0.00032399,96.11894263
23406,優渥,2,593350,0.00032399,96.11926662
23407,優等,2,593352,0.00032399,96.11959061
23408,優越性,2,593354,0.00032399,96.11991460
23409,優質,2,593356,0.00032399,96.12023859
23410,儲存卡,2,593358,0.00032399,96.12056257
23411,儲藏,2,593360,0.00032399,96.12088656
23412,儲蠟室,2,593362,0.00032399,96.12121055
23413,嚇止,2,593364,0.00032399,96.12153454
23414,嚇跑,2,593366,0.00032399,96.12185853
23415,嚇壞,2,593368,0.00032399,96.12218252
23416,壓扁,2,593370,0.00032399,96.12250650
23417,壓倒性,2,593372,0.00032399,96.12283049
23418,壓傷,2,593374,0.00032399,96.12315448
23419,壓縮空氣,2,593376,0.00032399,96.12347847
23420,嬰,2,593378,0.00032399,96.12380246
23421,嶺腳瀑布,2,593380,0.00032399,96.12412645
23422,應不應該,2,593382,0.00032399,96.12445043
23423,應式文,2,593384,0.00032399,96.12477442
23424,應景,2,593386,0.00032399,96.12509841
23425,懇,2,593388,0.00032399,96.12542240
23426,懇求,2,593390,0.00032399,96.12574639
23427,戲份,2,593392,0.00032399,96.12607038
23428,戲弄,2,593394,0.00032399,96.12639437
23429,戲服,2,593396,0.00032399,96.12671835
23430,戲班,2,593398,0.00032399,96.12704234
23431,戲稱,2,593400,0.00032399,96.12736633
23432,戲劇系,2,593402,0.00032399,96.12769032
23433,戲劇家,2,593404,0.00032399,96.12801431
23434,戴上,2,593406,0.00032399,96.12833830
23435,戴塔,2,593408,0.00032399,96.12866228
23436,擎,2,593410,0.00032399,96.12898627
23437,擊沉,2,593412,0.00032399,96.12931026
23438,擠進,2,593414,0.00032399,96.12963425
23439,擰,2,593416,0.00032399,96.12995824
23440,擦上,2,593418,0.00032399,96.13028223
23441,擦刷,2,593420,0.00032399,96.13060621
23442,擦槍走火,2,593422,0.00032399,96.13093020
23443,斃,2,593424,0.00032399,96.13125419
23444,曖昧,2,593426,0.00032399,96.13157818
23445,檔案系統,2,593428,0.00032399,96.13190217
23446,檔案櫃,2,593430,0.00032399,96.13222616
23447,檢附,2,593432,0.00032399,96.13255015
23448,檢調人員,2,593434,0.00032399,96.13287413
23449,檢警,2,593436,0.00032399,96.13319812
23450,濱中泰男,2,593438,0.00032399,96.13352211
23451,澀味,2,593440,0.00032399,96.13384610
23452,濕度,2,593442,0.00032399,96.13417009
23453,濕砂模調配自動化系統,2,593444,0.00032399,96.13449408
23454,營建股,2,593446,0.00032399,96.13481806
23455,營區,2,593448,0.00032399,96.13514205
23456,營部,2,593450,0.00032399,96.13546604
23457,營業加值稅,2,593452,0.00032399,96.13579003
23458,燥,2,593454,0.00032399,96.13611402
23459,燭光,2,593456,0.00032399,96.13643801
23460,獲益,2,593458,0.00032399,96.13676199
23461,獲悉,2,593460,0.00032399,96.13708598
23462,獲救,2,593462,0.00032399,96.13740997
23463,獲頒,2,593464,0.00032399,96.13773396
23464,環保所,2,593466,0.00032399,96.13805795
23465,環保商品,2,593468,0.00032399,96.13838194
23466,環球,2,593470,0.00032399,96.13870593
23467,環湖村,2,593472,0.00032399,96.13902991
23468,璨,2,593474,0.00032399,96.13935390
23469,療養院,2,593476,0.00032399,96.13967789
23470,瞳,2,593478,0.00032399,96.14000188
23471,瞬,2,593480,0.00032399,96.14032587
23472,瞧一瞧,2,593482,0.00032399,96.14064986
23473,瞧不起,2,593484,0.00032399,96.14097384
23474,瞭若指掌,2,593486,0.00032399,96.14129783
23475,矯,2,593488,0.00032399,96.14162182
23476,矯枉過正,2,593490,0.00032399,96.14194581
23477,磷酸鹽,2,593492,0.00032399,96.14226980
23478,禪坐,2,593494,0.00032399,96.14259379
23479,禪定,2,593496,0.00032399,96.14291777
23480,篷,2,593498,0.00032399,96.14324176
23481,績,2,593500,0.00032399,96.14356575
23482,繃,2,593502,0.00032399,96.14388974
23483,總收入,2,593504,0.00032399,96.14421373
23484,總站,2,593506,0.00032399,96.14453772
23485,總務,2,593508,0.00032399,96.14486171
23486,總統制,2,593510,0.00032399,96.14518569
23487,總統府秘書長,2,593512,0.00032399,96.14550968
23488,總辭,2,593514,0.00032399,96.14583367
23489,縱觀,2,593516,0.00032399,96.14615766
23490,繁衍,2,593518,0.00032399,96.14648165
23491,繁雜,2,593520,0.00032399,96.14680564
23492,繁體,2,593522,0.00032399,96.14712962
23493,聲名,2,593524,0.00032399,96.14745361
23494,聲波,2,593526,0.00032399,96.14777760
23495,聲張,2,593528,0.00032399,96.14810159
23496,聲部,2,593530,0.00032399,96.14842558
23497,聲援,2,593532,0.00032399,96.14874957
23498,聲霸卡,2,593534,0.00032399,96.14907356
23499,聰,2,593536,0.00032399,96.14939754
23500,聯合公報,2,593538,0.00032399,96.14972153
23501,聯合會,2,593540,0.00032399,96.15004552
23502,聯考,2,593542,0.00032399,96.15036951
23503,聯訊,2,593544,0.00032399,96.15069350
23504,聯通,2,593546,0.00032399,96.15101749
23505,聯華,2,593548,0.00032399,96.15134147
23506,聯華食品,2,593550,0.00032399,96.15166546
23507,聯貸,2,593552,0.00032399,96.15198945
23508,聯鼎,2,593554,0.00032399,96.15231344
23509,臂膀,2,593556,0.00032399,96.15263743
23510,臀,2,593558,0.00032399,96.15296142
23511,膿瑞斯,2,593560,0.00032399,96.15328540
23512,臉型,2,593562,0.00032399,96.15360939
23513,臉龐,2,593564,0.00032399,96.15393338
23514,臨死,2,593566,0.00032399,96.15425737
23515,臨空城,2,593568,0.00032399,96.15458136
23516,臨時工,2,593570,0.00032399,96.15490535
23517,臨時性,2,593572,0.00032399,96.15522934
23518,臨場,2,593574,0.00032399,96.15555332
23519,舉手,2,593576,0.00032399,96.15587731
23520,舉手之勞,2,593578,0.00032399,96.15620130
23521,舉措,2,593580,0.00032399,96.15652529
23522,艱憶,2,593582,0.00032399,96.15684928
23523,艱澀,2,593584,0.00032399,96.15717327
23524,薄荷油,2,593586,0.00032399,96.15749725
23525,蕾莉昂,2,593588,0.00032399,96.15782124
23526,薯條,2,593590,0.00032399,96.15814523
23527,薛桂文,2,593592,0.00032399,96.15846922
23528,薛琦,2,593594,0.00032399,96.15879321
23529,螺絲,2,593596,0.00032399,96.15911720
23530,螺絲成型機,2,593598,0.00032399,96.15944118
23531,謎底,2,593600,0.00032399,96.15976517
23532,謎團,2,593602,0.00032399,96.16008916
23533,謙卑,2,593604,0.00032399,96.16041315
23534,講述,2,593606,0.00032399,96.16073714
23535,講師,2,593608,0.00032399,96.16106113
23536,講理,2,593610,0.00032399,96.16138512
23537,講義,2,593612,0.00032399,96.16170910
23538,講解,2,593614,0.00032399,96.16203309
23539,謠言,2,593616,0.00032399,96.16235708
23540,謝卡,2,593618,0.00032399,96.16268107
23541,謝拉斯,2,593620,0.00032399,96.16300506
23542,謝長亨,2,593622,0.00032399,96.16332905
23543,謝春德,2,593624,0.00032399,96.16365303
23544,謝家孝,2,593626,0.00032399,96.16397702
23545,謝祖錫,2,593628,0.00032399,96.16430101
23546,謝敏政,2,593630,0.00032399,96.16462500
23547,謝淑媛,2,593632,0.00032399,96.16494899
23548,謝票,2,593634,0.00032399,96.16527298
23549,謝傑生,2,593636,0.00032399,96.16559696
23550,謝聰仁,2,593638,0.00032399,96.16592095
23551,豁然開朗,2,593640,0.00032399,96.16624494
23552,賽里歐斯,2,593642,0.00032399,96.16656893
23553,賽狗,2,593644,0.00032399,96.16689292
23554,賽場,2,593646,0.00032399,96.16721691
23555,購物袋,2,593648,0.00032399,96.16754090
23556,購得,2,593650,0.00032399,96.16786488
23557,轄下,2,593652,0.00032399,96.16818887
23558,輿克,2,593654,0.00032399,96.16851286
23559,避孕,2,593656,0.00032399,96.16883685
23560,避孕藥,2,593658,0.00032399,96.16916084
23561,避重就輕,2,593660,0.00032399,96.16948483
23562,避難,2,593662,0.00032399,96.16980881
23563,還本,2,593664,0.00032399,96.17013280
23564,醜聞,2,593666,0.00032399,96.17045679
23565,鍵入,2,593668,0.00032399,96.17078078
23566,鍋鏟,2,593670,0.00032399,96.17110477
23567,鍾正芳,2,593672,0.00032399,96.17142876
23568,鍾情,2,593674,0.00032399,96.17175274
23569,鍾雲蘭,2,593676,0.00032399,96.17207673
23570,鍾愛,2,593678,0.00032399,96.17240072
23571,鍾蓮芳,2,593680,0.00032399,96.17272471
23572,闊,2,593682,0.00032399,96.17304870
23573,隱私權,2,593684,0.00032399,96.17337269
23574,隱喻,2,593686,0.00032399,96.17369668
23575,霜狀,2,593688,0.00032399,96.17402066
23576,霞,2,593690,0.00032399,96.17434465
23577,餵飽,2,593692,0.00032399,96.17466864
23578,餵養,2,593694,0.00032399,96.17499263
23579,鮮度,2,593696,0.00032399,96.17531662
23580,鮮嫩,2,593698,0.00032399,96.17564061
23581,鮮艷,2,593700,0.00032399,96.17596459
23582,鴻溝,2,593702,0.00032399,96.17628858
23583,鴿子,2,593704,0.00032399,96.17661257
23584,黏連,2,593706,0.00032399,96.17693656
23585,黏膜炎,2,593708,0.00032399,96.17726055
23586,點工,2,593710,0.00032399,96.17758454
23587,點火,2,593712,0.00032399,96.17790853
23588,點石成金,2,593714,0.00032399,96.17823251
23589,點播率,2,593716,0.00032399,96.17855650
23590,點數,2,593718,0.00032399,96.17888049
23591,黛安薇絲特,2,593720,0.00032399,96.17920448
23592,擴及,2,593722,0.00032399,96.17952847
23593,擾流板,2,593724,0.00032399,96.17985246
23594,擾流翼,2,593726,0.00032399,96.18017644
23595,攆走,2,593728,0.00032399,96.18050043
23596,擺平,2,593730,0.00032399,96.18082442
23597,擺放,2,593732,0.00032399,96.18114841
23598,擺開,2,593734,0.00032399,96.18147240
23599,擺飾,2,593736,0.00032399,96.18179639
23600,擺盪,2,593738,0.00032399,96.18212037
23601,斷片,2,593740,0.00032399,96.18244436
23602,斷奶,2,593742,0.00032399,96.18276835
23603,斷食,2,593744,0.00032399,96.18309234
23604,斷食療法,2,593746,0.00032399,96.18341633
23605,斷裂,2,593748,0.00032399,96.18374032
23606,斷斷續續,2,593750,0.00032399,96.18406431
23607,斷續,2,593752,0.00032399,96.18438829
23608,檸檬酸,2,593754,0.00032399,96.18471228
23609,檯面下,2,593756,0.00032399,96.18503627
23610,檯階,2,593758,0.00032399,96.18536026
23611,歸咎,2,593760,0.00032399,96.18568425
23612,歸隊,2,593762,0.00032399,96.18600824
23613,歸罪,2,593764,0.00032399,96.18633222
23614,瀋陽,2,593766,0.00032399,96.18665621
23615,濾色片,2,593768,0.00032399,96.18698020
23616,瀆職罪嫌,2,593770,0.00032399,96.18730419
23617,濺,2,593772,0.00032399,96.18762818
23618,瀏覽程式,2,593774,0.00032399,96.18795217
23619,獵槍,2,593776,0.00032399,96.18827615
23620,癖,2,593778,0.00032399,96.18860014
23621,癒,2,593780,0.00032399,96.18892413
23622,瞻仰,2,593782,0.00032399,96.18924812
23623,禮品,2,593784,0.00032399,96.18957211
23624,禮盒,2,593786,0.00032399,96.18989610
23625,禮聘,2,593788,0.00032399,96.19022009
23626,禮貌性,2,593790,0.00032399,96.19054407
23627,禮數,2,593792,0.00032399,96.19086806
23628,竄升,2,593794,0.00032399,96.19119205
23629,竄起,2,593796,0.00032399,96.19151604
23630,簡而言之,2,593798,0.00032399,96.19184003
23631,簡易法庭,2,593800,0.00032399,96.19216402
23632,簡要,2,593802,0.00032399,96.19248800
23633,簡述,2,593804,0.00032399,96.19281199
23634,簡暉明,2,593806,0.00032399,96.19313598
23635,簡榮霖,2,593808,0.00032399,96.19345997
23636,簡體,2,593810,0.00032399,96.19378396
23637,糧食局,2,593812,0.00032399,96.19410795
23638,織,2,593814,0.00032399,96.19443193
23639,繡,2,593816,0.00032399,96.19475592
23640,翹翹板,2,593818,0.00032399,96.19507991
23641,翻升,2,593820,0.00032399,96.19540390
23642,翻拍,2,593822,0.00032399,96.19572789
23643,翻揀,2,593824,0.00032399,96.19605188
23644,翻滾,2,593826,0.00032399,96.19637587
23645,翻臉,2,593828,0.00032399,96.19669985
23646,翻覆,2,593830,0.00032399,96.19702384
23647,職缺,2,593832,0.00032399,96.19734783
23648,職能,2,593834,0.00032399,96.19767182
23649,職棒隊,2,593836,0.00032399,96.19799581
23650,職棒認同卡,2,593838,0.00032399,96.19831980
23651,職棒賽,2,593840,0.00032399,96.19864378
23652,職棒雜誌,2,593842,0.00032399,96.19896777
23653,舊址,2,593844,0.00032399,96.19929176
23654,舊識,2,593846,0.00032399,96.19961575
23655,藍卡,2,593848,0.00032399,96.19993974
23656,藍皮書計畫,2,593850,0.00032399,96.20026373
23657,藍色巨人,2,593852,0.00032399,96.20058771
23658,藍鷹,2,593854,0.00032399,96.20091170
23659,藉重,2,593856,0.00032399,96.20123569
23660,藉著,2,593858,0.00032399,96.20155968
23661,薰,2,593860,0.00032399,96.20188367
23662,薰陶,2,593862,0.00032399,96.20220766
23663,覆轍,2,593864,0.00032399,96.20253165
23664,贅言,2,593866,0.00032399,96.20285563
23665,軀幹,2,593868,0.00032399,96.20317962
23666,軀體,2,593870,0.00032399,96.20350361
23667,轉口,2,593872,0.00032399,96.20382760
23668,轉世,2,593874,0.00032399,96.20415159
23669,轉包,2,593876,0.00032399,96.20447558
23670,轉生,2,593878,0.00032399,96.20479956
23671,轉交,2,593880,0.00032399,96.20512355
23672,轉存,2,593882,0.00032399,96.20544754
23673,轉角,2,593884,0.00032399,96.20577153
23674,轉往,2,593886,0.00032399,96.20609552
23675,轉強,2,593888,0.00032399,96.20641951
23676,轉接,2,593890,0.00032399,96.20674350
23677,轉速,2,593892,0.00032399,96.20706748
23678,轉開,2,593894,0.00032399,96.20739147
23679,轉戰,2,593896,0.00032399,96.20771546
23680,轉機性,2,593898,0.00032399,96.20803945
23681,轉頭,2,593900,0.00032399,96.20836344
23682,轉圜,2,593902,0.00032399,96.20868743
23683,醫治,2,593904,0.00032399,96.20901141
23684,醫師會誌,2,593906,0.00032399,96.20933540
23685,醫護人員,2,593908,0.00032399,96.20965939
23686,鎖匙,2,593910,0.00032399,96.20998338
23687,鎮金店,2,593912,0.00032399,96.21030737
23688,闖蕩,2,593914,0.00032399,96.21063136
23689,離台,2,593916,0.00032399,96.21095534
23690,離線閱讀,2,593918,0.00032399,96.21127933
23691,雜技,2,593920,0.00032399,96.21160332
23692,雜物,2,593922,0.00032399,96.21192731
23693,雜貨,2,593924,0.00032399,96.21225130
23694,雜糧,2,593926,0.00032399,96.21257529
23695,雙十路,2,593928,0.00032399,96.21289928
23696,雙包,2,593930,0.00032399,96.21322326
23697,雙門,2,593932,0.00032399,96.21354725
23698,雙流橋,2,593934,0.00032399,96.21387124
23699,雙軌制,2,593936,0.00032399,96.21419523
23700,雙氣囊,2,593938,0.00032399,96.21451922
23701,雙管齊下,2,593940,0.00032399,96.21484321
23702,雙語,2,593942,0.00032399,96.21516719
23703,雙語教學,2,593944,0.00032399,96.21549118
23704,雙層,2,593946,0.00032399,96.21581517
23705,雙鋼琴,2,593948,0.00032399,96.21613916
23706,雙頰,2,593950,0.00032399,96.21646315
23707,雙雙對對,2,593952,0.00032399,96.21678714
23708,雞睪丸,2,593954,0.00032399,96.21711112
23709,鞭打,2,593956,0.00032399,96.21743511
23710,顏面,2,593958,0.00032399,96.21775910
23711,顏清標,2,593960,0.00032399,96.21808309
23712,餿,2,593962,0.00032399,96.21840708
23713,騎車,2,593964,0.00032399,96.21873107
23714,騎師,2,593966,0.00032399,96.21905506
23715,鬆手,2,593968,0.00032399,96.21937904
23716,鬆垮,2,593970,0.00032399,96.21970303
23717,魏憶龍,2,593972,0.00032399,96.22002702
23718,魏鏞,2,593974,0.00032399,96.22035101
23719,鯊魚,2,593976,0.00032399,96.22067500
23720,鯉魚潭工程,2,593978,0.00032399,96.22099899
23721,鵝毛,2,593980,0.00032399,96.22132297
23722,鵝屎,2,593982,0.00032399,96.22164696
23723,鵝場,2,593984,0.00032399,96.22197095
23724,壞死,2,593986,0.00032399,96.22229494
23725,壞掉,2,593988,0.00032399,96.22261893
23726,壞處,2,593990,0.00032399,96.22294292
23727,壞運,2,593992,0.00032399,96.22326690
23728,寵,2,593994,0.00032399,96.22359089
23729,寵兒,2,593996,0.00032399,96.22391488
23730,龐,2,593998,0.00032399,96.22423887
23731,懶洋洋,2,594000,0.00032399,96.22456286
23732,攀岩,2,594002,0.00032399,96.22488685
23733,攀高,2,594004,0.00032399,96.22521084
23734,曠,2,594006,0.00032399,96.22553482
23735,曝光矯正轉盤,2,594008,0.00032399,96.22585881
23736,櫥櫃,2,594010,0.00032399,96.22618280
23737,櫝,2,594012,0.00032399,96.22650679
23738,瀟瀟,2,594014,0.00032399,96.22683078
23739,瀝乾,2,594016,0.00032399,96.22715477
23740,爆,2,594018,0.00032399,96.22747875
23741,爆米花,2,594020,0.00032399,96.22780274
23742,獸類,2,594022,0.00032399,96.22812673
23743,癡,2,594024,0.00032399,96.22845072
23744,矇,2,594026,0.00032399,96.22877471
23745,禱告,2,594028,0.00032399,96.22909870
23746,穩定股市基金,2,594030,0.00032399,96.22942268
23747,穩重,2,594032,0.00032399,96.22974667
23748,穩紮穩打,2,594034,0.00032399,96.23007066
23749,穩壓,2,594036,0.00032399,96.23039465
23750,簽定,2,594038,0.00032399,96.23071864
23751,簽賭,2,594040,0.00032399,96.23104263
23752,繩,2,594042,0.00032399,96.23136662
23753,繩矩,2,594044,0.00032399,96.23169060
23754,羅勃特考帝,2,594046,0.00032399,96.23201459
23755,羅衫,2,594048,0.00032399,96.23233858
23756,羅馬人,2,594050,0.00032399,96.23266257
23757,羅得,2,594052,0.00032399,96.23298656
23758,羅祥國,2,594054,0.00032399,96.23331055
23759,羅傑,2,594056,0.00032399,96.23363453
23760,羅斯卓波維契,2,594058,0.00032399,96.23395852
23761,羅賓威廉斯,2,594060,0.00032399,96.23428251
23762,羅賓森,2,594062,0.00032399,96.23460650
23763,羅蘭艾默瑞,2,594064,0.00032399,96.23493049
23764,藝文,2,594066,0.00032399,96.23525448
23765,藝文界,2,594068,0.00032399,96.23557847
23766,藝文圈,2,594070,0.00032399,96.23590245
23767,藝術史,2,594072,0.00032399,96.23622644
23768,藝術性,2,594074,0.00032399,96.23655043
23769,藝廊,2,594076,0.00032399,96.23687442
23770,藝評家,2,594078,0.00032399,96.23719841
23771,藥方,2,594080,0.00032399,96.23752240
23772,藥物食品檢驗局,2,594082,0.00032399,96.23784638
23773,藥效,2,594084,0.00032399,96.23817037
23774,藥袋,2,594086,0.00032399,96.23849436
23775,證人,2,594088,0.00032399,96.23881835
23776,證交所,2,594090,0.00032399,96.23914234
23777,證所稅,2,594092,0.00032399,96.23946633
23778,證婚人,2,594094,0.00032399,96.23979031
23779,譏笑,2,594096,0.00032399,96.24011430
23780,贈品券,2,594098,0.00032399,96.24043829
23781,蹼,2,594100,0.00032399,96.24076228
23782,轎跑車,2,594102,0.00032399,96.24108627
23783,邊際,2,594104,0.00032399,96.24141026
23784,鏗鏘,2,594106,0.00032399,96.24173425
23785,關上,2,594108,0.00032399,96.24205823
23786,難求,2,594110,0.00032399,96.24238222
23787,難言之隱,2,594112,0.00032399,96.24270621
23788,難受,2,594114,0.00032399,96.24303020
23789,難易,2,594116,0.00032399,96.24335419
23790,難保,2,594118,0.00032399,96.24367818
23791,難得一見,2,594120,0.00032399,96.24400216
23792,難產,2,594122,0.00032399,96.24432615
23793,難處,2,594124,0.00032399,96.24465014
23794,難堪,2,594126,0.00032399,96.24497413
23795,霧水,2,594128,0.00032399,96.24529812
23796,韻味,2,594130,0.00032399,96.24562211
23797,類推,2,594132,0.00032399,96.24594609
23798,饅頭,2,594134,0.00032399,96.24627008
23799,勸募,2,594136,0.00032399,96.24659407
23800,嚷,2,594138,0.00032399,96.24691806
23801,嚴家淦,2,594140,0.00032399,96.24724205
23802,嚴陣以待,2,594142,0.00032399,96.24756604
23803,嚴懲,2,594144,0.00032399,96.24789003
23804,寶玉,2,594146,0.00032399,96.24821401
23805,寶島銀行,2,594148,0.00032399,96.24853800
23806,懺悔,2,594150,0.00032399,96.24886199
23807,攔阻,2,594152,0.00032399,96.24918598
23808,爐灶,2,594154,0.00032399,96.24950997
23809,礦,2,594156,0.00032399,96.24983396
23810,礦山,2,594158,0.00032399,96.25015794
23811,礦物,2,594160,0.00032399,96.25048193
23812,礦物質,2,594162,0.00032399,96.25080592
23813,礦質水,2,594164,0.00032399,96.25112991
23814,籌備處長,2,594166,0.00032399,96.25145390
23815,籌畫,2,594168,0.00032399,96.25177789
23816,籌集,2,594170,0.00032399,96.25210187
23817,籃下,2,594172,0.00032399,96.25242586
23818,籃板王,2,594174,0.00032399,96.25274985
23819,籃球場,2,594176,0.00032399,96.25307384
23820,繼位者,2,594178,0.00032399,96.25339783
23821,艦身,2,594180,0.00032399,96.25372182
23822,艦體,2,594182,0.00032399,96.25404581
23823,蘑菇,2,594184,0.00032399,96.25436979
23824,蘑菇湯,2,594186,0.00032399,96.25469378
23825,蘆洲,2,594188,0.00032399,96.25501777
23826,蘆葦,2,594190,0.00032399,96.25534176
23827,蘇利文,2,594192,0.00032399,96.25566575
23828,蘇炎城,2,594194,0.00032399,96.25598974
23829,蘇建和,2,594196,0.00032399,96.25631372
23830,蘇起,2,594198,0.00032399,96.25663771
23831,蘇富比公司,2,594200,0.00032399,96.25696170
23832,蘇澳鎮,2,594202,0.00032399,96.25728569
23833,蘇聯共和國,2,594204,0.00032399,96.25760968
23834,蘊藏,2,594206,0.00032399,96.25793367
23835,蘊釀,2,594208,0.00032399,96.25825765
23836,蠕動,2,594210,0.00032399,96.25858164
23837,覺察,2,594212,0.00032399,96.25890563
23838,觸及,2,594214,0.00032399,96.25922962
23839,觸底,2,594216,0.00032399,96.25955361
23840,觸動,2,594218,0.00032399,96.25987760
23841,觸發,2,594220,0.00032399,96.26020159
23842,議事廳,2,594222,0.00032399,96.26052557
23843,譬喻,2,594224,0.00032399,96.26084956
23844,警車,2,594226,0.00032399,96.26117355
23845,警官,2,594228,0.00032399,96.26149754
23846,警所,2,594230,0.00032399,96.26182153
23847,警界,2,594232,0.00032399,96.26214552
23848,警備總司令,2,594234,0.00032399,96.26246950
23849,贏面,2,594236,0.00032399,96.26279349
23850,躁,2,594238,0.00032399,96.26311748
23851,釋股,2,594240,0.00032399,96.26344147
23852,釋迦牟尼,2,594242,0.00032399,96.26376546
23853,闡釋,2,594244,0.00032399,96.26408945
23854,飄揚,2,594246,0.00032399,96.26441344
23855,飄渺,2,594248,0.00032399,96.26473742
23856,飄飄然,2,594250,0.00032399,96.26506141
23857,騰空,2,594252,0.00032399,96.26538540
23858,鹹魚,2,594254,0.00032399,96.26570939
23859,鹹魚翻身,2,594256,0.00032399,96.26603338
23860,麵皮,2,594258,0.00032399,96.26635737
23861,麵糰,2,594260,0.00032399,96.26668135
23862,黨大會,2,594262,0.00032399,96.26700534
23863,黨資事業,2,594264,0.00032399,96.26732933
23864,黨團會,2,594266,0.00032399,96.26765332
23865,懾人,2,594268,0.00032399,96.26797731
23866,攝角,2,594270,0.00032399,96.26830130
23867,攝政王,2,594272,0.00032399,96.26862528
23868,攝影分離,2,594274,0.00032399,96.26894927
23869,攝影系,2,594276,0.00032399,96.26927326
23870,攝影業者,2,594278,0.00032399,96.26959725
23871,攜手合作,2,594280,0.00032399,96.26992124
23872,欄杆,2,594282,0.00032399,96.27024523
23873,殲滅,2,594284,0.00032399,96.27056922
23874,灌輸,2,594286,0.00032399,96.27089320
23875,籐,2,594288,0.00032399,96.27121719
23876,纏身,2,594290,0.00032399,96.27154118
23877,纏訟,2,594292,0.00032399,96.27186517
23878,蘭,2,594294,0.00032399,96.27218916
23879,蘭陽平原,2,594296,0.00032399,96.27251315
23880,蘭薰,2,594298,0.00032399,96.27283713
23881,護送,2,594300,0.00032399,96.27316112
23882,護理站,2,594302,0.00032399,96.27348511
23883,護照,2,594304,0.00032399,96.27380910
23884,護墊,2,594306,0.00032399,96.27413309
23885,躍躍欲試,2,594308,0.00032399,96.27445708
23886,轟,2,594310,0.00032399,96.27478106
23887,辯,2,594312,0.00032399,96.27510505
23888,辯證,2,594314,0.00032399,96.27542904
23889,辯護律師,2,594316,0.00032399,96.27575303
23890,鐵刀木,2,594318,0.00032399,96.27607702
23891,鐵桶,2,594320,0.00032399,96.27640101
23892,鐵窗,2,594322,0.00032399,96.27672500
23893,鐵絲,2,594324,0.00032399,96.27704898
23894,鐵路地下化,2,594326,0.00032399,96.27737297
23895,鐵道,2,594328,0.00032399,96.27769696
23896,鐵輪溫泉區,2,594330,0.00032399,96.27802095
23897,鐵劑,2,594332,0.00032399,96.27834494
23898,鐵籃,2,594334,0.00032399,96.27866893
23899,霸主,2,594336,0.00032399,96.27899291
23900,露西,2,594338,0.00032399,96.27931690
23901,露面,2,594340,0.00032399,96.27964089
23902,露珠,2,594342,0.00032399,96.27996488
23903,顧不得,2,594344,0.00032399,96.28028887
23904,顧立明,2,594346,0.00032399,96.28061286
23905,顧盼,2,594348,0.00032399,96.28093684
23906,驅車,2,594350,0.00032399,96.28126083
23907,驅使,2,594352,0.00032399,96.28158482
23908,驅除,2,594354,0.00032399,96.28190881
23909,驅逐艦,2,594356,0.00032399,96.28223280
23910,驅鳥,2,594358,0.00032399,96.28255679
23911,魔法風雲會,2,594360,0.00032399,96.28288078
23912,魔法師,2,594362,0.00032399,96.28320476
23913,魔宮戰士,2,594364,0.00032399,96.28352875
23914,魔鬼命令,2,594366,0.00032399,96.28385274
23915,魔術內衣,2,594368,0.00032399,96.28417673
23916,黯,2,594370,0.00032399,96.28450072
23917,黯淡,2,594372,0.00032399,96.28482471
23918,黯然,2,594374,0.00032399,96.28514869
23919,黯然失色,2,594376,0.00032399,96.28547268
23920,囊,2,594378,0.00032399,96.28579667
23921,攤,2,594380,0.00032399,96.28612066
23922,攤子,2,594382,0.00032399,96.28644465
23923,攤提,2,594384,0.00032399,96.28676864
23924,攤開,2,594386,0.00032399,96.28709262
23925,攤攤手,2,594388,0.00032399,96.28741661
23926,權位,2,594390,0.00032399,96.28774060
23927,權責相符,2,594392,0.00032399,96.28806459
23928,歡欣,2,594394,0.00032399,96.28838858
23929,歡暢,2,594396,0.00032399,96.28871257
23930,歡聲雷動,2,594398,0.00032399,96.28903656
23931,灑上,2,594400,0.00032399,96.28936054
23932,疊架,2,594402,0.00032399,96.28968453
23933,癮君子,2,594404,0.00032399,96.29000852
23934,籠統,2,594406,0.00032399,96.29033251
23935,聽到,2,594408,0.00032399,96.29065650
23936,聽候,2,594410,0.00032399,96.29098049
23937,聽課,2,594412,0.00032399,96.29130447
23938,聽覺,2,594414,0.00032399,96.29162846
23939,襲來,2,594416,0.00032399,96.29195245
23940,襲捲,2,594418,0.00032399,96.29227644
23941,讀物,2,594420,0.00032399,96.29260043
23942,讀書會,2,594422,0.00032399,96.29292442
23943,讀訊,2,594424,0.00032399,96.29324841
23944,贖回,2,594426,0.00032399,96.29357239
23945,贖金,2,594428,0.00032399,96.29389638
23946,鑄造業,2,594430,0.00032399,96.29422037
23947,鑑別,2,594432,0.00032399,96.29454436
23948,鑑定報告,2,594434,0.00032399,96.29486835
23949,鬚毛,2,594436,0.00032399,96.29519234
23950,戀,2,594438,0.00032399,96.29551632
23951,戀人,2,594440,0.00032399,96.29584031
23952,戀棧,2,594442,0.00032399,96.29616430
23953,攪,2,594444,0.00032399,96.29648829
23954,竊取,2,594446,0.00032399,96.29681228
23955,竊盜險,2,594448,0.00032399,96.29713627
23956,竊賊,2,594450,0.00032399,96.29746025
23957,纖維質,2,594452,0.00032399,96.29778424
23958,蘿絲特,2,594454,0.00032399,96.29810823
23959,蠱惑,2,594456,0.00032399,96.29843222
23960,變化球,2,594458,0.00032399,96.29875621
23961,變局,2,594460,0.00032399,96.29908020
23962,變身,2,594462,0.00032399,96.29940419
23963,變為,2,594464,0.00032399,96.29972817
23964,變相,2,594466,0.00032399,96.30005216
23965,變通,2,594468,0.00032399,96.30037615
23966,變調,2,594470,0.00032399,96.30070014
23967,顯出,2,594472,0.00032399,96.30102413
23968,顯影盆,2,594474,0.00032399,96.30134812
23969,顯耀,2,594476,0.00032399,96.30167210
23970,驚世駭俗,2,594478,0.00032399,96.30199609
23971,驚呼,2,594480,0.00032399,96.30232008
23972,驚悚,2,594482,0.00032399,96.30264407
23973,驚覺,2,594484,0.00032399,96.30296806
23974,體育委員會,2,594486,0.00032399,96.30329205
23975,體委會,2,594488,0.00032399,96.30361603
23976,體面,2,594490,0.00032399,96.30394002
23977,體弱,2,594492,0.00032399,96.30426401
23978,體裁,2,594494,0.00032399,96.30458800
23979,體貼入微,2,594496,0.00032399,96.30491199
23980,體壇,2,594498,0.00032399,96.30523598
23981,罐裝,2,594500,0.00032399,96.30555997
23982,讓法,2,594502,0.00032399,96.30588395
23983,靈丹,2,594504,0.00032399,96.30620794
23984,靈活性,2,594506,0.00032399,96.30653193
23985,靈活度,2,594508,0.00032399,96.30685592
23986,靈動,2,594510,0.00032399,96.30717991
23987,驟減,2,594512,0.00032399,96.30750390
23988,驟然,2,594514,0.00032399,96.30782788
23989,鬢,2,594516,0.00032399,96.30815187
23990,鹽工,2,594518,0.00032399,96.30847586
23991,鹽分,2,594520,0.00032399,96.30879985
23992,鹽民,2,594522,0.00032399,96.30912384
23993,鹽柱,2,594524,0.00032399,96.30944783
23994,鹽場,2,594526,0.00032399,96.30977181
23995,鹽業,2,594528,0.00032399,96.31009580
23996,灣,2,594530,0.00032399,96.31041979
23997,灣裡地區,2,594532,0.00032399,96.31074378
23998,觀日大地,2,594534,0.00032399,96.31106777
23999,觀念性,2,594536,0.00032399,96.31139176
24000,觀音,2,594538,0.00032399,96.31171575
24001,觀音鄉,2,594540,0.00032399,96.31203973
24002,觀察家,2,594542,0.00032399,96.31236372
24003,觀賞者,2,594544,0.00032399,96.31268771
24004,觀瞻,2,594546,0.00032399,96.31301170
24005,鑰匙卡,2,594548,0.00032399,96.31333569
24006,顱骨,2,594550,0.00032399,96.31365968
24007,髖,2,594552,0.00032399,96.31398366
24008,鬣狗,2,594554,0.00032399,96.31430765
24009,讚美詩,2,594556,0.00032399,96.31463164
24010,讚許,2,594558,0.00032399,96.31495563
24011,讚頌,2,594560,0.00032399,96.31527962
24012,讚歎,2,594562,0.00032399,96.31560361
24013,鑽進,2,594564,0.00032399,96.31592759
24014,鱷魚蛋,2,594566,0.00032399,96.31625158
24015,鬱,2,594568,0.00032399,96.31657557
24016,籲,2,594570,0.00032399,96.31689956
24017,扺,2,594572,0.00032399,96.31722355
24018,芮內聖斯公司,2,594574,0.00032399,96.31754754
24019,芮氏地震規模,2,594576,0.00032399,96.31787153
24020,芮納斯,2,594578,0.00032399,96.31819551
24021,芡粉,2,594580,0.00032399,96.31851950
24022,邰智源,2,594582,0.00032399,96.31884349
24023,涂德錡,2,594584,0.00032399,96.31916748
24024,紓解,2,594586,0.00032399,96.31949147
24025,茼蒿,2,594588,0.00032399,96.31981546
24026,据,2,594590,0.00032399,96.32013944
24027,焗,2,594592,0.00032399,96.32046343
24028,粘連,2,594594,0.00032399,96.32078742
24029,粘嫦鈺,2,594596,0.00032399,96.32111141
24030,袪,2,594598,0.00032399,96.32143540
24031,焢,2,594600,0.00032399,96.32175939
24032,羡慕,2,594602,0.00032399,96.32208338
24033,鈦,2,594604,0.00032399,96.32240736
24034,靳萍萍,2,594606,0.00032399,96.32273135
24035,榖,2,594608,0.00032399,96.32305534
24036,噁心,2,594610,0.00032399,96.32337933
24037,醍醐,2,594612,0.00032399,96.32370332
24038,鍺,2,594614,0.00032399,96.32402731
24039,瀦留,2,594616,0.00032399,96.32435129
24040,謾罵,2,594618,0.00032399,96.32467528
24041,蹧蹋,2,594620,0.00032399,96.32499927
24042,鎩羽而歸,2,594622,0.00032399,96.32532326
24043,飆車族,2,594624,0.00032399,96.32564725
24044,裏面,2,594626,0.00032399,96.32597124
24045,恒生指數,2,594628,0.00032399,96.32629522
24046,恒溫,2,594630,0.00032399,96.32661921
24047,�w,2,594632,0.00032399,96.32694320
24048,�茼�,1,594633,0.00016199,96.32710520
24049,�菑膜籈Q會,1,594634,0.00016199,96.32726719
24050,�菑膠`,1,594635,0.00016199,96.32742918
24051,��,1,594636,0.00016199,96.32759118
24052,��,1,594637,0.00016199,96.32775317
24053,一一二七美國空軍行動小組,1,594638,0.00016199,96.32791517
24054,一大步,1,594639,0.00016199,96.32807716
24055,一大堆,1,594640,0.00016199,96.32823916
24056,一己之力,1,594641,0.00016199,96.32840115
24057,一不小心,1,594642,0.00016199,96.32856314
24058,一不留神,1,594643,0.00016199,96.32872514
24059,一之鄉,1,594644,0.00016199,96.32888713
24060,一太郎,1,594645,0.00016199,96.32904913
24061,一心,1,594646,0.00016199,96.32921112
24062,一手包,1,594647,0.00016199,96.32937311
24063,一片片,1,594648,0.00016199,96.32953511
24064,一片空白,1,594649,0.00016199,96.32969710
24065,一去不回,1,594650,0.00016199,96.32985910
24066,一去不返,1,594651,0.00016199,96.33002109
24067,一打,1,594652,0.00016199,96.33018309
24068,一休和尚,1,594653,0.00016199,96.33034508
24069,一份子,1,594654,0.00016199,96.33050707
24070,一字陣,1,594655,0.00016199,96.33066907
24071,一年一度,1,594656,0.00016199,96.33083106
24072,一次變電所,1,594657,0.00016199,96.33099306
24073,一江春水向東流,1,594658,0.00016199,96.33115505
24074,一但,1,594659,0.00016199,96.33131705
24075,一技之長,1,594660,0.00016199,96.33147904
24076,一把罩,1,594661,0.00016199,96.33164103
24077,一肚子,1,594662,0.00016199,96.33180303
24078,一見如故,1,594663,0.00016199,96.33196502
24079,一角,1,594664,0.00016199,96.33212702
24080,一言不發,1,594665,0.00016199,96.33228901
24081,一事無成,1,594666,0.00016199,96.33245100
24082,一來,1,594667,0.00016199,96.33261300
24083,一呼百諾,1,594668,0.00016199,96.33277499
24084,一周,1,594669,0.00016199,96.33293699
24085,一命嗚呼,1,594670,0.00016199,96.33309898
24086,一延再延,1,594671,0.00016199,96.33326098
24087,一往直前,1,594672,0.00016199,96.33342297
24088,一念之間,1,594673,0.00016199,96.33358496
24089,一招半式,1,594674,0.00016199,96.33374696
24090,一拍即合,1,594675,0.00016199,96.33390895
24091,一抱,1,594676,0.00016199,96.33407095
24092,一枝獨秀,1,594677,0.00016199,96.33423294
24093,一知半解,1,594678,0.00016199,96.33439494
24094,一肩扛,1,594679,0.00016199,96.33455693
24095,一門,1,594680,0.00016199,96.33471892
24096,一柱擎天,1,594681,0.00016199,96.33488092
24097,一派,1,594682,0.00016199,96.33504291
24098,一炮而紅,1,594683,0.00016199,96.33520491
24099,一盆盆,1,594684,0.00016199,96.33536690
24100,一個好人,1,594685,0.00016199,96.33552889
24101,一家之主,1,594686,0.00016199,96.33569089
24102,一家家,1,594687,0.00016199,96.33585288
24103,一展所長,1,594688,0.00016199,96.33601488
24104,一展長才,1,594689,0.00016199,96.33617687
24105,一座座,1,594690,0.00016199,96.33633887
24106,一扇扇,1,594691,0.00016199,96.33650086
24107,一晃眼,1,594692,0.00016199,96.33666285
24108,一根扁擔,1,594693,0.00016199,96.33682485
24109,一眨眼,1,594694,0.00016199,96.33698684
24110,一級方程式賽車,1,594695,0.00016199,96.33714884
24111,一級主管,1,594696,0.00016199,96.33731083
24112,一級棒,1,594697,0.00016199,96.33747283
24113,一般觀察名單,1,594698,0.00016199,96.33763482
24114,一針見血,1,594699,0.00016199,96.33779681
24115,一陣兒,1,594700,0.00016199,96.33795881
24116,一陣陣,1,594701,0.00016199,96.33812080
24117,一乾二淨,1,594702,0.00016199,96.33828280
24118,一條簡單的道路,1,594703,0.00016199,96.33844479
24119,一清專案,1,594704,0.00016199,96.33860678
24120,一瓶瓶,1,594705,0.00016199,96.33876878
24121,一粒粒,1,594706,0.00016199,96.33893077
24122,一貫作業,1,594707,0.00016199,96.33909277
24123,一貫性,1,594708,0.00016199,96.33925476
24124,一部份,1,594709,0.00016199,96.33941676
24125,一勞永逸,1,594710,0.00016199,96.33957875
24126,一厥不振,1,594711,0.00016199,96.33974074
24127,一場場,1,594712,0.00016199,96.33990274
24128,一期稻作,1,594713,0.00016199,96.34006473
24129,一棵棵,1,594714,0.00016199,96.34022673
24130,一湧而上,1,594715,0.00016199,96.34038872
24131,一無所成,1,594716,0.00016199,96.34055072
24132,一無所有,1,594717,0.00016199,96.34071271
24133,一無是處,1,594718,0.00016199,96.34087470
24134,一絲一毫,1,594719,0.00016199,96.34103670
24135,一塌糊塗,1,594720,0.00016199,96.34119869
24136,一塊塊,1,594721,0.00016199,96.34136069
24137,一新里,1,594722,0.00016199,96.34152268
24138,一溜煙,1,594723,0.00016199,96.34168467
24139,一群群,1,594724,0.00016199,96.34184667
24140,一路上,1,594725,0.00016199,96.34200866
24141,一道,1,594726,0.00016199,96.34217066
24142,一道道,1,594727,0.00016199,96.34233265
24143,一鼓作氣,1,594728,0.00016199,96.34249465
24144,一團,1,594729,0.00016199,96.34265664
24145,一塵不染,1,594730,0.00016199,96.34281863
24146,一夥,1,594731,0.00016199,96.34298063
24147,一對一,1,594732,0.00016199,96.34314262
24148,一網打盡,1,594733,0.00016199,96.34330462
24149,一審,1,594734,0.00016199,96.34346661
24150,一線希望,1,594735,0.00016199,96.34362861
24151,一遭,1,594736,0.00016199,96.34379060
24152,一瞥,1,594737,0.00016199,96.34395259
24153,一親芳澤,1,594738,0.00016199,96.34411459
24154,一頭,1,594739,0.00016199,96.34427658
24155,一應具全,1,594740,0.00016199,96.34443858
24156,一應俱全,1,594741,0.00016199,96.34460057
24157,一聲聲,1,594742,0.00016199,96.34476257
24158,一臂之力,1,594743,0.00016199,96.34492456
24159,一臉,1,594744,0.00016199,96.34508655
24160,一舉數得,1,594745,0.00016199,96.34524855
24161,一顆顆,1,594746,0.00016199,96.34541054
24162,一點不假,1,594747,0.00016199,96.34557254
24163,一壘安打,1,594748,0.00016199,96.34573453
24164,一擲千金,1,594749,0.00016199,96.34589652
24165,一曝十寒,1,594750,0.00016199,96.34605852
24166,一簾幽夢,1,594751,0.00016199,96.34622051
24167,一蹴可幾,1,594752,0.00016199,96.34638251
24168,一讀,1,594753,0.00016199,96.34654450
24169,一罐罐,1,594754,0.00016199,96.34670650
24170,一籮筐,1,594755,0.00016199,96.34686849
24171,乙種國庫券,1,594756,0.00016199,96.34703048
24172,乙醛,1,594757,0.00016199,96.34719248
24173,乙醯膽素脂,1,594758,0.00016199,96.34735447
24174,丁字陣,1,594759,0.00016199,96.34751647
24175,丁守中,1,594760,0.00016199,96.34767846
24176,丁竹知,1,594761,0.00016199,96.34784046
24177,丁育群,1,594762,0.00016199,96.34800245
24178,丁香蘿蔔,1,594763,0.00016199,96.34816444
24179,丁桐源,1,594764,0.00016199,96.34832644
24180,丁萬鳴,1,594765,0.00016199,96.34848843
24181,丁懋時,1,594766,0.00016199,96.34865043
24182,七十年代文化十事,1,594767,0.00016199,96.34881242
24183,七巧板,1,594768,0.00016199,96.34897441
24184,七股工業區,1,594769,0.00016199,96.34913641
24185,七股鄉土協進會,1,594770,0.00016199,96.34929840
24186,七股鄉民代表,1,594771,0.00016199,96.34946040
24187,七股鹽場,1,594772,0.00016199,96.34962239
24188,七屍八命,1,594773,0.00016199,96.34978439
24189,七個畢業生,1,594774,0.00016199,96.34994638
24190,七堵,1,594775,0.00016199,96.35010837
24191,七爺八爺,1,594776,0.00016199,96.35027037
24192,七輕,1,594777,0.00016199,96.35043236
24193,七嘴八舌,1,594778,0.00016199,96.35059436
24194,七賢二路,1,594779,0.00016199,96.35075635
24195,七寶,1,594780,0.00016199,96.35091835
24196,九一記者節,1,594781,0.00016199,96.35108034
24197,九二無鉛,1,594782,0.00016199,96.35124233
24198,九三軍人節,1,594783,0.00016199,96.35140433
24199,九五無鉛汽油,1,594784,0.00016199,96.35156632
24200,九份,1,594785,0.00016199,96.35172832
24201,九如一路,1,594786,0.00016199,96.35189031
24202,九州自然動物公園,1,594787,0.00016199,96.35205230
24203,九局,1,594788,0.00016199,96.35221430
24204,九命怪貓,1,594789,0.00016199,96.35237629
24205,九重部屋相撲團,1,594790,0.00016199,96.35253829
24206,九族文化村,1,594791,0.00016199,96.35270028
24207,九歌,1,594792,0.00016199,96.35286228
24208,九霄,1,594793,0.00016199,96.35302427
24209,九龍,1,594794,0.00016199,96.35318626
24210,九轉丹,1,594795,0.00016199,96.35334826
24211,了事,1,594796,0.00016199,96.35351025
24212,了卻,1,594797,0.00016199,96.35367225
24213,了得,1,594798,0.00016199,96.35383424
24214,了結,1,594799,0.00016199,96.35399624
24215,二刀頭,1,594800,0.00016199,96.35415823
24216,二分球,1,594801,0.00016199,96.35432022
24217,二位數,1,594802,0.00016199,96.35448222
24218,二呆藝館,1,594803,0.00016199,96.35464421
24219,二金紅,1,594804,0.00016199,96.35480621
24220,二度空間,1,594805,0.00016199,96.35496820
24221,二郎腿,1,594806,0.00016199,96.35513019
24222,二氧化矽,1,594807,0.00016199,96.35529219
24223,二氧化硫,1,594808,0.00016199,96.35545418
24224,二氧化氮,1,594809,0.00016199,96.35561618
24225,二期航空站,1,594810,0.00016199,96.35577817
24226,二期稻作,1,594811,0.00016199,96.35594017
24227,二游,1,594812,0.00016199,96.35610216
24228,二極化,1,594813,0.00016199,96.35626415
24229,二讀,1,594814,0.00016199,96.35642615
24230,人丁,1,594815,0.00016199,96.35658814
24231,人力車,1,594816,0.00016199,96.35675014
24232,人力資源,1,594817,0.00016199,96.35691213
24233,人力資源顧問公司,1,594818,0.00016199,96.35707413
24234,人口成長率,1,594819,0.00016199,96.35723612
24235,人口販子,1,594820,0.00016199,96.35739811
24236,人口普查局,1,594821,0.00016199,96.35756011
24237,人口數,1,594822,0.00016199,96.35772210
24238,人口論,1,594823,0.00016199,96.35788410
24239,人大副委員長,1,594824,0.00016199,96.35804609
24240,人工甘味,1,594825,0.00016199,96.35820808
24241,人工色素,1,594826,0.00016199,96.35837008
24242,人工添加物,1,594827,0.00016199,96.35853207
24243,人工器官,1,594828,0.00016199,96.35869407
24244,人工關節,1,594829,0.00016199,96.35885606
24245,人才培訓,1,594830,0.00016199,96.35901806
24246,人中,1,594831,0.00016199,96.35918005
24247,人孔工程,1,594832,0.00016199,96.35934204
24248,人心浮動,1,594833,0.00016199,96.35950404
24249,人文協進會,1,594834,0.00016199,96.35966603
24250,人文報導,1,594835,0.00016199,96.35982803
24251,人文精神,1,594836,0.00016199,96.35999002
24252,人本主義,1,594837,0.00016199,96.36015202
24253,人民解放軍,1,594838,0.00016199,96.36031401
24254,人犯,1,594839,0.00016199,96.36047600
24255,人生是夢,1,594840,0.00016199,96.36063800
24256,人因科技,1,594841,0.00016199,96.36079999
24257,人肉盾牌,1,594842,0.00016199,96.36096199
24258,人肉戰車,1,594843,0.00016199,96.36112398
24259,人行磚,1,594844,0.00016199,96.36128597
24260,人形,1,594845,0.00016199,96.36144797
24261,人我,1,594846,0.00016199,96.36160996
24262,人材,1,594847,0.00016199,96.36177196
24263,人身攻擊,1,594848,0.00016199,96.36193395
24264,人事任命同意權,1,594849,0.00016199,96.36209595
24265,人事案,1,594850,0.00016199,96.36225794
24266,人兒,1,594851,0.00016199,96.36241993
24267,人味,1,594852,0.00016199,96.36258193
24268,人命關天,1,594853,0.00016199,96.36274392
24269,人性主義,1,594854,0.00016199,96.36290592
24270,人治,1,594855,0.00016199,96.36306791
24271,人格權,1,594856,0.00016199,96.36322991
24272,人財兩失,1,594857,0.00016199,96.36339190
24273,人馬座,1,594858,0.00016199,96.36355389
24274,人馬路,1,594859,0.00016199,96.36371589
24275,人參樂,1,594860,0.00016199,96.36387788
24276,人問,1,594861,0.00016199,96.36403988
24277,人情冷暖,1,594862,0.00016199,96.36420187
24278,人情味,1,594863,0.00016199,96.36436386
24279,人造物,1,594864,0.00016199,96.36452586
24280,人造溫泉海灘,1,594865,0.00016199,96.36468785
24281,人造衛星,1,594866,0.00016199,96.36484985
24282,人評會,1,594867,0.00016199,96.36501184
24283,人週刊,1,594868,0.00016199,96.36517384
24284,人間雜誌,1,594869,0.00016199,96.36533583
24285,人猿,1,594870,0.00016199,96.36549782
24286,人道精神,1,594871,0.00016199,96.36565982
24287,人道價值觀,1,594872,0.00016199,96.36582181
24288,人壽,1,594873,0.00016199,96.36598381
24289,人壽保險公司,1,594874,0.00016199,96.36614580
24290,人稱,1,594875,0.00016199,96.36630780
24291,人與土地,1,594876,0.00016199,96.36646979
24292,人潮洶湧,1,594877,0.00016199,96.36663178
24293,人緣,1,594878,0.00016199,96.36679378
24294,人謀不臧,1,594879,0.00016199,96.36695577
24295,人擠人,1,594880,0.00016199,96.36711777
24296,人類學,1,594881,0.00016199,96.36727976
24297,人權法,1,594882,0.00016199,96.36744175
24298,人權運動,1,594883,0.00016199,96.36760375
24299,人體功學,1,594884,0.00016199,96.36776574
24300,人蔘,1,594885,0.00016199,96.36792774
24301,入內,1,594886,0.00016199,96.36808973
24302,入世,1,594887,0.00016199,96.36825173
24303,入主,1,594888,0.00016199,96.36841372
24304,入股,1,594889,0.00016199,96.36857571
24305,入夏,1,594890,0.00016199,96.36873771
24306,入射式,1,594891,0.00016199,96.36889970
24307,入座,1,594892,0.00016199,96.36906170
24308,入時,1,594893,0.00016199,96.36922369
24309,入海,1,594894,0.00016199,96.36938569
24310,入貨,1,594895,0.00016199,96.36954768
24311,入會費,1,594896,0.00016199,96.36970967
24312,入團,1,594897,0.00016199,96.36987167
24313,入榜,1,594898,0.00016199,96.37003366
24314,入睡,1,594899,0.00016199,96.37019566
24315,入網,1,594900,0.00016199,96.37035765
24316,入駐區,1,594901,0.00016199,96.37051964
24317,八一女排隊,1,594902,0.00016199,96.37068164
24318,八二三,1,594903,0.00016199,96.37084363
24319,八二三炮戰,1,594904,0.00016199,96.37100563
24320,八千里路雲和月,1,594905,0.00016199,96.37116762
24321,八仙燈,1,594906,0.00016199,96.37132962
24322,八吋晶圓代工廠,1,594907,0.00016199,96.37149161
24323,八卦,1,594908,0.00016199,96.37165360
24324,八卦山度假村,1,594909,0.00016199,96.37181560
24325,八音,1,594910,0.00016199,96.37197759
24326,八哥,1,594911,0.00016199,96.37213959
24327,八國聯軍,1,594912,0.00016199,96.37230158
24328,八連集電廠,1,594913,0.00016199,96.37246358
24329,八德二路,1,594914,0.00016199,96.37262557
24330,刀叉,1,594915,0.00016199,96.37278756
24331,刀口,1,594916,0.00016199,96.37294956
24332,刀片,1,594917,0.00016199,96.37311155
24333,刀塔,1,594918,0.00016199,96.37327355
24334,刀槍,1,594919,0.00016199,96.37343554
24335,刀劍,1,594920,0.00016199,96.37359754
24336,刁鑽,1,594921,0.00016199,96.37375953
24337,力山輕型工具機,1,594922,0.00016199,96.37392152
24338,力不從心,1,594923,0.00016199,96.37408352
24339,力守,1,594924,0.00016199,96.37424551
24340,力有未逮,1,594925,0.00016199,96.37440751
24341,力克,1,594926,0.00016199,96.37456950
24342,力抗,1,594927,0.00016199,96.37473149
24343,力阻,1,594928,0.00016199,96.37489349
24344,力保,1,594929,0.00016199,96.37505548
24345,力促,1,594930,0.00016199,96.37521748
24346,力捷集團,1,594931,0.00016199,96.37537947
24347,力捷電腦,1,594932,0.00016199,96.37554147
24348,力捷精英集團,1,594933,0.00016199,96.37570346
24349,力創,1,594934,0.00016199,96.37586545
24350,力場,1,594935,0.00016199,96.37602745
24351,力新,1,594936,0.00016199,96.37618944
24352,力圖振作,1,594937,0.00016199,96.37635144
24353,力麗,1,594938,0.00016199,96.37651343
24354,力霸房屋,1,594939,0.00016199,96.37667543
24355,力霸房屋公司,1,594940,0.00016199,96.37683742
24356,力霸集團,1,594941,0.00016199,96.37699941
24357,十二橡園,1,594942,0.00016199,96.37716141
24358,十大死亡原因,1,594943,0.00016199,96.37732340
24359,十大傑出女青年,1,594944,0.00016199,96.37748540
24360,十大傑出青年選拔籌備委員會,1,594945,0.00016199,96.37764739
24361,十大富豪,1,594946,0.00016199,96.37780938
24362,十六釐米底片,1,594947,0.00016199,96.37797138
24363,十月革命,1,594948,0.00016199,96.37813337
24364,十月革命廣場,1,594949,0.00016199,96.37829537
24365,十四全會,1,594950,0.00016199,96.37845736
24366,十四隻老鼠大搬家,1,594951,0.00016199,96.37861936
24367,十字,1,594952,0.00016199,96.37878135
24368,十字街頭,1,594953,0.00016199,96.37894334
24369,十字路口,1,594954,0.00016199,96.37910534
24370,十信,1,594955,0.00016199,96.37926733
24371,十誡,1,594956,0.00016199,96.37942933
24372,卜,1,594957,0.00016199,96.37959132
24373,卜邦貽,1,594958,0.00016199,96.37975332
24374,又唱又叫,1,594959,0.00016199,96.37991531
24375,三二九,1,594960,0.00016199,96.38007730
24376,三刀頭,1,594961,0.00016199,96.38023930
24377,三上三下,1,594962,0.00016199,96.38040129
24378,三井商事公司,1,594963,0.00016199,96.38056329
24379,三五好友,1,594964,0.00016199,96.38072528
24380,三分線,1,594965,0.00016199,96.38088727
24381,三天兩頭,1,594966,0.00016199,96.38104927
24382,三心兩意,1,594967,0.00016199,96.38121126
24383,三手車,1,594968,0.00016199,96.38137326
24384,三毛,1,594969,0.00016199,96.38153525
24385,三代古金文存,1,594970,0.00016199,96.38169725
24386,三代同堂,1,594971,0.00016199,96.38185924
24387,三令五申,1,594972,0.00016199,96.38202123
24388,三巨頭,1,594973,0.00016199,96.38218323
24389,三民區,1,594974,0.00016199,96.38234522
24390,三好耕三,1,594975,0.00016199,96.38250722
24391,三位一體,1,594976,0.00016199,96.38266921
24392,三更半夜,1,594977,0.00016199,96.38283121
24393,三角洲,1,594978,0.00016199,96.38299320
24394,三宗烤盤,1,594979,0.00016199,96.38315519
24395,三芝鄉,1,594980,0.00016199,96.38331719
24396,三采,1,594981,0.00016199,96.38347918
24397,三信,1,594982,0.00016199,96.38364118
24398,三度空間,1,594983,0.00016199,96.38380317
24399,三思而行,1,594984,0.00016199,96.38396516
24400,三思後行,1,594985,0.00016199,96.38412716
24401,三星物產,1,594986,0.00016199,96.38428915
24402,三軍劇隊,1,594987,0.00016199,96.38445115
24403,三重幫,1,594988,0.00016199,96.38461314
24404,三缺一,1,594989,0.00016199,96.38477514
24405,三商巧福,1,594990,0.00016199,96.38493713
24406,三商百貨,1,594991,0.00016199,96.38509912
24407,三商職棒,1,594992,0.00016199,96.38526112
24408,三國,1,594993,0.00016199,96.38542311
24409,三國幻想曲,1,594994,0.00016199,96.38558511
24410,三國遊戲,1,594995,0.00016199,96.38574710
24411,三國演義,1,594996,0.00016199,96.38590910
24412,三教九流,1,594997,0.00016199,96.38607109
24413,三條股份有限公司,1,594998,0.00016199,96.38623308
24414,三通概念股,1,594999,0.00016199,96.38639508
24415,三連音,1,595000,0.00016199,96.38655707
24416,三部曲,1,595001,0.00016199,96.38671907
24417,三番二次,1,595002,0.00016199,96.38688106
24418,三菱日蝕,1,595003,0.00016199,96.38704305
24419,三菱悍馬,1,595004,0.00016199,96.38720505
24420,三陽,1,595005,0.00016199,96.38736704
24421,三陽公司,1,595006,0.00016199,96.38752904
24422,三媽,1,595007,0.00016199,96.38769103
24423,三腳架座,1,595008,0.00016199,96.38785303
24424,三碟式,1,595009,0.00016199,96.38801502
24425,三酸甘油脂,1,595010,0.00016199,96.38817701
24426,三審,1,595011,0.00016199,96.38833901
24427,三層肉,1,595012,0.00016199,96.38850100
24428,三澤敬義,1,595013,0.00016199,96.38866300
24429,三興里,1,595014,0.00016199,96.38882499
24430,三檔,1,595015,0.00016199,96.38898699
24431,三總,1,595016,0.00016199,96.38914898
24432,三壘手,1,595017,0.00016199,96.38931097
24433,三壘安打,1,595018,0.00016199,96.38947297
24434,三灣,1,595019,0.00016199,96.38963496
24435,下一波,1,595020,0.00016199,96.38979696
24436,下刀,1,595021,0.00016199,96.38995895
24437,下支臂式,1,595022,0.00016199,96.39012094
24438,下文,1,595023,0.00016199,96.39028294
24439,下水道,1,595024,0.00016199,96.39044493
24440,下半季,1,595025,0.00016199,96.39060693
24441,下回,1,595026,0.00016199,96.39076892
24442,下年度,1,595027,0.00016199,96.39093092
24443,下尿路,1,595028,0.00016199,96.39109291
24444,下肚,1,595029,0.00016199,96.39125490
24445,下谷,1,595030,0.00016199,96.39141690
24446,下坡,1,595031,0.00016199,96.39157889
24447,下定決心,1,595032,0.00016199,96.39174089
24448,下拉式功能表,1,595033,0.00016199,96.39190288
24449,下雨天,1,595034,0.00016199,96.39206488
24450,下流,1,595035,0.00016199,96.39222687
24451,下限,1,595036,0.00016199,96.39238886
24452,下唇,1,595037,0.00016199,96.39255086
24453,下眼皮,1,595038,0.00016199,96.39271285
24454,下船,1,595039,0.00016199,96.39287485
24455,下棋,1,595040,0.00016199,96.39303684
24456,下痢,1,595041,0.00016199,96.39319883
24457,下痢型,1,595042,0.00016199,96.39336083
24458,下策,1,595043,0.00016199,96.39352282
24459,下階層,1,595044,0.00016199,96.39368482
24460,下新厝,1,595045,0.00016199,96.39384681
24461,下落,1,595046,0.00016199,96.39400881
24462,下落不明,1,595047,0.00016199,96.39417080
24463,下達,1,595048,0.00016199,96.39433279
24464,下滿,1,595049,0.00016199,96.39449479
24465,下獄,1,595050,0.00016199,96.39465678
24466,下網,1,595051,0.00016199,96.39481878
24467,下廚,1,595052,0.00016199,96.39498077
24468,下盤,1,595053,0.00016199,96.39514277
24469,下檔,1,595054,0.00016199,96.39530476
24470,下聯,1,595055,0.00016199,96.39546675
24471,下鍋,1,595056,0.00016199,96.39562875
24472,下顎,1,595057,0.00016199,96.39579074
24473,下嚥,1,595058,0.00016199,96.39595274
24474,下麵,1,595059,0.00016199,96.39611473
24475,丈二金剛,1,595060,0.00016199,96.39627672
24476,丈人,1,595061,0.00016199,96.39643872
24477,丈八蛇,1,595062,0.00016199,96.39660071
24478,丈夫型,1,595063,0.00016199,96.39676271
24479,上下文,1,595064,0.00016199,96.39692470
24480,上工,1,595065,0.00016199,96.39708670
24481,上允傳播股份有限公司,1,595066,0.00016199,96.39724869
24482,上古,1,595067,0.00016199,96.39741068
24483,上市,1,595068,0.00016199,96.39757268
24484,上白礁謁祖大典,1,595069,0.00016199,96.39773467
24485,上白礁謁祖祭典,1,595070,0.00016199,96.39789667
24486,上白醮,1,595071,0.00016199,96.39805866
24487,上吐下瀉,1,595072,0.00016199,96.39822066
24488,上年度,1,595073,0.00016199,96.39838265
24489,上尿路,1,595074,0.00016199,96.39854464
24490,上床,1,595075,0.00016199,96.39870664
24491,上杉,1,595076,0.00016199,96.39886863
24492,上杉佳郎,1,595077,0.00016199,96.39903063
24493,上身,1,595078,0.00016199,96.39919262
24494,上岸,1,595079,0.00016199,96.39935461
24495,上昇,1,595080,0.00016199,96.39951661
24496,上流社會,1,595081,0.00016199,96.39967860
24497,上風,1,595082,0.00016199,96.39984060
24498,上乘,1,595083,0.00016199,96.40000259
24499,上師相應法,1,595084,0.00016199,96.40016459
24500,上書,1,595085,0.00016199,96.40032658
24501,上桌,1,595086,0.00016199,96.40048857
24502,上海市工商行政管理局,1,595087,0.00016199,96.40065057
24503,上海京劇院,1,595088,0.00016199,96.40081256
24504,上海明星公司,1,595089,0.00016199,96.40097456
24505,上海的早晨,1,595090,0.00016199,96.40113655
24506,上海醫院,1,595091,0.00016199,96.40129855
24507,上班女郎命案,1,595092,0.00016199,96.40146054
24508,上眼皮,1,595093,0.00016199,96.40162253
24509,上菜,1,595094,0.00016199,96.40178453
24510,上進心,1,595095,0.00016199,96.40194652
24511,上傳,1,595096,0.00016199,96.40210852
24512,上新世,1,595097,0.00016199,96.40227051
24513,上溯,1,595098,0.00016199,96.40243251
24514,上源,1,595099,0.00016199,96.40259450
24515,上裝,1,595100,0.00016199,96.40275649
24516,上道,1,595101,0.00016199,96.40291849
24517,上達,1,595102,0.00016199,96.40308048
24518,上漲率,1,595103,0.00016199,96.40324248
24519,上福,1,595104,0.00016199,96.40340447
24520,上賓,1,595105,0.00016199,96.40356646
24521,上機,1,595106,0.00016199,96.40372846
24522,上穎工業,1,595107,0.00016199,96.40389045
24523,上選,1,595108,0.00016199,96.40405245
24524,上戲,1,595109,0.00016199,96.40421444
24525,上櫃股,1,595110,0.00016199,96.40437644
24526,上鏜,1,595111,0.00016199,96.40453843
24527,上騰,1,595112,0.00016199,96.40470042
24528,丸,1,595113,0.00016199,96.40486242
24529,丸紅,1,595114,0.00016199,96.40502441
24530,凡人,1,595115,0.00016199,96.40518641
24531,凡夫心,1,595116,0.00016199,96.40534840
24532,凡夫俗子,1,595117,0.00016199,96.40551040
24533,久津,1,595118,0.00016199,96.40567239
24534,久聞大名,1,595119,0.00016199,96.40583438
24535,么子,1,595120,0.00016199,96.40599638
24536,也內史陀．拉克勞,1,595121,0.00016199,96.40615837
24537,也有,1,595122,0.00016199,96.40632037
24538,也放,1,595123,0.00016199,96.40648236
24539,也能,1,595124,0.00016199,96.40664435
24540,也將,1,595125,0.00016199,96.40680635
24541,也就,1,595126,0.00016199,96.40696834
24542,于文正,1,595127,0.00016199,96.40713034
24543,于國華,1,595128,0.00016199,96.40729233
24544,亡羊補牢,1,595129,0.00016199,96.40745433
24545,勺,1,595130,0.00016199,96.40761632
24546,千代田區,1,595131,0.00016199,96.40777831
24547,千里眼,1,595132,0.00016199,96.40794031
24548,千里達,1,595133,0.00016199,96.40810230
24549,千奇百怪,1,595134,0.00016199,96.40826430
24550,千金,1,595135,0.00016199,96.40842629
24551,千島湖,1,595136,0.00016199,96.40858829
24552,千翔公司,1,595137,0.00016199,96.40875028
24553,千翔保全股份有限公司,1,595138,0.00016199,96.40891227
24554,千歲街,1,595139,0.00016199,96.40907427
24555,千載難逢,1,595140,0.00016199,96.40923626
24556,千頭萬緒,1,595141,0.00016199,96.40939826
24557,千變萬化,1,595142,0.00016199,96.40956025
24558,叉燒派,1,595143,0.00016199,96.40972224
24559,口不擇言,1,595144,0.00016199,96.40988424
24560,口中,1,595145,0.00016199,96.41004623
24561,口白,1,595146,0.00016199,96.41020823
24562,口吃妹,1,595147,0.00016199,96.41037022
24563,口耳,1,595148,0.00016199,96.41053222
24564,口技,1,595149,0.00016199,96.41069421
24565,口角炎,1,595150,0.00016199,96.41085620
24566,口音,1,595151,0.00016199,96.41101820
24567,口香糖公司,1,595152,0.00016199,96.41118019
24568,口臭,1,595153,0.00016199,96.41134219
24569,口乾,1,595154,0.00016199,96.41150418
24570,口乾舌燥,1,595155,0.00016199,96.41166618
24571,口部,1,595156,0.00016199,96.41182817
24572,口渴,1,595157,0.00016199,96.41199016
24573,口訴,1,595158,0.00016199,96.41215216
24574,口實,1,595159,0.00016199,96.41231415
24575,口語,1,595160,0.00016199,96.41247615
24576,口說無憑,1,595161,0.00016199,96.41263814
24577,口鼻,1,595162,0.00016199,96.41280013
24578,口德,1,595163,0.00016199,96.41296213
24579,口齒,1,595164,0.00016199,96.41312412
24580,口齒清晰,1,595165,0.00016199,96.41328612
24581,口頭禪,1,595166,0.00016199,96.41344811
24582,土土,1,595167,0.00016199,96.41361011
24583,土木,1,595168,0.00016199,96.41377210
24584,土木工程,1,595169,0.00016199,96.41393409
24585,土生土長,1,595170,0.00016199,96.41409609
24586,土地公告現值,1,595171,0.00016199,96.41425808
24587,土地分區管制使用規定,1,595172,0.00016199,96.41442008
24588,土地免納營利事業所得稅,1,595173,0.00016199,96.41458207
24589,土地政策,1,595174,0.00016199,96.41474407
24590,土耳其人,1,595175,0.00016199,96.41490606
24591,土坡,1,595176,0.00016199,96.41506805
24592,土炮,1,595177,0.00016199,96.41523005
24593,土風舞,1,595178,0.00016199,96.41539204
24594,土庫人,1,595179,0.00016199,96.41555404
24595,土產,1,595180,0.00016199,96.41571603
24596,土著,1,595181,0.00016199,96.41587802
24597,土黃,1,595182,0.00016199,96.41604002
24598,土黃色,1,595183,0.00016199,96.41620201
24599,土塊,1,595184,0.00016199,96.41636401
24600,土質,1,595185,0.00016199,96.41652600
24601,土器,1,595186,0.00016199,96.41668800
24602,土器手司,1,595187,0.00016199,96.41684999
24603,土龍,1,595188,0.00016199,96.41701198
24604,土雞城,1,595189,0.00016199,96.41717398
24605,士人,1,595190,0.00016199,96.41733597
24606,士大夫,1,595191,0.00016199,96.41749797
24607,士大夫畫,1,595192,0.00016199,96.41765996
24608,士官役,1,595193,0.00016199,96.41782196
24609,士林地方法院,1,595194,0.00016199,96.41798395
24610,士林地檢署,1,595195,0.00016199,96.41814594
24611,士氣如虹,1,595196,0.00016199,96.41830794
24612,士紳,1,595197,0.00016199,96.41846993
24613,士電,1,595198,0.00016199,96.41863193
24614,夕爾,1,595199,0.00016199,96.41879392
24615,大�C,1,595200,0.00016199,96.41895591
24616,大刀闊斧,1,595201,0.00016199,96.41911791
24617,大力士,1,595202,0.00016199,96.41927990
24618,大三,1,595203,0.00016199,96.41944190
24619,大丈夫,1,595204,0.00016199,96.41960389
24620,大大方方,1,595205,0.00016199,96.41976589
24621,大小事,1,595206,0.00016199,96.41992788
24622,大小周后,1,595207,0.00016199,96.42008987
24623,大小通吃,1,595208,0.00016199,96.42025187
24624,大不列顛,1,595209,0.00016199,96.42041386
24625,大不諱,1,595210,0.00016199,96.42057586
24626,大丹,1,595211,0.00016199,96.42073785
24627,大內,1,595212,0.00016199,96.42089985
24628,大內密探零零發,1,595213,0.00016199,96.42106184
24629,大公,1,595214,0.00016199,96.42122383
24630,大公無私,1,595215,0.00016199,96.42138583
24631,大公街,1,595216,0.00016199,96.42154782
24632,大友克洋,1,595217,0.00016199,96.42170982
24633,大夫,1,595218,0.00016199,96.42187181
24634,大屯山,1,595219,0.00016199,96.42203380
24635,大文豪,1,595220,0.00016199,96.42219580
24636,大方向,1,595221,0.00016199,96.42235779
24637,大方送,1,595222,0.00016199,96.42251979
24638,大犬座,1,595223,0.00016199,96.42268178
24639,大王椰,1,595224,0.00016199,96.42284378
24640,大主流,1,595225,0.00016199,96.42300577
24641,大功,1,595226,0.00016199,96.42316776
24642,大可放心,1,595227,0.00016199,96.42332976
24643,大可倫坡經濟委員會,1,595228,0.00016199,96.42349175
24644,大叫,1,595229,0.00016199,96.42365375
24645,大台北都會區,1,595230,0.00016199,96.42381574
24646,大台北焦點,1,595231,0.00016199,96.42397774
24647,大打折扣,1,595232,0.00016199,96.42413973
24648,大正,1,595233,0.00016199,96.42430172
24649,大甲媽祖,1,595234,0.00016199,96.42446372
24650,大白菜,1,595235,0.00016199,96.42462571
24651,大立伊勢丹,1,595236,0.00016199,96.42478771
24652,大伙,1,595237,0.00016199,96.42494970
24653,大吉,1,595238,0.00016199,96.42511169
24654,大同分局,1,595239,0.00016199,96.42527369
24655,大同里,1,595240,0.00016199,96.42543568
24656,大同國小,1,595241,0.00016199,96.42559768
24657,大合唱,1,595242,0.00016199,96.42575967
24658,大吃一驚,1,595243,0.00016199,96.42592167
24659,大好機會,1,595244,0.00016199,96.42608366
24660,大宇,1,595245,0.00016199,96.42624565
24661,大宇宙,1,595246,0.00016199,96.42640765
24662,大安區公所,1,595247,0.00016199,96.42656964
24663,大安森林公園,1,595248,0.00016199,96.42673164
24664,大有人在,1,595249,0.00016199,96.42689363
24665,大有改善,1,595250,0.00016199,96.42705563
24666,大江南北,1,595251,0.00016199,96.42721762
24667,大羽,1,595252,0.00016199,96.42737961
24668,大老婆,1,595253,0.00016199,96.42754161
24669,大老婆俱樂部,1,595254,0.00016199,96.42770360
24670,大老遠,1,595255,0.00016199,96.42786560
24671,大而化之,1,595256,0.00016199,96.42802759
24672,大行其道,1,595257,0.00016199,96.42818958
24673,大衣,1,595258,0.00016199,96.42835158
24674,大西洋,1,595259,0.00016199,96.42851357
24675,大西洋月刊,1,595260,0.00016199,96.42867557
24676,大兵週記,1,595261,0.00016199,96.42883756
24677,大局,1,595262,0.00016199,96.42899956
24678,大忌,1,595263,0.00016199,96.42916155
24679,大我,1,595264,0.00016199,96.42932354
24680,大材小用,1,595265,0.00016199,96.42948554
24681,大步,1,595266,0.00016199,96.42964753
24682,大沙彎海水浴場,1,595267,0.00016199,96.42980953
24683,大男人主義,1,595268,0.00016199,96.42997152
24684,大肚,1,595269,0.00016199,96.43013352
24685,大肚溪,1,595270,0.00016199,96.43029551
24686,大里,1,595271,0.00016199,96.43045750
24687,大亞,1,595272,0.00016199,96.43061950
24688,大佬級,1,595273,0.00016199,96.43078149
24689,大受歡迎,1,595274,0.00016199,96.43094349
24690,大呼過癮,1,595275,0.00016199,96.43110548
24691,大周,1,595276,0.00016199,96.43126748
24692,大周后,1,595277,0.00016199,96.43142947
24693,大姐,1,595278,0.00016199,96.43159146
24694,大姊頭,1,595279,0.00016199,96.43175346
24695,大官,1,595280,0.00016199,96.43191545
24696,大拇指,1,595281,0.00016199,96.43207745
24697,大東山,1,595282,0.00016199,96.43223944
24698,大武,1,595283,0.00016199,96.43240143
24699,大直,1,595284,0.00016199,96.43256343
24700,大門口,1,595285,0.00016199,96.43272542
24701,大俠,1,595286,0.00016199,96.43288742
24702,大前鋒,1,595287,0.00016199,96.43304941
24703,大型主機,1,595288,0.00016199,96.43321141
24704,大型低價公股,1,595289,0.00016199,96.43337340
24705,大型股,1,595290,0.00016199,96.43353539
24706,大威,1,595291,0.00016199,96.43369739
24707,大帥杯,1,595292,0.00016199,96.43385938
24708,大怒,1,595293,0.00016199,96.43402138
24709,大星,1,595294,0.00016199,96.43418337
24710,大洲,1,595295,0.00016199,96.43434537
24711,大英皇,1,595296,0.00016199,96.43450736
24712,大英國協,1,595297,0.00016199,96.43466935
24713,大計,1,595298,0.00016199,96.43483135
24714,大風吹,1,595299,0.00016199,96.43499334
24715,大香樓,1,595300,0.00016199,96.43515534
24716,大家來大便,1,595301,0.00016199,96.43531733
24717,大峰體育用品社,1,595302,0.00016199,96.43547932
24718,大庭廣眾,1,595303,0.00016199,96.43564132
24719,大骨,1,595304,0.00016199,96.43580331
24720,大骨節病,1,595305,0.00016199,96.43596531
24721,大動脈,1,595306,0.00016199,96.43612730
24722,大國,1,595307,0.00016199,96.43628930
24723,大堆,1,595308,0.00016199,96.43645129
24724,大專生,1,595309,0.00016199,96.43661328
24725,大屠殺,1,595310,0.00016199,96.43677528
24726,大掃除,1,595311,0.00016199,96.43693727
24727,大清早,1,595312,0.00016199,96.43709927
24728,大理國,1,595313,0.00016199,96.43726126
24729,大眾型,1,595314,0.00016199,96.43742326
24730,大眾傳播,1,595315,0.00016199,96.43758525
24731,大眼男孩,1,595316,0.00016199,96.43774724
24732,大眼滓,1,595317,0.00016199,96.43790924
24733,大統,1,595318,0.00016199,96.43807123
24734,大統百貨,1,595319,0.00016199,96.43823323
24735,大通建經,1,595320,0.00016199,96.43839522
24736,大都會,1,595321,0.00016199,96.43855721
24737,大都會人壽,1,595322,0.00016199,96.43871921
24738,大都會隊,1,595323,0.00016199,96.43888120
24739,大野一雄,1,595324,0.00016199,96.43904320
24740,大野善彥,1,595325,0.00016199,96.43920519
24741,大陸地區親屬來台繼承遺產規範,1,595326,0.00016199,96.43936719
24742,大陸行,1,595327,0.00016199,96.43952918
24743,大陸投資熱,1,595328,0.00016199,96.43969117
24744,大陸氣候,1,595329,0.00016199,96.43985317
24745,大陸航空球館,1,595330,0.00016199,96.44001516
24746,大陸廠,1,595331,0.00016199,96.44017716
24747,大陸熱,1,595332,0.00016199,96.44033915
24748,大陸籃協,1,595333,0.00016199,96.44050115
24749,大陰謀,1,595334,0.00016199,96.44066314
24750,大麥町狗,1,595335,0.00016199,96.44082513
24751,大麻,1,595336,0.00016199,96.44098713
24752,大凱子,1,595337,0.00016199,96.44114912
24753,大割香遶境,1,595338,0.00016199,96.44131112
24754,大勝,1,595339,0.00016199,96.44147311
24755,大喊,1,595340,0.00016199,96.44163510
24756,大提琴家,1,595341,0.00016199,96.44179710
24757,大智路,1,595342,0.00016199,96.44195909
24758,大減,1,595343,0.00016199,96.44212109
24759,大無明,1,595344,0.00016199,96.44228308
24760,大發雷霆,1,595345,0.00016199,96.44244508
24761,大華證券,1,595346,0.00016199,96.44260707
24762,大菜,1,595347,0.00016199,96.44276906
24763,大蛤包飯,1,595348,0.00016199,96.44293106
24764,大街,1,595349,0.00016199,96.44309305
24765,大貶,1,595350,0.00016199,96.44325505
24766,大開倒車,1,595351,0.00016199,96.44341704
24767,大隅半島,1,595352,0.00016199,96.44357904
24768,大雅,1,595353,0.00016199,96.44374103
24769,大雅之堂,1,595354,0.00016199,96.44390302
24770,大勢,1,595355,0.00016199,96.44406502
24771,大勢所趨,1,595356,0.00016199,96.44422701
24772,大園鄉,1,595357,0.00016199,96.44438901
24773,大園鄉公所,1,595358,0.00016199,96.44455100
24774,大園警分局,1,595359,0.00016199,96.44471299
24775,大圓建設,1,595360,0.00016199,96.44487499
24776,大圓滿密續,1,595361,0.00016199,96.44503698
24777,大意,1,595362,0.00016199,96.44519898
24778,大慈大悲,1,595363,0.00016199,96.44536097
24779,大搖大擺,1,595364,0.00016199,96.44552297
24780,大會堂,1,595365,0.00016199,96.44568496
24781,大業,1,595366,0.00016199,96.44584695
24782,大業路,1,595367,0.00016199,96.44600895
24783,大殿,1,595368,0.00016199,96.44617094
24784,大爺,1,595369,0.00016199,96.44633294
24785,大聖,1,595370,0.00016199,96.44649493
24786,大腸,1,595371,0.00016199,96.44665693
24787,大葉雀榕,1,595372,0.00016199,96.44681892
24788,大補丸,1,595373,0.00016199,96.44698091
24789,大話,1,595374,0.00016199,96.44714291
24790,大過新年,1,595375,0.00016199,96.44730490
24791,大鼓,1,595376,0.00016199,96.44746690
24792,大嘆,1,595377,0.00016199,96.44762889
24793,大壽,1,595378,0.00016199,96.44779088
24794,大寧,1,595379,0.00016199,96.44795288
24795,大漢天聲,1,595380,0.00016199,96.44811487
24796,大銀幕,1,595381,0.00016199,96.44827687
24797,大墩路,1,595382,0.00016199,96.44843886
24798,大寮養護中心,1,595383,0.00016199,96.44860086
24799,大廟法,1,595384,0.00016199,96.44876285
24800,大廣三量販店,1,595385,0.00016199,96.44892484
24801,大德,1,595386,0.00016199,96.44908684
24802,大摩股,1,595387,0.00016199,96.44924883
24803,大潭村,1,595388,0.00016199,96.44941083
24804,大熱門,1,595389,0.00016199,96.44957282
24805,大稻埕,1,595390,0.00016199,96.44973482
24806,大罵,1,595391,0.00016199,96.44989681
24807,大衛．辛曼,1,595392,0.00016199,96.45005880
24808,大衛王,1,595393,0.00016199,96.45022080
24809,大衛杜邱夫尼,1,595394,0.00016199,96.45038279
24810,大衛卓卡其,1,595395,0.00016199,96.45054479
24811,大衛博格,1,595396,0.00016199,96.45070678
24812,大賣,1,595397,0.00016199,96.45086877
24813,大噪,1,595398,0.00016199,96.45103077
24814,大器,1,595399,0.00016199,96.45119276
24815,大學法,1,595400,0.00016199,96.45135476
24816,大學時代,1,595401,0.00016199,96.45151675
24817,大學問,1,595402,0.00016199,96.45167875
24818,大學學院,1,595403,0.00016199,96.45184074
24819,大學聯考,1,595404,0.00016199,96.45200273
24820,大學聯招會,1,595405,0.00016199,96.45216473
24821,大澤啟二,1,595406,0.00016199,96.45232672
24822,大燈組,1,595407,0.00016199,96.45248872
24823,大穎集團,1,595408,0.00016199,96.45265071
24824,大錯特錯,1,595409,0.00016199,96.45281271
24825,大頭仔,1,595410,0.00016199,96.45297470
24826,大聯合政府,1,595411,0.00016199,96.45313669
24827,大薄片,1,595412,0.00016199,96.45329869
24828,大蟒蛇,1,595413,0.00016199,96.45346068
24829,大鍋飯,1,595414,0.00016199,96.45362268
24830,大額,1,595415,0.00016199,96.45378467
24831,大壞蛋,1,595416,0.00016199,96.45394666
24832,大礙,1,595417,0.00016199,96.45410866
24833,大羅,1,595418,0.00016199,96.45427065
24834,大關,1,595419,0.00016199,96.45443265
24835,大鵬營區,1,595420,0.00016199,96.45459464
24836,大鵬灣風景特定區,1,595421,0.00016199,96.45475664
24837,大鵬灣風景區,1,595422,0.00016199,96.45491863
24838,大鵬灣管理處,1,595423,0.00016199,96.45508062
24839,大鵬灣管理籌備處,1,595424,0.00016199,96.45524262
24840,大寶,1,595425,0.00016199,96.45540461
24841,大觀,1,595426,0.00016199,96.45556661
24842,女用,1,595427,0.00016199,96.45572860
24843,女色,1,595428,0.00016199,96.45589060
24844,女性主義者,1,595429,0.00016199,96.45605259
24845,女性政策研究中心,1,595430,0.00016199,96.45621458
24846,女性電影,1,595431,0.00016199,96.45637658
24847,女明星,1,595432,0.00016199,96.45653857
24848,女青年會,1,595433,0.00016199,96.45670057
24849,女娃兒,1,595434,0.00016199,96.45686256
24850,女孩兒,1,595435,0.00016199,96.45702456
24851,女書店,1,595436,0.00016199,96.45718655
24852,女神號,1,595437,0.00016199,96.45734854
24853,女秘書,1,595438,0.00016199,96.45751054
24854,女配角獎,1,595439,0.00016199,96.45767253
24855,女高音,1,595440,0.00016199,96.45783453
24856,女將,1,595441,0.00016199,96.45799652
24857,女強盜,1,595442,0.00016199,96.45815851
24858,女排賽,1,595443,0.00016199,96.45832051
24859,女裝店,1,595444,0.00016199,96.45848250
24860,女演員,1,595445,0.00016199,96.45864450
24861,女學者,1,595446,0.00016199,96.45880649
24862,女嬰,1,595447,0.00016199,96.45896849
24863,女壘隊,1,595448,0.00016199,96.45913048
24864,子凡,1,595449,0.00016199,96.45929247
24865,子母燈,1,595450,0.00016199,96.45945447
24866,子民事實,1,595451,0.00016199,96.45961646
24867,子弟兵,1,595452,0.00016199,96.45977846
24868,子宮內腔,1,595453,0.00016199,96.45994045
24869,子宮內腔區,1,595454,0.00016199,96.46010245
24870,子宮內膜異位症,1,595455,0.00016199,96.46026444
24871,子宮內膜腔,1,595456,0.00016199,96.46042643
24872,子宮外孕,1,595457,0.00016199,96.46058843
24873,子宮腺瘤,1,595458,0.00016199,96.46075042
24874,子宮頸口,1,595459,0.00016199,96.46091242
24875,子宮頸抹片,1,595460,0.00016199,96.46107441
24876,子宮頸抹片檢查,1,595461,0.00016199,96.46123640
24877,子宮鏡,1,595462,0.00016199,96.46139840
24878,子壺,1,595463,0.00016199,96.46156039
24879,子虛烏有,1,595464,0.00016199,96.46172239
24880,子癇前症,1,595465,0.00016199,96.46188438
24881,子癇症,1,595466,0.00016199,96.46204638
24882,寸土寸金,1,595467,0.00016199,96.46220837
24883,寸步不離,1,595468,0.00016199,96.46237036
24884,寸草不生,1,595469,0.00016199,96.46253236
24885,小人,1,595470,0.00016199,96.46269435
24886,小三峽,1,595471,0.00016199,96.46285635
24887,小口,1,595472,0.00016199,96.46301834
24888,小大人,1,595473,0.00016199,96.46318034
24889,小女子,1,595474,0.00016199,96.46334233
24890,小小目擊者叢書,1,595475,0.00016199,96.46350432
24891,小丑,1,595476,0.00016199,96.46366632
24892,小孔,1,595477,0.00016199,96.46382831
24893,小方,1,595478,0.00016199,96.46399031
24894,小木屋系列,1,595479,0.00016199,96.46415230
24895,小火,1,595480,0.00016199,96.46431429
24896,小犬座,1,595481,0.00016199,96.46447629
24897,小叮噹,1,595482,0.00016199,96.46463828
24898,小市民,1,595483,0.00016199,96.46480028
24899,小本經營,1,595484,0.00016199,96.46496227
24900,小白菜,1,595485,0.00016199,96.46512427
24901,小白臉,1,595486,0.00016199,96.46528626
24902,小名,1,595487,0.00016199,96.46544825
24903,小吃店,1,595488,0.00016199,96.46561025
24904,小吃業,1,595489,0.00016199,96.46577224
24905,小安東尼奧薩巴托,1,595490,0.00016199,96.46593424
24906,小曲兒,1,595491,0.00016199,96.46609623
24907,小有名氣,1,595492,0.00016199,96.46625823
24908,小老婆,1,595493,0.00016199,96.46642022
24909,小西園布袋戲,1,595494,0.00016199,96.46658221
24910,小兵,1,595495,0.00016199,96.46674421
24911,小兵立大功,1,595496,0.00016199,96.46690620
24912,小利,1,595497,0.00016199,96.46706820
24913,小我,1,595498,0.00016199,96.46723019
24914,小豆莢往太平洋的長途旅行遊記,1,595499,0.00016199,96.46739218
24915,小事,1,595500,0.00016199,96.46755418
24916,小事一樁,1,595501,0.00016199,96.46771617
24917,小亞細亞,1,595502,0.00016199,96.46787817
24918,小兒科,1,595503,0.00016199,96.46804016
24919,小兒胃腸科,1,595504,0.00016199,96.46820216
24920,小兩口,1,595505,0.00016199,96.46836415
24921,小叔,1,595506,0.00016199,96.46852614
24922,小周后,1,595507,0.00016199,96.46868814
24923,小妹,1,595508,0.00016199,96.46885013
24924,小姑,1,595509,0.00016199,96.46901213
24925,小姑娘,1,595510,0.00016199,96.46917412
24926,小玩意,1,595511,0.00016199,96.46933612
24927,小花旗,1,595512,0.00016199,96.46949811
24928,小虎隊,1,595513,0.00016199,96.46966010
24929,小金門,1,595514,0.00016199,96.46982210
24930,小雨,1,595515,0.00016199,96.46998409
24931,小雨蛙,1,595516,0.00016199,96.47014609
24932,小便池,1,595517,0.00016199,96.47030808
24933,小品詩,1,595518,0.00016199,96.47047007
24934,小型低價股,1,595519,0.00016199,96.47063207
24935,小型股,1,595520,0.00016199,96.47079406
24936,小型貫流鍋爐,1,595521,0.00016199,96.47095606
24937,小城,1,595522,0.00016199,96.47111805
24938,小星,1,595523,0.00016199,96.47128005
24939,小美人魚,1,595524,0.00016199,96.47144204
24940,小家庭,1,595525,0.00016199,96.47160403
24941,小時了了,1,595526,0.00016199,96.47176603
24942,小桃子,1,595527,0.00016199,96.47192802
24943,小氣,1,595528,0.00016199,96.47209002
24944,小草,1,595529,0.00016199,96.47225201
24945,小針美容,1,595530,0.00016199,96.47241401
24946,小馬,1,595531,0.00016199,96.47257600
24947,小鬼,1,595532,0.00016199,96.47273799
24948,小培,1,595533,0.00016199,96.47289999
24949,小將,1,595534,0.00016199,96.47306198
24950,小康,1,595535,0.00016199,96.47322398
24951,小眾,1,595536,0.00016199,96.47338597
24952,小眾市場,1,595537,0.00016199,96.47354796
24953,小笠原群島,1,595538,0.00016199,96.47370996
24954,小貨車,1,595539,0.00016199,96.47387195
24955,小鳥依人,1,595540,0.00016199,96.47403395
24956,小鹿亂撞,1,595541,0.00016199,96.47419594
24957,小喬丹,1,595542,0.00016199,96.47435794
24958,小報,1,595543,0.00016199,96.47451993
24959,小報告,1,595544,0.00016199,96.47468192
24960,小港,1,595545,0.00016199,96.47484392
24961,小猴,1,595546,0.00016199,96.47500591
24962,小菜,1,595547,0.00016199,96.47516791
24963,小費,1,595548,0.00016199,96.47532990
24964,小雅,1,595549,0.00016199,96.47549190
24965,小黃驪鳥,1,595550,0.00016199,96.47565389
24966,小黑,1,595551,0.00016199,96.47581588
24967,小溪頭,1,595552,0.00016199,96.47597788
24968,小矮人,1,595553,0.00016199,96.47613987
24969,小碎石,1,595554,0.00016199,96.47630187
24970,小節,1,595555,0.00016199,96.47646386
24971,小董,1,595556,0.00016199,96.47662585
24972,小號獨奏曲,1,595557,0.00016199,96.47678785
24973,小跟班,1,595558,0.00016199,96.47694984
24974,小路易葛塞特,1,595559,0.00016199,96.47711184
24975,小過,1,595560,0.00016199,96.47727383
24976,小漲,1,595561,0.00016199,96.47743583
24977,小熊,1,595562,0.00016199,96.47759782
24978,小碟,1,595563,0.00016199,96.47775981
24979,小蜜蜂,1,595564,0.00016199,96.47792181
24980,小說性,1,595565,0.00016199,96.47808380
24981,小調,1,595566,0.00016199,96.47824580
24982,小輩,1,595567,0.00016199,96.47840779
24983,小墾丁綠野渡假村,1,595568,0.00016199,96.47856979
24984,小學生,1,595569,0.00016199,96.47873178
24985,小賴,1,595570,0.00016199,96.47889377
24986,小錢,1,595571,0.00016199,96.47905577
24987,小雞,1,595572,0.00016199,96.47921776
24988,山水冊,1,595573,0.00016199,96.47937976
24989,山水村,1,595574,0.00016199,96.47954175
24990,山水畫派,1,595575,0.00016199,96.47970374
24991,山牛,1,595576,0.00016199,96.47986574
24992,山卡拉,1,595577,0.00016199,96.48002773
24993,山可．潘沙,1,595578,0.00016199,96.48018973
24994,山本,1,595579,0.00016199,96.48035172
24995,山本浩二,1,595580,0.00016199,96.48051372
24996,山田久志,1,595581,0.00016199,96.48067571
24997,山田能伸,1,595582,0.00016199,96.48083770
24998,山地刀絲瑪,1,595583,0.00016199,96.48099970
24999,山地鄉,1,595584,0.00016199,96.48116169
25000,山形,1,595585,0.00016199,96.48132369
25001,山村,1,595586,0.00016199,96.48148568
25002,山坡地保育利用條例,1,595587,0.00016199,96.48164768
25003,山姆,1,595588,0.00016199,96.48180967
25004,山東省,1,595589,0.00016199,96.48197166
25005,山河,1,595590,0.00016199,96.48213366
25006,山金車,1,595591,0.00016199,96.48229565
25007,山雨欲來,1,595592,0.00016199,96.48245765
25008,山城,1,595593,0.00016199,96.48261964
25009,山屋,1,595594,0.00016199,96.48278163
25010,山胞,1,595595,0.00016199,96.48294363
25011,山哥．潘沙,1,595596,0.00016199,96.48310562
25012,山埂,1,595597,0.00016199,96.48326762
25013,山峰,1,595598,0.00016199,96.48342961
25014,山徑,1,595599,0.00016199,96.48359161
25015,山海關,1,595600,0.00016199,96.48375360
25016,山崗,1,595601,0.00016199,96.48391559
25017,山嵐,1,595602,0.00016199,96.48407759
25018,山棕,1,595603,0.00016199,96.48423958
25019,山楊,1,595604,0.00016199,96.48440158
25020,山道後由,1,595605,0.00016199,96.48456357
25021,山歌,1,595606,0.00016199,96.48472557
25022,山澗,1,595607,0.00016199,96.48488756
25023,山壁,1,595608,0.00016199,96.48504955
25024,山雞,1,595609,0.00016199,96.48521155
25025,山櫻花,1,595610,0.00016199,96.48537354
25026,山�f,1,595611,0.00016199,96.48553554
25027,川流不息,1,595612,0.00016199,96.48569753
25028,川崎市,1,595613,0.00016199,96.48585953
25029,川菜,1,595614,0.00016199,96.48602152
25030,工匠,1,595615,0.00016199,96.48618351
25031,工作台,1,595616,0.00016199,96.48634551
25032,工作坊,1,595617,0.00016199,96.48650750
25033,工作狂,1,595618,0.00016199,96.48666950
25034,工作群組版,1,595619,0.00016199,96.48683149
25035,工作褲,1,595620,0.00016199,96.48699348
25036,工作權,1,595621,0.00016199,96.48715548
25037,工事,1,595622,0.00016199,96.48731747
25038,工具書,1,595623,0.00016199,96.48747947
25039,工研院電通所,1,595624,0.00016199,96.48764146
25040,工科,1,595625,0.00016199,96.48780346
25041,工商企業,1,595626,0.00016199,96.48796545
25042,工商社會,1,595627,0.00016199,96.48812744
25043,工商建研會,1,595628,0.00016199,96.48828944
25044,工商特區,1,595629,0.00016199,96.48845143
25045,工商業,1,595630,0.00016199,96.48861343
25046,工商業界,1,595631,0.00016199,96.48877542
25047,工商攝影,1,595632,0.00016199,96.48893742
25048,工專,1,595633,0.00016199,96.48909941
25049,工設系,1,595634,0.00016199,96.48926140
25050,工程事業處,1,595635,0.00016199,96.48942340
25051,工程建設,1,595636,0.00016199,96.48958539
25052,工程處,1,595637,0.00016199,96.48974739
25053,工程處長,1,595638,0.00016199,96.48990938
25054,工程隊,1,595639,0.00016199,96.49007137
25055,工程會,1,595640,0.00016199,96.49023337
25056,工程會主委,1,595641,0.00016199,96.49039536
25057,工程業務處,1,595642,0.00016199,96.49055736
25058,工程準備金,1,595643,0.00016199,96.49071935
25059,工業股價指數,1,595644,0.00016199,96.49088135
25060,工業重鎮,1,595645,0.00016199,96.49104334
25061,工業設計系,1,595646,0.00016199,96.49120533
25062,工學路,1,595647,0.00016199,96.49136733
25063,工錢,1,595648,0.00016199,96.49152932
25064,工聯,1,595649,0.00016199,96.49169132
25065,已要求,1,595650,0.00016199,96.49185331
25066,已婚,1,595651,0.00016199,96.49201531
25067,已開發國家,1,595652,0.00016199,96.49217730
25068,干犯,1,595653,0.00016199,96.49233929
25069,干辛萬苦,1,595654,0.00016199,96.49250129
25070,干邑白蘭地,1,595655,0.00016199,96.49266328
25071,干萬,1,595656,0.00016199,96.49282528
25072,弓兵,1,595657,0.00016199,96.49298727
25073,弓弦,1,595658,0.00016199,96.49314926
25074,弓法,1,595659,0.00016199,96.49331126
25075,弓箭,1,595660,0.00016199,96.49347325
25076,才好,1,595661,0.00016199,96.49363525
25077,才來,1,595662,0.00016199,96.49379724
25078,才要,1,595663,0.00016199,96.49395924
25079,才情,1,595664,0.00016199,96.49412123
25080,才幹,1,595665,0.00016199,96.49428322
25081,丑角,1,595666,0.00016199,96.49444522
25082,丑宛茹,1,595667,0.00016199,96.49460721
25083,不入,1,595668,0.00016199,96.49476921
25084,不丹,1,595669,0.00016199,96.49493120
25085,不予置評,1,595670,0.00016199,96.49509320
25086,不支,1,595671,0.00016199,96.49525519
25087,不比,1,595672,0.00016199,96.49541718
25088,不可及,1,595673,0.00016199,96.49557918
25089,不可收拾,1,595674,0.00016199,96.49574117
25090,不可告人,1,595675,0.00016199,96.49590317
25091,不可理喻,1,595676,0.00016199,96.49606516
25092,不可勝數,1,595677,0.00016199,96.49622715
25093,不可貌相,1,595678,0.00016199,96.49638915
25094,不可靠,1,595679,0.00016199,96.49655114
25095,不可諱言,1,595680,0.00016199,96.49671314
25096,不外乎,1,595681,0.00016199,96.49687513
25097,不犯,1,595682,0.00016199,96.49703713
25098,不甘心,1,595683,0.00016199,96.49719912
25099,不亦樂乎,1,595684,0.00016199,96.49736111
25100,不吐不快,1,595685,0.00016199,96.49752311
25101,不合作,1,595686,0.00016199,96.49768510
25102,不合時宜,1,595687,0.00016199,96.49784710
25103,不吃虧,1,595688,0.00016199,96.49800909
25104,不好看,1,595689,0.00016199,96.49817109
25105,不如人意,1,595690,0.00016199,96.49833308
25106,不安分,1,595691,0.00016199,96.49849507
25107,不有,1,595692,0.00016199,96.49865707
25108,不住,1,595693,0.00016199,96.49881906
25109,不吝,1,595694,0.00016199,96.49898106
25110,不忍卒睹,1,595695,0.00016199,96.49914305
25111,不良放款,1,595696,0.00016199,96.49930504
25112,不良於行,1,595697,0.00016199,96.49946704
25113,不良品,1,595698,0.00016199,96.49962903
25114,不言而喻,1,595699,0.00016199,96.49979103
25115,不足以,1,595700,0.00016199,96.49995302
25116,不周,1,595701,0.00016199,96.50011502
25117,不定,1,595702,0.00016199,96.50027701
25118,不屈,1,595703,0.00016199,96.50043900
25119,不拘,1,595704,0.00016199,96.50060100
25120,不枉,1,595705,0.00016199,96.50076299
25121,不沾,1,595706,0.00016199,96.50092499
25122,不知所云,1,595707,0.00016199,96.50108698
25123,不表,1,595708,0.00016199,96.50124898
25124,不近情理,1,595709,0.00016199,96.50141097
25125,不待,1,595710,0.00016199,96.50157296
25126,不思,1,595711,0.00016199,96.50173496
25127,不流,1,595712,0.00016199,96.50189695
25128,不流血革命,1,595713,0.00016199,96.50205895
25129,不為人知,1,595714,0.00016199,96.50222094
25130,不為過,1,595715,0.00016199,96.50238293
25131,不省人事,1,595716,0.00016199,96.50254493
25132,不耐煩,1,595717,0.00016199,96.50270692
25133,不苟,1,595718,0.00016199,96.50286892
25134,不要臉,1,595719,0.00016199,96.50303091
25135,不計其數,1,595720,0.00016199,96.50319291
25136,不計較,1,595721,0.00016199,96.50335490
25137,不負,1,595722,0.00016199,96.50351689
25138,不負眾望,1,595723,0.00016199,96.50367889
25139,不重,1,595724,0.00016199,96.50384088
25140,不食,1,595725,0.00016199,96.50400288
25141,不倦,1,595726,0.00016199,96.50416487
25142,不值得,1,595727,0.00016199,96.50432687
25143,不值錢,1,595728,0.00016199,96.50448886
25144,不修,1,595729,0.00016199,96.50465085
25145,不倫不類,1,595730,0.00016199,96.50481285
25146,不容置疑,1,595731,0.00016199,96.50497484
25147,不悔,1,595732,0.00016199,96.50513684
25148,不疾不徐,1,595733,0.00016199,96.50529883
25149,不眠不休,1,595734,0.00016199,96.50546082
25150,不起,1,595735,0.00016199,96.50562282
25151,不配,1,595736,0.00016199,96.50578481
25152,不假,1,595737,0.00016199,96.50594681
25153,不假思索,1,595738,0.00016199,96.50610880
25154,不假離營,1,595739,0.00016199,96.50627080
25155,不偏不倚,1,595740,0.00016199,96.50643279
25156,不動聲色,1,595741,0.00016199,96.50659478
25157,不夠看,1,595742,0.00016199,96.50675678
25158,不得其解,1,595743,0.00016199,96.50691877
25159,不從,1,595744,0.00016199,96.50708077
25160,不淺,1,595745,0.00016199,96.50724276
25161,不理不睬,1,595746,0.00016199,96.50740476
25162,不理會,1,595747,0.00016199,96.50756675
25163,不移,1,595748,0.00016199,96.50772874
25164,不通世務,1,595749,0.00016199,96.50789074
25165,不備,1,595750,0.00016199,96.50805273
25166,不勞而獲,1,595751,0.00016199,96.50821473
25167,不堪入目,1,595752,0.00016199,96.50837672
25168,不堪入耳,1,595753,0.00016199,96.50853871
25169,不寒而慄,1,595754,0.00016199,96.50870071
25170,不就,1,595755,0.00016199,96.50886270
25171,不敢恭維,1,595756,0.00016199,96.50902470
25172,不敢領教,1,595757,0.00016199,96.50918669
25173,不智,1,595758,0.00016199,96.50934869
25174,不無,1,595759,0.00016199,96.50951068
25175,不無小補,1,595760,0.00016199,96.50967267
25176,不絕如縷,1,595761,0.00016199,96.50983467
25177,不著急,1,595762,0.00016199,96.50999666
25178,不著痕跡,1,595763,0.00016199,96.51015866
25179,不虛,1,595764,0.00016199,96.51032065
25180,不虛此行,1,595765,0.00016199,96.51048265
25181,不順眼,1,595766,0.00016199,96.51064464
25182,不亂,1,595767,0.00016199,96.51080663
25183,不嫌,1,595768,0.00016199,96.51096863
25184,不意,1,595769,0.00016199,96.51113062
25185,不睬,1,595770,0.00016199,96.51129262
25186,不落,1,595771,0.00016199,96.51145461
25187,不落人後,1,595772,0.00016199,96.51161660
25188,不解之緣,1,595773,0.00016199,96.51177860
25189,不詳,1,595774,0.00016199,96.51194059
25190,不貲,1,595775,0.00016199,96.51210259
25191,不道德,1,595776,0.00016199,96.51226458
25192,不遂,1,595777,0.00016199,96.51242658
25193,不達,1,595778,0.00016199,96.51258857
25194,不圖,1,595779,0.00016199,96.51275056
25195,不察,1,595780,0.00016199,96.51291256
25196,不疑,1,595781,0.00016199,96.51307455
25197,不稱頭,1,595782,0.00016199,96.51323655
25198,不認得,1,595783,0.00016199,96.51339854
25199,不敷所需,1,595784,0.00016199,96.51356054
25200,不輟,1,595785,0.00016199,96.51372253
25201,不齒,1,595786,0.00016199,96.51388452
25202,不興,1,595787,0.00016199,96.51404652
25203,不謀而合,1,595788,0.00016199,96.51420851
25204,不遲,1,595789,0.00016199,96.51437051
25205,不醒,1,595790,0.00016199,96.51453250
25206,不濟,1,595791,0.00016199,96.51469450
25207,不翼而飛,1,595792,0.00016199,96.51485649
25208,不離,1,595793,0.00016199,96.51501848
25209,不雜,1,595794,0.00016199,96.51518048
25210,不懷好意,1,595795,0.00016199,96.51534247
25211,不礙事,1,595796,0.00016199,96.51550447
25212,不藥而癒,1,595797,0.00016199,96.51566646
25213,不識,1,595798,0.00016199,96.51582845
25214,不識時務,1,595799,0.00016199,96.51599045
25215,不關,1,595800,0.00016199,96.51615244
25216,不鏽鋼,1,595801,0.00016199,96.51631444
25217,不聽話,1,595802,0.00016199,96.51647643
25218,不靈,1,595803,0.00016199,96.51663843
25219,中刀,1,595804,0.00016199,96.51680042
25220,中士,1,595805,0.00016199,96.51696241
25221,中子活化法,1,595806,0.00016199,96.51712441
25222,中小企業銀行,1,595807,0.00016199,96.51728640
25223,中小企銀,1,595808,0.00016199,96.51744840
25224,中山,1,595809,0.00016199,96.51761039
25225,中山大學,1,595810,0.00016199,96.51777239
25226,中山女中,1,595811,0.00016199,96.51793438
25227,中山美穗,1,595812,0.00016199,96.51809637
25228,中山高,1,595813,0.00016199,96.51825837
25229,中山國中,1,595814,0.00016199,96.51842036
25230,中山堂,1,595815,0.00016199,96.51858236
25231,中介,1,595816,0.00016199,96.51874435
25232,中元祭典委員會,1,595817,0.00016199,96.51890634
25233,中元節,1,595818,0.00016199,96.51906834
25234,中友,1,595819,0.00016199,96.51923033
25235,中友卡,1,595820,0.00016199,96.51939233
25236,中心值,1,595821,0.00016199,96.51955432
25237,中心點,1,595822,0.00016199,96.51971632
25238,中文手寫輸入系統,1,595823,0.00016199,96.51987831
25239,中文卡,1,595824,0.00016199,96.52004030
25240,中文系,1,595825,0.00016199,96.52020230
25241,中文視窗作業環境,1,595826,0.00016199,96.52036429
25242,中文語音傳真通訊軟體,1,595827,0.00016199,96.52052629
25243,中文輸入,1,595828,0.00016199,96.52068828
25244,中文辨識系統,1,595829,0.00016199,96.52085028
25245,中日戰爭,1,595830,0.00016199,96.52101227
25246,中日證券,1,595831,0.00016199,96.52117426
25247,中世紀,1,595832,0.00016199,96.52133626
25248,中台,1,595833,0.00016199,96.52149825
25249,中台化,1,595834,0.00016199,96.52166025
25250,中央山谷,1,595835,0.00016199,96.52182224
25251,中央公園,1,595836,0.00016199,96.52198423
25252,中央化,1,595837,0.00016199,96.52214623
25253,中央民意代表,1,595838,0.00016199,96.52230822
25254,中央存款保險公司,1,595839,0.00016199,96.52247022
25255,中央投資公司,1,595840,0.00016199,96.52263221
25256,中央車站,1,595841,0.00016199,96.52279421
25257,中央版,1,595842,0.00016199,96.52295620
25258,中央空調,1,595843,0.00016199,96.52311819
25259,中央政府公債,1,595844,0.00016199,96.52328019
25260,中央政治局,1,595845,0.00016199,96.52344218
25261,中央政策會,1,595846,0.00016199,96.52360418
25262,中央軍委主席,1,595847,0.00016199,96.52376617
25263,中央健保局,1,595848,0.00016199,96.52392817
25264,中央產險,1,595849,0.00016199,96.52409016
25265,中央產險公司,1,595850,0.00016199,96.52425215
25266,中央組工會,1,595851,0.00016199,96.52441415
25267,中央陸軍軍官學校,1,595852,0.00016199,96.52457614
25268,中央圖書館,1,595853,0.00016199,96.52473814
25269,中央聯盟,1,595854,0.00016199,96.52490013
25270,中央警官學校,1,595855,0.00016199,96.52506212
25271,中央警察大學,1,595856,0.00016199,96.52522412
25272,中央黨校,1,595857,0.00016199,96.52538611
25273,中正,1,595858,0.00016199,96.52554811
25274,中正二分局,1,595859,0.00016199,96.52571010
25275,中正紀念堂,1,595860,0.00016199,96.52587210
25276,中立化,1,595861,0.00016199,96.52603409
25277,中共人民日報,1,595862,0.00016199,96.52619608
25278,中共外長,1,595863,0.00016199,96.52635808
25279,中共副主席,1,595864,0.00016199,96.52652007
25280,中共國台辦,1,595865,0.00016199,96.52668207
25281,中共潛艦,1,595866,0.00016199,96.52684406
25282,中共黨部,1,595867,0.00016199,96.52700606
25283,中年級,1,595868,0.00016199,96.52716805
25284,中耳,1,595869,0.00016199,96.52733004
25285,中耳炎,1,595870,0.00016199,96.52749204
25286,中西,1,595871,0.00016199,96.52765403
25287,中西片,1,595872,0.00016199,96.52781603
25288,中西部,1,595873,0.00016199,96.52797802
25289,中低音,1,595874,0.00016199,96.52814001
25290,中邪,1,595875,0.00016199,96.52830201
25291,中京院,1,595876,0.00016199,96.52846400
25292,中和作用,1,595877,0.00016199,96.52862600
25293,中性化,1,595878,0.00016199,96.52878799
25294,中性脂肪,1,595879,0.00016199,96.52894999
25295,中東戰爭,1,595880,0.00016199,96.52911198
25296,中法,1,595881,0.00016199,96.52927397
25297,中油性,1,595882,0.00016199,96.52943597
25298,中空裝,1,595883,0.00016199,96.52959796
25299,中長程,1,595884,0.00016199,96.52975996
25300,中長程導彈部隊,1,595885,0.00016199,96.52992195
25301,中長線,1,595886,0.00016199,96.53008395
25302,中信房屋,1,595887,0.00016199,96.53024594
25303,中保大樓,1,595888,0.00016199,96.53040793
25304,中南美,1,595889,0.00016199,96.53056993
25305,中南美司長,1,595890,0.00016199,96.53073192
25306,中南美洲,1,595891,0.00016199,96.53089392
25307,中型車,1,595892,0.00016199,96.53105591
25308,中型轟炸機中隊,1,595893,0.00016199,96.53121790
25309,中美,1,595894,0.00016199,96.53137990
25310,中美合作技術所,1,595895,0.00016199,96.53154189
25311,中美和,1,595896,0.00016199,96.53170389
25312,中美和公司,1,595897,0.00016199,96.53186588
25313,中美洲,1,595898,0.00016199,96.53202788
25314,中美班,1,595899,0.00016199,96.53218987
25315,中美基金,1,595900,0.00016199,96.53235186
25316,中美智慧財產權,1,595901,0.00016199,96.53251386
25317,中美斷交一年,1,595902,0.00016199,96.53267585
25318,中英文,1,595903,0.00016199,96.53283785
25319,中原大學,1,595904,0.00016199,96.53299984
25320,中原里,1,595905,0.00016199,96.53316184
25321,中庭,1,595906,0.00016199,96.53332383
25322,中時晚報,1,595907,0.00016199,96.53348582
25323,中紡,1,595908,0.00016199,96.53364782
25324,中乾性,1,595909,0.00016199,96.53380981
25325,中國人民銀行,1,595910,0.00016199,96.53397181
25326,中國人造纖維公司,1,595911,0.00016199,96.53413380
25327,中國少年兒童造形學會,1,595912,0.00016199,96.53429579
25328,中國文化大學,1,595913,0.00016199,96.53445779
25329,中國石油公司,1,595914,0.00016199,96.53461978
25330,中國回教協會,1,595915,0.00016199,96.53478178
25331,中國式,1,595916,0.00016199,96.53494377
25332,中國事務委員會,1,595917,0.00016199,96.53510577
25333,中國京劇院,1,595918,0.00016199,96.53526776
25334,中國兒童水墨畫展,1,595919,0.00016199,96.53542975
25335,中國青年,1,595920,0.00016199,96.53559175
25336,中國信託銀行,1,595921,0.00016199,96.53575374
25337,中國時報周刊,1,595922,0.00016199,96.53591574
25338,中國商業銀行,1,595923,0.00016199,96.53607773
25339,中國商銀顧問,1,595924,0.00016199,96.53623973
25340,中國國民黨,1,595925,0.00016199,96.53640172
25341,中國國際電視發行公司,1,595926,0.00016199,96.53656371
25342,中國童玩,1,595927,0.00016199,96.53672571
25343,中國童玩暨兒童攝影展覽,1,595928,0.00016199,96.53688770
25344,中國傳統的七個節日,1,595929,0.00016199,96.53704970
25345,中國概念,1,595930,0.00016199,96.53721169
25346,中國話,1,595931,0.00016199,96.53737368
25347,中國電視公司,1,595932,0.00016199,96.53753568
25348,中國遠洋航運公司,1,595933,0.00016199,96.53769767
25349,中國餐館症,1,595934,0.00016199,96.53785967
25350,中國藝術基金會,1,595935,0.00016199,96.53802166
25351,中國攝影專輯,1,595936,0.00016199,96.53818366
25352,中執委,1,595937,0.00016199,96.53834565
25353,中尉,1,595938,0.00016199,96.53850764
25354,中將局長,1,595939,0.00016199,96.53866964
25355,中帶,1,595940,0.00016199,96.53883163
25356,中產,1,595941,0.00016199,96.53899363
25357,中途島,1,595942,0.00016199,96.53915562
25358,中途站,1,595943,0.00016199,96.53931762
25359,中都汽車公司,1,595944,0.00016199,96.53947961
25360,中陰聞教得度,1,595945,0.00016199,96.53964160
25361,中圍,1,595946,0.00016199,96.53980360
25362,中港分廠,1,595947,0.00016199,96.53996559
25363,中港台,1,595948,0.00016199,96.54012759
25364,中港派出所,1,595949,0.00016199,96.54028958
25365,中港溪國際育樂開發公司,1,595950,0.00016199,96.54045157
25366,中程,1,595951,0.00016199,96.54061357
25367,中策,1,595952,0.00016199,96.54077556
25368,中筋麵粉,1,595953,0.00016199,96.54093756
25369,中華文化復興運動,1,595954,0.00016199,96.54109955
25370,中華民國大型購物中心協會,1,595955,0.00016199,96.54126155
25371,中華民國反共愛國聯盟,1,595956,0.00016199,96.54142354
25372,中華民國兒童文學會,1,595957,0.00016199,96.54158553
25373,中華民國兒童文學學會,1,595958,0.00016199,96.54174753
25374,中華民國花藝設計協會,1,595959,0.00016199,96.54190952
25375,中華民國保護智慧財產權協會,1,595960,0.00016199,96.54207152
25376,中華民國消費者文教基金會,1,595961,0.00016199,96.54223351
25377,中華民國僵直性脊椎炎之友協會,1,595962,0.00016199,96.54239551
25378,中華西路,1,595963,0.00016199,96.54255750
25379,中華投信公司,1,595964,0.00016199,96.54271949
25380,中華東路,1,595965,0.00016199,96.54288149
25381,中華國協,1,595966,0.00016199,96.54304348
25382,中華奧會主席,1,595967,0.00016199,96.54320548
25383,中華經濟研究所,1,595968,0.00016199,96.54336747
25384,中華路,1,595969,0.00016199,96.54352947
25385,中華電信,1,595970,0.00016199,96.54369146
25386,中華電線電纜公司,1,595971,0.00016199,96.54385345
25387,中華賓士公司,1,595972,0.00016199,96.54401545
25388,中華賓士汽車公司,1,595973,0.00016199,96.54417744
25389,中華職棒公司,1,595974,0.00016199,96.54433944
25390,中華職棒史,1,595975,0.00016199,96.54450143
25391,中華職棒聯盟,1,595976,0.00016199,96.54466342
25392,中華攝影,1,595977,0.00016199,96.54482542
25393,中華攝影學會,1,595978,0.00016199,96.54498741
25394,中華顧問工程司,1,595979,0.00016199,96.54514941
25395,中視周刊,1,595980,0.00016199,96.54531140
25396,中飯,1,595981,0.00016199,96.54547340
25397,中新世,1,595982,0.00016199,96.54563539
25398,中盟保全,1,595983,0.00016199,96.54579738
25399,中鼎工程,1,595984,0.00016199,96.54595938
25400,中精機,1,595985,0.00016199,96.54612137
25401,中聚酯加工絲,1,595986,0.00016199,96.54628337
25402,中廣流行網,1,595987,0.00016199,96.54644536
25403,中彈,1,595988,0.00016199,96.54660736
25404,中歐,1,595989,0.00016199,96.54676935
25405,中歐創投,1,595990,0.00016199,96.54693134
25406,中獎率,1,595991,0.00016199,96.54709334
25407,中箭,1,595992,0.00016199,96.54725533
25408,中線,1,595993,0.00016199,96.54741733
25409,中輟,1,595994,0.00016199,96.54757932
25410,中學生,1,595995,0.00016199,96.54774131
25411,中橫,1,595996,0.00016199,96.54790331
25412,中橡,1,595997,0.00016199,96.54806530
25413,中興大學,1,595998,0.00016199,96.54822730
25414,中興東路,1,595999,0.00016199,96.54838929
25415,中興銀行,1,596000,0.00016199,96.54855129
25416,中興職籃隊,1,596001,0.00016199,96.54871328
25417,中選會,1,596002,0.00016199,96.54887527
25418,中鋼結構,1,596003,0.00016199,96.54903727
25419,中環股,1,596004,0.00016199,96.54919926
25420,中環電子股,1,596005,0.00016199,96.54936126
25421,中韓斷交,1,596006,0.00016199,96.54952325
25422,中點,1,596007,0.00016199,96.54968525
25423,中點站,1,596008,0.00016199,96.54984724
25424,中壢廠,1,596009,0.00016199,96.55000923
25425,中藥店,1,596010,0.00016199,96.55017123
25426,中聽,1,596011,0.00016199,96.55033322
25427,丰姿,1,596012,0.00016199,96.55049522
25428,丹,1,596013,0.00016199,96.55065721
25429,丹．詹森,1,596014,0.00016199,96.55081920
25430,丹方,1,596015,0.00016199,96.55098120
25431,丹比,1,596016,0.00016199,96.55114319
25432,丹尼波利,1,596017,0.00016199,96.55130519
25433,丹尼爾．高曼,1,596018,0.00016199,96.55146718
25434,丹尼爾沙力凡,1,596019,0.00016199,96.55162918
25435,丹尼歐,1,596020,0.00016199,96.55179117
25436,丹亥達亞,1,596021,0.00016199,96.55195316
25437,丹艾葛蘭,1,596022,0.00016199,96.55211516
25438,丹妮餐廳,1,596023,0.00016199,96.55227715
25439,尹,1,596024,0.00016199,96.55243915
25440,尹里亞德,1,596025,0.00016199,96.55260114
25441,尹俊,1,596026,0.00016199,96.55276314
25442,尹衍樑,1,596027,0.00016199,96.55292513
25443,尹章中,1,596028,0.00016199,96.55308712
25444,井,1,596029,0.00016199,96.55324912
25445,井然,1,596030,0.00016199,96.55341111
25446,互用,1,596031,0.00016199,96.55357311
25447,互扣,1,596032,0.00016199,96.55373510
25448,互助會,1,596033,0.00016199,96.55389709
25449,互鬥,1,596034,0.00016199,96.55405909
25450,互動式軟體,1,596035,0.00016199,96.55422108
25451,互異,1,596036,0.00016199,96.55438308
25452,互敬,1,596037,0.00016199,96.55454507
25453,互補色,1,596038,0.00016199,96.55470707
25454,互譯,1,596039,0.00016199,96.55486906
25455,五一,1,596040,0.00016199,96.55503105
25456,五人團,1,596041,0.00016199,96.55519305
25457,五分割測光,1,596042,0.00016199,96.55535504
25458,五四,1,596043,0.00016199,96.55551704
25459,五光十色,1,596044,0.00016199,96.55567903
25460,五年計畫,1,596045,0.00016199,96.55584103
25461,五色鳥,1,596046,0.00016199,96.55600302
25462,五味雜陳,1,596047,0.00016199,96.55616501
25463,五弦琴,1,596048,0.00016199,96.55632701
25464,五股,1,596049,0.00016199,96.55648900
25465,五股交流道,1,596050,0.00016199,96.55665100
25466,五虎將,1,596051,0.00016199,96.55681299
25467,五指山,1,596052,0.00016199,96.55697498
25468,五星旗,1,596053,0.00016199,96.55713698
25469,五缸引擎,1,596054,0.00016199,96.55729897
25470,五音步詩,1,596055,0.00016199,96.55746097
25471,五香,1,596056,0.00016199,96.55762296
25472,五峰鄉,1,596057,0.00016199,96.55778496
25473,五院,1,596058,0.00016199,96.55794695
25474,五專聯招,1,596059,0.00016199,96.55810894
25475,五進式建築,1,596060,0.00016199,96.55827094
25476,五稜鏡,1,596061,0.00016199,96.55843293
25477,五稜鏡觀景窗,1,596062,0.00016199,96.55859493
25478,五經,1,596063,0.00016199,96.55875692
25479,五福臨門,1,596064,0.00016199,96.55891892
25480,五輕,1,596065,0.00016199,96.55908091
25481,五穀,1,596066,0.00016199,96.55924290
25482,五輻鋁圈,1,596067,0.00016199,96.55940490
25483,五點分割測光,1,596068,0.00016199,96.55956689
25484,五權一路,1,596069,0.00016199,96.55972889
25485,五權南路,1,596070,0.00016199,96.55989088
25486,五權路,1,596071,0.00016199,96.56005287
25487,五臟,1,596072,0.00016199,96.56021487
25488,五榖,1,596073,0.00016199,96.56037686
25489,仁,1,596074,0.00016199,96.56053886
25490,仁翔,1,596075,0.00016199,96.56070085
25491,仁德鄉,1,596076,0.00016199,96.56086285
25492,什,1,596077,0.00016199,96.56102484
25493,什錦炒麵,1,596078,0.00016199,96.56118683
25494,仇人,1,596079,0.00016199,96.56134883
25495,仇恨,1,596080,0.00016199,96.56151082
25496,仍有,1,596081,0.00016199,96.56167282
25497,仍要,1,596082,0.00016199,96.56183481
25498,今生今世,1,596083,0.00016199,96.56199681
25499,今生有約,1,596084,0.00016199,96.56215880
25500,今后,1,596085,0.00016199,96.56232079
25501,今年度,1,596086,0.00016199,96.56248279
25502,今兒,1,596087,0.00016199,96.56264478
25503,今昔,1,596088,0.00016199,96.56280678
25504,今非昔比,1,596089,0.00016199,96.56296877
25505,今晨,1,596090,0.00016199,96.56313076
25506,今舊,1,596091,0.00016199,96.56329276
25507,介面卡,1,596092,0.00016199,96.56345475
25508,介紹人,1,596093,0.00016199,96.56361675
25509,介意,1,596094,0.00016199,96.56377874
25510,介質,1,596095,0.00016199,96.56394074
25511,元大證券投資顧問公司,1,596096,0.00016199,96.56410273
25512,元凶,1,596097,0.00016199,96.56426472
25513,元化路,1,596098,0.00016199,96.56442672
25514,元旦,1,596099,0.00016199,96.56458871
25515,元老級,1,596100,0.00016199,96.56475071
25516,元宵節,1,596101,0.00016199,96.56491270
25517,元氣,1,596102,0.00016199,96.56507470
25518,元泰,1,596103,0.00016199,96.56523669
25519,元彪,1,596104,0.00016199,96.56539868
25520,元富基金,1,596105,0.00016199,96.56556068
25521,元町廠,1,596106,0.00016199,96.56572267
25522,允,1,596107,0.00016199,96.56588467
25523,允當,1,596108,0.00016199,96.56604666
25524,內八,1,596109,0.00016199,96.56620865
25525,內分解,1,596110,0.00016199,96.56637065
25526,內升制度,1,596111,0.00016199,96.56653264
25527,內外丹功協會,1,596112,0.00016199,96.56669464
25528,內外科,1,596113,0.00016199,96.56685663
25529,內外部,1,596114,0.00016199,96.56701863
25530,內同位碼,1,596115,0.00016199,96.56718062
25531,內向,1,596116,0.00016199,96.56734261
25532,內在美,1,596117,0.00016199,96.56750461
25533,內行仔,1,596118,0.00016199,96.56766660
25534,內疚,1,596119,0.00016199,96.56782860
25535,內室,1,596120,0.00016199,96.56799059
25536,內急,1,596121,0.00016199,96.56815259
25537,內政大臣,1,596122,0.00016199,96.56831458
25538,內省,1,596123,0.00016199,96.56847657
25539,內唐亞胡,1,596124,0.00016199,96.56863857
25540,內啡��,1,596125,0.00016199,96.56880056
25541,內野,1,596126,0.00016199,96.56896256
25542,內野手,1,596127,0.00016199,96.56912455
25543,內野安打,1,596128,0.00016199,96.56928655
25544,內場,1,596129,0.00016199,96.56944854
25545,內嵌,1,596130,0.00016199,96.56961053
25546,內湖分局長,1,596131,0.00016199,96.56977253
25547,內湖路,1,596132,0.00016199,96.56993452
25548,內華達州,1,596133,0.00016199,96.57009652
25549,內華達號戰鬥艦,1,596134,0.00016199,96.57025851
25550,內華達號戰艦綽號,1,596135,0.00016199,96.57042050
25551,內診,1,596136,0.00016199,96.57058250
25552,內亂,1,596137,0.00016199,96.57074449
25553,內傷,1,596138,0.00016199,96.57090649
25554,內置閃光燈,1,596139,0.00016199,96.57106848
25555,內置馬達,1,596140,0.00016199,96.57123048
25556,內裡,1,596141,0.00016199,96.57139247
25557,內閣制,1,596142,0.00016199,96.57155446
25558,內閣總理,1,596143,0.00016199,96.57171646
25559,內需股,1,596144,0.00016199,96.57187845
25560,內需型,1,596145,0.00016199,96.57204045
25561,內憂,1,596146,0.00016199,96.57220244
25562,內膜,1,596147,0.00016199,96.57236444
25563,內藏,1,596148,0.00016199,96.57252643
25564,內壢,1,596149,0.00016199,96.57268842
25565,內蘊,1,596150,0.00016199,96.57285042
25566,六三,1,596151,0.00016199,96.57301241
25567,六四天安門,1,596152,0.00016199,96.57317441
25568,六四事件,1,596153,0.00016199,96.57333640
25569,六四屠夫,1,596154,0.00016199,96.57349839
25570,六合,1,596155,0.00016199,96.57366039
25571,六神無主,1,596156,0.00016199,96.57382238
25572,六張犁,1,596157,0.00016199,96.57398438
25573,六朝,1,596158,0.00016199,96.57414637
25574,六福,1,596159,0.00016199,96.57430837
25575,六輕麥寮工業區,1,596160,0.00016199,96.57447036
25576,六龜,1,596161,0.00016199,96.57463235
25577,六點半,1,596162,0.00016199,96.57479435
25578,六鬚鯰,1,596163,0.00016199,96.57495634
25579,兮兮,1,596164,0.00016199,96.57511834
25580,公子哥,1,596165,0.00016199,96.57528033
25581,公司行號,1,596166,0.00016199,96.57544233
25582,公司持,1,596167,0.00016199,96.57560432
25583,公司債券,1,596168,0.00016199,96.57576631
25584,公平交易委員會,1,596169,0.00016199,96.57592831
25585,公正畫廊,1,596170,0.00016199,96.57609030
25586,公民投票權,1,596171,0.00016199,96.57625230
25587,公民連署,1,596172,0.00016199,96.57641429
25588,公民銀行,1,596173,0.00016199,96.57657628
25589,公民營,1,596174,0.00016199,96.57673828
25590,公民營銀行,1,596175,0.00016199,96.57690027
25591,公石,1,596176,0.00016199,96.57706227
25592,公立學校,1,596177,0.00016199,96.57722426
25593,公共工程專案小組,1,596178,0.00016199,96.57738626
25594,公共工程會,1,596179,0.00016199,96.57754825
25595,公共安全,1,596180,0.00016199,96.57771024
25596,公共安全罪,1,596181,0.00016199,96.57787224
25597,公共安全管理員,1,596182,0.00016199,96.57803423
25598,公共安檢,1,596183,0.00016199,96.57819623
25599,公共事務室,1,596184,0.00016199,96.57835822
25600,公共空間,1,596185,0.00016199,96.57852022
25601,公共建築,1,596186,0.00016199,96.57868221
25602,公共政策研究所,1,596187,0.00016199,96.57884420
25603,公共場合,1,596188,0.00016199,96.57900620
25604,公共意外,1,596189,0.00016199,96.57916819
25605,公共圖書館,1,596190,0.00016199,96.57933019
25606,公共衛生,1,596191,0.00016199,96.57949218
25607,公共關係,1,596192,0.00016199,96.57965417
25608,公安演習,1,596193,0.00016199,96.57981617
25609,公式化,1,596194,0.00016199,96.57997816
25610,公有市場,1,596195,0.00016199,96.58014016
25611,公有停車場,1,596196,0.00016199,96.58030215
25612,公羊,1,596197,0.00016199,96.58046415
25613,公佈欄,1,596198,0.00016199,96.58062614
25614,公車站牌,1,596199,0.00016199,96.58078813
25615,公事包,1,596200,0.00016199,96.58095013
25616,公股,1,596201,0.00016199,96.58111212
25617,公信力,1,596202,0.00016199,96.58127412
25618,公害,1,596203,0.00016199,96.58143611
25619,公家單位,1,596204,0.00016199,96.58159811
25620,公差,1,596205,0.00016199,96.58176010
25621,公益活動,1,596206,0.00016199,96.58192209
25622,公益路,1,596207,0.00016199,96.58208409
25623,公務局,1,596208,0.00016199,96.58224608
25624,公務機關,1,596209,0.00016199,96.58240808
25625,公國,1,596210,0.00016199,96.58257007
25626,公眾人物,1,596211,0.00016199,96.58273206
25627,公祭,1,596212,0.00016199,96.58289406
25628,公設,1,596213,0.00016199,96.58305605
25629,公費,1,596214,0.00016199,96.58321805
25630,公債票券,1,596215,0.00016199,96.58338004
25631,公傷假,1,596216,0.00016199,96.58354204
25632,公園處長,1,596217,0.00016199,96.58370403
25633,公媽,1,596218,0.00016199,96.58386602
25634,公會堂,1,596219,0.00016199,96.58402802
25635,公路局,1,596220,0.00016199,96.58419001
25636,公路電影,1,596221,0.00016199,96.58435201
25637,公蝦,1,596222,0.00016199,96.58451400
25638,公賣局長,1,596223,0.00016199,96.58467600
25639,公器,1,596224,0.00016199,96.58483799
25640,公積,1,596225,0.00016199,96.58499998
25641,公辦,1,596226,0.00016199,96.58516198
25642,公館,1,596227,0.00016199,96.58532397
25643,公龜,1,596228,0.00016199,96.58548597
25644,公營單位,1,596229,0.00016199,96.58564796
25645,公雞,1,596230,0.00016199,96.58580995
25646,公關費,1,596231,0.00016199,96.58597195
25647,冗員,1,596232,0.00016199,96.58613394
25648,凶狠,1,596233,0.00016199,96.58629594
25649,凶悍,1,596234,0.00016199,96.58645793
25650,凶神惡煞,1,596235,0.00016199,96.58661993
25651,凶險,1,596236,0.00016199,96.58678192
25652,分子量,1,596237,0.00016199,96.58694391
25653,分子鍵,1,596238,0.00016199,96.58710591
25654,分工合作,1,596239,0.00016199,96.58726790
25655,分不清,1,596240,0.00016199,96.58742990
25656,分心,1,596241,0.00016199,96.58759189
25657,分支機構,1,596242,0.00016199,96.58775389
25658,分司,1,596243,0.00016199,96.58791588
25659,分列式,1,596244,0.00016199,96.58807787
25660,分別心,1,596245,0.00016199,96.58823987
25661,分析力,1,596246,0.00016199,96.58840186
25662,分版,1,596247,0.00016199,96.58856386
25663,分門別類,1,596248,0.00016199,96.58872585
25664,分度,1,596249,0.00016199,96.58888784
25665,分段式,1,596250,0.00016199,96.58904984
25666,分流,1,596251,0.00016199,96.58921183
25667,分界,1,596252,0.00016199,96.58937383
25668,分界點,1,596253,0.00016199,96.58953582
25669,分秒,1,596254,0.00016199,96.58969782
25670,分音器,1,596255,0.00016199,96.58985981
25671,分娩,1,596256,0.00016199,96.59002180
25672,分家,1,596257,0.00016199,96.59018380
25673,分神,1,596258,0.00016199,96.59034579
25674,分級,1,596259,0.00016199,96.59050779
25675,分配面,1,596260,0.00016199,96.59066978
25676,分區,1,596261,0.00016199,96.59083178
25677,分崩離析,1,596262,0.00016199,96.59099377
25678,分野,1,596263,0.00016199,96.59115576
25679,分割表,1,596264,0.00016199,96.59131776
25680,分掌,1,596265,0.00016199,96.59147975
25681,分會,1,596266,0.00016199,96.59164175
25682,分際,1,596267,0.00016199,96.59180374
25683,分曉,1,596268,0.00016199,96.59196573
25684,分機,1,596269,0.00016199,96.59212773
25685,分離式,1,596270,0.00016199,96.59228972
25686,分贓,1,596271,0.00016199,96.59245172
25687,分靈廟宮,1,596272,0.00016199,96.59261371
25688,切口,1,596273,0.00016199,96.59277571
25689,切切實實,1,596274,0.00016199,96.59293770
25690,切回,1,596275,0.00016199,96.59309969
25691,切割刀,1,596276,0.00016199,96.59326169
25692,切換鈕,1,596277,0.00016199,96.59342368
25693,切換鍵,1,596278,0.00016199,96.59358568
25694,切菜蟻,1,596279,0.00016199,96.59374767
25695,切膚之痛,1,596280,0.00016199,96.59390967
25696,切斷,1,596281,0.00016199,96.59407166
25697,勾峰,1,596282,0.00016199,96.59423365
25698,勾欄,1,596283,0.00016199,96.59439565
25699,勿用,1,596284,0.00016199,96.59455764
25700,化去,1,596285,0.00016199,96.59471964
25701,化名,1,596286,0.00016199,96.59488163
25702,化合物,1,596287,0.00016199,96.59504362
25703,化妝台,1,596288,0.00016199,96.59520562
25704,化妝舞會,1,596289,0.00016199,96.59536761
25705,化肥,1,596290,0.00016199,96.59552961
25706,化為,1,596291,0.00016199,96.59569160
25707,化裝師,1,596292,0.00016199,96.59585360
25708,化敵為友,1,596293,0.00016199,96.59601559
25709,化學分子,1,596294,0.00016199,96.59617758
25710,化學物質,1,596295,0.00016199,96.59633958
25711,化學品部,1,596296,0.00016199,96.59650157
25712,化學獎,1,596297,0.00016199,96.59666357
25713,化學藥品,1,596298,0.00016199,96.59682556
25714,化險為夷,1,596299,0.00016199,96.59698756
25715,化糞池,1,596300,0.00016199,96.59714955
25716,化簡,1,596301,0.00016199,96.59731154
25717,化粧棉,1,596302,0.00016199,96.59747354
25718,化粧間,1,596303,0.00016199,96.59763553
25719,化粧��,1,596304,0.00016199,96.59779753
25720,匹夫之勇,1,596305,0.00016199,96.59795952
25721,匹配,1,596306,0.00016199,96.59812152
25722,午安,1,596307,0.00016199,96.59828351
25723,午安月刊,1,596308,0.00016199,96.59844550
25724,午夜狂奔,1,596309,0.00016199,96.59860750
25725,午飯,1,596310,0.00016199,96.59876949
25726,午餐盒,1,596311,0.00016199,96.59893149
25727,升上,1,596312,0.00016199,96.59909348
25728,升官,1,596313,0.00016199,96.59925547
25729,升級版,1,596314,0.00016199,96.59941747
25730,升幅,1,596315,0.00016199,96.59957946
25731,升等,1,596316,0.00016199,96.59974146
25732,友力,1,596317,0.00016199,96.59990345
25733,友宮,1,596318,0.00016199,96.60006545
25734,友嘉,1,596319,0.00016199,96.60022744
25735,友緣基金會,1,596320,0.00016199,96.60038943
25736,友誼賽,1,596321,0.00016199,96.60055143
25737,友聯頻道,1,596322,0.00016199,96.60071342
25738,及克萊斯勒,1,596323,0.00016199,96.60087542
25739,反人質銷稅,1,596324,0.00016199,96.60103741
25740,反手,1,596325,0.00016199,96.60119941
25741,反文運動,1,596326,0.00016199,96.60136140
25742,反台獨,1,596327,0.00016199,96.60152339
25743,反光,1,596328,0.00016199,96.60168539
25744,反光鏡,1,596329,0.00016199,96.60184738
25745,反共,1,596330,0.00016199,96.60200938
25746,反共愛國聯盟,1,596331,0.00016199,96.60217137
25747,反作用器,1,596332,0.00016199,96.60233336
25748,反抗意識,1,596333,0.00016199,96.60249536
25749,反李,1,596334,0.00016199,96.60265735
25750,反使,1,596335,0.00016199,96.60281935
25751,反重力,1,596336,0.00016199,96.60298134
25752,反唇相譏,1,596337,0.00016199,96.60314334
25753,反射孔,1,596338,0.00016199,96.60330533
25754,反射板,1,596339,0.00016199,96.60346732
25755,反射法,1,596340,0.00016199,96.60362932
25756,反砲戰,1,596341,0.00016199,96.60379131
25757,反問,1,596342,0.00016199,96.60395331
25758,反間諜,1,596343,0.00016199,96.60411530
25759,反間諜處,1,596344,0.00016199,96.60427730
25760,反傳統,1,596345,0.00016199,96.60443929
25761,反過來,1,596346,0.00016199,96.60460128
25762,反對者,1,596347,0.00016199,96.60476328
25763,反漲,1,596348,0.00016199,96.60492527
25764,反彈波,1,596349,0.00016199,96.60508727
25765,反潛魚雷,1,596350,0.00016199,96.60524926
25766,反潛機,1,596351,0.00016199,96.60541125
25767,反學院派,1,596352,0.00016199,96.60557325
25768,反戰,1,596353,0.00016199,96.60573524
25769,反應室,1,596354,0.00016199,96.60589724
25770,反應度,1,596355,0.00016199,96.60605923
25771,反應時間,1,596356,0.00016199,96.60622123
25772,反鎖,1,596357,0.00016199,96.60638322
25773,反證,1,596358,0.00016199,96.60654521
25774,反襯,1,596359,0.00016199,96.60670721
25775,天九牌,1,596360,0.00016199,96.60686920
25776,天人永隔,1,596361,0.00016199,96.60703120
25777,天下人,1,596362,0.00016199,96.60719319
25778,天下文化,1,596363,0.00016199,96.60735519
25779,天下文化出版社,1,596364,0.00016199,96.60751718
25780,天上,1,596365,0.00016199,96.60767917
25781,天大,1,596366,0.00016199,96.60784117
25782,天女,1,596367,0.00016199,96.60800316
25783,天山,1,596368,0.00016199,96.60816516
25784,天山雪蓮,1,596369,0.00016199,96.60832715
25785,天才車場,1,596370,0.00016199,96.60848914
25786,天才兒童,1,596371,0.00016199,96.60865114
25787,天不怕地不怕,1,596372,0.00016199,96.60881313
25788,天不應,1,596373,0.00016199,96.60897513
25789,天公,1,596374,0.00016199,96.60913712
25790,天文,1,596375,0.00016199,96.60929912
25791,天文學家,1,596376,0.00016199,96.60946111
25792,天水堂,1,596377,0.00016199,96.60962310
25793,天王巨星,1,596378,0.00016199,96.60978510
25794,天台,1,596379,0.00016199,96.60994709
25795,天生殺手,1,596380,0.00016199,96.61010909
25796,天生麗質,1,596381,0.00016199,96.61027108
25797,天后,1,596382,0.00016199,96.61043308
25798,天地心聞,1,596383,0.00016199,96.61059507
25799,天地精華,1,596384,0.00016199,96.61075706
25800,天安門事件,1,596385,0.00016199,96.61091906
25801,天安門廣場,1,596386,0.00016199,96.61108105
25802,天成,1,596387,0.00016199,96.61124305
25803,天呀,1,596388,0.00016199,96.61140504
25804,天命,1,596389,0.00016199,96.61156703
25805,天底下,1,596390,0.00016199,96.61172903
25806,天河石,1,596391,0.00016199,96.61189102
25807,天空大戰,1,596392,0.00016199,96.61205302
25808,天長地久,1,596393,0.00016199,96.61221501
25809,天雨,1,596394,0.00016199,96.61237701
25810,天姿撩人,1,596395,0.00016199,96.61253900
25811,天威卡,1,596396,0.00016199,96.61270099
25812,天氣報告,1,596397,0.00016199,96.61286299
25813,天狼星,1,596398,0.00016199,96.61302498
25814,天真無邪,1,596399,0.00016199,96.61318698
25815,天神商業街,1,596400,0.00016199,96.61334897
25816,天期,1,596401,0.00016199,96.61351097
25817,天然災害,1,596402,0.00016199,96.61367296
25818,天然果沐浴乳,1,596403,0.00016199,96.61383495
25819,天然蠟,1,596404,0.00016199,96.61399695
25820,天發,1,596405,0.00016199,96.61415894
25821,天群建設,1,596406,0.00016199,96.61432094
25822,天劍,1,596407,0.00016199,96.61448293
25823,天劍二型中程飛彈,1,596408,0.00016199,96.61464492
25824,天敵,1,596409,0.00016199,96.61480692
25825,天龍八部,1,596410,0.00016199,96.61496891
25826,天龍八部之喬峰,1,596411,0.00016199,96.61513091
25827,天職,1,596412,0.00016199,96.61529290
25828,天鵝,1,596413,0.00016199,96.61545490
25829,天鵝湖,1,596414,0.00016199,96.61561689
25830,天鵝絨,1,596415,0.00016199,96.61577888
25831,天鵝絨革命,1,596416,0.00016199,96.61594088
25832,天壤之別,1,596417,0.00016199,96.61610287
25833,天籟,1,596418,0.00016199,96.61626487
25834,夫妻檔,1,596419,0.00016199,96.61642686
25835,夫唱婦隨,1,596420,0.00016199,96.61658886
25836,太子鈴木,1,596421,0.00016199,96.61675085
25837,太古,1,596422,0.00016199,96.61691284
25838,太古集團,1,596423,0.00016199,96.61707484
25839,太平天國,1,596424,0.00016199,96.61723683
25840,太平洋地區,1,596425,0.00016199,96.61739883
25841,太平洋房屋公司,1,596426,0.00016199,96.61756082
25842,太平洋崇光,1,596427,0.00016199,96.61772281
25843,太平洋艦隊司令部,1,596428,0.00016199,96.61788481
25844,太平軍之役,1,596429,0.00016199,96.61804680
25845,太平鄉,1,596430,0.00016199,96.61820880
25846,太平號,1,596431,0.00016199,96.61837079
25847,太平警分駐所,1,596432,0.00016199,96.61853279
25848,太田母斑,1,596433,0.00016199,96.61869478
25849,太早,1,596434,0.00016199,96.61885677
25850,太克科技,1,596435,0.00016199,96.61901877
25851,太克噴臘,1,596436,0.00016199,96.61918076
25852,太空船,1,596437,0.00016199,96.61934276
25853,太空戰警,1,596438,0.00016199,96.61950475
25854,太空艙,1,596439,0.00016199,96.61966675
25855,太座,1,596440,0.00016199,96.61982874
25856,太陽花,1,596441,0.00016199,96.61999073
25857,太陽能,1,596442,0.00016199,96.62015273
25858,太陽眼鏡,1,596443,0.00016199,96.62031472
25859,太陽黑子,1,596444,0.00016199,96.62047672
25860,太慢太慢,1,596445,0.00016199,96.62063871
25861,太魯閣,1,596446,0.00016199,96.62080070
25862,太笈傳播,1,596447,0.00016199,96.62096270
25863,孔穴,1,596448,0.00016199,96.62112469
25864,孔明,1,596449,0.00016199,96.62128669
25865,孔武有力,1,596450,0.00016199,96.62144868
25866,孔長安,1,596451,0.00016199,96.62161068
25867,孔恩,1,596452,0.00016199,96.62177267
25868,孔隙,1,596453,0.00016199,96.62193466
25869,孔廟,1,596454,0.00016199,96.62209666
25870,孔德拉辛,1,596455,0.00016199,96.62225865
25871,少一點,1,596456,0.00016199,96.62242065
25872,少之又少,1,596457,0.00016199,96.62258264
25873,少少,1,596458,0.00016199,96.62274464
25874,少年人,1,596459,0.00016199,96.62290663
25875,少年犯,1,596460,0.00016199,96.62306862
25876,少年期,1,596461,0.00016199,96.62323062
25877,少壯派,1,596462,0.00016199,96.62339261
25878,少尉,1,596463,0.00016199,96.62355461
25879,少將,1,596464,0.00016199,96.62371660
25880,少淑女,1,596465,0.00016199,96.62387859
25881,少部份,1,596466,0.00016199,96.62404059
25882,少說,1,596467,0.00016199,96.62420258
25883,尤里西斯,1,596468,0.00016199,96.62436458
25884,尤金．史密斯,1,596469,0.00016199,96.62452657
25885,尤金．史密斯獎,1,596470,0.00016199,96.62468857
25886,尤為,1,596471,0.00016199,96.62485056
25887,尤英,1,596472,0.00016199,96.62501255
25888,尤英呢,1,596473,0.00016199,96.62517455
25889,尤清,1,596474,0.00016199,96.62533654
25890,尺骨神經,1,596475,0.00016199,96.62549854
25891,屯,1,596476,0.00016199,96.62566053
25892,巴士海峽,1,596477,0.00016199,96.62582253
25893,巴丹島,1,596478,0.00016199,96.62598452
25894,巴戈,1,596479,0.00016199,96.62614651
25895,巴比松,1,596480,0.00016199,96.62630851
25896,巴比松市,1,596481,0.00016199,96.62647050
25897,巴卡俾格米人,1,596482,0.00016199,96.62663250
25898,巴布亞新幾內亞,1,596483,0.00016199,96.62679449
25899,巴生,1,596484,0.00016199,96.62695649
25900,巴伐利亞,1,596485,0.00016199,96.62711848
25901,巴西里歐,1,596486,0.00016199,96.62728047
25902,巴克豪斯,1,596487,0.00016199,96.62744247
25903,巴里斯和海倫的愛情,1,596488,0.00016199,96.62760446
25904,巴拉茲,1,596489,0.00016199,96.62776646
25905,巴哈,1,596490,0.00016199,96.62792845
25906,巴洛克風,1,596491,0.00016199,96.62809044
25907,巴若拉,1,596492,0.00016199,96.62825244
25908,巴拿馬,1,596493,0.00016199,96.62841443
25909,巴特斯村,1,596494,0.00016199,96.62857643
25910,巴紗,1,596495,0.00016199,96.62873842
25911,巴勒斯坦解放組織,1,596496,0.00016199,96.62890042
25912,巴基斯坦,1,596497,0.00016199,96.62906241
25913,巴得斯特,1,596498,0.00016199,96.62922440
25914,巴望舞曲,1,596499,0.00016199,96.62938640
25915,巴斯可,1,596500,0.00016199,96.62954839
25916,巴筏出峽圖卷,1,596501,0.00016199,96.62971039
25917,巴賀內,1,596502,0.00016199,96.62987238
25918,巴塔哥尼亞區,1,596503,0.00016199,96.63003438
25919,巴頓芬克,1,596504,0.00016199,96.63019637
25920,巴爾托爾,1,596505,0.00016199,96.63035836
25921,巴爾提克,1,596506,0.00016199,96.63052036
25922,巴德,1,596507,0.00016199,96.63068235
25923,巴德．潘恩,1,596508,0.00016199,96.63084435
25924,巴黎音樂學院,1,596509,0.00016199,96.63100634
25925,巴黎國立大學,1,596510,0.00016199,96.63116833
25926,巴顏喀拉山,1,596511,0.00016199,96.63133033
25927,巴譚民都工業區,1,596512,0.00016199,96.63149232
25928,巴譚民都工業園區,1,596513,0.00016199,96.63165432
25929,巴譚島,1,596514,0.00016199,96.63181631
25930,幻象戰機,1,596515,0.00016199,96.63197831
25931,幻想世界,1,596516,0.00016199,96.63214030
25932,幻想世界劇院,1,596517,0.00016199,96.63230229
25933,幻夢,1,596518,0.00016199,96.63246429
25934,引人入勝,1,596519,0.00016199,96.63262628
25935,引人注意,1,596520,0.00016199,96.63278828
25936,引力,1,596521,0.00016199,96.63295027
25937,引以自豪,1,596522,0.00016199,96.63311227
25938,引以為憂,1,596523,0.00016199,96.63327426
25939,引用水,1,596524,0.00016199,96.63343625
25940,引用值,1,596525,0.00016199,96.63359825
25941,引信,1,596526,0.00016199,96.63376024
25942,引流,1,596527,0.00016199,96.63392224
25943,引經據典,1,596528,0.00016199,96.63408423
25944,引導性,1,596529,0.00016199,96.63424622
25945,引頸,1,596530,0.00016199,96.63440822
25946,引頸企盼,1,596531,0.00016199,96.63457021
25947,引擎溫度表,1,596532,0.00016199,96.63473221
25948,引擎蓋板,1,596533,0.00016199,96.63489420
25949,引爆點,1,596534,0.00016199,96.63505620
25950,引證,1,596535,0.00016199,96.63521819
25951,心切,1,596536,0.00016199,96.63538018
25952,心心相惜,1,596537,0.00016199,96.63554218
25953,心地,1,596538,0.00016199,96.63570417
25954,心如刀割,1,596539,0.00016199,96.63586617
25955,心安理得,1,596540,0.00016199,96.63602816
25956,心有餘悸,1,596541,0.00016199,96.63619016
25957,心灰意懶,1,596542,0.00016199,96.63635215
25958,心肝,1,596543,0.00016199,96.63651414
25959,心言,1,596544,0.00016199,96.63667614
25960,心事重重,1,596545,0.00016199,96.63683813
25961,心肺復甦術,1,596546,0.00016199,96.63700013
25962,心律不整,1,596547,0.00016199,96.63716212
25963,心急,1,596548,0.00016199,96.63732411
25964,心狠手辣,1,596549,0.00016199,96.63748611
25965,心悅誠服,1,596550,0.00016199,96.63764810
25966,心浮氣躁,1,596551,0.00016199,96.63781010
25967,心病,1,596552,0.00016199,96.63797209
25968,心神,1,596553,0.00016199,96.63813409
25969,心神喪失,1,596554,0.00016199,96.63829608
25970,心胸寬大,1,596555,0.00016199,96.63845807
25971,心理片,1,596556,0.00016199,96.63862007
25972,心理因素,1,596557,0.00016199,96.63878206
25973,心理系,1,596558,0.00016199,96.63894406
25974,心理性,1,596559,0.00016199,96.63910605
25975,心理專家,1,596560,0.00016199,96.63926805
25976,心理準備,1,596561,0.00016199,96.63943004
25977,心理輔導,1,596562,0.00016199,96.63959203
25978,心理學者,1,596563,0.00016199,96.63975403
25979,心理戰,1,596564,0.00016199,96.63991602
25980,心理變態,1,596565,0.00016199,96.64007802
25981,心眼,1,596566,0.00016199,96.64024001
25982,心軟,1,596567,0.00016199,96.64040200
25983,心痛,1,596568,0.00016199,96.64056400
25984,心脾,1,596569,0.00016199,96.64072599
25985,心虛,1,596570,0.00016199,96.64088799
25986,心慌,1,596571,0.00016199,96.64104998
25987,心腸,1,596572,0.00016199,96.64121198
25988,心腹大患,1,596573,0.00016199,96.64137397
25989,心路,1,596574,0.00016199,96.64153596
25990,心路文教基金會,1,596575,0.00016199,96.64169796
25991,心滿意足,1,596576,0.00016199,96.64185995
25992,心緒,1,596577,0.00016199,96.64202195
25993,心證,1,596578,0.00016199,96.64218394
25994,心臟內科,1,596579,0.00016199,96.64234594
25995,心臟性,1,596580,0.00016199,96.64250793
25996,心臟性疾病,1,596581,0.00016199,96.64266992
25997,心驚膽跳,1,596582,0.00016199,96.64283192
25998,心靈之旅,1,596583,0.00016199,96.64299391
25999,心靈溝通,1,596584,0.00016199,96.64315591
26000,戈,1,596585,0.00016199,96.64331790
26001,戈巴契夫,1,596586,0.00016199,96.64347989
26002,戶口,1,596587,0.00016199,96.64364189
26003,戶口查察,1,596588,0.00016199,96.64380388
26004,戶外活動,1,596589,0.00016199,96.64396588
26005,戶外教學,1,596590,0.00016199,96.64412787
26006,戶政,1,596591,0.00016199,96.64428987
26007,戶政所,1,596592,0.00016199,96.64445186
26008,戶政電腦連線,1,596593,0.00016199,96.64461385
26009,戶政電腦資訊系統,1,596594,0.00016199,96.64477585
26010,戶籍員,1,596595,0.00016199,96.64493784
26011,手下敗將,1,596596,0.00016199,96.64509984
26012,手工研究所,1,596597,0.00016199,96.64526183
26013,手工餅乾,1,596598,0.00016199,96.64542383
26014,手工藝研究所,1,596599,0.00016199,96.64558582
26015,手心,1,596600,0.00016199,96.64574781
26016,手把,1,596601,0.00016199,96.64590981
26017,手足無措,1,596602,0.00016199,96.64607180
26018,手到擒來,1,596603,0.00016199,96.64623380
26019,手刮刀,1,596604,0.00016199,96.64639579
26020,手帕,1,596605,0.00016199,96.64655778
26021,手拉胚,1,596606,0.00016199,96.64671978
26022,手型,1,596607,0.00016199,96.64688177
26023,手持式,1,596608,0.00016199,96.64704377
26024,手氣,1,596609,0.00016199,96.64720576
26025,手記,1,596610,0.00016199,96.64736776
26026,手動對焦轉盤,1,596611,0.00016199,96.64752975
26027,手動曝光尺度,1,596612,0.00016199,96.64769174
26028,手推車,1,596613,0.00016199,96.64785374
26029,手排變速箱,1,596614,0.00016199,96.64801573
26030,手淫,1,596615,0.00016199,96.64817773
26031,手球,1,596616,0.00016199,96.64833972
26032,手創,1,596617,0.00016199,96.64850172
26033,手提,1,596618,0.00016199,96.64866371
26034,手提袋,1,596619,0.00016199,96.64882570
26035,手筆,1,596620,0.00016199,96.64898770
26036,手塚,1,596621,0.00016199,96.64914969
26037,手錶,1,596622,0.00016199,96.64931169
26038,手頭上,1,596623,0.00016199,96.64947368
26039,手鍊,1,596624,0.00016199,96.64963567
26040,手藝,1,596625,0.00016199,96.64979767
26041,手邊,1,596626,0.00016199,96.64995966
26042,扎,1,596627,0.00016199,96.65012166
26043,扎根,1,596628,0.00016199,96.65028365
26044,支支,1,596629,0.00016199,96.65044565
26045,支助,1,596630,0.00016199,96.65060764
26046,支那,1,596631,0.00016199,96.65076963
26047,支持性,1,596632,0.00016199,96.65093163
26048,支持點,1,596633,0.00016199,96.65109362
26049,支氣管,1,596634,0.00016199,96.65125562
26050,支配性,1,596635,0.00016199,96.65141761
26051,支票本,1,596636,0.00016199,96.65157961
26052,支援力,1,596637,0.00016199,96.65174160
26053,支援性,1,596638,0.00016199,96.65190359
26054,支援者,1,596639,0.00016199,96.65206559
26055,支遣費,1,596640,0.00016199,96.65222758
26056,支撐力,1,596641,0.00016199,96.65238958
26057,支撐性,1,596642,0.00016199,96.65255157
26058,支線,1,596643,0.00016199,96.65271357
26059,支離,1,596644,0.00016199,96.65287556
26060,支離破碎,1,596645,0.00016199,96.65303755
26061,文人,1,596646,0.00016199,96.65319955
26062,文人政府,1,596647,0.00016199,96.65336154
26063,文人畫派,1,596648,0.00016199,96.65352354
26064,文化人,1,596649,0.00016199,96.65368553
26065,文化大革命,1,596650,0.00016199,96.65384752
26066,文化工作者,1,596651,0.00016199,96.65400952
26067,文化工程,1,596652,0.00016199,96.65417151
26068,文化中心劇場,1,596653,0.00016199,96.65433351
26069,文化城,1,596654,0.00016199,96.65449550
26070,文化宴饗,1,596655,0.00016199,96.65465750
26071,文化傳信,1,596656,0.00016199,96.65481949
26072,文句,1,596657,0.00016199,96.65498148
26073,文石,1,596658,0.00016199,96.65514348
26074,文字性,1,596659,0.00016199,96.65530547
26075,文字記者,1,596660,0.00016199,96.65546747
26076,文宇,1,596661,0.00016199,96.65562946
26077,文具,1,596662,0.00016199,96.65579146
26078,文官中立制度,1,596663,0.00016199,96.65595345
26079,文官化,1,596664,0.00016199,96.65611544
26080,文昌,1,596665,0.00016199,96.65627744
26081,文昌東路,1,596666,0.00016199,96.65643943
26082,文明史,1,596667,0.00016199,96.65660143
26083,文明病,1,596668,0.00016199,96.65676342
26084,文武配,1,596669,0.00016199,96.65692541
26085,文法,1,596670,0.00016199,96.65708741
26086,文盲,1,596671,0.00016199,96.65724940
26087,文品,1,596672,0.00016199,96.65741140
26088,文宣,1,596673,0.00016199,96.65757339
26089,文英館,1,596674,0.00016199,96.65773539
26090,文弱書生,1,596675,0.00016199,96.65789738
26091,文書科,1,596676,0.00016199,96.65805937
26092,文教,1,596677,0.00016199,96.65822137
26093,文教界,1,596678,0.00016199,96.65838336
26094,文教區,1,596679,0.00016199,96.65854536
26095,文教基金會,1,596680,0.00016199,96.65870735
26096,文淵閣彩色印前系統,1,596681,0.00016199,96.65886935
26097,文森帝諾佛,1,596682,0.00016199,96.65903134
26098,文雅,1,596683,0.00016199,96.65919333
26099,文匯報,1,596684,0.00016199,96.65935533
26100,文資法,1,596685,0.00016199,96.65951732
26101,文摘,1,596686,0.00016199,96.65967932
26102,文管陣頭,1,596687,0.00016199,96.65984131
26103,文豪,1,596688,0.00016199,96.66000330
26104,文學課,1,596689,0.00016199,96.66016530
26105,文瞻,1,596690,0.00016199,96.66032729
26106,文藝復興,1,596691,0.00016199,96.66048929
26107,文藝復興時期,1,596692,0.00016199,96.66065128
26108,文藝腔,1,596693,0.00016199,96.66081328
26109,文韻,1,596694,0.00016199,96.66097527
26110,文獻會,1,596695,0.00016199,96.66113726
26111,文仝,1,596696,0.00016199,96.66129926
26112,斗,1,596697,0.00016199,96.66146125
26113,斗蓬草,1,596698,0.00016199,96.66162325
26114,斗篷式,1,596699,0.00016199,96.66178524
26115,斗轉星移,1,596700,0.00016199,96.66194724
26116,斤斤計較,1,596701,0.00016199,96.66210923
26117,方子,1,596702,0.00016199,96.66227122
26118,方介君,1,596703,0.00016199,96.66243322
26119,方方正正,1,596704,0.00016199,96.66259521
26120,方正,1,596705,0.00016199,96.66275721
26121,方向舵,1,596706,0.00016199,96.66291920
26122,方向盤鎖,1,596707,0.00016199,96.66308119
26123,方向燈殼,1,596708,0.00016199,96.66324319
26124,方形,1,596709,0.00016199,96.66340518
26125,方言,1,596710,0.00016199,96.66356718
26126,方東龍休閒專業機構,1,596711,0.00016199,96.66372917
26127,方家,1,596712,0.00016199,96.66389117
26128,方院,1,596713,0.00016199,96.66405316
26129,方陣快砲,1,596714,0.00016199,96.66421515
26130,方眼男孩,1,596715,0.00016199,96.66437715
26131,方笛,1,596716,0.00016199,96.66453914
26132,方棋子,1,596717,0.00016199,96.66470114
26133,方圓,1,596718,0.00016199,96.66486313
26134,方塊字,1,596719,0.00016199,96.66502513
26135,日久,1,596720,0.00016199,96.66518712
26136,日久生情,1,596721,0.00016199,96.66534911
26137,日內瓦,1,596722,0.00016199,96.66551111
26138,日內瓦車展,1,596723,0.00016199,96.66567310
26139,日日夜夜,1,596724,0.00016199,96.66583510
26140,日月潭,1,596725,0.00016199,96.66599709
26141,日本方程式賽車,1,596726,0.00016199,96.66615908
26142,日本交流協會,1,596727,0.00016199,96.66632108
26143,日本任天堂公司,1,596728,0.00016199,96.66648307
26144,日本存款保險公司,1,596729,0.00016199,96.66664507
26145,日本式,1,596730,0.00016199,96.66680706
26146,日本成田機場,1,596731,0.00016199,96.66696906
26147,日本自行車探險俱樂部,1,596732,0.00016199,96.66713105
26148,日本住友商事公司,1,596733,0.00016199,96.66729304
26149,日本住宅金融公司,1,596734,0.00016199,96.66745504
26150,日本松下海外廣告獎,1,596735,0.00016199,96.66761703
26151,日本松下海外廣告賞,1,596736,0.00016199,96.66777903
26152,日本股市,1,596737,0.00016199,96.66794102
26153,日本金像獎,1,596738,0.00016199,96.66810302
26154,日本青年社,1,596739,0.00016199,96.66826501
26155,日本時事社,1,596740,0.00016199,96.66842700
26156,日本海,1,596741,0.00016199,96.66858900
26157,日本國土地理院,1,596742,0.00016199,96.66875099
26158,日本清酒,1,596743,0.00016199,96.66891299
26159,日本超市,1,596744,0.00016199,96.66907498
26160,日本群島,1,596745,0.00016199,96.66923697
26161,日本電氣,1,596746,0.00016199,96.66939897
26162,日本漫畫協會,1,596747,0.00016199,96.66956096
26163,日本優尼西佳隊,1,596748,0.00016199,96.66972296
26164,日本醬油,1,596749,0.00016199,96.66988495
26165,日正當中,1,596750,0.00016199,96.67004695
26166,日光峽谷,1,596751,0.00016199,96.67020894
26167,日光浴,1,596752,0.00016199,96.67037093
26168,日安,1,596753,0.00016199,96.67053293
26169,日耳曼,1,596754,0.00016199,96.67069492
26170,日系,1,596755,0.00016199,96.67085692
26171,日治,1,596756,0.00016199,96.67101891
26172,日茂行,1,596757,0.00016199,96.67118091
26173,日益惡化,1,596758,0.00016199,96.67134290
26174,日記簿,1,596759,0.00016199,96.67150489
26175,日動畫廊,1,596760,0.00016199,96.67166689
26176,日常用品,1,596761,0.00016199,96.67182888
26177,日盛,1,596762,0.00016199,96.67199088
26178,日盛期貨,1,596763,0.00016199,96.67215287
26179,日換星移,1,596764,0.00016199,96.67231486
26180,日華議員連盟會,1,596765,0.00016199,96.67247686
26181,日經指數,1,596766,0.00016199,96.67263885
26182,日經產業新聞,1,596767,0.00016199,96.67280085
26183,日僑工商會,1,596768,0.00016199,96.67296284
26184,日製,1,596769,0.00016199,96.67312484
26185,日認基金,1,596770,0.00016199,96.67328683
26186,日劇,1,596771,0.00016199,96.67344882
26187,日據,1,596772,0.00016199,96.67361082
26188,日據時代,1,596773,0.00016199,96.67377281
26189,日機,1,596774,0.00016199,96.67393481
26190,日興證券公司,1,596775,0.00016199,96.67409680
26191,日頭,1,596776,0.00016199,96.67425880
26192,日趨,1,596777,0.00016199,96.67442079
26193,日趨平穩,1,596778,0.00016199,96.67458278
26194,日霜,1,596779,0.00016199,96.67474478
26195,日曬,1,596780,0.00016199,96.67490677
26196,月子,1,596781,0.00016199,96.67506877
26197,月中,1,596782,0.00016199,96.67523076
26198,月分,1,596783,0.00016199,96.67539275
26199,月考,1,596784,0.00016199,96.67555475
26200,月事,1,596785,0.00016199,96.67571674
26201,月河,1,596786,0.00016199,96.67587874
26202,月初,1,596787,0.00016199,96.67604073
26203,月金,1,596788,0.00016199,96.67620273
26204,月亮的小孩,1,596789,0.00016199,96.67636472
26205,月桂冠,1,596790,0.00016199,96.67652671
26206,月琴,1,596791,0.00016199,96.67668871
26207,月琴隊,1,596792,0.00016199,96.67685070
26208,月琴歌隊,1,596793,0.00016199,96.67701270
26209,月號,1,596794,0.00016199,96.67717469
26210,月影,1,596795,0.00016199,96.67733669
26211,月薪,1,596796,0.00016199,96.67749868
26212,木乃伊型棺,1,596797,0.00016199,96.67766067
26213,木下正三,1,596798,0.00016199,96.67782267
26214,木天牛,1,596799,0.00016199,96.67798466
26215,木片,1,596800,0.00016199,96.67814666
26216,木瓜,1,596801,0.00016199,96.67830865
26217,木耳,1,596802,0.00016199,96.67847064
26218,木材業,1,596803,0.00016199,96.67863264
26219,木板屋,1,596804,0.00016199,96.67879463
26220,木柱,1,596805,0.00016199,96.67895663
26221,木柵路,1,596806,0.00016199,96.67911862
26222,木桌,1,596807,0.00016199,96.67928062
26223,木紋,1,596808,0.00016199,96.67944261
26224,木釘,1,596809,0.00016199,96.67960460
26225,木桶,1,596810,0.00016199,96.67976660
26226,木梨憲武,1,596811,0.00016199,96.67992859
26227,木訥寡言,1,596812,0.00016199,96.68009059
26228,木造,1,596813,0.00016199,96.68025258
26229,木喬,1,596814,0.00016199,96.68041458
26230,木喬傳播公司,1,596815,0.00016199,96.68057657
26231,木棉,1,596816,0.00016199,96.68073856
26232,木塊,1,596817,0.00016199,96.68090056
26233,木靴,1,596818,0.00016199,96.68106255
26234,木飾,1,596819,0.00016199,96.68122455
26235,木鼓舞,1,596820,0.00016199,96.68138654
26236,木製,1,596821,0.00016199,96.68154854
26237,木模,1,596822,0.00016199,96.68171053
26238,木質,1,596823,0.00016199,96.68187252
26239,木鞋舞,1,596824,0.00016199,96.68203452
26240,木橋,1,596825,0.00016199,96.68219651
26241,木雕營,1,596826,0.00016199,96.68235851
26242,木頭人,1,596827,0.00016199,96.68252050
26243,木頭美人,1,596828,0.00016199,96.68268249
26244,木櫥,1,596829,0.00016199,96.68284449
26245,欠佳,1,596830,0.00016199,96.68300648
26246,欠債,1,596831,0.00016199,96.68316848
26247,欠錢,1,596832,0.00016199,96.68333047
26248,止住,1,596833,0.00016199,96.68349247
26249,止痛針,1,596834,0.00016199,96.68365446
26250,止痛藥,1,596835,0.00016199,96.68381645
26251,止痛藥膏,1,596836,0.00016199,96.68397845
26252,止跌回升,1,596837,0.00016199,96.68414044
26253,止跌築底,1,596838,0.00016199,96.68430244
26254,止歇,1,596839,0.00016199,96.68446443
26255,歹,1,596840,0.00016199,96.68462643
26256,歹丸鄙兒,1,596841,0.00016199,96.68478842
26257,毋庸置疑,1,596842,0.00016199,96.68495041
26258,毋寧是,1,596843,0.00016199,96.68511241
26259,比不過,1,596844,0.00016199,96.68527440
26260,比分,1,596845,0.00016199,96.68543640
26261,比手劃腳,1,596846,0.00016199,96.68559839
26262,比比,1,596847,0.00016199,96.68576038
26263,比比看,1,596848,0.00016199,96.68592238
26264,比丘,1,596849,0.00016199,96.68608437
26265,比丘尼,1,596850,0.00016199,96.68624637
26266,比如說,1,596851,0.00016199,96.68640836
26267,比佛利山,1,596852,0.00016199,96.68657036
26268,比利時籍,1,596853,0.00016199,96.68673235
26269,比例尺,1,596854,0.00016199,96.68689434
26270,比來比去,1,596855,0.00016199,96.68705634
26271,比耶加默,1,596856,0.00016199,96.68721833
26272,比基尼,1,596857,0.00016199,96.68738033
26273,比評,1,596858,0.00016199,96.68754232
26274,比試,1,596859,0.00016199,96.68770432
26275,比爾．布瑞爾,1,596860,0.00016199,96.68786631
26276,比爾普曼,1,596861,0.00016199,96.68802830
26277,比稿,1,596862,0.00016199,96.68819030
26278,比鄰,1,596863,0.00016199,96.68835229
26279,比賽者,1,596864,0.00016199,96.68851429
26280,比賽場,1,596865,0.00016199,96.68867628
26281,比賽會,1,596866,0.00016199,96.68883827
26282,毛戈平,1,596867,0.00016199,96.68900027
26283,毛毛蟲,1,596868,0.00016199,96.68916226
26284,毛利,1,596869,0.00016199,96.68932426
26285,毛利率,1,596870,0.00016199,96.68948625
26286,毛夾,1,596871,0.00016199,96.68964825
26287,毛豆,1,596872,0.00016199,96.68981024
26288,毛刷,1,596873,0.00016199,96.68997223
26289,毛屍,1,596874,0.00016199,96.69013423
26290,毛料,1,596875,0.00016199,96.69029622
26291,毛骨悚然,1,596876,0.00016199,96.69045822
26292,毛細孔,1,596877,0.00016199,96.69062021
26293,毛線,1,596878,0.00016199,96.69078221
26294,毛線套,1,596879,0.00016199,96.69094420
26295,毛質,1,596880,0.00016199,96.69110619
26296,毛髮,1,596881,0.00016199,96.69126819
26297,毛錢,1,596882,0.00016199,96.69143018
26298,毛織物,1,596883,0.00016199,96.69159218
26299,氏族,1,596884,0.00016199,96.69175417
26300,水力發電,1,596885,0.00016199,96.69191616
26301,水上飛機,1,596886,0.00016199,96.69207816
26302,水上運動,1,596887,0.00016199,96.69224015
26303,水上摩托車,1,596888,0.00016199,96.69240215
26304,水土不合,1,596889,0.00016199,96.69256414
26305,水土保持,1,596890,0.00016199,96.69272614
26306,水中有氧舞蹈,1,596891,0.00016199,96.69288813
26307,水手隊,1,596892,0.00016199,96.69305012
26308,水火不容,1,596893,0.00016199,96.69321212
26309,水牛,1,596894,0.00016199,96.69337411
26310,水仙花,1,596895,0.00016199,96.69353611
26311,水冬瓜站,1,596896,0.00016199,96.69369810
26312,水平型,1,596897,0.00016199,96.69386010
26313,水生,1,596898,0.00016199,96.69402209
26314,水池邊的大橡樹,1,596899,0.00016199,96.69418408
26315,水污染,1,596900,0.00016199,96.69434608
26316,水米酒,1,596901,0.00016199,96.69450807
26317,水利局,1,596902,0.00016199,96.69467007
26318,水利事業,1,596903,0.00016199,96.69483206
26319,水利科,1,596904,0.00016199,96.69499405
26320,水底,1,596905,0.00016199,96.69515605
26321,水底寮,1,596906,0.00016199,96.69531804
26322,水性,1,596907,0.00016199,96.69548004
26323,水泥旅館,1,596908,0.00016199,96.69564203
26324,水泥碼頭,1,596909,0.00016199,96.69580403
26325,水泡,1,596910,0.00016199,96.69596602
26326,水肥,1,596911,0.00016199,96.69612801
26327,水花,1,596912,0.00016199,96.69629001
26328,水幽,1,596913,0.00016199,96.69645200
26329,水柳,1,596914,0.00016199,96.69661400
26330,水洗槽,1,596915,0.00016199,96.69677599
26331,水洩不通,1,596916,0.00016199,96.69693799
26332,水面軍艦,1,596917,0.00016199,96.69709998
26333,水粉畫,1,596918,0.00016199,96.69726197
26334,水荒,1,596919,0.00016199,96.69742397
26335,水密式,1,596920,0.00016199,96.69758596
26336,水彩筆,1,596921,0.00016199,96.69774796
26337,水患,1,596922,0.00016199,96.69790995
26338,水產,1,596923,0.00016199,96.69807194
26339,水產系,1,596924,0.00016199,96.69823394
26340,水產試驗所,1,596925,0.00016199,96.69839593
26341,水袖,1,596926,0.00016199,96.69855793
26342,水貨,1,596927,0.00016199,96.69871992
26343,水野,1,596928,0.00016199,96.69888192
26344,水循環,1,596929,0.00016199,96.69904391
26345,水勢,1,596930,0.00016199,96.69920590
26346,水塘,1,596931,0.00016199,96.69936790
26347,水溶性,1,596932,0.00016199,96.69952989
26348,水源地,1,596933,0.00016199,96.69969189
26349,水溝,1,596934,0.00016199,96.69985388
26350,水裡,1,596935,0.00016199,96.70001588
26351,水試所,1,596936,0.00016199,96.70017787
26352,水遁,1,596937,0.00016199,96.70033986
26353,水雷,1,596938,0.00016199,96.70050186
26354,水幕電影,1,596939,0.00016199,96.70066385
26355,水滴,1,596940,0.00016199,96.70082585
26356,水舞,1,596941,0.00016199,96.70098784
26357,水餃,1,596942,0.00016199,96.70114983
26358,水稻田,1,596943,0.00016199,96.70131183
26359,水稻耕作隊,1,596944,0.00016199,96.70147382
26360,水箱罩,1,596945,0.00016199,96.70163582
26361,水質污染,1,596946,0.00016199,96.70179781
26362,水壩,1,596947,0.00016199,96.70195981
26363,水鑽,1,596948,0.00016199,96.70212180
26364,火山灰,1,596949,0.00016199,96.70228379
26365,火山島,1,596950,0.00016199,96.70244579
26366,火山區,1,596951,0.00016199,96.70260778
26367,火坑,1,596952,0.00016199,96.70276978
26368,火車冒煙,1,596953,0.00016199,96.70293177
26369,火花,1,596954,0.00016199,96.70309377
26370,火拼,1,596955,0.00016199,96.70325576
26371,火流星,1,596956,0.00016199,96.70341775
26372,火炬,1,596957,0.00016199,96.70357975
26373,火紅,1,596958,0.00016199,96.70374174
26374,火柴棒狀,1,596959,0.00016199,96.70390374
26375,火氣,1,596960,0.00016199,96.70406573
26376,火神,1,596961,0.00016199,96.70422772
26377,火速,1,596962,0.00016199,96.70438972
26378,火喉,1,596963,0.00016199,96.70455171
26379,火種,1,596964,0.00016199,96.70471371
26380,火網,1,596965,0.00016199,96.70487570
26381,火腿片,1,596966,0.00016199,96.70503770
26382,火腿蛋,1,596967,0.00016199,96.70519969
26383,火熱,1,596968,0.00016199,96.70536168
26384,火箭莢艙,1,596969,0.00016199,96.70552368
26385,火箭塔,1,596970,0.00016199,96.70568567
26386,火箭艙,1,596971,0.00016199,96.70584767
26387,火燄,1,596972,0.00016199,96.70600966
26388,火鍋料,1,596973,0.00016199,96.70617166
26389,爪耙仔,1,596974,0.00016199,96.70633365
26390,父子檔,1,596975,0.00016199,96.70649564
26391,父母官,1,596976,0.00016199,96.70665764
26392,父島,1,596977,0.00016199,96.70681963
26393,父愛,1,596978,0.00016199,96.70698163
26394,片片,1,596979,0.00016199,96.70714362
26395,片名,1,596980,0.00016199,96.70730561
26396,片刻,1,596981,0.00016199,96.70746761
26397,片面,1,596982,0.00016199,96.70762960
26398,片假名,1,596983,0.00016199,96.70779160
26399,片基,1,596984,0.00016199,96.70795359
26400,片場,1,596985,0.00016199,96.70811559
26401,片源,1,596986,0.00016199,96.70827758
26402,片語,1,596987,0.00016199,96.70843957
26403,片廠,1,596988,0.00016199,96.70860157
26404,片頭曲,1,596989,0.00016199,96.70876356
26405,片斷,1,596990,0.00016199,96.70892556
26406,片藏量,1,596991,0.00016199,96.70908755
26407,牙科醫生,1,596992,0.00016199,96.70924955
26408,牙將,1,596993,0.00016199,96.70941154
26409,牙痛五分珠,1,596994,0.00016199,96.70957353
26410,牙買加,1,596995,0.00016199,96.70973553
26411,牙齒的故事,1,596996,0.00016199,96.70989752
26412,牙醫,1,596997,0.00016199,96.71005952
26413,牙癢癢,1,596998,0.00016199,96.71022151
26414,牛仔式,1,596999,0.00016199,96.71038351
26415,牛仔馬術競賽,1,597000,0.00016199,96.71054550
26416,牛仔裝,1,597001,0.00016199,96.71070749
26417,牛仔歌,1,597002,0.00016199,96.71086949
26418,牛奶浴,1,597003,0.00016199,96.71103148
26419,牛耳,1,597004,0.00016199,96.71119348
26420,牛耳朵,1,597005,0.00016199,96.71135547
26421,牛肉丸,1,597006,0.00016199,96.71151746
26422,牛肉粥,1,597007,0.00016199,96.71167946
26423,牛尾巴,1,597008,0.00016199,96.71184145
26424,牛肝,1,597009,0.00016199,96.71200345
26425,牛郎,1,597010,0.00016199,96.71216544
26426,牛眠山,1,597011,0.00016199,96.71232744
26427,牛神,1,597012,0.00016199,96.71248943
26428,牛馬,1,597013,0.00016199,96.71265142
26429,牛骨,1,597014,0.00016199,96.71281342
26430,牛宿二,1,597015,0.00016199,96.71297541
26431,牛排館,1,597016,0.00016199,96.71313741
26432,牛羚,1,597017,0.00016199,96.71329940
26433,牛棚,1,597018,0.00016199,96.71346140
26434,牛脾,1,597019,0.00016199,96.71362339
26435,牛酥烙,1,597020,0.00016199,96.71378538
26436,牛群,1,597021,0.00016199,96.71394738
26437,牛鈴聲,1,597022,0.00016199,96.71410937
26438,牛慶福,1,597023,0.00016199,96.71427137
26439,牛瘟,1,597024,0.00016199,96.71443336
26440,犬科動物,1,597025,0.00016199,96.71459535
26441,犬儒式,1,597026,0.00016199,96.71475735
26442,王人政,1,597027,0.00016199,96.71491934
26443,王又曾,1,597028,0.00016199,96.71508134
26444,王士傑,1,597029,0.00016199,96.71524333
26445,王中銘,1,597030,0.00016199,96.71540533
26446,王公貴族,1,597031,0.00016199,96.71556732
26447,王世勛,1,597032,0.00016199,96.71572931
26448,王玉雲,1,597033,0.00016199,96.71589131
26449,王田,1,597034,0.00016199,96.71605330
26450,王仲豫,1,597035,0.00016199,96.71621530
26451,王光英,1,597036,0.00016199,96.71637729
26452,王光熙,1,597037,0.00016199,96.71653929
26453,王安憶,1,597038,0.00016199,96.71670128
26454,王羽,1,597039,0.00016199,96.71686327
26455,王志偉,1,597040,0.00016199,96.71702527
26456,王咄,1,597041,0.00016199,96.71718726
26457,王坤,1,597042,0.00016199,96.71734926
26458,王林,1,597043,0.00016199,96.71751125
26459,王長鼎,1,597044,0.00016199,96.71767324
26460,王信良,1,597045,0.00016199,96.71783524
26461,王奕凱,1,597046,0.00016199,96.71799723
26462,王姿文,1,597047,0.00016199,96.71815923
26463,王建宇,1,597048,0.00016199,96.71832122
26464,王政一,1,597049,0.00016199,96.71848322
26465,王炳輝,1,597050,0.00016199,96.71864521
26466,王美恩,1,597051,0.00016199,96.71880720
26467,王海浩,1,597052,0.00016199,96.71896920
26468,王郡,1,597053,0.00016199,96.71913119
26469,王國琦,1,597054,0.00016199,96.71929319
26470,王國榮,1,597055,0.00016199,96.71945518
26471,王清波,1,597056,0.00016199,96.71961718
26472,王清峰,1,597057,0.00016199,96.71977917
26473,王莽,1,597058,0.00016199,96.71994116
26474,王博如,1,597059,0.00016199,96.72010316
26475,王惠民,1,597060,0.00016199,96.72026515
26476,王渝文,1,597061,0.00016199,96.72042715
26477,王菲,1,597062,0.00016199,96.72058914
26478,王雅芬,1,597063,0.00016199,96.72075113
26479,王傳聰,1,597064,0.00016199,96.72091313
26480,王毓綱,1,597065,0.00016199,96.72107512
26481,王詩婷,1,597066,0.00016199,96.72123712
26482,王道揚,1,597067,0.00016199,96.72139911
26483,王嘉陵,1,597068,0.00016199,96.72156111
26484,王嘉廉,1,597069,0.00016199,96.72172310
26485,王碧珠,1,597070,0.00016199,96.72188509
26486,王慶華,1,597071,0.00016199,96.72204709
26487,王學呈,1,597072,0.00016199,96.72220908
26488,王曉民,1,597073,0.00016199,96.72237108
26489,王豫元,1,597074,0.00016199,96.72253307
26490,王鋼,1,597075,0.00016199,96.72269507
26491,王鍵元,1,597076,0.00016199,96.72285706
26492,王鴻薇,1,597077,0.00016199,96.72301905
26493,王韻,1,597078,0.00016199,96.72318105
26494,王麗珠,1,597079,0.00016199,96.72334304
26495,王麗荸,1,597080,0.00016199,96.72350504
26496,王馨逸,1,597081,0.00016199,96.72366703
26497,王權,1,597082,0.00016199,96.72382902
26498,丙子年,1,597083,0.00016199,96.72399102
26499,丙建土地,1,597084,0.00016199,96.72415301
26500,丙種,1,597085,0.00016199,96.72431501
26501,世上,1,597086,0.00016199,96.72447700
26502,世仇,1,597087,0.00016199,96.72463900
26503,世世代代,1,597088,0.00016199,96.72480099
26504,世外莊,1,597089,0.00016199,96.72496298
26505,世俗化,1,597090,0.00016199,96.72512498
26506,世界一級方程式,1,597091,0.00016199,96.72528697
26507,世界大同,1,597092,0.00016199,96.72544897
26508,世界大戰,1,597093,0.00016199,96.72561096
26509,世界之冠,1,597094,0.00016199,96.72577296
26510,世界地理雜誌,1,597095,0.00016199,96.72593495
26511,世界足球大賽,1,597096,0.00016199,96.72609694
26512,世界青年杯,1,597097,0.00016199,96.72625894
26513,世界盃,1,597098,0.00016199,96.72642093
26514,世界級,1,597099,0.00016199,96.72658293
26515,世界報,1,597100,0.00016199,96.72674492
26516,世界新聞傳播學院,1,597101,0.00016199,96.72690691
26517,世界銀行,1,597102,0.00016199,96.72706891
26518,世紀武術賽,1,597103,0.00016199,96.72723090
26519,世風,1,597104,0.00016199,96.72739290
26520,世展博覽公司,1,597105,0.00016199,96.72755489
26521,世華商銀,1,597106,0.00016199,96.72771689
26522,世貿,1,597107,0.00016199,96.72787888
26523,世貿二館,1,597108,0.00016199,96.72804087
26524,世間人,1,597109,0.00016199,96.72820287
26525,世新會館,1,597110,0.00016199,96.72836486
26526,世態炎涼,1,597111,0.00016199,96.72852686
26527,世襲,1,597112,0.00016199,96.72868885
26528,且是,1,597113,0.00016199,96.72885085
26529,丘,1,597114,0.00016199,96.72901284
26530,丘比河,1,597115,0.00016199,96.72917483
26531,丘比國家公園,1,597116,0.00016199,96.72933683
26532,丘如華,1,597117,0.00016199,96.72949882
26533,主人公,1,597118,0.00016199,96.72966082
26534,主子,1,597119,0.00016199,96.72982281
26535,主打歌,1,597120,0.00016199,96.72998480
26536,主任檢察官,1,597121,0.00016199,96.73014680
26537,主曲,1,597122,0.00016199,96.73030879
26538,主臥室,1,597123,0.00016199,96.73047079
26539,主客,1,597124,0.00016199,96.73063278
26540,主客制,1,597125,0.00016199,96.73079478
26541,主流派,1,597126,0.00016199,96.73095677
26542,主計官員,1,597127,0.00016199,96.73111876
26543,主計室,1,597128,0.00016199,96.73128076
26544,主頁,1,597129,0.00016199,96.73144275
26545,主宰者,1,597130,0.00016199,96.73160475
26546,主峰,1,597131,0.00016199,96.73176674
26547,主副食,1,597132,0.00016199,96.73192874
26548,主動式液晶顯示器,1,597133,0.00016199,96.73209073
26549,主動脈,1,597134,0.00016199,96.73225272
26550,主動權,1,597135,0.00016199,96.73241472
26551,主將,1,597136,0.00016199,96.73257671
26552,主從關係,1,597137,0.00016199,96.73273871
26553,主控站,1,597138,0.00016199,96.73290070
26554,主旋律,1,597139,0.00016199,96.73306269
26555,主祭,1,597140,0.00016199,96.73322469
26556,主幹,1,597141,0.00016199,96.73338668
26557,主幹道,1,597142,0.00016199,96.73354868
26558,主管單位,1,597143,0.00016199,96.73371067
26559,主調,1,597144,0.00016199,96.73387267
26560,主導者,1,597145,0.00016199,96.73403466
26561,主機房,1,597146,0.00016199,96.73419665
26562,主謀,1,597147,0.00016199,96.73435865
26563,主辦人,1,597148,0.00016199,96.73452064
26564,主辦者,1,597149,0.00016199,96.73468264
26565,主翼,1,597150,0.00016199,96.73484463
26566,主講,1,597151,0.00016199,96.73500663
26567,主講人,1,597152,0.00016199,96.73516862
26568,主講者,1,597153,0.00016199,96.73533061
26569,主權在民,1,597154,0.00016199,96.73549261
26570,主體性,1,597155,0.00016199,96.73565460
26571,主觀式,1,597156,0.00016199,96.73581660
26572,乍見,1,597157,0.00016199,96.73597859
26573,乍看之下,1,597158,0.00016199,96.73614058
26574,乏力,1,597159,0.00016199,96.73630258
26575,乏味,1,597160,0.00016199,96.73646457
26576,乏善可陳,1,597161,0.00016199,96.73662657
26577,以大吃小,1,597162,0.00016199,96.73678856
26578,以小搏大,1,597163,0.00016199,96.73695056
26579,以牙還牙,1,597164,0.00016199,96.73711255
26580,以可塞高級教練機,1,597165,0.00016199,96.73727454
26581,以假亂真,1,597166,0.00016199,96.73743654
26582,以偏概全,1,597167,0.00016199,96.73759853
26583,以短支長,1,597168,0.00016199,96.73776053
26584,以管窺天,1,597169,0.00016199,96.73792252
26585,以暴制暴,1,597170,0.00016199,96.73808452
26586,付之一炬,1,597171,0.00016199,96.73824651
26587,付委,1,597172,0.00016199,96.73840850
26588,付諸流水,1,597173,0.00016199,96.73857050
26589,仕女,1,597174,0.00016199,96.73873249
26590,他快,1,597175,0.00016199,96.73889449
26591,他鄉,1,597176,0.00016199,96.73905648
26592,他媽的,1,597177,0.00016199,96.73921848
26593,代一,1,597178,0.00016199,96.73938047
26594,代言物,1,597179,0.00016199,96.73954246
26595,代表處,1,597180,0.00016199,96.73970446
26596,代班,1,597181,0.00016199,96.73986645
26597,代理局長,1,597182,0.00016199,96.74002845
26598,代勞,1,597183,0.00016199,96.74019044
26599,代報單,1,597184,0.00016199,96.74035243
26600,代溝,1,597185,0.00016199,96.74051443
26601,代罪羔羊,1,597186,0.00016199,96.74067642
26602,代數,1,597187,0.00016199,96.74083842
26603,代碼,1,597188,0.00016199,96.74100041
26604,代課,1,597189,0.00016199,96.74116241
26605,代銷,1,597190,0.00016199,96.74132440
26606,代養,1,597191,0.00016199,96.74148639
26607,令人窒息,1,597192,0.00016199,96.74164839
26608,令斬牌,1,597193,0.00016199,96.74181038
26609,仙,1,597194,0.00016199,96.74197238
26610,仙貝,1,597195,0.00016199,96.74213437
26611,仙風道骨,1,597196,0.00016199,96.74229637
26612,仙劍奇俠氣劫紅不讓,1,597197,0.00016199,96.74245836
26613,充公,1,597198,0.00016199,96.74262035
26614,充分條件,1,597199,0.00016199,96.74278235
26615,充血期,1,597200,0.00016199,96.74294434
26616,充其量,1,597201,0.00016199,96.74310634
26617,充員戰士,1,597202,0.00016199,96.74326833
26618,充塞,1,597203,0.00016199,96.74343032
26619,充實感,1,597204,0.00016199,96.74359232
26620,充數,1,597205,0.00016199,96.74375431
26621,兄弟影視,1,597206,0.00016199,96.74391631
26622,兄弟鬩牆,1,597207,0.00016199,96.74407830
26623,兄姊,1,597208,0.00016199,96.74424030
26624,冊子,1,597209,0.00016199,96.74440229
26625,冬日,1,597210,0.00016199,96.74456428
26626,冬瓜,1,597211,0.00016199,96.74472628
26627,冬季大三角形,1,597212,0.00016199,96.74488827
26628,冬季奧運會,1,597213,0.00016199,96.74505027
26629,冬季號,1,597214,0.00016199,96.74521226
26630,冬風,1,597215,0.00016199,96.74537426
26631,冬眠,1,597216,0.00016199,96.74553625
26632,冬雪,1,597217,0.00016199,96.74569824
26633,冬暖夏涼,1,597218,0.00016199,96.74586024
26634,冬蔔,1,597219,0.00016199,96.74602223
26635,冬蟲夏草,1,597220,0.00016199,96.74618423
26636,凹子,1,597221,0.00016199,96.74634622
26637,凹扁,1,597222,0.00016199,96.74650821
26638,凹洞,1,597223,0.00016199,96.74667021
26639,凹痕,1,597224,0.00016199,96.74683220
26640,凹槽,1,597225,0.00016199,96.74699420
26641,出人意表,1,597226,0.00016199,96.74715619
26642,出人意料,1,597227,0.00016199,96.74731819
26643,出入鏡,1,597228,0.00016199,96.74748018
26644,出口退稅率,1,597229,0.00016199,96.74764217
26645,出口國,1,597230,0.00016199,96.74780417
26646,出口處,1,597231,0.00016199,96.74796616
26647,出水口,1,597232,0.00016199,96.74812816
26648,出水量,1,597233,0.00016199,96.74829015
26649,出片年,1,597234,0.00016199,96.74845215
26650,出乎,1,597235,0.00016199,96.74861414
26651,出乎意外,1,597236,0.00016199,96.74877613
26652,出刊,1,597237,0.00016199,96.74893813
26653,出生率,1,597238,0.00016199,96.74910012
26654,出地,1,597239,0.00016199,96.74926212
26655,出汗,1,597240,0.00016199,96.74942411
26656,出見,1,597241,0.00016199,96.74958610
26657,出其不意,1,597242,0.00016199,96.74974810
26658,出油量,1,597243,0.00016199,96.74991009
26659,出版物,1,597244,0.00016199,96.75007209
26660,出版屋,1,597245,0.00016199,96.75023408
26661,出界,1,597246,0.00016199,96.75039608
26662,出家,1,597247,0.00016199,96.75055807
26663,出差,1,597248,0.00016199,96.75072006
26664,出席費,1,597249,0.00016199,96.75088206
26665,出席數,1,597250,0.00016199,96.75104405
26666,出師表,1,597251,0.00016199,96.75120605
26667,出庭,1,597252,0.00016199,96.75136804
26668,出料口,1,597253,0.00016199,96.75153004
26669,出氣,1,597254,0.00016199,96.75169203
26670,出浴,1,597255,0.00016199,96.75185402
26671,出神,1,597256,0.00016199,96.75201602
26672,出納,1,597257,0.00016199,96.75217801
26673,出航,1,597258,0.00016199,96.75234001
26674,出唱片,1,597259,0.00016199,96.75250200
26675,出產,1,597260,0.00016199,96.75266399
26676,出產地,1,597261,0.00016199,96.75282599
26677,出訪,1,597262,0.00016199,96.75298798
26678,出貨比,1,597263,0.00016199,96.75314998
26679,出掌,1,597264,0.00016199,96.75331197
26680,出牌,1,597265,0.00016199,96.75347397
26681,出超,1,597266,0.00016199,96.75363596
26682,出嫁,1,597267,0.00016199,96.75379795
26683,出團率,1,597268,0.00016199,96.75395995
26684,出塵,1,597269,0.00016199,96.75412194
26685,出獄,1,597270,0.00016199,96.75428394
26686,出頭天,1,597271,0.00016199,96.75444593
26687,出鏡,1,597272,0.00016199,96.75460793
26688,出關,1,597273,0.00016199,96.75476992
26689,出籠,1,597274,0.00016199,96.75493191
26690,凸兩凸,1,597275,0.00016199,96.75509391
26691,凸起物,1,597276,0.00016199,96.75525590
26692,刊出,1,597277,0.00016199,96.75541790
26693,刊印,1,597278,0.00016199,96.75557989
26694,刊頭,1,597279,0.00016199,96.75574188
26695,加力箱,1,597280,0.00016199,96.75590388
26696,加工品,1,597281,0.00016199,96.75606587
26697,加工區,1,597282,0.00016199,96.75622787
26698,加工機,1,597283,0.00016199,96.75638986
26699,加州式,1,597284,0.00016199,96.75655186
26700,加州理工學院,1,597285,0.00016199,96.75671385
26701,加州餐廳,1,597286,0.00016199,96.75687584
26702,加利科技,1,597287,0.00016199,96.75703784
26703,加完,1,597288,0.00016199,96.75719983
26704,加把勁,1,597289,0.00016199,96.75736183
26705,加里曼丹,1,597290,0.00016199,96.75752382
26706,加味啤酒,1,597291,0.00016199,96.75768582
26707,加果,1,597292,0.00016199,96.75784781
26708,加注,1,597293,0.00016199,96.75800980
26709,加油槍,1,597294,0.00016199,96.75817180
26710,加長型勞斯萊斯,1,597295,0.00016199,96.75833379
26711,加計,1,597296,0.00016199,96.75849579
26712,加值,1,597297,0.00016199,96.75865778
26713,加值稅,1,597298,0.00016199,96.75881977
26714,加拿大世界日報,1,597299,0.00016199,96.75898177
26715,加拿大駐台北貿易辦事處,1,597300,0.00016199,96.75914376
26716,加釘,1,597301,0.00016199,96.75930576
26717,加強型,1,597302,0.00016199,96.75946775
26718,加強型爽膚水,1,597303,0.00016199,96.75962975
26719,加添,1,597304,0.00016199,96.75979174
26720,加速晶片,1,597305,0.00016199,96.75995373
26721,加速感,1,597306,0.00016199,96.76011573
26722,加菜金,1,597307,0.00016199,96.76027772
26723,加開,1,597308,0.00016199,96.76043972
26724,加溫,1,597309,0.00016199,96.76060171
26725,加盟金,1,597310,0.00016199,96.76076371
26726,加祿,1,597311,0.00016199,96.76092570
26727,加飾,1,597312,0.00016199,96.76108769
26728,加滿,1,597313,0.00016199,96.76124969
26729,加維特,1,597314,0.00016199,96.76141168
26730,加德那,1,597315,0.00016199,96.76157368
26731,加德納,1,597316,0.00016199,96.76173567
26732,加壓水柱,1,597317,0.00016199,96.76189766
26733,加薪,1,597318,0.00016199,96.76205966
26734,加鎖,1,597319,0.00016199,96.76222165
26735,加藤,1,597320,0.00016199,96.76238365
26736,加權平均利率,1,597321,0.00016199,96.76254564
26737,加權股價,1,597322,0.00016199,96.76270764
26738,加權股價指數,1,597323,0.00016199,96.76286963
26739,加權得標利率,1,597324,0.00016199,96.76303162
26740,功夫龍纖維,1,597325,0.00016199,96.76319362
26741,功能型,1,597326,0.00016199,96.76335561
26742,功勳艇,1,597327,0.00016199,96.76351761
26743,功績,1,597328,0.00016199,96.76367960
26744,功虧一潰,1,597329,0.00016199,96.76384160
26745,包入,1,597330,0.00016199,96.76400359
26746,包工,1,597331,0.00016199,96.76416558
26747,包心菜,1,597332,0.00016199,96.76432758
26748,包合,1,597333,0.00016199,96.76448957
26749,包住,1,597334,0.00016199,96.76465157
26750,包利斯．郭朵諾夫,1,597335,0.00016199,96.76481356
26751,包夾,1,597336,0.00016199,96.76497556
26752,包車,1,597337,0.00016199,96.76513755
26753,包法利夫人,1,597338,0.00016199,96.76529954
26754,包容心,1,597339,0.00016199,96.76546154
26755,包容性,1,597340,0.00016199,96.76562353
26756,包庭政,1,597341,0.00016199,96.76578553
26757,包偉銘,1,597342,0.00016199,96.76594752
26758,包廂,1,597343,0.00016199,96.76610951
26759,包絡線,1,597344,0.00016199,96.76627151
26760,包敬言,1,597345,0.00016199,96.76643350
26761,包裝紙,1,597346,0.00016199,96.76659550
26762,包機,1,597347,0.00016199,96.76675749
26763,包繞,1,597348,0.00016199,96.76691949
26764,包覆,1,597349,0.00016199,96.76708148
26765,匆匆一瞥,1,597350,0.00016199,96.76724347
26766,北一女中,1,597351,0.00016199,96.76740547
26767,北屯,1,597352,0.00016199,96.76756746
26768,北屯區,1,597353,0.00016199,96.76772946
26769,北卡羅來納,1,597354,0.00016199,96.76789145
26770,北卡羅萊納,1,597355,0.00016199,96.76805345
26771,北市環保問題兩年改善計畫,1,597356,0.00016199,96.76821544
26772,北市醫療器材商業同業工會,1,597357,0.00016199,96.76837743
26773,北平東路,1,597358,0.00016199,96.76853943
26774,北伐,1,597359,0.00016199,96.76870142
26775,北西北,1,597360,0.00016199,96.76886342
26776,北宋,1,597361,0.00016199,96.76902541
26777,北投垃圾焚化廠,1,597362,0.00016199,96.76918740
26778,北投區,1,597363,0.00016199,96.76934940
26779,北谷公園棒球場,1,597364,0.00016199,96.76951139
26780,北京人民大學,1,597365,0.00016199,96.76967339
26781,北京電影學院導演系,1,597366,0.00016199,96.76983538
26782,北京機場,1,597367,0.00016199,96.76999738
26783,北宜二高交流道,1,597368,0.00016199,96.77015937
26784,北岸,1,597369,0.00016199,96.77032136
26785,北河三,1,597370,0.00016199,96.77048336
26786,北河村,1,597371,0.00016199,96.77064535
26787,北門,1,597372,0.00016199,96.77080735
26788,北非三國,1,597373,0.00016199,96.77096934
26789,北竿,1,597374,0.00016199,96.77113134
26790,北美地區,1,597375,0.00016199,96.77129333
26791,北迥鐵路,1,597376,0.00016199,96.77145532
26792,北郊,1,597377,0.00016199,96.77161732
26793,北埔,1,597378,0.00016199,96.77177931
26794,北挪威室內樂團,1,597379,0.00016199,96.77194131
26795,北高雄副都心計劃,1,597380,0.00016199,96.77210330
26796,北高線,1,597381,0.00016199,96.77226529
26797,北國,1,597382,0.00016199,96.77242729
26798,北勢,1,597383,0.00016199,96.77258928
26799,北新里,1,597384,0.00016199,96.77275128
26800,北極熊,1,597385,0.00016199,96.77291327
26801,北境,1,597386,0.00016199,96.77307527
26802,北管樂隊,1,597387,0.00016199,96.77323726
26803,北機組,1,597388,0.00016199,96.77339925
26804,北濱公路,1,597389,0.00016199,96.77356125
26805,北韓隊,1,597390,0.00016199,96.77372324
26806,北醫附設醫院,1,597391,0.00016199,96.77388524
26807,半山區,1,597392,0.00016199,96.77404723
26808,半反射層,1,597393,0.00016199,96.77420923
26809,半天然,1,597394,0.00016199,96.77437122
26810,半日遊,1,597395,0.00016199,96.77453321
26811,半月,1,597396,0.00016199,96.77469521
26812,半月形,1,597397,0.00016199,96.77485720
26813,半世紀,1,597398,0.00016199,96.77501920
26814,半仙,1,597399,0.00016199,96.77518119
26815,半正弦,1,597400,0.00016199,96.77534318
26816,半官方,1,597401,0.00016199,96.77550518
26817,半空,1,597402,0.00016199,96.77566717
26818,半信半疑,1,597403,0.00016199,96.77582917
26819,半個月,1,597404,0.00016199,96.77599116
26820,半島酒店,1,597405,0.00016199,96.77615316
26821,半徑,1,597406,0.00016199,96.77631515
26822,半球型,1,597407,0.00016199,96.77647714
26823,半球型整風罩,1,597408,0.00016199,96.77663914
26824,半終身,1,597409,0.00016199,96.77680113
26825,半透明,1,597410,0.00016199,96.77696313
26826,半圓形,1,597411,0.00016199,96.77712512
26827,半遊牧民族,1,597412,0.00016199,96.77728712
26828,半截,1,597413,0.00016199,96.77744911
26829,半裸,1,597414,0.00016199,96.77761110
26830,半調理食品,1,597415,0.00016199,96.77777310
26831,半躺,1,597416,0.00016199,96.77793509
26832,半輩子,1,597417,0.00016199,96.77809709
26833,半導體產業,1,597418,0.00016199,96.77825908
26834,半隱居,1,597419,0.00016199,96.77842107
26835,卡士柏,1,597420,0.00016199,96.77858307
26836,卡丹尼柯夫,1,597421,0.00016199,96.77874506
26837,卡化,1,597422,0.00016199,96.77890706
26838,卡友,1,597423,0.00016199,96.77906905
26839,卡司,1,597424,0.00016199,96.77923105
26840,卡布奇諾咖啡,1,597425,0.00016199,96.77939304
26841,卡地根,1,597426,0.00016199,96.77955503
26842,卡式,1,597427,0.00016199,96.77971703
26843,卡西達,1,597428,0.00016199,96.77987902
26844,卡位戰,1,597429,0.00016199,96.78004102
26845,卡利諾,1,597430,0.00016199,96.78020301
26846,卡拉揚,1,597431,0.00016199,96.78036501
26847,卡拉維拉斯斷層,1,597432,0.00016199,96.78052700
26848,卡洛波娃,1,597433,0.00016199,96.78068899
26849,卡恩,1,597434,0.00016199,96.78085099
26850,卡桑德拉,1,597435,0.00016199,96.78101298
26851,卡納邦爵士,1,597436,0.00016199,96.78117498
26852,卡甜,1,597437,0.00016199,96.78133697
26853,卡通化,1,597438,0.00016199,96.78149896
26854,卡通城,1,597439,0.00016199,96.78166096
26855,卡通畫,1,597440,0.00016199,96.78182295
26856,卡通電影,1,597441,0.00016199,96.78198495
26857,卡通影片,1,597442,0.00016199,96.78214694
26858,卡普蘭,1,597443,0.00016199,96.78230894
26859,卡萊,1,597444,0.00016199,96.78247093
26860,卡塔尼亞,1,597445,0.00016199,96.78263292
26861,卡楚夏型火箭,1,597446,0.00016199,96.78279492
26862,卡路里,1,597447,0.00016199,96.78295691
26863,卡圖納耶克,1,597448,0.00016199,96.78311891
26864,卡爾德隆,1,597449,0.00016199,96.78328090
26865,卡鍵,1,597450,0.00016199,96.78344290
26866,卡羅納州,1,597451,0.00016199,96.78360489
26867,占用,1,597452,0.00016199,96.78376688
26868,占星術,1,597453,0.00016199,96.78392888
26869,卯上,1,597454,0.00016199,96.78409087
26870,卯足,1,597455,0.00016199,96.78425287
26871,去向,1,597456,0.00016199,96.78441486
26872,去年在馬倫巴,1,597457,0.00016199,96.78457685
26873,去函,1,597458,0.00016199,96.78473885
26874,去夏,1,597459,0.00016199,96.78490084
26875,去脂油,1,597460,0.00016199,96.78506284
26876,去氫酵素,1,597461,0.00016199,96.78522483
26877,去逝,1,597462,0.00016199,96.78538683
26878,去腥,1,597463,0.00016199,96.78554882
26879,去膠,1,597464,0.00016199,96.78571081
26880,去職,1,597465,0.00016199,96.78587281
26881,可可,1,597466,0.00016199,96.78603480
26882,可可豆,1,597467,0.00016199,96.78619680
26883,可由,1,597468,0.00016199,96.78635879
26884,可回收物,1,597469,0.00016199,96.78652079
26885,可供,1,597470,0.00016199,96.78668278
26886,可抽取式硬碟,1,597471,0.00016199,96.78684477
26887,可知,1,597472,0.00016199,96.78700677
26888,可建地,1,597473,0.00016199,96.78716876
26889,可恨,1,597474,0.00016199,96.78733076
26890,可洛那,1,597475,0.00016199,96.78749275
26891,可看,1,597476,0.00016199,96.78765474
26892,可看性,1,597477,0.00016199,96.78781674
26893,可要,1,597478,0.00016199,96.78797873
26894,可乘,1,597479,0.00016199,96.78814073
26895,可耕土地,1,597480,0.00016199,96.78830272
26896,可能是,1,597481,0.00016199,96.78846472
26897,可教導式自動澆鑄機系統,1,597482,0.00016199,96.78862671
26898,可循,1,597483,0.00016199,96.78878870
26899,可想,1,597484,0.00016199,96.78895070
26900,可管,1,597485,0.00016199,96.78911269
26901,可說是,1,597486,0.00016199,96.78927469
26902,可樂那,1,597487,0.00016199,96.78943668
26903,可樂娜,1,597488,0.00016199,96.78959868
26904,可樂娜啤酒,1,597489,0.00016199,96.78976067
26905,可編程邏輯晶片,1,597490,0.00016199,96.78992266
26906,可謂是,1,597491,0.00016199,96.79008466
26907,可擦式無線壓感數位板,1,597492,0.00016199,96.79024665
26908,可轉讓定存單到期,1,597493,0.00016199,96.79040865
26909,可證,1,597494,0.00016199,96.79057064
26910,可議,1,597495,0.00016199,96.79073263
26911,可攜式電腦,1,597496,0.00016199,96.79089463
26912,可攜式磁碟機,1,597497,0.00016199,96.79105662
26913,可灌溉水源,1,597498,0.00016199,96.79121862
26914,可讀性,1,597499,0.00016199,96.79138061
26915,可變性,1,597500,0.00016199,96.79154261
26916,可變螺距車葉,1,597501,0.00016199,96.79170460
26917,古巴,1,597502,0.00016199,96.79186659
26918,古文字家,1,597503,0.00016199,96.79202859
26919,古文物,1,597504,0.00016199,96.79219058
26920,古生物,1,597505,0.00016199,96.79235258
26921,古早,1,597506,0.00016199,96.79251457
26922,古早人,1,597507,0.00016199,96.79267657
26923,古伯斯,1,597508,0.00016199,96.79283856
26924,古兵器,1,597509,0.00016199,96.79300055
26925,古典式,1,597510,0.00016199,96.79316255
26926,古典派,1,597511,0.00016199,96.79332454
26927,古典美,1,597512,0.00016199,96.79348654
26928,古典音樂,1,597513,0.00016199,96.79364853
26929,古奇,1,597514,0.00016199,96.79381053
26930,古板,1,597515,0.00016199,96.79397252
26931,古玩,1,597516,0.00016199,96.79413451
26932,古亭國小,1,597517,0.00016199,96.79429651
26933,古城,1,597518,0.00016199,96.79445850
26934,古倫特,1,597519,0.00016199,96.79462050
26935,古厝,1,597520,0.00016199,96.79478249
26936,古書,1,597521,0.00016199,96.79494448
26937,古梅．林巴,1,597522,0.00016199,96.79510648
26938,古都,1,597523,0.00016199,96.79526847
26939,古勝吉,1,597524,0.00016199,96.79543047
26940,古惑仔,1,597525,0.00016199,96.79559246
26941,古意,1,597526,0.00016199,96.79575446
26942,古董店,1,597527,0.00016199,96.79591645
26943,古董櫃,1,597528,0.00016199,96.79607844
26944,古裝,1,597529,0.00016199,96.79624044
26945,古裝武俠漫畫,1,597530,0.00016199,96.79640243
26946,古裝武俠劇,1,597531,0.00016199,96.79656443
26947,古樂,1,597532,0.00016199,96.79672642
26948,古諺,1,597533,0.00016199,96.79688842
26949,古諾,1,597534,0.00016199,96.79705041
26950,古禮,1,597535,0.00016199,96.79721240
26951,古蹟區,1,597536,0.00016199,96.79737440
26952,古靈精怪,1,597537,0.00016199,96.79753639
26953,右下角,1,597538,0.00016199,96.79769839
26954,右上角,1,597539,0.00016199,96.79786038
26955,右方,1,597540,0.00016199,96.79802237
26956,右外野,1,597541,0.00016199,96.79818437
26957,右外野手,1,597542,0.00016199,96.79834636
26958,右派,1,597543,0.00016199,96.79850836
26959,右腳,1,597544,0.00016199,96.79867035
26960,右圖,1,597545,0.00016199,96.79883235
26961,右駕,1,597546,0.00016199,96.79899434
26962,右鍵,1,597547,0.00016199,96.79915633
26963,召入,1,597548,0.00016199,96.79931833
26964,召見,1,597549,0.00016199,96.79948032
26965,叮叮,1,597550,0.00016199,96.79964232
26966,叮叮噹噹,1,597551,0.00016199,96.79980431
26967,叮噹,1,597552,0.00016199,96.79996631
26968,叩門聲,1,597553,0.00016199,96.80012830
26969,叩醒,1,597554,0.00016199,96.80029029
26970,叩應,1,597555,0.00016199,96.80045229
26971,叨,1,597556,0.00016199,96.80061428
26972,叨絮,1,597557,0.00016199,96.80077628
26973,司令部,1,597558,0.00016199,96.80093827
26974,司法史,1,597559,0.00016199,96.80110026
26975,司法委員會,1,597560,0.00016199,96.80126226
26976,司法警察,1,597561,0.00016199,96.80142425
26977,司空見慣,1,597562,0.00016199,96.80158625
26978,司徒加,1,597563,0.00016199,96.80174824
26979,司徒衛,1,597564,0.00016199,96.80191024
26980,司馬昭,1,597565,0.00016199,96.80207223
26981,司掌,1,597566,0.00016199,96.80223422
26982,司儀,1,597567,0.00016199,96.80239622
26983,叫不靈,1,597568,0.00016199,96.80255821
26984,叫化雞,1,597569,0.00016199,96.80272021
26985,叫出,1,597570,0.00016199,96.80288220
26986,叫好,1,597571,0.00016199,96.80304420
26987,叫作,1,597572,0.00016199,96.80320619
26988,叫床,1,597573,0.00016199,96.80336818
26989,叫座,1,597574,0.00016199,96.80353018
26990,叫做,1,597575,0.00016199,96.80369217
26991,叫價,1,597576,0.00016199,96.80385417
26992,叫窮,1,597577,0.00016199,96.80401616
26993,叫聲,1,597578,0.00016199,96.80417815
26994,另定,1,597579,0.00016199,96.80434015
26995,另眼相看,1,597580,0.00016199,96.80450214
26996,另眼看待,1,597581,0.00016199,96.80466414
26997,另類空間,1,597582,0.00016199,96.80482613
26998,只不過,1,597583,0.00016199,96.80498813
26999,只見,1,597584,0.00016199,96.80515012
27000,只怕,1,597585,0.00016199,96.80531211
27001,只要我長大,1,597586,0.00016199,96.80547411
27002,只得,1,597587,0.00016199,96.80563610
27003,只須,1,597588,0.00016199,96.80579810
27004,只想,1,597589,0.00016199,96.80596009
27005,只管,1,597590,0.00016199,96.80612209
27006,只賺不賠,1,597591,0.00016199,96.80628408
27007,只顧,1,597592,0.00016199,96.80644607
27008,史上,1,597593,0.00016199,96.80660807
27009,史丹佛大學,1,597594,0.00016199,96.80677006
27010,史丹佛花園飯店,1,597595,0.00016199,96.80693206
27011,史丹利郝運,1,597596,0.00016199,96.80709405
27012,史卡拉,1,597597,0.00016199,96.80725604
27013,史卡拉歌劇院,1,597598,0.00016199,96.80741804
27014,史考特,1,597599,0.00016199,96.80758003
27015,史坦尼,1,597600,0.00016199,96.80774203
27016,史坦普,1,597601,0.00016199,96.80790402
27017,史波舟,1,597602,0.00016199,96.80806602
27018,史波克,1,597603,0.00016199,96.80822801
27019,史金納,1,597604,0.00016199,96.80839000
27020,史前學家,1,597605,0.00016199,96.80855200
27021,史威特,1,597606,0.00016199,96.80871399
27022,史帝文佛瑞爾,1,597607,0.00016199,96.80887599
27023,史帝芬．貝斯特,1,597608,0.00016199,96.80903798
27024,史特拉狄瓦利,1,597609,0.00016199,96.80919998
27025,史特拉斯堡,1,597610,0.00016199,96.80936197
27026,史特勞斯曼術式,1,597611,0.00016199,96.80952396
27027,史記,1,597612,0.00016199,96.80968596
27028,史都華．達賽爾,1,597613,0.00016199,96.80984795
27029,史傳,1,597614,0.00016199,96.81000995
27030,史塔佛,1,597615,0.00016199,96.81017194
27031,史塔克頓,1,597616,0.00016199,96.81033393
27032,史蒂文貝傑曼,1,597617,0.00016199,96.81049593
27033,史蒂文索德貝格,1,597618,0.00016199,96.81065792
27034,史蒂文鮑爾,1,597619,0.00016199,96.81081992
27035,史蒂芬,1,597620,0.00016199,96.81098191
27036,史蒂芬柯林斯,1,597621,0.00016199,96.81114391
27037,史詩,1,597622,0.00016199,96.81130590
27038,史達林主義,1,597623,0.00016199,96.81146789
27039,史榮恩,1,597624,0.00016199,96.81162989
27040,史學家,1,597625,0.00016199,96.81179188
27041,史戴西凱奇,1,597626,0.00016199,96.81195388
27042,史蹟,1,597627,0.00016199,96.81211587
27043,史鑑,1,597628,0.00016199,96.81227787
27044,史搢成,1,597629,0.00016199,96.81243986
27045,史搢臣,1,597630,0.00016199,96.81260185
27046,叱吒,1,597631,0.00016199,96.81276385
27047,叱吒一時,1,597632,0.00016199,96.81292584
27048,台十一線,1,597633,0.00016199,96.81308784
27049,台上,1,597634,0.00016199,96.81324983
27050,台大人,1,597635,0.00016199,96.81341182
27051,台中工業區,1,597636,0.00016199,96.81357382
27052,台中中友百貨,1,597637,0.00016199,96.81373581
27053,台中世貿,1,597638,0.00016199,96.81389781
27054,台中市區,1,597639,0.00016199,96.81405980
27055,台中交流道,1,597640,0.00016199,96.81422180
27056,台中港路,1,597641,0.00016199,96.81438379
27057,台中監獄,1,597642,0.00016199,96.81454578
27058,台中廣三,1,597643,0.00016199,96.81470778
27059,台中醫院,1,597644,0.00016199,96.81486977
27060,台中攝影藝廊,1,597645,0.00016199,96.81503177
27061,台五線,1,597646,0.00016199,96.81519376
27062,台火工學新世界,1,597647,0.00016199,96.81535576
27063,台北大學,1,597648,0.00016199,96.81551775
27064,台北之音,1,597649,0.00016199,96.81567974
27065,台北木柵線,1,597650,0.00016199,96.81584174
27066,台北世貿中心,1,597651,0.00016199,96.81600373
27067,台北市土地使用分區管制規則,1,597652,0.00016199,96.81616573
27068,台北市立國樂團,1,597653,0.00016199,96.81632772
27069,台北市社教館,1,597654,0.00016199,96.81648971
27070,台北市美術館長,1,597655,0.00016199,96.81665171
27071,台北市神壇輔導要點草案,1,597656,0.00016199,96.81681370
27072,台北市舞廳舞場酒家酒吧及特種咖啡茶室管理規則,1,597657,0.00016199,96.81697570
27073,台北市調處,1,597658,0.00016199,96.81713769
27074,台北市籍,1,597659,0.00016199,96.81729969
27075,台北企銀,1,597660,0.00016199,96.81746168
27076,台北地院,1,597661,0.00016199,96.81762367
27077,台北後院畫廊,1,597662,0.00016199,96.81778567
27078,台北盆地,1,597663,0.00016199,96.81794766
27079,台北看守所,1,597664,0.00016199,96.81810966
27080,台北家具展,1,597665,0.00016199,96.81827165
27081,台北國際打擊樂節,1,597666,0.00016199,96.81843365
27082,台北國際家具展,1,597667,0.00016199,96.81859564
27083,台北新公園,1,597668,0.00016199,96.81875763
27084,台北榮總,1,597669,0.00016199,96.81891963
27085,台北縣市,1,597670,0.00016199,96.81908162
27086,台北縣長,1,597671,0.00016199,96.81924362
27087,台北攝影藝廊,1,597672,0.00016199,96.81940561
27088,台北護專,1,597673,0.00016199,96.81956760
27089,台企,1,597674,0.00016199,96.81972960
27090,台合公司,1,597675,0.00016199,96.81989159
27091,台安醫院,1,597676,0.00016199,96.82005359
27092,台汽客運,1,597677,0.00016199,96.82021558
27093,台育證券公司,1,597678,0.00016199,96.82037758
27094,台拉維夫人,1,597679,0.00016199,96.82053957
27095,台東新站,1,597680,0.00016199,96.82070156
27096,台泥公司,1,597681,0.00016199,96.82086356
27097,台南市長,1,597682,0.00016199,96.82102555
27098,台南企銀,1,597683,0.00016199,96.82118755
27099,台南科技,1,597684,0.00016199,96.82134954
27100,台南科技工業區,1,597685,0.00016199,96.82151154
27101,台南科技工業園區,1,597686,0.00016199,96.82167353
27102,台南鹽場,1,597687,0.00016199,96.82183552
27103,台柱,1,597688,0.00016199,96.82199752
27104,台省,1,597689,0.00016199,96.82215951
27105,台風,1,597690,0.00016199,96.82232151
27106,台泰關係委員會,1,597691,0.00016199,96.82248350
27107,台視文化公司,1,597692,0.00016199,96.82264550
27108,台開公司,1,597693,0.00016199,96.82280749
27109,台階式,1,597694,0.00016199,96.82296948
27110,台陽美協,1,597695,0.00016199,96.82313148
27111,台塑六輕,1,597696,0.00016199,96.82329347
27112,台塑六輕麥寮工業區,1,597697,0.00016199,96.82345547
27113,台塑公司,1,597698,0.00016199,96.82361746
27114,台新銀行,1,597699,0.00016199,96.82377945
27115,台經院,1,597700,0.00016199,96.82394145
27116,台達電,1,597701,0.00016199,96.82410344
27117,台鈴,1,597702,0.00016199,96.82426544
27118,台電大樓,1,597703,0.00016199,96.82442743
27119,台綜院,1,597704,0.00016199,96.82458943
27120,台閩,1,597705,0.00016199,96.82475142
27121,台閩地區,1,597706,0.00016199,96.82491341
27122,台熱公司,1,597707,0.00016199,96.82507541
27123,台鋁,1,597708,0.00016199,96.82523740
27124,台橡膠,1,597709,0.00016199,96.82539940
27125,台機,1,597710,0.00016199,96.82556139
27126,台澳,1,597711,0.00016199,96.82572339
27127,台積一廠,1,597712,0.00016199,96.82588538
27128,台糖農場,1,597713,0.00016199,96.82604737
27129,台聯,1,597714,0.00016199,96.82620937
27130,台證投顧,1,597715,0.00016199,96.82637136
27131,台籍,1,597716,0.00016199,96.82653336
27132,台鹽生產處,1,597717,0.00016199,96.82669535
27133,台灣史,1,597718,0.00016199,96.82685734
27134,台灣史詩劇,1,597719,0.00016199,96.82701934
27135,台灣本島,1,597720,0.00016199,96.82718133
27136,台灣企銀,1,597721,0.00016199,96.82734333
27137,台灣光復節,1,597722,0.00016199,96.82750532
27138,台灣克萊斯勒,1,597723,0.00016199,96.82766732
27139,台灣克萊斯勒公司,1,597724,0.00016199,96.82782931
27140,台灣克萊斯勒汽車,1,597725,0.00016199,96.82799130
27141,台灣杉,1,597726,0.00016199,96.82815330
27142,台灣兒童救濟,1,597727,0.00016199,96.82831529
27143,台灣和高電器,1,597728,0.00016199,96.82847729
27144,台灣矽谷,1,597729,0.00016199,96.82863928
27145,台灣股票,1,597730,0.00016199,96.82880128
27146,台灣青少年全方位關懷中心,1,597731,0.00016199,96.82896327
27147,台灣柯達公司,1,597732,0.00016199,96.82912526
27148,台灣省交通處,1,597733,0.00016199,96.82928726
27149,台灣省府,1,597734,0.00016199,96.82944925
27150,台灣省菸酒公賣局,1,597735,0.00016199,96.82961125
27151,台灣研究所,1,597736,0.00016199,96.82977324
27152,台灣研究會,1,597737,0.00016199,96.82993523
27153,台灣美術的運動史,1,597738,0.00016199,96.83009723
27154,台灣時報,1,597739,0.00016199,96.83025922
27155,台灣海岸保護協會,1,597740,0.00016199,96.83042122
27156,台灣海域,1,597741,0.00016199,96.83058321
27157,台灣區家具工業同業公會,1,597742,0.00016199,96.83074521
27158,台灣區營造公會,1,597743,0.00016199,96.83090720
27159,台灣通史,1,597744,0.00016199,96.83106919
27160,台灣畫眉,1,597745,0.00016199,96.83123119
27161,台灣菜,1,597746,0.00016199,96.83139318
27162,台灣進行曲,1,597747,0.00016199,96.83155518
27163,台灣當代藝術節,1,597748,0.00016199,96.83171717
27164,台灣綜合行銷中心,1,597749,0.00016199,96.83187917
27165,台灣銀行,1,597750,0.00016199,96.83204116
27166,台灣劇場,1,597751,0.00016199,96.83220315
27167,台灣廣告,1,597752,0.00016199,96.83236515
27168,台灣廣告公司,1,597753,0.00016199,96.83252714
27169,台灣廠,1,597754,0.00016199,96.83268914
27170,台灣駐菲律賓經濟文化辦事處,1,597755,0.00016199,96.83285113
27171,台灣積體電路公司,1,597756,0.00016199,96.83301312
27172,台灣鐵路管理局,1,597757,0.00016199,96.83317512
27173,台灣觀光,1,597758,0.00016199,96.83333711
27174,句句,1,597759,0.00016199,96.83349911
27175,句號,1,597760,0.00016199,96.83366110
27176,句話,1,597761,0.00016199,96.83382310
27177,句點,1,597762,0.00016199,96.83398509
27178,叻,1,597763,0.00016199,96.83414708
27179,四人幫,1,597764,0.00016199,96.83430908
27180,四中全會,1,597765,0.00016199,96.83447107
27181,四天,1,597766,0.00016199,96.83463307
27182,四四方方,1,597767,0.00016199,96.83479506
27183,四平派出所,1,597768,0.00016199,96.83495706
27184,四立,1,597769,0.00016199,96.83511905
27185,四伏,1,597770,0.00016199,96.83528104
27186,四死球,1,597771,0.00016199,96.83544304
27187,四色機,1,597772,0.00016199,96.83560503
27188,四角形,1,597773,0.00016199,96.83576703
27189,四兩撥千斤,1,597774,0.00016199,96.83592902
27190,四季小提琴協奏曲,1,597775,0.00016199,96.83609101
27191,四季豆,1,597776,0.00016199,96.83625301
27192,四季果,1,597777,0.00016199,96.83641500
27193,四季神,1,597778,0.00016199,96.83657700
27194,四季飯店,1,597779,0.00016199,96.83673899
27195,四門,1,597780,0.00016199,96.83690099
27196,四星上將,1,597781,0.00016199,96.83706298
27197,四書,1,597782,0.00016199,96.83722497
27198,四海,1,597783,0.00016199,96.83738697
27199,四海幫,1,597784,0.00016199,96.83754896
27200,四逆人參湯,1,597785,0.00016199,96.83771096
27201,四望,1,597786,0.00016199,96.83787295
27202,四通八達,1,597787,0.00016199,96.83803495
27203,四湖工業區,1,597788,0.00016199,96.83819694
27204,四溢,1,597789,0.00016199,96.83835893
27205,四輪傳動車,1,597790,0.00016199,96.83852093
27206,四獸山,1,597791,0.00016199,96.83868292
27207,四顧,1,597792,0.00016199,96.83884492
27208,囚禁,1,597793,0.00016199,96.83900691
27209,外八,1,597794,0.00016199,96.83916890
27210,外子,1,597795,0.00016199,96.83933090
27211,外分解,1,597796,0.00016199,96.83949289
27212,外包裝,1,597797,0.00016199,96.83965489
27213,外交人員,1,597798,0.00016199,96.83981688
27214,外交豁免權,1,597799,0.00016199,96.83997888
27215,外同位碼,1,597800,0.00016199,96.84014087
27216,外弛內張,1,597801,0.00016199,96.84030286
27217,外行仔,1,597802,0.00016199,96.84046486
27218,外邦,1,597803,0.00016199,96.84062685
27219,外事辦,1,597804,0.00016199,96.84078885
27220,外事辦公室,1,597805,0.00016199,96.84095084
27221,外來者,1,597806,0.00016199,96.84111284
27222,外星追緝令,1,597807,0.00016199,96.84127483
27223,外流道,1,597808,0.00016199,96.84143682
27224,外洩,1,597809,0.00016199,96.84159882
27225,外省仔,1,597810,0.00016199,96.84176081
27226,外相,1,597811,0.00016199,96.84192281
27227,外科部,1,597812,0.00016199,96.84208480
27228,外徑,1,597813,0.00016199,96.84224679
27229,外框,1,597814,0.00016199,96.84240879
27230,外祖母,1,597815,0.00016199,96.84257078
27231,外國客人,1,597816,0.00016199,96.84273278
27232,外帶,1,597817,0.00016199,96.84289477
27233,外掛程式,1,597818,0.00016199,96.84305677
27234,外部應用程式,1,597819,0.00016199,96.84321876
27235,外陰部,1,597820,0.00016199,96.84338075
27236,外勞特區,1,597821,0.00016199,96.84354275
27237,外景,1,597822,0.00016199,96.84370474
27238,外甥,1,597823,0.00016199,96.84386674
27239,外貿,1,597824,0.00016199,96.84402873
27240,外貿經部,1,597825,0.00016199,96.84419073
27241,外匯存底,1,597826,0.00016199,96.84435272
27242,外滑式,1,597827,0.00016199,96.84451471
27243,外號,1,597828,0.00016199,96.84467671
27244,外遇,1,597829,0.00016199,96.84483870
27245,外蒙,1,597830,0.00016199,96.84500070
27246,外蒙古,1,597831,0.00016199,96.84516269
27247,外銀,1,597832,0.00016199,96.84532468
27248,外箱,1,597833,0.00016199,96.84548668
27249,外緣,1,597834,0.00016199,96.84564867
27250,外線,1,597835,0.00016199,96.84581067
27251,外銷成衣店,1,597836,0.00016199,96.84597266
27252,外銷股,1,597837,0.00016199,96.84613466
27253,外鋪,1,597838,0.00016199,96.84629665
27254,外壓,1,597839,0.00016199,96.84645864
27255,外環道,1,597840,0.00016199,96.84662064
27256,外環道路,1,597841,0.00016199,96.84678263
27257,外環線,1,597842,0.00016199,96.84694463
27258,外籍球員,1,597843,0.00016199,96.84710662
27259,央,1,597844,0.00016199,96.84726862
27260,央債,1,597845,0.00016199,96.84743061
27261,失土,1,597846,0.00016199,96.84759260
27262,失手,1,597847,0.00016199,96.84775460
27263,失足,1,597848,0.00016199,96.84791659
27264,失修,1,597849,0.00016199,96.84807859
27265,失措,1,597850,0.00016199,96.84824058
27266,失敗率,1,597851,0.00016199,96.84840257
27267,失望性,1,597852,0.00016199,96.84856457
27268,失散,1,597853,0.00016199,96.84872656
27269,失智,1,597854,0.00016199,96.84888856
27270,失勢,1,597855,0.00016199,96.84905055
27271,失落感,1,597856,0.00016199,96.84921255
27272,失算,1,597857,0.00016199,96.84937454
27273,失魂落魄,1,597858,0.00016199,96.84953653
27274,失據,1,597859,0.00016199,96.84969853
27275,失竊,1,597860,0.00016199,96.84986052
27276,奴役,1,597861,0.00016199,96.85002252
27277,奶奶,1,597862,0.00016199,96.85018451
27278,奶油色,1,597863,0.00016199,96.85034651
27279,奶烙味,1,597864,0.00016199,96.85050850
27280,奶茶,1,597865,0.00016199,96.85067049
27281,奶瓶,1,597866,0.00016199,96.85083249
27282,奶量,1,597867,0.00016199,96.85099448
27283,奶嘴,1,597868,0.00016199,96.85115648
27284,尼文,1,597869,0.00016199,96.85131847
27285,尼氏,1,597870,0.00016199,96.85148047
27286,尼克隊,1,597871,0.00016199,96.85164246
27287,尼克錫爾,1,597872,0.00016199,96.85180445
27288,尼克羅波里斯,1,597873,0.00016199,96.85196645
27289,尼康公司,1,597874,0.00016199,96.85212844
27290,尼康相機,1,597875,0.00016199,96.85229044
27291,尼爾森,1,597876,0.00016199,96.85245243
27292,尼德蘭,1,597877,0.00016199,96.85261442
27293,尼賴吉哈佐,1,597878,0.00016199,96.85277642
27294,尼羅河大蜥,1,597879,0.00016199,96.85293841
27295,尼羅河巨蜥,1,597880,0.00016199,96.85310041
27296,尼羅河邊,1,597881,0.00016199,96.85326240
27297,尼羅河鱷魚,1,597882,0.00016199,96.85342440
27298,尼羅鱷,1,597883,0.00016199,96.85358639
27299,巨人軍,1,597884,0.00016199,96.85374838
27300,巨人族,1,597885,0.00016199,96.85391038
27301,巨匠,1,597886,0.00016199,96.85407237
27302,巨投,1,597887,0.00016199,96.85423437
27303,巨災,1,597888,0.00016199,96.85439636
27304,巨淵企業社,1,597889,0.00016199,96.85455836
27305,巨款,1,597890,0.00016199,96.85472035
27306,巨禍,1,597891,0.00016199,96.85488234
27307,巨輻,1,597892,0.00016199,96.85504434
27308,巨頭,1,597893,0.00016199,96.85520633
27309,巨環類,1,597894,0.00016199,96.85536833
27310,巧克力糖,1,597895,0.00016199,96.85553032
27311,巧計,1,597896,0.00016199,96.85569231
27312,巧詐,1,597897,0.00016199,96.85585431
27313,巧遇,1,597898,0.00016199,96.85601630
27314,左手肘,1,597899,0.00016199,96.85617830
27315,左右逢源,1,597900,0.00016199,96.85634029
27316,左拉,1,597901,0.00016199,96.85650229
27317,左後方,1,597902,0.00016199,96.85666428
27318,左後衛,1,597903,0.00016199,96.85682627
27319,左脅,1,597904,0.00016199,96.85698827
27320,左腳,1,597905,0.00016199,96.85715026
27321,左駕,1,597906,0.00016199,96.85731226
27322,左轉,1,597907,0.00016199,96.85747425
27323,市民廣場,1,597908,0.00016199,96.85763625
27324,市立凱旋醫院,1,597909,0.00016199,96.85779824
27325,市立圖書館,1,597910,0.00016199,96.85796023
27326,市立精神醫院,1,597911,0.00016199,96.85812223
27327,市長室,1,597912,0.00016199,96.85828422
27328,市政府新聞處,1,597913,0.00016199,96.85844622
27329,市政資料館,1,597914,0.00016199,96.85860821
27330,市美館,1,597915,0.00016199,96.85877020
27331,市面上,1,597916,0.00016199,96.85893220
27332,市產,1,597917,0.00016199,96.85909419
27333,市場分析,1,597918,0.00016199,96.85925619
27334,市場分析師,1,597919,0.00016199,96.85941818
27335,市場方,1,597920,0.00016199,96.85958018
27336,市場占有率,1,597921,0.00016199,96.85974217
27337,市場佔有率,1,597922,0.00016199,96.85990416
27338,市場面,1,597923,0.00016199,96.86006616
27339,市場調查,1,597924,0.00016199,96.86022815
27340,市儈,1,597925,0.00016199,96.86039015
27341,市調,1,597926,0.00016199,96.86055214
27342,市調公司,1,597927,0.00016199,96.86071414
27343,市調處,1,597928,0.00016199,96.86087613
27344,布衣,1,597929,0.00016199,96.86103812
27345,布里斯班,1,597930,0.00016199,96.86120012
27346,布侖特,1,597931,0.00016199,96.86136211
27347,布拉克,1,597932,0.00016199,96.86152411
27348,布林,1,597933,0.00016199,96.86168610
27349,布面,1,597934,0.00016199,96.86184809
27350,布烈松,1,597935,0.00016199,96.86201009
27351,布景,1,597936,0.00016199,96.86217208
27352,布萊恩．麥金利,1,597937,0.00016199,96.86233408
27353,布塔雷,1,597938,0.00016199,96.86249607
27354,布達佩斯,1,597939,0.00016199,96.86265807
27355,布爾人,1,597940,0.00016199,96.86282006
27356,布爾津客運站,1,597941,0.00016199,96.86298205
27357,布爾喬亞,1,597942,0.00016199,96.86314405
27358,布質,1,597943,0.00016199,96.86330604
27359,布鞋,1,597944,0.00016199,96.86346804
27360,布魯克斯,1,597945,0.00016199,96.86363003
27361,布魯京斯研究所,1,597946,0.00016199,96.86379203
27362,布魯斯潘,1,597947,0.00016199,96.86395402
27363,布魯圖斯,1,597948,0.00016199,96.86411601
27364,布藍斯威克廣場,1,597949,0.00016199,96.86427801
27365,布蘭德公園,1,597950,0.00016199,96.86444000
27366,布芮居斯,1,597951,0.00016199,96.86460200
27367,平心而論,1,597952,0.00016199,96.86476399
27368,平心靜氣,1,597953,0.00016199,96.86492598
27369,平手,1,597954,0.00016199,96.86508798
27370,平台掃描器,1,597955,0.00016199,96.86524997
27371,平台軟體部,1,597956,0.00016199,96.86541197
27372,平平靜靜,1,597957,0.00016199,96.86557396
27373,平生,1,597958,0.00016199,96.86573596
27374,平行處理系統,1,597959,0.00016199,96.86589795
27375,平均值,1,597960,0.00016199,96.86605994
27376,平均國內生產毛額,1,597961,0.00016199,96.86622194
27377,平均線,1,597962,0.00016199,96.86638393
27378,平定,1,597963,0.00016199,96.86654593
27379,平房,1,597964,0.00016199,96.86670792
27380,平板,1,597965,0.00016199,96.86686992
27381,平板鋼,1,597966,0.00016199,96.86703191
27382,平松守彥,1,597967,0.00016199,96.86719390
27383,平版,1,597968,0.00016199,96.86735590
27384,平流層,1,597969,0.00016199,96.86751789
27385,平面式,1,597970,0.00016199,96.86767989
27386,平面直角顯示器,1,597971,0.00016199,96.86784188
27387,平面媒體,1,597972,0.00016199,96.86800387
27388,平面圖,1,597973,0.00016199,96.86816587
27389,平面稿,1,597974,0.00016199,96.86832786
27390,平倉,1,597975,0.00016199,96.86848986
27391,平埔族,1,597976,0.00016199,96.86865185
27392,平埔噶瑪蘭族,1,597977,0.00016199,96.86881385
27393,平起平坐,1,597978,0.00016199,96.86897584
27394,平假名,1,597979,0.00016199,96.86913783
27395,平庸,1,597980,0.00016199,96.86929983
27396,平添,1,597981,0.00016199,96.86946182
27397,平陽,1,597982,0.00016199,96.86962382
27398,平滑,1,597983,0.00016199,96.86978581
27399,平溪消防小隊長,1,597984,0.00016199,96.86994781
27400,平溪鄉,1,597985,0.00016199,96.87010980
27401,平補,1,597986,0.00016199,96.87027179
27402,平路,1,597987,0.00016199,96.87043379
27403,平價化,1,597988,0.00016199,96.87059578
27404,平價位,1,597989,0.00016199,96.87075778
27405,平價車,1,597990,0.00016199,96.87091977
27406,平潭縣,1,597991,0.00016199,96.87108176
27407,平盤,1,597992,0.00016199,96.87124376
27408,平躺,1,597993,0.00016199,96.87140575
27409,平整度,1,597994,0.00016199,96.87156775
27410,平衡性,1,597995,0.00016199,96.87172974
27411,平衡桿,1,597996,0.00016199,96.87189174
27412,平衡點,1,597997,0.00016199,96.87205373
27413,幼年,1,597998,0.00016199,96.87221572
27414,幼年期,1,597999,0.00016199,96.87237772
27415,幼兒教育,1,598000,0.00016199,96.87253971
27416,幼者,1,598001,0.00016199,96.87270171
27417,幼苗,1,598002,0.00016199,96.87286370
27418,幼師,1,598003,0.00016199,96.87302570
27419,幼教,1,598004,0.00016199,96.87318769
27420,幼童軍,1,598005,0.00016199,96.87334968
27421,幼獅文藝,1,598006,0.00016199,96.87351168
27422,幼稚,1,598007,0.00016199,96.87367367
27423,幼雛,1,598008,0.00016199,96.87383567
27424,幼獸,1,598009,0.00016199,96.87399766
27425,弘一,1,598010,0.00016199,96.87415965
27426,弘前櫻花祭,1,598011,0.00016199,96.87432165
27427,弘揚,1,598012,0.00016199,96.87448364
27428,弘道,1,598013,0.00016199,96.87464564
27429,弗,1,598014,0.00016199,96.87480763
27430,弗氏海豚,1,598015,0.00016199,96.87496963
27431,弗利茲．萊納,1,598016,0.00016199,96.87513162
27432,弗里克,1,598017,0.00016199,96.87529361
27433,弗洛伊德．普洛特和李曼．史蘭,1,598018,0.00016199,96.87545561
27434,弗洛依德,1,598019,0.00016199,96.87561760
27435,弗洛依德．波克多,1,598020,0.00016199,96.87577960
27436,弗姬,1,598021,0.00016199,96.87594159
27437,弗朗斯基,1,598022,0.00016199,96.87610359
27438,弗瑞德．札洛卡,1,598023,0.00016199,96.87626558
27439,弗雷克‧詹明信,1,598024,0.00016199,96.87642757
27440,必死,1,598025,0.00016199,96.87658957
27441,必是,1,598026,0.00016199,96.87675156
27442,必要條件,1,598027,0.00016199,96.87691356
27443,必修課程,1,598028,0.00016199,96.87707555
27444,必將,1,598029,0.00016199,96.87723755
27445,必勝客,1,598030,0.00016199,96.87739954
27446,必會,1,598031,0.00016199,96.87756153
27447,必經之地,1,598032,0.00016199,96.87772353
27448,必需品,1,598033,0.00016199,96.87788552
27449,打入冷宮,1,598034,0.00016199,96.87804752
27450,打工,1,598035,0.00016199,96.87820951
27451,打中,1,598036,0.00016199,96.87837150
27452,打分數,1,598037,0.00016199,96.87853350
27453,打勾勾,1,598038,0.00016199,96.87869549
27454,打火機,1,598039,0.00016199,96.87885749
27455,打平,1,598040,0.00016199,96.87901948
27456,打打氣,1,598041,0.00016199,96.87918148
27457,打打鬧鬧,1,598042,0.00016199,96.87934347
27458,打印,1,598043,0.00016199,96.87950546
27459,打地鋪,1,598044,0.00016199,96.87966746
27460,打好,1,598045,0.00016199,96.87982945
27461,打字行,1,598046,0.00016199,96.87999145
27462,打字機,1,598047,0.00016199,96.88015344
27463,打成一片,1,598048,0.00016199,96.88031544
27464,打死,1,598049,0.00016199,96.88047743
27465,打完,1,598050,0.00016199,96.88063942
27466,打岔,1,598051,0.00016199,96.88080142
27467,打折扣,1,598052,0.00016199,96.88096341
27468,打定,1,598053,0.00016199,96.88112541
27469,打法,1,598054,0.00016199,96.88128740
27470,打泡,1,598055,0.00016199,96.88144939
27471,打亮,1,598056,0.00016199,96.88161139
27472,打垮,1,598057,0.00016199,96.88177338
27473,打盹兒,1,598058,0.00016199,96.88193538
27474,打草驚蛇,1,598059,0.00016199,96.88209737
27475,打馬虎眼,1,598060,0.00016199,96.88225937
27476,打混,1,598061,0.00016199,96.88242136
27477,打理,1,598062,0.00016199,96.88258335
27478,打菜,1,598063,0.00016199,96.88274535
27479,打量,1,598064,0.00016199,96.88290734
27480,打亂,1,598065,0.00016199,96.88306934
27481,打傷,1,598066,0.00016199,96.88323133
27482,打雷,1,598067,0.00016199,96.88339333
27483,打零工,1,598068,0.00016199,96.88355532
27484,打緊,1,598069,0.00016199,96.88371731
27485,打數,1,598070,0.00016199,96.88387931
27486,打賭,1,598071,0.00016199,96.88404130
27487,打磨,1,598072,0.00016199,96.88420330
27488,打擊王,1,598073,0.00016199,96.88436529
27489,打擊樂團,1,598074,0.00016199,96.88452728
27490,打擊樂器,1,598075,0.00016199,96.88468928
27491,打點王,1,598076,0.00016199,96.88485127
27492,打鼾,1,598077,0.00016199,96.88501327
27493,打翻,1,598078,0.00016199,96.88517526
27494,打響,1,598079,0.00016199,96.88533726
27495,扔,1,598080,0.00016199,96.88549925
27496,扔進,1,598081,0.00016199,96.88566124
27497,扒光,1,598082,0.00016199,96.88582324
27498,斥,1,598083,0.00016199,96.88598523
27499,旦夕,1,598084,0.00016199,96.88614723
27500,朮,1,598085,0.00016199,96.88630922
27501,本土文化,1,598086,0.00016199,96.88647122
27502,本土研究,1,598087,0.00016199,96.88663321
27503,本土籍球員,1,598088,0.00016199,96.88679520
27504,本片,1,598089,0.00016199,96.88695720
27505,本末倒置,1,598090,0.00016199,96.88711919
27506,本田,1,598091,0.00016199,96.88728119
27507,本田汽車,1,598092,0.00016199,96.88744318
27508,本份,1,598093,0.00016199,96.88760517
27509,本地化,1,598094,0.00016199,96.88776717
27510,本州,1,598095,0.00016199,96.88792916
27511,本旨,1,598096,0.00016199,96.88809116
27512,本位,1,598097,0.00016199,96.88825315
27513,本位主義,1,598098,0.00016199,96.88841515
27514,本屆,1,598099,0.00016199,96.88857714
27515,本初,1,598100,0.00016199,96.88873913
27516,本是,1,598101,0.00016199,96.88890113
27517,本家御川,1,598102,0.00016199,96.88906312
27518,本票,1,598103,0.00016199,96.88922512
27519,本體論,1,598104,0.00016199,96.88938711
27520,未卜,1,598105,0.00016199,96.88954911
27521,未上市盤商,1,598106,0.00016199,96.88971110
27522,未上櫃,1,598107,0.00016199,96.88987309
27523,未亡人,1,598108,0.00016199,96.89003509
27524,未公開,1,598109,0.00016199,96.89019708
27525,未付,1,598110,0.00016199,96.89035908
27526,未充,1,598111,0.00016199,96.89052107
27527,未申報,1,598112,0.00016199,96.89068306
27528,未成年人,1,598113,0.00016199,96.89084506
27529,未改正,1,598114,0.00016199,96.89100705
27530,未改革,1,598115,0.00016199,96.89116905
27531,未見,1,598116,0.00016199,96.89133104
27532,未依,1,598117,0.00016199,96.89149304
27533,未來主義,1,598118,0.00016199,96.89165503
27534,未受制,1,598119,0.00016199,96.89181702
27535,未明,1,598120,0.00016199,96.89197902
27536,未明確,1,598121,0.00016199,96.89214101
27537,未果,1,598122,0.00016199,96.89230301
27538,未泯,1,598123,0.00016199,96.89246500
27539,未知數,1,598124,0.00016199,96.89262700
27540,未雨綢繆,1,598125,0.00016199,96.89278899
27541,未圈答,1,598126,0.00016199,96.89295098
27542,未婚夫,1,598127,0.00016199,96.89311298
27543,未婚妻,1,598128,0.00016199,96.89327497
27544,未接受,1,598129,0.00016199,96.89343697
27545,未被,1,598130,0.00016199,96.89359896
27546,未竟,1,598131,0.00016199,96.89376095
27547,未幾,1,598132,0.00016199,96.89392295
27548,未發包,1,598133,0.00016199,96.89408494
27549,未發生,1,598134,0.00016199,96.89424694
27550,未發現,1,598135,0.00016199,96.89440893
27551,未開發國家,1,598136,0.00016199,96.89457093
27552,未塞,1,598137,0.00016199,96.89473292
27553,未解,1,598138,0.00016199,96.89489491
27554,未解秘密,1,598139,0.00016199,96.89505691
27555,未嘗,1,598140,0.00016199,96.89521890
27556,未孵化,1,598141,0.00016199,96.89538090
27557,未盡,1,598142,0.00016199,96.89554289
27558,未確定,1,598143,0.00016199,96.89570489
27559,未臻,1,598144,0.00016199,96.89586688
27560,未鬆口,1,598145,0.00016199,96.89602887
27561,未覺先動,1,598146,0.00016199,96.89619087
27562,末了,1,598147,0.00016199,96.89635286
27563,末代,1,598148,0.00016199,96.89651486
27564,末位,1,598149,0.00016199,96.89667685
27565,札原正裕,1,598150,0.00016199,96.89683884
27566,正中,1,598151,0.00016199,96.89700084
27567,正中神經,1,598152,0.00016199,96.89716283
27568,正反合,1,598153,0.00016199,96.89732483
27569,正月,1,598154,0.00016199,96.89748682
27570,正由,1,598155,0.00016199,96.89764882
27571,正向,1,598156,0.00016199,96.89781081
27572,正式版,1,598157,0.00016199,96.89797280
27573,正事,1,598158,0.00016199,96.89813480
27574,正念,1,598159,0.00016199,96.89829679
27575,正直,1,598160,0.00016199,96.89845879
27576,正品,1,598161,0.00016199,96.89862078
27577,正室,1,598162,0.00016199,96.89878278
27578,正派,1,598163,0.00016199,96.89894477
27579,正風小組,1,598164,0.00016199,96.89910676
27580,正氣,1,598165,0.00016199,96.89926876
27581,正副,1,598166,0.00016199,96.89943075
27582,正常化,1,598167,0.00016199,96.89959275
27583,正常值,1,598168,0.00016199,96.89975474
27584,正梯形,1,598169,0.00016199,96.89991673
27585,正規賽,1,598170,0.00016199,96.90007873
27586,正港,1,598171,0.00016199,96.90024072
27587,正腎上腺素,1,598172,0.00016199,96.90040272
27588,正項,1,598173,0.00016199,96.90056471
27589,正黃,1,598174,0.00016199,96.90072671
27590,正新,1,598175,0.00016199,96.90088870
27591,正楷,1,598176,0.00016199,96.90105069
27592,正義連線,1,598177,0.00016199,96.90121269
27593,正義感,1,598178,0.00016199,96.90137468
27594,正道,1,598179,0.00016199,96.90153668
27595,正數,1,598180,0.00016199,96.90169867
27596,正編,1,598181,0.00016199,96.90186067
27597,正點,1,598182,0.00016199,96.90202266
27598,正職,1,598183,0.00016199,96.90218465
27599,正廳,1,598184,0.00016199,96.90234665
27600,母女情,1,598185,0.00016199,96.90250864
27601,母子茶壺,1,598186,0.00016199,96.90267064
27602,母子檔,1,598187,0.00016199,96.90283263
27603,母性,1,598188,0.00016199,96.90299462
27604,母壺,1,598189,0.00016199,96.90315662
27605,母熊,1,598190,0.00016199,96.90331861
27606,母廠,1,598191,0.00016199,96.90348061
27607,母盤,1,598192,0.00016199,96.90364260
27608,母親卡,1,598193,0.00016199,96.90380460
27609,母龜,1,598194,0.00016199,96.90396659
27610,民主制度,1,598195,0.00016199,96.90412858
27611,民主政治,1,598196,0.00016199,96.90429058
27612,民主黨,1,598197,0.00016199,96.90445257
27613,民生二路,1,598198,0.00016199,96.90461457
27614,民生用品,1,598199,0.00016199,96.90477656
27615,民生凋敝,1,598200,0.00016199,96.90493856
27616,民生報之友卡,1,598201,0.00016199,96.90510055
27617,民用航空,1,598202,0.00016199,96.90526254
27618,民兵隊,1,598203,0.00016199,96.90542454
27619,民事,1,598204,0.00016199,96.90558653
27620,民事訴訟法,1,598205,0.00016199,96.90574853
27621,民房,1,598206,0.00016199,96.90591052
27622,民法,1,598207,0.00016199,96.90607252
27623,民俗館,1,598208,0.00016199,96.90623451
27624,民政人員,1,598209,0.00016199,96.90639650
27625,民政課,1,598210,0.00016199,96.90655850
27626,民政廳長,1,598211,0.00016199,96.90672049
27627,民航客機,1,598212,0.00016199,96.90688249
27628,民航界,1,598213,0.00016199,96.90704448
27629,民航業,1,598214,0.00016199,96.90720647
27630,民國政府,1,598215,0.00016199,96.90736847
27631,民宿,1,598216,0.00016199,96.90753046
27632,民族路,1,598217,0.00016199,96.90769246
27633,民族舞蹈,1,598218,0.00016199,96.90785445
27634,民族學者,1,598219,0.00016199,96.90801645
27635,民眾服務社,1,598220,0.00016199,96.90817844
27636,民進黨主席,1,598221,0.00016199,96.90834043
27637,民意廣場,1,598222,0.00016199,96.90850243
27638,民意調查,1,598223,0.00016199,96.90866442
27639,民歌,1,598224,0.00016199,96.90882642
27640,民福醬園,1,598225,0.00016199,96.90898841
27641,民興紡織公司,1,598226,0.00016199,96.90915041
27642,民聲文化傳播,1,598227,0.00016199,96.90931240
27643,民權二橋,1,598228,0.00016199,96.90947439
27644,民權大樓,1,598229,0.00016199,96.90963639
27645,永久居留權,1,598230,0.00016199,96.90979838
27646,永大,1,598231,0.00016199,96.90996038
27647,永不止息,1,598232,0.00016199,96.91012237
27648,永光,1,598233,0.00016199,96.91028436
27649,永垂不朽,1,598234,0.00016199,96.91044636
27650,永浴愛河,1,598235,0.00016199,96.91060835
27651,永康交流道,1,598236,0.00016199,96.91077035
27652,永逢集團,1,598237,0.00016199,96.91093234
27653,永無,1,598238,0.00016199,96.91109434
27654,永無止盡,1,598239,0.00016199,96.91125633
27655,永慶房屋,1,598240,0.00016199,96.91141832
27656,永樂社區,1,598241,0.00016199,96.91158032
27657,永豐棧麗緻酒店,1,598242,0.00016199,96.91174231
27658,永豐路,1,598243,0.00016199,96.91190431
27659,永豐餘,1,598244,0.00016199,96.91206630
27660,永續經營,1,598245,0.00016199,96.91222830
27661,永恒,1,598246,0.00016199,96.91239029
27662,犯下,1,598247,0.00016199,96.91255228
27663,犯不著,1,598248,0.00016199,96.91271428
27664,犯行,1,598249,0.00016199,96.91287627
27665,犯煞,1,598250,0.00016199,96.91303827
27666,犯罪率,1,598251,0.00016199,96.91320026
27667,玄武岩,1,598252,0.00016199,96.91336225
27668,玄武湖,1,598253,0.00016199,96.91352425
27669,玄關桌,1,598254,0.00016199,96.91368624
27670,玉山人,1,598255,0.00016199,96.91384824
27671,玉成,1,598256,0.00016199,96.91401023
27672,玉里警分局,1,598257,0.00016199,96.91417223
27673,玉佩,1,598258,0.00016199,96.91433422
27674,玉帛,1,598259,0.00016199,96.91449621
27675,玉翔國際顧問企業公司,1,598260,0.00016199,96.91465821
27676,玉豐里,1,598261,0.00016199,96.91482020
27677,瓜果類,1,598262,0.00016199,96.91498220
27678,瓜達尼尼,1,598263,0.00016199,96.91514419
27679,瓦加,1,598264,0.00016199,96.91530619
27680,瓦理．裘納,1,598265,0.00016199,96.91546818
27681,瓦斯車加氣站,1,598266,0.00016199,96.91563017
27682,瓦斯管,1,598267,0.00016199,96.91579217
27683,瓦斯鍋爐,1,598268,0.00016199,96.91595416
27684,瓦斯爐,1,598269,0.00016199,96.91611616
27685,瓦塞克,1,598270,0.00016199,96.91627815
27686,瓦楞釘機,1,598271,0.00016199,96.91644014
27687,瓦薩,1,598272,0.00016199,96.91660214
27688,瓦薩公園,1,598273,0.00016199,96.91676413
27689,甘心,1,598274,0.00016199,96.91692613
27690,甘平,1,598275,0.00016199,96.91708812
27691,甘地夫人,1,598276,0.00016199,96.91725012
27692,甘哈,1,598277,0.00016199,96.91741211
27693,甘拜下風,1,598278,0.00016199,96.91757410
27694,甘泉,1,598279,0.00016199,96.91773610
27695,甘美,1,598280,0.00016199,96.91789809
27696,甘迪,1,598281,0.00016199,96.91806009
27697,甘絲,1,598282,0.00016199,96.91822208
27698,甘菊,1,598283,0.00016199,96.91838408
27699,甘箏,1,598284,0.00016199,96.91854607
27700,甘蔗,1,598285,0.00016199,96.91870806
27701,甘澀,1,598286,0.00016199,96.91887006
27702,甘露,1,598287,0.00016199,96.91903205
27703,甘露水,1,598288,0.00016199,96.91919405
27704,甘露茶水,1,598289,0.00016199,96.91935604
27705,生力,1,598290,0.00016199,96.91951803
27706,生力啤酒,1,598291,0.00016199,96.91968003
27707,生手,1,598292,0.00016199,96.91984202
27708,生日快樂歌,1,598293,0.00016199,96.92000402
27709,生水,1,598294,0.00016199,96.92016601
27710,生出,1,598295,0.00016199,96.92032801
27711,生吃,1,598296,0.00016199,96.92049000
27712,生存術,1,598297,0.00016199,96.92065199
27713,生存權,1,598298,0.00016199,96.92081399
27714,生成激素,1,598299,0.00016199,96.92097598
27715,生死戀,1,598300,0.00016199,96.92113798
27716,生死觀,1,598301,0.00016199,96.92129997
27717,生冷,1,598302,0.00016199,96.92146197
27718,生肖,1,598303,0.00016199,96.92162396
27719,生育期,1,598304,0.00016199,96.92178595
27720,生乳,1,598305,0.00016199,96.92194795
27721,生命回顧,1,598306,0.00016199,96.92210994
27722,生命隊,1,598307,0.00016199,96.92227194
27723,生命體,1,598308,0.00016199,96.92243393
27724,生怕,1,598309,0.00016199,96.92259592
27725,生枝子,1,598310,0.00016199,96.92275792
27726,生物學,1,598311,0.00016199,96.92291991
27727,生物學界,1,598312,0.00016199,96.92308191
27728,生物體,1,598313,0.00016199,96.92324390
27729,生者,1,598314,0.00016199,96.92340590
27730,生長地,1,598315,0.00016199,96.92356789
27731,生長期,1,598316,0.00016199,96.92372988
27732,生長激素,1,598317,0.00016199,96.92389188
27733,生怨,1,598318,0.00016199,96.92405387
27734,生活性,1,598319,0.00016199,96.92421587
27735,生活版,1,598320,0.00016199,96.92437786
27736,生活面,1,598321,0.00016199,96.92453986
27737,生啤酒,1,598322,0.00016199,96.92470185
27738,生涯規畫,1,598323,0.00016199,96.92486384
27739,生理性,1,598324,0.00016199,96.92502584
27740,生理食鹽水,1,598325,0.00016199,96.92518783
27741,生理期,1,598326,0.00016199,96.92534983
27742,生理學,1,598327,0.00016199,96.92551182
27743,生理學獎,1,598328,0.00016199,96.92567381
27744,生產力中心,1,598329,0.00016199,96.92583581
27745,生產地,1,598330,0.00016199,96.92599780
27746,生產科長,1,598331,0.00016199,96.92615980
27747,生產國,1,598332,0.00016199,96.92632179
27748,生產率,1,598333,0.00016199,96.92648379
27749,生產部,1,598334,0.00016199,96.92664578
27750,生產磁,1,598335,0.00016199,96.92680777
27751,生疏,1,598336,0.00016199,96.92696977
27752,生蛋雞,1,598337,0.00016199,96.92713176
27753,生殖季,1,598338,0.00016199,96.92729376
27754,生殖道,1,598339,0.00016199,96.92745575
27755,生菜葉,1,598340,0.00016199,96.92761775
27756,生意量,1,598341,0.00016199,96.92777974
27757,生煙,1,598342,0.00016199,96.92794173
27758,生路,1,598343,0.00016199,96.92810373
27759,生態系,1,598344,0.00016199,96.92826572
27760,生態保育,1,598345,0.00016199,96.92842772
27761,生態圈,1,598346,0.00016199,96.92858971
27762,生趣,1,598347,0.00016199,96.92875170
27763,生蠔,1,598348,0.00016199,96.92891370
27764,生鏽,1,598349,0.00016199,96.92907569
27765,用人唯才,1,598350,0.00016199,96.92923769
27766,用水量,1,598351,0.00016199,96.92939968
27767,用它,1,598352,0.00016199,96.92956168
27768,用兵,1,598353,0.00016199,96.92972367
27769,用者,1,598354,0.00016199,96.92988566
27770,用料,1,598355,0.00016199,96.93004766
27771,用起來,1,598356,0.00016199,96.93020965
27772,用詞,1,598357,0.00016199,96.93037165
27773,用盡,1,598358,0.00016199,96.93053364
27774,用糖量,1,598359,0.00016199,96.93069564
27775,用糖業者,1,598360,0.00016199,96.93085763
27776,用餐區,1,598361,0.00016199,96.93101962
27777,用藥,1,598362,0.00016199,96.93118162
27778,用籤,1,598363,0.00016199,96.93134361
27779,田中鎮,1,598364,0.00016199,96.93150561
27780,田太代一,1,598365,0.00016199,96.93166760
27781,田仔,1,598366,0.00016199,96.93182959
27782,田宮,1,598367,0.00016199,96.93199159
27783,田徑賽,1,598368,0.00016199,96.93215358
27784,田納西,1,598369,0.00016199,96.93231558
27785,田訓民,1,598370,0.00016199,96.93247757
27786,田淵,1,598371,0.00016199,96.93263957
27787,田野調查,1,598372,0.00016199,96.93280156
27788,田園詩,1,598373,0.00016199,96.93296355
27789,田鼠洞,1,598374,0.00016199,96.93312555
27790,田僑,1,598375,0.00016199,96.93328754
27791,田雞蟆,1,598376,0.00016199,96.93344954
27792,田邊製藥,1,598377,0.00016199,96.93361153
27793,由今掛勇,1,598378,0.00016199,96.93377353
27794,由來已久,1,598379,0.00016199,96.93393552
27795,由弱轉強,1,598380,0.00016199,96.93409751
27796,甲狀腺,1,598381,0.00016199,96.93425951
27797,甲特,1,598382,0.00016199,96.93442150
27798,甲組聯賽,1,598383,0.00016199,96.93458350
27799,甲等特考,1,598384,0.00016199,96.93474549
27800,甲烷,1,598385,0.00016199,96.93490749
27801,申告,1,598386,0.00016199,96.93506948
27802,申貸,1,598387,0.00016199,96.93523147
27803,申請人,1,598388,0.00016199,96.93539347
27804,申請書,1,598389,0.00016199,96.93555546
27805,申請案,1,598390,0.00016199,96.93571746
27806,申請單,1,598391,0.00016199,96.93587945
27807,申論,1,598392,0.00016199,96.93604144
27808,申辯,1,598393,0.00016199,96.93620344
27809,白人政府,1,598394,0.00016199,96.93636543
27810,白手,1,598395,0.00016199,96.93652743
27811,白木耳,1,598396,0.00016199,96.93668942
27812,白水,1,598397,0.00016199,96.93685142
27813,白水案,1,598398,0.00016199,96.93701341
27814,白白淨淨,1,598399,0.00016199,96.93717540
27815,白白嫩嫩,1,598400,0.00016199,96.93733740
27816,白皮書,1,598401,0.00016199,96.93749939
27817,白皮袋,1,598402,0.00016199,96.93766139
27818,白吃,1,598403,0.00016199,96.93782338
27819,白池地獄,1,598404,0.00016199,96.93798538
27820,白肉,1,598405,0.00016199,96.93814737
27821,白血病,1,598406,0.00016199,96.93830936
27822,白沙灣,1,598407,0.00016199,96.93847136
27823,白沙灣安樂園,1,598408,0.00016199,96.93863335
27824,白卷,1,598409,0.00016199,96.93879535
27825,白夜,1,598410,0.00016199,96.93895734
27826,白昆弘,1,598411,0.00016199,96.93911933
27827,白明奇,1,598412,0.00016199,96.93928133
27828,白河鎮,1,598413,0.00016199,96.93944332
27829,白虎人參湯,1,598414,0.00016199,96.93960532
27830,白金長笛,1,598415,0.00016199,96.93976731
27831,白金唱片,1,598416,0.00016199,96.93992931
27832,白帝城,1,598417,0.00016199,96.94009130
27833,白面書生,1,598418,0.00016199,96.94025329
27834,白首偕老,1,598419,0.00016199,96.94041529
27835,白宮風暴,1,598420,0.00016199,96.94057728
27836,白晉東,1,598421,0.00016199,96.94073928
27837,白海,1,598422,0.00016199,96.94090127
27838,白粉,1,598423,0.00016199,96.94106327
27839,白紙黑字,1,598424,0.00016199,96.94122526
27840,白馬王子,1,598425,0.00016199,96.94138725
27841,白骨,1,598426,0.00016199,96.94154925
27842,白雪暟暟,1,598427,0.00016199,96.94171124
27843,白描,1,598428,0.00016199,96.94187324
27844,白開水,1,598429,0.00016199,96.94203523
27845,白開水活動,1,598430,0.00016199,96.94219722
27846,白飯,1,598431,0.00016199,96.94235922
27847,白煙,1,598432,0.00016199,96.94252121
27848,白葡萄酒,1,598433,0.00016199,96.94268321
27849,白話,1,598434,0.00016199,96.94284520
27850,白嘉莉,1,598435,0.00016199,96.94300720
27851,白榕園,1,598436,0.00016199,96.94316919
27852,白銀,1,598437,0.00016199,96.94333118
27853,白領,1,598438,0.00016199,96.94349318
27854,白熱,1,598439,0.00016199,96.94365517
27855,白膜,1,598440,0.00016199,96.94381717
27856,白醋,1,598441,0.00016199,96.94397916
27857,白錫鏗,1,598442,0.00016199,96.94414116
27858,白頭髮,1,598443,0.00016199,96.94430315
27859,白礁亭,1,598444,0.00016199,96.94446514
27860,白礁鄉,1,598445,0.00016199,96.94462714
27861,白額樹蛙,1,598446,0.00016199,96.94478913
27862,白麗麗,1,598447,0.00016199,96.94495113
27863,白蘭特,1,598448,0.00016199,96.94511312
27864,白鐵仔,1,598449,0.00016199,96.94527511
27865,白鷺鷥,1,598450,0.00016199,96.94543711
27866,白皙,1,598451,0.00016199,96.94559910
27867,皮下注射器,1,598452,0.00016199,96.94576110
27868,皮下脂肪,1,598453,0.00016199,96.94592309
27869,皮包骨,1,598454,0.00016199,96.94608509
27870,皮衣,1,598455,0.00016199,96.94624708
27871,皮夾狗,1,598456,0.00016199,96.94640907
27872,皮亞第戈果斯基,1,598457,0.00016199,96.94657107
27873,皮表,1,598458,0.00016199,96.94673306
27874,皮面,1,598459,0.00016199,96.94689506
27875,皮革業,1,598460,0.00016199,96.94705705
27876,皮疹,1,598461,0.00016199,96.94721905
27877,皮紋,1,598462,0.00016199,96.94738104
27878,皮脂,1,598463,0.00016199,96.94754303
27879,皮脂腺,1,598464,0.00016199,96.94770503
27880,皮脂膜,1,598465,0.00016199,96.94786702
27881,皮袋,1,598466,0.00016199,96.94802902
27882,皮業,1,598467,0.00016199,96.94819101
27883,皮道堅,1,598468,0.00016199,96.94835300
27884,皮爾斯伯瑞,1,598469,0.00016199,96.94851500
27885,皮影戲,1,598470,0.00016199,96.94867699
27886,皮箱,1,598471,0.00016199,96.94883899
27887,皮鞭,1,598472,0.00016199,96.94900098
27888,目孔,1,598473,0.00016199,96.94916298
27889,目空一切,1,598474,0.00016199,96.94932497
27890,目眩,1,598475,0.00016199,96.94948696
27891,目無法紀,1,598476,0.00016199,96.94964896
27892,目標物,1,598477,0.00016199,96.94981095
27893,目標區,1,598478,0.00016199,96.94997295
27894,目賭,1,598479,0.00016199,96.95013494
27895,目錄頁,1,598480,0.00016199,96.95029694
27896,目擊者叢書自然博物館系列,1,598481,0.00016199,96.95045893
27897,目瞪口呆,1,598482,0.00016199,96.95062092
27898,矛頭,1,598483,0.00016199,96.95078292
27899,矢口否認,1,598484,0.00016199,96.95094491
27900,矢野,1,598485,0.00016199,96.95110691
27901,石子路,1,598486,0.00016199,96.95126890
27902,石川市立球場,1,598487,0.00016199,96.95143089
27903,石友,1,598488,0.00016199,96.95159289
27904,石台,1,598489,0.00016199,96.95175488
27905,石灰岩,1,598490,0.00016199,96.95191688
27906,石材,1,598491,0.00016199,96.95207887
27907,石秀探莊,1,598492,0.00016199,96.95224087
27908,石刻,1,598493,0.00016199,96.95240286
27909,石板步道,1,598494,0.00016199,96.95256485
27910,石板屋,1,598495,0.00016199,96.95272685
27911,石板路,1,598496,0.00016199,96.95288884
27912,石花園,1,598497,0.00016199,96.95305084
27913,石青,1,598498,0.00016199,96.95321283
27914,石洗藍,1,598499,0.00016199,96.95337483
27915,石破天驚,1,598500,0.00016199,96.95353682
27916,石國忠,1,598501,0.00016199,96.95369881
27917,石梯,1,598502,0.00016199,96.95386081
27918,石牌,1,598503,0.00016199,96.95402280
27919,石階,1,598504,0.00016199,96.95418480
27920,石楠花,1,598505,0.00016199,96.95434679
27921,石像,1,598506,0.00016199,96.95450878
27922,石榴子石,1,598507,0.00016199,96.95467078
27923,石綠,1,598508,0.00016199,96.95483277
27924,石膏,1,598509,0.00016199,96.95499477
27925,石膏板,1,598510,0.00016199,96.95515676
27926,石磊村,1,598511,0.00016199,96.95531876
27927,石器,1,598512,0.00016199,96.95548075
27928,石橋貴明,1,598513,0.00016199,96.95564274
27929,石橋證券公司,1,598514,0.00016199,96.95580474
27930,石雕,1,598515,0.00016199,96.95596673
27931,石癡,1,598516,0.00016199,96.95612873
27932,石爐,1,598517,0.00016199,96.95629072
27933,石蠟,1,598518,0.00016199,96.95645272
27934,石灣陶,1,598519,0.00016199,96.95661471
27935,石碇站,1,598520,0.00016199,96.95677670
27936,石碇鄉公所,1,598521,0.00016199,96.95693870
27937,石�|,1,598522,0.00016199,96.95710069
27938,示現,1,598523,0.00016199,96.95726269
27939,示意,1,598524,0.00016199,96.95742468
27940,示範光碟,1,598525,0.00016199,96.95758667
27941,示範教室,1,598526,0.00016199,96.95774867
27942,禾本科,1,598527,0.00016199,96.95791066
27943,禾本科植物,1,598528,0.00016199,96.95807266
27944,禾場,1,598529,0.00016199,96.95823465
27945,穴道按摩,1,598530,0.00016199,96.95839665
27946,立方,1,598531,0.00016199,96.95855864
27947,立方體,1,598532,0.00016199,96.95872063
27948,立判高下,1,598533,0.00016199,96.95888263
27949,立即性,1,598534,0.00016199,96.95904462
27950,立足點,1,598535,0.00016199,96.95920662
27951,立法局,1,598536,0.00016199,96.95936861
27952,立法院交通預算聯席委員會,1,598537,0.00016199,96.95953061
27953,立法程序,1,598538,0.00016199,96.95969260
27954,立法會,1,598539,0.00016199,96.95985459
27955,立竿見影,1,598540,0.00016199,96.96001659
27956,立面,1,598541,0.00016199,96.96017858
27957,立院舞台,1,598542,0.00016199,96.96034058
27958,立國,1,598543,0.00016199,96.96050257
27959,立基點,1,598544,0.00016199,96.96066457
27960,立達啟能訓練中心,1,598545,0.00016199,96.96082656
27961,立體交叉道,1,598546,0.00016199,96.96098855
27962,立體表示法,1,598547,0.00016199,96.96115055
27963,立體感,1,598548,0.00016199,96.96131254
27964,立體圖形,1,598549,0.00016199,96.96147454
27965,立體圖像,1,598550,0.00016199,96.96163653
27966,丟擲,1,598551,0.00016199,96.96179852
27967,乒乓球,1,598552,0.00016199,96.96196052
27968,乩童,1,598553,0.00016199,96.96212251
27969,交叉分析,1,598554,0.00016199,96.96228451
27970,交工處,1,598555,0.00016199,96.96244650
27971,交友,1,598556,0.00016199,96.96260850
27972,交加,1,598557,0.00016199,96.96277049
27973,交回,1,598558,0.00016199,96.96293248
27974,交耳,1,598559,0.00016199,96.96309448
27975,交易商,1,598560,0.00016199,96.96325647
27976,交易稅,1,598561,0.00016199,96.96341847
27977,交屋,1,598562,0.00016199,96.96358046
27978,交流道口,1,598563,0.00016199,96.96374246
27979,交界,1,598564,0.00016199,96.96390445
27980,交相,1,598565,0.00016199,96.96406644
27981,交相輝映,1,598566,0.00016199,96.96422844
27982,交差性,1,598567,0.00016199,96.96439043
27983,交陣,1,598568,0.00016199,96.96455243
27984,交處,1,598569,0.00016199,96.96471442
27985,交通安全課,1,598570,0.00016199,96.96487641
27986,交通事業黨部,1,598571,0.00016199,96.96503841
27987,交通宣導短片,1,598572,0.00016199,96.96520040
27988,交通動線,1,598573,0.00016199,96.96536240
27989,交通部政次,1,598574,0.00016199,96.96552439
27990,交通裁決所,1,598575,0.00016199,96.96568639
27991,交通量,1,598576,0.00016199,96.96584838
27992,交通隊,1,598577,0.00016199,96.96601037
27993,交通號誌,1,598578,0.00016199,96.96617237
27994,交通運輸學會,1,598579,0.00016199,96.96633436
27995,交通網,1,598580,0.00016199,96.96649636
27996,交割,1,598581,0.00016199,96.96665835
27997,交割股,1,598582,0.00016199,96.96682035
27998,交換式,1,598583,0.00016199,96.96698234
27999,交換機,1,598584,0.00016199,96.96714433
28000,交替,1,598585,0.00016199,96.96730633
28001,交匯,1,598586,0.00016199,96.96746832
28002,交鳴,1,598587,0.00016199,96.96763032
28003,交誼,1,598588,0.00016199,96.96779231
28004,交談式,1,598589,0.00016199,96.96795430
28005,交鋒,1,598590,0.00016199,96.96811630
28006,交戰國,1,598591,0.00016199,96.96827829
28007,交機,1,598592,0.00016199,96.96844029
28008,交辦,1,598593,0.00016199,96.96860228
28009,交頭接耳,1,598594,0.00016199,96.96876428
28010,交還,1,598595,0.00016199,96.96892627
28011,交雜,1,598596,0.00016199,96.96908826
28012,交纏,1,598597,0.00016199,96.96925026
28013,交響樂,1,598598,0.00016199,96.96941225
28014,交疊,1,598599,0.00016199,96.96957425
28015,亦即,1,598600,0.00016199,96.96973624
28016,仿如,1,598601,0.00016199,96.96989824
28017,仿倣,1,598602,0.00016199,96.97006023
28018,伉儷珠寶,1,598603,0.00016199,96.97022222
28019,伊,1,598604,0.00016199,96.97038422
28020,伊凡．蘇沙寧,1,598605,0.00016199,96.97054621
28021,伊凡斯區,1,598606,0.00016199,96.97070821
28022,伊列斯古,1,598607,0.00016199,96.97087020
28023,伊里昂,1,598608,0.00016199,96.97103219
28024,伊里恩,1,598609,0.00016199,96.97119419
28025,伊果王子,1,598610,0.00016199,96.97135618
28026,伊芙島,1,598611,0.00016199,96.97151818
28027,伊南,1,598612,0.00016199,96.97168017
28028,伊莎貝爾曼德茲,1,598613,0.00016199,96.97184217
28029,伊莉莎白．凱爾,1,598614,0.00016199,96.97200416
28030,伊莉莎白柏克蕾,1,598615,0.00016199,96.97216615
28031,伊斯坦堡,1,598616,0.00016199,96.97232815
28032,伊斯坦堡大學,1,598617,0.00016199,96.97249014
28033,伊斯蘭區,1,598618,0.00016199,96.97265214
28034,伊塔西,1,598619,0.00016199,96.97281413
28035,伊奧尼亞海,1,598620,0.00016199,96.97297613
28036,伊奧柯斯,1,598621,0.00016199,96.97313812
28037,伊爾,1,598622,0.00016199,96.97330011
28038,伊爾的神話,1,598623,0.00016199,96.97346211
28039,伊藤忠,1,598624,0.00016199,96.97362410
28040,伊麗莎白‧陶曼,1,598625,0.00016199,96.97378610
28041,伊麗莎白麥高文,1,598626,0.00016199,96.97394809
28042,伍迪艾倫,1,598627,0.00016199,96.97411008
28043,伍崇韜,1,598628,0.00016199,96.97427208
28044,伍爾菲,1,598629,0.00016199,96.97443407
28045,休士頓,1,598630,0.00016199,96.97459607
28046,休威爾森,1,598631,0.00016199,96.97475806
28047,休息站,1,598632,0.00016199,96.97492006
28048,休格斯,1,598633,0.00016199,96.97508205
28049,休假日,1,598634,0.00016199,96.97524404
28050,休斯電子,1,598635,0.00016199,96.97540604
28051,休斯頓,1,598636,0.00016199,96.97556803
28052,休閒化,1,598637,0.00016199,96.97573003
28053,休閒地,1,598638,0.00016199,96.97589202
28054,休閒式,1,598639,0.00016199,96.97605402
28055,休閒性,1,598640,0.00016199,96.97621601
28056,休閒風,1,598641,0.00016199,96.97637800
28057,休閒區,1,598642,0.00016199,96.97654000
28058,休閒渡假中心,1,598643,0.00016199,96.97670199
28059,休閒運動,1,598644,0.00016199,96.97686399
28060,休閒運動業,1,598645,0.00016199,96.97702598
28061,休業,1,598646,0.00016199,96.97718797
28062,休葛蘭,1,598647,0.00016199,96.97734997
28063,休憩處,1,598648,0.00016199,96.97751196
28064,伏地挺身,1,598649,0.00016199,96.97767396
28065,伏特加,1,598650,0.00016199,96.97783595
28066,伏筆,1,598651,0.00016199,96.97799795
28067,仲介業,1,598652,0.00016199,96.97815994
28068,仲裁,1,598653,0.00016199,96.97832193
28069,仲裁者,1,598654,0.00016199,96.97848393
28070,任人擺佈,1,598655,0.00016199,96.97864592
28071,任由,1,598656,0.00016199,96.97880792
28072,任官,1,598657,0.00016199,96.97896991
28073,任務區,1,598658,0.00016199,96.97913191
28074,任滿,1,598659,0.00016199,96.97929390
28075,任賢齊,1,598660,0.00016199,96.97945589
28076,任選,1,598661,0.00016199,96.97961789
28077,仰臥起坐,1,598662,0.00016199,96.97977988
28078,仰面,1,598663,0.00016199,96.97994188
28079,仰望,1,598664,0.00016199,96.98010387
28080,份外,1,598665,0.00016199,96.98026586
28081,份兒,1,598666,0.00016199,96.98042786
28082,企求,1,598667,0.00016199,96.98058985
28083,企研社,1,598668,0.00016199,96.98075185
28084,企畫人,1,598669,0.00016199,96.98091384
28085,企畫組,1,598670,0.00016199,96.98107584
28086,企業家獎,1,598671,0.00016199,96.98123783
28087,企業館,1,598672,0.00016199,96.98139982
28088,企劃室,1,598673,0.00016199,96.98156182
28089,企劃處,1,598674,0.00016199,96.98172381
28090,企劃課,1,598675,0.00016199,96.98188581
28091,企管所,1,598676,0.00016199,96.98204780
28092,企管研究所,1,598677,0.00016199,96.98220980
28093,企銀股,1,598678,0.00016199,96.98237179
28094,光大,1,598679,0.00016199,96.98253378
28095,光大實業,1,598680,0.00016199,96.98269578
28096,光友公司,1,598681,0.00016199,96.98285777
28097,光光,1,598682,0.00016199,96.98301977
28098,光合作用,1,598683,0.00016199,96.98318176
28099,光男,1,598684,0.00016199,96.98334375
28100,光禿禿,1,598685,0.00016199,96.98350575
28101,光芒四射,1,598686,0.00016199,96.98366774
28102,光宗耀祖,1,598687,0.00016199,96.98382974
28103,光明磊落,1,598688,0.00016199,96.98399173
28104,光明燈,1,598689,0.00016199,96.98415373
28105,光效,1,598690,0.00016199,96.98431572
28106,光彩奪目,1,598691,0.00016199,96.98447771
28107,光敏感,1,598692,0.00016199,96.98463971
28108,光華二號,1,598693,0.00016199,96.98480170
28109,光華投信,1,598694,0.00016199,96.98496370
28110,光華投資,1,598695,0.00016199,96.98512569
28111,光潔,1,598696,0.00016199,96.98528769
28112,光學文字辨識系統,1,598697,0.00016199,96.98544968
28113,光澤感,1,598698,0.00016199,96.98561167
28114,兇相,1,598699,0.00016199,96.98577367
28115,兇匪,1,598700,0.00016199,96.98593566
28116,兇神惡煞,1,598701,0.00016199,96.98609766
28117,兇惡,1,598702,0.00016199,96.98625965
28118,兇殘,1,598703,0.00016199,96.98642164
28119,先下手,1,598704,0.00016199,96.98658364
28120,先天上,1,598705,0.00016199,96.98674563
28121,先父,1,598706,0.00016199,96.98690763
28122,先左腳再右腳,1,598707,0.00016199,96.98706962
28123,先后,1,598708,0.00016199,96.98723162
28124,先把,1,598709,0.00016199,96.98739361
28125,先明,1,598710,0.00016199,96.98755560
28126,先河,1,598711,0.00016199,96.98771760
28127,先拜,1,598712,0.00016199,96.98787959
28128,先施百貨,1,598713,0.00016199,96.98804159
28129,先哲,1,598714,0.00016199,96.98820358
28130,先峰,1,598715,0.00016199,96.98836558
28131,先祖,1,598716,0.00016199,96.98852757
28132,先斬後奏,1,598717,0.00016199,96.98868956
28133,先馳得點,1,598718,0.00016199,96.98885156
28134,全反射層,1,598719,0.00016199,96.98901355
28135,全天候,1,598720,0.00016199,96.98917555
28136,全斗煥,1,598721,0.00016199,96.98933754
28137,全比例,1,598722,0.00016199,96.98949954
28138,全民日報,1,598723,0.00016199,96.98966153
28139,全民健保,1,598724,0.00016199,96.98982352
28140,全民健保法,1,598725,0.00016199,96.98998552
28141,全民商圈,1,598726,0.00016199,96.99014751
28142,全局,1,598727,0.00016199,96.99030951
28143,全身性,1,598728,0.00016199,96.99047150
28144,全身像,1,598729,0.00016199,96.99063349
28145,全家人,1,598730,0.00016199,96.99079549
28146,全家大小,1,598731,0.00016199,96.99095748
28147,全家超商,1,598732,0.00016199,96.99111948
28148,全息,1,598733,0.00016199,96.99128147
28149,全海岸活蝦之家,1,598734,0.00016199,96.99144347
28150,全海岸活蝦王,1,598735,0.00016199,96.99160546
28151,全神貫注,1,598736,0.00016199,96.99176745
28152,全能,1,598737,0.00016199,96.99192945
28153,全區,1,598738,0.00016199,96.99209144
28154,全國工商建設研究會,1,598739,0.00016199,96.99225344
28155,全國工業總會,1,598740,0.00016199,96.99241543
28156,全國船務代理業聯合會,1,598741,0.00016199,96.99257743
28157,全國貨櫃協會,1,598742,0.00016199,96.99273942
28158,全國雅藝石聯展,1,598743,0.00016199,96.99290141
28159,全國電子公司,1,598744,0.00016199,96.99306341
28160,全國標準度政會議,1,598745,0.00016199,96.99322540
28161,全國體總,1,598746,0.00016199,96.99338740
28162,全球存託憑證,1,598747,0.00016199,96.99354939
28163,全球型,1,598748,0.00016199,96.99371138
28164,全球組合投資型基金,1,598749,0.00016199,96.99387338
28165,全球組合投資基金,1,598750,0.00016199,96.99403537
28166,全球資訊網路,1,598751,0.00016199,96.99419737
28167,全球電視台,1,598752,0.00016199,96.99435936
28168,全盛,1,598753,0.00016199,96.99452136
28169,全都,1,598754,0.00016199,96.99468335
28170,全麥,1,598755,0.00016199,96.99484534
28171,全無,1,598756,0.00016199,96.99500734
28172,全週,1,598757,0.00016199,96.99516933
28173,全開式,1,598758,0.00016199,96.99533133
28174,全勤,1,598759,0.00016199,96.99549332
28175,全新尖兵,1,598760,0.00016199,96.99565532
28176,全像,1,598761,0.00016199,96.99581731
28177,全像攝影記憶體,1,598762,0.00016199,96.99597930
28178,全碟式,1,598763,0.00016199,96.99614130
28179,全劇,1,598764,0.00016199,96.99630329
28180,全彈性魔術胸罩,1,598765,0.00016199,96.99646529
28181,全線,1,598766,0.00016199,96.99662728
28182,全調理,1,598767,0.00016199,96.99678927
28183,全興工業區,1,598768,0.00016199,96.99695127
28184,全錄,1,598769,0.00016199,96.99711326
28185,全錄公司,1,598770,0.00016199,96.99727526
28186,全頻域立體聲,1,598771,0.00016199,96.99743725
28187,全壘打牆,1,598772,0.00016199,96.99759925
28188,全職,1,598773,0.00016199,96.99776124
28189,全額交割股,1,598774,0.00016199,96.99792323
28190,共生,1,598775,0.00016199,96.99808523
28191,共同性,1,598776,0.00016199,96.99824722
28192,共同宣言,1,598777,0.00016199,96.99840922
28193,共同基金,1,598778,0.00016199,96.99857121
28194,共事,1,598779,0.00016199,96.99873321
28195,共和制,1,598780,0.00016199,96.99889520
28196,共枕,1,598781,0.00016199,96.99905719
28197,共看,1,598782,0.00016199,96.99921919
28198,共負,1,598783,0.00016199,96.99938118
28199,共赴,1,598784,0.00016199,96.99954318
28200,共時,1,598785,0.00016199,96.99970517
28201,共產,1,598786,0.00016199,96.99986716
28202,共產主義,1,598787,0.00016199,97.00002916
28203,共產革命,1,598788,0.00016199,97.00019115
28204,共產黨,1,598789,0.00016199,97.00035315
28205,共通性,1,598790,0.00016199,97.00051514
28206,共聚,1,598791,0.00016199,97.00067714
28207,共謀,1,598792,0.00016199,97.00083913
28208,共譜,1,598793,0.00016199,97.00100112
28209,再三,1,598794,0.00016199,97.00116312
28210,再生紙文具,1,598795,0.00016199,97.00132511
28211,再生緣,1,598796,0.00016199,97.00148711
28212,再生衛生紙,1,598797,0.00016199,97.00164910
28213,再見全壘打,1,598798,0.00016199,97.00181110
28214,再見斑斑,1,598799,0.00016199,97.00197309
28215,再版,1,598800,0.00016199,97.00213508
28216,再起,1,598801,0.00016199,97.00229708
28217,再循環燃燒裝置,1,598802,0.00016199,97.00245907
28218,再發,1,598803,0.00016199,97.00262107
28219,再發率,1,598804,0.00016199,97.00278306
28220,再會啦心愛的無緣的人,1,598805,0.00016199,97.00294505
28221,再領風騷,1,598806,0.00016199,97.00310705
28222,再戰,1,598807,0.00016199,97.00326904
28223,再議,1,598808,0.00016199,97.00343104
28224,再續,1,598809,0.00016199,97.00359303
28225,冰川堰塞湖,1,598810,0.00016199,97.00375503
28226,冰冰涼涼,1,598811,0.00016199,97.00391702
28227,冰血暴,1,598812,0.00016199,97.00407901
28228,冰河,1,598813,0.00016199,97.00424101
28229,冰品,1,598814,0.00016199,97.00440300
28230,冰柱,1,598815,0.00016199,97.00456500
28231,冰桶,1,598816,0.00016199,97.00472699
28232,冰敷,1,598817,0.00016199,97.00488899
28233,冰櫃,1,598818,0.00016199,97.00505098
28234,冰鎮,1,598819,0.00016199,97.00521297
28235,冰釀啤酒,1,598820,0.00016199,97.00537497
28236,列支敦士敦,1,598821,0.00016199,97.00553696
28237,列必希葉,1,598822,0.00016199,97.00569896
28238,列名,1,598823,0.00016199,97.00586095
28239,列隊,1,598824,0.00016199,97.00602294
28240,列傳,1,598825,0.00016199,97.00618494
28241,列寧之墓,1,598826,0.00016199,97.00634693
28242,列寧格勒,1,598827,0.00016199,97.00650893
28243,列寧運動場,1,598828,0.00016199,97.00667092
28244,刑求,1,598829,0.00016199,97.00683292
28245,刑事小隊長,1,598830,0.00016199,97.00699491
28246,刑法,1,598831,0.00016199,97.00715690
28247,刑場上婚禮,1,598832,0.00016199,97.00731890
28248,刑警,1,598833,0.00016199,97.00748089
28249,刑警大隊,1,598834,0.00016199,97.00764289
28250,划水,1,598835,0.00016199,97.00780488
28251,划得來,1,598836,0.00016199,97.00796688
28252,劣,1,598837,0.00016199,97.00812887
28253,劣化,1,598838,0.00016199,97.00829086
28254,劣根性,1,598839,0.00016199,97.00845286
28255,劣敗,1,598840,0.00016199,97.00861485
28256,劣等,1,598841,0.00016199,97.00877685
28257,劣質,1,598842,0.00016199,97.00893884
28258,匈牙利裔,1,598843,0.00016199,97.00910083
28259,匡正,1,598844,0.00016199,97.00926283
28260,匠心,1,598845,0.00016199,97.00942482
28261,印尼廠,1,598846,0.00016199,97.00958682
28262,印尼觀光局,1,598847,0.00016199,97.00974881
28263,印地安那州,1,598848,0.00016199,97.00991081
28264,印地安保衛戰,1,598849,0.00016199,97.01007280
28265,印字,1,598850,0.00016199,97.01023479
28266,印材,1,598851,0.00016199,97.01039679
28267,印刷公司,1,598852,0.00016199,97.01055878
28268,印刷術,1,598853,0.00016199,97.01072078
28269,印刷業,1,598854,0.00016199,97.01088277
28270,印刷電路板,1,598855,0.00016199,97.01104477
28271,印刷稿,1,598856,0.00016199,97.01120676
28272,印刷體,1,598857,0.00016199,97.01136875
28273,印泥,1,598858,0.00016199,97.01153075
28274,印花,1,598859,0.00016199,97.01169274
28275,印前作業,1,598860,0.00016199,97.01185474
28276,印度教神,1,598861,0.00016199,97.01201673
28277,印度菜,1,598862,0.00016199,97.01217872
28278,印度街,1,598863,0.00016199,97.01234072
28279,印度煎餅,1,598864,0.00016199,97.01250271
28280,印度橡膠樹,1,598865,0.00016199,97.01266471
28281,印染,1,598866,0.00016199,97.01282670
28282,印痕,1,598867,0.00016199,97.01298870
28283,印第安人,1,598868,0.00016199,97.01315069
28284,印第安瓊斯,1,598869,0.00016199,97.01331268
28285,印透,1,598870,0.00016199,97.01347468
28286,印象式,1,598871,0.00016199,97.01363667
28287,印順長老,1,598872,0.00016199,97.01379867
28288,印像派,1,598873,0.00016199,97.01396066
28289,印模,1,598874,0.00016199,97.01412266
28290,印鑑,1,598875,0.00016199,97.01428465
28291,印驗,1,598876,0.00016199,97.01444664
28292,危疑,1,598877,0.00016199,97.01460864
28293,危橋,1,598878,0.00016199,97.01477063
28294,危機四伏,1,598879,0.00016199,97.01493263
28295,危機企業,1,598880,0.00016199,97.01509462
28296,危機迷情,1,598881,0.00016199,97.01525661
28297,危險群,1,598882,0.00016199,97.01541861
28298,危顫顫,1,598883,0.00016199,97.01558060
28299,吉人,1,598884,0.00016199,97.01574260
28300,吉凶禍福,1,598885,0.00016199,97.01590459
28301,吉田義男,1,598886,0.00016199,97.01606659
28302,吉吉元,1,598887,0.00016199,97.01622858
28303,吉吉元電腦,1,598888,0.00016199,97.01639057
28304,吉米．韓翠克斯,1,598889,0.00016199,97.01655257
28305,吉米陳,1,598890,0.00016199,97.01671456
28306,吉伯地,1,598891,0.00016199,97.01687656
28307,吉利,1,598892,0.00016199,97.01703855
28308,吉利爾斯,1,598893,0.00016199,97.01720055
28309,吉奇,1,598894,0.00016199,97.01736254
28310,吉姆．諾史東,1,598895,0.00016199,97.01752453
28311,吉星,1,598896,0.00016199,97.01768653
28312,吉祥,1,598897,0.00016199,97.01784852
28313,吉普賽,1,598898,0.00016199,97.01801052
28314,吉爾邦節,1,598899,0.00016199,97.01817251
28315,吉爾夏漢,1,598900,0.00016199,97.01833451
28316,吉爾祿牛小排,1,598901,0.00016199,97.01849650
28317,吉諾,1,598902,0.00016199,97.01865849
28318,同一陣線,1,598903,0.00016199,97.01882049
28319,同不同意,1,598904,0.00016199,97.01898248
28320,同仇敵愾,1,598905,0.00016199,97.01914448
28321,同心,1,598906,0.00016199,97.01930647
28322,同心圓,1,598907,0.00016199,97.01946846
28323,同文,1,598908,0.00016199,97.01963046
28324,同台,1,598909,0.00016199,97.01979245
28325,同志愛,1,598910,0.00016199,97.01995445
28326,同步平行處理,1,598911,0.00016199,97.02011644
28327,同步系統,1,598912,0.00016199,97.02027844
28328,同步錄影,1,598913,0.00016199,97.02044043
28329,同享,1,598914,0.00016199,97.02060242
28330,同宗,1,598915,0.00016199,97.02076442
28331,同居人,1,598916,0.00016199,97.02092641
28332,同居大作戰,1,598917,0.00016199,97.02108841
28333,同治三年,1,598918,0.00016199,97.02125040
28334,同門,1,598919,0.00016199,97.02141240
28335,同型車,1,598920,0.00016199,97.02157439
28336,同胞愛,1,598921,0.00016199,97.02173638
28337,同棲,1,598922,0.00016199,97.02189838
28338,同軸,1,598923,0.00016199,97.02206037
28339,同量,1,598924,0.00016199,97.02222237
28340,同意書,1,598925,0.00016199,97.02238436
28341,同感,1,598926,0.00016199,97.02254635
28342,同源異性轉化,1,598927,0.00016199,97.02270835
28343,同遊,1,598928,0.00016199,97.02287034
28344,同僚,1,598929,0.00016199,97.02303234
28345,同聲,1,598930,0.00016199,97.02319433
28346,同歸於盡,1,598931,0.00016199,97.02335633
28347,同屬,1,598932,0.00016199,97.02351832
28348,吊動式木屋,1,598933,0.00016199,97.02368031
28349,吊橋,1,598934,0.00016199,97.02384231
28350,吐奶,1,598935,0.00016199,97.02400430
28351,吐氣,1,598936,0.00016199,97.02416630
28352,吐實,1,598937,0.00016199,97.02432829
28353,吐盡,1,598938,0.00016199,97.02449029
28354,吐魯番,1,598939,0.00016199,97.02465228
28355,各人,1,598940,0.00016199,97.02481427
28356,各州,1,598941,0.00016199,97.02497627
28357,各自為政,1,598942,0.00016199,97.02513826
28358,各個,1,598943,0.00016199,97.02530026
28359,各執一詞,1,598944,0.00016199,97.02546225
28360,向心,1,598945,0.00016199,97.02562424
28361,向外,1,598946,0.00016199,97.02578624
28362,向前,1,598947,0.00016199,97.02594823
28363,向後,1,598948,0.00016199,97.02611023
28364,向秋,1,598949,0.00016199,97.02627222
28365,向敞廳,1,598950,0.00016199,97.02643422
28366,向量推力,1,598951,0.00016199,97.02659621
28367,向量圖形,1,598952,0.00016199,97.02675820
28368,名山大川,1,598953,0.00016199,97.02692020
28369,名古屋,1,598954,0.00016199,97.02708219
28370,名目,1,598955,0.00016199,97.02724419
28371,名目利率,1,598956,0.00016199,97.02740618
28372,名位,1,598957,0.00016199,97.02756818
28373,名車,1,598958,0.00016199,97.02773017
28374,名佳利,1,598959,0.00016199,97.02789216
28375,名店,1,598960,0.00016199,97.02805416
28376,名狀,1,598961,0.00016199,97.02821615
28377,名流,1,598962,0.00016199,97.02837815
28378,名師,1,598963,0.00016199,97.02854014
28379,名副其實,1,598964,0.00016199,97.02870213
28380,名堂,1,598965,0.00016199,97.02886413
28381,名符其實,1,598966,0.00016199,97.02902612
28382,名設計師,1,598967,0.00016199,97.02918812
28383,名菜,1,598968,0.00016199,97.02935011
28384,名間鄉公所,1,598969,0.00016199,97.02951211
28385,名落孫山,1,598970,0.00016199,97.02967410
28386,名演員,1,598971,0.00016199,97.02983609
28387,名聞,1,598972,0.00016199,97.02999809
28388,名聞遐邇,1,598973,0.00016199,97.03016008
28389,名銜,1,598974,0.00016199,97.03032208
28390,名廚,1,598975,0.00016199,97.03048407
28391,名廠,1,598976,0.00016199,97.03064607
28392,名模,1,598977,0.00016199,97.03080806
28393,名駒,1,598978,0.00016199,97.03097005
28394,名導,1,598979,0.00016199,97.03113205
28395,名聲大噪,1,598980,0.00016199,97.03129404
28396,名藝術家,1,598981,0.00016199,97.03145604
28397,名譽理事,1,598982,0.00016199,97.03161803
28398,合十,1,598983,0.00016199,97.03178002
28399,合不合適,1,598984,0.00016199,97.03194202
28400,合用,1,598985,0.00016199,97.03210401
28401,合成皮,1,598986,0.00016199,97.03226601
28402,合成品,1,598987,0.00016199,97.03242800
28403,合成語音,1,598988,0.00016199,97.03259000
28404,合成膠,1,598989,0.00016199,97.03275199
28405,合而為一,1,598990,0.00016199,97.03291398
28406,合作度,1,598991,0.00016199,97.03307598
28407,合作備忘錄,1,598992,0.00016199,97.03323797
28408,合作經營,1,598993,0.00016199,97.03339997
28409,合作網,1,598994,0.00016199,97.03356196
28410,合身,1,598995,0.00016199,97.03372396
28411,合併症,1,598996,0.00016199,97.03388595
28412,合拍,1,598997,0.00016199,97.03404794
28413,合法性,1,598998,0.00016199,97.03420994
28414,合肥,1,598999,0.00016199,97.03437193
28415,合奏,1,599000,0.00016199,97.03453393
28416,合音,1,599001,0.00016199,97.03469592
28417,合音牆,1,599002,0.00016199,97.03485791
28418,合家歡台,1,599003,0.00016199,97.03501991
28419,合庫隊,1,599004,0.00016199,97.03518190
28420,合得來,1,599005,0.00016199,97.03534390
28421,合焦標示,1,599006,0.00016199,97.03550589
28422,合腳性,1,599007,0.00016199,97.03566789
28423,合解,1,599008,0.00016199,97.03582988
28424,合夥,1,599009,0.00016199,97.03599187
28425,合算,1,599010,0.00016199,97.03615387
28426,合影,1,599011,0.00016199,97.03631586
28427,合縱,1,599012,0.00016199,97.03647786
28428,吃下來,1,599013,0.00016199,97.03663985
28429,吃不消,1,599014,0.00016199,97.03680185
28430,吃奶,1,599015,0.00016199,97.03696384
28431,吃光,1,599016,0.00016199,97.03712583
28432,吃吃,1,599017,0.00016199,97.03728783
28433,吃吃看,1,599018,0.00016199,97.03744982
28434,吃角子老虎,1,599019,0.00016199,97.03761182
28435,吃到,1,599020,0.00016199,97.03777381
28436,吃法,1,599021,0.00016199,97.03793580
28437,吃苦,1,599022,0.00016199,97.03809780
28438,吃苦耐勞,1,599023,0.00016199,97.03825979
28439,吃素,1,599024,0.00016199,97.03842179
28440,吃喝,1,599025,0.00016199,97.03858378
28441,吃喝院,1,599026,0.00016199,97.03874578
28442,吃過,1,599027,0.00016199,97.03890777
28443,吃藥,1,599028,0.00016199,97.03906976
28444,后,1,599029,0.00016199,97.03923176
28445,因人而異,1,599030,0.00016199,97.03939375
28446,因地制宜,1,599031,0.00016199,97.03955575
28447,因材施教,1,599032,0.00016199,97.03971774
28448,因果,1,599033,0.00016199,97.03987974
28449,因果關係,1,599034,0.00016199,97.04004173
28450,因故,1,599035,0.00016199,97.04020372
28451,因噎廢食,1,599036,0.00016199,97.04036572
28452,因數,1,599037,0.00016199,97.04052771
28453,回吐,1,599038,0.00016199,97.04068971
28454,回存,1,599039,0.00016199,97.04085170
28455,回扣,1,599040,0.00016199,97.04101369
28456,回收商,1,599041,0.00016199,97.04117569
28457,回降,1,599042,0.00016199,97.04133768
28458,回修,1,599043,0.00016199,97.04149968
28459,回娘家,1,599044,0.00016199,97.04166167
28460,回挫,1,599045,0.00016199,97.04182367
28461,回航,1,599046,0.00016199,97.04198566
28462,回巢,1,599047,0.00016199,97.04214765
28463,回族,1,599048,0.00016199,97.04230965
28464,回票,1,599049,0.00016199,97.04247164
28465,回軟,1,599050,0.00016199,97.04263364
28466,回報率,1,599051,0.00016199,97.04279563
28467,回程,1,599052,0.00016199,97.04295763
28468,回跌,1,599053,0.00016199,97.04311962
28469,回想起來,1,599054,0.00016199,97.04328161
28470,回敬,1,599055,0.00016199,97.04344361
28471,回暖,1,599056,0.00016199,97.04360560
28472,回溯,1,599057,0.00016199,97.04376760
28473,回溯相容,1,599058,0.00016199,97.04392959
28474,回溫,1,599059,0.00016199,97.04409158
28475,回落,1,599060,0.00016199,97.04425358
28476,回頭路,1,599061,0.00016199,97.04441557
28477,回禮,1,599062,0.00016199,97.04457757
28478,回覆,1,599063,0.00016199,97.04473956
28479,回覆碼,1,599064,0.00016199,97.04490156
28480,回餽,1,599065,0.00016199,97.04506355
28481,回穩,1,599066,0.00016199,97.04522554
28482,回贈,1,599067,0.00016199,97.04538754
28483,囝仔子,1,599068,0.00016199,97.04554953
28484,地力,1,599069,0.00016199,97.04571153
28485,地下工廠,1,599070,0.00016199,97.04587352
28486,地下情,1,599071,0.00016199,97.04603552
28487,地下通道,1,599072,0.00016199,97.04619751
28488,地下街,1,599073,0.00016199,97.04635950
28489,地下管道,1,599074,0.00016199,97.04652150
28490,地下鐵,1,599075,0.00016199,97.04668349
28491,地上石,1,599076,0.00016199,97.04684549
28492,地大物博,1,599077,0.00016199,97.04700748
28493,地方小吃,1,599078,0.00016199,97.04716948
28494,地方主義,1,599079,0.00016199,97.04733147
28495,地方自治,1,599080,0.00016199,97.04749346
28496,地方法院,1,599081,0.00016199,97.04765546
28497,地方稅,1,599082,0.00016199,97.04781745
28498,地主之誼,1,599083,0.00016199,97.04797945
28499,地平線,1,599084,0.00016199,97.04814144
28500,地母神,1,599085,0.00016199,97.04830343
28501,地穴,1,599086,0.00016199,97.04846543
28502,地利之便,1,599087,0.00016199,97.04862742
28503,地板面積,1,599088,0.00016199,97.04878942
28504,地界,1,599089,0.00016199,97.04895141
28505,地峽,1,599090,0.00016199,97.04911341
28506,地庫,1,599091,0.00016199,97.04927540
28507,地脈,1,599092,0.00016199,97.04943739
28508,地院,1,599093,0.00016199,97.04959939
28509,地域性,1,599094,0.00016199,97.04976138
28510,地產股,1,599095,0.00016199,97.04992338
28511,地雷,1,599096,0.00016199,97.05008537
28512,地獄道,1,599097,0.00016199,97.05024737
28513,地獄蒸料理,1,599098,0.00016199,97.05040936
28514,地磁,1,599099,0.00016199,97.05057135
28515,地磁儀,1,599100,0.00016199,97.05073335
28516,地層,1,599101,0.00016199,97.05089534
28517,地標性,1,599102,0.00016199,97.05105734
28518,地緣關係,1,599103,0.00016199,97.05121933
28519,地質學家,1,599104,0.00016199,97.05138132
28520,地磚,1,599105,0.00016199,97.05154332
28521,地攤,1,599106,0.00016199,97.05170531
28522,在下,1,599107,0.00016199,97.05186731
28523,在台居留權,1,599108,0.00016199,97.05202930
28524,在地人,1,599109,0.00016199,97.05219130
28525,在此之外,1,599110,0.00016199,97.05235329
28526,在位,1,599111,0.00016199,97.05251528
28527,在家居士,1,599112,0.00016199,97.05267728
28528,在座,1,599113,0.00016199,97.05283927
28529,在校生,1,599114,0.00016199,97.05300127
28530,在野,1,599115,0.00016199,97.05316326
28531,在職訓練,1,599116,0.00016199,97.05332526
28532,在職婦女,1,599117,0.00016199,97.05348725
28533,夙,1,599118,0.00016199,97.05364924
28534,多一點,1,599119,0.00016199,97.05381124
28535,多工,1,599120,0.00016199,97.05397323
28536,多元文化,1,599121,0.00016199,97.05413523
28537,多日,1,599122,0.00016199,97.05429722
28538,多伯斯,1,599123,0.00016199,97.05445921
28539,多角,1,599124,0.00016199,97.05462121
28540,多明尼加,1,599125,0.00016199,97.05478320
28541,多明尼克,1,599126,0.00016199,97.05494520
28542,多明尼亞,1,599127,0.00016199,97.05510719
28543,多空扭轉,1,599128,0.00016199,97.05526919
28544,多采,1,599129,0.00016199,97.05543118
28545,多金族,1,599130,0.00016199,97.05559317
28546,多姿,1,599131,0.00016199,97.05575517
28547,多姿多采,1,599132,0.00016199,97.05591716
28548,多面性,1,599133,0.00016199,97.05607916
28549,多娜．羅亞布,1,599134,0.00016199,97.05624115
28550,多恩布許,1,599135,0.00016199,97.05640315
28551,多彩,1,599136,0.00016199,97.05656514
28552,多情,1,599137,0.00016199,97.05672713
28553,多處,1,599138,0.00016199,97.05688913
28554,多連桿,1,599139,0.00016199,97.05705112
28555,多媒體文件,1,599140,0.00016199,97.05721312
28556,多媒體光碟,1,599141,0.00016199,97.05737511
28557,多媒體系統,1,599142,0.00016199,97.05753710
28558,多媒體延伸,1,599143,0.00016199,97.05769910
28559,多媒體物件,1,599144,0.00016199,97.05786109
28560,多媒體指令集延伸,1,599145,0.00016199,97.05802309
28561,多媒體革命,1,599146,0.00016199,97.05818508
28562,多項化,1,599147,0.00016199,97.05834708
28563,多愁善感,1,599148,0.00016199,97.05850907
28564,多瑙河,1,599149,0.00016199,97.05867106
28565,多較,1,599150,0.00016199,97.05883306
28566,多疑,1,599151,0.00016199,97.05899505
28567,多種,1,599152,0.00016199,97.05915705
28568,多管齊下,1,599153,0.00016199,97.05931904
28569,多語制,1,599154,0.00016199,97.05948104
28570,多層,1,599155,0.00016199,97.05964303
28571,多層次,1,599156,0.00016199,97.05980502
28572,多慮,1,599157,0.00016199,97.05996702
28573,多數人,1,599158,0.00016199,97.06012901
28574,多頭行情,1,599159,0.00016199,97.06029101
28575,多點噴射供油系統,1,599160,0.00016199,97.06045300
28576,多邊,1,599161,0.00016199,97.06061499
28577,多囊性,1,599162,0.00016199,97.06077699
28578,多胜鍊,1,599163,0.00016199,97.06093898
28579,夷平,1,599164,0.00016199,97.06110098
28580,妄自菲薄,1,599165,0.00016199,97.06126297
28581,奸險,1,599166,0.00016199,97.06142497
28582,好大喜功,1,599167,0.00016199,97.06158696
28583,好比,1,599168,0.00016199,97.06174895
28584,好好笑,1,599169,0.00016199,97.06191095
28585,好男好女,1,599170,0.00016199,97.06207294
28586,好事多磨,1,599171,0.00016199,97.06223494
28587,好來塢,1,599172,0.00016199,97.06239693
28588,好書大家讀,1,599173,0.00016199,97.06255893
28589,好起來,1,599174,0.00016199,97.06272092
28590,好酒,1,599175,0.00016199,97.06288291
28591,好鬥,1,599176,0.00016199,97.06304491
28592,好動,1,599177,0.00016199,97.06320690
28593,好強,1,599178,0.00016199,97.06336890
28594,好訟,1,599179,0.00016199,97.06353089
28595,好勝,1,599180,0.00016199,97.06369288
28596,好報,1,599181,0.00016199,97.06385488
28597,好幾天,1,599182,0.00016199,97.06401687
28598,好惡,1,599183,0.00016199,97.06417887
28599,好景,1,599184,0.00016199,97.06434086
28600,好景不常,1,599185,0.00016199,97.06450286
28601,好萊塢山莊,1,599186,0.00016199,97.06466485
28602,好萊塢國際廣播獎,1,599187,0.00016199,97.06482684
28603,好菜,1,599188,0.00016199,97.06498884
28604,好貴,1,599189,0.00016199,97.06515083
28605,好意,1,599190,0.00016199,97.06531283
28606,好腳,1,599191,0.00016199,97.06547482
28607,好過,1,599192,0.00016199,97.06563682
28608,好戰,1,599193,0.00016199,97.06579881
28609,好戲,1,599194,0.00016199,97.06596080
28610,好膽,1,599195,0.00016199,97.06612280
28611,如火如荼,1,599196,0.00016199,97.06628479
28612,如有,1,599197,0.00016199,97.06644679
28613,如此看來,1,599198,0.00016199,97.06660878
28614,如何是好,1,599199,0.00016199,97.06677077
28615,如何做一本書,1,599200,0.00016199,97.06693277
28616,如何做菜最營養,1,599201,0.00016199,97.06709476
28617,如沐春風,1,599202,0.00016199,97.06725676
28618,如果恐龍回來了,1,599203,0.00016199,97.06741875
28619,如法泡製,1,599204,0.00016199,97.06758075
28620,如虎添翼,1,599205,0.00016199,97.06774274
28621,如要,1,599206,0.00016199,97.06790473
28622,如席,1,599207,0.00016199,97.06806673
28623,如能,1,599208,0.00016199,97.06822872
28624,如假包換,1,599209,0.00016199,97.06839072
28625,如常,1,599210,0.00016199,97.06855271
28626,如喪考妣,1,599211,0.00016199,97.06871471
28627,如雷,1,599212,0.00016199,97.06887670
28628,如雷貫耳,1,599213,0.00016199,97.06903869
28629,如圖,1,599214,0.00016199,97.06920069
28630,如獲至寶,1,599215,0.00016199,97.06936268
28631,字母的字串,1,599216,0.00016199,97.06952468
28632,字面,1,599217,0.00016199,97.06968667
28633,字庫,1,599218,0.00016199,97.06984866
28634,字紙簍,1,599219,0.00016199,97.07001066
28635,字集,1,599220,0.00016199,97.07017265
28636,字寫體,1,599221,0.00016199,97.07033465
28637,字蟲,1,599222,0.00016199,97.07049664
28638,存亡,1,599223,0.00016199,97.07065864
28639,存心,1,599224,0.00016199,97.07082063
28640,存回,1,599225,0.00016199,97.07098262
28641,存在主義,1,599226,0.00016199,97.07114462
28642,存放款比率,1,599227,0.00016199,97.07130661
28643,存摺,1,599228,0.00016199,97.07146861
28644,存疑,1,599229,0.00016199,97.07163060
28645,存廢,1,599230,0.00016199,97.07179260
28646,存證,1,599231,0.00016199,97.07195459
28647,存續期間,1,599232,0.00016199,97.07211658
28648,宇,1,599233,0.00016199,97.07227858
28649,宇宙操,1,599234,0.00016199,97.07244057
28650,宇航公司,1,599235,0.00016199,97.07260257
28651,守口如瓶,1,599236,0.00016199,97.07276456
28652,守方,1,599237,0.00016199,97.07292656
28653,守法,1,599238,0.00016199,97.07308855
28654,守候,1,599239,0.00016199,97.07325054
28655,守密,1,599240,0.00016199,97.07341254
28656,守緊,1,599241,0.00016199,97.07357453
28657,守衛處,1,599242,0.00016199,97.07373653
28658,守護,1,599243,0.00016199,97.07389852
28659,安比西林,1,599244,0.00016199,97.07406051
28660,安可曲,1,599245,0.00016199,97.07422251
28661,安打王,1,599246,0.00016199,97.07438450
28662,安生醫院,1,599247,0.00016199,97.07454650
28663,安全人員,1,599248,0.00016199,97.07470849
28664,安全存糧,1,599249,0.00016199,97.07487049
28665,安全扣,1,599250,0.00016199,97.07503248
28666,安全把,1,599251,0.00016199,97.07519447
28667,安全係數,1,599252,0.00016199,97.07535647
28668,安全資訊,1,599253,0.00016199,97.07551846
28669,安全燈,1,599254,0.00016199,97.07568046
28670,安吉拉,1,599255,0.00016199,97.07584245
28671,安吉維勒,1,599256,0.00016199,97.07600445
28672,安地斯山,1,599257,0.00016199,97.07616644
28673,安好,1,599258,0.00016199,97.07632843
28674,安安—和白血病作戰的男孩,1,599259,0.00016199,97.07649043
28675,安安心心,1,599260,0.00016199,97.07665242
28676,安安靜靜,1,599261,0.00016199,97.07681442
28677,安住,1,599262,0.00016199,97.07697641
28678,安克先娜門,1,599263,0.00016199,97.07713840
28679,安克赫吉,1,599264,0.00016199,97.07730040
28680,安坑,1,599265,0.00016199,97.07746239
28681,安那托力亞高原,1,599266,0.00016199,97.07762439
28682,安坦卡拉,1,599267,0.00016199,97.07778638
28683,安妮班克勞馥,1,599268,0.00016199,97.07794838
28684,安居樂業,1,599269,0.00016199,97.07811037
28685,安放,1,599270,0.00016199,97.07827236
28686,安東尼歐班德拉斯,1,599271,0.00016199,97.07843436
28687,安東尼霍普金斯,1,599272,0.00016199,97.07859635
28688,安東尼戴考尼斯,1,599273,0.00016199,97.07875835
28689,安迪．沃荷,1,599274,0.00016199,97.07892034
28690,安泰富士山信託,1,599275,0.00016199,97.07908234
28691,安特斯．佩尼卡,1,599276,0.00016199,97.07924433
28692,安眠,1,599277,0.00016199,97.07940632
28693,安得森,1,599278,0.00016199,97.07956832
28694,安祥,1,599279,0.00016199,97.07973031
28695,安富利,1,599280,0.00016199,97.07989231
28696,安插,1,599281,0.00016199,97.08005430
28697,安斯特．佩尼卡,1,599282,0.00016199,97.08021629
28698,安然自怡,1,599283,0.00016199,97.08037829
28699,安然抵達,1,599284,0.00016199,97.08054028
28700,安然無恙,1,599285,0.00016199,97.08070228
28701,安琪兒,1,599286,0.00016199,97.08086427
28702,安琪拉貝塞,1,599287,0.00016199,97.08102627
28703,安葬,1,599288,0.00016199,97.08118826
28704,安德,1,599289,0.00016199,97.08135025
28705,安調,1,599290,0.00016199,97.08151225
28706,安養,1,599291,0.00016199,97.08167424
28707,安謐,1,599292,0.00016199,97.08183624
28708,寺廟燈,1,599293,0.00016199,97.08199823
28709,尖牙,1,599294,0.00016199,97.08216023
28710,尖兵,1,599295,0.00016199,97.08232222
28711,尖沙咀,1,599296,0.00016199,97.08248421
28712,尖細,1,599297,0.00016199,97.08264621
28713,尖頂,1,599298,0.00016199,97.08280820
28714,尖塔,1,599299,0.00016199,97.08297020
28715,尖端資訊技術中心,1,599300,0.00016199,97.08313219
28716,尖酸刻薄,1,599301,0.00016199,97.08329418
28717,尖領,1,599302,0.00016199,97.08345618
28718,尖鋒,1,599303,0.00016199,97.08361817
28719,尖聲,1,599304,0.00016199,97.08378017
28720,州民,1,599305,0.00016199,97.08394216
28721,州立法局,1,599306,0.00016199,97.08410416
28722,州政府,1,599307,0.00016199,97.08426615
28723,州檢察總長,1,599308,0.00016199,97.08442814
28724,帆布,1,599309,0.00016199,97.08459014
28725,帆布畫,1,599310,0.00016199,97.08475213
28726,帆船鞋,1,599311,0.00016199,97.08491413
28727,并,1,599312,0.00016199,97.08507612
28728,年中,1,599313,0.00016199,97.08523812
28729,年平均,1,599314,0.00016199,97.08540011
28730,年平均值,1,599315,0.00016199,97.08556210
28731,年式,1,599316,0.00016199,97.08572410
28732,年住房率,1,599317,0.00016199,97.08588609
28733,年事已高,1,599318,0.00016199,97.08604809
28734,年所得,1,599319,0.00016199,97.08621008
28735,年度盈利,1,599320,0.00016199,97.08637207
28736,年度費,1,599321,0.00016199,97.08653407
28737,年租金,1,599322,0.00016199,97.08669606
28738,年產值,1,599323,0.00016199,97.08685806
28739,年產能,1,599324,0.00016199,97.08702005
28740,年貨,1,599325,0.00016199,97.08718205
28741,年報酬率,1,599326,0.00016199,97.08734404
28742,年歲,1,599327,0.00016199,97.08750603
28743,年經濟成長率,1,599328,0.00016199,97.08766803
28744,年資,1,599329,0.00016199,97.08783002
28745,年滿,1,599330,0.00016199,97.08799202
28746,年輕力壯,1,599331,0.00016199,97.08815401
28747,年輕化,1,599332,0.00016199,97.08831601
28748,年需求量,1,599333,0.00016199,97.08847800
28749,年銷售額,1,599334,0.00016199,97.08863999
28750,年獲利,1,599335,0.00016199,97.08880199
28751,年籍,1,599336,0.00016199,97.08896398
28752,忙完,1,599337,0.00016199,97.08912598
28753,忙裡偷閒,1,599338,0.00016199,97.08928797
28754,成人刊物,1,599339,0.00016199,97.08944996
28755,成人飲品,1,599340,0.00016199,97.08961196
28756,成人節目,1,599341,0.00016199,97.08977395
28757,成千上百,1,599342,0.00016199,97.08993595
28758,成不成功,1,599343,0.00016199,97.09009794
28759,成天,1,599344,0.00016199,97.09025994
28760,成功級艦,1,599345,0.00016199,97.09042193
28761,成功高中,1,599346,0.00016199,97.09058392
28762,成功路,1,599347,0.00016199,97.09074592
28763,成交率,1,599348,0.00016199,97.09090791
28764,成名作,1,599349,0.00016199,97.09106991
28765,成因,1,599350,0.00016199,97.09123190
28766,成衣業,1,599351,0.00016199,97.09139390
28767,成衣零售商,1,599352,0.00016199,97.09155589
28768,成串,1,599353,0.00016199,97.09171788
28769,成形術,1,599354,0.00016199,97.09187988
28770,成果報告,1,599355,0.00016199,97.09204187
28771,成長股,1,599356,0.00016199,97.09220387
28772,成長期,1,599357,0.00016199,97.09236586
28773,成則為王,1,599358,0.00016199,97.09252785
28774,成倍,1,599359,0.00016199,97.09268985
28775,成員國,1,599360,0.00016199,97.09285184
28776,成家立業,1,599361,0.00016199,97.09301384
28777,成真,1,599362,0.00016199,97.09317583
28778,成都,1,599363,0.00016199,97.09333783
28779,成報,1,599364,0.00016199,97.09349982
28780,成對,1,599365,0.00016199,97.09366181
28781,成數,1,599366,0.00016199,97.09382381
28782,成熟品,1,599367,0.00016199,97.09398580
28783,成癮,1,599368,0.00016199,97.09414780
28784,扣人心弦,1,599369,0.00016199,97.09430979
28785,扣分,1,599370,0.00016199,97.09447179
28786,扣押,1,599371,0.00016199,97.09463378
28787,扣減,1,599372,0.00016199,97.09479577
28788,扣緊,1,599373,0.00016199,97.09495777
28789,扣應,1,599374,0.00016199,97.09511976
28790,托米,1,599375,0.00016199,97.09528176
28791,托兒,1,599376,0.00016199,97.09544375
28792,托庸,1,599377,0.00016199,97.09560574
28793,托魯奇,1,599378,0.00016199,97.09576774
28794,收心,1,599379,0.00016199,97.09592973
28795,收支,1,599380,0.00016199,97.09609173
28796,收付款,1,599381,0.00016199,97.09625372
28797,收市,1,599382,0.00016199,97.09641572
28798,收伏,1,599383,0.00016199,97.09657771
28799,收件箱,1,599384,0.00016199,97.09673970
28800,收兵,1,599385,0.00016199,97.09690170
28801,收走,1,599386,0.00016199,97.09706369
28802,收放,1,599387,0.00016199,97.09722569
28803,收服,1,599388,0.00016199,97.09738768
28804,收屍,1,599389,0.00016199,97.09754968
28805,收紅,1,599390,0.00016199,97.09771167
28806,收容,1,599391,0.00016199,97.09787366
28807,收益型,1,599392,0.00016199,97.09803566
28808,收納架,1,599393,0.00016199,97.09819765
28809,收納盒,1,599394,0.00016199,97.09835965
28810,收納櫃,1,599395,0.00016199,97.09852164
28811,收訊,1,599396,0.00016199,97.09868363
28812,收起,1,599397,0.00016199,97.09884563
28813,收報機,1,599398,0.00016199,97.09900762
28814,收復,1,599399,0.00016199,97.09916962
28815,收發,1,599400,0.00016199,97.09933161
28816,收視戶,1,599401,0.00016199,97.09949361
28817,收費站,1,599402,0.00016199,97.09965560
28818,收費處,1,599403,0.00016199,97.09981759
28819,收運,1,599404,0.00016199,97.09997959
28820,收歌,1,599405,0.00016199,97.10014158
28821,收齊,1,599406,0.00016199,97.10030358
28822,收價,1,599407,0.00016199,97.10046557
28823,收盤指數,1,599408,0.00016199,97.10062757
28824,收盤價,1,599409,0.00016199,97.10078956
28825,收養,1,599410,0.00016199,97.10095155
28826,收獲,1,599411,0.00016199,97.10111355
28827,收購量,1,599412,0.00016199,97.10127554
28828,收藏品,1,599413,0.00016199,97.10143754
28829,收藏架,1,599414,0.00016199,97.10159953
28830,收穫量,1,599415,0.00016199,97.10176153
28831,收歛,1,599416,0.00016199,97.10192352
28832,早川,1,599417,0.00016199,97.10208551
28833,早老年性癡呆,1,599418,0.00016199,97.10224751
28834,早飯,1,599419,0.00016199,97.10240950
28835,早會,1,599420,0.00016199,97.10257150
28836,早熟,1,599421,0.00016199,97.10273349
28837,早點,1,599422,0.00016199,97.10289548
28838,早覺會,1,599423,0.00016199,97.10305748
28839,旨意,1,599424,0.00016199,97.10321947
28840,旨趣,1,599425,0.00016199,97.10338147
28841,旬,1,599426,0.00016199,97.10354346
28842,旭青,1,599427,0.00016199,97.10370546
28843,旭麗,1,599428,0.00016199,97.10386745
28844,曲由,1,599429,0.00016199,97.10402944
28845,曲度,1,599430,0.00016199,97.10419144
28846,曲柄式,1,599431,0.00016199,97.10435343
28847,曲射砲,1,599432,0.00016199,97.10451543
28848,曲高和寡,1,599433,0.00016199,97.10467742
28849,曲終人散,1,599434,0.00016199,97.10483942
28850,曲軸,1,599435,0.00016199,97.10500141
28851,曲解,1,599436,0.00016199,97.10516340
28852,曲齒聯結器,1,599437,0.00016199,97.10532540
28853,曲藝,1,599438,0.00016199,97.10548739
28854,曳光,1,599439,0.00016199,97.10564939
28855,有女飛天,1,599440,0.00016199,97.10581138
28856,有心者,1,599441,0.00016199,97.10597337
28857,有功,1,599442,0.00016199,97.10613537
28858,有成,1,599443,0.00016199,97.10629736
28859,有別,1,599444,0.00016199,97.10645936
28860,有利可圖,1,599445,0.00016199,97.10662135
28861,有利點,1,599446,0.00016199,97.10678335
28862,有所不同,1,599447,0.00016199,97.10694534
28863,有所爭議,1,599448,0.00016199,97.10710733
28864,有所保留,1,599449,0.00016199,97.10726933
28865,有所突破,1,599450,0.00016199,97.10743132
28866,有勁,1,599451,0.00016199,97.10759332
28867,有型,1,599452,0.00016199,97.10775531
28868,有為,1,599453,0.00016199,97.10791731
28869,有限公司,1,599454,0.00016199,97.10807930
28870,有害物品,1,599455,0.00016199,97.10824129
28871,有效日期,1,599456,0.00016199,97.10840329
28872,有效性,1,599457,0.00016199,97.10856528
28873,有氧舞蹈,1,599458,0.00016199,97.10872728
28874,有益身心,1,599459,0.00016199,97.10888927
28875,有夠,1,599460,0.00016199,97.10905126
28876,有教無類,1,599461,0.00016199,97.10921326
28877,有條不紊,1,599462,0.00016199,97.10937525
28878,有袋族,1,599463,0.00016199,97.10953725
28879,有備而來,1,599464,0.00016199,97.10969924
28880,有朝一日,1,599465,0.00016199,97.10986124
28881,有意無意,1,599466,0.00016199,97.11002323
28882,有意義,1,599467,0.00016199,97.11018522
28883,有感而發,1,599468,0.00016199,97.11034722
28884,有話要問,1,599469,0.00016199,97.11050921
28885,有增無減,1,599470,0.00016199,97.11067121
28886,有模有樣,1,599471,0.00016199,97.11083320
28887,有線頻道,1,599472,0.00016199,97.11099520
28888,有餘,1,599473,0.00016199,97.11115719
28889,有機矽化合物,1,599474,0.00016199,97.11131918
28890,有機酸,1,599475,0.00016199,97.11148118
28891,有機體,1,599476,0.00016199,97.11164317
28892,有興趣,1,599477,0.00016199,97.11180517
28893,有賴,1,599478,0.00016199,97.11196716
28894,有藤,1,599479,0.00016199,97.11212915
28895,有關單位,1,599480,0.00016199,97.11229115
28896,有關當局,1,599481,0.00016199,97.11245314
28897,朴,1,599482,0.00016199,97.11261514
28898,朴仁哲,1,599483,0.00016199,97.11277713
28899,朱士廷,1,599484,0.00016199,97.11293913
28900,朱元璋,1,599485,0.00016199,97.11310112
28901,朱文公,1,599486,0.00016199,97.11326311
28902,朱失文,1,599487,0.00016199,97.11342511
28903,朱旭建,1,599488,0.00016199,97.11358710
28904,朱邦復,1,599489,0.00016199,97.11374910
28905,朱坤茂,1,599490,0.00016199,97.11391109
28906,朱俊奇,1,599491,0.00016199,97.11407309
28907,朱為正,1,599492,0.00016199,97.11423508
28908,朱家故事,1,599493,0.00016199,97.11439707
28909,朱家瑩,1,599494,0.00016199,97.11455907
28910,朱格諾夫,1,599495,0.00016199,97.11472106
28911,朱曼黎,1,599496,0.00016199,97.11488306
28912,朱國鳳,1,599497,0.00016199,97.11504505
28913,朱鳳妹,1,599498,0.00016199,97.11520704
28914,朱甌,1,599499,0.00016199,97.11536904
28915,朱麗克莉絲蒂,1,599500,0.00016199,97.11553103
28916,朱麗觀,1,599501,0.00016199,97.11569303
28917,朵夫曼,1,599502,0.00016199,97.11585502
28918,次子宮,1,599503,0.00016199,97.11601702
28919,次系統,1,599504,0.00016199,97.11617901
28920,次級團體,1,599505,0.00016199,97.11634100
28921,次等,1,599506,0.00016199,97.11650300
28922,此行,1,599507,0.00016199,97.11666499
28923,此事,1,599508,0.00016199,97.11682699
28924,此刻,1,599509,0.00016199,97.11698898
28925,此後,1,599510,0.00016199,97.11715098
28926,此番,1,599511,0.00016199,97.11731297
28927,此際,1,599512,0.00016199,97.11747496
28928,死不休,1,599513,0.00016199,97.11763696
28929,死心塌地,1,599514,0.00016199,97.11779895
28930,死水,1,599515,0.00016199,97.11796095
28931,死囚犯,1,599516,0.00016199,97.11812294
28932,死刑的迷思,1,599517,0.00016199,97.11828493
28933,死灰復燃,1,599518,0.00016199,97.11844693
28934,死而復生,1,599519,0.00016199,97.11860892
28935,死角,1,599520,0.00016199,97.11877092
28936,死命,1,599521,0.00016199,97.11893291
28937,死板,1,599522,0.00016199,97.11909491
28938,死屍,1,599523,0.00016199,97.11925690
28939,死活,1,599524,0.00016199,97.11941889
28940,死相,1,599525,0.00016199,97.11958089
28941,死訊,1,599526,0.00016199,97.11974288
28942,死寂,1,599527,0.00016199,97.11990488
28943,死硬,1,599528,0.00016199,97.12006687
28944,死傷,1,599529,0.00016199,97.12022887
28945,死裡逃生,1,599530,0.00016199,97.12039086
28946,死錢,1,599531,0.00016199,97.12055285
28947,死黨,1,599532,0.00016199,97.12071485
28948,汗毛,1,599533,0.00016199,97.12087684
28949,汗馬功勞,1,599534,0.00016199,97.12103884
28950,汗圈,1,599535,0.00016199,97.12120083
28951,汗液,1,599536,0.00016199,97.12136282
28952,汙,1,599537,0.00016199,97.12152482
28953,汙水處理廠,1,599538,0.00016199,97.12168681
28954,汙垢,1,599539,0.00016199,97.12184881
28955,汙染防治技術發展中心,1,599540,0.00016199,97.12201080
28956,汙染物,1,599541,0.00016199,97.12217280
28957,汙衊,1,599542,0.00016199,97.12233479
28958,江元慶,1,599543,0.00016199,97.12249678
28959,江戶時代,1,599544,0.00016199,97.12265878
28960,江米條,1,599545,0.00016199,97.12282077
28961,江西,1,599546,0.00016199,97.12298277
28962,江克賢,1,599547,0.00016199,97.12314476
28963,江防砲艇,1,599548,0.00016199,97.12330676
28964,江映瑤,1,599549,0.00016199,97.12346875
28965,江泰權,1,599550,0.00016199,97.12363074
28966,江淑娜,1,599551,0.00016199,97.12379274
28967,江船,1,599552,0.00016199,97.12395473
28968,江湖恩怨,1,599553,0.00016199,97.12411673
28969,江湖級,1,599554,0.00016199,97.12427872
28970,江圖,1,599555,0.00016199,97.12444071
28971,江衛級,1,599556,0.00016199,97.12460271
28972,江聰昊,1,599557,0.00016199,97.12476470
28973,池沼,1,599558,0.00016199,97.12492670
28974,池華瓊,1,599559,0.00016199,97.12508869
28975,汕尾,1,599560,0.00016199,97.12525069
28976,汕頭紅,1,599561,0.00016199,97.12541268
28977,污水,1,599562,0.00016199,97.12557467
28978,污物,1,599563,0.00016199,97.12573667
28979,污染性,1,599564,0.00016199,97.12589866
28980,污染物質,1,599565,0.00016199,97.12606066
28981,污辱,1,599566,0.00016199,97.12622265
28982,污漬,1,599567,0.00016199,97.12638465
28983,灰土,1,599568,0.00016199,97.12654664
28984,灰白,1,599569,0.00016199,97.12670863
28985,灰灰,1,599570,0.00016199,97.12687063
28986,灰灰黃黃,1,599571,0.00016199,97.12703262
28987,灰色調,1,599572,0.00016199,97.12719462
28988,灰沈沈,1,599573,0.00016199,97.12735661
28989,灰泥,1,599574,0.00016199,97.12751860
28990,灰狗,1,599575,0.00016199,97.12768060
28991,灰袍,1,599576,0.00016199,97.12784259
28992,灰棕色,1,599577,0.00016199,97.12800459
28993,灰黃色,1,599578,0.00016199,97.12816658
28994,灰黑,1,599579,0.00016199,97.12832858
28995,灰綠色,1,599580,0.00016199,97.12849057
28996,灰褐色,1,599581,0.00016199,97.12865256
28997,灰頭土臉,1,599582,0.00016199,97.12881456
28998,灰藍,1,599583,0.00016199,97.12897655
28999,灰黯,1,599584,0.00016199,97.12913855
29000,牟玉珮,1,599585,0.00016199,97.12930054
29001,牟矛,1,599586,0.00016199,97.12946254
29002,百忙,1,599587,0.00016199,97.12962453
29003,百老匯上空子彈,1,599588,0.00016199,97.12978652
29004,百步蛇,1,599589,0.00016199,97.12994852
29005,百佳公司,1,599590,0.00016199,97.13011051
29006,百花怒放,1,599591,0.00016199,97.13027251
29007,百威,1,599592,0.00016199,97.13043450
29008,百威啤酒,1,599593,0.00016199,97.13059650
29009,百帝廣告,1,599594,0.00016199,97.13075849
29010,百帝廣告集團,1,599595,0.00016199,97.13092048
29011,百思不解,1,599596,0.00016199,97.13108248
29012,百家,1,599597,0.00016199,97.13124447
29013,百家爭鳴,1,599598,0.00016199,97.13140647
29014,百病纏身,1,599599,0.00016199,97.13156846
29015,百般刁難,1,599600,0.00016199,97.13173045
29016,百貨界,1,599601,0.00016199,97.13189245
29017,百貨零售店,1,599602,0.00016199,97.13205444
29018,百貨類,1,599603,0.00016199,97.13221644
29019,百連公司,1,599604,0.00016199,97.13237843
29020,百連木屋,1,599605,0.00016199,97.13254043
29021,百連企業有限公司,1,599606,0.00016199,97.13270242
29022,百感交集,1,599607,0.00016199,97.13286441
29023,百歲酒,1,599608,0.00016199,97.13302641
29024,百萬富翁,1,599609,0.00016199,97.13318840
29025,百鼎,1,599610,0.00016199,97.13335040
29026,百態,1,599611,0.00016199,97.13351239
29027,百憂解,1,599612,0.00016199,97.13367439
29028,百魯特歌劇院,1,599613,0.00016199,97.13383638
29029,百戰百勝,1,599614,0.00016199,97.13399837
29030,百獸,1,599615,0.00016199,97.13416037
29031,百麗新電腦公司,1,599616,0.00016199,97.13432236
29032,百靈佳殷格翰大藥廠,1,599617,0.00016199,97.13448436
29033,竹子,1,599618,0.00016199,97.13464635
29034,竹山,1,599619,0.00016199,97.13480834
29035,竹北分局,1,599620,0.00016199,97.13497034
29036,竹北交流道,1,599621,0.00016199,97.13513233
29037,竹市,1,599622,0.00016199,97.13529433
29038,竹企,1,599623,0.00016199,97.13545632
29039,竹床,1,599624,0.00016199,97.13561832
29040,竹門,1,599625,0.00016199,97.13578031
29041,竹南鎮,1,599626,0.00016199,97.13594230
29042,竹竿,1,599627,0.00016199,97.13610430
29043,竹馬藝陣,1,599628,0.00016199,97.13626629
29044,竹崎市區,1,599629,0.00016199,97.13642829
29045,竹崎鄉,1,599630,0.00016199,97.13659028
29046,竹笛,1,599631,0.00016199,97.13675228
29047,竹細工傳統產業會館,1,599632,0.00016199,97.13691427
29048,竹圍,1,599633,0.00016199,97.13707626
29049,竹棒,1,599634,0.00016199,97.13723826
29050,竹葉青,1,599635,0.00016199,97.13740025
29051,竹縣,1,599636,0.00016199,97.13756225
29052,米佛峽灣,1,599637,0.00016199,97.13772424
29053,米克,1,599638,0.00016199,97.13788623
29054,米奇鼠,1,599639,0.00016199,97.13804823
29055,米芾,1,599640,0.00016199,97.13821022
29056,米契,1,599641,0.00016199,97.13837222
29057,米酒薑汁浸足法,1,599642,0.00016199,97.13853421
29058,米高里奇,1,599643,0.00016199,97.13869621
29059,米高梅公司,1,599644,0.00016199,97.13885820
29060,米勒,1,599645,0.00016199,97.13902019
29061,米勒氏管腔,1,599646,0.00016199,97.13918219
29062,米開朗基羅,1,599647,0.00016199,97.13934418
29063,米歇爾．嘉爾森,1,599648,0.00016199,97.13950618
29064,米蘭昆德拉,1,599649,0.00016199,97.13966817
29065,米蘭達理察森,1,599650,0.00016199,97.13983017
29066,米蘭德大飯店,1,599651,0.00016199,97.13999216
29067,羊毛衣廠,1,599652,0.00016199,97.14015415
29068,羊毛衫,1,599653,0.00016199,97.14031615
29069,羊毛脂,1,599654,0.00016199,97.14047814
29070,羊水,1,599655,0.00016199,97.14064014
29071,羊皮,1,599656,0.00016199,97.14080213
29072,羊肉,1,599657,0.00016199,97.14096412
29073,羊烙,1,599658,0.00016199,97.14112612
29074,羊排,1,599659,0.00016199,97.14128811
29075,羊膜,1,599660,0.00016199,97.14145011
29076,羊膜腔炎,1,599661,0.00016199,97.14161210
29077,羽,1,599662,0.00016199,97.14177410
29078,老人化國家,1,599663,0.00016199,97.14193609
29079,老人安養院,1,599664,0.00016199,97.14209808
29080,老人斑,1,599665,0.00016199,97.14226008
29081,老三主義,1,599666,0.00016199,97.14242207
29082,老大哥,1,599667,0.00016199,97.14258407
29083,老太婆,1,599668,0.00016199,97.14274606
29084,老月份牌廣告畫,1,599669,0.00016199,97.14290806
29085,老北京的四合院,1,599670,0.00016199,97.14307005
29086,老旦,1,599671,0.00016199,97.14323204
29087,老母難,1,599672,0.00016199,97.14339404
29088,老生代,1,599673,0.00016199,97.14355603
29089,老生常談,1,599674,0.00016199,97.14371803
29090,老年人,1,599675,0.00016199,97.14388002
29091,老店,1,599676,0.00016199,97.14404201
29092,老者,1,599677,0.00016199,97.14420401
29093,老面孔,1,599678,0.00016199,97.14436600
29094,老哥,1,599679,0.00016199,97.14452800
29095,老師傅,1,599680,0.00016199,97.14468999
29096,老爹,1,599681,0.00016199,97.14485199
29097,老祖宗,1,599682,0.00016199,97.14501398
29098,老蚌生珠,1,599683,0.00016199,97.14517597
29099,老婦人,1,599684,0.00016199,97.14533797
29100,老情人,1,599685,0.00016199,97.14549996
29101,老酗客,1,599686,0.00016199,97.14566196
29102,老傢伙,1,599687,0.00016199,97.14582395
29103,老猴,1,599688,0.00016199,97.14598595
29104,老搭檔,1,599689,0.00016199,97.14614794
29105,老爺爺,1,599690,0.00016199,97.14630993
29106,老當益壯,1,599691,0.00016199,97.14647193
29107,老頑固,1,599692,0.00016199,97.14663392
29108,老練,1,599693,0.00016199,97.14679592
29109,老調調,1,599694,0.00016199,97.14695791
29110,老鄰居,1,599695,0.00016199,97.14711990
29111,老謀深算,1,599696,0.00016199,97.14728190
29112,老頭,1,599697,0.00016199,97.14744389
29113,老頭兒,1,599698,0.00016199,97.14760589
29114,老饕,1,599699,0.00016199,97.14776788
29115,考古冶金家,1,599700,0.00016199,97.14792988
29116,考古動物學家,1,599701,0.00016199,97.14809187
29117,考古植物學家,1,599702,0.00016199,97.14825386
29118,考古學系,1,599703,0.00016199,97.14841586
29119,考古學者,1,599704,0.00016199,97.14857785
29120,考卷,1,599705,0.00016199,97.14873985
29121,考院,1,599706,0.00016199,97.14890184
29122,考進,1,599707,0.00016199,97.14906384
29123,考量點,1,599708,0.00016199,97.14922583
29124,考據,1,599709,0.00016199,97.14938782
29125,考題,1,599710,0.00016199,97.14954982
29126,而今,1,599711,0.00016199,97.14971181
29127,而來,1,599712,0.00016199,97.14987381
29128,而定,1,599713,0.00016199,97.15003580
29129,而爾津縣,1,599714,0.00016199,97.15019779
29130,而導致,1,599715,0.00016199,97.15035979
29131,耳目,1,599716,0.00016199,97.15052178
29132,耳垂,1,599717,0.00016199,97.15068378
29133,耳毒性,1,599718,0.00016199,97.15084577
29134,耳提面命,1,599719,0.00016199,97.15100777
29135,耳飾,1,599720,0.00016199,97.15116976
29136,耳福,1,599721,0.00016199,97.15133175
29137,耳膜,1,599722,0.00016199,97.15149375
29138,耳邊,1,599723,0.00016199,97.15165574
29139,耳聾,1,599724,0.00016199,97.15181774
29140,肉片,1,599725,0.00016199,97.15197973
29141,肉汁,1,599726,0.00016199,97.15214173
29142,肉身,1,599727,0.00016199,97.15230372
29143,肉身彌撤,1,599728,0.00016199,97.15246571
29144,肉品市場,1,599729,0.00016199,97.15262771
29145,肉排,1,599730,0.00016199,97.15278970
29146,肉票,1,599731,0.00016199,97.15295170
29147,肉販,1,599732,0.00016199,97.15311369
29148,肉感,1,599733,0.00016199,97.15327568
29149,肉粽,1,599734,0.00016199,97.15343768
29150,肉鬆,1,599735,0.00016199,97.15359967
29151,肉鬆飯糰,1,599736,0.00016199,97.15376167
29152,肉舖,1,599737,0.00016199,97.15392366
29153,肋骨,1,599738,0.00016199,97.15408566
29154,肋排,1,599739,0.00016199,97.15424765
29155,肌肉萎縮症,1,599740,0.00016199,97.15440964
29156,肌理,1,599741,0.00016199,97.15457164
29157,自主車,1,599742,0.00016199,97.15473363
29158,自主神經,1,599743,0.00016199,97.15489563
29159,自主權,1,599744,0.00016199,97.15505762
29160,自以為是,1,599745,0.00016199,97.15521962
29161,自幼,1,599746,0.00016199,97.15538161
29162,自民黨,1,599747,0.00016199,97.15554360
29163,自由人,1,599748,0.00016199,97.15570560
29164,自由女神,1,599749,0.00016199,97.15586759
29165,自由港,1,599750,0.00016199,97.15602959
29166,自由路,1,599751,0.00016199,97.15619158
29167,自由線,1,599752,0.00016199,97.15635357
29168,自立門戶,1,599753,0.00016199,97.15651557
29169,自立報系,1,599754,0.00016199,97.15667756
29170,自成一格,1,599755,0.00016199,97.15683956
29171,自此之後,1,599756,0.00016199,97.15700155
29172,自住,1,599757,0.00016199,97.15716355
29173,自住型,1,599758,0.00016199,97.15732554
29174,自作,1,599759,0.00016199,97.15748753
29175,自作聰明,1,599760,0.00016199,97.15764953
29176,自利,1,599761,0.00016199,97.15781152
29177,自助式,1,599762,0.00016199,97.15797352
29178,自助價,1,599763,0.00016199,97.15813551
29179,自我介紹,1,599764,0.00016199,97.15829751
29180,自我約束,1,599765,0.00016199,97.15845950
29181,自我解嘲,1,599766,0.00016199,97.15862149
29182,自我膨脹,1,599767,0.00016199,97.15878349
29183,自我瞭解,1,599768,0.00016199,97.15894548
29184,自求,1,599769,0.00016199,97.15910748
29185,自足,1,599770,0.00016199,97.15926947
29186,自來水事業處,1,599771,0.00016199,97.15943147
29187,自制力,1,599772,0.00016199,97.15959346
29188,自卑,1,599773,0.00016199,97.15975545
29189,自卑感,1,599774,0.00016199,97.15991745
29190,自始至終,1,599775,0.00016199,97.16007944
29191,自性,1,599776,0.00016199,97.16024144
29192,自承,1,599777,0.00016199,97.16040343
29193,自明,1,599778,0.00016199,97.16056542
29194,自況,1,599779,0.00016199,97.16072742
29195,自治,1,599780,0.00016199,97.16088941
29196,自治體,1,599781,0.00016199,97.16105141
29197,自信滿滿,1,599782,0.00016199,97.16121340
29198,自勉,1,599783,0.00016199,97.16137540
29199,自恃,1,599784,0.00016199,97.16153739
29200,自持,1,599785,0.00016199,97.16169938
29201,自相殘殺,1,599786,0.00016199,97.16186138
29202,自若,1,599787,0.00016199,97.16202337
29203,自述,1,599788,0.00016199,97.16218537
29204,自食惡果,1,599789,0.00016199,97.16234736
29205,自家人,1,599790,0.00016199,97.16250936
29206,自動化造模生產線,1,599791,0.00016199,97.16267135
29207,自動自發,1,599792,0.00016199,97.16283334
29208,自動步槍,1,599793,0.00016199,97.16299534
29209,自動造模線,1,599794,0.00016199,97.16315733
29210,自動提款機,1,599795,0.00016199,97.16331933
29211,自動視差矯正裝置,1,599796,0.00016199,97.16348132
29212,自動澆鑄系統,1,599797,0.00016199,97.16364331
29213,自強,1,599798,0.00016199,97.16380531
29214,自強活動,1,599799,0.00016199,97.16396730
29215,自強號,1,599800,0.00016199,97.16412930
29216,自得其樂,1,599801,0.00016199,97.16429129
29217,自排型,1,599802,0.00016199,97.16445329
29218,自排變速箱,1,599803,0.00016199,97.16461528
29219,自殺率,1,599804,0.00016199,97.16477727
29220,自清,1,599805,0.00016199,97.16493927
29221,自習,1,599806,0.00016199,97.16510126
29222,自許,1,599807,0.00016199,97.16526326
29223,自責,1,599808,0.00016199,97.16542525
29224,自責分,1,599809,0.00016199,97.16558725
29225,自備款,1,599810,0.00016199,97.16574924
29226,自欺欺人,1,599811,0.00016199,97.16591123
29227,自殘性,1,599812,0.00016199,97.16607323
29228,自然女神,1,599813,0.00016199,97.16623522
29229,自然光,1,599814,0.00016199,97.16639722
29230,自然而然,1,599815,0.00016199,97.16655921
29231,自然性,1,599816,0.00016199,97.16672120
29232,自然亮光磨砂對焦屏,1,599817,0.00016199,97.16688320
29233,自然美護膚美容,1,599818,0.00016199,97.16704519
29234,自然風,1,599819,0.00016199,97.16720719
29235,自然恐龍公園,1,599820,0.00016199,97.16736918
29236,自然極限,1,599821,0.00016199,97.16753118
29237,自畫像,1,599822,0.00016199,97.16769317
29238,自發,1,599823,0.00016199,97.16785516
29239,自給自足,1,599824,0.00016199,97.16801716
29240,自給率,1,599825,0.00016199,97.16817915
29241,自視,1,599826,0.00016199,97.16834115
29242,自費,1,599827,0.00016199,97.16850314
29243,自亂陣腳,1,599828,0.00016199,97.16866514
29244,自傲,1,599829,0.00016199,97.16882713
29245,自毀,1,599830,0.00016199,97.16898912
29246,自製率,1,599831,0.00016199,97.16915112
29247,自慰,1,599832,0.00016199,97.16931311
29248,自憐,1,599833,0.00016199,97.16947511
29249,自暴自棄,1,599834,0.00016199,97.16963710
29250,自燃,1,599835,0.00016199,97.16979909
29251,自選,1,599836,0.00016199,97.16996109
29252,自謙,1,599837,0.00016199,97.17012308
29253,自曝其短,1,599838,0.00016199,97.17028508
29254,自願性,1,599839,0.00016199,97.17044707
29255,自詡,1,599840,0.00016199,97.17060907
29256,至上主義,1,599841,0.00016199,97.17077106
29257,至此,1,599842,0.00016199,97.17093305
29258,至高,1,599843,0.00016199,97.17109505
29259,至高無上,1,599844,0.00016199,97.17125704
29260,至高點,1,599845,0.00016199,97.17141904
29261,舌尖,1,599846,0.00016199,97.17158103
29262,舌間音,1,599847,0.00016199,97.17174303
29263,舟船,1,599848,0.00016199,97.17190502
29264,色中性,1,599849,0.00016199,97.17206701
29265,色狼,1,599850,0.00016199,97.17222901
29266,色素蛋白,1,599851,0.00016199,97.17239100
29267,色草,1,599852,0.00016199,97.17255300
29268,艾力克森,1,599853,0.00016199,97.17271499
29269,艾氏樹蛙,1,599854,0.00016199,97.17287698
29270,艾米莉華特森,1,599855,0.00016199,97.17303898
29271,艾米達．艾茲阿尼,1,599856,0.00016199,97.17320097
29272,艾伯哈特．桑格爾,1,599857,0.00016199,97.17336297
29273,艾利歐．波馬利,1,599858,0.00016199,97.17352496
29274,艾姆斯研究中心,1,599859,0.00016199,97.17368696
29275,艾姆達,1,599860,0.00016199,97.17384895
29276,艾拉特,1,599861,0.00016199,97.17401094
29277,艾威,1,599862,0.00016199,97.17417294
29278,艾威公司,1,599863,0.00016199,97.17433493
29279,艾思斯特．范．阿肯,1,599864,0.00016199,97.17449693
29280,艾科卡,1,599865,0.00016199,97.17465892
29281,艾美獎,1,599866,0.00016199,97.17482092
29282,艾倫柏絲汀,1,599867,0.00016199,97.17498291
29283,艾倫雷克曼,1,599868,0.00016199,97.17514490
29284,艾格蒙,1,599869,0.00016199,97.17530690
29285,艾格蒙序曲,1,599870,0.00016199,97.17546889
29286,艾茲阿尼,1,599871,0.00016199,97.17563089
29287,艾勒芳達石窟,1,599872,0.00016199,97.17579288
29288,艾得哈里斯,1,599873,0.00016199,97.17595487
29289,艾得格,1,599874,0.00016199,97.17611687
29290,艾理克．魏斯蕭斯,1,599875,0.00016199,97.17627886
29291,艾略特,1,599876,0.00016199,97.17644086
29292,艾麥克喬治,1,599877,0.00016199,97.17660285
29293,艾森蒙,1,599878,0.00016199,97.17676485
29294,艾森豪,1,599879,0.00016199,97.17692684
29295,艾琳娜理查斯,1,599880,0.00016199,97.17708883
29296,艾瑞克史托茲,1,599881,0.00016199,97.17725083
29297,艾達爾,1,599882,0.00016199,97.17741282
29298,艾碧,1,599883,0.00016199,97.17757482
29299,艾德加,1,599884,0.00016199,97.17773681
29300,艾德華,1,599885,0.00016199,97.17789881
29301,艾德華．路易斯,1,599886,0.00016199,97.17806080
29302,艾德華特,1,599887,0.00016199,97.17822279
29303,艾德溫．伊斯力,1,599888,0.00016199,97.17838479
29304,艾蓮,1,599889,0.00016199,97.17854678
29305,艾醇蕭茲,1,599890,0.00016199,97.17870878
29306,艾麗特公司,1,599891,0.00016199,97.17887077
29307,艾麗特國際有限公司,1,599892,0.00016199,97.17903276
29308,艾麗絲．古德曼,1,599893,0.00016199,97.17919476
29309,血土龍,1,599894,0.00016199,97.17935675
29310,血汗錢,1,599895,0.00016199,97.17951875
29311,血池地獄,1,599896,0.00016199,97.17968074
29312,血色,1,599897,0.00016199,97.17984274
29313,血泊,1,599898,0.00016199,97.18000473
29314,血的故事,1,599899,0.00016199,97.18016672
29315,血花,1,599900,0.00016199,97.18032872
29316,血紅,1,599901,0.00016199,97.18049071
29317,血氣方剛,1,599902,0.00016199,97.18065271
29318,血脈,1,599903,0.00016199,97.18081470
29319,血脈賁張,1,599904,0.00016199,97.18097670
29320,血清素,1,599905,0.00016199,97.18113869
29321,血清學,1,599906,0.00016199,97.18130068
29322,血進血出,1,599907,0.00016199,97.18146268
29323,血瘀,1,599908,0.00016199,97.18162467
29324,血漬,1,599909,0.00016199,97.18178667
29325,血滯,1,599910,0.00016199,97.18194866
29326,血管炎,1,599911,0.00016199,97.18211065
29327,血管栓塞,1,599912,0.00016199,97.18227265
29328,血管病,1,599913,0.00016199,97.18243464
29329,血管壁,1,599914,0.00016199,97.18259664
29330,血緣,1,599915,0.00016199,97.18275863
29331,血膜,1,599916,0.00016199,97.18292063
29332,血糖,1,599917,0.00016199,97.18308262
29333,血龍,1,599918,0.00016199,97.18324461
29334,血壓計,1,599919,0.00016199,97.18340661
29335,血壓掣,1,599920,0.00016199,97.18356860
29336,行文,1,599921,0.00016199,97.18373060
29337,行來,1,599922,0.00016199,97.18389259
29338,行者,1,599923,0.00016199,97.18405459
29339,行屍走肉,1,599924,0.00016199,97.18421658
29340,行政人員,1,599925,0.00016199,97.18437857
29341,行政大樓,1,599926,0.00016199,97.18454057
29342,行政院公共工程委員會,1,599927,0.00016199,97.18470256
29343,行政院青輔會,1,599928,0.00016199,97.18486456
29344,行政院秘書長,1,599929,0.00016199,97.18502655
29345,行政院組織法,1,599930,0.00016199,97.18518855
29346,行政院會,1,599931,0.00016199,97.18535054
29347,行政區,1,599932,0.00016199,97.18551253
29348,行政組長,1,599933,0.00016199,97.18567453
29349,行政處分,1,599934,0.00016199,97.18583652
29350,行政部,1,599935,0.00016199,97.18599852
29351,行政部門,1,599936,0.00016199,97.18616051
29352,行政單位,1,599937,0.00016199,97.18632250
29353,行政業務,1,599938,0.00016199,97.18648450
29354,行政體系,1,599939,0.00016199,97.18664649
29355,行星曆,1,599940,0.00016199,97.18680849
29356,行為主義者,1,599941,0.00016199,97.18697048
29357,行氣,1,599942,0.00016199,97.18713248
29358,行動電話,1,599943,0.00016199,97.18729447
29359,行得通,1,599944,0.00016199,97.18745646
29360,行情板,1,599945,0.00016199,97.18761846
29361,行情表,1,599946,0.00016199,97.18778045
29362,行搶,1,599947,0.00016199,97.18794245
29363,行腳,1,599948,0.00016199,97.18810444
29364,行路樹,1,599949,0.00016199,97.18826644
29365,行銷人員,1,599950,0.00016199,97.18842843
29366,行銷者,1,599951,0.00016199,97.18859042
29367,行銷副理,1,599952,0.00016199,97.18875242
29368,行銷部,1,599953,0.00016199,97.18891441
29369,行銷經理,1,599954,0.00016199,97.18907641
29370,行禮,1,599955,0.00016199,97.18923840
29371,行竊,1,599956,0.00016199,97.18940039
29372,衣衫,1,599957,0.00016199,97.18956239
29373,衣衫襤褸,1,599958,0.00016199,97.18972438
29374,衣食,1,599959,0.00016199,97.18988638
29375,衣料,1,599960,0.00016199,97.19004837
29376,衣缽,1,599961,0.00016199,97.19021037
29377,衣帽間,1,599962,0.00016199,97.19037236
29378,衣著,1,599963,0.00016199,97.19053435
29379,衣裳,1,599964,0.00016199,97.19069635
29380,衣褲,1,599965,0.00016199,97.19085834
29381,衣擺,1,599966,0.00016199,97.19102034
29382,衣櫃,1,599967,0.00016199,97.19118233
29383,衣襟,1,599968,0.00016199,97.19134433
29384,西山,1,599969,0.00016199,97.19150632
29385,西川里,1,599970,0.00016199,97.19166831
29386,西屯,1,599971,0.00016199,97.19183031
29387,西方式,1,599972,0.00016199,97.19199230
29388,西北方,1,599973,0.00016199,97.19215430
29389,西北地區,1,599974,0.00016199,97.19231629
29390,西北角,1,599975,0.00016199,97.19247828
29391,西北雨,1,599976,0.00016199,97.19264028
29392,西北航空,1,599977,0.00016199,97.19280227
29393,西卡紙,1,599978,0.00016199,97.19296427
29394,西瓜刀,1,599979,0.00016199,97.19312626
29395,西瓜石,1,599980,0.00016199,97.19328826
29396,西田隆彥,1,599981,0.00016199,97.19345025
29397,西吉島,1,599982,0.00016199,97.19361224
29398,西沙,1,599983,0.00016199,97.19377424
29399,西貝流士,1,599984,0.00016199,97.19393623
29400,西貝流士第一號交響曲,1,599985,0.00016199,97.19409823
29401,西亞,1,599986,0.00016199,97.19426022
29402,西彼町,1,599987,0.00016199,97.19442222
29403,西服業,1,599988,0.00016199,97.19458421
29404,西南山角,1,599989,0.00016199,97.19474620
29405,西南角,1,599990,0.00016199,97.19490820
29406,西城故事,1,599991,0.00016199,97.19507019
29407,西洋式,1,599992,0.00016199,97.19523219
29408,西洋風,1,599993,0.00016199,97.19539418
29409,西風,1,599994,0.00016199,97.19555617
29410,西恩,1,599995,0.00016199,97.19571817
29411,西格蒙,1,599996,0.00016199,97.19588016
29412,西班巴賽隆納奧運,1,599997,0.00016199,97.19604216
29413,西班文報,1,599998,0.00016199,97.19620415
29414,西貢,1,599999,0.00016199,97.19636615
29415,西貢小姐,1,600000,0.00016199,97.19652814
29416,西莒,1,600001,0.00016199,97.19669013
29417,西部片,1,600002,0.00016199,97.19685213
29418,西畫,1,600003,0.00016199,97.19701412
29419,西裝頭,1,600004,0.00016199,97.19717612
29420,西漢,1,600005,0.00016199,97.19733811
29421,西瑪人,1,600006,0.00016199,97.19750011
29422,西歐,1,600007,0.00016199,97.19766210
29423,西學中用,1,600008,0.00016199,97.19782409
29424,西牆,1,600009,0.00016199,97.19798609
29425,西螺,1,600010,0.00016199,97.19814808
29426,西螺鎮長,1,600011,0.00016199,97.19831008
29427,西藏文,1,600012,0.00016199,97.19847207
29428,西藥行,1,600013,0.00016199,97.19863406
29429,西鐵,1,600014,0.00016199,97.19879606
29430,亨利,1,600015,0.00016199,97.19895805
29431,亨利．馬蒂斯,1,600016,0.00016199,97.19912005
29432,亨利．福特,1,600017,0.00016199,97.19928204
29433,亨利．羅斯,1,600018,0.00016199,97.19944404
29434,亨德,1,600019,0.00016199,97.19960603
29435,位元操作元,1,600020,0.00016199,97.19976802
29436,住民立委,1,600021,0.00016199,97.19993002
29437,住宅用地,1,600022,0.00016199,97.20009201
29438,住宅金融專門公司,1,600023,0.00016199,97.20025401
29439,住客,1,600024,0.00016199,97.20041600
29440,住客數,1,600025,0.00016199,97.20057800
29441,住商不動產公司,1,600026,0.00016199,97.20073999
29442,住商房屋,1,600027,0.00016199,97.20090198
29443,住宿者,1,600028,0.00016199,97.20106398
29444,住進來,1,600029,0.00016199,97.20122597
29445,佞,1,600030,0.00016199,97.20138797
29446,伴君,1,600031,0.00016199,97.20154996
29447,伴娘,1,600032,0.00016199,97.20171195
29448,伴唱,1,600033,0.00016199,97.20187395
29449,伴您,1,600034,0.00016199,97.20203594
29450,佛光山,1,600035,0.00016199,97.20219794
29451,佛里斯特懷塔克,1,600036,0.00016199,97.20235993
29452,佛典,1,600037,0.00016199,97.20252193
29453,佛性,1,600038,0.00016199,97.20268392
29454,佛拉那,1,600039,0.00016199,97.20284591
29455,佛洛依德,1,600040,0.00016199,97.20300791
29456,佛洛依德．普洛特,1,600041,0.00016199,97.20316990
29457,佛界,1,600042,0.00016199,97.20333190
29458,佛書,1,600043,0.00016199,97.20349389
29459,佛朗明哥路,1,600044,0.00016199,97.20365589
29460,佛朗哥,1,600045,0.00016199,97.20381788
29461,佛烈德瑞克．芮納斯,1,600046,0.00016199,97.20397987
29462,佛堂,1,600047,0.00016199,97.20414187
29463,佛教文教基金會,1,600048,0.00016199,97.20430386
29464,佛教叢林學院,1,600049,0.00016199,97.20446586
29465,佛萊爾計程車公司,1,600050,0.00016199,97.20462785
29466,佛塞利,1,600051,0.00016199,97.20478984
29467,佛殿,1,600052,0.00016199,97.20495184
29468,佛經,1,600053,0.00016199,97.20511383
29469,佛跳牆,1,600054,0.00016199,97.20527583
29470,佛漢．威廉士,1,600055,0.00016199,97.20543782
29471,佛德,1,600056,0.00016199,97.20559982
29472,佛誕,1,600057,0.00016199,97.20576181
29473,佛雕,1,600058,0.00016199,97.20592380
29474,佛聲,1,600059,0.00016199,97.20608580
29475,佛羅里達馬林魚隊,1,600060,0.00016199,97.20624779
29476,佛羅倫斯,1,600061,0.00016199,97.20640979
29477,何不,1,600062,0.00016199,97.20657178
29478,何方,1,600063,0.00016199,97.20673378
29479,何日君再來,1,600064,0.00016199,97.20689577
29480,何世全,1,600065,0.00016199,97.20705776
29481,何以,1,600066,0.00016199,97.20721976
29482,何平,1,600067,0.00016199,97.20738175
29483,何在,1,600068,0.00016199,97.20754375
29484,何利,1,600069,0.00016199,97.20770574
29485,何岡,1,600070,0.00016199,97.20786773
29486,何抱,1,600071,0.00016199,97.20802973
29487,何故,1,600072,0.00016199,97.20819172
29488,何美頤,1,600073,0.00016199,97.20835372
29489,何偉真,1,600074,0.00016199,97.20851571
29490,何偉康,1,600075,0.00016199,97.20867771
29491,何啟功,1,600076,0.00016199,97.20883970
29492,何啟正,1,600077,0.00016199,97.20900169
29493,何許人也,1,600078,0.00016199,97.20916369
29494,何晴,1,600079,0.00016199,97.20932568
29495,何嘉仁書店,1,600080,0.00016199,97.20948768
29496,何壽川,1,600081,0.00016199,97.20964967
29497,何樂而不為,1,600082,0.00016199,97.20981167
29498,何鴻棋,1,600083,0.00016199,97.20997366
29499,何藍韓,1,600084,0.00016199,97.21013565
29500,估計數,1,600085,0.00016199,97.21029765
29501,估驗,1,600086,0.00016199,97.21045964
29502,佐丹奴公司,1,600087,0.00016199,97.21062164
29503,佐丹奴主席,1,600088,0.00016199,97.21078363
29504,佐丹奴企業有限公司,1,600089,0.00016199,97.21094562
29505,佐丹奴國際公司,1,600090,0.00016199,97.21110762
29506,佐佐岡義人,1,600091,0.00016199,97.21126961
29507,佐味,1,600092,0.00016199,97.21143161
29508,佐料,1,600093,0.00016199,97.21159360
29509,佐餐,1,600094,0.00016199,97.21175560
29510,佐餐酒,1,600095,0.00016199,97.21191759
29511,佐藤,1,600096,0.00016199,97.21207958
29512,佐藤征一郎,1,600097,0.00016199,97.21224158
29513,佑臻公司,1,600098,0.00016199,97.21240357
29514,伺服馬達,1,600099,0.00016199,97.21256557
29515,伺服程式,1,600100,0.00016199,97.21272756
29516,伺服端,1,600101,0.00016199,97.21288956
29517,伺候,1,600102,0.00016199,97.21305155
29518,伸入,1,600103,0.00016199,97.21321354
29519,伸延,1,600104,0.00016199,97.21337554
29520,伸長,1,600105,0.00016199,97.21353753
29521,伸展台,1,600106,0.00016199,97.21369953
29522,伸展性,1,600107,0.00016199,97.21386152
29523,伸進,1,600108,0.00016199,97.21402352
29524,伸縮號,1,600109,0.00016199,97.21418551
29525,伸縮鏡頭,1,600110,0.00016199,97.21434750
29526,佃農,1,600111,0.00016199,97.21450950
29527,佔有慾,1,600112,0.00016199,97.21467149
29528,佔位子,1,600113,0.00016199,97.21483349
29529,佔住,1,600114,0.00016199,97.21499548
29530,佔滿,1,600115,0.00016199,97.21515747
29531,佔線,1,600116,0.00016199,97.21531947
29532,似是而非,1,600117,0.00016199,97.21548146
29533,但沒,1,600118,0.00016199,97.21564346
29534,但要,1,600119,0.00016199,97.21580545
29535,但傑利柯,1,600120,0.00016199,97.21596745
29536,佣,1,600121,0.00016199,97.21612944
29537,作人處事,1,600122,0.00016199,97.21629143
29538,作手,1,600123,0.00016199,97.21645343
29539,作主,1,600124,0.00016199,97.21661542
29540,作出來,1,600125,0.00016199,97.21677742
29541,作用力,1,600126,0.00016199,97.21693941
29542,作奸犯科,1,600127,0.00016199,97.21710141
29543,作成,1,600128,0.00016199,97.21726340
29544,作收,1,600129,0.00016199,97.21742539
29545,作事,1,600130,0.00016199,97.21758739
29546,作怪,1,600131,0.00016199,97.21774938
29547,作品集,1,600132,0.00016199,97.21791138
29548,作假,1,600133,0.00016199,97.21807337
29549,作梗,1,600134,0.00016199,97.21823536
29550,作菜,1,600135,0.00016199,97.21839736
29551,作詞,1,600136,0.00016199,97.21855935
29552,作詞家,1,600137,0.00016199,97.21872135
29553,作亂,1,600138,0.00016199,97.21888334
29554,作業平台,1,600139,0.00016199,97.21904534
29555,作準,1,600140,0.00016199,97.21920733
29556,作圖,1,600141,0.00016199,97.21936932
29557,作廢,1,600142,0.00016199,97.21953132
29558,作戰書記,1,600143,0.00016199,97.21969331
29559,作戰隊,1,600144,0.00016199,97.21985531
29560,作醮,1,600145,0.00016199,97.22001730
29561,你好,1,600146,0.00016199,97.22017930
29562,你我他,1,600147,0.00016199,97.22034129
29563,你的房屋我的房屋,1,600148,0.00016199,97.22050328
29564,你怎麼說,1,600149,0.00016199,97.22066528
29565,伯公坑,1,600150,0.00016199,97.22082727
29566,伯仲,1,600151,0.00016199,97.22098927
29567,伯列斯．巴斯可,1,600152,0.00016199,97.22115126
29568,伯西佛．大衛,1,600153,0.00016199,97.22131325
29569,伯季,1,600154,0.00016199,97.22147525
29570,伯恩,1,600155,0.00016199,97.22163724
29571,伯烈斯．巴斯可,1,600156,0.00016199,97.22179924
29572,伯納街,1,600157,0.00016199,97.22196123
29573,伯樂,1,600158,0.00016199,97.22212323
29574,伯爵,1,600159,0.00016199,97.22228522
29575,伯羅奔尼撒半島,1,600160,0.00016199,97.22244721
29576,低劣,1,600161,0.00016199,97.22260921
29577,低地林,1,600162,0.00016199,97.22277120
29578,低地國,1,600163,0.00016199,97.22293320
29579,低年級,1,600164,0.00016199,97.22309519
29580,低位,1,600165,0.00016199,97.22325719
29581,低利融資,1,600166,0.00016199,97.22341918
29582,低沈,1,600167,0.00016199,97.22358117
29583,低谷,1,600168,0.00016199,97.22374317
29584,低屈,1,600169,0.00016199,97.22390516
29585,低弦,1,600170,0.00016199,97.22406716
29586,低所得,1,600171,0.00016199,97.22422915
29587,低空掠過,1,600172,0.00016199,97.22439114
29588,低垂,1,600173,0.00016199,97.22455314
29589,低限主義,1,600174,0.00016199,97.22471513
29590,低級,1,600175,0.00016199,97.22487713
29591,低脂優格,1,600176,0.00016199,97.22503912
29592,低胸,1,600177,0.00016199,97.22520112
29593,低迷不振,1,600178,0.00016199,97.22536311
29594,低階,1,600179,0.00016199,97.22552510
29595,低微,1,600180,0.00016199,97.22568710
29596,低矮,1,600181,0.00016199,97.22584909
29597,低語,1,600182,0.00016199,97.22601109
29598,低價股,1,600183,0.00016199,97.22617308
29599,低層次,1,600184,0.00016199,97.22633508
29600,低潮期,1,600185,0.00016199,97.22649707
29601,低盤,1,600186,0.00016199,97.22665906
29602,低賤,1,600187,0.00016199,97.22682106
29603,低檔區,1,600188,0.00016199,97.22698305
29604,低聲,1,600189,0.00016199,97.22714505
29605,余仁華,1,600190,0.00016199,97.22730704
29606,余文欽,1,600191,0.00016199,97.22746903
29607,余克敏,1,600192,0.00016199,97.22763103
29608,余信輝,1,600193,0.00016199,97.22779302
29609,余建新,1,600194,0.00016199,97.22795502
29610,余紀忠,1,600195,0.00016199,97.22811701
29611,余國雄,1,600196,0.00016199,97.22827901
29612,佝僂,1,600197,0.00016199,97.22844100
29613,佈,1,600198,0.00016199,97.22860299
29614,佈衣族,1,600199,0.00016199,97.22876499
29615,佚名,1,600200,0.00016199,97.22892698
29616,兌換券,1,600201,0.00016199,97.22908898
29617,克山病,1,600202,0.00016199,97.22925097
29618,克利夫蘭印地安人隊,1,600203,0.00016199,97.22941297
29619,克里夫伊凡斯,1,600204,0.00016199,97.22957496
29620,克里夫蘭,1,600205,0.00016199,97.22973695
29621,克里米亞戰爭,1,600206,0.00016199,97.22989895
29622,克里克,1,600207,0.00016199,97.23006094
29623,克里特島,1,600208,0.00016199,97.23022294
29624,克里斯．瓊斯,1,600209,0.00016199,97.23038493
29625,克里斯多佛諾斯,1,600210,0.00016199,97.23054692
29626,克里斯特安桑歌劇院,1,600211,0.00016199,97.23070892
29627,克拉碼頭,1,600212,0.00016199,97.23087091
29628,克林荷弗之死,1,600213,0.00016199,97.23103291
29629,克洛斯,1,600214,0.00016199,97.23119490
29630,克卿,1,600215,0.00016199,97.23135690
29631,克紹箕裘,1,600216,0.00016199,97.23151889
29632,克莉絲汀娜蕾西,1,600217,0.00016199,97.23168088
29633,克竟其功,1,600218,0.00016199,97.23184288
29634,克萊茲瑪樂團,1,600219,0.00016199,97.23200487
29635,克萊斯勒財務公司,1,600220,0.00016199,97.23216687
29636,克隆尼,1,600221,0.00016199,97.23232886
29637,克雷公司,1,600222,0.00016199,97.23249086
29638,克雷斯威爾,1,600223,0.00016199,97.23265285
29639,克魯茲,1,600224,0.00016199,97.23281484
29640,克魯森,1,600225,0.00016199,97.23297684
29641,克難,1,600226,0.00016199,97.23313883
29642,克麗斯帝,1,600227,0.00016199,97.23330083
29643,克麗絲蒂安妮．紐斯蘭－福爾哈爾德,1,600228,0.00016199,97.23346282
29644,克麗絲蒂安妮．福爾哈爾德,1,600229,0.00016199,97.23362481
29645,免俗,1,600230,0.00016199,97.23378681
29646,免疫功能,1,600231,0.00016199,97.23394880
29647,免疫系統,1,600232,0.00016199,97.23411080
29648,免疫球蛋白,1,600233,0.00016199,97.23427279
29649,免除掉,1,600234,0.00016199,97.23443479
29650,免掉,1,600235,0.00016199,97.23459678
29651,免稅店,1,600236,0.00016199,97.23475877
29652,免稅債券基金,1,600237,0.00016199,97.23492077
29653,免稅額,1,600238,0.00016199,97.23508276
29654,免徵,1,600239,0.00016199,97.23524476
29655,免職,1,600240,0.00016199,97.23540675
29656,免繳,1,600241,0.00016199,97.23556875
29657,兵分兩路,1,600242,0.00016199,97.23573074
29658,兵來將擋,1,600243,0.00016199,97.23589273
29659,兵家,1,600244,0.00016199,97.23605473
29660,兵馬俑,1,600245,0.00016199,97.23621672
29661,兵符,1,600246,0.00016199,97.23637872
29662,兵棋,1,600247,0.00016199,97.23654071
29663,兵團,1,600248,0.00016199,97.23670270
29664,兵營,1,600249,0.00016199,97.23686470
29665,兵變,1,600250,0.00016199,97.23702669
29666,冷光,1,600251,0.00016199,97.23718869
29667,冷光表,1,600252,0.00016199,97.23735068
29668,冷冷清清,1,600253,0.00016199,97.23751268
29669,冷冷濕濕,1,600254,0.00016199,97.23767467
29670,冷冽,1,600255,0.00016199,97.23783666
29671,冷雨,1,600256,0.00016199,97.23799866
29672,冷卻劑,1,600257,0.00016199,97.23816065
29673,冷泉,1,600258,0.00016199,97.23832265
29674,冷泉風景區,1,600259,0.00016199,97.23848464
29675,冷面,1,600260,0.00016199,97.23864664
29676,冷風,1,600261,0.00016199,97.23880863
29677,冷凍車,1,600262,0.00016199,97.23897062
29678,冷淡,1,600263,0.00016199,97.23913262
29679,冷清清,1,600264,0.00016199,97.23929461
29680,冷感,1,600265,0.00016199,97.23945661
29681,冷暖,1,600266,0.00016199,97.23961860
29682,冷暖自知,1,600267,0.00016199,97.23978059
29683,冷暖空調,1,600268,0.00016199,97.23994259
29684,冷暖氣,1,600269,0.00016199,97.24010458
29685,冷溼,1,600270,0.00016199,97.24026658
29686,冷雋,1,600271,0.00016199,97.24042857
29687,冷熱,1,600272,0.00016199,97.24059057
29688,冷鋒,1,600273,0.00016199,97.24075256
29689,冷霜,1,600274,0.00016199,97.24091455
29690,冷藏起來,1,600275,0.00016199,97.24107655
29691,冷豔,1,600276,0.00016199,97.24123854
29692,別出新裁,1,600277,0.00016199,97.24140054
29693,別有用心,1,600278,0.00016199,97.24156253
29694,別府市,1,600279,0.00016199,97.24172453
29695,別府車站,1,600280,0.00016199,97.24188652
29696,別府灣,1,600281,0.00016199,97.24204851
29697,別林斯基,1,600282,0.00016199,97.24221051
29698,別致,1,600283,0.00016199,97.24237250
29699,別苑,1,600284,0.00016199,97.24253450
29700,別無選擇,1,600285,0.00016199,97.24269649
29701,別管,1,600286,0.00016199,97.24285849
29702,別緻,1,600287,0.00016199,97.24302048
29703,別樹一格,1,600288,0.00016199,97.24318247
29704,判別,1,600289,0.00016199,97.24334447
29705,利比亞,1,600290,0.00016199,97.24350646
29706,利他主義,1,600291,0.00016199,97.24366846
29707,利市,1,600292,0.00016199,97.24383045
29708,利用率,1,600293,0.00016199,97.24399244
29709,利托斯卡安,1,600294,0.00016199,97.24415444
29710,利物浦大學,1,600295,0.00016199,97.24431643
29711,利物浦市,1,600296,0.00016199,97.24447843
29712,利查,1,600297,0.00016199,97.24464042
29713,利柏殊,1,600298,0.00016199,97.24480242
29714,利害關係,1,600299,0.00016199,97.24496441
29715,利根,1,600300,0.00016199,97.24512640
29716,利益點,1,600301,0.00016199,97.24528840
29717,利率絕對水準,1,600302,0.00016199,97.24545039
29718,利齒,1,600303,0.00016199,97.24561239
29719,刪去,1,600304,0.00016199,97.24577438
29720,刨,1,600305,0.00016199,97.24593638
29721,刨成,1,600306,0.00016199,97.24609837
29722,劫財,1,600307,0.00016199,97.24626036
29723,劫奪,1,600308,0.00016199,97.24642236
29724,劫難,1,600309,0.00016199,97.24658435
29725,助洗劑,1,600310,0.00016199,97.24674635
29726,助教,1,600311,0.00016199,97.24690834
29727,助燃,1,600312,0.00016199,97.24707033
29728,助興,1,600313,0.00016199,97.24723233
29729,助選員,1,600314,0.00016199,97.24739432
29730,助禱,1,600315,0.00016199,97.24755632
29731,努,1,600316,0.00016199,97.24771831
29732,努力不懈,1,600317,0.00016199,97.24788031
29733,努德維克,1,600318,0.00016199,97.24804230
29734,即日起,1,600319,0.00016199,97.24820429
29735,即使如此,1,600320,0.00016199,97.24836629
29736,即便,1,600321,0.00016199,97.24852828
29737,即食,1,600322,0.00016199,97.24869028
29738,卵形,1,600323,0.00016199,97.24885227
29739,卵巢腫瘤,1,600324,0.00016199,97.24901427
29740,卵磷脂,1,600325,0.00016199,97.24917626
29741,吝嗇,1,600326,0.00016199,97.24933825
29742,吞下,1,600327,0.00016199,97.24950025
29743,吞吞吐吐,1,600328,0.00016199,97.24966224
29744,吞沒,1,600329,0.00016199,97.24982424
29745,吞服,1,600330,0.00016199,97.24998623
29746,吞食,1,600331,0.00016199,97.25014822
29747,吞掉,1,600332,0.00016199,97.25031022
29748,吞雲吐霧,1,600333,0.00016199,97.25047221
29749,吞噬,1,600334,0.00016199,97.25063421
29750,吞噬細胞,1,600335,0.00016199,97.25079620
29751,吞嚥,1,600336,0.00016199,97.25095820
29752,吧檯,1,600337,0.00016199,97.25112019
29753,吧�W,1,600338,0.00016199,97.25128218
29754,吳大利,1,600339,0.00016199,97.25144418
29755,吳大維,1,600340,0.00016199,97.25160617
29756,吳中立,1,600341,0.00016199,97.25176817
29757,吳天明,1,600342,0.00016199,97.25193016
29758,吳心蓮,1,600343,0.00016199,97.25209216
29759,吳文良,1,600344,0.00016199,97.25225415
29760,吳文媛,1,600345,0.00016199,97.25241614
29761,吳正弘,1,600346,0.00016199,97.25257814
29762,吳永男,1,600347,0.00016199,97.25274013
29763,吳再欽,1,600348,0.00016199,97.25290213
29764,吳存信,1,600349,0.00016199,97.25306412
29765,吳安家,1,600350,0.00016199,97.25322611
29766,吳行健,1,600351,0.00016199,97.25338811
29767,吳廷燁,1,600352,0.00016199,97.25355010
29768,吳志華,1,600353,0.00016199,97.25371210
29769,吳育全,1,600354,0.00016199,97.25387409
29770,吳育玟,1,600355,0.00016199,97.25403609
29771,吳辰君,1,600356,0.00016199,97.25419808
29772,吳京,1,600357,0.00016199,97.25436007
29773,吳佩玲,1,600358,0.00016199,97.25452207
29774,吳宗憲,1,600359,0.00016199,97.25468406
29775,吳念真,1,600360,0.00016199,97.25484606
29776,吳東明,1,600361,0.00016199,97.25500805
29777,吳阿明,1,600362,0.00016199,97.25517005
29778,吳青常,1,600363,0.00016199,97.25533204
29779,吳政修,1,600364,0.00016199,97.25549403
29780,吳映卿,1,600365,0.00016199,97.25565603
29781,吳英璋,1,600366,0.00016199,97.25581802
29782,吳倩蓮,1,600367,0.00016199,97.25598002
29783,吳容始,1,600368,0.00016199,97.25614201
29784,吳容延,1,600369,0.00016199,97.25630400
29785,吳容怡,1,600370,0.00016199,97.25646600
29786,吳容明,1,600371,0.00016199,97.25662799
29787,吳祚昌,1,600372,0.00016199,97.25678999
29788,吳國重,1,600373,0.00016199,97.25695198
29789,吳國卿,1,600374,0.00016199,97.25711398
29790,吳基福,1,600375,0.00016199,97.25727597
29791,吳清波,1,600376,0.00016199,97.25743796
29792,吳淞,1,600377,0.00016199,97.25759996
29793,吳媛華,1,600378,0.00016199,97.25776195
29794,吳尊賢,1,600379,0.00016199,97.25792395
29795,吳復連,1,600380,0.00016199,97.25808594
29796,吳閏鏡,1,600381,0.00016199,97.25824794
29797,吳榮欽,1,600382,0.00016199,97.25840993
29798,吳銘輝,1,600383,0.00016199,97.25857192
29799,吳鳳北路,1,600384,0.00016199,97.25873392
29800,吳儀,1,600385,0.00016199,97.25889591
29801,吳德美,1,600386,0.00016199,97.25905791
29802,吳興街,1,600387,0.00016199,97.25921990
29803,吳錫藤,1,600388,0.00016199,97.25938189
29804,吳靜吉,1,600389,0.00016199,97.25954389
29805,吳鴻霖,1,600390,0.00016199,97.25970588
29806,吳鎮宇,1,600391,0.00016199,97.25986788
29807,吳麗娟,1,600392,0.00016199,97.26002987
29808,吳鐵雄,1,600393,0.00016199,97.26019187
29809,呂文生,1,600394,0.00016199,97.26035386
29810,呂幼綬,1,600395,0.00016199,97.26051585
29811,呂秀蓮,1,600396,0.00016199,97.26067785
29812,呂亞力,1,600397,0.00016199,97.26083984
29813,呂坤,1,600398,0.00016199,97.26100184
29814,呂金財,1,600399,0.00016199,97.26116383
29815,呂秋溶,1,600400,0.00016199,97.26132583
29816,呂淑慧,1,600401,0.00016199,97.26148782
29817,呂雪彗,1,600402,0.00016199,97.26164981
29818,呂進芳,1,600403,0.00016199,97.26181181
29819,呂樑鑑,1,600404,0.00016199,97.26197380
29820,呂學樟,1,600405,0.00016199,97.26213580
29821,君主制,1,600406,0.00016199,97.26229779
29822,告一段落,1,600407,0.00016199,97.26245978
29823,告急,1,600408,0.00016199,97.26262178
29824,告密者,1,600409,0.00016199,97.26278377
29825,告慰,1,600410,0.00016199,97.26294577
29826,吹牛,1,600411,0.00016199,97.26310776
29827,吹出,1,600412,0.00016199,97.26326976
29828,吹泡泡機,1,600413,0.00016199,97.26343175
29829,吹笛手,1,600414,0.00016199,97.26359374
29830,吹落,1,600415,0.00016199,97.26375574
29831,吹熄,1,600416,0.00016199,97.26391773
29832,吹噓,1,600417,0.00016199,97.26407973
29833,吹糖人,1,600418,0.00016199,97.26424172
29834,吹襲,1,600419,0.00016199,97.26440372
29835,吻,1,600420,0.00016199,97.26456571
29836,吸一吸,1,600421,0.00016199,97.26472770
29837,吸水,1,600422,0.00016199,97.26488970
29838,吸水性,1,600423,0.00016199,97.26505169
29839,吸安,1,600424,0.00016199,97.26521369
29840,吸收力,1,600425,0.00016199,97.26537568
29841,吸吮,1,600426,0.00016199,97.26553767
29842,吸走,1,600427,0.00016199,97.26569967
29843,吸毒者,1,600428,0.00016199,97.26586166
29844,吸食器,1,600429,0.00016199,97.26602366
29845,吸煙房,1,600430,0.00016199,97.26618565
29846,吸盤,1,600431,0.00016199,97.26634765
29847,吸膠犯,1,600432,0.00016199,97.26650964
29848,吸震性,1,600433,0.00016199,97.26667163
29849,吸頭,1,600434,0.00016199,97.26683363
29850,吸蟲病,1,600435,0.00016199,97.26699562
29851,吵醒,1,600436,0.00016199,97.26715762
29852,吵翻天,1,600437,0.00016199,97.26731961
29853,吼聲,1,600438,0.00016199,97.26748161
29854,吱吱喳喳,1,600439,0.00016199,97.26764360
29855,含水量,1,600440,0.00016199,97.26780559
29856,含毒性物質,1,600441,0.00016199,97.26796759
29857,含氧,1,600442,0.00016199,97.26812958
29858,含氧量,1,600443,0.00016199,97.26829158
29859,含鉛量,1,600444,0.00016199,97.26845357
29860,含藏,1,600445,0.00016199,97.26861556
29861,吟,1,600446,0.00016199,97.26877756
29862,困住,1,600447,0.00016199,97.26893955
29863,困苦,1,600448,0.00016199,97.26910155
29864,困難度,1,600449,0.00016199,97.26926354
29865,囤積,1,600450,0.00016199,97.26942554
29866,囤積品,1,600451,0.00016199,97.26958753
29867,坑洞,1,600452,0.00016199,97.26974952
29868,均勻度,1,600453,0.00016199,97.26991152
29869,均比,1,600454,0.00016199,97.27007351
29870,均富,1,600455,0.00016199,97.27023551
29871,均豪精密工業公司,1,600456,0.00016199,97.27039750
29872,均質,1,600457,0.00016199,97.27055950
29873,均衡器,1,600458,0.00016199,97.27072149
29874,均攤,1,600459,0.00016199,97.27088348
29875,坎坷,1,600460,0.00016199,97.27104548
29876,坎帕尼亞,1,600461,0.00016199,97.27120747
29877,坎城廣告獎,1,600462,0.00016199,97.27136947
29878,坎倫．奈澤,1,600463,0.00016199,97.27153146
29879,坎培拉,1,600464,0.00016199,97.27169346
29880,坐上,1,600465,0.00016199,97.27185545
29881,坐月子,1,600466,0.00016199,97.27201744
29882,坐月子中心,1,600467,0.00016199,97.27217944
29883,坐收,1,600468,0.00016199,97.27234143
29884,坐位,1,600469,0.00016199,97.27250343
29885,坐享,1,600470,0.00016199,97.27266542
29886,坐定,1,600471,0.00016199,97.27282741
29887,坐板凳,1,600472,0.00016199,97.27298941
29888,坐骨神經痛,1,600473,0.00016199,97.27315140
29889,坐船,1,600474,0.00016199,97.27331340
29890,坐視,1,600475,0.00016199,97.27347539
29891,坐滿,1,600476,0.00016199,97.27363739
29892,坐擁,1,600477,0.00016199,97.27379938
29893,壯丁,1,600478,0.00016199,97.27396137
29894,壯年,1,600479,0.00016199,97.27412337
29895,壯年人,1,600480,0.00016199,97.27428536
29896,壯壯,1,600481,0.00016199,97.27444736
29897,壯男艷舞秀,1,600482,0.00016199,97.27460935
29898,壯舉,1,600483,0.00016199,97.27477135
29899,壯闊,1,600484,0.00016199,97.27493334
29900,夾心餅乾,1,600485,0.00016199,97.27509533
29901,夾克,1,600486,0.00016199,97.27525733
29902,夾帶,1,600487,0.00016199,97.27541932
29903,夾腳拖鞋,1,600488,0.00016199,97.27558132
29904,夾縫,1,600489,0.00016199,97.27574331
29905,妝色,1,600490,0.00016199,97.27590530
29906,妝扮,1,600491,0.00016199,97.27606730
29907,妝容,1,600492,0.00016199,97.27622929
29908,妝點,1,600493,0.00016199,97.27639129
29909,妒火,1,600494,0.00016199,97.27655328
29910,妨害公務,1,600495,0.00016199,97.27671528
29911,妞,1,600496,0.00016199,97.27687727
29912,妙境,1,600497,0.00016199,97.27703926
29913,妖光,1,600498,0.00016199,97.27720126
29914,妖怪,1,600499,0.00016199,97.27736325
29915,妖嬈,1,600500,0.00016199,97.27752525
29916,妖魔,1,600501,0.00016199,97.27768724
29917,妖艷,1,600502,0.00016199,97.27784924
29918,妥善度,1,600503,0.00016199,97.27801123
29919,妥善率,1,600504,0.00016199,97.27817322
29920,孝子,1,600505,0.00016199,97.27833522
29921,孝敬,1,600506,0.00016199,97.27849721
29922,孝道,1,600507,0.00016199,97.27865921
29923,完全血球,1,600508,0.00016199,97.27882120
29924,完蛋,1,600509,0.00016199,97.27898319
29925,宋川強,1,600510,0.00016199,97.27914519
29926,宋文勳,1,600511,0.00016199,97.27930718
29927,宋艾克,1,600512,0.00016199,97.27946918
29928,宋秩銘,1,600513,0.00016199,97.27963117
29929,宋朝,1,600514,0.00016199,97.27979317
29930,宋肇基,1,600515,0.00016199,97.27995516
29931,宋慶齡,1,600516,0.00016199,97.28011715
29932,宋濤,1,600517,0.00016199,97.28027915
29933,宏泰,1,600518,0.00016199,97.28044114
29934,宏都拉斯,1,600519,0.00016199,97.28060314
29935,宏遠,1,600520,0.00016199,97.28076513
29936,宏總,1,600521,0.00016199,97.28092713
29937,宏碁科技,1,600522,0.00016199,97.28108912
29938,宏碁集團,1,600523,0.00016199,97.28125111
29939,宏碁電腦公司,1,600524,0.00016199,97.28141311
29940,宏碁電腦集團,1,600525,0.00016199,97.28157510
29941,局部測光框,1,600526,0.00016199,97.28173710
29942,尿尿巷,1,600527,0.00016199,97.28189909
29943,尿毒症,1,600528,0.00016199,97.28206108
29944,尿毒患者,1,600529,0.00016199,97.28222308
29945,尿量,1,600530,0.00016199,97.28238507
29946,尿道口,1,600531,0.00016199,97.28254707
29947,尿道炎,1,600532,0.00016199,97.28270906
29948,尾段,1,600533,0.00016199,97.28287106
29949,尾廂,1,600534,0.00016199,97.28303305
29950,尾端,1,600535,0.00016199,97.28319504
29951,尾數,1,600536,0.00016199,97.28335704
29952,尾燈,1,600537,0.00016199,97.28351903
29953,尾燈組,1,600538,0.00016199,97.28368103
29954,尾聲,1,600539,0.00016199,97.28384302
29955,岌岌,1,600540,0.00016199,97.28400502
29956,巫,1,600541,0.00016199,97.28416701
29957,巫山,1,600542,0.00016199,97.28432900
29958,巫師,1,600543,0.00016199,97.28449100
29959,希旨承風,1,600544,0.00016199,97.28465299
29960,希沙立克山崗,1,600545,0.00016199,97.28481499
29961,希拉蕊,1,600546,0.00016199,97.28497698
29962,希街藍調,1,600547,0.00016199,97.28513897
29963,希爾頓飯店,1,600548,0.00016199,97.28530097
29964,希爾頓業務部,1,600549,0.00016199,97.28546296
29965,希冀,1,600550,0.00016199,97.28562496
29966,希臘正教,1,600551,0.00016199,97.28578695
29967,希臘式,1,600552,0.00016199,97.28594895
29968,序言,1,600553,0.00016199,97.28611094
29969,序幕,1,600554,0.00016199,97.28627293
29970,庇佑,1,600555,0.00016199,97.28643493
29971,庇縱,1,600556,0.00016199,97.28659692
29972,床緣,1,600557,0.00016199,97.28675892
29973,床頭,1,600558,0.00016199,97.28692091
29974,弄出,1,600559,0.00016199,97.28708291
29975,弄春池,1,600560,0.00016199,97.28724490
29976,弄傷,1,600561,0.00016199,97.28740689
29977,弟媳婦,1,600562,0.00016199,97.28756889
29978,形同具文,1,600563,0.00016199,97.28773088
29979,形同陌路,1,600564,0.00016199,97.28789288
29980,形式主義,1,600565,0.00016199,97.28805487
29981,形成期,1,600566,0.00016199,97.28821686
29982,形而上,1,600567,0.00016199,97.28837886
29983,形色,1,600568,0.00016199,97.28854085
29984,形形色色,1,600569,0.00016199,97.28870285
29985,形像,1,600570,0.00016199,97.28886484
29986,形態學,1,600571,0.00016199,97.28902684
29987,形貌,1,600572,0.00016199,97.28918883
29988,彷若,1,600573,0.00016199,97.28935082
29989,役男,1,600574,0.00016199,97.28951282
29990,忘了,1,600575,0.00016199,97.28967481
29991,忌食,1,600576,0.00016199,97.28983681
29992,忌憚,1,600577,0.00016199,97.28999880
29993,志工室,1,600578,0.00016199,97.29016080
29994,志同道合,1,600579,0.00016199,97.29032279
29995,志在四方,1,600580,0.00016199,97.29048478
29996,志在必得,1,600581,0.00016199,97.29064678
29997,志信,1,600582,0.00016199,97.29080877
29998,志高湖,1,600583,0.00016199,97.29097077
29999,志趣,1,600584,0.00016199,97.29113276
30000,志聯,1,600585,0.00016199,97.29129475
30001,志聯工業,1,600586,0.00016199,97.29145675
30002,志願卡,1,600587,0.00016199,97.29161874
30003,忍氣吞聲,1,600588,0.00016199,97.29178074
30004,忍痛,1,600589,0.00016199,97.29194273
30005,快刀計畫,1,600590,0.00016199,97.29210473
30006,快打旋風,1,600591,0.00016199,97.29226672
30007,快快樂樂,1,600592,0.00016199,97.29242871
30008,快攻,1,600593,0.00016199,97.29259071
30009,快走,1,600594,0.00016199,97.29275270
30010,快迅,1,600595,0.00016199,97.29291470
30011,快到,1,600596,0.00016199,97.29307669
30012,快門速度,1,600597,0.00016199,97.29323869
30013,快活,1,600598,0.00016199,97.29340068
30014,快訊,1,600599,0.00016199,97.29356267
30015,快閃記憶體,1,600600,0.00016199,97.29372467
30016,快閃轉換軟體,1,600601,0.00016199,97.29388666
30017,快捷,1,600602,0.00016199,97.29404866
30018,快跑,1,600603,0.00016199,97.29421065
30019,快意,1,600604,0.00016199,97.29437264
30020,快艇隊,1,600605,0.00016199,97.29453464
30021,快慢,1,600606,0.00016199,97.29469663
30022,快遞,1,600607,0.00016199,97.29485863
30023,快遞轉運中心,1,600608,0.00016199,97.29502062
30024,快慰,1,600609,0.00016199,97.29518262
30025,快樂時光,1,600610,0.00016199,97.29534461
30026,快點,1,600611,0.00016199,97.29550660
30027,快轉,1,600612,0.00016199,97.29566860
30028,戒定慧,1,600613,0.00016199,97.29583059
30029,戒治,1,600614,0.00016199,97.29599259
30030,戒慎,1,600615,0.00016199,97.29615458
30031,戒慎恐懼,1,600616,0.00016199,97.29631658
30032,我只在乎你,1,600617,0.00016199,97.29647857
30033,我行我素,1,600618,0.00016199,97.29664056
30034,我希望我也生病,1,600619,0.00016199,97.29680256
30035,我見猶憐,1,600620,0.00016199,97.29696455
30036,我和小凱絕交了,1,600621,0.00016199,97.29712655
30037,我的耶穌,1,600622,0.00016199,97.29728854
30038,我第一眼看見,1,600623,0.00016199,97.29745054
30039,我最喜歡爺爺,1,600624,0.00016199,97.29761253
30040,我想,1,600625,0.00016199,97.29777452
30041,我愛你,1,600626,0.00016199,97.29793652
30042,我撒了一個謊,1,600627,0.00016199,97.29809851
30043,我變、我變、我變變變,1,600628,0.00016199,97.29826051
30044,抄球,1,600629,0.00016199,97.29842250
30045,抄錄,1,600630,0.00016199,97.29858449
30046,抄襲者,1,600631,0.00016199,97.29874649
30047,抗乙醯膽胺,1,600632,0.00016199,97.29890848
30048,抗日戰爭,1,600633,0.00016199,97.29907048
30049,抗沮喪劑,1,600634,0.00016199,97.29923247
30050,抗值約,1,600635,0.00016199,97.29939447
30051,抗衰,1,600636,0.00016199,97.29955646
30052,抗跌,1,600637,0.00016199,97.29971845
30053,抗潰瘍,1,600638,0.00016199,97.29988045
30054,抗震爆,1,600639,0.00016199,97.30004244
30055,抗壓,1,600640,0.00016199,97.30020444
30056,抗癌,1,600641,0.00016199,97.30036643
30057,抖,1,600642,0.00016199,97.30052843
30058,抖出,1,600643,0.00016199,97.30069042
30059,抖落,1,600644,0.00016199,97.30085241
30060,抖擻,1,600645,0.00016199,97.30101441
30061,技士,1,600646,0.00016199,97.30117640
30062,技工,1,600647,0.00016199,97.30133840
30063,技正,1,600648,0.00016199,97.30150039
30064,技改,1,600649,0.00016199,97.30166238
30065,技師,1,600650,0.00016199,97.30182438
30066,技術中心,1,600651,0.00016199,97.30198637
30067,技術分析師,1,600652,0.00016199,97.30214837
30068,技術支援處,1,600653,0.00016199,97.30231036
30069,技術界,1,600654,0.00016199,97.30247236
30070,技術組,1,600655,0.00016199,97.30263435
30071,技術組長,1,600656,0.00016199,97.30279634
30072,技術處,1,600657,0.00016199,97.30295834
30073,技術部,1,600658,0.00016199,97.30312033
30074,技癢,1,600659,0.00016199,97.30328233
30075,扶老攜幼,1,600660,0.00016199,97.30344432
30076,扶助,1,600661,0.00016199,97.30360632
30077,扶養,1,600662,0.00016199,97.30376831
30078,扭鬥,1,600663,0.00016199,97.30393030
30079,把一把,1,600664,0.00016199,97.30409230
30080,把手,1,600665,0.00016199,97.30425429
30081,把戲,1,600666,0.00016199,97.30441629
30082,把臂言歡,1,600667,0.00016199,97.30457828
30083,扼守,1,600668,0.00016199,97.30474027
30084,找上門,1,600669,0.00016199,97.30490227
30085,找找,1,600670,0.00016199,97.30506426
30086,批示,1,600671,0.00016199,97.30522626
30087,批次作業,1,600672,0.00016199,97.30538825
30088,批定,1,600673,0.00016199,97.30555025
30089,批發商,1,600674,0.00016199,97.30571224
30090,批發價,1,600675,0.00016199,97.30587423
30091,扳,1,600676,0.00016199,97.30603623
30092,扳住,1,600677,0.00016199,97.30619822
30093,扳倒,1,600678,0.00016199,97.30636022
30094,扳動,1,600679,0.00016199,97.30652221
30095,抒展,1,600680,0.00016199,97.30668421
30096,抒解,1,600681,0.00016199,97.30684620
30097,抒緩,1,600682,0.00016199,97.30700819
30098,扯上,1,600683,0.00016199,97.30717019
30099,折回,1,600684,0.00016199,97.30733218
30100,折扣品,1,600685,0.00016199,97.30749418
30101,折服,1,600686,0.00016199,97.30765617
30102,折返,1,600687,0.00016199,97.30781816
30103,折射,1,600688,0.00016199,97.30798016
30104,折衷,1,600689,0.00016199,97.30814215
30105,折換,1,600690,0.00016199,97.30830415
30106,折腰,1,600691,0.00016199,97.30846614
30107,折價單,1,600692,0.00016199,97.30862814
30108,折線,1,600693,0.00016199,97.30879013
30109,折舊率,1,600694,0.00016199,97.30895212
30110,折疊,1,600695,0.00016199,97.30911412
30111,折讓,1,600696,0.00016199,97.30927611
30112,扮相,1,600697,0.00016199,97.30943811
30113,扮黑臉,1,600698,0.00016199,97.30960010
30114,投手群,1,600699,0.00016199,97.30976210
30115,投身,1,600700,0.00016199,97.30992409
30116,投信事業管理規則,1,600701,0.00016199,97.31008608
30117,投信債券,1,600702,0.00016199,97.31024808
30118,投保人,1,600703,0.00016199,97.31041007
30119,投書,1,600704,0.00016199,97.31057207
30120,投票所,1,600705,0.00016199,97.31073406
30121,投訴,1,600706,0.00016199,97.31089605
30122,投開票,1,600707,0.00016199,97.31105805
30123,投資回收分析,1,600708,0.00016199,97.31122004
30124,投資額,1,600709,0.00016199,97.31138204
30125,投稿者,1,600710,0.00016199,97.31154403
30126,投靠,1,600711,0.00016199,97.31170603
30127,投錢,1,600712,0.00016199,97.31186802
30128,投擲,1,600713,0.00016199,97.31203001
30129,投顧公司,1,600714,0.00016199,97.31219201
30130,抓人,1,600715,0.00016199,97.31235400
30131,抓下,1,600716,0.00016199,97.31251600
30132,抓走,1,600717,0.00016199,97.31267799
30133,抓起,1,600718,0.00016199,97.31283999
30134,抓起來,1,600719,0.00016199,97.31300198
30135,抓鬼特攻隊,1,600720,0.00016199,97.31316397
30136,抓掉,1,600721,0.00016199,97.31332597
30137,抓握,1,600722,0.00016199,97.31348796
30138,抓傷,1,600723,0.00016199,97.31364996
30139,抓準,1,600724,0.00016199,97.31381195
30140,抓圖,1,600725,0.00016199,97.31397394
30141,抓蟲,1,600726,0.00016199,97.31413594
30142,抑,1,600727,0.00016199,97.31429793
30143,抑揚頓挫,1,600728,0.00016199,97.31445993
30144,改天,1,600729,0.00016199,97.31462192
30145,改出,1,600730,0.00016199,97.31478392
30146,改打,1,600731,0.00016199,97.31494591
30147,改至,1,600732,0.00016199,97.31510790
30148,改改,1,600733,0.00016199,97.31526990
30149,改走,1,600734,0.00016199,97.31543189
30150,改版,1,600735,0.00016199,97.31559389
30151,改革風,1,600736,0.00016199,97.31575588
30152,改掉,1,600737,0.00016199,97.31591788
30153,改換,1,600738,0.00016199,97.31607987
30154,改期,1,600739,0.00016199,97.31624186
30155,改朝換代,1,600740,0.00016199,97.31640386
30156,改善費,1,600741,0.00016199,97.31656585
30157,改裝案,1,600742,0.00016199,97.31672785
30158,改裝證,1,600743,0.00016199,97.31688984
30159,改道,1,600744,0.00016199,97.31705183
30160,改過,1,600745,0.00016199,97.31721383
30161,改過自新,1,600746,0.00016199,97.31737582
30162,改隸,1,600747,0.00016199,97.31753782
30163,攻下,1,600748,0.00016199,97.31769981
30164,攻上,1,600749,0.00016199,97.31786181
30165,攻心為上,1,600750,0.00016199,97.31802380
30166,攻打,1,600751,0.00016199,97.31818579
30167,攻防,1,600752,0.00016199,97.31834779
30168,攻城,1,600753,0.00016199,97.31850978
30169,攻城陣,1,600754,0.00016199,97.31867178
30170,攻堅,1,600755,0.00016199,97.31883377
30171,攻略,1,600756,0.00016199,97.31899577
30172,攻無不克,1,600757,0.00016199,97.31915776
30173,攻擊手,1,600758,0.00016199,97.31931975
30174,攻擊行為,1,600759,0.00016199,97.31948175
30175,攻擊性,1,600760,0.00016199,97.31964374
30176,攻擊機,1,600761,0.00016199,97.31980574
30177,旱地,1,600762,0.00016199,97.31996773
30178,旱溪,1,600763,0.00016199,97.32012972
30179,更正,1,600764,0.00016199,97.32029172
30180,更名,1,600765,0.00016199,97.32045371
30181,更易,1,600766,0.00016199,97.32061571
30182,更迭,1,600767,0.00016199,97.32077770
30183,更異,1,600768,0.00016199,97.32093970
30184,束手就擒,1,600769,0.00016199,97.32110169
30185,束裝,1,600770,0.00016199,97.32126368
30186,李力持,1,600771,0.00016199,97.32142568
30187,李又寧,1,600772,0.00016199,97.32158767
30188,李三榮,1,600773,0.00016199,97.32174967
30189,李小平,1,600774,0.00016199,97.32191166
30190,李六條,1,600775,0.00016199,97.32207366
30191,李公麟,1,600776,0.00016199,97.32223565
30192,李太極,1,600777,0.00016199,97.32239764
30193,李木隆,1,600778,0.00016199,97.32255964
30194,李仟,1,600779,0.00016199,97.32272163
30195,李可,1,600780,0.00016199,97.32288363
30196,李布,1,600781,0.00016199,97.32304562
30197,李正雄,1,600782,0.00016199,97.32320761
30198,李正斌,1,600783,0.00016199,97.32336961
30199,李仲英,1,600784,0.00016199,97.32353160
30200,李全松,1,600785,0.00016199,97.32369360
30201,李佛,1,600786,0.00016199,97.32385559
30202,李希特,1,600787,0.00016199,97.32401759
30203,李志村,1,600788,0.00016199,97.32417958
30204,李志鴻,1,600789,0.00016199,97.32434157
30205,李秀芬,1,600790,0.00016199,97.32450357
30206,李佳座,1,600791,0.00016199,97.32466556
30207,李佳諭,1,600792,0.00016199,97.32482756
30208,李叔同,1,600793,0.00016199,97.32498955
30209,李姓宗親會,1,600794,0.00016199,97.32515155
30210,李孟蒨,1,600795,0.00016199,97.32531354
30211,李念祖,1,600796,0.00016199,97.32547553
30212,李明依,1,600797,0.00016199,97.32563753
30213,李明憲,1,600798,0.00016199,97.32579952
30214,李東憲,1,600799,0.00016199,97.32596152
30215,李松德,1,600800,0.00016199,97.32612351
30216,李治蒙,1,600801,0.00016199,97.32628551
30217,李炎權,1,600802,0.00016199,97.32644750
30218,李金��,1,600803,0.00016199,97.32660949
30219,李金波,1,600804,0.00016199,97.32677149
30220,李門．史崔蘭,1,600805,0.00016199,97.32693348
30221,李奕民,1,600806,0.00016199,97.32709548
30222,李奕園,1,600807,0.00016199,97.32725747
30223,李建興,1,600808,0.00016199,97.32741946
30224,李彥甫,1,600809,0.00016199,97.32758146
30225,李思訓,1,600810,0.00016199,97.32774345
30226,李政道,1,600811,0.00016199,97.32790545
30227,李香蘭,1,600812,0.00016199,97.32806744
30228,李納德．波特,1,600813,0.00016199,97.32822944
30229,李健果,1,600814,0.00016199,97.32839143
30230,李曼峰,1,600815,0.00016199,97.32855342
30231,李梅仙,1,600816,0.00016199,97.32871542
30232,李眷,1,600817,0.00016199,97.32887741
30233,李媛媛,1,600818,0.00016199,97.32903941
30234,李斯．布朗,1,600819,0.00016199,97.32920140
30235,李斯特,1,600820,0.00016199,97.32936340
30236,李絲麗林卡葛蕾特,1,600821,0.00016199,97.32952539
30237,李超,1,600822,0.00016199,97.32968738
30238,李雅景,1,600823,0.00016199,97.32984938
30239,李雲鑫,1,600824,0.00016199,97.33001137
30240,李奧納德,1,600825,0.00016199,97.33017337
30241,李煥章,1,600826,0.00016199,97.33033536
30242,李嘉,1,600827,0.00016199,97.33049735
30243,李察吉爾,1,600828,0.00016199,97.33065935
30244,李榮烈,1,600829,0.00016199,97.33082134
30245,李滿江,1,600830,0.00016199,97.33098334
30246,李熊標,1,600831,0.00016199,97.33114533
30247,李維,1,600832,0.00016199,97.33130733
30248,李維史陀,1,600833,0.00016199,97.33146932
30249,李維民,1,600834,0.00016199,97.33163131
30250,李銀滄,1,600835,0.00016199,97.33179331
30251,李慶元,1,600836,0.00016199,97.33195530
30252,李慧敏,1,600837,0.00016199,97.33211730
30253,李衛華,1,600838,0.00016199,97.33227929
30254,李靜婷,1,600839,0.00016199,97.33244129
30255,李鴻基,1,600840,0.00016199,97.33260328
30256,李瀛輝,1,600841,0.00016199,97.33276527
30257,杏仁,1,600842,0.00016199,97.33292727
30258,材木,1,600843,0.00016199,97.33308926
30259,材料所,1,600844,0.00016199,97.33325126
30260,材料學會,1,600845,0.00016199,97.33341325
30261,村童,1,600846,0.00016199,97.33357524
30262,村廟,1,600847,0.00016199,97.33373724
30263,杜小雙,1,600848,0.00016199,97.33389923
30264,杜之外,1,600849,0.00016199,97.33406123
30265,杜可風,1,600850,0.00016199,97.33422322
30266,杜全昌,1,600851,0.00016199,97.33438522
30267,杜邦公司,1,600852,0.00016199,97.33454721
30268,杜帕克,1,600853,0.00016199,97.33470920
30269,杜金龍,1,600854,0.00016199,97.33487120
30270,杜書伍,1,600855,0.00016199,97.33503319
30271,杜茲綠洲,1,600856,0.00016199,97.33519519
30272,杜強,1,600857,0.00016199,97.33535718
30273,杜惠美,1,600858,0.00016199,97.33551918
30274,杜斯妥也夫斯基,1,600859,0.00016199,97.33568117
30275,杜進才,1,600860,0.00016199,97.33584316
30276,杜德偉,1,600861,0.00016199,97.33600516
30277,杜鵑,1,600862,0.00016199,97.33616715
30278,杜蘭朵,1,600863,0.00016199,97.33632915
30279,杖,1,600864,0.00016199,97.33649114
30280,杉山寧,1,600865,0.00016199,97.33665313
30281,杆格,1,600866,0.00016199,97.33681513
30282,步下,1,600867,0.00016199,97.33697712
30283,步上,1,600868,0.00016199,97.33713912
30284,步子,1,600869,0.00016199,97.33730111
30285,步出,1,600870,0.00016199,97.33746311
30286,步行蟲,1,600871,0.00016199,97.33762510
30287,步程,1,600872,0.00016199,97.33778709
30288,步進馬達,1,600873,0.00016199,97.33794909
30289,步履,1,600874,0.00016199,97.33811108
30290,每日新聞,1,600875,0.00016199,97.33827308
30291,每日新聞報,1,600876,0.00016199,97.33843507
30292,每日雙周刊,1,600877,0.00016199,97.33859707
30293,求仁得仁,1,600878,0.00016199,97.33875906
30294,求去,1,600879,0.00016199,97.33892105
30295,求生,1,600880,0.00016199,97.33908305
30296,求生存,1,600881,0.00016199,97.33924504
30297,求刑,1,600882,0.00016199,97.33940704
30298,求同化異,1,600883,0.00016199,97.33956903
30299,求助信,1,600884,0.00016199,97.33973102
30300,求取,1,600885,0.00016199,97.33989302
30301,求偶季,1,600886,0.00016199,97.34005501
30302,求偶期,1,600887,0.00016199,97.34021701
30303,求情,1,600888,0.00016199,97.34037900
30304,求救,1,600889,0.00016199,97.34054100
30305,求救函,1,600890,0.00016199,97.34070299
30306,求現,1,600891,0.00016199,97.34086498
30307,求勝心,1,600892,0.00016199,97.34102698
30308,求新求變,1,600893,0.00016199,97.34118897
30309,求饒,1,600894,0.00016199,97.34135097
30310,汞,1,600895,0.00016199,97.34151296
30311,沙丁魚,1,600896,0.00016199,97.34167496
30312,沙天牛,1,600897,0.00016199,97.34183695
30313,沙加緬度,1,600898,0.00016199,97.34199894
30314,沙末依斯邁,1,600899,0.00016199,97.34216094
30315,沙石,1,600900,0.00016199,97.34232293
30316,沙立克山崗,1,600901,0.00016199,97.34248493
30317,沙西米,1,600902,0.00016199,97.34264692
30318,沙沙響聲,1,600903,0.00016199,97.34280891
30319,沙岩,1,600904,0.00016199,97.34297091
30320,沙拉吧,1,600905,0.00016199,97.34313290
30321,沙林毒氣,1,600906,0.00016199,97.34329490
30322,沙皇時期,1,600907,0.00016199,97.34345689
30323,沙國,1,600908,0.00016199,97.34361889
30324,沙崙地區,1,600909,0.00016199,97.34378088
30325,沙場,1,600910,0.00016199,97.34394287
30326,沙發椅,1,600911,0.00016199,97.34410487
30327,沙鍋,1,600912,0.00016199,97.34426686
30328,沙灘車,1,600913,0.00016199,97.34442886
30329,沁,1,600914,0.00016199,97.34459085
30330,沈入,1,600915,0.00016199,97.34475285
30331,沈不住氣,1,600916,0.00016199,97.34491484
30332,沈立安,1,600917,0.00016199,97.34507683
30333,沈伊默,1,600918,0.00016199,97.34523883
30334,沈呂百,1,600919,0.00016199,97.34540082
30335,沈沒,1,600920,0.00016199,97.34556282
30336,沈思,1,600921,0.00016199,97.34572481
30337,沈偉,1,600922,0.00016199,97.34588680
30338,沈淪,1,600923,0.00016199,97.34604880
30339,沈揚,1,600924,0.00016199,97.34621079
30340,沈溺,1,600925,0.00016199,97.34637279
30341,沈道立,1,600926,0.00016199,97.34653478
30342,沈潛,1,600927,0.00016199,97.34669678
30343,沈默寡言,1,600928,0.00016199,97.34685877
30344,沉吟,1,600929,0.00016199,97.34702076
30345,沉沉欲睡,1,600930,0.00016199,97.34718276
30346,沉沒,1,600931,0.00016199,97.34734475
30347,沉迷,1,600932,0.00016199,97.34750675
30348,沉痛,1,600933,0.00016199,97.34766874
30349,沉著,1,600934,0.00016199,97.34783074
30350,沉溺,1,600935,0.00016199,97.34799273
30351,沉睡,1,600936,0.00016199,97.34815472
30352,沉蓄,1,600937,0.00016199,97.34831672
30353,沉潛,1,600938,0.00016199,97.34847871
30354,沉積,1,600939,0.00016199,97.34864071
30355,汪士瑜,1,600940,0.00016199,97.34880270
30356,汪大衛,1,600941,0.00016199,97.34896469
30357,汪汪,1,600942,0.00016199,97.34912669
30358,汪敬煦,1,600943,0.00016199,97.34928868
30359,汪精衛,1,600944,0.00016199,97.34945068
30360,汪輝祖,1,600945,0.00016199,97.34961267
30361,決一勝負,1,600946,0.00016199,97.34977467
30362,決明子,1,600947,0.00016199,97.34993666
30363,決勝,1,600948,0.00016199,97.35009865
30364,決勝期,1,600949,0.00016199,97.35026065
30365,決然,1,600950,0.00016199,97.35042264
30366,決策中心,1,600951,0.00016199,97.35058464
30367,決策者,1,600952,0.00016199,97.35074663
30368,決策權,1,600953,0.00016199,97.35090863
30369,決裂,1,600954,0.00016199,97.35107062
30370,決意,1,600955,0.00016199,97.35123261
30371,決標,1,600956,0.00016199,97.35139461
30372,決選,1,600957,0.00016199,97.35155660
30373,決斷,1,600958,0.00016199,97.35171860
30374,汰舊,1,600959,0.00016199,97.35188059
30375,汨,1,600960,0.00016199,97.35204258
30376,汨羅,1,600961,0.00016199,97.35220458
30377,沖片罐,1,600962,0.00016199,97.35236657
30378,沖印,1,600963,0.00016199,97.35252857
30379,沖印店,1,600964,0.00016199,97.35269056
30380,沖回,1,600965,0.00016199,97.35285256
30381,沖刷,1,600966,0.00016199,97.35301455
30382,沖昏頭,1,600967,0.00016199,97.35317654
30383,沖泡,1,600968,0.00016199,97.35333854
30384,沖洗式,1,600969,0.00016199,97.35350053
30385,沖洗術,1,600970,0.00016199,97.35366253
30386,沖掉,1,600971,0.00016199,97.35382452
30387,沖淨,1,600972,0.00016199,97.35398652
30388,沖銷,1,600973,0.00016199,97.35414851
30389,沖澠市立棒球場,1,600974,0.00016199,97.35431050
30390,沖繩盃公開賽,1,600975,0.00016199,97.35447250
30391,沖繩縣,1,600976,0.00016199,97.35463449
30392,沒出息,1,600977,0.00016199,97.35479649
30393,沒有人,1,600978,0.00016199,97.35495848
30394,沒沒無名,1,600979,0.00016199,97.35512048
30395,沒沒無聞,1,600980,0.00016199,97.35528247
30396,沒法子,1,600981,0.00016199,97.35544446
30397,汽化,1,600982,0.00016199,97.35560646
30398,汽水瓶,1,600983,0.00016199,97.35576845
30399,汽車修理廠,1,600984,0.00016199,97.35593045
30400,汽車商,1,600985,0.00016199,97.35609244
30401,汽車電話,1,600986,0.00016199,97.35625443
30402,汽車暨軍備司令部,1,600987,0.00016199,97.35641643
30403,汽車導航系統,1,600988,0.00016199,97.35657842
30404,汽油引擎,1,600989,0.00016199,97.35674042
30405,汽油系統,1,600990,0.00016199,97.35690241
30406,汽油車,1,600991,0.00016199,97.35706441
30407,汽油桶,1,600992,0.00016199,97.35722640
30408,汽泡酒,1,600993,0.00016199,97.35738839
30409,沃夫,1,600994,0.00016199,97.35755039
30410,沃艾人,1,600995,0.00016199,97.35771238
30411,沃艾族,1,600996,0.00016199,97.35787438
30412,沃特．惠特摩爾,1,600997,0.00016199,97.35803637
30413,汲,1,600998,0.00016199,97.35819837
30414,汲水,1,600999,0.00016199,97.35836036
30415,汲汲營營,1,601000,0.00016199,97.35852235
30416,灼熱,1,601001,0.00016199,97.35868435
30417,災厄,1,601002,0.00016199,97.35884634
30418,災戶,1,601003,0.00016199,97.35900834
30419,災後,1,601004,0.00016199,97.35917033
30420,災變,1,601005,0.00016199,97.35933232
30421,牢房,1,601006,0.00016199,97.35949432
30422,牡丹,1,601007,0.00016199,97.35965631
30423,牡丹皮,1,601008,0.00016199,97.35981831
30424,牡丹亭,1,601009,0.00016199,97.35998030
30425,狄恩,1,601010,0.00016199,97.36014230
30426,狄恩戴弗林,1,601011,0.00016199,97.36030429
30427,狄嘉,1,601012,0.00016199,97.36046628
30428,狄鶯,1,601013,0.00016199,97.36062828
30429,狂人,1,601014,0.00016199,97.36079027
30430,狂妄,1,601015,0.00016199,97.36095227
30431,狂烈,1,601016,0.00016199,97.36111426
30432,狂笑,1,601017,0.00016199,97.36127626
30433,狂漲,1,601018,0.00016199,97.36143825
30434,狂歡,1,601019,0.00016199,97.36160024
30435,狂歡節,1,601020,0.00016199,97.36176224
30436,玖龍企業,1,601021,0.00016199,97.36192423
30437,男女老幼,1,601022,0.00016199,97.36208623
30438,男女朋友,1,601023,0.00016199,97.36224822
30439,男女關係,1,601024,0.00016199,97.36241021
30440,男方,1,601025,0.00016199,97.36257221
30441,男同性戀,1,601026,0.00016199,97.36273420
30442,男同學,1,601027,0.00016199,97.36289620
30443,男色,1,601028,0.00016199,97.36305819
30444,男兒身,1,601029,0.00016199,97.36322019
30445,男性化,1,601030,0.00016199,97.36338218
30446,男裝業,1,601031,0.00016199,97.36354417
30447,男籃,1,601032,0.00016199,97.36370617
30448,皂化,1,601033,0.00016199,97.36386816
30449,私人渡假區,1,601034,0.00016199,97.36403016
30450,私生活,1,601035,0.00016199,97.36419215
30451,私立大學,1,601036,0.00016199,97.36435415
30452,私立學校法,1,601037,0.00016199,97.36451614
30453,私利,1,601038,0.00016199,97.36467813
30454,私事,1,601039,0.00016199,97.36484013
30455,私底,1,601040,0.00016199,97.36500212
30456,私相授受,1,601041,0.00016199,97.36516412
30457,私密,1,601042,0.00016199,97.36532611
30458,私欲,1,601043,0.00016199,97.36548810
30459,私處,1,601044,0.00016199,97.36565010
30460,秀才,1,601045,0.00016199,97.36581209
30461,秀林鄉,1,601046,0.00016199,97.36597409
30462,秀娥,1,601047,0.00016199,97.36613608
30463,秀逗,1,601048,0.00016199,97.36629808
30464,秀髮,1,601049,0.00016199,97.36646007
30465,禿,1,601050,0.00016199,97.36662206
30466,禿鷹,1,601051,0.00016199,97.36678406
30467,禿鸛,1,601052,0.00016199,97.36694605
30468,系上,1,601053,0.00016199,97.36710805
30469,系列性,1,601054,0.00016199,97.36727004
30470,系統戰,1,601055,0.00016199,97.36743204
30471,肖象,1,601056,0.00016199,97.36759403
30472,肝功能,1,601057,0.00016199,97.36775602
30473,肝門靜脈,1,601058,0.00016199,97.36791802
30474,肝疾,1,601059,0.00016199,97.36808001
30475,肝細胞癌,1,601060,0.00016199,97.36824201
30476,肝斑,1,601061,0.00016199,97.36840400
30477,肝脾,1,601062,0.00016199,97.36856599
30478,肝酥丸,1,601063,0.00016199,97.36872799
30479,肝糖,1,601064,0.00016199,97.36888998
30480,肝膿瘍,1,601065,0.00016199,97.36905198
30481,肝膽,1,601066,0.00016199,97.36921397
30482,育成型,1,601067,0.00016199,97.36937597
30483,育兒,1,601068,0.00016199,97.36953796
30484,育林,1,601069,0.00016199,97.36969995
30485,育林國小,1,601070,0.00016199,97.36986195
30486,育嬰,1,601071,0.00016199,97.37002394
30487,良久,1,601072,0.00016199,97.37018594
30488,良方,1,601073,0.00016199,97.37034793
30489,良多,1,601074,0.00016199,97.37050993
30490,良辰吉時,1,601075,0.00016199,97.37067192
30491,良品,1,601076,0.00016199,97.37083391
30492,良美,1,601077,0.00016199,97.37099591
30493,良苦,1,601078,0.00016199,97.37115790
30494,良港,1,601079,0.00016199,97.37131990
30495,良緣,1,601080,0.00016199,97.37148189
30496,良質,1,601081,0.00016199,97.37164388
30497,良窳,1,601082,0.00016199,97.37180588
30498,芒草,1,601083,0.00016199,97.37196787
30499,見地,1,601084,0.00016199,97.37212987
30500,見色忘友,1,601085,0.00016199,97.37229186
30501,見見,1,601086,0.00016199,97.37245386
30502,見到,1,601087,0.00016199,97.37261585
30503,見底,1,601088,0.00016199,97.37277784
30504,見怪不怪,1,601089,0.00016199,97.37293984
30505,見表,1,601090,0.00016199,97.37310183
30506,見習,1,601091,0.00016199,97.37326383
30507,見証,1,601092,0.00016199,97.37342582
30508,見義勇為,1,601093,0.00016199,97.37358782
30509,見過,1,601094,0.00016199,97.37374981
30510,見覆,1,601095,0.00016199,97.37391180
30511,角色扮演,1,601096,0.00016199,97.37407380
30512,角宿村,1,601097,0.00016199,97.37423579
30513,角蛋白,1,601098,0.00016199,97.37439779
30514,角逐戰,1,601099,0.00016199,97.37455978
30515,角質殼,1,601100,0.00016199,97.37472177
30516,言下之意,1,601101,0.00016199,97.37488377
30517,言之過早,1,601102,0.00016199,97.37504576
30518,言明,1,601103,0.00016199,97.37520776
30519,言表,1,601104,0.00016199,97.37536975
30520,言情小說,1,601105,0.00016199,97.37553175
30521,言教,1,601106,0.00016199,97.37569374
30522,言喻,1,601107,0.00016199,97.37585573
30523,言菊朋,1,601108,0.00016199,97.37601773
30524,言傳,1,601109,0.00016199,97.37617972
30525,言談舉止,1,601110,0.00016199,97.37634172
30526,言興朋,1,601111,0.00016199,97.37650371
30527,言簡意賅,1,601112,0.00016199,97.37666571
30528,谷染,1,601113,0.00016199,97.37682770
30529,豆干,1,601114,0.00016199,97.37698969
30530,豆干絲,1,601115,0.00016199,97.37715169
30531,豆芽,1,601116,0.00016199,97.37731368
30532,豆花,1,601117,0.00016199,97.37747568
30533,豆乾,1,601118,0.00016199,97.37763767
30534,豆豉,1,601119,0.00016199,97.37779966
30535,豆鼓,1,601120,0.00016199,97.37796166
30536,豆腐丸子,1,601121,0.00016199,97.37812365
30537,豆輪,1,601122,0.00016199,97.37828565
30538,豆簽,1,601123,0.00016199,97.37844764
30539,豆蔻,1,601124,0.00016199,97.37860964
30540,貝比雍,1,601125,0.00016199,97.37877163
30541,貝氏,1,601126,0.00016199,97.37893362
30542,貝加,1,601127,0.00016199,97.37909562
30543,貝母,1,601128,0.00016199,97.37925761
30544,貝克鴨,1,601129,0.00016199,97.37941961
30545,貝貝紐渥絲,1,601130,0.00016199,97.37958160
30546,貝里,1,601131,0.00016199,97.37974360
30547,貝河省,1,601132,0.00016199,97.37990559
30548,貝特杭塔維涅,1,601133,0.00016199,97.38006758
30549,貝納,1,601134,0.00016199,97.38022958
30550,貝勒維爾,1,601135,0.00016199,97.38039157
30551,貝都因人,1,601136,0.00016199,97.38055357
30552,貝斯,1,601137,0.00016199,97.38071556
30553,貝蒂蜜勒,1,601138,0.00016199,97.38087756
30554,貝爾,1,601139,0.00016199,97.38103955
30555,貝爾曲線,1,601140,0.00016199,97.38120154
30556,貝爾格,1,601141,0.00016199,97.38136354
30557,赤子,1,601142,0.00016199,97.38152553
30558,赤子心,1,601143,0.00016199,97.38168753
30559,赤芍,1,601144,0.00016199,97.38184952
30560,赤身,1,601145,0.00016199,97.38201151
30561,赤珊瑚,1,601146,0.00016199,97.38217351
30562,赤島社,1,601147,0.00016199,97.38233550
30563,赤腳,1,601148,0.00016199,97.38249750
30564,赤裸裸,1,601149,0.00016199,97.38265949
30565,赤熱,1,601150,0.00016199,97.38282149
30566,赤壁,1,601151,0.00016199,97.38298348
30567,走一走,1,601152,0.00016199,97.38314547
30568,走人,1,601153,0.00016199,97.38330747
30569,走上街頭,1,601154,0.00016199,97.38346946
30570,走不過,1,601155,0.00016199,97.38363146
30571,走火入魔,1,601156,0.00016199,97.38379345
30572,走行式,1,601157,0.00016199,97.38395545
30573,走走看,1,601158,0.00016199,97.38411744
30574,走走跑跑,1,601159,0.00016199,97.38427943
30575,走來走去,1,601160,0.00016199,97.38444143
30576,走狗,1,601161,0.00016199,97.38460342
30577,走弱,1,601162,0.00016199,97.38476542
30578,走馬燈,1,601163,0.00016199,97.38492741
30579,走動管理,1,601164,0.00016199,97.38508940
30580,走貶,1,601165,0.00016199,97.38525140
30581,走勢圖,1,601166,0.00016199,97.38541339
30582,走路法,1,601167,0.00016199,97.38557539
30583,走過,1,601168,0.00016199,97.38573738
30584,走邊,1,601169,0.00016199,97.38589938
30585,足見,1,601170,0.00016199,97.38606137
30586,足食,1,601171,0.00016199,97.38622336
30587,足球小將,1,601172,0.00016199,97.38638536
30588,足部,1,601173,0.00016199,97.38654735
30589,身亡,1,601174,0.00016199,97.38670935
30590,身不由己,1,601175,0.00016199,97.38687134
30591,身分證,1,601176,0.00016199,97.38703334
30592,身心俱疲,1,601177,0.00016199,97.38719533
30593,身孕,1,601178,0.00016199,97.38735732
30594,身份證書,1,601179,0.00016199,97.38751932
30595,身形,1,601180,0.00016199,97.38768131
30596,身來,1,601181,0.00016199,97.38784331
30597,身家性命,1,601182,0.00016199,97.38800530
30598,身教,1,601183,0.00016199,97.38816729
30599,車手,1,601184,0.00016199,97.38832929
30600,車主手冊,1,601185,0.00016199,97.38849128
30601,車外,1,601186,0.00016199,97.38865328
30602,車奴,1,601187,0.00016199,97.38881527
30603,車衣工,1,601188,0.00016199,97.38897727
30604,車衣機,1,601189,0.00016199,97.38913926
30605,車床,1,601190,0.00016199,97.38930125
30606,車車,1,601191,0.00016199,97.38946325
30607,車係,1,601192,0.00016199,97.38962524
30608,車胎,1,601193,0.00016199,97.38978724
30609,車庫,1,601194,0.00016199,97.38994923
30610,車舵,1,601195,0.00016199,97.39011123
30611,車速,1,601196,0.00016199,97.39027322
30612,車軸,1,601197,0.00016199,97.39043521
30613,車號,1,601198,0.00016199,97.39059721
30614,車潮,1,601199,0.00016199,97.39075920
30615,車輪,1,601200,0.00016199,97.39092120
30616,車輪戰,1,601201,0.00016199,97.39108319
30617,車頭燈,1,601202,0.00016199,97.39124518
30618,辛巴威,1,601203,0.00016199,97.39140718
30619,辛辛那堤,1,601204,0.00016199,97.39156917
30620,辛辛那提,1,601205,0.00016199,97.39173117
30621,辛辛苦苦,1,601206,0.00016199,97.39189316
30622,辛浦森,1,601207,0.00016199,97.39205516
30623,辛蒂．雪爾曼,1,601208,0.00016199,97.39221715
30624,辛蒂克勞馥,1,601209,0.00016199,97.39237914
30625,辛旗,1,601210,0.00016199,97.39254114
30626,辛諾波里,1,601211,0.00016199,97.39270313
30627,迅捷,1,601212,0.00016199,97.39286513
30628,迅雷,1,601213,0.00016199,97.39302712
30629,迄無先例,1,601214,0.00016199,97.39318912
30630,巡一,1,601215,0.00016199,97.39335111
30631,巡二艦隊,1,601216,0.00016199,97.39351310
30632,巡弋航程,1,601217,0.00016199,97.39367510
30633,巡查,1,601218,0.00016199,97.39383709
30634,巡看,1,601219,0.00016199,97.39399909
30635,巡迴展,1,601220,0.00016199,97.39416108
30636,巡迴賽,1,601221,0.00016199,97.39432307
30637,巡場,1,601222,0.00016199,97.39448507
30638,巡遊,1,601223,0.00016199,97.39464706
30639,巡演,1,601224,0.00016199,97.39480906
30640,巡邏車,1,601225,0.00016199,97.39497105
30641,巡邏網,1,601226,0.00016199,97.39513305
30642,巡邏機,1,601227,0.00016199,97.39529504
30643,邢智田,1,601228,0.00016199,97.39545703
30644,邦,1,601229,0.00016199,97.39561903
30645,邦交,1,601230,0.00016199,97.39578102
30646,邦迪,1,601231,0.00016199,97.39594302
30647,邦誼,1,601232,0.00016199,97.39610501
30648,那米比沙漠,1,601233,0.00016199,97.39626701
30649,那位,1,601234,0.00016199,97.39642900
30650,那些日子以來,1,601235,0.00016199,97.39659099
30651,那羅,1,601236,0.00016199,97.39675299
30652,那邊,1,601237,0.00016199,97.39691498
30653,里內．史崔克蘭德,1,601238,0.00016199,97.39707698
30654,里民大會,1,601239,0.00016199,97.39723897
30655,里耳,1,601240,0.00016199,97.39740096
30656,里脊肉,1,601241,0.00016199,97.39756296
30657,里戛杜卡利索,1,601242,0.00016199,97.39772495
30658,里港,1,601243,0.00016199,97.39788695
30659,里港鄉,1,601244,0.00016199,97.39804894
30660,里幹事,1,601245,0.00016199,97.39821094
30661,里歐納德．波特爾,1,601246,0.00016199,97.39837293
30662,里鄰,1,601247,0.00016199,97.39853492
30663,防水門,1,601248,0.00016199,97.39869692
30664,防水氣密,1,601249,0.00016199,97.39885891
30665,防火材料,1,601250,0.00016199,97.39902091
30666,防火時效,1,601251,0.00016199,97.39918290
30667,防火帽,1,601252,0.00016199,97.39934490
30668,防火樹,1,601253,0.00016199,97.39950689
30669,防火牆,1,601254,0.00016199,97.39966888
30670,防汙,1,601255,0.00016199,97.39983088
30671,防杜,1,601256,0.00016199,97.39999287
30672,防身,1,601257,0.00016199,97.40015487
30673,防波堤,1,601258,0.00016199,97.40031686
30674,防音林帶,1,601259,0.00016199,97.40047885
30675,防備,1,601260,0.00016199,97.40064085
30676,防盜器,1,601261,0.00016199,97.40080284
30677,防傾桿,1,601262,0.00016199,97.40096484
30678,防溺,1,601263,0.00016199,97.40112683
30679,防溺勤務,1,601264,0.00016199,97.40128883
30680,防漏,1,601265,0.00016199,97.40145082
30681,防腐性,1,601266,0.00016199,97.40161281
30682,防蝕,1,601267,0.00016199,97.40177481
30683,防彈盾,1,601268,0.00016199,97.40193680
30684,防彈背心,1,601269,0.00016199,97.40209880
30685,防撞鋼樑,1,601270,0.00016199,97.40226079
30686,防衛力,1,601271,0.00016199,97.40242279
30687,防衛牆,1,601272,0.00016199,97.40258478
30688,防震係數,1,601273,0.00016199,97.40274677
30689,阮孟琴,1,601274,0.00016199,97.40290877
30690,阮夏潘,1,601275,0.00016199,97.40307076
30691,阪神隊,1,601276,0.00016199,97.40323276
30692,並行,1,601277,0.00016199,97.40339475
30693,並行不悖,1,601278,0.00016199,97.40355674
30694,並肩,1,601279,0.00016199,97.40371874
30695,並肩作戰,1,601280,0.00016199,97.40388073
30696,並非如此,1,601281,0.00016199,97.40404273
30697,並將,1,601282,0.00016199,97.40420472
30698,乖巧,1,601283,0.00016199,97.40436672
30699,乖舛,1,601284,0.00016199,97.40452871
30700,乖乖順順,1,601285,0.00016199,97.40469070
30701,乖順,1,601286,0.00016199,97.40485270
30702,乖馴,1,601287,0.00016199,97.40501469
30703,乳白色,1,601288,0.00016199,97.40517669
30704,乳烙,1,601289,0.00016199,97.40533868
30705,乳黃色,1,601290,0.00016199,97.40550068
30706,乳腺炎,1,601291,0.00016199,97.40566267
30707,乳酪蛋糕,1,601292,0.00016199,97.40582466
30708,乳膏,1,601293,0.00016199,97.40598666
30709,乳製品,1,601294,0.00016199,97.40614865
30710,乳酸,1,601295,0.00016199,97.40631065
30711,乳癰,1,601296,0.00016199,97.40647264
30712,事事,1,601297,0.00016199,97.40663463
30713,事例,1,601298,0.00016199,97.40679663
30714,事倍功半,1,601299,0.00016199,97.40695862
30715,事務局,1,601300,0.00016199,97.40712062
30716,事務性,1,601301,0.00016199,97.40728261
30717,事業家,1,601302,0.00016199,97.40744461
30718,事業部,1,601303,0.00016199,97.40760660
30719,事業體,1,601304,0.00016199,97.40776859
30720,事過境遷,1,601305,0.00016199,97.40793059
30721,事證,1,601306,0.00016199,97.40809258
30722,事權不一,1,601307,0.00016199,97.40825458
30723,亞力山大健康俱樂部,1,601308,0.00016199,97.40841657
30724,亞太下背痛醫學會,1,601309,0.00016199,97.40857857
30725,亞太之星,1,601310,0.00016199,97.40874056
30726,亞太投資公司,1,601311,0.00016199,97.40890255
30727,亞太金融中心,1,601312,0.00016199,97.40906455
30728,亞太特區,1,601313,0.00016199,97.40922654
30729,亞太媒體公司,1,601314,0.00016199,97.40938854
30730,亞太製造中心,1,601315,0.00016199,97.40955053
30731,亞太營運特區,1,601316,0.00016199,97.40971253
30732,亞太藝術,1,601317,0.00016199,97.40987452
30733,亞布達,1,601318,0.00016199,97.41003651
30734,亞伯拉罕．林肯,1,601319,0.00016199,97.41019851
30735,亞伯特,1,601320,0.00016199,97.41036050
30736,亞克丹,1,601321,0.00016199,97.41052250
30737,亞利安,1,601322,0.00016199,97.41068449
30738,亞系,1,601323,0.00016199,97.41084648
30739,亞里斯多德,1,601324,0.00016199,97.41100848
30740,亞東醫院,1,601325,0.00016199,97.41117047
30741,亞東關係協會,1,601326,0.00016199,97.41133247
30742,亞泥公司,1,601327,0.00016199,97.41149446
30743,亞青杯,1,601328,0.00016199,97.41165646
30744,亞非研究學院,1,601329,0.00016199,97.41181845
30745,亞信,1,601330,0.00016199,97.41198044
30746,亞洲化學,1,601331,0.00016199,97.41214244
30747,亞洲信託公司,1,601332,0.00016199,97.41230443
30748,亞洲排球聯合總會,1,601333,0.00016199,97.41246643
30749,亞洲證券公司,1,601334,0.00016199,97.41262842
30750,亞美尼亞,1,601335,0.00016199,97.41279042
30751,亞美尼亞人,1,601336,0.00016199,97.41295241
30752,亞倫,1,601337,0.00016199,97.41311440
30753,亞特藍道夫,1,601338,0.00016199,97.41327640
30754,亞特蘭大奧運會,1,601339,0.00016199,97.41343839
30755,亞特蘭大奧運籌備委員會,1,601340,0.00016199,97.41360039
30756,亞細亞,1,601341,0.00016199,97.41376238
30757,亞都飯店,1,601342,0.00016199,97.41392437
30758,亞麻仁油,1,601343,0.00016199,97.41408637
30759,亞斯克雷皮歐斯,1,601344,0.00016199,97.41424836
30760,亞視,1,601345,0.00016199,97.41441036
30761,亞瑟數據機,1,601346,0.00016199,97.41457235
30762,亞當．史密斯,1,601347,0.00016199,97.41473435
30763,亞當．蘇利文,1,601348,0.00016199,97.41489634
30764,亞當斯,1,601349,0.00016199,97.41505833
30765,亞群,1,601350,0.00016199,97.41522033
30766,亞爾比昂,1,601351,0.00016199,97.41538232
30767,亞聚,1,601352,0.00016199,97.41554432
30768,亞熱帶地區,1,601353,0.00016199,97.41570631
30769,亞駒大紀念柱,1,601354,0.00016199,97.41586831
30770,亞擔那州,1,601355,0.00016199,97.41603030
30771,亞擔那航空學校,1,601356,0.00016199,97.41619229
30772,亞擔納,1,601357,0.00016199,97.41635429
30773,亞歷鮑德溫,1,601358,0.00016199,97.41651628
30774,亞諾德,1,601359,0.00016199,97.41667828
30775,亞聯工程顧問公司,1,601360,0.00016199,97.41684027
30776,亞胺環己酮,1,601361,0.00016199,97.41700226
30777,京人,1,601362,0.00016199,97.41716426
30778,京兆尹,1,601363,0.00016199,97.41732625
30779,京阪神地區,1,601364,0.00016199,97.41748825
30780,京官,1,601365,0.00016199,97.41765024
30781,京津,1,601366,0.00016199,97.41781224
30782,京都大學,1,601367,0.00016199,97.41797423
30783,京陽實業,1,601368,0.00016199,97.41813622
30784,京劇界,1,601369,0.00016199,97.41829822
30785,京劇院,1,601370,0.00016199,97.41846021
30786,京劇組,1,601371,0.00016199,97.41862221
30787,京德,1,601372,0.00016199,97.41878420
30788,京戲,1,601373,0.00016199,97.41894620
30789,佯,1,601374,0.00016199,97.41910819
30790,依山,1,601375,0.00016199,97.41927018
30791,依次,1,601376,0.00016199,97.41943218
30792,依依,1,601377,0.00016199,97.41959417
30793,依恃,1,601378,0.00016199,97.41975617
30794,依偎,1,601379,0.00016199,97.41991816
30795,依斯特,1,601380,0.00016199,97.42008015
30796,依樣,1,601381,0.00016199,97.42024215
30797,依賴性,1,601382,0.00016199,97.42040414
30798,侍,1,601383,0.00016199,97.42056614
30799,佳士得公司,1,601384,0.00016199,97.42072813
30800,佳句,1,601385,0.00016199,97.42089013
30801,佳作獎,1,601386,0.00016199,97.42105212
30802,佳里糖廠,1,601387,0.00016199,97.42121411
30803,佳佳的妹妹不見了,1,601388,0.00016199,97.42137611
30804,佳和,1,601389,0.00016199,97.42153810
30805,佳音英語,1,601390,0.00016199,97.42170010
30806,佳鼎科技,1,601391,0.00016199,97.42186209
30807,佳樂水風景區,1,601392,0.00016199,97.42202409
30808,佳營電子,1,601393,0.00016199,97.42218608
30809,佳鵝公路,1,601394,0.00016199,97.42234807
30810,佳麗,1,601395,0.00016199,97.42251007
30811,使力,1,601396,0.00016199,97.42267206
30812,使用人,1,601397,0.00016199,97.42283406
30813,使用戶,1,601398,0.00016199,97.42299605
30814,使用卡,1,601399,0.00016199,97.42315804
30815,使用年限,1,601400,0.00016199,97.42332004
30816,使用性,1,601401,0.00016199,97.42348203
30817,使用執照,1,601402,0.00016199,97.42364403
30818,使用期,1,601403,0.00016199,97.42380602
30819,使用量,1,601404,0.00016199,97.42396802
30820,使命感,1,601405,0.00016199,97.42413001
30821,使喚,1,601406,0.00016199,97.42429200
30822,使然,1,601407,0.00016199,97.42445400
30823,佬,1,601408,0.00016199,97.42461599
30824,供不起,1,601409,0.00016199,97.42477799
30825,供水,1,601410,0.00016199,97.42493998
30826,供出,1,601411,0.00016199,97.42510198
30827,供承,1,601412,0.00016199,97.42526397
30828,供品,1,601413,0.00016199,97.42542596
30829,供養人,1,601414,0.00016199,97.42558796
30830,供辭,1,601415,0.00016199,97.42574995
30831,例句,1,601416,0.00016199,97.42591195
30832,例假日,1,601417,0.00016199,97.42607394
30833,例証,1,601418,0.00016199,97.42623593
30834,來年,1,601419,0.00016199,97.42639793
30835,來者,1,601420,0.00016199,97.42655992
30836,來者不善,1,601421,0.00016199,97.42672192
30837,來客,1,601422,0.00016199,97.42688391
30838,來看東西的剖面,1,601423,0.00016199,97.42704591
30839,來時路,1,601424,0.00016199,97.42720790
30840,來得少,1,601425,0.00016199,97.42736989
30841,來處,1,601426,0.00016199,97.42753189
30842,來越,1,601427,0.00016199,97.42769388
30843,來源國,1,601428,0.00016199,97.42785588
30844,來路不明,1,601429,0.00016199,97.42801787
30845,來電者,1,601430,0.00016199,97.42817987
30846,來歷,1,601431,0.00016199,97.42834186
30847,來頭,1,601432,0.00016199,97.42850385
30848,併用,1,601433,0.00016199,97.42866585
30849,併同,1,601434,0.00016199,97.42882784
30850,併合,1,601435,0.00016199,97.42898984
30851,佩尼卡,1,601436,0.00016199,97.42915183
30852,佩卓夫斯基劇院,1,601437,0.00016199,97.42931382
30853,佩特．尼克森,1,601438,0.00016199,97.42947582
30854,佩蒂,1,601439,0.00016199,97.42963781
30855,佾,1,601440,0.00016199,97.42979981
30856,侏儒,1,601441,0.00016199,97.42996180
30857,兔,1,601442,0.00016199,97.43012380
30858,兒子的大玩偶,1,601443,0.00016199,97.43028579
30859,兒孫,1,601444,0.00016199,97.43044778
30860,兒茶酚氨,1,601445,0.00016199,97.43060978
30861,兒童文學會,1,601446,0.00016199,97.43077177
30862,兒童文學學會,1,601447,0.00016199,97.43093377
30863,兒童者,1,601448,0.00016199,97.43109576
30864,兒童級,1,601449,0.00016199,97.43125776
30865,兒童基金會,1,601450,0.00016199,97.43141975
30866,兒童救濟基金,1,601451,0.00016199,97.43158174
30867,兒童節,1,601452,0.00016199,97.43174374
30868,兒童運動會,1,601453,0.00016199,97.43190573
30869,兒童遊園,1,601454,0.00016199,97.43206773
30870,兒童福利聯盟基金會,1,601455,0.00016199,97.43222972
30871,兒童營,1,601456,0.00016199,97.43239171
30872,兒歌,1,601457,0.00016199,97.43255371
30873,兩手,1,601458,0.00016199,97.43271570
30874,兩手肘,1,601459,0.00016199,97.43287770
30875,兩手並進,1,601460,0.00016199,97.43303969
30876,兩手策略,1,601461,0.00016199,97.43320169
30877,兩用,1,601462,0.00016199,97.43336368
30878,兩全其美,1,601463,0.00016199,97.43352567
30879,兩年改善計畫,1,601464,0.00016199,97.43368767
30880,兩肋插刀,1,601465,0.00016199,97.43384966
30881,兩衣廠,1,601466,0.00016199,97.43401166
30882,兩位數,1,601467,0.00016199,97.43417365
30883,兩把刷子,1,601468,0.00016199,97.43433565
30884,兩角,1,601469,0.00016199,97.43449764
30885,兩岸白皮書,1,601470,0.00016199,97.43465963
30886,兩岸協定,1,601471,0.00016199,97.43482163
30887,兩岸航運協會,1,601472,0.00016199,97.43498362
30888,兩岸通航,1,601473,0.00016199,97.43514562
30889,兩性,1,601474,0.00016199,97.43530761
30890,兩段式省水馬桶,1,601475,0.00016199,97.43546960
30891,兩個,1,601476,0.00016199,97.43563160
30892,兩旁,1,601477,0.00016199,97.43579359
30893,兩敗俱傷,1,601478,0.00016199,97.43595559
30894,兩組,1,601479,0.00016199,97.43611758
30895,兩棲動物,1,601480,0.00016199,97.43627958
30896,兩棲登陸,1,601481,0.00016199,97.43644157
30897,兩棲戰車團,1,601482,0.00016199,97.43660356
30898,兩塊,1,601483,0.00016199,97.43676556
30899,兩會,1,601484,0.00016199,97.43692755
30900,兩歲,1,601485,0.00016199,97.43708955
30901,兩層,1,601486,0.00016199,97.43725154
30902,兩廣總督,1,601487,0.00016199,97.43741354
30903,兩輪,1,601488,0.00016199,97.43757553
30904,兩頰,1,601489,0.00016199,97.43773752
30905,兩頭,1,601490,0.00016199,97.43789952
30906,兩點,1,601491,0.00016199,97.43806151
30907,兩點半,1,601492,0.00016199,97.43822351
30908,具文,1,601493,0.00016199,97.43838550
30909,具全,1,601494,0.00016199,97.43854750
30910,具志川市球場,1,601495,0.00016199,97.43870949
30911,具象化,1,601496,0.00016199,97.43887148
30912,具體化,1,601497,0.00016199,97.43903348
30913,典藏版,1,601498,0.00016199,97.43919547
30914,典藏館,1,601499,0.00016199,97.43935747
30915,函送,1,601500,0.00016199,97.43951946
30916,函請,1,601501,0.00016199,97.43968145
30917,刻文,1,601502,0.00016199,97.43984345
30918,刻片機,1,601503,0.00016199,97.44000544
30919,刻字,1,601504,0.00016199,97.44016744
30920,刻苦,1,601505,0.00016199,97.44032943
30921,刻苦耐勞,1,601506,0.00016199,97.44049143
30922,刻骨銘心,1,601507,0.00016199,97.44065342
30923,刻痕,1,601508,0.00016199,97.44081541
30924,刻鐘,1,601509,0.00016199,97.44097741
30925,刷出,1,601510,0.00016199,97.44113940
30926,刷卡,1,601511,0.00016199,97.44130140
30927,刺耳,1,601512,0.00016199,97.44146339
30928,刺眼,1,601513,0.00016199,97.44162539
30929,刺激感,1,601514,0.00016199,97.44178738
30930,刺激驚爆點,1,601515,0.00016199,97.44194937
30931,刺鮭皮,1,601516,0.00016199,97.44211137
30932,刺繡,1,601517,0.00016199,97.44227336
30933,到任,1,601518,0.00016199,97.44243536
30934,到時,1,601519,0.00016199,97.44259735
30935,到班,1,601520,0.00016199,97.44275934
30936,刮板,1,601521,0.00016199,97.44292134
30937,刮起,1,601522,0.00016199,97.44308333
30938,刮除,1,601523,0.00016199,97.44324533
30939,刮號,1,601524,0.00016199,97.44340732
30940,刮鬍族,1,601525,0.00016199,97.44356932
30941,制住,1,601526,0.00016199,97.44373131
30942,制免,1,601527,0.00016199,97.44389330
30943,制空權,1,601528,0.00016199,97.44405530
30944,制度面,1,601529,0.00016199,97.44421729
30945,制訂者,1,601530,0.00016199,97.44437929
30946,制勝,1,601531,0.00016199,97.44454128
30947,制電磁權,1,601532,0.00016199,97.44470328
30948,制憲,1,601533,0.00016199,97.44486527
30949,協和,1,601534,0.00016199,97.44502726
30950,協談,1,601535,0.00016199,97.44518926
30951,卓卡其,1,601536,0.00016199,97.44535125
30952,卓別林,1,601537,0.00016199,97.44551325
30953,卓庭竹,1,601538,0.00016199,97.44567524
30954,卓森雄,1,601539,0.00016199,97.44583723
30955,卓越性,1,601540,0.00016199,97.44599923
30956,卓蘭,1,601541,0.00016199,97.44616122
30957,卑,1,601542,0.00016199,97.44632322
30958,卑鄙,1,601543,0.00016199,97.44648521
30959,卷宗,1,601544,0.00016199,97.44664721
30960,卸妝液,1,601545,0.00016199,97.44680920
30961,卸放,1,601546,0.00016199,97.44697119
30962,卸唇液,1,601547,0.00016199,97.44713319
30963,卸責,1,601548,0.00016199,97.44729518
30964,取巧,1,601549,0.00016199,97.44745718
30965,取悅,1,601550,0.00016199,97.44761917
30966,取勝,1,601551,0.00016199,97.44778117
30967,取締役,1,601552,0.00016199,97.44794316
30968,取銷,1,601553,0.00016199,97.44810515
30969,取擷,1,601554,0.00016199,97.44826715
30970,受用,1,601555,0.00016199,97.44842914
30971,受光體,1,601556,0.00016199,97.44859114
30972,受氣包,1,601557,0.00016199,97.44875313
30973,受益權,1,601558,0.00016199,97.44891512
30974,受辱,1,601559,0.00016199,97.44907712
30975,受教,1,601560,0.00016199,97.44923911
30976,受累,1,601561,0.00016199,97.44940111
30977,受惠者,1,601562,0.00016199,97.44956310
30978,受測,1,601563,0.00016199,97.44972510
30979,受雇,1,601564,0.00016199,97.44988709
30980,受賄,1,601565,0.00016199,97.45004908
30981,受獎,1,601566,0.00016199,97.45021108
30982,受寵若驚,1,601567,0.00016199,97.45037307
30983,受騙,1,601568,0.00016199,97.45053507
30984,受權,1,601569,0.00016199,97.45069706
30985,味全公司,1,601570,0.00016199,97.45085906
30986,味全龍隊,1,601571,0.00016199,97.45102105
30987,味素,1,601572,0.00016199,97.45118304
30988,味醂,1,601573,0.00016199,97.45134504
30989,呵,1,601574,0.00016199,97.45150703
30990,呵呵,1,601575,0.00016199,97.45166903
30991,咖哩,1,601576,0.00016199,97.45183102
30992,咖啡命,1,601577,0.00016199,97.45199301
30993,咖啡室,1,601578,0.00016199,97.45215501
30994,咖啡屋,1,601579,0.00016199,97.45231700
30995,咖啡紅,1,601580,0.00016199,97.45247900
30996,咖啡座,1,601581,0.00016199,97.45264099
30997,咖啡粉,1,601582,0.00016199,97.45280299
30998,咖啡壺,1,601583,0.00016199,97.45296498
30999,咖啡漬,1,601584,0.00016199,97.45312697
31000,咖啡廳,1,601585,0.00016199,97.45328897
31001,咕噥,1,601586,0.00016199,97.45345096
31002,咀嚼感,1,601587,0.00016199,97.45361296
31003,呷,1,601588,0.00016199,97.45377495
31004,咄,1,601589,0.00016199,97.45393695
31005,咆哮,1,601590,0.00016199,97.45409894
31006,咆嘯聲,1,601591,0.00016199,97.45426093
31007,呼吸道感染,1,601592,0.00016199,97.45442293
31008,呼吸器,1,601593,0.00016199,97.45458492
31009,呼朋引伴,1,601594,0.00016199,97.45474692
31010,呼風喚雨,1,601595,0.00016199,97.45490891
31011,呼哮,1,601596,0.00016199,97.45507090
31012,呼啦舞,1,601597,0.00016199,97.45523290
31013,呼嘯,1,601598,0.00016199,97.45539489
31014,呼嘯而過,1,601599,0.00016199,97.45555689
31015,呼請,1,601600,0.00016199,97.45571888
31016,咐,1,601601,0.00016199,97.45588088
31017,和仁村,1,601602,0.00016199,97.45604287
31018,和平之旅,1,601603,0.00016199,97.45620486
31019,和平天使,1,601604,0.00016199,97.45636686
31020,和平水泥專業區,1,601605,0.00016199,97.45652885
31021,和平克．佛洛德,1,601606,0.00016199,97.45669085
31022,和平協定,1,601607,0.00016199,97.45685284
31023,和平泉町,1,601608,0.00016199,97.45701484
31024,和平相處,1,601609,0.00016199,97.45717683
31025,和平區,1,601610,0.00016199,97.45733882
31026,和平船,1,601611,0.00016199,97.45750082
31027,和平飯店,1,601612,0.00016199,97.45766281
31028,和合,1,601613,0.00016199,97.45782481
31029,和好如初,1,601614,0.00016199,97.45798680
31030,和成,1,601615,0.00016199,97.45814879
31031,和成企業,1,601616,0.00016199,97.45831079
31032,和成欣業,1,601617,0.00016199,97.45847278
31033,和協,1,601618,0.00016199,97.45863478
31034,和坤,1,601619,0.00016199,97.45879677
31035,和尚頭,1,601620,0.00016199,97.45895877
31036,和服,1,601621,0.00016199,97.45912076
31037,和信,1,601622,0.00016199,97.45928275
31038,和信集團,1,601623,0.00016199,97.45944475
31039,和信鯨隊,1,601624,0.00016199,97.45960674
31040,和桐,1,601625,0.00016199,97.45976874
31041,和真路,1,601626,0.00016199,97.45993073
31042,和高電器,1,601627,0.00016199,97.46009273
31043,和喬公司,1,601628,0.00016199,97.46025472
31044,和喬科技公司,1,601629,0.00016199,97.46041671
31045,和稀泥,1,601630,0.00016199,97.46057871
31046,和歌山縣,1,601631,0.00016199,97.46074070
31047,和歌詩人,1,601632,0.00016199,97.46090270
31048,和樂,1,601633,0.00016199,97.46106469
31049,和樂融融,1,601634,0.00016199,97.46122668
31050,和談,1,601635,0.00016199,97.46138868
31051,和諧性,1,601636,0.00016199,97.46155067
31052,和藹可親,1,601637,0.00016199,97.46171267
31053,呢帽,1,601638,0.00016199,97.46187466
31054,周一德,1,601639,0.00016199,97.46203666
31055,周人蔘案,1,601640,0.00016199,97.46219865
31056,周人蔘電玩案,1,601641,0.00016199,97.46236064
31057,周大華,1,601642,0.00016199,97.46252264
31058,周文郁,1,601643,0.00016199,97.46268463
31059,周世斌,1,601644,0.00016199,97.46284663
31060,周兆良,1,601645,0.00016199,97.46300862
31061,周佩虹,1,601646,0.00016199,97.46317062
31062,周到,1,601647,0.00016199,97.46333261
31063,周宗旭,1,601648,0.00016199,97.46349460
31064,周怡倫,1,601649,0.00016199,97.46365660
31065,周思潔,1,601650,0.00016199,97.46381859
31066,周美惠,1,601651,0.00016199,97.46398059
31067,周家獻,1,601652,0.00016199,97.46414258
31068,周密,1,601653,0.00016199,97.46430457
31069,周期,1,601654,0.00016199,97.46446657
31070,周維新,1,601655,0.00016199,97.46462856
31071,周賢坤,1,601656,0.00016199,97.46479056
31072,周勵志,1,601657,0.00016199,97.46495255
31073,周轉金,1,601658,0.00016199,97.46511455
31074,周炅鈞,1,601659,0.00016199,97.46527654
31075,咋,1,601660,0.00016199,97.46543853
31076,咋舌稱奇,1,601661,0.00016199,97.46560053
31077,命中,1,601662,0.00016199,97.46576252
31078,命中率,1,601663,0.00016199,97.46592452
31079,命仙,1,601664,0.00016199,97.46608651
31080,命官,1,601665,0.00016199,97.46624851
31081,命運交響曲,1,601666,0.00016199,97.46641050
31082,命館,1,601667,0.00016199,97.46657249
31083,固有,1,601668,0.00016199,97.46673449
31084,固定型投資商品,1,601669,0.00016199,97.46689648
31085,固票行動,1,601670,0.00016199,97.46705848
31086,垃圾分類,1,601671,0.00016199,97.46722047
31087,垃圾丘,1,601672,0.00016199,97.46738247
31088,垃圾堆,1,601673,0.00016199,97.46754446
31089,垃圾源,1,601674,0.00016199,97.46770645
31090,垃圾資源回收,1,601675,0.00016199,97.46786845
31091,坪方,1,601676,0.00016199,97.46803044
31092,坪林,1,601677,0.00016199,97.46819244
31093,坡頂,1,601678,0.00016199,97.46835443
31094,坡道,1,601679,0.00016199,97.46851642
31095,坦,1,601680,0.00016199,97.46867842
31096,坦克,1,601681,0.00016199,97.46884041
31097,坦言,1,601682,0.00016199,97.46900241
31098,坦率,1,601683,0.00016199,97.46916440
31099,坦誠,1,601684,0.00016199,97.46932640
31100,坤,1,601685,0.00016199,97.46948839
31101,坤生,1,601686,0.00016199,97.46965038
31102,夜入桃花源,1,601687,0.00016199,97.46981238
31103,夜大,1,601688,0.00016199,97.46997437
31104,夜不閉戶,1,601689,0.00016199,97.47013637
31105,夜行神龍,1,601690,0.00016199,97.47029836
31106,夜攻,1,601691,0.00016199,97.47046036
31107,夜夜,1,601692,0.00016199,97.47062235
31108,夜空,1,601693,0.00016199,97.47078434
31109,夜景,1,601694,0.00016199,97.47094634
31110,夜視鏡,1,601695,0.00016199,97.47110833
31111,夜裡,1,601696,0.00016199,97.47127033
31112,夜幕,1,601697,0.00016199,97.47143232
31113,夜貓族,1,601698,0.00016199,97.47159431
31114,夜總會,1,601699,0.00016199,97.47175631
31115,奉令,1,601700,0.00016199,97.47191830
31116,奉守,1,601701,0.00016199,97.47208030
31117,奉承,1,601702,0.00016199,97.47224229
31118,奉迎,1,601703,0.00016199,97.47240429
31119,奉派,1,601704,0.00016199,97.47256628
31120,奉為,1,601705,0.00016199,97.47272827
31121,奉陪到底,1,601706,0.00016199,97.47289027
31122,奉節,1,601707,0.00016199,97.47305226
31123,奇人,1,601708,0.00016199,97.47321426
31124,奇士勞斯基,1,601709,0.00016199,97.47337625
31125,奇石,1,601710,0.00016199,97.47353825
31126,奇妙的動物寶寶,1,601711,0.00016199,97.47370024
31127,奇妙的熊,1,601712,0.00016199,97.47386223
31128,奇妙的蝙蝠,1,601713,0.00016199,97.47402423
31129,奇妙國,1,601714,0.00016199,97.47418622
31130,奇奇怪怪,1,601715,0.00016199,97.47434822
31131,奇岩路,1,601716,0.00016199,97.47451021
31132,奇珍異獸,1,601717,0.00016199,97.47467220
31133,奇美公司,1,601718,0.00016199,97.47483420
31134,奇案,1,601719,0.00016199,97.47499619
31135,奇情,1,601720,0.00016199,97.47515819
31136,奇異旅程之真心愛你,1,601721,0.00016199,97.47532018
31137,奇想,1,601722,0.00016199,97.47548218
31138,奇裝異服,1,601723,0.00016199,97.47564417
31139,奇遇,1,601724,0.00016199,97.47580616
31140,奇緣,1,601725,0.00016199,97.47596816
31141,奇巖怪石,1,601726,0.00016199,97.47613015
31142,奈基,1,601727,0.00016199,97.47629215
31143,奔放的旋律,1,601728,0.00016199,97.47645414
31144,奔洩,1,601729,0.00016199,97.47661614
31145,奔騰,1,601730,0.00016199,97.47677813
31146,妾,1,601731,0.00016199,97.47694012
31147,妻兒,1,601732,0.00016199,97.47710212
31148,妻離子散,1,601733,0.00016199,97.47726411
31149,委托,1,601734,0.00016199,97.47742611
31150,委員長,1,601735,0.00016199,97.47758810
31151,委恩州立大學,1,601736,0.00016199,97.47775009
31152,委婉,1,601737,0.00016199,97.47791209
31153,委會員,1,601738,0.00016199,97.47807408
31154,委瑞內拉,1,601739,0.00016199,97.47823608
31155,姑姑,1,601740,0.00016199,97.47839807
31156,姑息,1,601741,0.00016199,97.47856007
31157,姆指,1,601742,0.00016199,97.47872206
31158,姐弟,1,601743,0.00016199,97.47888405
31159,姍拉娜,1,601744,0.00016199,97.47904605
31160,姊弟,1,601745,0.00016199,97.47920804
31161,姊妹市,1,601746,0.00016199,97.47937004
31162,孟加拉,1,601747,0.00016199,97.47953203
31163,孟庭葦,1,601748,0.00016199,97.47969403
31164,孟庭麗,1,601749,0.00016199,97.47985602
31165,孟許,1,601750,0.00016199,97.48001801
31166,孤女,1,601751,0.00016199,97.48018001
31167,孤立感,1,601752,0.00016199,97.48034200
31168,孤男寡女,1,601753,0.00016199,97.48050400
31169,孤注一擲,1,601754,0.00016199,97.48066599
31170,孤芳自賞,1,601755,0.00016199,97.48082798
31171,孤島,1,601756,0.00016199,97.48098998
31172,孤寂,1,601757,0.00016199,97.48115197
31173,孤魂,1,601758,0.00016199,97.48131397
31174,孤僻,1,601759,0.00016199,97.48147596
31175,孤獨的儀式,1,601760,0.00016199,97.48163796
31176,孤鶴,1,601761,0.00016199,97.48179995
31177,孤鸞年,1,601762,0.00016199,97.48196194
31178,季末,1,601763,0.00016199,97.48212394
31179,季季,1,601764,0.00016199,97.48228593
31180,季節性,1,601765,0.00016199,97.48244793
31181,季節感,1,601766,0.00016199,97.48260992
31182,季賽,1,601767,0.00016199,97.48277192
31183,宗教紀念區,1,601768,0.00016199,97.48293391
31184,宗教家,1,601769,0.00016199,97.48309590
31185,宗親會,1,601770,0.00016199,97.48325790
31186,宗鑫公司,1,601771,0.00016199,97.48341989
31187,定心丸,1,601772,0.00016199,97.48358189
31188,定目,1,601773,0.00016199,97.48374388
31189,定存利率,1,601774,0.00016199,97.48390587
31190,定作,1,601775,0.00016199,97.48406787
31191,定局,1,601776,0.00016199,97.48422986
31192,定見,1,601777,0.00016199,97.48439186
31193,定金,1,601778,0.00016199,97.48455385
31194,定型,1,601779,0.00016199,97.48471585
31195,定為,1,601780,0.00016199,97.48487784
31196,定風草,1,601781,0.00016199,97.48503983
31197,定策,1,601782,0.00016199,97.48520183
31198,定義成,1,601783,0.00016199,97.48536382
31199,定影盆,1,601784,0.00016199,97.48552582
31200,定稿,1,601785,0.00016199,97.48568781
31201,官司費,1,601786,0.00016199,97.48584981
31202,官股,1,601787,0.00016199,97.48601180
31203,官派,1,601788,0.00016199,97.48617379
31204,官派時代,1,601789,0.00016199,97.48633579
31205,官能,1,601790,0.00016199,97.48649778
31206,官商綁標,1,601791,0.00016199,97.48665978
31207,官評西,1,601792,0.00016199,97.48682177
31208,官運,1,601793,0.00016199,97.48698376
31209,宜人,1,601794,0.00016199,97.48714576
31210,宜昌,1,601795,0.00016199,97.48730775
31211,宜野灣市立棒球場,1,601796,0.00016199,97.48746975
31212,宜蘭人,1,601797,0.00016199,97.48763174
31213,宜蘭市,1,601798,0.00016199,97.48779374
31214,宜蘭客運,1,601799,0.00016199,97.48795573
31215,宙斯神,1,601800,0.00016199,97.48811772
31216,宙斯神殿,1,601801,0.00016199,97.48827972
31217,尚．布希亞,1,601802,0.00016199,97.48844171
31218,尚．法蘭斯瓦．李歐塔,1,601803,0.00016199,97.48860371
31219,尚‧布瑞,1,601804,0.00016199,97.48876570
31220,尚比亞,1,601805,0.00016199,97.48892770
31221,尚且,1,601806,0.00016199,97.48908969
31222,尚保羅高第耶,1,601807,0.00016199,97.48925168
31223,尚待,1,601808,0.00016199,97.48941368
31224,尚馬克巴爾,1,601809,0.00016199,97.48957567
31225,尚無,1,601810,0.00016199,97.48973767
31226,尚德工廠,1,601811,0.00016199,97.48989966
31227,尚德公司,1,601812,0.00016199,97.49006165
31228,尚德事件,1,601813,0.00016199,97.49022365
31229,尚屬,1,601814,0.00016199,97.49038564
31230,屈,1,601815,0.00016199,97.49054764
31231,屈服,1,601816,0.00016199,97.49070963
31232,屈就,1,601817,0.00016199,97.49087163
31233,居上,1,601818,0.00016199,97.49103362
31234,居中,1,601819,0.00016199,97.49119561
31235,居心,1,601820,0.00016199,97.49135761
31236,居民公約,1,601821,0.00016199,97.49151960
31237,居耳言,1,601822,0.00016199,97.49168160
31238,居住區,1,601823,0.00016199,97.49184359
31239,居所,1,601824,0.00016199,97.49200559
31240,居室,1,601825,0.00016199,97.49216758
31241,居高不下,1,601826,0.00016199,97.49232957
31242,居間,1,601827,0.00016199,97.49249157
31243,岩手縣,1,601828,0.00016199,97.49265356
31244,岩石堆中的綿羊,1,601829,0.00016199,97.49281556
31245,岩尾別,1,601830,0.00016199,97.49297755
31246,岩漿,1,601831,0.00016199,97.49313955
31247,岩鹽,1,601832,0.00016199,97.49330154
31248,岱山,1,601833,0.00016199,97.49346353
31249,岳父母,1,601834,0.00016199,97.49362553
31250,岳家,1,601835,0.00016199,97.49378752
31251,帕沙發,1,601836,0.00016199,97.49394952
31252,帕拉奧圖,1,601837,0.00016199,97.49411151
31253,帕洛阿爾特電力研究所,1,601838,0.00016199,97.49427350
31254,帕馬,1,601839,0.00016199,97.49443550
31255,帕德嫩神廟,1,601840,0.00016199,97.49459749
31256,幸運艦,1,601841,0.00016199,97.49475949
31257,幸福豹隊,1,601842,0.00016199,97.49492148
31258,幸福銳豹,1,601843,0.00016199,97.49508348
31259,店仔口,1,601844,0.00016199,97.49524547
31260,店招,1,601845,0.00016199,97.49540746
31261,店東,1,601846,0.00016199,97.49556946
31262,店門,1,601847,0.00016199,97.49573145
31263,店數,1,601848,0.00016199,97.49589345
31264,店鋪,1,601849,0.00016199,97.49605544
31265,店舖,1,601850,0.00016199,97.49621744
31266,底比斯,1,601851,0.00016199,97.49637943
31267,底光,1,601852,0.00016199,97.49654142
31268,底限,1,601853,0.00016199,97.49670342
31269,底特律老虎隊,1,601854,0.00016199,97.49686541
31270,底層,1,601855,0.00016199,97.49702741
31271,底標,1,601856,0.00016199,97.49718940
31272,庖廚,1,601857,0.00016199,97.49735139
31273,延存,1,601858,0.00016199,97.49751339
31274,延安,1,601859,0.00016199,97.49767538
31275,延年益壽,1,601860,0.00016199,97.49783738
31276,延展,1,601861,0.00016199,97.49799937
31277,延展性,1,601862,0.00016199,97.49816137
31278,延聘,1,601863,0.00016199,97.49832336
31279,延燒,1,601864,0.00016199,97.49848535
31280,延穎,1,601865,0.00016199,97.49864735
31281,延宕,1,601866,0.00016199,97.49880934
31282,弦樂器,1,601867,0.00016199,97.49897134
31283,弧,1,601868,0.00016199,97.49913333
31284,弧度,1,601869,0.00016199,97.49929533
31285,弧線,1,601870,0.00016199,97.49945732
31286,弩兵,1,601871,0.00016199,97.49961931
31287,往上,1,601872,0.00016199,97.49978131
31288,往右,1,601873,0.00016199,97.49994330
31289,往來戶,1,601874,0.00016199,97.50010530
31290,往東,1,601875,0.00016199,97.50026729
31291,往訪,1,601876,0.00016199,97.50042928
31292,征服力,1,601877,0.00016199,97.50059128
31293,征服者,1,601878,0.00016199,97.50075327
31294,彼岸,1,601879,0.00016199,97.50091527
31295,彼得,1,601880,0.00016199,97.50107726
31296,彼得．杜拉克,1,601881,0.00016199,97.50123926
31297,彼得．謝拉斯,1,601882,0.00016199,97.50140125
31298,彼得一世,1,601883,0.00016199,97.50156324
31299,彼得大帝,1,601884,0.00016199,97.50172524
31300,彼得林區,1,601885,0.00016199,97.50188723
31301,彼得聖吉,1,601886,0.00016199,97.50204923
31302,彼得福克,1,601887,0.00016199,97.50221122
31303,彼德洛希卡,1,601888,0.00016199,97.50237322
31304,忝,1,601889,0.00016199,97.50253521
31305,忠心,1,601890,0.00016199,97.50269720
31306,忠告,1,601891,0.00016199,97.50285920
31307,忠言,1,601892,0.00016199,97.50302119
31308,忠明南路,1,601893,0.00016199,97.50318319
31309,忠厚,1,601894,0.00016199,97.50334518
31310,忠貞,1,601895,0.00016199,97.50350717
31311,忠烈祠,1,601896,0.00016199,97.50366917
31312,忠義同志會,1,601897,0.00016199,97.50383116
31313,忠誠度,1,601898,0.00016199,97.50399316
31314,忠誠路,1,601899,0.00016199,97.50415515
31315,念佛,1,601900,0.00016199,97.50431715
31316,念念有詞,1,601901,0.00016199,97.50447914
31317,念珠,1,601902,0.00016199,97.50464113
31318,念珠菌,1,601903,0.00016199,97.50480313
31319,忿怒,1,601904,0.00016199,97.50496512
31320,怏怏,1,601905,0.00016199,97.50512712
31321,怯,1,601906,0.00016199,97.50528911
31322,怯步,1,601907,0.00016199,97.50545111
31323,怖,1,601908,0.00016199,97.50561310
31324,怪客,1,601909,0.00016199,97.50577509
31325,怪頭,1,601910,0.00016199,97.50593709
31326,怪癖,1,601911,0.00016199,97.50609908
31327,怪獸,1,601912,0.00016199,97.50626108
31328,怡合運輸股份有限公司,1,601913,0.00016199,97.50642307
31329,怡富投信基金,1,601914,0.00016199,97.50658506
31330,怡富證券公司,1,601915,0.00016199,97.50674706
31331,怡然,1,601916,0.00016199,97.50690905
31332,怡華,1,601917,0.00016199,97.50707105
31333,怡園,1,601918,0.00016199,97.50723304
31334,性．謊言．錄影帶,1,601919,0.00016199,97.50739504
31335,性子,1,601920,0.00016199,97.50755703
31336,性氾濫,1,601921,0.00016199,97.50771902
31337,性生活,1,601922,0.00016199,97.50788102
31338,性向,1,601923,0.00016199,97.50804301
31339,性冷感,1,601924,0.00016199,97.50820501
31340,性知識,1,601925,0.00016199,97.50836700
31341,性阻,1,601926,0.00016199,97.50852900
31342,性侵犯,1,601927,0.00016199,97.50869099
31343,性高潮,1,601928,0.00016199,97.50885298
31344,性暗示,1,601929,0.00016199,97.50901498
31345,性經驗,1,601930,0.00016199,97.50917697
31346,性暴力,1,601931,0.00016199,97.50933897
31347,性趣,1,601932,0.00016199,97.50950096
31348,性器官,1,601933,0.00016199,97.50966295
31349,性關係,1,601934,0.00016199,97.50982495
31350,怩,1,601935,0.00016199,97.50998694
31351,或由,1,601936,0.00016199,97.51014894
31352,或裝,1,601937,0.00016199,97.51031093
31353,戕害,1,601938,0.00016199,97.51047293
31354,房地,1,601939,0.00016199,97.51063492
31355,房身,1,601940,0.00016199,97.51079691
31356,房屋仲介公司,1,601941,0.00016199,97.51095891
31357,房屋貸款,1,601942,0.00016199,97.51112090
31358,房貸,1,601943,0.00016199,97.51128290
31359,房貸戶,1,601944,0.00016199,97.51144489
31360,房間數,1,601945,0.00016199,97.51160689
31361,房價率,1,601946,0.00016199,97.51176888
31362,房簷,1,601947,0.00016199,97.51193087
31363,所以然,1,601948,0.00016199,97.51209287
31364,所用,1,601949,0.00016199,97.51225486
31365,所多瑪山,1,601950,0.00016199,97.51241686
31366,所多瑪王,1,601951,0.00016199,97.51257885
31367,所作,1,601952,0.00016199,97.51274084
31368,所見,1,601953,0.00016199,97.51290284
31369,所言,1,601954,0.00016199,97.51306483
31370,所附,1,601955,0.00016199,97.51322683
31371,所指,1,601956,0.00016199,97.51338882
31372,所述,1,601957,0.00016199,97.51355082
31373,所能,1,601958,0.00016199,97.51371281
31374,所做所為,1,601959,0.00016199,97.51387480
31375,所得稅率,1,601960,0.00016199,97.51403680
31376,所得稅款,1,601961,0.00016199,97.51419879
31377,所提,1,601962,0.00016199,97.51436079
31378,所費不貲,1,601963,0.00016199,97.51452278
31379,所傷,1,601964,0.00016199,97.51468478
31380,所愛,1,601965,0.00016199,97.51484677
31381,所談,1,601966,0.00016199,97.51500876
31382,所獲,1,601967,0.00016199,97.51517076
31383,所屬,1,601968,0.00016199,97.51533275
31384,承受力,1,601969,0.00016199,97.51549475
31385,承若,1,601970,0.00016199,97.51565674
31386,承租人,1,601971,0.00016199,97.51581873
31387,承做,1,601972,0.00016199,97.51598073
31388,承造商,1,601973,0.00016199,97.51614272
31389,承傳,1,601974,0.00016199,97.51630472
31390,承裝,1,601975,0.00016199,97.51646671
31391,承銷人自治會,1,601976,0.00016199,97.51662871
31392,承銷利益,1,601977,0.00016199,97.51679070
31393,承銷營業稅,1,601978,0.00016199,97.51695269
31394,承辦員,1,601979,0.00016199,97.51711469
31395,承辦權,1,601980,0.00016199,97.51727668
31396,承襲,1,601981,0.00016199,97.51743868
31397,拉丁傳播集團,1,601982,0.00016199,97.51760067
31398,拉了拉,1,601983,0.00016199,97.51776267
31399,拉升,1,601984,0.00016199,97.51792466
31400,拉瓦布葉,1,601985,0.00016199,97.51808665
31401,拉瓦希葉夫婦肖像,1,601986,0.00016199,97.51824865
31402,拉住,1,601987,0.00016199,97.51841064
31403,拉低,1,601988,0.00016199,97.51857264
31404,拉扯,1,601989,0.00016199,97.51873463
31405,拉肚子,1,601990,0.00016199,97.51889662
31406,拉拉,1,601991,0.00016199,97.51905862
31407,拉法葉艦,1,601992,0.00016199,97.51922061
31408,拉奏,1,601993,0.00016199,97.51938261
31409,拉珍,1,601994,0.00016199,97.51954460
31410,拉格斐,1,601995,0.00016199,97.51970660
31411,拉票,1,601996,0.00016199,97.51986859
31412,拉凱奈,1,601997,0.00016199,97.52003058
31413,拉斐爾,1,601998,0.00016199,97.52019258
31414,拉斯,1,601999,0.00016199,97.52035457
31415,拉斯維加斯大道,1,602000,0.00016199,97.52051657
31416,拉距戰,1,602001,0.00016199,97.52067856
31417,拉進,1,602002,0.00016199,97.52084056
31418,拉爾凡德利葉,1,602003,0.00016199,97.52100255
31419,拉聚,1,602004,0.00016199,97.52116454
31420,拉賓,1,602005,0.00016199,97.52132654
31421,拉鋸,1,602006,0.00016199,97.52148853
31422,拉攏,1,602007,0.00016199,97.52165053
31423,拉鏈帶,1,602008,0.00016199,97.52181252
31424,拉茜,1,602009,0.00016199,97.52197452
31425,抿,1,602010,0.00016199,97.52213651
31426,抿住,1,602011,0.00016199,97.52229850
31427,拂面,1,602012,0.00016199,97.52246050
31428,拂園歌仔戲團,1,602013,0.00016199,97.52262249
31429,抹拭,1,602014,0.00016199,97.52278449
31430,拒送,1,602015,0.00016199,97.52294648
31431,拒唱,1,602016,0.00016199,97.52310847
31432,拒絕往來戶,1,602017,0.00016199,97.52327047
31433,拒審,1,602018,0.00016199,97.52343246
31434,招一招,1,602019,0.00016199,97.52359446
31435,招回來,1,602020,0.00016199,97.52375645
31436,招待會,1,602021,0.00016199,97.52391845
31437,招架不住,1,602022,0.00016199,97.52408044
31438,招術,1,602023,0.00016199,97.52424243
31439,招搖,1,602024,0.00016199,97.52440443
31440,招會,1,602025,0.00016199,97.52456642
31441,招認,1,602026,0.00016199,97.52472842
31442,披頭四,1,602027,0.00016199,97.52489041
31443,披覆,1,602028,0.00016199,97.52505241
31444,拓,1,602029,0.00016199,97.52521440
31445,拓大,1,602030,0.00016199,97.52537639
31446,拓印,1,602031,0.00016199,97.52553839
31447,拓票,1,602032,0.00016199,97.52570038
31448,拓圖,1,602033,0.00016199,97.52586238
31449,拓銷,1,602034,0.00016199,97.52602437
31450,拔刀相助,1,602035,0.00016199,97.52618636
31451,拔下,1,602036,0.00016199,97.52634836
31452,拔完,1,602037,0.00016199,97.52651035
31453,拔取,1,602038,0.00016199,97.52667235
31454,拔得頭籌,1,602039,0.00016199,97.52683434
31455,拔掉,1,602040,0.00016199,97.52699634
31456,拔頂兒,1,602041,0.00016199,97.52715833
31457,拔雅里,1,602042,0.00016199,97.52732032
31458,拔擢,1,602043,0.00016199,97.52748232
31459,拋空,1,602044,0.00016199,97.52764431
31460,拈,1,602045,0.00016199,97.52780631
31461,抨,1,602046,0.00016199,97.52796830
31462,抽不出,1,602047,0.00016199,97.52813030
31463,抽走,1,602048,0.00016199,97.52829229
31464,抽風機,1,602049,0.00016199,97.52845428
31465,抽換,1,602050,0.00016199,97.52861628
31466,抽痛,1,602051,0.00016199,97.52877827
31467,抽絲剝繭,1,602052,0.00016199,97.52894027
31468,抽象攝影,1,602053,0.00016199,97.52910226
31469,抽樣法,1,602054,0.00016199,97.52926425
31470,抽獎券,1,602055,0.00016199,97.52942625
31471,抽調,1,602056,0.00016199,97.52958824
31472,抽頭金,1,602057,0.00016199,97.52975024
31473,抽離出,1,602058,0.00016199,97.52991223
31474,抽簽,1,602059,0.00016199,97.53007423
31475,抽釋,1,602060,0.00016199,97.53023622
31476,押解,1,602061,0.00016199,97.53039821
31477,押運,1,602062,0.00016199,97.53056021
31478,拐吸,1,602063,0.00016199,97.53072220
31479,拐角,1,602064,0.00016199,97.53088420
31480,拙拙,1,602065,0.00016199,97.53104619
31481,拇指,1,602066,0.00016199,97.53120819
31482,拍下來,1,602067,0.00016199,97.53137018
31483,拍子,1,602068,0.00016199,97.53153217
31484,拍出來,1,602069,0.00016199,97.53169417
31485,拍定,1,602070,0.00016199,97.53185616
31486,拍定價格,1,602071,0.00016199,97.53201816
31487,拍拖,1,602072,0.00016199,97.53218015
31488,拍板,1,602073,0.00016199,97.53234214
31489,拍案叫絕,1,602074,0.00016199,97.53250414
31490,拍廣告,1,602075,0.00016199,97.53266613
31491,拍賣行,1,602076,0.00016199,97.53282813
31492,拍賣期,1,602077,0.00016199,97.53299012
31493,抵台,1,602078,0.00016199,97.53315212
31494,抵用券,1,602079,0.00016199,97.53331411
31495,抵死不從,1,602080,0.00016199,97.53347610
31496,抵減,1,602081,0.00016199,97.53363810
31497,抵價,1,602082,0.00016199,97.53380009
31498,抵觸,1,602083,0.00016199,97.53396209
31499,拚一拚,1,602084,0.00016199,97.53412408
31500,拚命三郎,1,602085,0.00016199,97.53428608
31501,拚勁,1,602086,0.00016199,97.53444807
31502,拚盤,1,602087,0.00016199,97.53461006
31503,抱朴子,1,602088,0.00016199,97.53477206
31504,抱牢,1,602089,0.00016199,97.53493405
31505,抱抱,1,602090,0.00016199,97.53509605
31506,抱病,1,602091,0.00016199,97.53525804
31507,拘役,1,602092,0.00016199,97.53542003
31508,拘限,1,602093,0.00016199,97.53558203
31509,拘謹,1,602094,0.00016199,97.53574402
31510,拖拉,1,602095,0.00016199,97.53590602
31511,拖放,1,602096,0.00016199,97.53606801
31512,拖動,1,602097,0.00016199,97.53623001
31513,拖船,1,602098,0.00016199,97.53639200
31514,拖運,1,602099,0.00016199,97.53655399
31515,拖靶,1,602100,0.00016199,97.53671599
31516,拖緩,1,602101,0.00016199,97.53687798
31517,拗不過,1,602102,0.00016199,97.53703998
31518,拆完,1,602103,0.00016199,97.53720197
31519,拆卸,1,602104,0.00016199,97.53736397
31520,拆返,1,602105,0.00016199,97.53752596
31521,拆開,1,602106,0.00016199,97.53768795
31522,抬出,1,602107,0.00016199,97.53784995
31523,抬槓,1,602108,0.00016199,97.53801194
31524,拎出,1,602109,0.00016199,97.53817394
31525,放上,1,602110,0.00016199,97.53833593
31526,放牛班,1,602111,0.00016199,97.53849792
31527,放出,1,602112,0.00016199,97.53865992
31528,放生,1,602113,0.00016199,97.53882191
31529,放在,1,602114,0.00016199,97.53898391
31530,放冷箭,1,602115,0.00016199,97.53914590
31531,放屁,1,602116,0.00016199,97.53930790
31532,放空氣,1,602117,0.00016199,97.53946989
31533,放流,1,602118,0.00016199,97.53963188
31534,放射學,1,602119,0.00016199,97.53979388
31535,放送,1,602120,0.00016199,97.53995587
31536,放款利率,1,602121,0.00016199,97.54011787
31537,放肆,1,602122,0.00016199,97.54027986
31538,放過,1,602123,0.00016199,97.54044186
31539,放輕鬆,1,602124,0.00016199,97.54060385
31540,放緩,1,602125,0.00016199,97.54076584
31541,放膽,1,602126,0.00016199,97.54092784
31542,斧斤,1,602127,0.00016199,97.54108983
31543,斧頭,1,602128,0.00016199,97.54125183
31544,斧鉞,1,602129,0.00016199,97.54141382
31545,旺,1,602130,0.00016199,97.54157581
31546,旺宏,1,602131,0.00016199,97.54173781
31547,旺宏電子公司,1,602132,0.00016199,97.54189980
31548,易利信,1,602133,0.00016199,97.54206180
31549,易事,1,602134,0.00016199,97.54222379
31550,易怒,1,602135,0.00016199,97.54238579
31551,易染,1,602136,0.00016199,97.54254778
31552,易容,1,602137,0.00016199,97.54270977
31553,易經,1,602138,0.00016199,97.54287177
31554,易懂,1,602139,0.00016199,97.54303376
31555,昌,1,602140,0.00016199,97.54319576
31556,昌迪加爾,1,602141,0.00016199,97.54335775
31557,昌盛,1,602142,0.00016199,97.54351975
31558,昌運,1,602143,0.00016199,97.54368174
31559,昆,1,602144,0.00016199,97.54384373
31560,昆士蘭州,1,602145,0.00016199,97.54400573
31561,昆汀尼拉,1,602146,0.00016199,97.54416772
31562,昆虫,1,602147,0.00016199,97.54432972
31563,昂揚,1,602148,0.00016199,97.54449171
31564,昂然,1,602149,0.00016199,97.54465370
31565,昂奮,1,602150,0.00016199,97.54481570
31566,明日之星,1,602151,0.00016199,97.54497769
31567,明尼波里鎮,1,602152,0.00016199,97.54513969
31568,明尼蘇達州,1,602153,0.00016199,97.54530168
31569,明目張膽,1,602154,0.00016199,97.54546368
31570,明示,1,602155,0.00016199,97.54562567
31571,明式,1,602156,0.00016199,97.54578766
31572,明見,1,602157,0.00016199,97.54594966
31573,明兒,1,602158,0.00016199,97.54611165
31574,明定,1,602159,0.00016199,97.54627365
31575,明治,1,602160,0.00016199,97.54643564
31576,明知,1,602161,0.00016199,97.54659764
31577,明信片,1,602162,0.00016199,97.54675963
31578,明室燈,1,602163,0.00016199,97.54692162
31579,明後年,1,602164,0.00016199,97.54708362
31580,明星級,1,602165,0.00016199,97.54724561
31581,明星塑膠,1,602166,0.00016199,97.54740761
31582,明星照,1,602167,0.00016199,97.54756960
31583,明珠,1,602168,0.00016199,97.54773159
31584,明珠茶藝館,1,602169,0.00016199,97.54789359
31585,明級,1,602170,0.00016199,97.54805558
31586,明晚,1,602171,0.00016199,97.54821758
31587,明眼人,1,602172,0.00016199,97.54837957
31588,明晰,1,602173,0.00016199,97.54854157
31589,明智,1,602174,0.00016199,97.54870356
31590,明朝,1,602175,0.00016199,97.54886555
31591,明牌股,1,602176,0.00016199,97.54902755
31592,明暗度,1,602177,0.00016199,97.54918954
31593,明說,1,602178,0.00016199,97.54935154
31594,明德,1,602179,0.00016199,97.54951353
31595,明德春天百貨,1,602180,0.00016199,97.54967553
31596,明曜,1,602181,0.00016199,97.54983752
31597,明鏡周刊,1,602182,0.00016199,97.54999951
31598,明礬,1,602183,0.00016199,97.55016151
31599,明碁電腦,1,602184,0.00016199,97.55032350
31600,昏天暗地,1,602185,0.00016199,97.55048550
31601,昏暗,1,602186,0.00016199,97.55064749
31602,昇任,1,602187,0.00016199,97.55080949
31603,昇陽電腦聯盟,1,602188,0.00016199,97.55097148
31604,服侍,1,602189,0.00016199,97.55113347
31605,服務中心,1,602190,0.00016199,97.55129547
31606,服務性,1,602191,0.00016199,97.55145746
31607,服務站,1,602192,0.00016199,97.55161946
31608,服務區,1,602193,0.00016199,97.55178145
31609,服務程式,1,602194,0.00016199,97.55194344
31610,服務費,1,602195,0.00016199,97.55210544
31611,服務網,1,602196,0.00016199,97.55226743
31612,服裝秀,1,602197,0.00016199,97.55242943
31613,服裝師,1,602198,0.00016199,97.55259142
31614,服裝精品店,1,602199,0.00016199,97.55275342
31615,朋分,1,602200,0.00016199,97.55291541
31616,朋莊,1,602201,0.00016199,97.55307740
31617,朋馳汽車,1,602202,0.00016199,97.55323940
31618,杭特利,1,602203,0.00016199,97.55340139
31619,枕,1,602204,0.00016199,97.55356339
31620,枕戈待旦,1,602205,0.00016199,97.55372538
31621,枕骨,1,602206,0.00016199,97.55388738
31622,枕頭套,1,602207,0.00016199,97.55404937
31623,東元醫院,1,602208,0.00016199,97.55421136
31624,東升,1,602209,0.00016199,97.55437336
31625,東方之珠,1,602210,0.00016199,97.55453535
31626,東方集團,1,602211,0.00016199,97.55469735
31627,東方漢蒙,1,602212,0.00016199,97.55485934
31628,東方銀行,1,602213,0.00016199,97.55502133
31629,東方廣告,1,602214,0.00016199,97.55518333
31630,東北人,1,602215,0.00016199,97.55534532
31631,東北班,1,602216,0.00016199,97.55550732
31632,東石,1,602217,0.00016199,97.55566931
31633,東江艦,1,602218,0.00016199,97.55583131
31634,東西向,1,602219,0.00016199,97.55599330
31635,東西向快速道路,1,602220,0.00016199,97.55615529
31636,東吳大學,1,602221,0.00016199,97.55631729
31637,東尾修,1,602222,0.00016199,97.55647928
31638,東京三菱銀行,1,602223,0.00016199,97.55664128
31639,東京迪士尼樂園,1,602224,0.00016199,97.55680327
31640,東京都,1,602225,0.00016199,97.55696527
31641,東京塔,1,602226,0.00016199,97.55712726
31642,東京愛情故事,1,602227,0.00016199,97.55728925
31643,東協,1,602228,0.00016199,97.55745125
31644,東姑拉曼,1,602229,0.00016199,97.55761324
31645,東怡,1,602230,0.00016199,97.55777524
31646,東門,1,602231,0.00016199,97.55793723
31647,東南水泥,1,602232,0.00016199,97.55809922
31648,東南西北,1,602233,0.00016199,97.55826122
31649,東南亞國協,1,602234,0.00016199,97.55842321
31650,東南班,1,602235,0.00016199,97.55858521
31651,東南區,1,602236,0.00016199,97.55874720
31652,東帝士公司,1,602237,0.00016199,97.55890920
31653,東郊,1,602238,0.00016199,97.55907119
31654,東面,1,602239,0.00016199,97.55923318
31655,東倒西歪,1,602240,0.00016199,97.55939518
31656,東海,1,602241,0.00016199,97.55955717
31657,東海岸,1,602242,0.00016199,97.55971917
31658,東海國小,1,602243,0.00016199,97.55988116
31659,東高雄社區,1,602244,0.00016199,97.56004316
31660,東莒,1,602245,0.00016199,97.56020515
31661,東普金斯術,1,602246,0.00016199,97.56036714
31662,東港人,1,602247,0.00016199,97.56052914
31663,東港國中,1,602248,0.00016199,97.56069113
31664,東港鎮,1,602249,0.00016199,97.56085313
31665,東雲公司,1,602250,0.00016199,97.56101512
31666,東漢,1,602251,0.00016199,97.56117711
31667,東德,1,602252,0.00016199,97.56133911
31668,東歐舞,1,602253,0.00016199,97.56150110
31669,東機組,1,602254,0.00016199,97.56166310
31670,東興,1,602255,0.00016199,97.56182509
31671,東興汽車公司,1,602256,0.00016199,97.56198709
31672,東鋼,1,602257,0.00016199,97.56214908
31673,東聯化學,1,602258,0.00016199,97.56231107
31674,東證一部指數,1,602259,0.00016199,97.56247307
31675,東鹼,1,602260,0.00016199,97.56263506
31676,果子,1,602261,0.00016199,97.56279706
31677,果汁機,1,602262,0.00016199,97.56295905
31678,果農,1,602263,0.00016199,97.56312105
31679,果醬,1,602264,0.00016199,97.56328304
31680,枝城,1,602265,0.00016199,97.56344503
31681,枝梢,1,602266,0.00016199,97.56360703
31682,枝幹,1,602267,0.00016199,97.56376902
31683,林小樓,1,602268,0.00016199,97.56393102
31684,林友勝,1,602269,0.00016199,97.56409301
31685,林天良,1,602270,0.00016199,97.56425500
31686,林天從,1,602271,0.00016199,97.56441700
31687,林天德,1,602272,0.00016199,97.56457899
31688,林文咋,1,602273,0.00016199,97.56474099
31689,林文明,1,602274,0.00016199,97.56490298
31690,林文欽,1,602275,0.00016199,97.56506498
31691,林文進,1,602276,0.00016199,97.56522697
31692,林文義,1,602277,0.00016199,97.56538896
31693,林文察,1,602278,0.00016199,97.56555096
31694,林木,1,602279,0.00016199,97.56571295
31695,林火順,1,602280,0.00016199,97.56587495
31696,林世昌,1,602281,0.00016199,97.56603694
31697,林世華,1,602282,0.00016199,97.56619894
31698,林幼英,1,602283,0.00016199,97.56636093
31699,林本儀,1,602284,0.00016199,97.56652292
31700,林正盛,1,602285,0.00016199,97.56668492
31701,林田山,1,602286,0.00016199,97.56684691
31702,林立鑫,1,602287,0.00016199,97.56700891
31703,林光顯,1,602288,0.00016199,97.56717090
31704,林全洲,1,602289,0.00016199,97.56733289
31705,林地,1,602290,0.00016199,97.56749489
31706,林江力,1,602291,0.00016199,97.56765688
31707,林伸茂,1,602292,0.00016199,97.56781888
31708,林克歡,1,602293,0.00016199,97.56798087
31709,林宏宗,1,602294,0.00016199,97.56814287
31710,林床,1,602295,0.00016199,97.56830486
31711,林志成,1,602296,0.00016199,97.56846685
31712,林志敏,1,602297,0.00016199,97.56862885
31713,林志嘉,1,602298,0.00016199,97.56879084
31714,林沖夜奔,1,602299,0.00016199,97.56895284
31715,林秀君,1,602300,0.00016199,97.56911483
31716,林秀偉,1,602301,0.00016199,97.56927683
31717,林坤枋,1,602302,0.00016199,97.56943882
31718,林奇,1,602303,0.00016199,97.56960081
31719,林奈,1,602304,0.00016199,97.56976281
31720,林姆斯基．高沙可夫,1,602305,0.00016199,97.56992480
31721,林尚義,1,602306,0.00016199,97.57008680
31722,林居利,1,602307,0.00016199,97.57024879
31723,林忠山,1,602308,0.00016199,97.57041078
31724,林忠正,1,602309,0.00016199,97.57057278
31725,林昌城,1,602310,0.00016199,97.57073477
31726,林林總總,1,602311,0.00016199,97.57089677
31727,林杰懋,1,602312,0.00016199,97.57105876
31728,林松輝,1,602313,0.00016199,97.57122076
31729,林武,1,602314,0.00016199,97.57138275
31730,林肯廣場,1,602315,0.00016199,97.57154474
31731,林信男,1,602316,0.00016199,97.57170674
31732,林品,1,602317,0.00016199,97.57186873
31733,林建平,1,602318,0.00016199,97.57203073
31734,林建和,1,602319,0.00016199,97.57219272
31735,林政鋒,1,602320,0.00016199,97.57235472
31736,林春榮,1,602321,0.00016199,97.57251671
31737,林某,1,602322,0.00016199,97.57267870
31738,林洽民,1,602323,0.00016199,97.57284070
31739,林珍良,1,602324,0.00016199,97.57300269
31740,林相,1,602325,0.00016199,97.57316469
31741,林美姿,1,602326,0.00016199,97.57332668
31742,林美玲,1,602327,0.00016199,97.57348867
31743,林重鎣,1,602328,0.00016199,97.57365067
31744,林風眠,1,602329,0.00016199,97.57381266
31745,林厝,1,602330,0.00016199,97.57397466
31746,林家琛,1,602331,0.00016199,97.57413665
31747,林恕暉,1,602332,0.00016199,97.57429865
31748,林海,1,602333,0.00016199,97.57446064
31749,林浩正,1,602334,0.00016199,97.57462263
31750,林偉斌,1,602335,0.00016199,97.57478463
31751,林務局長,1,602336,0.00016199,97.57494662
31752,林區,1,602337,0.00016199,97.57510862
31753,林國翰,1,602338,0.00016199,97.57527061
31754,林添丁,1,602339,0.00016199,97.57543261
31755,林淑卿,1,602340,0.00016199,97.57559460
31756,林淑娟,1,602341,0.00016199,97.57575659
31757,林爽文,1,602342,0.00016199,97.57591859
31758,林產,1,602343,0.00016199,97.57608058
31759,林野,1,602344,0.00016199,97.57624258
31760,林勝利,1,602345,0.00016199,97.57640457
31761,林場增,1,602346,0.00016199,97.57656656
31762,林朝棟,1,602347,0.00016199,97.57672856
31763,林森北路,1,602348,0.00016199,97.57689055
31764,林棋山,1,602349,0.00016199,97.57705255
31765,林琪欣,1,602350,0.00016199,97.57721454
31766,林蛙,1,602351,0.00016199,97.57737654
31767,林賀夫,1,602352,0.00016199,97.57753853
31768,林超熙,1,602353,0.00016199,97.57770052
31769,林雲鶯,1,602354,0.00016199,97.57786252
31770,林黃淑貞,1,602355,0.00016199,97.57802451
31771,林園,1,602356,0.00016199,97.57818651
31772,林新源,1,602357,0.00016199,97.57834850
31773,林會承,1,602358,0.00016199,97.57851050
31774,林源吉,1,602359,0.00016199,97.57867249
31775,林源朗,1,602360,0.00016199,97.57883448
31776,林瑞和,1,602361,0.00016199,97.57899648
31777,林瑞陽,1,602362,0.00016199,97.57915847
31778,林義雄,1,602363,0.00016199,97.57932047
31779,林群超,1,602364,0.00016199,97.57948246
31780,林裕勳,1,602365,0.00016199,97.57964446
31781,林靖磷,1,602366,0.00016199,97.57980645
31782,林福來,1,602367,0.00016199,97.57996844
31783,林福益,1,602368,0.00016199,97.58013044
31784,林儀芬,1,602369,0.00016199,97.58029243
31785,林德福,1,602370,0.00016199,97.58045443
31786,林慶祥,1,602371,0.00016199,97.58061642
31787,林澄枝,1,602372,0.00016199,97.58077841
31788,林蓮珍,1,602373,0.00016199,97.58094041
31789,林親民,1,602374,0.00016199,97.58110240
31790,林謝罕,1,602375,0.00016199,97.58126440
31791,林鴻鈞,1,602376,0.00016199,97.58142639
31792,林黛,1,602377,0.00016199,97.58158839
31793,林豐喜,1,602378,0.00016199,97.58175038
31794,林邊,1,602379,0.00016199,97.58191237
31795,林邊鄉,1,602380,0.00016199,97.58207437
31796,林獻堂,1,602381,0.00016199,97.58223636
31797,林耀輝,1,602382,0.00016199,97.58239836
31798,杯水車薪,1,602383,0.00016199,97.58256035
31799,板口,1,602384,0.00016199,97.58272235
31800,板口守彥,1,602385,0.00016199,97.58288434
31801,板椅,1,602386,0.00016199,97.58304633
31802,板凳舞,1,602387,0.00016199,97.58320833
31803,板橋地檢署,1,602388,0.00016199,97.58337032
31804,板橋消防分隊,1,602389,0.00016199,97.58353232
31805,板橋藝專,1,602390,0.00016199,97.58369431
31806,枉,1,602391,0.00016199,97.58385630
31807,枉然,1,602392,0.00016199,97.58401830
31808,松下公司廣告,1,602393,0.00016199,97.58418029
31809,松下電器產業株式會社,1,602394,0.00016199,97.58434229
31810,松木,1,602395,0.00016199,97.58450428
31811,松居弘吉,1,602396,0.00016199,97.58466628
31812,松枝,1,602397,0.00016199,97.58482827
31813,松崗出版社,1,602398,0.00016199,97.58499026
31814,松雀鷹,1,602399,0.00016199,97.58515226
31815,松雪泰子,1,602400,0.00016199,97.58531425
31816,松博特海依,1,602401,0.00016199,97.58547625
31817,松雲,1,602402,0.00016199,97.58563824
31818,松德路,1,602403,0.00016199,97.58580024
31819,松樹,1,602404,0.00016199,97.58596223
31820,欣,1,602405,0.00016199,97.58612422
31821,欣欣水泥,1,602406,0.00016199,97.58628622
31822,欣欣客運公司,1,602407,0.00016199,97.58644821
31823,欣凱電子,1,602408,0.00016199,97.58661021
31824,武又林,1,602409,0.00016199,97.58677220
31825,武士道,1,602410,0.00016199,97.58693419
31826,武士戰盔,1,602411,0.00016199,97.58709619
31827,武打動作,1,602412,0.00016199,97.58725818
31828,武生,1,602413,0.00016199,97.58742018
31829,武夷山,1,602414,0.00016199,97.58758217
31830,武技,1,602415,0.00016199,97.58774417
31831,武昌,1,602416,0.00016199,97.58790616
31832,武林,1,602417,0.00016199,97.58806815
31833,武俠電影,1,602418,0.00016199,97.58823015
31834,武洲,1,602419,0.00016199,97.58839214
31835,武進一型,1,602420,0.00016199,97.58855414
31836,武進二型,1,602421,0.00016199,97.58871613
31837,武進三型,1,602422,0.00016199,97.58887813
31838,武進三級艦,1,602423,0.00016199,97.58904012
31839,武裝教練機,1,602424,0.00016199,97.58920211
31840,武道館,1,602425,0.00016199,97.58936411
31841,武漢級,1,602426,0.00016199,97.58952610
31842,武漢電廠,1,602427,0.00016199,97.58968810
31843,武戲,1,602428,0.00016199,97.58985009
31844,歧異,1,602429,0.00016199,97.59001208
31845,歧途,1,602430,0.00016199,97.59017408
31846,氓,1,602431,0.00016199,97.59033607
31847,氛,1,602432,0.00016199,97.59049807
31848,注射器,1,602433,0.00016199,97.59066006
31849,注意度,1,602434,0.00016199,97.59082206
31850,注腳,1,602435,0.00016199,97.59098405
31851,泳,1,602436,0.00016199,97.59114604
31852,泳池,1,602437,0.00016199,97.59130804
31853,泳技,1,602438,0.00016199,97.59147003
31854,泳者,1,602439,0.00016199,97.59163203
31855,沱江艦,1,602440,0.00016199,97.59179402
31856,泌尿道感染,1,602441,0.00016199,97.59195602
31857,泥沙,1,602442,0.00016199,97.59211801
31858,泥垢,1,602443,0.00016199,97.59228000
31859,泥漿,1,602444,0.00016199,97.59244200
31860,泥漿池,1,602445,0.00016199,97.59260399
31861,河北,1,602446,0.00016199,97.59276599
31862,河西,1,602447,0.00016199,97.59292798
31863,河流口,1,602448,0.00016199,97.59308997
31864,河流級,1,602449,0.00016199,97.59325197
31865,河馬,1,602450,0.00016199,97.59341396
31866,河堤,1,602451,0.00016199,97.59357596
31867,河濱大道,1,602452,0.00016199,97.59373795
31868,河邊,1,602453,0.00016199,97.59389995
31869,沾上,1,602454,0.00016199,97.59406194
31870,沾上邊,1,602455,0.00016199,97.59422393
31871,沾料,1,602456,0.00016199,97.59438593
31872,沾粉,1,602457,0.00016199,97.59454792
31873,波光,1,602458,0.00016199,97.59470992
31874,波西米亞,1,602459,0.00016199,97.59487191
31875,波里尼,1,602460,0.00016199,97.59503391
31876,波昂,1,602461,0.00016199,97.59519590
31877,波昂美術館,1,602462,0.00016199,97.59535789
31878,波長,1,602463,0.00016199,97.59551989
31879,波段性,1,602464,0.00016199,97.59568188
31880,波美拉尼亞,1,602465,0.00016199,97.59584388
31881,波音貨機,1,602466,0.00016199,97.59600587
31882,波哥多,1,602467,0.00016199,97.59616786
31883,波峰,1,602468,0.00016199,97.59632986
31884,波浪狀,1,602469,0.00016199,97.59649185
31885,波浪襯墊,1,602470,0.00016199,97.59665385
31886,波茲茅斯號,1,602471,0.00016199,97.59681584
31887,波茲曼,1,602472,0.00016199,97.59697784
31888,波動性,1,602473,0.00016199,97.59713983
31889,波幅,1,602474,0.00016199,97.59730182
31890,波斯灣,1,602475,0.00016199,97.59746382
31891,波斯灣戰爭,1,602476,0.00016199,97.59762581
31892,波塞頓,1,602477,0.00016199,97.59778781
31893,波塞瓊島,1,602478,0.00016199,97.59794980
31894,波福特,1,602479,0.00016199,97.59811180
31895,波樂克斯兄弟,1,602480,0.00016199,97.59827379
31896,波錫奧斯比賽會,1,602481,0.00016199,97.59843578
31897,波濤洶湧,1,602482,0.00016199,97.59859778
31898,波羅的海,1,602483,0.00016199,97.59875977
31899,波瀾壯闊,1,602484,0.00016199,97.59892177
31900,波灣戰事,1,602485,0.00016199,97.59908376
31901,法方,1,602486,0.00016199,97.59924575
31902,法式料理,1,602487,0.00016199,97.59940775
31903,法辛烷值,1,602488,0.00016199,97.59956974
31904,法亞航,1,602489,0.00016199,97.59973174
31905,法制化,1,602490,0.00016199,97.59989373
31906,法官法,1,602491,0.00016199,97.60005573
31907,法拉頭,1,602492,0.00016199,97.60021772
31908,法度,1,602493,0.00016199,97.60037971
31909,法律與你雜誌社,1,602494,0.00016199,97.60054171
31910,法界,1,602495,0.00016199,97.60070370
31911,法軍,1,602496,0.00016199,97.60086570
31912,法庭,1,602497,0.00016199,97.60102769
31913,法朗,1,602498,0.00016199,97.60118969
31914,法國干邑白蘭地,1,602499,0.00016199,97.60135168
31915,法國區,1,602500,0.00016199,97.60151367
31916,法國號,1,602501,0.00016199,97.60167567
31917,法國歐洲日報,1,602502,0.00016199,97.60183766
31918,法國樺榭公司,1,602503,0.00016199,97.60199966
31919,法舶,1,602504,0.00016199,97.60216165
31920,法雅,1,602505,0.00016199,97.60232364
31921,法源寺,1,602506,0.00016199,97.60248564
31922,法源基礎,1,602507,0.00016199,97.60264763
31923,法瑪西亞普強藥廠,1,602508,0.00016199,97.60280963
31924,法網,1,602509,0.00016199,97.60297162
31925,法網恢恢,1,602510,0.00016199,97.60313362
31926,法製,1,602511,0.00016199,97.60329561
31927,法語,1,602512,0.00016199,97.60345760
31928,法器,1,602513,0.00016199,97.60361960
31929,法學,1,602514,0.00016199,97.60378159
31930,法學院,1,602515,0.00016199,97.60394359
31931,法醫,1,602516,0.00016199,97.60410558
31932,法蘭西,1,602517,0.00016199,97.60426758
31933,法蘭西斯．波瑪瑞,1,602518,0.00016199,97.60442957
31934,法蘭西斯卡普拉,1,602519,0.00016199,97.60459156
31935,法蘭西斯麥多曼,1,602520,0.00016199,97.60475356
31936,法蘭克．亞倫,1,602521,0.00016199,97.60491555
31937,法蘭克．喬埃思,1,602522,0.00016199,97.60507755
31938,法蘭克‧卡爾維特,1,602523,0.00016199,97.60523954
31939,法蘭克華利,1,602524,0.00016199,97.60540154
31940,法蘭克福人,1,602525,0.00016199,97.60556353
31941,沸,1,602526,0.00016199,97.60572552
31942,沸騰,1,602527,0.00016199,97.60588752
31943,油加利,1,602528,0.00016199,97.60604951
31944,油加利樹,1,602529,0.00016199,97.60621151
31945,油光,1,602530,0.00016199,97.60637350
31946,油豆腐,1,602531,0.00016199,97.60653549
31947,油表,1,602532,0.00016199,97.60669749
31948,油亮,1,602533,0.00016199,97.60685948
31949,油品汙染物標準,1,602534,0.00016199,97.60702148
31950,油炸冰淇淋,1,602535,0.00016199,97.60718347
31951,油料,1,602536,0.00016199,97.60734547
31952,油桐花季,1,602537,0.00016199,97.60750746
31953,油桐樹,1,602538,0.00016199,97.60766945
31954,油氣回收設備,1,602539,0.00016199,97.60783145
31955,油紙傘,1,602540,0.00016199,97.60799344
31956,油耗,1,602541,0.00016199,97.60815544
31957,油脂小子,1,602542,0.00016199,97.60831743
31958,油彩,1,602543,0.00016199,97.60847943
31959,油麻菜籽,1,602544,0.00016199,97.60864142
31960,油量,1,602545,0.00016199,97.60880341
31961,油煎,1,602546,0.00016199,97.60896541
31962,油煙味,1,602547,0.00016199,97.60912740
31963,油路,1,602548,0.00016199,97.60928940
31964,油潤,1,602549,0.00016199,97.60945139
31965,油錢,1,602550,0.00016199,97.60961338
31966,油壓管路,1,602551,0.00016199,97.60977538
31967,油壓撐桿式,1,602552,0.00016199,97.60993737
31968,油麵,1,602553,0.00016199,97.61009937
31969,油罐車,1,602554,0.00016199,97.61026136
31970,況明潔,1,602555,0.00016199,97.61042336
31971,沮喪感,1,602556,0.00016199,97.61058535
31972,沿河,1,602557,0.00016199,97.61074734
31973,沿街,1,602558,0.00016199,97.61090934
31974,沿襲,1,602559,0.00016199,97.61107133
31975,治下,1,602560,0.00016199,97.61123333
31976,治金,1,602561,0.00016199,97.61139532
31977,治軍,1,602562,0.00016199,97.61155732
31978,治理,1,602563,0.00016199,97.61171931
31979,治標,1,602564,0.00016199,97.61188130
31980,泡一泡,1,602565,0.00016199,97.61204330
31981,泡入,1,602566,0.00016199,97.61220529
31982,泡妞神風隊,1,602567,0.00016199,97.61236729
31983,泡咖啡,1,602568,0.00016199,97.61252928
31984,泡泡,1,602569,0.00016199,97.61269127
31985,泡泡水,1,602570,0.00016199,97.61285327
31986,泡泡草,1,602571,0.00016199,97.61301526
31987,泡疹,1,602572,0.00016199,97.61317726
31988,泡茶,1,602573,0.00016199,97.61333925
31989,泡眼,1,602574,0.00016199,97.61350125
31990,泡湯,1,602575,0.00016199,97.61366324
31991,泡湯樂,1,602576,0.00016199,97.61382523
31992,泡腫,1,602577,0.00016199,97.61398723
31993,泡綿,1,602578,0.00016199,97.61414922
31994,泡影,1,602579,0.00016199,97.61431122
31995,泡澡,1,602580,0.00016199,97.61447321
31996,泡褲,1,602581,0.00016199,97.61463521
31997,泛美,1,602582,0.00016199,97.61479720
31998,泛神論,1,602583,0.00016199,97.61495919
31999,泛黃,1,602584,0.00016199,97.61512119
32000,泛濫,1,602585,0.00016199,97.61528318
32001,泊接站,1,602586,0.00016199,97.61544518
32002,泯沒,1,602587,0.00016199,97.61560717
32003,泠,1,602588,0.00016199,97.61576916
32004,炕窯,1,602589,0.00016199,97.61593116
32005,炎酷,1,602590,0.00016199,97.61609315
32006,炒勻,1,602591,0.00016199,97.61625515
32007,炒翻天,1,602592,0.00016199,97.61641714
32008,炒麵,1,602593,0.00016199,97.61657914
32009,炙,1,602594,0.00016199,97.61674113
32010,爬上爬下,1,602595,0.00016199,97.61690312
32011,爬升,1,602596,0.00016199,97.61706512
32012,爬行類,1,602597,0.00016199,97.61722711
32013,爬起來,1,602598,0.00016199,97.61738911
32014,爬動,1,602599,0.00016199,97.61755110
32015,爭先恐後,1,602600,0.00016199,97.61771310
32016,爭妍,1,602601,0.00016199,97.61787509
32017,爭求,1,602602,0.00016199,97.61803708
32018,爭持,1,602603,0.00016199,97.61819908
32019,爭食,1,602604,0.00016199,97.61836107
32020,爭現,1,602605,0.00016199,97.61852307
32021,爭逐,1,602606,0.00016199,97.61868506
32022,爭勝,1,602607,0.00016199,97.61884705
32023,爭詢,1,602608,0.00016199,97.61900905
32024,爭運,1,602609,0.00016199,97.61917104
32025,爭霸,1,602610,0.00016199,97.61933304
32026,爸爸走丟了,1,602611,0.00016199,97.61949503
32027,爸爸節,1,602612,0.00016199,97.61965703
32028,版型,1,602613,0.00016199,97.61981902
32029,版畫家,1,602614,0.00016199,97.61998101
32030,牧,1,602615,0.00016199,97.62014301
32031,牧人,1,602616,0.00016199,97.62030500
32032,牧牛飲澤,1,602617,0.00016199,97.62046700
32033,牧卡,1,602618,0.00016199,97.62062899
32034,牧羊,1,602619,0.00016199,97.62079099
32035,牧羊神,1,602620,0.00016199,97.62095298
32036,牧羊警犬,1,602621,0.00016199,97.62111497
32037,牧歌,1,602622,0.00016199,97.62127697
32038,物件導向語言,1,602623,0.00016199,97.62143896
32039,物件欄,1,602624,0.00016199,97.62160096
32040,物流,1,602625,0.00016199,97.62176295
32041,物理性,1,602626,0.00016199,97.62192494
32042,物理學家,1,602627,0.00016199,97.62208694
32043,物理學獎,1,602628,0.00016199,97.62224893
32044,物種,1,602629,0.00016199,97.62241093
32045,物質主義,1,602630,0.00016199,97.62257292
32046,物器,1,602631,0.00016199,97.62273492
32047,狀似,1,602632,0.00016199,97.62289691
32048,狀況三,1,602633,0.00016199,97.62305890
32049,狗汁,1,602634,0.00016199,97.62322090
32050,狗皮,1,602635,0.00016199,97.62338289
32051,狗尾,1,602636,0.00016199,97.62354489
32052,狗兒,1,602637,0.00016199,97.62370688
32053,狗狗,1,602638,0.00016199,97.62386888
32054,狐谷民俗社,1,602639,0.00016199,97.62403087
32055,狐谷民間音樂節,1,602640,0.00016199,97.62419286
32056,狐狸,1,602641,0.00016199,97.62435486
32057,狐群狗黨,1,602642,0.00016199,97.62451685
32058,狐疑,1,602643,0.00016199,97.62467885
32059,玩一玩,1,602644,0.00016199,97.62484084
32060,玩不起,1,602645,0.00016199,97.62500283
32061,玩石風,1,602646,0.00016199,97.62516483
32062,玩弄,1,602647,0.00016199,97.62532682
32063,玩具店,1,602648,0.00016199,97.62548882
32064,玩具貓,1,602649,0.00016199,97.62565081
32065,玩票,1,602650,0.00016199,97.62581281
32066,玩牌,1,602651,0.00016199,97.62597480
32067,玩樂,1,602652,0.00016199,97.62613679
32068,玫瑰色,1,602653,0.00016199,97.62629879
32069,玫瑰露,1,602654,0.00016199,97.62646078
32070,疝氣帶,1,602655,0.00016199,97.62662278
32071,疙瘩,1,602656,0.00016199,97.62678477
32072,的的確確,1,602657,0.00016199,97.62694677
32073,盲女,1,602658,0.00016199,97.62710876
32074,直六渦輪,1,602659,0.00016199,97.62727075
32075,直升,1,602660,0.00016199,97.62743275
32076,直向,1,602661,0.00016199,97.62759474
32077,直角,1,602662,0.00016199,97.62775674
32078,直到世界末日,1,602663,0.00016199,97.62791873
32079,直呼,1,602664,0.00016199,97.62808072
32080,直昇機,1,602665,0.00016199,97.62824272
32081,直飛,1,602666,0.00016199,97.62840471
32082,直追,1,602667,0.00016199,97.62856671
32083,直接由,1,602668,0.00016199,97.62872870
32084,直接噴射渦輪增壓引擎,1,602669,0.00016199,97.62889070
32085,直接攝影,1,602670,0.00016199,97.62905269
32086,直掃描頻率,1,602671,0.00016199,97.62921468
32087,直爽,1,602672,0.00016199,97.62937668
32088,直率,1,602673,0.00016199,97.62953867
32089,直通,1,602674,0.00016199,97.62970067
32090,直搗,1,602675,0.00016199,97.62986266
32091,直腸,1,602676,0.00016199,97.63002466
32092,直落,1,602677,0.00016199,97.63018665
32093,直逼,1,602678,0.00016199,97.63034864
32094,直線式,1,602679,0.00016199,97.63051064
32095,直線型,1,602680,0.00016199,97.63067263
32096,直線機,1,602681,0.00016199,97.63083463
32097,直覺式,1,602682,0.00016199,97.63099662
32098,直覺性,1,602683,0.00016199,97.63115861
32099,直驅,1,602684,0.00016199,97.63132061
32100,知己知彼,1,602685,0.00016199,97.63148260
32101,知不知道,1,602686,0.00016199,97.63164460
32102,知事,1,602687,0.00016199,97.63180659
32103,知性美,1,602688,0.00016199,97.63196859
32104,知法犯法,1,602689,0.00016199,97.63213058
32105,知能,1,602690,0.00016199,97.63229257
32106,知識分子型,1,602691,0.00016199,97.63245457
32107,知難行易,1,602692,0.00016199,97.63261656
32108,矽統,1,602693,0.00016199,97.63277856
32109,矽酸鈣板,1,602694,0.00016199,97.63294055
32110,矽導線,1,602695,0.00016199,97.63310255
32111,社子,1,602696,0.00016199,97.63326454
32112,社工系,1,602697,0.00016199,97.63342653
32113,社工會,1,602698,0.00016199,97.63358853
32114,社交圈,1,602699,0.00016199,97.63375052
32115,社后,1,602700,0.00016199,97.63391252
32116,社區型商店,1,602701,0.00016199,97.63407451
32117,社區發展協會,1,602702,0.00016199,97.63423651
32118,社區管理委員會,1,602703,0.00016199,97.63439850
32119,社教單位,1,602704,0.00016199,97.63456049
32120,社評,1,602705,0.00016199,97.63472249
32121,社會人野球聯盟,1,602706,0.00016199,97.63488448
32122,社會中,1,602707,0.00016199,97.63504648
32123,社會化,1,602708,0.00016199,97.63520847
32124,社會主義,1,602709,0.00016199,97.63537046
32125,社會系,1,602710,0.00016199,97.63553246
32126,社會科學,1,602711,0.00016199,97.63569445
32127,社會處,1,602712,0.00016199,97.63585645
32128,社會隊,1,602713,0.00016199,97.63601844
32129,社會學家,1,602714,0.00016199,97.63618044
32130,社福明,1,602715,0.00016199,97.63634243
32131,空口,1,602716,0.00016199,97.63650442
32132,空中小姐,1,602717,0.00016199,97.63666642
32133,空中英語教室,1,602718,0.00016199,97.63682841
32134,空中閣樓,1,602719,0.00016199,97.63699041
32135,空中樓閣,1,602720,0.00016199,97.63715240
32136,空心菜,1,602721,0.00016199,97.63731440
32137,空手而回,1,602722,0.00016199,97.63747639
32138,空出,1,602723,0.00016199,97.63763838
32139,空白票,1,602724,0.00016199,97.63780038
32140,空穴來風,1,602725,0.00016199,97.63796237
32141,空地勤,1,602726,0.00016199,97.63812437
32142,空位,1,602727,0.00016199,97.63828636
32143,空谷,1,602728,0.00016199,97.63844835
32144,空防系統,1,602729,0.00016199,97.63861035
32145,空防雷達,1,602730,0.00016199,97.63877234
32146,空空,1,602731,0.00016199,97.63893434
32147,空芭樂褲,1,602732,0.00016199,97.63909633
32148,空屋率,1,602733,0.00016199,97.63925833
32149,空洞,1,602734,0.00016199,97.63942032
32150,空洞化,1,602735,0.00016199,97.63958231
32151,空軍一號,1,602736,0.00016199,97.63974431
32152,空軍型機動械彈破壞系統,1,602737,0.00016199,97.63990630
32153,空軍樂隊,1,602738,0.00016199,97.64006830
32154,空軍總部情報署,1,602739,0.00016199,97.64023029
32155,空域,1,602740,0.00016199,97.64039229
32156,空桶,1,602741,0.00016199,97.64055428
32157,空瓶,1,602742,0.00016199,97.64071627
32158,空無,1,602743,0.00016199,97.64087827
32159,空無一物,1,602744,0.00016199,97.64104026
32160,空間感,1,602745,0.00016199,97.64120226
32161,空勤學園,1,602746,0.00016199,97.64136425
32162,空想科學世界,1,602747,0.00016199,97.64152624
32163,空照,1,602748,0.00016199,97.64168824
32164,空腹,1,602749,0.00016199,97.64185023
32165,空運中心,1,602750,0.00016199,97.64201223
32166,空對空飛彈,1,602751,0.00016199,97.64217422
32167,空調科,1,602752,0.00016199,97.64233622
32168,空優,1,602753,0.00016199,97.64249821
32169,空壓,1,602754,0.00016199,97.64266020
32170,空曠,1,602755,0.00016199,97.64282220
32171,空難,1,602756,0.00016199,97.64298419
32172,穹蒼,1,602757,0.00016199,97.64314619
32173,糾港,1,602758,0.00016199,97.64330818
32174,糾葛,1,602759,0.00016199,97.64347018
32175,罔顧,1,602760,0.00016199,97.64363217
32176,肺病,1,602761,0.00016199,97.64379416
32177,肺癌,1,602762,0.00016199,97.64395616
32178,肺臟,1,602763,0.00016199,97.64411815
32179,肥肉,1,602764,0.00016199,97.64428015
32180,肥皂劇,1,602765,0.00016199,97.64444214
32181,肥肥胖胖,1,602766,0.00016199,97.64460413
32182,肥短,1,602767,0.00016199,97.64476613
32183,肥腴,1,602768,0.00016199,97.64492812
32184,肢障團體,1,602769,0.00016199,97.64509012
32185,肢體衝突,1,602770,0.00016199,97.64525211
32186,股分,1,602771,0.00016199,97.64541411
32187,股四頭肌,1,602772,0.00016199,97.64557610
32188,股市前瞻,1,602773,0.00016199,97.64573809
32189,股份公司,1,602774,0.00016199,97.64590009
32190,股式,1,602775,0.00016199,97.64606208
32191,股東大會,1,602776,0.00016199,97.64622408
32192,股東名冊,1,602777,0.00016199,97.64638607
32193,股東常會,1,602778,0.00016199,97.64654807
32194,股東臨時會,1,602779,0.00016199,97.64671006
32195,股票股利,1,602780,0.00016199,97.64687205
32196,股票指數,1,602781,0.00016199,97.64703405
32197,股權數,1,602782,0.00016199,97.64719604
32198,肩上,1,602783,0.00016199,97.64735804
32199,肩胛,1,602784,0.00016199,97.64752003
32200,肩帶式,1,602785,0.00016199,97.64768202
32201,肩酸,1,602786,0.00016199,97.64784402
32202,肯尼羅吉斯,1,602787,0.00016199,97.64800601
32203,肯秀羅夫,1,602788,0.00016199,97.64816801
32204,肯辛頓校區,1,602789,0.00016199,97.64833000
32205,肯峭,1,602790,0.00016199,97.64849200
32206,肯塔基,1,602791,0.00016199,97.64865399
32207,肯塔基州,1,602792,0.00016199,97.64881598
32208,臥,1,602793,0.00016199,97.64897798
32209,臥式,1,602794,0.00016199,97.64913997
32210,臥底,1,602795,0.00016199,97.64930197
32211,臥房,1,602796,0.00016199,97.64946396
32212,臥病,1,602797,0.00016199,97.64962596
32213,芳,1,602798,0.00016199,97.64978795
32214,芳香療法,1,602799,0.00016199,97.64994994
32215,芳香療法與生活保健,1,602800,0.00016199,97.65011194
32216,芳香療法與美容護膚,1,602801,0.00016199,97.65027393
32217,芳草,1,602802,0.00016199,97.65043593
32218,芳菲,1,602803,0.00016199,97.65059792
32219,芳蘭,1,602804,0.00016199,97.65075991
32220,芝士,1,602805,0.00016199,97.65092191
32221,芝交,1,602806,0.00016199,97.65108390
32222,芝麻小事,1,602807,0.00016199,97.65124590
32223,芝麻皮,1,602808,0.00016199,97.65140789
32224,芝麻綠豆,1,602809,0.00016199,97.65156989
32225,芙,1,602810,0.00016199,97.65173188
32226,芙蓉花,1,602811,0.00016199,97.65189387
32227,芭比娃娃,1,602812,0.00016199,97.65205587
32228,芭比儂國際公司,1,602813,0.00016199,97.65221786
32229,芭芭拉．克魯格,1,602814,0.00016199,97.65237986
32230,芽苞,1,602815,0.00016199,97.65254185
32231,花心,1,602816,0.00016199,97.65270385
32232,花木蘭,1,602817,0.00016199,97.65286584
32233,花布,1,602818,0.00016199,97.65302783
32234,花生泥,1,602819,0.00016199,97.65318983
32235,花用,1,602820,0.00016199,97.65335182
32236,花白,1,602821,0.00016199,97.65351382
32237,花式,1,602822,0.00016199,97.65367581
32238,花季,1,602823,0.00016199,97.65383780
32239,花招百出,1,602824,0.00016199,97.65399980
32240,花東,1,602825,0.00016199,97.65416179
32241,花東公路,1,602826,0.00016199,97.65432379
32242,花東防衛司令,1,602827,0.00016199,97.65448578
32243,花東縱谷風景區,1,602828,0.00016199,97.65464778
32244,花果,1,602829,0.00016199,97.65480977
32245,花枝,1,602830,0.00016199,97.65497176
32246,花枝招展,1,602831,0.00016199,97.65513376
32247,花花,1,602832,0.00016199,97.65529575
32248,花花世界,1,602833,0.00016199,97.65545775
32249,花盆,1,602834,0.00016199,97.65561974
32250,花科,1,602835,0.00016199,97.65578174
32251,花圃,1,602836,0.00016199,97.65594373
32252,花容失色,1,602837,0.00016199,97.65610572
32253,花拳繡腿,1,602838,0.00016199,97.65626772
32254,花圈,1,602839,0.00016199,97.65642971
32255,花瓶,1,602840,0.00016199,97.65659171
32256,花毯,1,602841,0.00016199,97.65675370
32257,花稍,1,602842,0.00016199,97.65691569
32258,花開花落,1,602843,0.00016199,97.65707769
32259,花園城市,1,602844,0.00016199,97.65723968
32260,花葉,1,602845,0.00016199,97.65740168
32261,花鼓陣,1,602846,0.00016199,97.65756367
32262,花旗貴賓金融卡,1,602847,0.00016199,97.65772567
32263,花旗蔘冰糖燕窩,1,602848,0.00016199,97.65788766
32264,花碧玉,1,602849,0.00016199,97.65804965
32265,花樣年華,1,602850,0.00016199,97.65821165
32266,花樣百出,1,602851,0.00016199,97.65837364
32267,花蓮玉里榮民醫院,1,602852,0.00016199,97.65853564
32268,花蓮門諾醫院,1,602853,0.00016199,97.65869763
32269,花蓮港,1,602854,0.00016199,97.65885963
32270,花蓮廠,1,602855,0.00016199,97.65902162
32271,花蓮縣政府,1,602856,0.00016199,97.65918361
32272,花器,1,602857,0.00016199,97.65934561
32273,花壇,1,602858,0.00016199,97.65950760
32274,花磚,1,602859,0.00016199,97.65966960
32275,花縣警局,1,602860,0.00016199,97.65983159
32276,花蕊,1,602861,0.00016199,97.65999358
32277,花雕,1,602862,0.00016199,97.66015558
32278,花蕾,1,602863,0.00016199,97.66031757
32279,花點,1,602864,0.00016199,97.66047957
32280,芬芳,1,602865,0.00016199,97.66064156
32281,芬蘭河,1,602866,0.00016199,97.66080356
32282,芥菜,1,602867,0.00016199,97.66096555
32283,芸芸,1,602868,0.00016199,97.66112754
32284,虎口,1,602869,0.00016199,97.66128954
32285,虎尾,1,602870,0.00016199,97.66145153
32286,虎豹,1,602871,0.00016199,97.66161353
32287,虎將,1,602872,0.00016199,97.66177552
32288,虱目魚,1,602873,0.00016199,97.66193752
32289,初一,1,602874,0.00016199,97.66209951
32290,初升,1,602875,0.00016199,97.66226150
32291,初始化,1,602876,0.00016199,97.66242350
32292,初時,1,602877,0.00016199,97.66258549
32293,初創,1,602878,0.00016199,97.66274749
32294,初期值,1,602879,0.00016199,97.66290948
32295,初階,1,602880,0.00016199,97.66307148
32296,初識,1,602881,0.00016199,97.66323347
32297,初戀,1,602882,0.00016199,97.66339546
32298,表相,1,602883,0.00016199,97.66355746
32299,表述,1,602884,0.00016199,97.66371945
32300,表面積,1,602885,0.00016199,97.66388145
32301,表哥,1,602886,0.00016199,97.66404344
32302,表現慾,1,602887,0.00016199,97.66420543
32303,表報,1,602888,0.00016199,97.66436743
32304,表殼,1,602889,0.00016199,97.66452942
32305,表裡一致,1,602890,0.00016199,97.66469142
32306,表飾,1,602891,0.00016199,97.66485341
32307,表演力,1,602892,0.00016199,97.66501541
32308,表演台,1,602893,0.00016199,97.66517740
32309,表演式,1,602894,0.00016199,97.66533939
32310,表演性,1,602895,0.00016199,97.66550139
32311,表演者,1,602896,0.00016199,97.66566338
32312,表演廳,1,602897,0.00016199,97.66582538
32313,表層,1,602898,0.00016199,97.66598737
32314,軋,1,602899,0.00016199,97.66614937
32315,軋軋,1,602900,0.00016199,97.66631136
32316,軋型,1,602901,0.00016199,97.66647335
32317,迎刃而解,1,602902,0.00016199,97.66663535
32318,迎向,1,602903,0.00016199,97.66679734
32319,迎風,1,602904,0.00016199,97.66695934
32320,迎神賽會,1,602905,0.00016199,97.66712133
32321,迎娶,1,602906,0.00016199,97.66728332
32322,迎頭痛擊,1,602907,0.00016199,97.66744532
32323,迎頭趕上,1,602908,0.00016199,97.66760731
32324,返台,1,602909,0.00016199,97.66776931
32325,返老還童,1,602910,0.00016199,97.66793130
32326,返航,1,602911,0.00016199,97.66809330
32327,返鄉,1,602912,0.00016199,97.66825529
32328,返馳變壓器,1,602913,0.00016199,97.66841728
32329,近山區,1,602914,0.00016199,97.66857928
32330,近乎,1,602915,0.00016199,97.66874127
32331,近代中國女權運動史料,1,602916,0.00016199,97.66890327
32332,近代史,1,602917,0.00016199,97.66906526
32333,近代書法家,1,602918,0.00016199,97.66922726
32334,近百,1,602919,0.00016199,97.66938925
32335,近程,1,602920,0.00016199,97.66955124
32336,近視,1,602921,0.00016199,97.66971324
32337,近照,1,602922,0.00016199,97.66987523
32338,近戰,1,602923,0.00016199,97.67003723
32339,近攝型態,1,602924,0.00016199,97.67019922
32340,邵麗娟,1,602925,0.00016199,97.67036121
32341,邱大宗,1,602926,0.00016199,97.67052321
32342,邱心志,1,602927,0.00016199,97.67068520
32343,邱永漢,1,602928,0.00016199,97.67084720
32344,邱立屏,1,602929,0.00016199,97.67100919
32345,邱吉爾,1,602930,0.00016199,97.67117119
32346,邱英昊,1,602931,0.00016199,97.67133318
32347,邱展全,1,602932,0.00016199,97.67149517
32348,邱淑玲,1,602933,0.00016199,97.67165717
32349,邱淑貞,1,602934,0.00016199,97.67181916
32350,邱婷,1,602935,0.00016199,97.67198116
32351,邱發山,1,602936,0.00016199,97.67214315
32352,邱順始,1,602937,0.00016199,97.67230515
32353,邱勤庭,1,602938,0.00016199,97.67246714
32354,邱彰,1,602939,0.00016199,97.67262913
32355,采盟,1,602940,0.00016199,97.67279113
32356,采韻,1,602941,0.00016199,97.67295312
32357,金子,1,602942,0.00016199,97.67311512
32358,金山南路,1,602943,0.00016199,97.67327711
32359,金工,1,602944,0.00016199,97.67343910
32360,金中信,1,602945,0.00016199,97.67360110
32361,金井義明,1,602946,0.00016199,97.67376309
32362,金元萱,1,602947,0.00016199,97.67392509
32363,金手套,1,602948,0.00016199,97.67408708
32364,金文,1,602949,0.00016199,97.67424908
32365,金氏世界博物館,1,602950,0.00016199,97.67441107
32366,金氏紀錄,1,602951,0.00016199,97.67457306
32367,金卡,1,602952,0.00016199,97.67473506
32368,金正吉,1,602953,0.00016199,97.67489705
32369,金玉,1,602954,0.00016199,97.67505905
32370,金瓜石,1,602955,0.00016199,97.67522104
32371,金石堂書店,1,602956,0.00016199,97.67538304
32372,金光,1,602957,0.00016199,97.67554503
32373,金光黨,1,602958,0.00016199,97.67570702
32374,金匠,1,602959,0.00016199,97.67586902
32375,金曲龍虎榜,1,602960,0.00016199,97.67603101
32376,金色轟炸機,1,602961,0.00016199,97.67619301
32377,金角,1,602962,0.00016199,97.67635500
32378,金貝辛格,1,602963,0.00016199,97.67651699
32379,金車食品,1,602964,0.00016199,97.67667899
32380,金防部,1,602965,0.00016199,97.67684098
32381,金店,1,602966,0.00016199,97.67700298
32382,金門仔,1,602967,0.00016199,97.67716497
32383,金門島,1,602968,0.00016199,97.67732697
32384,金門航空站,1,602969,0.00016199,97.67748896
32385,金門線,1,602970,0.00016199,97.67765095
32386,金亭,1,602971,0.00016199,97.67781295
32387,金城鎮,1,602972,0.00016199,97.67797494
32388,金星記,1,602973,0.00016199,97.67813694
32389,金面媽祖,1,602974,0.00016199,97.67829893
32390,金剛,1,602975,0.00016199,97.67846093
32391,金剛薩埵,1,602976,0.00016199,97.67862292
32392,金庫,1,602977,0.00016199,97.67878491
32393,金海岸,1,602978,0.00016199,97.67894691
32394,金脈,1,602979,0.00016199,97.67910890
32395,金崇誠,1,602980,0.00016199,97.67927090
32396,金崇諴,1,602981,0.00016199,97.67943289
32397,金袋獎,1,602982,0.00016199,97.67959488
32398,金雀花,1,602983,0.00016199,97.67975688
32399,金凱瑞,1,602984,0.00016199,97.67991887
32400,金棺,1,602985,0.00016199,97.68008087
32401,金湯匙,1,602986,0.00016199,97.68024286
32402,金牌國片,1,602987,0.00016199,97.68040486
32403,金牌警校軍,1,602988,0.00016199,97.68056685
32404,金童,1,602989,0.00016199,97.68072884
32405,金筆,1,602990,0.00016199,97.68089084
32406,金鄉縣,1,602991,0.00016199,97.68105283
32407,金雄烈,1,602992,0.00016199,97.68121483
32408,金獅影音,1,602993,0.00016199,97.68137682
32409,金盞,1,602994,0.00016199,97.68153882
32410,金頓公司,1,602995,0.00016199,97.68170081
32411,金頓科技股份有限公司,1,602996,0.00016199,97.68186280
32412,金鼎,1,602997,0.00016199,97.68202480
32413,金鼎期貨,1,602998,0.00016199,97.68218679
32414,金鼎樟佳,1,602999,0.00016199,97.68234879
32415,金像獎,1,603000,0.00016199,97.68251078
32416,金嘉莊開發公司,1,603001,0.00016199,97.68267277
32417,金夢,1,603002,0.00016199,97.68283477
32418,金碧山水,1,603003,0.00016199,97.68299676
32419,金碧輝煌,1,603004,0.00016199,97.68315876
32420,金箔,1,603005,0.00016199,97.68332075
32421,金箏,1,603006,0.00016199,97.68348275
32422,金銀島,1,603007,0.00016199,97.68364474
32423,金儀車錶,1,603008,0.00016199,97.68380673
32424,金獎影后,1,603009,0.00016199,97.68396873
32425,金緯纖維,1,603010,0.00016199,97.68413072
32426,金蓮花,1,603011,0.00016199,97.68429272
32427,金賞獎,1,603012,0.00016199,97.68445471
32428,金融中心,1,603013,0.00016199,97.68461671
32429,金融危機,1,603014,0.00016199,97.68477870
32430,金融局長,1,603015,0.00016199,97.68494069
32431,金融性,1,603016,0.00016199,97.68510269
32432,金融區,1,603017,0.00016199,97.68526468
32433,金融學,1,603018,0.00016199,97.68542668
32434,金錶,1,603019,0.00016199,97.68558867
32435,金鋼甲,1,603020,0.00016199,97.68575066
32436,金龜頭,1,603021,0.00016199,97.68591266
32437,金懋,1,603022,0.00016199,97.68607465
32438,金燦燦,1,603023,0.00016199,97.68623665
32439,金縷梅,1,603024,0.00016199,97.68639864
32440,金臂人,1,603025,0.00016199,97.68656064
32441,金雞廣場,1,603026,0.00016199,97.68672263
32442,金寶山,1,603027,0.00016199,97.68688462
32443,金屬工業研究發展中心,1,603028,0.00016199,97.68704662
32444,金屬交易所,1,603029,0.00016199,97.68720861
32445,金屬交易員,1,603030,0.00016199,97.68737061
32446,金屬部門,1,603031,0.00016199,97.68753260
32447,金屬線材製造機,1,603032,0.00016199,97.68769460
32448,金攝影獎,1,603033,0.00016199,97.68785659
32449,金權政黨,1,603034,0.00016199,97.68801858
32450,長女,1,603035,0.00016199,97.68818058
32451,長不長,1,603036,0.00016199,97.68834257
32452,長方塊,1,603037,0.00016199,97.68850457
32453,長幼,1,603038,0.00016199,97.68866656
32454,長打率,1,603039,0.00016199,97.68882855
32455,長安大街,1,603040,0.00016199,97.68899055
32456,長江實業,1,603041,0.00016199,97.68915254
32457,長尾,1,603042,0.00016199,97.68931454
32458,長形,1,603043,0.00016199,97.68947653
32459,長沙,1,603044,0.00016199,97.68963853
32460,長谷,1,603045,0.00016199,97.68980052
32461,長谷川德七,1,603046,0.00016199,97.68996251
32462,長豆莢,1,603047,0.00016199,97.69012451
32463,長夜,1,603048,0.00016199,97.69028650
32464,長板椅,1,603049,0.00016199,97.69044850
32465,長青會,1,603050,0.00016199,97.69061049
32466,長青運動會,1,603051,0.00016199,97.69077249
32467,長春,1,603052,0.00016199,97.69093448
32468,長春酒,1,603053,0.00016199,97.69109647
32469,長春集團,1,603054,0.00016199,97.69125847
32470,長衫,1,603055,0.00016199,97.69142046
32471,長孫,1,603056,0.00016199,97.69158246
32472,長島,1,603057,0.00016199,97.69174445
32473,長島一茂,1,603058,0.00016199,97.69190645
32474,長島愛樂管弦樂團,1,603059,0.00016199,97.69206844
32475,長索狀,1,603060,0.00016199,97.69223043
32476,長袖善舞,1,603061,0.00016199,97.69239243
32477,長袍馬褂,1,603062,0.00016199,97.69255442
32478,長途客運,1,603063,0.00016199,97.69271642
32479,長途電話,1,603064,0.00016199,97.69287841
32480,長廊,1,603065,0.00016199,97.69304040
32481,長期利率,1,603066,0.00016199,97.69320240
32482,長短線,1,603067,0.00016199,97.69336439
32483,長筒,1,603068,0.00016199,97.69352639
32484,長跑,1,603069,0.00016199,97.69368838
32485,長進,1,603070,0.00016199,97.69385038
32486,長傳球,1,603071,0.00016199,97.69401237
32487,長媳,1,603072,0.00016199,97.69417436
32488,長腳大蝦,1,603073,0.00016199,97.69433636
32489,長腳赤蛙,1,603074,0.00016199,97.69449835
32490,長話短說,1,603075,0.00016199,97.69466035
32491,長壽,1,603076,0.00016199,97.69482234
32492,長榮集團,1,603077,0.00016199,97.69498434
32493,長榮運輸,1,603078,0.00016199,97.69514633
32494,長槍兵,1,603079,0.00016199,97.69530832
32495,長億高爾夫球場,1,603080,0.00016199,97.69547032
32496,長銷書,1,603081,0.00016199,97.69563231
32497,長駐,1,603082,0.00016199,97.69579431
32498,長髮,1,603083,0.00016199,97.69595630
32499,長機,1,603084,0.00016199,97.69611829
32500,長頸鹿科,1,603085,0.00016199,97.69628029
32501,長龍,1,603086,0.00016199,97.69644228
32502,長濱,1,603087,0.00016199,97.69660428
32503,長營企業公司,1,603088,0.00016199,97.69676627
32504,長營企業股份有限公司,1,603089,0.00016199,97.69692827
32505,長纖布,1,603090,0.00016199,97.69709026
32506,門子,1,603091,0.00016199,97.69725225
32507,門牙,1,603092,0.00016199,97.69741425
32508,門卡迪,1,603093,0.00016199,97.69757624
32509,門外漢,1,603094,0.00016199,97.69773824
32510,門田博光,1,603095,0.00016199,97.69790023
32511,門兒,1,603096,0.00016199,97.69806223
32512,門房,1,603097,0.00016199,97.69822422
32513,門板,1,603098,0.00016199,97.69838621
32514,門門,1,603099,0.00016199,97.69854821
32515,門後,1,603100,0.00016199,97.69871020
32516,門都沒有,1,603101,0.00016199,97.69887220
32517,門診大樓,1,603102,0.00016199,97.69903419
32518,門鈴,1,603103,0.00016199,97.69919618
32519,門飾板,1,603104,0.00016199,97.69935818
32520,門燈,1,603105,0.00016199,97.69952017
32521,門燈記號,1,603106,0.00016199,97.69968217
32522,門縫,1,603107,0.00016199,97.69984416
32523,門邊,1,603108,0.00016199,97.70000616
32524,門關,1,603109,0.00016199,97.70016815
32525,阿七,1,603110,0.00016199,97.70033014
32526,阿公店餐廳,1,603111,0.00016199,97.70049214
32527,阿尼埃爾,1,603112,0.00016199,97.70065413
32528,阿尼埃爾的泳者,1,603113,0.00016199,97.70081613
32529,阿布奎基總台,1,603114,0.00016199,97.70097812
32530,阿弗列德,1,603115,0.00016199,97.70114012
32531,阿甘,1,603116,0.00016199,97.70130211
32532,阿伊達,1,603117,0.00016199,97.70146410
32533,阿托,1,603118,0.00016199,97.70162610
32534,阿托哥,1,603119,0.00016199,97.70178809
32535,阿米西人,1,603120,0.00016199,97.70195009
32536,阿亨大學,1,603121,0.00016199,97.70211208
32537,阿克赫納頓王,1,603122,0.00016199,97.70227407
32538,阿克羅提利,1,603123,0.00016199,97.70243607
32539,阿利亞,1,603124,0.00016199,97.70259806
32540,阿努比斯,1,603125,0.00016199,97.70276006
32541,阿宏,1,603126,0.00016199,97.70292205
32542,阿貝．多傑,1,603127,0.00016199,97.70308405
32543,阿里,1,603128,0.00016199,97.70324604
32544,阿里山鐵路,1,603129,0.00016199,97.70340803
32545,阿姆斯特丹,1,603130,0.00016199,97.70357003
32546,阿帕奇族,1,603131,0.00016199,97.70373202
32547,阿拉,1,603132,0.00016199,97.70389402
32548,阿拉巴馬,1,603133,0.00016199,97.70405601
32549,阿拉巴馬大學,1,603134,0.00016199,97.70421801
32550,阿拉巴馬商業理事會,1,603135,0.00016199,97.70438000
32551,阿拉巴馬彩券,1,603136,0.00016199,97.70454199
32552,阿拉伯人,1,603137,0.00016199,97.70470399
32553,阿拉莫哥多,1,603138,0.00016199,97.70486598
32554,阿波羅十三,1,603139,0.00016199,97.70502798
32555,阿波羅神,1,603140,0.00016199,97.70518997
32556,阿肯色,1,603141,0.00016199,97.70535196
32557,阿信,1,603142,0.00016199,97.70551396
32558,阿格西,1,603143,0.00016199,97.70567595
32559,阿特曼,1,603144,0.00016199,97.70583795
32560,阿茲海默症,1,603145,0.00016199,97.70599994
32561,阿基拉,1,603146,0.00016199,97.70616194
32562,阿喀琉斯,1,603147,0.00016199,97.70632393
32563,阿提喀,1,603148,0.00016199,97.70648592
32564,阿斯匹靈,1,603149,0.00016199,97.70664792
32565,阿斯平,1,603150,0.00016199,97.70680991
32566,阿菊婆,1,603151,0.00016199,97.70697191
32567,阿媽級,1,603152,0.00016199,97.70713390
32568,阿罩霧,1,603153,0.00016199,97.70729590
32569,阿達瓦,1,603154,0.00016199,97.70745789
32570,阿爾及利亞,1,603155,0.00016199,97.70761988
32571,阿爾戈利斯灣,1,603156,0.00016199,97.70778188
32572,阿聯大公國,1,603157,0.00016199,97.70794387
32573,阿羅拉號,1,603158,0.00016199,97.70810587
32574,阿羅許羅德,1,603159,0.00016199,97.70826786
32575,阿蘇火山,1,603160,0.00016199,97.70842985
32576,阿蘇火山國立公園,1,603161,0.00016199,97.70859185
32577,阿靈頓國家公墓,1,603162,0.00016199,97.70875384
32578,阻尼,1,603163,0.00016199,97.70891584
32579,阻抗,1,603164,0.00016199,97.70907783
32580,阻值,1,603165,0.00016199,97.70923983
32581,阻塞性,1,603166,0.00016199,97.70940182
32582,阻塞物,1,603167,0.00016199,97.70956381
32583,附卡,1,603168,0.00016199,97.70972581
32584,附件,1,603169,0.00016199,97.70988780
32585,附和,1,603170,0.00016199,97.71004980
32586,附表,1,603171,0.00016199,97.71021179
32587,附記,1,603172,0.00016199,97.71037379
32588,附庸,1,603173,0.00016199,97.71053578
32589,附著作用,1,603174,0.00016199,97.71069777
32590,附著性,1,603175,0.00016199,97.71085977
32591,附會,1,603176,0.00016199,97.71102176
32592,附圖,1,603177,0.00016199,97.71118376
32593,雨布,1,603178,0.00016199,97.71134575
32594,雨林,1,603179,0.00016199,97.71150774
32595,雨林區,1,603180,0.00016199,97.71166974
32596,雨後春筍,1,603181,0.00016199,97.71183173
32597,雨雪,1,603182,0.00016199,97.71199373
32598,雨勢,1,603183,0.00016199,97.71215572
32599,雨滴,1,603184,0.00016199,97.71231772
32600,雨聲國小,1,603185,0.00016199,97.71247971
32601,雨霧,1,603186,0.00016199,97.71264170
32602,青山綠水,1,603187,0.00016199,97.71280370
32603,青工會,1,603188,0.00016199,97.71296569
32604,青木,1,603189,0.00016199,97.71312769
32605,青木一三,1,603190,0.00016199,97.71328968
32606,青木建設,1,603191,0.00016199,97.71345168
32607,青年人,1,603192,0.00016199,97.71361367
32608,青年工作會,1,603193,0.00016199,97.71377566
32609,青年軍,1,603194,0.00016199,97.71393766
32610,青年報,1,603195,0.00016199,97.71409965
32611,青年會,1,603196,0.00016199,97.71426165
32612,青年路,1,603197,0.00016199,97.71442364
32613,青年黨籍,1,603198,0.00016199,97.71458563
32614,青豆仁,1,603199,0.00016199,97.71474763
32615,青果課長,1,603200,0.00016199,97.71490962
32616,青花菜,1,603201,0.00016199,97.71507162
32617,青青,1,603202,0.00016199,97.71523361
32618,青春永駐,1,603203,0.00016199,97.71539561
32619,青春夜線,1,603204,0.00016199,97.71555760
32620,青春帝國,1,603205,0.00016199,97.71571959
32621,青埔,1,603206,0.00016199,97.71588159
32622,青島西路,1,603207,0.00016199,97.71604358
32623,青海高原,1,603208,0.00016199,97.71620558
32624,青梅竹馬,1,603209,0.00016199,97.71636757
32625,青棒,1,603210,0.00016199,97.71652957
32626,青紫,1,603211,0.00016199,97.71669156
32627,青菜末,1,603212,0.00016199,97.71685355
32628,青菜湯,1,603213,0.00016199,97.71701555
32629,青雲,1,603214,0.00016199,97.71717754
32630,青楓,1,603215,0.00016199,97.71733954
32631,青綠,1,603216,0.00016199,97.71750153
32632,青銅石器,1,603217,0.00016199,97.71766353
32633,青銅器時代,1,603218,0.00016199,97.71782552
32634,青龍草,1,603219,0.00016199,97.71798751
32635,青蘋果,1,603220,0.00016199,97.71814951
32636,青黴素,1,603221,0.00016199,97.71831150
32637,非土著,1,603222,0.00016199,97.71847350
32638,非主要,1,603223,0.00016199,97.71863549
32639,非主動式,1,603224,0.00016199,97.71879748
32640,非平衡式,1,603225,0.00016199,97.71895948
32641,非必然,1,603226,0.00016199,97.71912147
32642,非交錯式螢幕,1,603227,0.00016199,97.71928347
32643,非先發,1,603228,0.00016199,97.71944546
32644,非存在,1,603229,0.00016199,97.71960746
32645,非自覺心理,1,603230,0.00016199,97.71976945
32646,非委任制,1,603231,0.00016199,97.71993144
32647,非物質,1,603232,0.00016199,97.72009344
32648,非政治,1,603233,0.00016199,97.72025543
32649,非洲人,1,603234,0.00016199,97.72041743
32650,非軍事區,1,603235,0.00016199,97.72057942
32651,非音樂,1,603236,0.00016199,97.72074142
32652,非假日,1,603237,0.00016199,97.72090341
32653,非常態,1,603238,0.00016199,97.72106540
32654,非帶原者,1,603239,0.00016199,97.72122740
32655,非插入式,1,603240,0.00016199,97.72138939
32656,非結構性,1,603241,0.00016199,97.72155139
32657,非經濟,1,603242,0.00016199,97.72171338
32658,非零和,1,603243,0.00016199,97.72187537
32659,非寫實,1,603244,0.00016199,97.72203737
32660,非數量化,1,603245,0.00016199,97.72219936
32661,非賣品,1,603246,0.00016199,97.72236136
32662,非戰之罪,1,603247,0.00016199,97.72252335
32663,非營利,1,603248,0.00016199,97.72268535
32664,非議,1,603249,0.00016199,97.72284734
32665,非攝影,1,603250,0.00016199,97.72300933
32666,亟欲,1,603251,0.00016199,97.72317133
32667,亭亭玉立,1,603252,0.00016199,97.72333332
32668,亮片,1,603253,0.00016199,97.72349532
32669,亮光漆,1,603254,0.00016199,97.72365731
32670,亮亮,1,603255,0.00016199,97.72381931
32671,亮面,1,603256,0.00016199,97.72398130
32672,亮粉,1,603257,0.00016199,97.72414329
32673,亮彩,1,603258,0.00016199,97.72430529
32674,亮票,1,603259,0.00016199,97.72446728
32675,亮橙,1,603260,0.00016199,97.72462928
32676,亮鑽,1,603261,0.00016199,97.72479127
32677,信一路,1,603262,0.00016199,97.72495326
32678,信口,1,603263,0.00016199,97.72511526
32679,信不信,1,603264,0.00016199,97.72527725
32680,信心滿滿,1,603265,0.00016199,97.72543925
32681,信以為真,1,603266,0.00016199,97.72560124
32682,信用部,1,603267,0.00016199,97.72576324
32683,信任感,1,603268,0.00016199,97.72592523
32684,信州,1,603269,0.00016199,97.72608722
32685,信托,1,603270,0.00016199,97.72624922
32686,信邪,1,603271,0.00016199,97.72641121
32687,信差,1,603272,0.00016199,97.72657321
32688,信託業法草案,1,603273,0.00016199,97.72673520
32689,信教,1,603274,0.00016199,97.72689720
32690,信條,1,603275,0.00016199,97.72705919
32691,信貸,1,603276,0.00016199,97.72722118
32692,信箋,1,603277,0.00016199,97.72738318
32693,信誼出版社,1,603278,0.00016199,97.72754517
32694,信賴感,1,603279,0.00016199,97.72770717
32695,侵入性儀器,1,603280,0.00016199,97.72786916
32696,侵占,1,603281,0.00016199,97.72803115
32697,侵佔罪,1,603282,0.00016199,97.72819315
32698,侵吞,1,603283,0.00016199,97.72835514
32699,侵略者,1,603284,0.00016199,97.72851714
32700,侯友宜,1,603285,0.00016199,97.72867913
32701,侯文楚,1,603286,0.00016199,97.72884113
32702,侯明甫,1,603287,0.00016199,97.72900312
32703,侯博明,1,603288,0.00016199,97.72916511
32704,侯惠仙,1,603289,0.00016199,97.72932711
32705,侯錦軒,1,603290,0.00016199,97.72948910
32706,便池,1,603291,0.00016199,97.72965110
32707,便衣,1,603292,0.00016199,97.72981309
32708,便衣刑警,1,603293,0.00016199,97.72997509
32709,便利超商,1,603294,0.00016199,97.73013708
32710,便秘,1,603295,0.00016199,97.73029907
32711,便會,1,603296,0.00016199,97.73046107
32712,便當公司,1,603297,0.00016199,97.73062306
32713,便當袋,1,603298,0.00016199,97.73078506
32714,俠客,1,603299,0.00016199,97.73094705
32715,俠客歐尼爾,1,603300,0.00016199,97.73110904
32716,俏,1,603301,0.00016199,97.73127104
32717,俏佾,1,603302,0.00016199,97.73143303
32718,保戶,1,603303,0.00016199,97.73159503
32719,保本型,1,603304,0.00016199,97.73175702
32720,保民,1,603305,0.00016199,97.73191902
32721,保生大帝,1,603306,0.00016199,97.73208101
32722,保全化,1,603307,0.00016199,97.73224300
32723,保存下來,1,603308,0.00016199,97.73240500
32724,保存性,1,603309,0.00016199,97.73256699
32725,保守主義,1,603310,0.00016199,97.73272899
32726,保守型,1,603311,0.00016199,97.73289098
32727,保守派,1,603312,0.00016199,97.73305298
32728,保安,1,603313,0.00016199,97.73321497
32729,保安警察第七總隊,1,603314,0.00016199,97.73337696
32730,保冷袋,1,603315,0.00016199,97.73353896
32731,保肝丸,1,603316,0.00016199,97.73370095
32732,保育小組,1,603317,0.00016199,97.73386295
32733,保育界,1,603318,0.00016199,97.73402494
32734,保育動物,1,603319,0.00016199,97.73418693
32735,保育區,1,603320,0.00016199,97.73434893
32736,保育課,1,603321,0.00016199,97.73451092
32737,保命,1,603322,0.00016199,97.73467292
32738,保修,1,603323,0.00016199,97.73483491
32739,保修廠,1,603324,0.00016199,97.73499691
32740,保留款,1,603325,0.00016199,97.73515890
32741,保健室,1,603326,0.00016199,97.73532089
32742,保健部,1,603327,0.00016199,97.73548289
32743,保釣,1,603328,0.00016199,97.73564488
32744,保釣運動,1,603329,0.00016199,97.73580688
32745,保費,1,603330,0.00016199,97.73596887
32746,保暖,1,603331,0.00016199,97.73613087
32747,保溫,1,603332,0.00016199,97.73629286
32748,保管費,1,603333,0.00016199,97.73645485
32749,保管箱,1,603334,0.00016199,97.73661685
32750,保歐羅康堤,1,603335,0.00016199,97.73677884
32751,保衛者,1,603336,0.00016199,97.73694084
32752,保養廠,1,603337,0.00016199,97.73710283
32753,保險司司長,1,603338,0.00016199,97.73726482
32754,保險套,1,603339,0.00016199,97.73742682
32755,保險業申請電腦處理個人資料登記程序及收費標準,1,603340,0.00016199,97.73758881
32756,保薦,1,603341,0.00016199,97.73775081
32757,保額,1,603342,0.00016199,97.73791280
32758,保羅．艾倫,1,603343,0.00016199,97.73807480
32759,保羅．克魯森,1,603344,0.00016199,97.73823679
32760,保羅．麥克艾維,1,603345,0.00016199,97.73839878
32761,保羅湯瑪斯安德森,1,603346,0.00016199,97.73856078
32762,保羅葛萊瑟,1,603347,0.00016199,97.73872277
32763,保證人,1,603348,0.00016199,97.73888477
32764,保證價格,1,603349,0.00016199,97.73904676
32765,保鏢,1,603350,0.00016199,97.73920876
32766,保麗龍,1,603351,0.00016199,97.73937075
32767,保護女神,1,603352,0.00016199,97.73953274
32768,保護傘,1,603353,0.00016199,97.73969474
32769,促進會,1,603354,0.00016199,97.73985673
32770,促銷力,1,603355,0.00016199,97.74001873
32771,促銷活動,1,603356,0.00016199,97.74018072
32772,促銷期,1,603357,0.00016199,97.74034271
32773,促銷價,1,603358,0.00016199,97.74050471
32774,促銷戰,1,603359,0.00016199,97.74066670
32775,促擁,1,603360,0.00016199,97.74082870
32776,俘,1,603361,0.00016199,97.74099069
32777,俘虜,1,603362,0.00016199,97.74115269
32778,俊秀,1,603363,0.00016199,97.74131468
32779,俊俏,1,603364,0.00016199,97.74147667
32780,俊帥,1,603365,0.00016199,97.74163867
32781,俊美,1,603366,0.00016199,97.74180066
32782,俊國隊,1,603367,0.00016199,97.74196266
32783,俗世,1,603368,0.00016199,97.74212465
32784,俗話,1,603369,0.00016199,97.74228665
32785,俗塵,1,603370,0.00016199,97.74244864
32786,俗麗,1,603371,0.00016199,97.74261063
32787,侮,1,603372,0.00016199,97.74277263
32788,俄人,1,603373,0.00016199,97.74293462
32789,俄亥俄,1,603374,0.00016199,97.74309662
32790,俄亥俄大學,1,603375,0.00016199,97.74325861
32791,俄亥俄州,1,603376,0.00016199,97.74342060
32792,俄軍,1,603377,0.00016199,97.74358260
32793,俄製,1,603378,0.00016199,97.74374459
32794,俚語,1,603379,0.00016199,97.74390659
32795,俞大綱,1,603380,0.00016199,97.74406858
32796,俞振飛,1,603381,0.00016199,97.74423058
32797,俞振庭,1,603382,0.00016199,97.74439257
32798,俞國華,1,603383,0.00016199,97.74455456
32799,侷促,1,603384,0.00016199,97.74471656
32800,冒失,1,603385,0.00016199,97.74487855
32801,冒用,1,603386,0.00016199,97.74504055
32802,冒泡,1,603387,0.00016199,97.74520254
32803,冒雨,1,603388,0.00016199,97.74536454
32804,冒借,1,603389,0.00016199,97.74552653
32805,冒煙,1,603390,0.00016199,97.74568852
32806,冒險性,1,603391,0.00016199,97.74585052
32807,冒險家,1,603392,0.00016199,97.74601251
32808,冒險館,1,603393,0.00016199,97.74617451
32809,冠上,1,603394,0.00016199,97.74633650
32810,冠狀動脈,1,603395,0.00016199,97.74649850
32811,冠狀動脈心臟病,1,603396,0.00016199,97.74666049
32812,冠瑋,1,603397,0.00016199,97.74682248
32813,剃,1,603398,0.00016199,97.74698448
32814,剃刀,1,603399,0.00016199,97.74714647
32815,削,1,603400,0.00016199,97.74730847
32816,削尖,1,603401,0.00016199,97.74747046
32817,削骨,1,603402,0.00016199,97.74763245
32818,前一天,1,603403,0.00016199,97.74779445
32819,前人,1,603404,0.00016199,97.74795644
32820,前不久,1,603405,0.00016199,97.74811844
32821,前文,1,603406,0.00016199,97.74828043
32822,前田青��,1,603407,0.00016199,97.74844243
32823,前兆,1,603408,0.00016199,97.74860442
32824,前列腺,1,603409,0.00016199,97.74876641
32825,前季,1,603410,0.00016199,97.74892841
32826,前波,1,603411,0.00016199,97.74909040
32827,前金區,1,603412,0.00016199,97.74925240
32828,前奏,1,603413,0.00016199,97.74941439
32829,前奏曲,1,603414,0.00016199,97.74957639
32830,前奏聖詠曲,1,603415,0.00016199,97.74973838
32831,前客座氣囊,1,603416,0.00016199,97.74990037
32832,前茅,1,603417,0.00016199,97.75006237
32833,前倨後恭,1,603418,0.00016199,97.75022436
32834,前哨,1,603419,0.00016199,97.75038636
32835,前庭,1,603420,0.00016199,97.75054835
32836,前座,1,603421,0.00016199,97.75071034
32837,前場,1,603422,0.00016199,97.75087234
32838,前窗,1,603423,0.00016199,97.75103433
32839,前菜,1,603424,0.00016199,97.75119633
32840,前週,1,603425,0.00016199,97.75135832
32841,前置胎盤,1,603426,0.00016199,97.75152032
32842,前置碼,1,603427,0.00016199,97.75168231
32843,前輪驅動車,1,603428,0.00016199,97.75184430
32844,前艙,1,603429,0.00016199,97.75200630
32845,前瞻性,1,603430,0.00016199,97.75216829
32846,前鎮,1,603431,0.00016199,97.75233029
32847,前鎮區,1,603432,0.00016199,97.75249228
32848,前題,1,603433,0.00016199,97.75265428
32849,前驅,1,603434,0.00016199,97.75281627
32850,前驅分子,1,603435,0.00016199,97.75297826
32851,前驅車,1,603436,0.00016199,97.75314026
32852,剋制,1,603437,0.00016199,97.75330225
32853,勇者鬥惡龍,1,603438,0.00016199,97.75346425
32854,勇奪,1,603439,0.00016199,97.75362624
32855,勉力,1,603440,0.00016199,97.75378823
32856,勃起,1,603441,0.00016199,97.75395023
32857,勁兒,1,603442,0.00016199,97.75411222
32858,勁射,1,603443,0.00016199,97.75427422
32859,勁揚,1,603444,0.00016199,97.75443621
32860,勁道,1,603445,0.00016199,97.75459821
32861,勁舞,1,603446,0.00016199,97.75476020
32862,勁敵,1,603447,0.00016199,97.75492219
32863,南山,1,603448,0.00016199,97.75508419
32864,南元農場,1,603449,0.00016199,97.75524618
32865,南天竺,1,603450,0.00016199,97.75540818
32866,南屯人,1,603451,0.00016199,97.75557017
32867,南屯交流道,1,603452,0.00016199,97.75573217
32868,南屯派出所,1,603453,0.00016199,97.75589416
32869,南方人,1,603454,0.00016199,97.75605615
32870,南方省,1,603455,0.00016199,97.75621815
32871,南北向,1,603456,0.00016199,97.75638014
32872,南北戰爭,1,603457,0.00016199,97.75654214
32873,南卡羅來納,1,603458,0.00016199,97.75670413
32874,南台灣,1,603459,0.00016199,97.75686612
32875,南市,1,603460,0.00016199,97.75702812
32876,南平里,1,603461,0.00016199,97.75719011
32877,南安普敦大學,1,603462,0.00016199,97.75735211
32878,南西崔薇絲,1,603463,0.00016199,97.75751410
32879,南西薩瓦卡,1,603464,0.00016199,97.75767610
32880,南投市,1,603465,0.00016199,97.75783809
32881,南投廠,1,603466,0.00016199,97.75800008
32882,南沙群島,1,603467,0.00016199,97.75816208
32883,南巡,1,603468,0.00016199,97.75832407
32884,南乳,1,603469,0.00016199,97.75848607
32885,南乳燒肉,1,603470,0.00016199,97.75864806
32886,南亞塑膠,1,603471,0.00016199,97.75881006
32887,南京西路,1,603472,0.00016199,97.75897205
32888,南京軍區,1,603473,0.00016199,97.75913404
32889,南昌,1,603474,0.00016199,97.75929604
32890,南門路,1,603475,0.00016199,97.75945803
32891,南非語,1,603476,0.00016199,97.75962003
32892,南洋,1,603477,0.00016199,97.75978202
32893,南洲里,1,603478,0.00016199,97.75994401
32894,南津關,1,603479,0.00016199,97.76010601
32895,南美,1,603480,0.00016199,97.76026800
32896,南埔,1,603481,0.00016199,97.76043000
32897,南紡,1,603482,0.00016199,97.76059199
32898,南側,1,603483,0.00016199,97.76075399
32899,南部化,1,603484,0.00016199,97.76091598
32900,南斯拉夫,1,603485,0.00016199,97.76107797
32901,南港路,1,603486,0.00016199,97.76123997
32902,南港輪胎,1,603487,0.00016199,97.76140196
32903,南越,1,603488,0.00016199,97.76156396
32904,南開工商專,1,603489,0.00016199,97.76172595
32905,南陽,1,603490,0.00016199,97.76188795
32906,南陽街,1,603491,0.00016199,97.76204994
32907,南陽實業,1,603492,0.00016199,97.76221193
32908,南雅夜市,1,603493,0.00016199,97.76237393
32909,南雅東路,1,603494,0.00016199,97.76253592
32910,南新里,1,603495,0.00016199,97.76269792
32911,南歐人,1,603496,0.00016199,97.76285991
32912,南磯洋水泥,1,603497,0.00016199,97.76302190
32913,南縯,1,603498,0.00016199,97.76318390
32914,南翼,1,603499,0.00016199,97.76334589
32915,南蟆,1,603500,0.00016199,97.76350789
32916,南蹊市,1,603501,0.00016199,97.76366988
32917,南鍬營電力公司,1,603502,0.00016199,97.76383188
32918,南闈南精油隊,1,603503,0.00016199,97.76399387
32919,南灣,1,603504,0.00016199,97.76415586
32920,南蠻,1,603505,0.00016199,97.76431786
32921,卻步,1,603506,0.00016199,97.76447985
32922,厚生,1,603507,0.00016199,97.76464185
32923,厚生大臣,1,603508,0.00016199,97.76480384
32924,厚生省,1,603509,0.00016199,97.76496584
32925,厚此薄彼,1,603510,0.00016199,97.76512783
32926,厚利,1,603511,0.00016199,97.76528982
32927,厚植,1,603512,0.00016199,97.76545182
32928,厚意,1,603513,0.00016199,97.76561381
32929,厚裝書,1,603514,0.00016199,97.76577581
32930,厚膜,1,603515,0.00016199,97.76593780
32931,厚薄,1,603516,0.00016199,97.76609979
32932,叛變,1,603517,0.00016199,97.76626179
32933,咬下,1,603518,0.00016199,97.76642378
32934,咬切齒,1,603519,0.00016199,97.76658578
32935,咬牙切齒,1,603520,0.00016199,97.76674777
32936,咬字,1,603521,0.00016199,97.76690977
32937,咬住,1,603522,0.00016199,97.76707176
32938,咬起來,1,603523,0.00016199,97.76723375
32939,咬碎,1,603524,0.00016199,97.76739575
32940,咬緊牙根,1,603525,0.00016199,97.76755774
32941,哀求,1,603526,0.00016199,97.76771974
32942,哀怨,1,603527,0.00016199,97.76788173
32943,哀矜,1,603528,0.00016199,97.76804373
32944,哀淒,1,603529,0.00016199,97.76820572
32945,哀痛,1,603530,0.00016199,97.76836771
32946,哀嚎,1,603531,0.00016199,97.76852971
32947,哀嚎廝殺,1,603532,0.00016199,97.76869170
32948,哎呀,1,603533,0.00016199,97.76885370
32949,咳嗽藥水,1,603534,0.00016199,97.76901569
32950,哇沙米鮭魚飯糰,1,603535,0.00016199,97.76917768
32951,哇哇,1,603536,0.00016199,97.76933968
32952,哇哇叫,1,603537,0.00016199,97.76950167
32953,咽部,1,603538,0.00016199,97.76966367
32954,咪,1,603539,0.00016199,97.76982566
32955,品位,1,603540,0.00016199,97.76998766
32956,品系,1,603541,0.00016199,97.77014965
32957,品茗,1,603542,0.00016199,97.77031164
32958,品評,1,603543,0.00016199,97.77047364
32959,品賀,1,603544,0.00016199,97.77063563
32960,品種改良,1,603545,0.00016199,97.77079763
32961,品嚐者,1,603546,0.00016199,97.77095962
32962,哄堂大笑,1,603547,0.00016199,97.77112162
32963,哈士蟆油,1,603548,0.00016199,97.77128361
32964,哈巴河,1,603549,0.00016199,97.77144560
32965,哈佛教育學院,1,603550,0.00016199,97.77160760
32966,哈伯瑪斯,1,603551,0.00016199,97.77176959
32967,哈利貝拉方提,1,603552,0.00016199,97.77193159
32968,哈希迪,1,603553,0.00016199,97.77209358
32969,哈里遜教授利,1,603554,0.00016199,97.77225557
32970,哈里遜福特,1,603555,0.00016199,97.77241757
32971,哈姆雷特,1,603556,0.00016199,97.77257956
32972,哈拉,1,603557,0.00016199,97.77274156
32973,哈金斯,1,603558,0.00016199,97.77290355
32974,哈哈鏡,1,603559,0.00016199,97.77306555
32975,哈威,1,603560,0.00016199,97.77322754
32976,哈帝,1,603561,0.00016199,97.77338953
32977,哈特曼斑馬,1,603562,0.00016199,97.77355153
32978,哈馬克,1,603563,0.00016199,97.77371352
32979,哈密瓜,1,603564,0.00016199,97.77387552
32980,哈瑞,1,603565,0.00016199,97.77403751
32981,哈雷,1,603566,0.00016199,97.77419951
32982,哈瑪斯,1,603567,0.00016199,97.77436150
32983,哈維佛斯坦,1,603568,0.00016199,97.77452349
32984,哈潑,1,603569,0.00016199,97.77468549
32985,哈默,1,603570,0.00016199,97.77484748
32986,哈蘇相機,1,603571,0.00016199,97.77500948
32987,哈蘇首獎,1,603572,0.00016199,97.77517147
32988,哈囉,1,603573,0.00016199,97.77533347
32989,垂手可得,1,603574,0.00016199,97.77549546
32990,垂直分工,1,603575,0.00016199,97.77565745
32991,垂直直掃描頻率,1,603576,0.00016199,97.77581945
32992,垂直型,1,603577,0.00016199,97.77598144
32993,垂直掃描頻率,1,603578,0.00016199,97.77614344
32994,垂垂,1,603579,0.00016199,97.77630543
32995,垂釣,1,603580,0.00016199,97.77646742
32996,垂墜感,1,603581,0.00016199,97.77662942
32997,型製,1,603582,0.00016199,97.77679141
32998,型錄,1,603583,0.00016199,97.77695341
32999,垣,1,603584,0.00016199,97.77711540
33000,垢病,1,603585,0.00016199,97.77727740
33001,城下鰈,1,603586,0.00016199,97.77743939
33002,城市花園,1,603587,0.00016199,97.77760138
33003,城府,1,603588,0.00016199,97.77776338
33004,城保,1,603589,0.00016199,97.77792537
33005,城鄉所,1,603590,0.00016199,97.77808737
33006,城磚,1,603591,0.00016199,97.77824936
33007,奏樂,1,603592,0.00016199,97.77841136
33008,姜玉景,1,603593,0.00016199,97.77857335
33009,姜秀鑾,1,603594,0.00016199,97.77873534
33010,姜炫煥,1,603595,0.00016199,97.77889734
33011,姜苦樂,1,603596,0.00016199,97.77905933
33012,姜維君,1,603597,0.00016199,97.77922133
33013,娃娃鞋,1,603598,0.00016199,97.77938332
33014,姪女,1,603599,0.00016199,97.77954531
33015,姚仁喜,1,603600,0.00016199,97.77970731
33016,姚阿宰,1,603601,0.00016199,97.77986930
33017,姚嘉文,1,603602,0.00016199,97.78003130
33018,姚增馨,1,603603,0.00016199,97.78019329
33019,姦污,1,603604,0.00016199,97.78035529
33020,姦淫,1,603605,0.00016199,97.78051728
33021,威士卡國際組織,1,603606,0.00016199,97.78067927
33022,威吐摩,1,603607,0.00016199,97.78084127
33023,威克森林,1,603608,0.00016199,97.78100326
33024,威利,1,603609,0.00016199,97.78116526
33025,威利．威坎諾斯基,1,603610,0.00016199,97.78132725
33026,威利在那裡？不可思議的夢幻之旅,1,603611,0.00016199,97.78148925
33027,威利現在在那裡,1,603612,0.00016199,97.78165124
33028,威武,1,603613,0.00016199,97.78181323
33029,威金森,1,603614,0.00016199,97.78197523
33030,威信,1,603615,0.00016199,97.78213722
33031,威風八面,1,603616,0.00016199,97.78229922
33032,威望,1,603617,0.00016199,97.78246121
33033,威猛,1,603618,0.00016199,97.78262320
33034,威勢,1,603619,0.00016199,97.78278520
33035,威廉．赫迦斯,1,603620,0.00016199,97.78294719
33036,威廉梅西,1,603621,0.00016199,97.78310919
33037,威廉莫洛出版公司,1,603622,0.00016199,97.78327118
33038,威廉赫特,1,603623,0.00016199,97.78343318
33039,威廉鮑德溫,1,603624,0.00016199,97.78359517
33040,威逼,1,603625,0.00016199,97.78375716
33041,威爾史密斯,1,603626,0.00016199,97.78391916
33042,威爾第,1,603627,0.00016199,97.78408115
33043,威凜,1,603628,0.00016199,97.78424315
33044,威權體制,1,603629,0.00016199,97.78440514
33045,姻緣,1,603630,0.00016199,97.78456714
33046,孩子氣,1,603631,0.00016199,97.78472913
33047,宣威火腿,1,603632,0.00016199,97.78489112
33048,宣傳品,1,603633,0.00016199,97.78505312
33049,宣傳單,1,603634,0.00016199,97.78521511
33050,宣銅烈,1,603635,0.00016199,97.78537711
33051,宣講,1,603636,0.00016199,97.78553910
33052,室溫,1,603637,0.00016199,97.78570109
33053,客戶服務部,1,603638,0.00016199,97.78586309
33054,客家人,1,603639,0.00016199,97.78602508
33055,客家文化館,1,603640,0.00016199,97.78618708
33056,客家話,1,603641,0.00016199,97.78634907
33057,客家電台,1,603642,0.00016199,97.78651107
33058,客家廣播電台,1,603643,0.00016199,97.78667306
33059,客席,1,603644,0.00016199,97.78683505
33060,客座,1,603645,0.00016199,97.78699705
33061,客貨車,1,603646,0.00016199,97.78715904
33062,客貨運,1,603647,0.00016199,97.78732104
33063,客雅山,1,603648,0.00016199,97.78748303
33064,客飯,1,603649,0.00016199,97.78764503
33065,客運車,1,603650,0.00016199,97.78780702
33066,客語,1,603651,0.00016199,97.78796901
33067,客觀性,1,603652,0.00016199,97.78813101
33068,封印,1,603653,0.00016199,97.78829300
33069,封建,1,603654,0.00016199,97.78845500
33070,封建思想,1,603655,0.00016199,97.78861699
33071,封面照,1,603656,0.00016199,97.78877898
33072,封殺,1,603657,0.00016199,97.78894098
33073,封港,1,603658,0.00016199,97.78910297
33074,封號,1,603659,0.00016199,97.78926497
33075,封錠,1,603660,0.00016199,97.78942696
33076,封館,1,603661,0.00016199,97.78958896
33077,屎,1,603662,0.00016199,97.78975095
33078,屎霸,1,603663,0.00016199,97.78991294
33079,屏中雀選,1,603664,0.00016199,97.79007494
33080,屏列,1,603665,0.00016199,97.79023693
33081,屏東市,1,603666,0.00016199,97.79039893
33082,屏風表演班,1,603667,0.00016199,97.79056092
33083,屏棄,1,603668,0.00016199,97.79072292
33084,屏衛,1,603669,0.00016199,97.79088491
33085,屏鵝公路,1,603670,0.00016199,97.79104690
33086,屍,1,603671,0.00016199,97.79120890
33087,屍袋,1,603672,0.00016199,97.79137089
33088,屍橫遍地,1,603673,0.00016199,97.79153289
33089,屋舍,1,603674,0.00016199,97.79169488
33090,屋裡,1,603675,0.00016199,97.79185687
33091,帝,1,603676,0.00016199,97.79201887
33092,帝王型總統,1,603677,0.00016199,97.79218086
33093,帝后,1,603678,0.00016199,97.79234286
33094,帝制,1,603679,0.00016199,97.79250485
33095,帝制時代,1,603680,0.00016199,97.79266685
33096,帝國主義,1,603681,0.00016199,97.79282884
33097,帝國飯店,1,603682,0.00016199,97.79299083
33098,帥哥,1,603683,0.00016199,97.79315283
33099,幽幽,1,603684,0.00016199,97.79331482
33100,幽草,1,603685,0.00016199,97.79347682
33101,幽遠,1,603686,0.00016199,97.79363881
33102,幽靈,1,603687,0.00016199,97.79380081
33103,幽闇,1,603688,0.00016199,97.79396280
33104,度政會議,1,603689,0.00016199,97.79412479
33105,度假村,1,603690,0.00016199,97.79428679
33106,度假勝地,1,603691,0.00016199,97.79444878
33107,度量衡,1,603692,0.00016199,97.79461078
33108,建中人,1,603693,0.00016199,97.79477277
33109,建台,1,603694,0.00016199,97.79493476
33110,建地合建,1,603695,0.00016199,97.79509676
33111,建研愛心基金會,1,603696,0.00016199,97.79525875
33112,建研會,1,603697,0.00016199,97.79542075
33113,建國工專,1,603698,0.00016199,97.79558274
33114,建國北路,1,603699,0.00016199,97.79574474
33115,建國市場,1,603700,0.00016199,97.79590673
33116,建國路,1,603701,0.00016199,97.79606872
33117,建設大臣,1,603702,0.00016199,97.79623072
33118,建設業者,1,603703,0.00016199,97.79639271
33119,建進,1,603704,0.00016199,97.79655471
33120,建新路,1,603705,0.00016199,97.79671670
33121,建構者,1,603706,0.00016199,97.79687870
33122,建管,1,603707,0.00016199,97.79704069
33123,建管組,1,603708,0.00016199,97.79720268
33124,建廠,1,603709,0.00016199,97.79736468
33125,建築工業學院,1,603710,0.00016199,97.79752667
33126,建築技術規則修正案,1,603711,0.00016199,97.79768867
33127,建築系,1,603712,0.00016199,97.79785066
33128,建築法規,1,603713,0.00016199,97.79801265
33129,建築處,1,603714,0.00016199,97.79817465
33130,建築廢棄物掩埋場,1,603715,0.00016199,97.79833664
33131,建檔,1,603716,0.00016199,97.79849864
33132,建議值,1,603717,0.00016199,97.79866063
33133,建黨,1,603718,0.00016199,97.79882263
33134,待別,1,603719,0.00016199,97.79898462
33135,待客,1,603720,0.00016199,97.79914661
33136,待產,1,603721,0.00016199,97.79930861
33137,待產室,1,603722,0.00016199,97.79947060
33138,待會,1,603723,0.00016199,97.79963260
33139,待會兒,1,603724,0.00016199,97.79979459
33140,待價而沽,1,603725,0.00016199,97.79995659
33141,待機,1,603726,0.00016199,97.80011858
33142,律,1,603727,0.00016199,97.80028057
33143,律法,1,603728,0.00016199,97.80044257
33144,律師袍,1,603729,0.00016199,97.80060456
33145,律師費,1,603730,0.00016199,97.80076656
33146,律動,1,603731,0.00016199,97.80092855
33147,徇私,1,603732,0.00016199,97.80109055
33148,後天性,1,603733,0.00016199,97.80125254
33149,後世,1,603734,0.00016199,97.80141453
33150,後母,1,603735,0.00016199,97.80157653
33151,後車窗,1,603736,0.00016199,97.80173852
33152,後防,1,603737,0.00016199,97.80190052
33153,後來居上,1,603738,0.00016199,97.80206251
33154,後花園,1,603739,0.00016199,97.80222450
33155,後門,1,603740,0.00016199,97.80238650
33156,後背,1,603741,0.00016199,97.80254849
33157,後埔,1,603742,0.00016199,97.80271049
33158,後記,1,603743,0.00016199,97.80287248
33159,後起之秀,1,603744,0.00016199,97.80303448
33160,後患,1,603745,0.00016199,97.80319647
33161,後備,1,603746,0.00016199,97.80335846
33162,後備軍人,1,603747,0.00016199,97.80352046
33163,後場,1,603748,0.00016199,97.80368245
33164,後援會,1,603749,0.00016199,97.80384445
33165,後港里,1,603750,0.00016199,97.80400644
33166,後然,1,603751,0.00016199,97.80416844
33167,後軸,1,603752,0.00016199,97.80433043
33168,後勤科,1,603753,0.00016199,97.80449242
33169,後置,1,603754,0.00016199,97.80465442
33170,後腦,1,603755,0.00016199,97.80481641
33171,後腦勺,1,603756,0.00016199,97.80497841
33172,後腦稍,1,603757,0.00016199,97.80514040
33173,後裔,1,603758,0.00016199,97.80530239
33174,後路,1,603759,0.00016199,97.80546439
33175,後塵,1,603760,0.00016199,97.80562638
33176,後端,1,603761,0.00016199,97.80578838
33177,後緣,1,603762,0.00016199,97.80595037
33178,後輪,1,603763,0.00016199,97.80611237
33179,後鄧小平時代,1,603764,0.00016199,97.80627436
33180,後壁,1,603765,0.00016199,97.80643635
33181,後壁湖,1,603766,0.00016199,97.80659835
33182,後龍,1,603767,0.00016199,97.80676034
33183,後邊,1,603768,0.00016199,97.80692234
33184,後繼,1,603769,0.00016199,97.80708433
33185,後續性,1,603770,0.00016199,97.80724633
33186,怒不可遏,1,603771,0.00016199,97.80740832
33187,怒目,1,603772,0.00016199,97.80757031
33188,怒吼,1,603773,0.00016199,97.80773231
33189,怒責,1,603774,0.00016199,97.80789430
33190,怒罵,1,603775,0.00016199,97.80805630
33191,思考力,1,603776,0.00016199,97.80821829
33192,思考者,1,603777,0.00016199,97.80838028
33193,思念,1,603778,0.00016199,97.80854228
33194,思想起,1,603779,0.00016199,97.80870427
33195,思想課,1,603780,0.00016199,97.80886627
33196,思路,1,603781,0.00016199,97.80902826
33197,思潮,1,603782,0.00016199,97.80919026
33198,思薇爾,1,603783,0.00016199,97.80935225
33199,怠,1,603784,0.00016199,97.80951424
33200,怠忽,1,603785,0.00016199,97.80967624
33201,怠慢,1,603786,0.00016199,97.80983823
33202,急不急,1,603787,0.00016199,97.81000023
33203,急功心切,1,603788,0.00016199,97.81016222
33204,急行軍,1,603789,0.00016199,97.81032422
33205,急尿,1,603790,0.00016199,97.81048621
33206,急制盆,1,603791,0.00016199,97.81064820
33207,急性喉炎,1,603792,0.00016199,97.81081020
33208,急於一時,1,603793,0.00016199,97.81097219
33209,急度,1,603794,0.00016199,97.81113419
33210,急起,1,603795,0.00016199,97.81129618
33211,急欲,1,603796,0.00016199,97.81145817
33212,急就章,1,603797,0.00016199,97.81162017
33213,急智,1,603798,0.00016199,97.81178216
33214,急須,1,603799,0.00016199,97.81194416
33215,急瘋,1,603800,0.00016199,97.81210615
33216,急購,1,603801,0.00016199,97.81226815
33217,急趨,1,603802,0.00016199,97.81243014
33218,急轉,1,603803,0.00016199,97.81259213
33219,急轉直下,1,603804,0.00016199,97.81275413
33220,急難,1,603805,0.00016199,97.81291612
33221,怎有,1,603806,0.00016199,97.81307812
33222,怎能,1,603807,0.00016199,97.81324011
33223,怎麼回事,1,603808,0.00016199,97.81340211
33224,怨氣,1,603809,0.00016199,97.81356410
33225,怨歎,1,603810,0.00016199,97.81372609
33226,恍如,1,603811,0.00016199,97.81388809
33227,恍恍惚惚,1,603812,0.00016199,97.81405008
33228,恰巴,1,603813,0.00016199,97.81421208
33229,恰如,1,603814,0.00016199,97.81437407
33230,恰是,1,603815,0.00016199,97.81453606
33231,恨恨,1,603816,0.00016199,97.81469806
33232,恢宏,1,603817,0.00016199,97.81486005
33233,恢復室,1,603818,0.00016199,97.81502205
33234,恢復期,1,603819,0.00016199,97.81518404
33235,恆生股價指數,1,603820,0.00016199,97.81534604
33236,恆春半島,1,603821,0.00016199,97.81550803
33237,恆春林業試驗所,1,603822,0.00016199,97.81567002
33238,恆溫,1,603823,0.00016199,97.81583202
33239,恆壓,1,603824,0.00016199,97.81599401
33240,恆昶攝影藝廊,1,603825,0.00016199,97.81615601
33241,恃寵而驕,1,603826,0.00016199,97.81631800
33242,恬逸,1,603827,0.00016199,97.81648000
33243,恬適,1,603828,0.00016199,97.81664199
33244,扁平檔案資料庫,1,603829,0.00016199,97.81680398
33245,扁擔,1,603830,0.00016199,97.81696598
33246,扁鵲,1,603831,0.00016199,97.81712797
33247,拜天公,1,603832,0.00016199,97.81728997
33248,拜占庭,1,603833,0.00016199,97.81745196
33249,拜占庭學家,1,603834,0.00016199,97.81761395
33250,拜年,1,603835,0.00016199,97.81777595
33251,拜別,1,603836,0.00016199,97.81793794
33252,拜祭,1,603837,0.00016199,97.81809994
33253,拜鼓,1,603838,0.00016199,97.81826193
33254,拜爾德,1,603839,0.00016199,97.81842393
33255,拜請,1,603840,0.00016199,97.81858592
33256,拜讀,1,603841,0.00016199,97.81874791
33257,挖土機臂,1,603842,0.00016199,97.81890991
33258,挖來,1,603843,0.00016199,97.81907190
33259,挖洞,1,603844,0.00016199,97.81923390
33260,挖苦,1,603845,0.00016199,97.81939589
33261,挖寶,1,603846,0.00016199,97.81955789
33262,按兵不動,1,603847,0.00016199,97.81971988
33263,按按,1,603848,0.00016199,97.81988187
33264,按捺,1,603849,0.00016199,97.82004387
33265,按捺不住,1,603850,0.00016199,97.82020586
33266,按理,1,603851,0.00016199,97.82036786
33267,按鈴,1,603852,0.00016199,97.82052985
33268,按圖索驥,1,603853,0.00016199,97.82069184
33269,按摩師,1,603854,0.00016199,97.82085384
33270,按摩霜,1,603855,0.00016199,97.82101583
33271,按錯,1,603856,0.00016199,97.82117783
33272,按壓,1,603857,0.00016199,97.82133982
33273,拼好,1,603858,0.00016199,97.82150182
33274,拼接,1,603859,0.00016199,97.82166381
33275,拼貼,1,603860,0.00016199,97.82182580
33276,拼貼式,1,603861,0.00016199,97.82198780
33277,拼裝,1,603862,0.00016199,97.82214979
33278,拼裝廠,1,603863,0.00016199,97.82231179
33279,拭淚,1,603864,0.00016199,97.82247378
33280,拭淨,1,603865,0.00016199,97.82263578
33281,持久力,1,603866,0.00016199,97.82279777
33282,持有人,1,603867,0.00016199,97.82295976
33283,持咒,1,603868,0.00016199,97.82312176
33284,持重,1,603869,0.00016199,97.82328375
33285,持家,1,603870,0.00016199,97.82344575
33286,持槍,1,603871,0.00016199,97.82360774
33287,持績,1,603872,0.00016199,97.82376973
33288,持繼,1,603873,0.00016199,97.82393173
33289,指令集,1,603874,0.00016199,97.82409372
33290,指向性,1,603875,0.00016199,97.82425572
33291,指命,1,603876,0.00016199,97.82441771
33292,指定用途信託資金投資國外有價證券辦法,1,603877,0.00016199,97.82457971
33293,指定曲,1,603878,0.00016199,97.82474170
33294,指押,1,603879,0.00016199,97.82490369
33295,指南山,1,603880,0.00016199,97.82506569
33296,指南客運,1,603881,0.00016199,97.82522768
33297,指指點點,1,603882,0.00016199,97.82538968
33298,指涉,1,603883,0.00016199,97.82555167
33299,指針,1,603884,0.00016199,97.82571367
33300,指揮台,1,603885,0.00016199,97.82587566
33301,指揮官,1,603886,0.00016199,97.82603765
33302,指摘,1,603887,0.00016199,97.82619965
33303,指數函數,1,603888,0.00016199,97.82636164
33304,指數型基金,1,603889,0.00016199,97.82652364
33305,指數效應,1,603890,0.00016199,97.82668563
33306,指數高點論,1,603891,0.00016199,97.82684762
33307,指標廠,1,603892,0.00016199,97.82700962
33308,指頭,1,603893,0.00016199,97.82717161
33309,指環,1,603894,0.00016199,97.82733361
33310,指職甄選,1,603895,0.00016199,97.82749560
33311,拱廊,1,603896,0.00016199,97.82765760
33312,拱豬,1,603897,0.00016199,97.82781959
33313,拷貝機,1,603898,0.00016199,97.82798158
33314,括傷,1,603899,0.00016199,97.82814358
33315,拾荒老人,1,603900,0.00016199,97.82830557
33316,拾畫叫畫,1,603901,0.00016199,97.82846757
33317,挑挑揀揀,1,603902,0.00016199,97.82862956
33318,挑起,1,603903,0.00016199,97.82879156
33319,挑動,1,603904,0.00016199,97.82895355
33320,挑逗性,1,603905,0.00016199,97.82911554
33321,挑嘴,1,603906,0.00016199,97.82927754
33322,挑戰者,1,603907,0.00016199,97.82943953
33323,挑籃,1,603908,0.00016199,97.82960153
33324,政大,1,603909,0.00016199,97.82976352
33325,政令,1,603910,0.00016199,97.82992552
33326,政協,1,603911,0.00016199,97.83008751
33327,政委,1,603912,0.00016199,97.83024950
33328,政府債券類基金,1,603913,0.00016199,97.83041150
33329,政治工程,1,603914,0.00016199,97.83057349
33330,政治化,1,603915,0.00016199,97.83073549
33331,政治局常委,1,603916,0.00016199,97.83089748
33332,政治系,1,603917,0.00016199,97.83105947
33333,政治迫害,1,603918,0.00016199,97.83122147
33334,政治圈,1,603919,0.00016199,97.83138346
33335,政治舞台,1,603920,0.00016199,97.83154546
33336,政治領袖,1,603921,0.00016199,97.83170745
33337,政務院,1,603922,0.00016199,97.83186945
33338,政商界,1,603923,0.00016199,97.83203144
33339,政綱,1,603924,0.00016199,97.83219343
33340,政黨協商,1,603925,0.00016199,97.83235543
33341,故土,1,603926,0.00016199,97.83251742
33342,故布疑陣,1,603927,0.00016199,97.83267942
33343,故步自封,1,603928,0.00016199,97.83284141
33344,故宮,1,603929,0.00016199,97.83300341
33345,故態,1,603930,0.00016199,97.83316540
33346,施工期,1,603931,0.00016199,97.83332739
33347,施丹吉兒,1,603932,0.00016199,97.83348939
33348,施佩爾,1,603933,0.00016199,97.83365138
33349,施要瑜,1,603934,0.00016199,97.83381338
33350,施計,1,603935,0.00016199,97.83397537
33351,施恩,1,603936,0.00016199,97.83413736
33352,施格蘭志亞公司,1,603937,0.00016199,97.83429936
33353,施雪芬,1,603938,0.00016199,97.83446135
33354,施豐坤,1,603939,0.00016199,97.83462335
33355,施鎮洋,1,603940,0.00016199,97.83478534
33356,既使,1,603941,0.00016199,97.83494734
33357,既往不咎,1,603942,0.00016199,97.83510933
33358,春分,1,603943,0.00016199,97.83527132
33359,春分盤,1,603944,0.00016199,97.83543332
33360,春光,1,603945,0.00016199,97.83559531
33361,春季號,1,603946,0.00016199,97.83575731
33362,春風不化雨,1,603947,0.00016199,97.83591930
33363,春夏秋冬,1,603948,0.00016199,97.83608130
33364,春陽,1,603949,0.00016199,97.83624329
33365,春暉電影台,1,603950,0.00016199,97.83640528
33366,春裝,1,603951,0.00016199,97.83656728
33367,春雷,1,603952,0.00016199,97.83672927
33368,昭示,1,603953,0.00016199,97.83689127
33369,昭安宮,1,603954,0.00016199,97.83705326
33370,昭和四十四年,1,603955,0.00016199,97.83721525
33371,昭然若揭,1,603956,0.00016199,97.83737725
33372,昭彰,1,603957,0.00016199,97.83753924
33373,映證,1,603958,0.00016199,97.83770124
33374,映襯,1,603959,0.00016199,97.83786323
33375,是就是不是．不是就是是,1,603960,0.00016199,97.83802523
33376,星斗,1,603961,0.00016199,97.83818722
33377,星河,1,603962,0.00016199,97.83834921
33378,星河夜語,1,603963,0.00016199,97.83851121
33379,星狀,1,603964,0.00016199,97.83867320
33380,星空,1,603965,0.00016199,97.83883520
33381,星相,1,603966,0.00016199,97.83899719
33382,星島集團,1,603967,0.00016199,97.83915919
33383,星訊,1,603968,0.00016199,97.83932118
33384,星迷,1,603969,0.00016199,97.83948317
33385,星宿海,1,603970,0.00016199,97.83964517
33386,星野仙一,1,603971,0.00016199,97.83980716
33387,星期二,1,603972,0.00016199,97.83996916
33388,星期三,1,603973,0.00016199,97.84013115
33389,星期四,1,603974,0.00016199,97.84029314
33390,星期假日,1,603975,0.00016199,97.84045514
33391,星象,1,603976,0.00016199,97.84061713
33392,星雲,1,603977,0.00016199,97.84077913
33393,星夢,1,603978,0.00016199,97.84094112
33394,星幣,1,603979,0.00016199,97.84110312
33395,星際終結者,1,603980,0.00016199,97.84126511
33396,昨兒,1,603981,0.00016199,97.84142710
33397,柿,1,603982,0.00016199,97.84158910
33398,染料,1,603983,0.00016199,97.84175109
33399,染滿,1,603984,0.00016199,97.84191309
33400,柱狀,1,603985,0.00016199,97.84207508
33401,柱侯醬,1,603986,0.00016199,97.84223708
33402,柔,1,603987,0.00016199,97.84239907
33403,柔性政黨,1,603988,0.00016199,97.84256106
33404,柔柔,1,603989,0.00016199,97.84272306
33405,柔美感,1,603990,0.00016199,97.84288505
33406,柔剛,1,603991,0.00016199,97.84304705
33407,柔軟感,1,603992,0.00016199,97.84320904
33408,柔軟操,1,603993,0.00016199,97.84337103
33409,柔雅,1,603994,0.00016199,97.84353303
33410,柔道,1,603995,0.00016199,97.84369502
33411,某事,1,603996,0.00016199,97.84385702
33412,架牢,1,603997,0.00016199,97.84401901
33413,架空,1,603998,0.00016199,97.84418101
33414,架構出,1,603999,0.00016199,97.84434300
33415,枯手,1,604000,0.00016199,97.84450499
33416,枯水期,1,604001,0.00016199,97.84466699
33417,枯枯乾乾,1,604002,0.00016199,97.84482898
33418,枯草,1,604003,0.00016199,97.84499098
33419,枯萎,1,604004,0.00016199,97.84515297
33420,枯樹,1,604005,0.00016199,97.84531497
33421,枯澀,1,604006,0.00016199,97.84547696
33422,枯燥,1,604007,0.00016199,97.84563895
33423,枯躁,1,604008,0.00016199,97.84580095
33424,柵欄,1,604009,0.00016199,97.84596294
33425,柯山姆,1,604010,0.00016199,97.84612494
33426,柯尼卡,1,604011,0.00016199,97.84628693
33427,柯波拉,1,604012,0.00016199,97.84644892
33428,柯美月,1,604013,0.00016199,97.84661092
33429,柯時東,1,604014,0.00016199,97.84677291
33430,柯莊屘,1,604015,0.00016199,97.84693491
33431,柯富拓,1,604016,0.00016199,97.84709690
33432,柯達數位相機,1,604017,0.00016199,97.84725890
33433,柯雷延,1,604018,0.00016199,97.84742089
33434,柯夢波丹,1,604019,0.00016199,97.84758288
33435,柯爾,1,604020,0.00016199,97.84774488
33436,柯爾克孜人,1,604021,0.00016199,97.84790687
33437,柯爾要,1,604022,0.00016199,97.84806887
33438,柯諾里,1,604023,0.00016199,97.84823086
33439,柯蘭,1,604024,0.00016199,97.84839286
33440,柯愫吟,1,604025,0.00016199,97.84855485
33441,查封,1,604026,0.00016199,97.84871684
33442,查理王子,1,604027,0.00016199,97.84887884
33443,查理包法利,1,604028,0.00016199,97.84904083
33444,查理哈蒙,1,604029,0.00016199,97.84920283
33445,查理皇子,1,604030,0.00016199,97.84936482
33446,查普曼,1,604031,0.00016199,97.84952681
33447,查禁,1,604032,0.00016199,97.84968881
33448,查賄,1,604033,0.00016199,97.84985080
33449,查爾斯,1,604034,0.00016199,97.85001280
33450,查爾斯．凱遜,1,604035,0.00016199,97.85017479
33451,查爾斯泰柏特,1,604036,0.00016199,97.85033679
33452,查爾斯葛洛汀,1,604037,0.00016199,97.85049878
33453,查德,1,604038,0.00016199,97.85066077
33454,查驗,1,604039,0.00016199,97.85082277
33455,柏尹特顧問公司,1,604040,0.00016199,97.85098476
33456,柏克萊,1,604041,0.00016199,97.85114676
33457,柏克萊大學,1,604042,0.00016199,97.85130875
33458,柏克萊加大,1,604043,0.00016199,97.85147075
33459,柏拉圖,1,604044,0.00016199,97.85163274
33460,柏林市長,1,604045,0.00016199,97.85179473
33461,柏林國民劇院,1,604046,0.00016199,97.85195673
33462,柏油路,1,604047,0.00016199,97.85211872
33463,柏娜汀,1,604048,0.00016199,97.85228072
33464,柏格包得,1,604049,0.00016199,97.85244271
33465,柏崗札,1,604050,0.00016199,97.85260470
33466,柏楊,1,604051,0.00016199,97.85276670
33467,柏圖曼資料庫,1,604052,0.00016199,97.85292869
33468,柏壽廳,1,604053,0.00016199,97.85309069
33469,柏靈油,1,604054,0.00016199,97.85325268
33470,柳,1,604055,0.00016199,97.85341468
33471,柳川福三,1,604056,0.00016199,97.85357667
33472,柳杉,1,604057,0.00016199,97.85373866
33473,柳政學,1,604058,0.00016199,97.85390066
33474,柳夢梅,1,604059,0.00016199,97.85406265
33475,柳蘭,1,604060,0.00016199,97.85422465
33476,歪,1,604061,0.00016199,97.85438664
33477,歪曲,1,604062,0.00016199,97.85454864
33478,歪眼,1,604063,0.00016199,97.85471063
33479,段鍾沂,1,604064,0.00016199,97.85487262
33480,毒性化學物質,1,604065,0.00016199,97.85503462
33481,毒物,1,604066,0.00016199,97.85519661
33482,毒物管理處,1,604067,0.00016199,97.85535861
33483,毒梟,1,604068,0.00016199,97.85552060
33484,毒蛇猛獸,1,604069,0.00016199,97.85568259
33485,毒販,1,604070,0.00016199,97.85584459
33486,毒辣,1,604071,0.00016199,97.85600658
33487,毒箭,1,604072,0.00016199,97.85616858
33488,毒藥,1,604073,0.00016199,97.85633057
33489,毒癰,1,604074,0.00016199,97.85649257
33490,毗連,1,604075,0.00016199,97.85665456
33491,毗鄰,1,604076,0.00016199,97.85681655
33492,氟,1,604077,0.00016199,97.85697855
33493,泉州燈,1,604078,0.00016199,97.85714054
33494,泉色,1,604079,0.00016199,97.85730254
33495,洋人,1,604080,0.00016199,97.85746453
33496,洋星,1,604081,0.00016199,97.85762653
33497,洋洋大觀,1,604082,0.00016199,97.85778852
33498,洋洋旅遊,1,604083,0.00016199,97.85795051
33499,洋洋灑灑,1,604084,0.00016199,97.85811251
33500,洋傘,1,604085,0.00016199,97.85827450
33501,洋菸酒,1,604086,0.00016199,97.85843650
33502,洋蔥丁,1,604087,0.00016199,97.85859849
33503,洋菇,1,604088,0.00016199,97.85876049
33504,洲,1,604089,0.00016199,97.85892248
33505,洪水,1,604090,0.00016199,97.85908447
33506,洪守德,1,604091,0.00016199,97.85924647
33507,洪自誠,1,604092,0.00016199,97.85940846
33508,洪明進,1,604093,0.00016199,97.85957046
33509,洪金寶,1,604094,0.00016199,97.85973245
33510,洪家儀,1,604095,0.00016199,97.85989444
33511,洪振源,1,604096,0.00016199,97.86005644
33512,洪根強,1,604097,0.00016199,97.86021843
33513,洪荒,1,604098,0.00016199,97.86038043
33514,洪荒時代,1,604099,0.00016199,97.86054242
33515,洪國龍,1,604100,0.00016199,97.86070442
33516,洪崇焜,1,604101,0.00016199,97.86086641
33517,洪惠,1,604102,0.00016199,97.86102840
33518,洪雅齡,1,604103,0.00016199,97.86119040
33519,流下來,1,604104,0.00016199,97.86135239
33520,流民,1,604105,0.00016199,97.86151439
33521,流刑,1,604106,0.00016199,97.86167638
33522,流刑地,1,604107,0.00016199,97.86183838
33523,流年,1,604108,0.00016199,97.86200037
33524,流行色,1,604109,0.00016199,97.86216236
33525,流行風,1,604110,0.00016199,97.86232436
33526,流行病,1,604111,0.00016199,97.86248635
33527,流行感,1,604112,0.00016199,97.86264835
33528,流行歌曲,1,604113,0.00016199,97.86281034
33529,流行語,1,604114,0.00016199,97.86297233
33530,流言蜚語,1,604115,0.00016199,97.86313433
33531,流俗,1,604116,0.00016199,97.86329632
33532,流星群,1,604117,0.00016199,97.86345832
33533,流洩,1,604118,0.00016199,97.86362031
33534,流砂,1,604119,0.00016199,97.86378231
33535,流浪狗,1,604120,0.00016199,97.86394430
33536,流淚,1,604121,0.00016199,97.86410629
33537,流產術,1,604122,0.00016199,97.86426829
33538,流通水,1,604123,0.00016199,97.86443028
33539,流通業,1,604124,0.00016199,97.86459228
33540,流連,1,604125,0.00016199,97.86475427
33541,流速,1,604126,0.00016199,97.86491627
33542,流程圖,1,604127,0.00016199,97.86507826
33543,流進,1,604128,0.00016199,97.86524025
33544,流傳下來,1,604129,0.00016199,97.86540225
33545,流會,1,604130,0.00016199,97.86556424
33546,流經,1,604131,0.00016199,97.86572624
33547,流落,1,604132,0.00016199,97.86588823
33548,流暢度,1,604133,0.00016199,97.86605022
33549,流線型,1,604134,0.00016199,97.86621222
33550,流竄,1,604135,0.00016199,97.86637421
33551,流離失所,1,604136,0.00016199,97.86653621
33552,流覽,1,604137,0.00016199,97.86669820
33553,流覽器,1,604138,0.00016199,97.86686020
33554,津津樂道,1,604139,0.00016199,97.86702219
33555,津液,1,604140,0.00016199,97.86718418
33556,津貼,1,604141,0.00016199,97.86734618
33557,洞口,1,604142,0.00016199,97.86750817
33558,洞洞裝,1,604143,0.00016199,97.86767017
33559,洞悉力,1,604144,0.00016199,97.86783216
33560,洞察,1,604145,0.00016199,97.86799416
33561,洗手間,1,604146,0.00016199,97.86815615
33562,洗水槽,1,604147,0.00016199,97.86831814
33563,洗去,1,604148,0.00016199,97.86848014
33564,洗耳恭聽,1,604149,0.00016199,97.86864213
33565,洗衣清潔劑,1,604150,0.00016199,97.86880413
33566,洗衣精,1,604151,0.00016199,97.86896612
33567,洗劫,1,604152,0.00016199,97.86912811
33568,洗浴,1,604153,0.00016199,97.86929011
33569,洗掉,1,604154,0.00016199,97.86945210
33570,洗牌,1,604155,0.00016199,97.86961410
33571,洗腎,1,604156,0.00016199,97.86977609
33572,洗腦,1,604157,0.00016199,97.86993809
33573,洗髮乳,1,604158,0.00016199,97.87010008
33574,洗髮精,1,604159,0.00016199,97.87026207
33575,洗頭,1,604160,0.00016199,97.87042407
33576,洗鍊,1,604161,0.00016199,97.87058606
33577,活人,1,604162,0.00016199,97.87074806
33578,活化石,1,604163,0.00016199,97.87091005
33579,活水,1,604164,0.00016199,97.87107205
33580,活生,1,604165,0.00016199,97.87123404
33581,活活,1,604166,0.00016199,97.87139603
33582,活起來,1,604167,0.00016199,97.87155803
33583,活動力,1,604168,0.00016199,97.87172002
33584,活動度,1,604169,0.00016199,97.87188202
33585,活眼,1,604170,0.00016199,97.87204401
33586,活脫脫,1,604171,0.00016199,97.87220600
33587,活期,1,604172,0.00016199,97.87236800
33588,活像,1,604173,0.00016199,97.87252999
33589,活蝦,1,604174,0.00016199,97.87269199
33590,活蝦王,1,604175,0.00016199,97.87285398
33591,活蹦亂跳,1,604176,0.00016199,97.87301598
33592,洽尋,1,604177,0.00016199,97.87317797
33593,洽當,1,604178,0.00016199,97.87333996
33594,派令,1,604179,0.00016199,97.87350196
33595,派任,1,604180,0.00016199,97.87366395
33596,派兵,1,604181,0.00016199,97.87382595
33597,派車,1,604182,0.00016199,97.87398794
33598,派屈克羅賓森,1,604183,0.00016199,97.87414994
33599,派拉蒙,1,604184,0.00016199,97.87431193
33600,派拉蒙影片公司,1,604185,0.00016199,97.87447392
33601,派兼,1,604186,0.00016199,97.87463592
33602,派特,1,604187,0.00016199,97.87479791
33603,派特森,1,604188,0.00016199,97.87495991
33604,派特森基地,1,604189,0.00016199,97.87512190
33605,派特歐康諾,1,604190,0.00016199,97.87528389
33606,洶湧,1,604191,0.00016199,97.87544589
33607,洛,1,604192,0.00016199,97.87560788
33608,洛史都華,1,604193,0.00016199,97.87576988
33609,洛艾拉摩,1,604194,0.00016199,97.87593187
33610,洛克希德．馬丁公司,1,604195,0.00016199,97.87609387
33611,洛克福耳,1,604196,0.00016199,97.87625586
33612,洛杉磯時報,1,604197,0.00016199,97.87641785
33613,洛杉磯級核動力攻擊潛艦,1,604198,0.00016199,97.87657985
33614,洛杉磯郡,1,604199,0.00016199,97.87674184
33615,洛里昂市,1,604200,0.00016199,97.87690384
33616,洛奇,1,604201,0.00016199,97.87706583
33617,洛桑市,1,604202,0.00016199,97.87722783
33618,洛德曼,1,604203,0.00016199,97.87738982
33619,洩洪,1,604204,0.00016199,97.87755181
33620,洩料,1,604205,0.00016199,97.87771381
33621,洩漏,1,604206,0.00016199,97.87787580
33622,洩慾,1,604207,0.00016199,97.87803780
33623,洩露,1,604208,0.00016199,97.87819979
33624,為了,1,604209,0.00016199,97.87836178
33625,為人詬病,1,604210,0.00016199,97.87852378
33626,為什麼呢,1,604211,0.00016199,97.87868577
33627,為今之計,1,604212,0.00016199,97.87884777
33628,為民服務,1,604213,0.00016199,97.87900976
33629,為伍,1,604214,0.00016199,97.87917176
33630,為先,1,604215,0.00016199,97.87933375
33631,為此,1,604216,0.00016199,97.87949574
33632,為時已晚,1,604217,0.00016199,97.87965774
33633,為時過早,1,604218,0.00016199,97.87981973
33634,為國捐驅,1,604219,0.00016199,97.87998173
33635,為患,1,604220,0.00016199,97.88014372
33636,為期,1,604221,0.00016199,97.88030572
33637,為期不遠,1,604222,0.00016199,97.88046771
33638,為數,1,604223,0.00016199,97.88062970
33639,為鄰,1,604224,0.00016199,97.88079170
33640,為難,1,604225,0.00016199,97.88095369
33641,炬,1,604226,0.00016199,97.88111569
33642,炯炯,1,604227,0.00016199,97.88127768
33643,炯炯有神,1,604228,0.00016199,97.88143967
33644,炭火,1,604229,0.00016199,97.88160167
33645,炭燒咖啡,1,604230,0.00016199,97.88176366
33646,炸死,1,604231,0.00016199,97.88192566
33647,炸魚,1,604232,0.00016199,97.88208765
33648,炸開,1,604233,0.00016199,97.88224965
33649,炸豬皮,1,604234,0.00016199,97.88241164
33650,炸雞排,1,604235,0.00016199,97.88257363
33651,炮口,1,604236,0.00016199,97.88273563
33652,炮車,1,604237,0.00016199,97.88289762
33653,炮訓部,1,604238,0.00016199,97.88305962
33654,炮戰,1,604239,0.00016199,97.88322161
33655,牴觸,1,604240,0.00016199,97.88338361
33656,狩獵者,1,604241,0.00016199,97.88354560
33657,狠下心,1,604242,0.00016199,97.88370759
33658,狠話,1,604243,0.00016199,97.88386959
33659,狡計,1,604244,0.00016199,97.88403158
33660,狡詐,1,604245,0.00016199,97.88419358
33661,狡滑,1,604246,0.00016199,97.88435557
33662,玷辱,1,604247,0.00016199,97.88451756
33663,珊瑚王國,1,604248,0.00016199,97.88467956
33664,珊瑚館,1,604249,0.00016199,97.88484155
33665,珊瑚礁,1,604250,0.00016199,97.88500355
33666,珊瑚寶石公司,1,604251,0.00016199,97.88516554
33667,珊儂．布拉斯,1,604252,0.00016199,97.88532754
33668,玻尿酸,1,604253,0.00016199,97.88548953
33669,玻璃式,1,604254,0.00016199,97.88565152
33670,玻璃瓶,1,604255,0.00016199,97.88581352
33671,玻璃櫃,1,604256,0.00016199,97.88597551
33672,玻璃甕,1,604257,0.00016199,97.88613751
33673,珍妮佛傑森李,1,604258,0.00016199,97.88629950
33674,珍妮絲,1,604259,0.00016199,97.88646150
33675,珍娜,1,604260,0.00016199,97.88662349
33676,珍娜．貝克,1,604261,0.00016199,97.88678548
33677,珍珠白,1,604262,0.00016199,97.88694748
33678,珍珠海潛水訓練中心,1,604263,0.00016199,97.88710947
33679,珍珠博物館,1,604264,0.00016199,97.88727147
33680,珍稀,1,604265,0.00016199,97.88743346
33681,珍禽,1,604266,0.00016199,97.88759546
33682,珍寶,1,604267,0.00016199,97.88775745
33683,珍饌,1,604268,0.00016199,97.88791944
33684,甚且,1,604269,0.00016199,97.88808144
33685,甚至是,1,604270,0.00016199,97.88824343
33686,甚金,1,604271,0.00016199,97.88840543
33687,甚是,1,604272,0.00016199,97.88856742
33688,甭,1,604273,0.00016199,97.88872941
33689,甭提,1,604274,0.00016199,97.88889141
33690,畏畏縮縮,1,604275,0.00016199,97.88905340
33691,畏縮,1,604276,0.00016199,97.88921540
33692,皆知,1,604277,0.00016199,97.88937739
33693,皇天,1,604278,0.00016199,97.88953939
33694,皇民化運動,1,604279,0.00016199,97.88970138
33695,皇后坊,1,604280,0.00016199,97.88986337
33696,皇后草地球場,1,604281,0.00016199,97.89002537
33697,皇妃,1,604282,0.00016199,97.89018736
33698,皇冠小劇場,1,604283,0.00016199,97.89034936
33699,皇帝客運站,1,604284,0.00016199,97.89051135
33700,皇皇,1,604285,0.00016199,97.89067335
33701,皇家國家公園,1,604286,0.00016199,97.89083534
33702,皇陵谷,1,604287,0.00016199,97.89099733
33703,皇普,1,604288,0.00016199,97.89115933
33704,皇旗,1,604289,0.00016199,97.89132132
33705,皈依,1,604290,0.00016199,97.89148332
33706,盆栽,1,604291,0.00016199,97.89164531
33707,盆浴,1,604292,0.00016199,97.89180730
33708,省一中,1,604293,0.00016199,97.89196930
33709,省力,1,604294,0.00016199,97.89213129
33710,省分,1,604295,0.00016199,97.89229329
33711,省水,1,604296,0.00016199,97.89245528
33712,省水型馬桶,1,604297,0.00016199,97.89261728
33713,省水馬桶,1,604298,0.00016199,97.89277927
33714,省主席,1,604299,0.00016199,97.89294126
33715,省市長,1,604300,0.00016199,97.89310326
33716,省立,1,604301,0.00016199,97.89326525
33717,省立美術館,1,604302,0.00016199,97.89342725
33718,省立苗栗醫院,1,604303,0.00016199,97.89358924
33719,省立新竹醫院,1,604304,0.00016199,97.89375124
33720,省立醫院,1,604305,0.00016199,97.89391323
33721,省交通處,1,604306,0.00016199,97.89407522
33722,省份,1,604307,0.00016199,97.89423722
33723,省刑大,1,604308,0.00016199,97.89439921
33724,省卻,1,604309,0.00016199,97.89456121
33725,省政,1,604310,0.00016199,97.89472320
33726,省視,1,604311,0.00016199,97.89488519
33727,省電,1,604312,0.00016199,97.89504719
33728,省電型電冰箱,1,604313,0.00016199,97.89520918
33729,省聯,1,604314,0.00016199,97.89537118
33730,省籍,1,604315,0.00016199,97.89553317
33731,省議長,1,604316,0.00016199,97.89569517
33732,相互連接,1,604317,0.00016199,97.89585716
33733,相互輝映,1,604318,0.00016199,97.89601915
33734,相欠,1,604319,0.00016199,97.89618115
33735,相比之下,1,604320,0.00016199,97.89634314
33736,相加,1,604321,0.00016199,97.89650514
33737,相扣,1,604322,0.00016199,97.89666713
33738,相伴,1,604323,0.00016199,97.89682913
33739,相似性,1,604324,0.00016199,97.89699112
33740,相形之下,1,604325,0.00016199,97.89715311
33741,相依,1,604326,0.00016199,97.89731511
33742,相知,1,604327,0.00016199,97.89747710
33743,相契,1,604328,0.00016199,97.89763910
33744,相待,1,604329,0.00016199,97.89780109
33745,相思樹,1,604330,0.00016199,97.89796308
33746,相乘作用,1,604331,0.00016199,97.89812508
33747,相容度,1,604332,0.00016199,97.89828707
33748,相送,1,604333,0.00016199,97.89844907
33749,相尋,1,604334,0.00016199,97.89861106
33750,相間,1,604335,0.00016199,97.89877306
33751,相嫉,1,604336,0.00016199,97.89893505
33752,相對性,1,604337,0.00016199,97.89909704
33753,相稱,1,604338,0.00016199,97.89925904
33754,相賓,1,604339,0.00016199,97.89942103
33755,相熟,1,604340,0.00016199,97.89958303
33756,相談室,1,604341,0.00016199,97.89974502
33757,相機袋,1,604342,0.00016199,97.89990702
33758,相融感,1,604343,0.00016199,97.90006901
33759,相親,1,604344,0.00016199,97.90023100
33760,相親相愛,1,604345,0.00016199,97.90039300
33761,相隨,1,604346,0.00016199,97.90055499
33762,相邀,1,604347,0.00016199,97.90071699
33763,相黏,1,604348,0.00016199,97.90087898
33764,相簿,1,604349,0.00016199,97.90104097
33765,相贈,1,604350,0.00016199,97.90120297
33766,相關性,1,604351,0.00016199,97.90136496
33767,相讓,1,604352,0.00016199,97.90152696
33768,眉心,1,604353,0.00016199,97.90168895
33769,眉批,1,604354,0.00016199,97.90185095
33770,眉峰,1,604355,0.00016199,97.90201294
33771,眉骨,1,604356,0.00016199,97.90217493
33772,眉剪,1,604357,0.00016199,97.90233693
33773,眉開眼笑,1,604358,0.00016199,97.90249892
33774,看上去,1,604359,0.00016199,97.90266092
33775,看不見的城市,1,604360,0.00016199,97.90282291
33776,看不到,1,604361,0.00016199,97.90298491
33777,看不起,1,604362,0.00016199,97.90314690
33778,看不清,1,604363,0.00016199,97.90330889
33779,看出來,1,604364,0.00016199,97.90347089
33780,看台,1,604365,0.00016199,97.90363288
33781,看似,1,604366,0.00016199,97.90379488
33782,看作,1,604367,0.00016199,97.90395687
33783,看走眼,1,604368,0.00016199,97.90411886
33784,看板,1,604369,0.00016199,97.90428086
33785,看空,1,604370,0.00016199,97.90444285
33786,看門道,1,604371,0.00016199,97.90460485
33787,看俏,1,604372,0.00016199,97.90476684
33788,看家,1,604373,0.00016199,97.90492884
33789,看書,1,604374,0.00016199,97.90509083
33790,看破,1,604375,0.00016199,97.90525282
33791,看笑話,1,604376,0.00016199,97.90541482
33792,看得見,1,604377,0.00016199,97.90557681
33793,看得開,1,604378,0.00016199,97.90573881
33794,看球,1,604379,0.00016199,97.90590080
33795,看透,1,604380,0.00016199,97.90606280
33796,看準,1,604381,0.00016199,97.90622479
33797,看過,1,604382,0.00016199,97.90638678
33798,看樣子,1,604383,0.00016199,97.90654878
33799,看戲,1,604384,0.00016199,97.90671077
33800,盾,1,604385,0.00016199,97.90687277
33801,盾牌,1,604386,0.00016199,97.90703476
33802,盾牌兵,1,604387,0.00016199,97.90719675
33803,矜持,1,604388,0.00016199,97.90735875
33804,砂布,1,604389,0.00016199,97.90752074
33805,砂粒,1,604390,0.00016199,97.90768274
33806,砂麈,1,604391,0.00016199,97.90784473
33807,研求,1,604392,0.00016199,97.90800673
33808,研究室,1,604393,0.00016199,97.90816872
33809,研定,1,604394,0.00016199,97.90833071
33810,研習會,1,604395,0.00016199,97.90849271
33811,研習營,1,604396,0.00016199,97.90865470
33812,研發單位,1,604397,0.00016199,97.90881670
33813,研磨,1,604398,0.00016199,97.90897869
33814,砌,1,604399,0.00016199,97.90914069
33815,砍殺,1,604400,0.00016199,97.90930268
33816,祈,1,604401,0.00016199,97.90946467
33817,祈請,1,604402,0.00016199,97.90962667
33818,祈願,1,604403,0.00016199,97.90978866
33819,祇是,1,604404,0.00016199,97.90995066
33820,祇要,1,604405,0.00016199,97.91011265
33821,科凡斯基那,1,604406,0.00016199,97.91027464
33822,科工館,1,604407,0.00016199,97.91043664
33823,科幻小說,1,604408,0.00016199,97.91059863
33824,科幻片,1,604409,0.00016199,97.91076063
33825,科幻迷,1,604410,0.00016199,97.91092262
33826,科幻感,1,604411,0.00016199,97.91108462
33827,科比西埃,1,604412,0.00016199,97.91124661
33828,科比特,1,604413,0.00016199,97.91140860
33829,科目,1,604414,0.00016199,97.91157060
33830,科技公司,1,604415,0.00016199,97.91173259
33831,科技化,1,604416,0.00016199,97.91189459
33832,科技界,1,604417,0.00016199,97.91205658
33833,科技濾水壺,1,604418,0.00016199,97.91221858
33834,科林斯海灣,1,604419,0.00016199,97.91238057
33835,科林斯運河,1,604420,0.00016199,97.91254256
33836,科威特,1,604421,0.00016199,97.91270456
33837,科研,1,604422,0.00016199,97.91286655
33838,科格拉,1,604423,0.00016199,97.91302855
33839,科特蘭,1,604424,0.00016199,97.91319054
33840,科魚,1,604425,0.00016199,97.91335254
33841,科博館,1,604426,0.00016199,97.91351453
33842,科瑪科瑪,1,604427,0.00016199,97.91367652
33843,科摩羅,1,604428,0.00016199,97.91383852
33844,科學性,1,604429,0.00016199,97.91400051
33845,科學界,1,604430,0.00016199,97.91416251
33846,科羅拉多州,1,604431,0.00016199,97.91432450
33847,秋山,1,604432,0.00016199,97.91448649
33848,秋山富一,1,604433,0.00016199,97.91464849
33849,秋日,1,604434,0.00016199,97.91481048
33850,秋冬季,1,604435,0.00016199,97.91497248
33851,秋田縣,1,604436,0.00016199,97.91513447
33852,秋色,1,604437,0.00016199,97.91529647
33853,秋季號,1,604438,0.00016199,97.91545846
33854,秋訣,1,604439,0.00016199,97.91562045
33855,秋意,1,604440,0.00016199,97.91578245
33856,穿出,1,604441,0.00016199,97.91594444
33857,穿甲彈,1,604442,0.00016199,97.91610644
33858,穿成,1,604443,0.00016199,97.91626843
33859,穿刺,1,604444,0.00016199,97.91643043
33860,穿法,1,604445,0.00016199,97.91659242
33861,穿起來,1,604446,0.00016199,97.91675441
33862,穿脫,1,604447,0.00016199,97.91691641
33863,穿透力,1,604448,0.00016199,97.91707840
33864,穿幫,1,604449,0.00016199,97.91724040
33865,穿髒,1,604450,0.00016199,97.91740239
33866,突出症,1,604451,0.00016199,97.91756438
33867,突尼西亞,1,604452,0.00016199,97.91772638
33868,突穿,1,604453,0.00016199,97.91788837
33869,突飛猛進,1,604454,0.00016199,97.91805037
33870,突破口,1,604455,0.00016199,97.91821236
33871,突厥,1,604456,0.00016199,97.91837436
33872,突厥語,1,604457,0.00016199,97.91853635
33873,突擊隊,1,604458,0.00016199,97.91869834
33874,突襲,1,604459,0.00016199,97.91886034
33875,突變體,1,604460,0.00016199,97.91902233
33876,突兀,1,604461,0.00016199,97.91918433
33877,竿,1,604462,0.00016199,97.91934632
33878,籽,1,604463,0.00016199,97.91950832
33879,紅土,1,604464,0.00016199,97.91967031
33880,紅木櫃,1,604465,0.00016199,97.91983230
33881,紅包本,1,604466,0.00016199,97.91999430
33882,紅白酒,1,604467,0.00016199,97.92015629
33883,紅石峽谷國家休憩地,1,604468,0.00016199,97.92031829
33884,紅石磚,1,604469,0.00016199,97.92048028
33885,紅地毯,1,604470,0.00016199,97.92064227
33886,紅字,1,604471,0.00016199,97.92080427
33887,紅色系,1,604472,0.00016199,97.92096626
33888,紅血素,1,604473,0.00016199,97.92112826
33889,紅血球,1,604474,0.00016199,97.92129025
33890,紅衣,1,604475,0.00016199,97.92145225
33891,紅妝,1,604476,0.00016199,97.92161424
33892,紅尾冬,1,604477,0.00016199,97.92177623
33893,紅狗,1,604478,0.00016199,97.92193823
33894,紅花籽油,1,604479,0.00016199,97.92210022
33895,紅星,1,604480,0.00016199,97.92226222
33896,紅胡蘿蔔,1,604481,0.00016199,97.92242421
33897,紅唇,1,604482,0.00016199,97.92258621
33898,紅柴坑,1,604483,0.00016199,97.92274820
33899,紅狼,1,604484,0.00016199,97.92291019
33900,紅紋鳳蝶,1,604485,0.00016199,97.92307219
33901,紅啤酒,1,604486,0.00016199,97.92323418
33902,紅陵,1,604487,0.00016199,97.92339618
33903,紅雀,1,604488,0.00016199,97.92355817
33904,紅頂藝人,1,604489,0.00016199,97.92372016
33905,紅斑色,1,604490,0.00016199,97.92388216
33906,紅棕,1,604491,0.00016199,97.92404415
33907,紅棕色,1,604492,0.00016199,97.92420615
33908,紅毯,1,604493,0.00016199,97.92436814
33909,紅筆,1,604494,0.00016199,97.92453014
33910,紅絲,1,604495,0.00016199,97.92469213
33911,紅黑,1,604496,0.00016199,97.92485412
33912,紅葉,1,604497,0.00016199,97.92501612
33913,紅葉溫泉,1,604498,0.00016199,97.92517811
33914,紅葡萄酒,1,604499,0.00016199,97.92534011
33915,紅遍,1,604500,0.00016199,97.92550210
33916,紅塵,1,604501,0.00016199,97.92566410
33917,紅鳳菜,1,604502,0.00016199,97.92582609
33918,紅蔥頭,1,604503,0.00016199,97.92598808
33919,紅褐色,1,604504,0.00016199,97.92615008
33920,紅燒魚,1,604505,0.00016199,97.92631207
33921,紅燒獅子頭,1,604506,0.00016199,97.92647407
33922,紅磚步道,1,604507,0.00016199,97.92663606
33923,紅糖水,1,604508,0.00016199,97.92679805
33924,紅頭仔,1,604509,0.00016199,97.92696005
33925,紅燭,1,604510,0.00016199,97.92712204
33926,紅顏,1,604511,0.00016199,97.92728404
33927,紅寶石,1,604512,0.00016199,97.92744603
33928,紅寶石雷射,1,604513,0.00016199,97.92760803
33929,紅露酒,1,604514,0.00016199,97.92777002
33930,紅蘿蔔汁,1,604515,0.00016199,97.92793201
33931,紀元,1,604516,0.00016199,97.92809401
33932,紀念金幣,1,604517,0.00016199,97.92825600
33933,紀念堂,1,604518,0.00016199,97.92841800
33934,紀念晶,1,604519,0.00016199,97.92857999
33935,紀念會,1,604520,0.00016199,97.92874199
33936,紀念幣,1,604521,0.00016199,97.92890398
33937,紀念館,1,604522,0.00016199,97.92906597
33938,紀綠,1,604523,0.00016199,97.92922797
33939,紀慧玲,1,604524,0.00016199,97.92938996
33940,紀錄人,1,604525,0.00016199,97.92955196
33941,紀錄片,1,604526,0.00016199,97.92971395
33942,紀錄台,1,604527,0.00016199,97.92987594
33943,紀錄者,1,604528,0.00016199,97.93003794
33944,紀錄報,1,604529,0.00016199,97.93019993
33945,紀麗君,1,604530,0.00016199,97.93036193
33946,約旦河,1,604531,0.00016199,97.93052392
33947,約克大學,1,604532,0.00016199,97.93068592
33948,約克公爵,1,604533,0.00016199,97.93084791
33949,約見,1,604534,0.00016199,97.93100990
33950,約定俗成,1,604535,0.00016199,97.93117190
33951,約是,1,604536,0.00016199,97.93133389
33952,約略,1,604537,0.00016199,97.93149589
33953,約漢娜．隆貝格,1,604538,0.00016199,97.93165788
33954,約翰．古騰博格,1,604539,0.00016199,97.93181988
33955,約翰．布雷蕭,1,604540,0.00016199,97.93198187
33956,約翰．艾略待,1,604541,0.00016199,97.93214386
33957,約翰．亞當斯,1,604542,0.00016199,97.93230586
33958,約翰．洛曲,1,604543,0.00016199,97.93246785
33959,約翰．馬丁,1,604544,0.00016199,97.93262985
33960,約翰．麥波爾,1,604545,0.00016199,97.93279184
33961,約翰．篇柏騰,1,604546,0.00016199,97.93295383
33962,約翰屈伏特,1,604547,0.00016199,97.93311583
33963,約翰拉塞特,1,604548,0.00016199,97.93327782
33964,約翰密勒,1,604549,0.00016199,97.93343982
33965,約翰梅森,1,604550,0.00016199,97.93360181
33966,約翰莫塞里,1,604551,0.00016199,97.93376381
33967,約翰葛里斯漢,1,604552,0.00016199,97.93392580
33968,約蘭塔．史庫拉,1,604553,0.00016199,97.93408779
33969,美人魚,1,604554,0.00016199,97.93424979
33970,美人關,1,604555,0.00016199,97.93441178
33971,美女與野獸,1,604556,0.00016199,97.93457378
33972,美分,1,604557,0.00016199,97.93473577
33973,美少女,1,604558,0.00016199,97.93489777
33974,美心茶園,1,604559,0.00016199,97.93505976
33975,美式足球,1,604560,0.00016199,97.93522175
33976,美色,1,604561,0.00016199,97.93538375
33977,美利堅共和國,1,604562,0.00016199,97.93554574
33978,美利達,1,604563,0.00016199,97.93570774
33979,美村路,1,604564,0.00016199,97.93586973
33980,美邦公司,1,604565,0.00016199,97.93603172
33981,美林,1,604566,0.00016199,97.93619372
33982,美林日本公司,1,604567,0.00016199,97.93635571
33983,美林證卷,1,604568,0.00016199,97.93651771
33984,美股,1,604569,0.00016199,97.93667970
33985,美洲虎式,1,604570,0.00016199,97.93684170
33986,美食天下,1,604571,0.00016199,97.93700369
33987,美容刷,1,604572,0.00016199,97.93716568
33988,美容院,1,604573,0.00016199,97.93732768
33989,美容顧問,1,604574,0.00016199,97.93748967
33990,美格股票,1,604575,0.00016199,97.93765167
33991,美脂皂,1,604576,0.00016199,97.93781366
33992,美商證券公司,1,604577,0.00016199,97.93797566
33993,美國大選,1,604578,0.00016199,97.93813765
33994,美國女性政策研究中心,1,604579,0.00016199,97.93829964
33995,美國戶外休閒聯盟,1,604580,0.00016199,97.93846164
33996,美國水松,1,604581,0.00016199,97.93862363
33997,美國仔,1,604582,0.00016199,97.93878563
33998,美國存託憑證,1,604583,0.00016199,97.93894762
33999,美國那斯達克證券市場,1,604584,0.00016199,97.93910961
34000,美國長期公債期貨,1,604585,0.00016199,97.93927161
34001,美國故事,1,604586,0.00016199,97.93943360
34002,美國家庭福利協會,1,604587,0.00016199,97.93959560
34003,美國海灣,1,604588,0.00016199,97.93975759
34004,美國紐澤西醫院,1,604589,0.00016199,97.93991959
34005,美國航空太空總署,1,604590,0.00016199,97.94008158
34006,美國移民法,1,604591,0.00016199,97.94024357
34007,美國移民歸化局,1,604592,0.00016199,97.94040557
34008,美國第七艦隊司令,1,604593,0.00016199,97.94056756
34009,美國貨,1,604594,0.00016199,97.94072956
34010,美國陸軍戰車,1,604595,0.00016199,97.94089155
34011,美國貿易代表署,1,604596,0.00016199,97.94105355
34012,美國開放學府,1,604597,0.00016199,97.94121554
34013,美國債券市場,1,604598,0.00016199,97.94137753
34014,美國奧克拉荷馬市大爆炸案,1,604599,0.00016199,97.94153953
34015,美國新聞周刊,1,604600,0.00016199,97.94170152
34016,美國舞孃,1,604601,0.00016199,97.94186352
34017,美國聯邦,1,604602,0.00016199,97.94202551
34018,美國聯邦航空總署,1,604603,0.00016199,97.94218751
34019,美國聯邦準備理事會,1,604604,0.00016199,97.94234950
34020,美國聯邦調查局,1,604605,0.00016199,97.94251149
34021,美術老師,1,604606,0.00016199,97.94267349
34022,美術界,1,604607,0.00016199,97.94283548
34023,美術科,1,604608,0.00016199,97.94299748
34024,美術家,1,604609,0.00016199,97.94315947
34025,美術院,1,604610,0.00016199,97.94332146
34026,美術觀,1,604611,0.00016199,97.94348346
34027,美雪美雪,1,604612,0.00016199,97.94364545
34028,美僑,1,604613,0.00016199,97.94380745
34029,美夢成真,1,604614,0.00016199,97.94396944
34030,美稱,1,604615,0.00016199,97.94413144
34031,美語中心,1,604616,0.00016199,97.94429343
34032,美德,1,604617,0.00016199,97.94445542
34033,美樂淡啤酒,1,604618,0.00016199,97.94461742
34034,美談,1,604619,0.00016199,97.94477941
34035,美輪美奐,1,604620,0.00016199,97.94494141
34036,美餚,1,604621,0.00016199,97.94510340
34037,美麗島,1,604622,0.00016199,97.94526540
34038,美麗新世界,1,604623,0.00016199,97.94542739
34039,美體,1,604624,0.00016199,97.94558938
34040,美饌,1,604625,0.00016199,97.94575138
34041,美鑫科技,1,604626,0.00016199,97.94591337
34042,耐不住,1,604627,0.00016199,97.94607537
34043,耐用性,1,604628,0.00016199,97.94623736
34044,耐受力,1,604629,0.00016199,97.94639935
34045,耐玩度,1,604630,0.00016199,97.94656135
34046,耐撞,1,604631,0.00016199,97.94672334
34047,耐衝擊,1,604632,0.00016199,97.94688534
34048,耐聽,1,604633,0.00016199,97.94704733
34049,耍,1,604634,0.00016199,97.94720933
34050,耍大牌,1,604635,0.00016199,97.94737132
34051,耍詐,1,604636,0.00016199,97.94753331
34052,耍寶,1,604637,0.00016199,97.94769531
34053,耶卡特林堡,1,604638,0.00016199,97.94785730
34054,耶拿,1,604639,0.00016199,97.94801930
34055,耶拿大學,1,604640,0.00016199,97.94818129
34056,耶誕,1,604641,0.00016199,97.94834329
34057,耶誕節,1,604642,0.00016199,97.94850528
34058,耶誕樹,1,604643,0.00016199,97.94866727
34059,耶魯,1,604644,0.00016199,97.94882927
34060,耶魯的沙洛維,1,604645,0.00016199,97.94899126
34061,胖胖,1,604646,0.00016199,97.94915326
34062,胖精靈,1,604647,0.00016199,97.94931525
34063,胃部,1,604648,0.00016199,97.94947724
34064,胃寒,1,604649,0.00016199,97.94963924
34065,胃痛,1,604650,0.00016199,97.94980123
34066,胃腸道,1,604651,0.00016199,97.94996323
34067,背下來,1,604652,0.00016199,97.95012522
34068,背光式螢幕,1,604653,0.00016199,97.95028722
34069,背板,1,604654,0.00016199,97.95044921
34070,背波,1,604655,0.00016199,97.95061120
34071,背信,1,604656,0.00016199,97.95077320
34072,背頁,1,604657,0.00016199,97.95093519
34073,背書,1,604658,0.00016199,97.95109719
34074,背景地,1,604659,0.00016199,97.95125918
34075,背景顏色,1,604660,0.00016199,97.95142118
34076,背離,1,604661,0.00016199,97.95158317
34077,胡一鳳,1,604662,0.00016199,97.95174516
34078,胡人,1,604663,0.00016199,97.95190716
34079,胡文虎,1,604664,0.00016199,97.95206915
34080,胡佛水壩,1,604665,0.00016199,97.95223115
34081,胡佛局長,1,604666,0.00016199,97.95239314
34082,胡宏道,1,604667,0.00016199,97.95255513
34083,胡志明,1,604668,0.00016199,97.95271713
34084,胡帛,1,604669,0.00016199,97.95287912
34085,胡思亂想,1,604670,0.00016199,97.95304112
34086,胡若梅,1,604671,0.00016199,97.95320311
34087,胡狼,1,604672,0.00016199,97.95336511
34088,胡珮璉,1,604673,0.00016199,97.95352710
34089,胡國然,1,604674,0.00016199,97.95368909
34090,胡塞爾,1,604675,0.00016199,97.95385109
34091,胡榮灒,1,604676,0.00016199,97.95401308
34092,胡德松,1,604677,0.00016199,97.95417508
34093,胡適之,1,604678,0.00016199,97.95433707
34094,胡錦濤,1,604679,0.00016199,97.95449907
34095,胡寶璉,1,604680,0.00016199,97.95466106
34096,胡蘭成,1,604681,0.00016199,97.95482305
34097,胎死腹中,1,604682,0.00016199,97.95498505
34098,胎便,1,604683,0.00016199,97.95514704
34099,胎教,1,604684,0.00016199,97.95530904
34100,胎頭,1,604685,0.00016199,97.95547103
34101,胞,1,604686,0.00016199,97.95563302
34102,胞嘧啶,1,604687,0.00016199,97.95579502
34103,致函,1,604688,0.00016199,97.95595701
34104,致命性,1,604689,0.00016199,97.95611901
34105,致命傷,1,604690,0.00016199,97.95628100
34106,致哀,1,604691,0.00016199,97.95644300
34107,致送,1,604692,0.00016199,97.95660499
34108,致涵,1,604693,0.00016199,97.95676698
34109,致癌,1,604694,0.00016199,97.95692898
34110,致癌性物質,1,604695,0.00016199,97.95709097
34111,致癌率,1,604696,0.00016199,97.95725297
34112,致辭,1,604697,0.00016199,97.95741496
34113,舢舨,1,604698,0.00016199,97.95757696
34114,范立達,1,604699,0.00016199,97.95773895
34115,范秀琴,1,604700,0.00016199,97.95790094
34116,范宗沛,1,604701,0.00016199,97.95806294
34117,范圍,1,604702,0.00016199,97.95822493
34118,范登柏格,1,604703,0.00016199,97.95838693
34119,范榮達,1,604704,0.00016199,97.95854892
34120,范艷華,1,604705,0.00016199,97.95871091
34121,茅台,1,604706,0.00016199,97.95887291
34122,茅屋,1,604707,0.00016199,97.95903490
34123,茅膏菜屬,1,604708,0.00016199,97.95919690
34124,苣,1,604709,0.00016199,97.95935889
34125,苛求,1,604710,0.00016199,97.95952089
34126,苛刻,1,604711,0.00016199,97.95968288
34127,苦中苦,1,604712,0.00016199,97.95984487
34128,苦心人,1,604713,0.00016199,97.96000687
34129,苦日子,1,604714,0.00016199,97.96016886
34130,苦水,1,604715,0.00016199,97.96033086
34131,苦汁,1,604716,0.00016199,97.96049285
34132,苦瓜炒肉絲,1,604717,0.00016199,97.96065485
34133,苦瓜臉,1,604718,0.00016199,97.96081684
34134,苦果,1,604719,0.00016199,97.96097883
34135,苦哈哈,1,604720,0.00016199,97.96114083
34136,苦笑,1,604721,0.00016199,97.96130282
34137,苦茶仔,1,604722,0.00016199,97.96146482
34138,苦幹,1,604723,0.00016199,97.96162681
34139,苦楚,1,604724,0.00016199,97.96178880
34140,苦撐,1,604725,0.00016199,97.96195080
34141,苦澀,1,604726,0.00016199,97.96211279
34142,苦難者,1,604727,0.00016199,97.96227479
34143,茄汁鴨肉麵,1,604728,0.00016199,97.96243678
34144,茄苳變電所,1,604729,0.00016199,97.96259878
34145,茄萣鄉,1,604730,0.00016199,97.96276077
34146,若有所失,1,604731,0.00016199,97.96292276
34147,若有所思,1,604732,0.00016199,97.96308476
34148,若非,1,604733,0.00016199,97.96324675
34149,若無其事,1,604734,0.00016199,97.96340875
34150,若然,1,604735,0.00016199,97.96357074
34151,若隱若現,1,604736,0.00016199,97.96373274
34152,茂盛金屬有限公司,1,604737,0.00016199,97.96389473
34153,苗圃,1,604738,0.00016199,97.96405672
34154,苗栗交流道,1,604739,0.00016199,97.96421872
34155,苗栗高商,1,604740,0.00016199,97.96438071
34156,苗栗區,1,604741,0.00016199,97.96454271
34157,苗族,1,604742,0.00016199,97.96470470
34158,苗豐強,1,604743,0.00016199,97.96486669
34159,英寸,1,604744,0.00016199,97.96502869
34160,英才路,1,604745,0.00016199,97.96519068
34161,英尺,1,604746,0.00016199,97.96535268
34162,英文字,1,604747,0.00016199,97.96551467
34163,英文亞洲時報,1,604748,0.00016199,97.96567667
34164,英文虎報,1,604749,0.00016199,97.96583866
34165,英文南華早報,1,604750,0.00016199,97.96600065
34166,英文曼谷郵報,1,604751,0.00016199,97.96616265
34167,英文漢聲雜誌社,1,604752,0.00016199,97.96632464
34168,英文課,1,604753,0.00016199,97.96648664
34169,英式,1,604754,0.00016199,97.96664863
34170,英系,1,604755,0.00016199,97.96681063
34171,英明,1,604756,0.00016199,97.96697262
34172,英姿煥發,1,604757,0.00016199,97.96713461
34173,英哩,1,604758,0.00016199,97.96729661
34174,英挺,1,604759,0.00016199,97.96745860
34175,英氣,1,604760,0.00016199,97.96762060
34176,英泰廣告,1,604761,0.00016199,97.96778259
34177,英烈的歲月,1,604762,0.00016199,97.96794458
34178,英畝,1,604763,0.00016199,97.96810658
34179,英國佬,1,604764,0.00016199,97.96826857
34180,英國室內交響樂團,1,604765,0.00016199,97.96843057
34181,英國浩威,1,604766,0.00016199,97.96859256
34182,英國航太,1,604767,0.00016199,97.96875456
34183,英國國家廣播公司,1,604768,0.00016199,97.96891655
34184,英發,1,604769,0.00016199,97.96907854
34185,英雄不敗,1,604770,0.00016199,97.96924054
34186,英雄交響曲,1,604771,0.00016199,97.96940253
34187,英雄好漢,1,604772,0.00016199,97.96956453
34188,英雄帖,1,604773,0.00016199,97.96972652
34189,英雄傳,1,604774,0.00016199,97.96988852
34190,英雄夢,1,604775,0.00016199,97.97005051
34191,英群公司,1,604776,0.00016199,97.97021250
34192,英語電台,1,604777,0.00016199,97.97037450
34193,英籍,1,604778,0.00016199,97.97053649
34194,茁長,1,604779,0.00016199,97.97069849
34195,苜蓿芽,1,604780,0.00016199,97.97086048
34196,苓雅,1,604781,0.00016199,97.97102248
34197,苟且,1,604782,0.00016199,97.97118447
34198,苯,1,604783,0.00016199,97.97134646
34199,苯二甲酸,1,604784,0.00016199,97.97150846
34200,衍化,1,604785,0.00016199,97.97167045
34201,衍生性金融商品,1,604786,0.00016199,97.97183245
34202,要不了,1,604787,0.00016199,97.97199444
34203,要犯,1,604788,0.00016199,97.97215643
34204,要地,1,604789,0.00016199,97.97231843
34205,要有,1,604790,0.00016199,97.97248042
34206,要命,1,604791,0.00016199,97.97264242
34207,要是,1,604792,0.00016199,97.97280441
34208,要挾,1,604793,0.00016199,97.97296641
34209,要項,1,604794,0.00016199,97.97312840
34210,要塞,1,604795,0.00016199,97.97329039
34211,要塞砲,1,604796,0.00016199,97.97345239
34212,要緊,1,604797,0.00016199,97.97361438
34213,計時表,1,604798,0.00016199,97.97377638
34214,計然,1,604799,0.00016199,97.97393837
34215,計畫書,1,604800,0.00016199,97.97410037
34216,計程車公會,1,604801,0.00016199,97.97426236
34217,計酬,1,604802,0.00016199,97.97442435
34218,計劃表,1,604803,0.00016199,97.97458635
34219,計劃室,1,604804,0.00016199,97.97474834
34220,訂下,1,604805,0.00016199,97.97491034
34221,訂立,1,604806,0.00016199,97.97507233
34222,訂房,1,604807,0.00016199,97.97523432
34223,訂金,1,604808,0.00016199,97.97539632
34224,訂約,1,604809,0.00016199,97.97555831
34225,訂約金,1,604810,0.00016199,97.97572031
34226,訂製,1,604811,0.00016199,97.97588230
34227,訂價,1,604812,0.00016199,97.97604430
34228,訂價部,1,604813,0.00016199,97.97620629
34229,訃聞,1,604814,0.00016199,97.97636828
34230,負有盛名,1,604815,0.00016199,97.97653028
34231,負荷量,1,604816,0.00016199,97.97669227
34232,負責任,1,604817,0.00016199,97.97685427
34233,負責制,1,604818,0.00016199,97.97701626
34234,負傷,1,604819,0.00016199,97.97717826
34235,赴約,1,604820,0.00016199,97.97734025
34236,赴美,1,604821,0.00016199,97.97750224
34237,赴宴,1,604822,0.00016199,97.97766424
34238,赴諸,1,604823,0.00016199,97.97782623
34239,趴,1,604824,0.00016199,97.97798823
34240,趴下,1,604825,0.00016199,97.97815022
34241,軍士,1,604826,0.00016199,97.97831221
34242,軍火,1,604827,0.00016199,97.97847421
34243,軍功路,1,604828,0.00016199,97.97863620
34244,軍民糾紛,1,604829,0.00016199,97.97879820
34245,軍車,1,604830,0.00016199,97.97896019
34246,軍事情報局長,1,604831,0.00016199,97.97912219
34247,軍事單位,1,604832,0.00016199,97.97928418
34248,軍制,1,604833,0.00016199,97.97944617
34249,軍官與魔鬼,1,604834,0.00016199,97.97960817
34250,軍服,1,604835,0.00016199,97.97977016
34251,軍係,1,604836,0.00016199,97.97993216
34252,軍品,1,604837,0.00016199,97.98009415
34253,軍師,1,604838,0.00016199,97.98025615
34254,軍校,1,604839,0.00016199,97.98041814
34255,軍訓,1,604840,0.00016199,97.98058013
34256,軍訓用槍,1,604841,0.00016199,97.98074213
34257,軍情,1,604842,0.00016199,97.98090412
34258,軍情局,1,604843,0.00016199,97.98106612
34259,軍裝,1,604844,0.00016199,97.98122811
34260,軍儀,1,604845,0.00016199,97.98139010
34261,軍樂,1,604846,0.00016199,97.98155210
34262,軍機,1,604847,0.00016199,97.98171409
34263,迦太基,1,604848,0.00016199,97.98187609
34264,迦南難民營,1,604849,0.00016199,97.98203808
34265,迪化街,1,604850,0.00016199,97.98220008
34266,迪斯奈樂園,1,604851,0.00016199,97.98236207
34267,迪雅茲,1,604852,0.00016199,97.98252406
34268,迥然,1,604853,0.00016199,97.98268606
34269,迭有表現,1,604854,0.00016199,97.98284805
34270,迫不得已,1,604855,0.00016199,97.98301005
34271,迤灑,1,604856,0.00016199,97.98317204
34272,郊,1,604857,0.00016199,97.98333404
34273,郎,1,604858,0.00016199,97.98349603
34274,郎世寧,1,604859,0.00016199,97.98365802
34275,郎靜山,1,604860,0.00016199,97.98382002
34276,酋長,1,604861,0.00016199,97.98398201
34277,重化工業,1,604862,0.00016199,97.98414401
34278,重水,1,604863,0.00016199,97.98430600
34279,重打,1,604864,0.00016199,97.98446799
34280,重回,1,604865,0.00016199,97.98462999
34281,重地,1,604866,0.00016199,97.98479198
34282,重汙染工業,1,604867,0.00016199,97.98495398
34283,重估,1,604868,0.00016199,97.98511597
34284,重來,1,604869,0.00016199,97.98527797
34285,重金,1,604870,0.00016199,97.98543996
34286,重型股,1,604871,0.00016199,97.98560195
34287,重度,1,604872,0.00016199,97.98576395
34288,重洋,1,604873,0.00016199,97.98592594
34289,重要站,1,604874,0.00016199,97.98608794
34290,重病患者,1,604875,0.00016199,97.98624993
34291,重砲,1,604876,0.00016199,97.98641193
34292,重配,1,604877,0.00016199,97.98657392
34293,重做,1,604878,0.00016199,97.98673591
34294,重設,1,604879,0.00016199,97.98689791
34295,重創,1,604880,0.00016199,97.98705990
34296,重圍,1,604881,0.00016199,97.98722190
34297,重提,1,604882,0.00016199,97.98738389
34298,重貼現率,1,604883,0.00016199,97.98754588
34299,重陽,1,604884,0.00016199,97.98770788
34300,重陽節,1,604885,0.00016199,97.98786987
34301,重傷,1,604886,0.00016199,97.98803187
34302,重嫌,1,604887,0.00016199,97.98819386
34303,重新出發,1,604888,0.00016199,97.98835586
34304,重罪,1,604889,0.00016199,97.98851785
34305,重話,1,604890,0.00016199,97.98867984
34306,重載,1,604891,0.00016199,97.98884184
34307,重寫,1,604892,0.00016199,97.98900383
34308,重慶森林,1,604893,0.00016199,97.98916583
34309,重慶路,1,604894,0.00016199,97.98932782
34310,重複性,1,604895,0.00016199,97.98948982
34311,重整旗鼓,1,604896,0.00016199,97.98965181
34312,重機槍,1,604897,0.00016199,97.98981380
34313,重獲,1,604898,0.00016199,97.98997580
34314,重轟炸中隊,1,604899,0.00016199,97.99013779
34315,重疊處,1,604900,0.00016199,97.99029979
34316,限用,1,604901,0.00016199,97.99046178
34317,限量版,1,604902,0.00016199,97.99062377
34318,限製,1,604903,0.00016199,97.99078577
34319,限額,1,604904,0.00016199,97.99094776
34320,降下,1,604905,0.00016199,97.99110976
34321,降生,1,604906,0.00016199,97.99127175
34322,降至,1,604907,0.00016199,97.99143375
34323,降為,1,604908,0.00016199,97.99159574
34324,降息,1,604909,0.00016199,97.99175773
34325,降級,1,604910,0.00016199,97.99191973
34326,降幅,1,604911,0.00016199,97.99208172
34327,降落費,1,604912,0.00016199,97.99224372
34328,降調,1,604913,0.00016199,97.99240571
34329,面世,1,604914,0.00016199,97.99256771
34330,面包車,1,604915,0.00016199,97.99272970
34331,面皮,1,604916,0.00016199,97.99289169
34332,面行,1,604917,0.00016199,97.99305369
34333,面見,1,604918,0.00016199,97.99321568
34334,面的時節,1,604919,0.00016199,97.99337768
34335,面面,1,604920,0.00016199,97.99353967
34336,面風,1,604921,0.00016199,97.99370166
34337,面容,1,604922,0.00016199,97.99386366
34338,面部,1,604923,0.00016199,97.99402565
34339,面朝,1,604924,0.00016199,97.99418765
34340,面罩,1,604925,0.00016199,97.99434964
34341,面漆,1,604926,0.00016199,97.99451164
34342,面談,1,604927,0.00016199,97.99467363
34343,面臨性,1,604928,0.00016199,97.99483562
34344,面邀,1,604929,0.00016199,97.99499762
34345,面霜,1,604930,0.00016199,97.99515961
34346,革命史,1,604931,0.00016199,97.99532161
34347,革命者,1,604932,0.00016199,97.99548360
34348,革命實踐研究院,1,604933,0.00016199,97.99564560
34349,革命戰,1,604934,0.00016199,97.99580759
34350,革職,1,604935,0.00016199,97.99596958
34351,韋瓦第,1,604936,0.00016199,97.99613158
34352,韋伯史代,1,604937,0.00016199,97.99629357
34353,韋家雄,1,604938,0.00016199,97.99645557
34354,韋恩斯坦,1,604939,0.00016199,97.99661756
34355,韋端,1,604940,0.00016199,97.99677955
34356,音波,1,604941,0.00016199,97.99694155
34357,音軌,1,604942,0.00016199,97.99710354
34358,音訊,1,604943,0.00016199,97.99726554
34359,音訊全無,1,604944,0.00016199,97.99742753
34360,音感,1,604945,0.00016199,97.99758953
34361,音源,1,604946,0.00016199,97.99775152
34362,音節,1,604947,0.00016199,97.99791351
34363,音標,1,604948,0.00016199,97.99807551
34364,音樂史,1,604949,0.00016199,97.99823750
34365,音樂季,1,604950,0.00016199,97.99839950
34366,音樂研究所,1,604951,0.00016199,97.99856149
34367,音樂時報雜誌,1,604952,0.00016199,97.99872349
34368,音樂院,1,604953,0.00016199,97.99888548
34369,音樂教室,1,604954,0.00016199,97.99904747
34370,音樂盒,1,604955,0.00016199,97.99920947
34371,音樂與音響,1,604956,0.00016199,97.99937146
34372,音樂劇,1,604957,0.00016199,97.99953346
34373,音樂學家,1,604958,0.00016199,97.99969545
34374,音樂聲,1,604959,0.00016199,97.99985745
34375,音壓,1,604960,0.00016199,98.00001944
34376,音譯,1,604961,0.00016199,98.00018143
34377,音響史,1,604962,0.00016199,98.00034343
34378,音響店,1,604963,0.00016199,98.00050542
34379,音響藝坊,1,604964,0.00016199,98.00066742
34380,風土,1,604965,0.00016199,98.00082941
34381,風土人情,1,604966,0.00016199,98.00099140
34382,風切,1,604967,0.00016199,98.00115340
34383,風月式,1,604968,0.00016199,98.00131539
34384,風水學,1,604969,0.00016199,98.00147739
34385,風仙,1,604970,0.00016199,98.00163938
34386,風伋山,1,604971,0.00016199,98.00180138
34387,風尚雜誌,1,604972,0.00016199,98.00196337
34388,風雨,1,604973,0.00016199,98.00212536
34389,風雨交加,1,604974,0.00016199,98.00228736
34390,風雨飄搖,1,604975,0.00016199,98.00244935
34391,風流,1,604976,0.00016199,98.00261135
34392,風浪板,1,604977,0.00016199,98.00277334
34393,風情萬種,1,604978,0.00016199,98.00293534
34394,風笛,1,604979,0.00016199,98.00309733
34395,風雪,1,604980,0.00016199,98.00325932
34396,風景畫,1,604981,0.00016199,98.00342132
34397,風華,1,604982,0.00016199,98.00358331
34398,風雲人物,1,604983,0.00016199,98.00374531
34399,風雲企業獎,1,604984,0.00016199,98.00390730
34400,風雲論壇,1,604985,0.00016199,98.00406929
34401,風獅爺,1,604986,0.00016199,98.00423129
34402,風塵,1,604987,0.00016199,98.00439328
34403,風塵僕僕,1,604988,0.00016199,98.00455528
34404,風箏,1,604989,0.00016199,98.00471727
34405,風暴大陸,1,604990,0.00016199,98.00487927
34406,風暴計,1,604991,0.00016199,98.00504126
34407,風險區,1,604992,0.00016199,98.00520325
34408,風頭,1,604993,0.00016199,98.00536525
34409,風濕性關節炎,1,604994,0.00016199,98.00552724
34410,風聲鶴唳,1,604995,0.00016199,98.00568924
34411,風靡一時,1,604996,0.00016199,98.00585123
34412,風韻,1,604997,0.00016199,98.00601323
34413,飛入,1,604998,0.00016199,98.00617522
34414,飛刀手,1,604999,0.00016199,98.00633721
34415,飛毛腿飛彈,1,605000,0.00016199,98.00649921
34416,飛出,1,605001,0.00016199,98.00666120
34417,飛行原理,1,605002,0.00016199,98.00682320
34418,飛行執照,1,605003,0.00016199,98.00698519
34419,飛行試驗研究院,1,605004,0.00016199,98.00714718
34420,飛行模擬機,1,605005,0.00016199,98.00730918
34421,飛利普公司,1,605006,0.00016199,98.00747117
34422,飛展奇,1,605007,0.00016199,98.00763317
34423,飛航網路,1,605008,0.00016199,98.00779516
34424,飛旋海豚,1,605009,0.00016199,98.00795716
34425,飛球,1,605010,0.00016199,98.00811915
34426,飛魚飛彈,1,605011,0.00016199,98.00828114
34427,飛鳥,1,605012,0.00016199,98.00844314
34428,飛程,1,605013,0.00016199,98.00860513
34429,飛越北極星,1,605014,0.00016199,98.00876713
34430,飛雅特,1,605015,0.00016199,98.00892912
34431,飛雅特車廠,1,605016,0.00016199,98.00909112
34432,飛雅特轎車,1,605017,0.00016199,98.00925311
34433,飛黃騰達,1,605018,0.00016199,98.00941510
34434,飛漲,1,605019,0.00016199,98.00957710
34435,飛彈外交,1,605020,0.00016199,98.00973909
34436,飛彈試射,1,605021,0.00016199,98.00990109
34437,飛盤計畫,1,605022,0.00016199,98.01006308
34438,飛機結構,1,605023,0.00016199,98.01022507
34439,飛機頭,1,605024,0.00016199,98.01038707
34440,飛霓體,1,605025,0.00016199,98.01054906
34441,食人鱷,1,605026,0.00016199,98.01071106
34442,食古不化,1,605027,0.00016199,98.01087305
34443,食用菌,1,605028,0.00016199,98.01103505
34444,食米,1,605029,0.00016199,98.01119704
34445,食性,1,605030,0.00016199,98.01135903
34446,食物中毒,1,605031,0.00016199,98.01152103
34447,食物鏈,1,605032,0.00016199,98.01168302
34448,食品工業發展研究所,1,605033,0.00016199,98.01184502
34449,食品加工業,1,605034,0.00016199,98.01200701
34450,食品所,1,605035,0.00016199,98.01216901
34451,食品業,1,605036,0.00016199,98.01233100
34452,食宿,1,605037,0.00016199,98.01249299
34453,食欲,1,605038,0.00016199,98.01265499
34454,食道,1,605039,0.00016199,98.01281698
34455,食膳,1,605040,0.00016199,98.01297898
34456,食療品,1,605041,0.00016199,98.01314097
34457,首次購屋貸款額度,1,605042,0.00016199,98.01330296
34458,首局,1,605043,0.00016199,98.01346496
34459,首批,1,605044,0.00016199,98.01362695
34460,首屈一指,1,605045,0.00016199,98.01378895
34461,首映電影雜誌,1,605046,0.00016199,98.01395094
34462,首映雜誌,1,605047,0.00016199,98.01411294
34463,首重,1,605048,0.00016199,98.01427493
34464,首首,1,605049,0.00016199,98.01443692
34465,首席顧問,1,605050,0.00016199,98.01459892
34466,首場,1,605051,0.00016199,98.01476091
34467,首善,1,605052,0.00016199,98.01492291
34468,首飾盒,1,605053,0.00016199,98.01508490
34469,首播,1,605054,0.00016199,98.01524690
34470,首獎,1,605055,0.00016199,98.01540889
34471,香山,1,605056,0.00016199,98.01557088
34472,香火,1,605057,0.00016199,98.01573288
34473,香油,1,605058,0.00016199,98.01589487
34474,香香暖暖,1,605059,0.00016199,98.01605687
34475,香案,1,605060,0.00016199,98.01621886
34476,香格里拉飯店,1,605061,0.00016199,98.01638085
34477,香格里拉樂園,1,605062,0.00016199,98.01654285
34478,香氣,1,605063,0.00016199,98.01670484
34479,香貢貢,1,605064,0.00016199,98.01686684
34480,香港怡富,1,605065,0.00016199,98.01702883
34481,香港股市,1,605066,0.00016199,98.01719083
34482,香港南華早報,1,605067,0.00016199,98.01735282
34483,香港島,1,605068,0.00016199,98.01751481
34484,香港特區籌委會,1,605069,0.00016199,98.01767681
34485,香港商寶比公司,1,605070,0.00016199,98.01783880
34486,香港最佳印製書籍獎,1,605071,0.00016199,98.01800080
34487,香港智慧財產權調查局,1,605072,0.00016199,98.01816279
34488,香港蘋果日報,1,605073,0.00016199,98.01832479
34489,香絲,1,605074,0.00016199,98.01848678
34490,香菸,1,605075,0.00016199,98.01864877
34491,香菜末,1,605076,0.00016199,98.01881077
34492,香酥,1,605077,0.00016199,98.01897276
34493,香腸,1,605078,0.00016199,98.01913476
34494,香達,1,605079,0.00016199,98.01929675
34495,香榭里舍大道,1,605080,0.00016199,98.01945874
34496,香精,1,605081,0.00016199,98.01962074
34497,香調,1,605082,0.00016199,98.01978273
34498,香糖,1,605083,0.00016199,98.01994473
34499,香蕉,1,605084,0.00016199,98.02010672
34500,香檳色,1,605085,0.00016199,98.02026872
34501,香菇芽,1,605086,0.00016199,98.02043071
34502,香菇絲,1,605087,0.00016199,98.02059270
34503,香菇麵,1,605088,0.00016199,98.02075470
34504,乘車,1,605089,0.00016199,98.02091669
34505,乘除,1,605090,0.00016199,98.02107869
34506,乘涼,1,605091,0.00016199,98.02124068
34507,乘船,1,605092,0.00016199,98.02140268
34508,乘筏,1,605093,0.00016199,98.02156467
34509,乘駕,1,605094,0.00016199,98.02172666
34510,倍加,1,605095,0.00016199,98.02188866
34511,倍低音提琴,1,605096,0.00016199,98.02205065
34512,倍耐力,1,605097,0.00016199,98.02221265
34513,倍率,1,605098,0.00016199,98.02237464
34514,倍漲,1,605099,0.00016199,98.02253663
34515,倍頻器,1,605100,0.00016199,98.02269863
34516,俯,1,605101,0.00016199,98.02286062
34517,俯臥,1,605102,0.00016199,98.02302262
34518,俯拾,1,605103,0.00016199,98.02318461
34519,俯拾即是,1,605104,0.00016199,98.02334661
34520,俯看,1,605105,0.00016199,98.02350860
34521,俯臨,1,605106,0.00016199,98.02367059
34522,倦勤,1,605107,0.00016199,98.02383259
34523,倦勤齋,1,605108,0.00016199,98.02399458
34524,倖,1,605109,0.00016199,98.02415658
34525,倖存者,1,605110,0.00016199,98.02431857
34526,值回票價,1,605111,0.00016199,98.02448057
34527,值班,1,605112,0.00016199,98.02464256
34528,借取,1,605113,0.00016199,98.02480455
34529,借票,1,605114,0.00016199,98.02496655
34530,借牌費,1,605115,0.00016199,98.02512854
34531,倚天中文,1,605116,0.00016199,98.02529054
34532,倚天電腦,1,605117,0.00016199,98.02545253
34533,倚靠,1,605118,0.00016199,98.02561453
34534,倒不如,1,605119,0.00016199,98.02577652
34535,倒戈,1,605120,0.00016199,98.02593851
34536,倒叩,1,605121,0.00016199,98.02610051
34537,倒行逆施,1,605122,0.00016199,98.02626250
34538,倒店貨,1,605123,0.00016199,98.02642450
34539,倒流,1,605124,0.00016199,98.02658649
34540,倒風,1,605125,0.00016199,98.02674848
34541,倒拿,1,605126,0.00016199,98.02691048
34542,倒帶,1,605127,0.00016199,98.02707247
34543,倒捲,1,605128,0.00016199,98.02723447
34544,倒著,1,605129,0.00016199,98.02739646
34545,倒影,1,605130,0.00016199,98.02755846
34546,俱全,1,605131,0.00016199,98.02772045
34547,俱在,1,605132,0.00016199,98.02788244
34548,俱有,1,605133,0.00016199,98.02804444
34549,俱佳,1,605134,0.00016199,98.02820643
34550,俱備,1,605135,0.00016199,98.02836843
34551,俱揚,1,605136,0.00016199,98.02853042
34552,倡,1,605137,0.00016199,98.02869242
34553,倡行,1,605138,0.00016199,98.02885441
34554,個人主義者,1,605139,0.00016199,98.02901640
34555,個人平均所得,1,605140,0.00016199,98.02917840
34556,個人保護法,1,605141,0.00016199,98.02934039
34557,個人消費金融部,1,605142,0.00016199,98.02950239
34558,個人電腦主機,1,605143,0.00016199,98.02966438
34559,個人數位助理,1,605144,0.00016199,98.02982637
34560,個中,1,605145,0.00016199,98.02998837
34561,個別股,1,605146,0.00016199,98.03015036
34562,個兒,1,605147,0.00016199,98.03031236
34563,個性美,1,605148,0.00016199,98.03047435
34564,個真,1,605149,0.00016199,98.03063635
34565,個頻,1,605150,0.00016199,98.03079834
34566,候彩鳳,1,605151,0.00016199,98.03096033
34567,候傳,1,605152,0.00016199,98.03112233
34568,候機,1,605153,0.00016199,98.03128432
34569,候選車,1,605154,0.00016199,98.03144632
34570,倘如,1,605155,0.00016199,98.03160831
34571,修佛,1,605156,0.00016199,98.03177031
34572,修來,1,605157,0.00016199,98.03193230
34573,修定,1,605158,0.00016199,98.03209429
34574,修長,1,605159,0.00016199,98.03225629
34575,修建,1,605160,0.00016199,98.03241828
34576,修眉日,1,605161,0.00016199,98.03258028
34577,修訂案,1,605162,0.00016199,98.03274227
34578,修容餅,1,605163,0.00016199,98.03290426
34579,修理,1,605164,0.00016199,98.03306626
34580,修畢,1,605165,0.00016199,98.03322825
34581,修船業,1,605166,0.00016199,98.03339025
34582,修業,1,605167,0.00016199,98.03355224
34583,修編,1,605168,0.00016199,98.03371424
34584,修養,1,605169,0.00016199,98.03387623
34585,修憲案,1,605170,0.00016199,98.03403822
34586,修禪,1,605171,0.00016199,98.03420022
34587,修禪風,1,605172,0.00016199,98.03436221
34588,修辭,1,605173,0.00016199,98.03452421
34589,倪雅華,1,605174,0.00016199,98.03468620
34590,倫常,1,605175,0.00016199,98.03484820
34591,倫敦中心區,1,605176,0.00016199,98.03501019
34592,倫敦佬,1,605177,0.00016199,98.03517218
34593,倫敦金融時報,1,605178,0.00016199,98.03533418
34594,倫敦音,1,605179,0.00016199,98.03549617
34595,倫敦愛樂,1,605180,0.00016199,98.03565817
34596,倉頡,1,605181,0.00016199,98.03582016
34597,倉儲碼頭,1,605182,0.00016199,98.03598215
34598,倉儲轉運區,1,605183,0.00016199,98.03614415
34599,兼併,1,605184,0.00016199,98.03630614
34600,兼負,1,605185,0.00016199,98.03646814
34601,兼備,1,605186,0.00016199,98.03663013
34602,兼課,1,605187,0.00016199,98.03679213
34603,兼職人員,1,605188,0.00016199,98.03695412
34604,冤大頭,1,605189,0.00016199,98.03711611
34605,冤屈,1,605190,0.00016199,98.03727811
34606,冤枉路,1,605191,0.00016199,98.03744010
34607,冤枉錢,1,605192,0.00016199,98.03760210
34608,冤家,1,605193,0.00016199,98.03776409
34609,冤獄案,1,605194,0.00016199,98.03792609
34610,冤魂,1,605195,0.00016199,98.03808808
34611,冥冥,1,605196,0.00016199,98.03825007
34612,冥誕,1,605197,0.00016199,98.03841207
34613,凍僵,1,605198,0.00016199,98.03857406
34614,凌,1,605199,0.00016199,98.03873606
34615,凌佩君,1,605200,0.00016199,98.03889805
34616,凌珮君,1,605201,0.00016199,98.03906004
34617,凌越,1,605202,0.00016199,98.03922204
34618,凌亂,1,605203,0.00016199,98.03938403
34619,凌群電腦,1,605204,0.00016199,98.03954603
34620,凌群電腦公司,1,605205,0.00016199,98.03970802
34621,准尉,1,605206,0.00016199,98.03987002
34622,凋敝,1,605207,0.00016199,98.04003201
34623,凋零,1,605208,0.00016199,98.04019400
34624,剖白,1,605209,0.00016199,98.04035600
34625,剖析篇,1,605210,0.00016199,98.04051799
34626,剖腹產,1,605211,0.00016199,98.04067999
34627,剔,1,605212,0.00016199,98.04084198
34628,剔透感,1,605213,0.00016199,98.04100398
34629,剔頭,1,605214,0.00016199,98.04116597
34630,剛巧,1,605215,0.00016199,98.04132796
34631,剛柔配,1,605216,0.00016199,98.04148996
34632,剝皮,1,605217,0.00016199,98.04165195
34633,剝除,1,605218,0.00016199,98.04181395
34634,剝離,1,605219,0.00016199,98.04197594
34635,匪,1,605220,0.00016199,98.04213793
34636,匪疑,1,605221,0.00016199,98.04229993
34637,卿,1,605222,0.00016199,98.04246192
34638,原子核,1,605223,0.00016199,98.04262392
34639,原文版,1,605224,0.00016199,98.04278591
34640,原木,1,605225,0.00016199,98.04294791
34641,原生,1,605226,0.00016199,98.04310990
34642,原亦藝術空間藝廊,1,605227,0.00016199,98.04327189
34643,原地,1,605228,0.00016199,98.04343389
34644,原地踏步,1,605229,0.00016199,98.04359588
34645,原址,1,605230,0.00016199,98.04375788
34646,原委,1,605231,0.00016199,98.04391987
34647,原物料,1,605232,0.00016199,98.04408187
34648,原狀,1,605233,0.00016199,98.04424386
34649,原則上,1,605234,0.00016199,98.04440585
34650,原型機,1,605235,0.00016199,98.04456785
34651,原音,1,605236,0.00016199,98.04472984
34652,原原本本,1,605237,0.00016199,98.04489184
34653,原料空氣,1,605238,0.00016199,98.04505383
34654,原案,1,605239,0.00016199,98.04521582
34655,原素,1,605240,0.00016199,98.04537782
34656,原產局,1,605241,0.00016199,98.04553981
34657,原創性,1,605242,0.00016199,98.04570181
34658,原裝,1,605243,0.00016199,98.04586380
34659,原裝車,1,605244,0.00016199,98.04602580
34660,原圖,1,605245,0.00016199,98.04618779
34661,原價,1,605246,0.00016199,98.04634978
34662,原廠,1,605247,0.00016199,98.04651178
34663,原聲帶,1,605248,0.00016199,98.04667377
34664,原籍,1,605249,0.00016199,98.04683577
34665,哨音,1,605250,0.00016199,98.04699776
34666,唐．尼爾遜,1,605251,0.00016199,98.04715976
34667,唐‧喬凡尼,1,605252,0.00016199,98.04732175
34668,唐氏症,1,605253,0.00016199,98.04748374
34669,唐在揚,1,605254,0.00016199,98.04764574
34670,唐老鴨,1,605255,0.00016199,98.04780773
34671,唐突,1,605256,0.00016199,98.04796973
34672,唐若蘭,1,605257,0.00016199,98.04813172
34673,唐納佛倫,1,605258,0.00016199,98.04829371
34674,唐納柏德利,1,605259,0.00016199,98.04845571
34675,唐草,1,605260,0.00016199,98.04861770
34676,唐國強,1,605261,0.00016199,98.04877970
34677,唐啟,1,605262,0.00016199,98.04894169
34678,唐啟始,1,605263,0.00016199,98.04910369
34679,唐朝,1,605264,0.00016199,98.04926568
34680,唐裝,1,605265,0.00016199,98.04942767
34681,唐榮公司,1,605266,0.00016199,98.04958967
34682,唐榮椿,1,605267,0.00016199,98.04975166
34683,哥兒倆,1,605268,0.00016199,98.04991366
34684,哥倆好,1,605269,0.00016199,98.05007565
34685,哲理,1,605270,0.00016199,98.05023765
34686,哺乳類,1,605271,0.00016199,98.05039964
34687,哭起來,1,605272,0.00016199,98.05056163
34688,哭訴無門,1,605273,0.00016199,98.05072363
34689,員山鄉,1,605274,0.00016199,98.05088562
34690,員工股,1,605275,0.00016199,98.05104762
34691,員林警分局,1,605276,0.00016199,98.05120961
34692,哪裏,1,605277,0.00016199,98.05137160
34693,唇色,1,605278,0.00016199,98.05153360
34694,唇峰,1,605279,0.00016199,98.05169559
34695,唇彩,1,605280,0.00016199,98.05185759
34696,唇彩盒,1,605281,0.00016199,98.05201958
34697,唇週修護霜,1,605282,0.00016199,98.05218158
34698,唇廓,1,605283,0.00016199,98.05234357
34699,唇槍舌劍,1,605284,0.00016199,98.05250556
34700,唇齒,1,605285,0.00016199,98.05266756
34701,唇顎裂,1,605286,0.00016199,98.05282955
34702,唇�f,1,605287,0.00016199,98.05299155
34703,哽塞,1,605288,0.00016199,98.05315354
34704,唏嗦,1,605289,0.00016199,98.05331554
34705,唏噓,1,605290,0.00016199,98.05347753
34706,埔里鎮,1,605291,0.00016199,98.05363952
34707,埋沒,1,605292,0.00016199,98.05380152
34708,埋頭苦幹,1,605293,0.00016199,98.05396351
34709,埃及人,1,605294,0.00016199,98.05412551
34710,埃及王,1,605295,0.00016199,98.05428750
34711,埃及博物館,1,605296,0.00016199,98.05444950
34712,夏冬宮,1,605297,0.00016199,98.05461149
34713,夏享教育學院,1,605298,0.00016199,98.05477348
34714,夏季號,1,605299,0.00016199,98.05493548
34715,夏季熱,1,605300,0.00016199,98.05509747
34716,夏娃八號,1,605301,0.00016199,98.05525947
34717,夏娃辛普森,1,605302,0.00016199,98.05542146
34718,夏威夷三溫暖,1,605303,0.00016199,98.05558345
34719,夏威夷大學,1,605304,0.00016199,98.05574545
34720,夏威夷毛納基山,1,605305,0.00016199,98.05590744
34721,夏春秋,1,605306,0.00016199,98.05606944
34722,夏洛蒂路易絲,1,605307,0.00016199,98.05623143
34723,夏淑賢,1,605308,0.00016199,98.05639343
34724,夏裝,1,605309,0.00016199,98.05655542
34725,夏漢,1,605310,0.00016199,98.05671741
34726,夏爾桑巴河,1,605311,0.00016199,98.05687941
34727,夏儂,1,605312,0.00016199,98.05704140
34728,夏曆,1,605313,0.00016199,98.05720340
34729,夏翼平原上的夕暉,1,605314,0.00016199,98.05736539
34730,套利指數,1,605315,0.00016199,98.05752739
34731,套裝軟體,1,605316,0.00016199,98.05768938
34732,娘,1,605317,0.00016199,98.05785137
34733,娘惹菜,1,605318,0.00016199,98.05801337
34734,娜伊娜,1,605319,0.00016199,98.05817536
34735,娜迪亞主題曲,1,605320,0.00016199,98.05833736
34736,娛,1,605321,0.00016199,98.05849935
34737,娛樂中心,1,605322,0.00016199,98.05866134
34738,姬路市,1,605323,0.00016199,98.05882334
34739,孫子兵法,1,605324,0.00016199,98.05898533
34740,孫天勤,1,605325,0.00016199,98.05914733
34741,孫宏元,1,605326,0.00016199,98.05930932
34742,孫叔叔,1,605327,0.00016199,98.05947132
34743,孫紀善,1,605328,0.00016199,98.05963331
34744,孫悟空歷險記,1,605329,0.00016199,98.05979530
34745,孫留香,1,605330,0.00016199,98.05995730
34746,孫越,1,605331,0.00016199,98.06011929
34747,孫運璿,1,605332,0.00016199,98.06028129
34748,孫瑋芒,1,605333,0.00016199,98.06044328
34749,宰,1,605334,0.00016199,98.06060528
34750,宰制,1,605335,0.00016199,98.06076727
34751,宰相,1,605336,0.00016199,98.06092926
34752,宰相劉羅鍋,1,605337,0.00016199,98.06109126
34753,害人,1,605338,0.00016199,98.06125325
34754,害處,1,605339,0.00016199,98.06141525
34755,家中,1,605340,0.00016199,98.06157724
34756,家扶,1,605341,0.00016199,98.06173923
34757,家具業,1,605342,0.00016199,98.06190123
34758,家長會,1,605343,0.00016199,98.06206322
34759,家室,1,605344,0.00016199,98.06222522
34760,家政班,1,605345,0.00016199,98.06238721
34761,家計,1,605346,0.00016199,98.06254921
34762,家家戶戶,1,605347,0.00016199,98.06271120
34763,家家酒,1,605348,0.00016199,98.06287319
34764,家庭健康顧問,1,605349,0.00016199,98.06303519
34765,家庭號,1,605350,0.00016199,98.06319718
34766,家庭電視遊樂器,1,605351,0.00016199,98.06335918
34767,家庭電腦雜誌,1,605352,0.00016199,98.06352117
34768,家庭暴力,1,605353,0.00016199,98.06368317
34769,家庭醫學科,1,605354,0.00016199,98.06384516
34770,家徒四壁,1,605355,0.00016199,98.06400715
34771,家財萬貫,1,605356,0.00016199,98.06416915
34772,家務事,1,605357,0.00016199,98.06433114
34773,家族企業,1,605358,0.00016199,98.06449314
34774,家訪,1,605359,0.00016199,98.06465513
34775,家鄉菜,1,605360,0.00016199,98.06481712
34776,家禽,1,605361,0.00016199,98.06497912
34777,家電產品,1,605362,0.00016199,98.06514111
34778,家飾,1,605363,0.00016199,98.06530311
34779,家飾布,1,605364,0.00016199,98.06546510
34780,家飾品,1,605365,0.00016199,98.06562710
34781,家廟,1,605366,0.00016199,98.06578909
34782,家數,1,605367,0.00016199,98.06595108
34783,家樂氏,1,605368,0.00016199,98.06611308
34784,家樂福,1,605369,0.00016199,98.06627507
34785,家醫科,1,605370,0.00016199,98.06643707
34786,家裏,1,605371,0.00016199,98.06659906
34787,宴客,1,605372,0.00016199,98.06676106
34788,宴席,1,605373,0.00016199,98.06692305
34789,宴請,1,605374,0.00016199,98.06708504
34790,宮女,1,605375,0.00016199,98.06724704
34791,宮本武藏,1,605376,0.00016199,98.06740903
34792,宮廷秘方,1,605377,0.00016199,98.06757103
34793,宮苑,1,605378,0.00016199,98.06773302
34794,宮崎峻卡通,1,605379,0.00016199,98.06789501
34795,宮崎駿,1,605380,0.00016199,98.06805701
34796,宮縮,1,605381,0.00016199,98.06821900
34797,容光煥發,1,605382,0.00016199,98.06838100
34798,容許度,1,605383,0.00016199,98.06854299
34799,容積率,1,605384,0.00016199,98.06870499
34800,容錯,1,605385,0.00016199,98.06886698
34801,容錦昌,1,605386,0.00016199,98.06902897
34802,射出機,1,605387,0.00016199,98.06919097
34803,射向,1,605388,0.00016199,98.06935296
34804,射門,1,605389,0.00016199,98.06951496
34805,射控,1,605390,0.00016199,98.06967695
34806,射腳,1,605391,0.00016199,98.06983895
34807,射頻,1,605392,0.00016199,98.07000094
34808,展示中心,1,605393,0.00016199,98.07016293
34809,展示區,1,605394,0.00016199,98.07032493
34810,展示場,1,605395,0.00016199,98.07048692
34811,展示館,1,605396,0.00016199,98.07064892
34812,展信,1,605397,0.00016199,98.07081091
34813,展區,1,605398,0.00016199,98.07097290
34814,展場,1,605399,0.00016199,98.07113490
34815,展覽場,1,605400,0.00016199,98.07129689
34816,展覽館,1,605401,0.00016199,98.07145889
34817,屐木,1,605402,0.00016199,98.07162088
34818,峭立,1,605403,0.00016199,98.07178288
34819,峽灣,1,605404,0.00016199,98.07194487
34820,峻工,1,605405,0.00016199,98.07210686
34821,峻挺,1,605406,0.00016199,98.07226886
34822,峻然,1,605407,0.00016199,98.07243085
34823,峻壁,1,605408,0.00016199,98.07259285
34824,峻嶺,1,605409,0.00016199,98.07275484
34825,島上,1,605410,0.00016199,98.07291684
34826,島國,1,605411,0.00016199,98.07307883
34827,島野修,1,605412,0.00016199,98.07324082
34828,差一點,1,605413,0.00016199,98.07340282
34829,差別性,1,605414,0.00016199,98.07356481
34830,差動式,1,605415,0.00016199,98.07372681
34831,差強人意,1,605416,0.00016199,98.07388880
34832,差速箱,1,605417,0.00016199,98.07405079
34833,席古拉,1,605418,0.00016199,98.07421279
34834,席哈克,1,605419,0.00016199,98.07437478
34835,席哈特,1,605420,0.00016199,98.07453678
34836,席瑞登,1,605421,0.00016199,98.07469877
34837,席瑞登．卡維特,1,605422,0.00016199,98.07486077
34838,師大,1,605423,0.00016199,98.07502276
34839,師父級,1,605424,0.00016199,98.07518475
34840,師兄,1,605425,0.00016199,98.07534675
34841,師兄弟,1,605426,0.00016199,98.07550874
34842,師兄妹,1,605427,0.00016199,98.07567074
34843,師出有名,1,605428,0.00016199,98.07583273
34844,師母,1,605429,0.00016199,98.07599473
34845,師事,1,605430,0.00016199,98.07615672
34846,師法,1,605431,0.00016199,98.07631871
34847,師徒,1,605432,0.00016199,98.07648071
34848,師團,1,605433,0.00016199,98.07664270
34849,庫力克,1,605434,0.00016199,98.07680470
34850,庫光,1,605435,0.00016199,98.07696669
34851,庫存量,1,605436,0.00016199,98.07712868
34852,庭外和解,1,605437,0.00016199,98.07729068
34853,庭院,1,605438,0.00016199,98.07745267
34854,座上賓,1,605439,0.00016199,98.07761467
34855,座物,1,605440,0.00016199,98.07777666
34856,座標,1,605441,0.00016199,98.07793866
34857,弱者,1,605442,0.00016199,98.07810065
34858,徒步,1,605443,0.00016199,98.07826264
34859,徒步區,1,605444,0.00016199,98.07842464
34860,徒勞,1,605445,0.00016199,98.07858663
34861,徒然,1,605446,0.00016199,98.07874863
34862,徑口,1,605447,0.00016199,98.07891062
34863,徐文彬,1,605448,0.00016199,98.07907262
34864,徐世華,1,605449,0.00016199,98.07923461
34865,徐正棽,1,605450,0.00016199,98.07939660
34866,徐永玉,1,605451,0.00016199,98.07955860
34867,徐竹平,1,605452,0.00016199,98.07972059
34868,徐宏銘,1,605453,0.00016199,98.07988259
34869,徐宗和,1,605454,0.00016199,98.08004458
34870,徐冠春,1,605455,0.00016199,98.08020657
34871,徐美秀,1,605456,0.00016199,98.08036857
34872,徐國安,1,605457,0.00016199,98.08053056
34873,徐淑媛,1,605458,0.00016199,98.08069256
34874,徐博生,1,605459,0.00016199,98.08085455
34875,徐曾坤,1,605460,0.00016199,98.08101655
34876,徐華鳳,1,605461,0.00016199,98.08117854
34877,徐進良,1,605462,0.00016199,98.08134053
34878,徐榮德,1,605463,0.00016199,98.08150253
34879,徐緩,1,605464,0.00016199,98.08166452
34880,徐瀛洲,1,605465,0.00016199,98.08182652
34881,恣肆,1,605466,0.00016199,98.08198851
34882,恥笑,1,605467,0.00016199,98.08215051
34883,恐怖角,1,605468,0.00016199,98.08231250
34884,恐懼症,1,605469,0.00016199,98.08247449
34885,恭,1,605470,0.00016199,98.08263649
34886,恭祝,1,605471,0.00016199,98.08279848
34887,恩將仇報,1,605472,0.00016199,98.08296048
34888,恩蓋地,1,605473,0.00016199,98.08312247
34889,恩賜,1,605474,0.00016199,98.08328447
34890,恩寵,1,605475,0.00016199,98.08344646
34891,息值,1,605476,0.00016199,98.08360845
34892,悟,1,605477,0.00016199,98.08377045
34893,悍將,1,605478,0.00016199,98.08393244
34894,悍然,1,605479,0.00016199,98.08409444
34895,悔,1,605480,0.00016199,98.08425643
34896,悔不當初,1,605481,0.00016199,98.08441842
34897,悔意,1,605482,0.00016199,98.08458042
34898,悖離,1,605483,0.00016199,98.08474241
34899,扇形,1,605484,0.00016199,98.08490441
34900,扇風點火,1,605485,0.00016199,98.08506640
34901,扇舞,1,605486,0.00016199,98.08522840
34902,拳擊賽,1,605487,0.00016199,98.08539039
34903,拿了,1,605488,0.00016199,98.08555238
34904,拿住,1,605489,0.00016199,98.08571438
34905,拿到,1,605490,0.00016199,98.08587637
34906,拿定,1,605491,0.00016199,98.08603837
34907,拿喬,1,605492,0.00016199,98.08620036
34908,拿督,1,605493,0.00016199,98.08636236
34909,捎,1,605494,0.00016199,98.08652435
34910,捎回,1,605495,0.00016199,98.08668634
34911,振作,1,605496,0.00016199,98.08684834
34912,振振有詞,1,605497,0.00016199,98.08701033
34913,振源企業,1,605498,0.00016199,98.08717233
34914,振興經濟方案,1,605499,0.00016199,98.08733432
34915,捕快,1,605500,0.00016199,98.08749631
34916,捕食,1,605501,0.00016199,98.08765831
34917,捕獲,1,605502,0.00016199,98.08782030
34918,捆,1,605503,0.00016199,98.08798230
34919,捉起,1,605504,0.00016199,98.08814429
34920,挺而走險,1,605505,0.00016199,98.08830629
34921,挺拔,1,605506,0.00016199,98.08846828
34922,捐出,1,605507,0.00016199,98.08863027
34923,捐棄成見,1,605508,0.00016199,98.08879227
34924,捐贈者,1,605509,0.00016199,98.08895426
34925,捐驅,1,605510,0.00016199,98.08911626
34926,挽袖哲學,1,605511,0.00016199,98.08927825
34927,挪亞方舟,1,605512,0.00016199,98.08944025
34928,挪移,1,605513,0.00016199,98.08960224
34929,挫低,1,605514,0.00016199,98.08976423
34930,挫落,1,605515,0.00016199,98.08992623
34931,挨,1,605516,0.00016199,98.09008822
34932,挨打,1,605517,0.00016199,98.09025022
34933,挨揍,1,605518,0.00016199,98.09041221
34934,捍衛戰士,1,605519,0.00016199,98.09057420
34935,效命,1,605520,0.00016199,98.09073620
34936,敉平,1,605521,0.00016199,98.09089819
34937,料到,1,605522,0.00016199,98.09106019
34938,料理店,1,605523,0.00016199,98.09122218
34939,旁作,1,605524,0.00016199,98.09138418
34940,旁落,1,605525,0.00016199,98.09154617
34941,旁聽,1,605526,0.00016199,98.09170816
34942,旁觀,1,605527,0.00016199,98.09187016
34943,旅大級,1,605528,0.00016199,98.09203215
34944,旅北同鄉會,1,605529,0.00016199,98.09219415
34945,旅行車,1,605530,0.00016199,98.09235614
34946,旅行團,1,605531,0.00016199,98.09251814
34947,旅桃同鄉協進會,1,605532,0.00016199,98.09268013
34948,旅遊促進局,1,605533,0.00016199,98.09284212
34949,旅遊團,1,605534,0.00016199,98.09300412
34950,時代感,1,605535,0.00016199,98.09316611
34951,時令,1,605536,0.00016199,98.09332811
34952,時光飛逝,1,605537,0.00016199,98.09349010
34953,時好時壞,1,605538,0.00016199,98.09365209
34954,時而,1,605539,0.00016199,98.09381409
34955,時至,1,605540,0.00016199,98.09397608
34956,時局,1,605541,0.00016199,98.09413808
34957,時事社,1,605542,0.00016199,98.09430007
34958,時空特警,1,605543,0.00016199,98.09446207
34959,時報文化,1,605544,0.00016199,98.09462406
34960,時報文學獎,1,605545,0.00016199,98.09478605
34961,時報鷹隊,1,605546,0.00016199,98.09494805
34962,時評家,1,605547,0.00016199,98.09511004
34963,時間性,1,605548,0.00016199,98.09527204
34964,時間點,1,605549,0.00016199,98.09543403
34965,時裝圈,1,605550,0.00016199,98.09559603
34966,時裝業,1,605551,0.00016199,98.09575802
34967,時運,1,605552,0.00016199,98.09592001
34968,時鬈,1,605553,0.00016199,98.09608201
34969,晉,1,605554,0.00016199,98.09624400
34970,晉見,1,605555,0.00016199,98.09640600
34971,晉身,1,605556,0.00016199,98.09656799
34972,晏,1,605557,0.00016199,98.09672998
34973,晌,1,605558,0.00016199,98.09689198
34974,書中,1,605559,0.00016199,98.09705397
34975,書市,1,605560,0.00016199,98.09721597
34976,書生,1,605561,0.00016199,98.09737796
34977,書目,1,605562,0.00016199,98.09753996
34978,書函,1,605563,0.00016199,98.09770195
34979,書卷,1,605564,0.00016199,98.09786394
34980,書法展,1,605565,0.00016199,98.09802594
34981,書架,1,605566,0.00016199,98.09818793
34982,書面報告,1,605567,0.00016199,98.09834993
34983,書記長,1,605568,0.00016199,98.09851192
34984,書堆,1,605569,0.00016199,98.09867392
34985,書報,1,605570,0.00016199,98.09883591
34986,書報攤,1,605571,0.00016199,98.09899790
34987,書畫家,1,605572,0.00016199,98.09915990
34988,書評,1,605573,0.00016199,98.09932189
34989,書僮,1,605574,0.00016199,98.09948389
34990,書學邇言,1,605575,0.00016199,98.09964588
34991,書籤,1,605576,0.00016199,98.09980787
34992,朗帕爾,1,605577,0.00016199,98.09996987
34993,校刀手,1,605578,0.00016199,98.10013186
34994,校友會,1,605579,0.00016199,98.10029386
34995,校刊,1,605580,0.00016199,98.10045585
34996,校外,1,605581,0.00016199,98.10061785
34997,校外活動,1,605582,0.00016199,98.10077984
34998,校正,1,605583,0.00016199,98.10094183
34999,校址,1,605584,0.00016199,98.10110383
35000,校車,1,605585,0.00016199,98.10126582
35001,校長室,1,605586,0.00016199,98.10142782
35002,校風,1,605587,0.00016199,98.10158981
35003,校尉,1,605588,0.00016199,98.10175181
35004,校慶,1,605589,0.00016199,98.10191380
35005,核,1,605590,0.00016199,98.10207579
35006,核一,1,605591,0.00016199,98.10223779
35007,核二,1,605592,0.00016199,98.10239978
35008,核三廠,1,605593,0.00016199,98.10256178
35009,核子安全高峰會議,1,605594,0.00016199,98.10272377
35010,核子物理,1,605595,0.00016199,98.10288576
35011,核子廢料,1,605596,0.00016199,98.10304776
35012,核反應器,1,605597,0.00016199,98.10320975
35013,核四案,1,605598,0.00016199,98.10337175
35014,核四廢止興建案,1,605599,0.00016199,98.10353374
35015,核四廠,1,605600,0.00016199,98.10369574
35016,核生化管制,1,605601,0.00016199,98.10385773
35017,核示,1,605602,0.00016199,98.10401972
35018,核動力,1,605603,0.00016199,98.10418172
35019,核動力彈道飛彈潛艦,1,605604,0.00016199,98.10434371
35020,核電,1,605605,0.00016199,98.10450571
35021,案卷,1,605606,0.00016199,98.10466770
35022,案量,1,605607,0.00016199,98.10482970
35023,框定,1,605608,0.00016199,98.10499169
35024,框架,1,605609,0.00016199,98.10515368
35025,框框,1,605610,0.00016199,98.10531568
35026,根目錄,1,605611,0.00016199,98.10547767
35027,根拉桿,1,605612,0.00016199,98.10563967
35028,根治,1,605613,0.00016199,98.10580166
35029,根留,1,605614,0.00016199,98.10596365
35030,根留台灣,1,605615,0.00016199,98.10612565
35031,根菜,1,605616,0.00016199,98.10628764
35032,根據地,1,605617,0.00016199,98.10644964
35033,桂,1,605618,0.00016199,98.10661163
35034,桂宏,1,605619,0.00016199,98.10677363
35035,桂冠,1,605620,0.00016199,98.10693562
35036,桂格養生麥粉,1,605621,0.00016199,98.10709761
35037,桔子,1,605622,0.00016199,98.10725961
35038,梳妝台,1,605623,0.00016199,98.10742160
35039,梳粧,1,605624,0.00016199,98.10758360
35040,梳粧台,1,605625,0.00016199,98.10774559
35041,桌上型,1,605626,0.00016199,98.10790759
35042,桌上型麥克風,1,605627,0.00016199,98.10806958
35043,桑,1,605628,0.00016199,98.10823157
35044,桑妮亞,1,605629,0.00016199,98.10839357
35045,桑妮亞韋德亞瑟頓,1,605630,0.00016199,98.10855556
35046,桑根,1,605631,0.00016199,98.10871756
35047,桑格爾,1,605632,0.00016199,98.10887955
35048,桑德斯,1,605633,0.00016199,98.10904155
35049,桑樹,1,605634,0.00016199,98.10920354
35050,桑騰,1,605635,0.00016199,98.10936553
35051,桑椹,1,605636,0.00016199,98.10952753
35052,栽跟斗,1,605637,0.00016199,98.10968952
35053,柴可夫斯基音樂學,1,605638,0.00016199,98.10985152
35054,柴松林,1,605639,0.00016199,98.11001351
35055,柴油主機,1,605640,0.00016199,98.11017550
35056,柴油渦輪增壓引擎,1,605641,0.00016199,98.11033750
35057,柴祖賢,1,605642,0.00016199,98.11049949
35058,桐葉,1,605643,0.00016199,98.11066149
35059,格外地,1,605644,0.00016199,98.11082348
35060,格列佛遊記,1,605645,0.00016199,98.11098548
35061,格老子的孫子,1,605646,0.00016199,98.11114747
35062,格言,1,605647,0.00016199,98.11130946
35063,格哈尼克,1,605648,0.00016199,98.11147146
35064,格倫．丹尼斯,1,605649,0.00016199,98.11163345
35065,格格不入,1,605650,0.00016199,98.11179545
35066,格調,1,605651,0.00016199,98.11195744
35067,格蘭岱,1,605652,0.00016199,98.11211944
35068,桃山廳,1,605653,0.00016199,98.11228143
35069,桃色,1,605654,0.00016199,98.11244342
35070,桃花,1,605655,0.00016199,98.11260542
35071,桃花源,1,605656,0.00016199,98.11276741
35072,桃花過渡,1,605657,0.00016199,98.11292941
35073,桃粟,1,605658,0.00016199,98.11309140
35074,桃園縣長,1,605659,0.00016199,98.11325339
35075,株式會社,1,605660,0.00016199,98.11341539
35076,栓,1,605661,0.00016199,98.11357738
35077,栓塞,1,605662,0.00016199,98.11373938
35078,殊途同歸,1,605663,0.00016199,98.11390137
35079,殉身,1,605664,0.00016199,98.11406337
35080,殷允中,1,605665,0.00016199,98.11422536
35081,殷正洋,1,605666,0.00016199,98.11438735
35082,殷延泉,1,605667,0.00016199,98.11454935
35083,殷雙喜,1,605668,0.00016199,98.11471134
35084,氣人,1,605669,0.00016199,98.11487334
35085,氣功社,1,605670,0.00016199,98.11503533
35086,氣份,1,605671,0.00016199,98.11519733
35087,氣宇軒昂,1,605672,0.00016199,98.11535932
35088,氣血,1,605673,0.00016199,98.11552131
35089,氣沖沖,1,605674,0.00016199,98.11568331
35090,氣定神閒,1,605675,0.00016199,98.11584530
35091,氣泡浴,1,605676,0.00016199,98.11600730
35092,氣室,1,605677,0.00016199,98.11616929
35093,氣急敗壞,1,605678,0.00016199,98.11633128
35094,氣缸,1,605679,0.00016199,98.11649328
35095,氣脈,1,605680,0.00016199,98.11665527
35096,氣動力,1,605681,0.00016199,98.11681727
35097,氣盛,1,605682,0.00016199,98.11697926
35098,氣絕,1,605683,0.00016199,98.11714126
35099,氣象偵察研究組,1,605684,0.00016199,98.11730325
35100,氣象偵察組,1,605685,0.00016199,98.11746524
35101,氣勢如虹,1,605686,0.00016199,98.11762724
35102,氣極敗壞,1,605687,0.00016199,98.11778923
35103,氣管,1,605688,0.00016199,98.11795123
35104,氣質高雅,1,605689,0.00016199,98.11811322
35105,氣輪,1,605690,0.00016199,98.11827522
35106,氣魄,1,605691,0.00016199,98.11843721
35107,氣壓,1,605692,0.00016199,98.11859920
35108,氧分子,1,605693,0.00016199,98.11876120
35109,氧化現象,1,605694,0.00016199,98.11892319
35110,氨酸類,1,605695,0.00016199,98.11908519
35111,泰,1,605696,0.00016199,98.11924718
35112,泰山,1,605697,0.00016199,98.11940917
35113,泰山福客多,1,605698,0.00016199,98.11957117
35114,泰半,1,605699,0.00016199,98.11973316
35115,泰央行,1,605700,0.00016199,98.11989516
35116,泰風,1,605701,0.00016199,98.12005715
35117,泰國世界日報,1,605702,0.00016199,98.12021915
35118,泰然,1,605703,0.00016199,98.12038114
35119,泰雅族織布,1,605704,0.00016199,98.12054313
35120,泰雅語,1,605705,0.00016199,98.12070513
35121,泰瑞莎．貝崗莎,1,605706,0.00016199,98.12086712
35122,泰瑞戰神,1,605707,0.00016199,98.12102912
35123,泰雷曼,1,605708,0.00016199,98.12119111
35124,泰爾地區,1,605709,0.00016199,98.12135311
35125,泰爾惡作劇,1,605710,0.00016199,98.12151510
35126,泰德,1,605711,0.00016199,98.12167709
35127,泰德．特納,1,605712,0.00016199,98.12183909
35128,泰豐,1,605713,0.00016199,98.12200108
35129,浪人,1,605714,0.00016199,98.12216308
35130,浪花,1,605715,0.00016199,98.12232507
35131,浪跡天涯,1,605716,0.00016199,98.12248706
35132,浪漫主義,1,605717,0.00016199,98.12264906
35133,浪漫史,1,605718,0.00016199,98.12281105
35134,浪漫樂派,1,605719,0.00016199,98.12297305
35135,浪蕩,1,605720,0.00016199,98.12313504
35136,消化液,1,605721,0.00016199,98.12329704
35137,消失無蹤,1,605722,0.00016199,98.12345903
35138,消沈,1,605723,0.00016199,98.12362102
35139,消防人員,1,605724,0.00016199,98.12378302
35140,消防車,1,605725,0.00016199,98.12394501
35141,消波,1,605726,0.00016199,98.12410701
35142,消保法,1,605727,0.00016199,98.12426900
35143,消音,1,605728,0.00016199,98.12443100
35144,消耗量,1,605729,0.00016199,98.12459299
35145,消掉,1,605730,0.00016199,98.12475498
35146,消散,1,605731,0.00016199,98.12491698
35147,消減,1,605732,0.00016199,98.12507897
35148,消費成長率,1,605733,0.00016199,98.12524097
35149,消費性商品,1,605734,0.00016199,98.12540296
35150,消費者物價指數,1,605735,0.00016199,98.12556495
35151,消費者信心指數,1,605736,0.00016199,98.12572695
35152,消費者保護法,1,605737,0.00016199,98.12588894
35153,消費金融,1,605738,0.00016199,98.12605094
35154,消費品,1,605739,0.00016199,98.12621293
35155,消費客,1,605740,0.00016199,98.12637493
35156,消費電子裝置,1,605741,0.00016199,98.12653692
35157,消愁,1,605742,0.00016199,98.12669891
35158,消遣,1,605743,0.00016199,98.12686091
35159,消瘦,1,605744,0.00016199,98.12702290
35160,消磨,1,605745,0.00016199,98.12718490
35161,消聲匿跡,1,605746,0.00016199,98.12734689
35162,浦添市民球場,1,605747,0.00016199,98.12750889
35163,浦賽爾,1,605748,0.00016199,98.12767088
35164,浸水,1,605749,0.00016199,98.12783287
35165,浸信會,1,605750,0.00016199,98.12799487
35166,浸漬,1,605751,0.00016199,98.12815686
35167,浸濕,1,605752,0.00016199,98.12831886
35168,海三軍區,1,605753,0.00016199,98.12848085
35169,海三軍區司令,1,605754,0.00016199,98.12864284
35170,海上自衛隊,1,605755,0.00016199,98.12880484
35171,海山,1,605756,0.00016199,98.12896683
35172,海山合,1,605757,0.00016199,98.12912883
35173,海山消防分隊,1,605758,0.00016199,98.12929082
35174,海天,1,605759,0.00016199,98.12945282
35175,海牙市,1,605760,0.00016199,98.12961481
35176,海外市場,1,605761,0.00016199,98.12977680
35177,海外共同基金,1,605762,0.00016199,98.12993880
35178,海外投資,1,605763,0.00016199,98.13010079
35179,海外投資人,1,605764,0.00016199,98.13026279
35180,海外旅遊,1,605765,0.00016199,98.13042478
35181,海外經濟合作發展委員會,1,605766,0.00016199,98.13058678
35182,海外廠,1,605767,0.00016199,98.13074877
35183,海尼希．謝里曼,1,605768,0.00016199,98.13091076
35184,海尼根,1,605769,0.00016199,98.13107276
35185,海吉亞．蘇菲亞,1,605770,0.00016199,98.13123475
35186,海合會,1,605771,0.00016199,98.13139675
35187,海地獄,1,605772,0.00016199,98.13155874
35188,海巡部,1,605773,0.00016199,98.13172073
35189,海防部隊,1,605774,0.00016199,98.13188273
35190,海協會,1,605775,0.00016199,98.13204472
35191,海姆．季諾,1,605776,0.00016199,98.13220672
35192,海底世界,1,605777,0.00016199,98.13236871
35193,海底電纜,1,605778,0.00016199,98.13253071
35194,海泥,1,605779,0.00016199,98.13269270
35195,海波消除劑,1,605780,0.00016199,98.13285469
35196,海法,1,605781,0.00016199,98.13301669
35197,海法港,1,605782,0.00016199,98.13317868
35198,海沿仔,1,605783,0.00016199,98.13334068
35199,海空,1,605784,0.00016199,98.13350267
35200,海空域,1,605785,0.00016199,98.13366467
35201,海空聯合演習,1,605786,0.00016199,98.13382666
35202,海空聯訓,1,605787,0.00016199,98.13398865
35203,海洋探勘艦,1,605788,0.00016199,98.13415065
35204,海洋學者,1,605789,0.00016199,98.13431264
35205,海派,1,605790,0.00016199,98.13447464
35206,海洛因,1,605791,0.00016199,98.13463663
35207,海苔,1,605792,0.00016199,98.13479862
35208,海軍上將,1,605793,0.00016199,98.13496062
35209,海軍少將,1,605794,0.00016199,98.13512261
35210,海軍總部,1,605795,0.00016199,98.13528461
35211,海飛茲,1,605796,0.00016199,98.13544660
35212,海員,1,605797,0.00016199,98.13560860
35213,海峽中線,1,605798,0.00016199,98.13577059
35214,海峽對岸,1,605799,0.00016199,98.13593258
35215,海狸,1,605800,0.00016199,98.13609458
35216,海神,1,605801,0.00016199,98.13625657
35217,海神號,1,605802,0.00016199,98.13641857
35218,海航,1,605803,0.00016199,98.13658056
35219,海茲,1,605804,0.00016199,98.13674256
35220,海帶芽,1,605805,0.00016199,98.13690455
35221,海產,1,605806,0.00016199,98.13706654
35222,海豚肉,1,605807,0.00016199,98.13722854
35223,海陸,1,605808,0.00016199,98.13739053
35224,海陸兩會,1,605809,0.00016199,98.13755253
35225,海鳥,1,605810,0.00016199,98.13771452
35226,海棉,1,605811,0.00016199,98.13787652
35227,海棉體,1,605812,0.00016199,98.13803851
35228,海盜船,1,605813,0.00016199,98.13820050
35229,海量,1,605814,0.00016199,98.13836250
35230,海滄計畫,1,605815,0.00016199,98.13852449
35231,海獅,1,605816,0.00016199,98.13868649
35232,海蒂,1,605817,0.00016199,98.13884848
35233,海葵,1,605818,0.00016199,98.13901047
35234,海葡萄,1,605819,0.00016199,98.13917247
35235,海路,1,605820,0.00016199,98.13933446
35236,海綿,1,605821,0.00016199,98.13949646
35237,海蝕平台,1,605822,0.00016199,98.13965845
35238,海嘯,1,605823,0.00016199,98.13982045
35239,海潮,1,605824,0.00016199,98.13998244
35240,海龍級,1,605825,0.00016199,98.14014443
35241,海濤,1,605826,0.00016199,98.14030643
35242,海闊,1,605827,0.00016199,98.14046842
35243,海闊天空,1,605828,0.00016199,98.14063042
35244,海鮮湯,1,605829,0.00016199,98.14079241
35245,海鮮醬,1,605830,0.00016199,98.14095441
35246,海檬果,1,605831,0.00016199,98.14111640
35247,海藍寶石,1,605832,0.00016199,98.14127839
35248,海難,1,605833,0.00016199,98.14144039
35249,海藻,1,605834,0.00016199,98.14160238
35250,海權,1,605835,0.00016199,98.14176438
35251,海灘裝,1,605836,0.00016199,98.14192637
35252,海體,1,605837,0.00016199,98.14208836
35253,海鱷魚,1,605838,0.00016199,98.14225036
35254,海欉樹飛彈,1,605839,0.00016199,98.14241235
35255,涉水,1,605840,0.00016199,98.14257435
35256,涉外,1,605841,0.00016199,98.14273634
35257,涉案人,1,605842,0.00016199,98.14289834
35258,涉案者,1,605843,0.00016199,98.14306033
35259,涉貪,1,605844,0.00016199,98.14322232
35260,浮山,1,605845,0.00016199,98.14338432
35261,浮世繪,1,605846,0.00016199,98.14354631
35262,浮出,1,605847,0.00016199,98.14370831
35263,浮面,1,605848,0.00016199,98.14387030
35264,浮浴,1,605849,0.00016199,98.14403230
35265,浮起,1,605850,0.00016199,98.14419429
35266,浮華,1,605851,0.00016199,98.14435628
35267,浮華世界雜誌,1,605852,0.00016199,98.14451828
35268,浮雲,1,605853,0.00016199,98.14468027
35269,浮腫,1,605854,0.00016199,98.14484227
35270,浮標,1,605855,0.00016199,98.14500426
35271,浮躁,1,605856,0.00016199,98.14516625
35272,浴巾,1,605857,0.00016199,98.14532825
35273,浴化,1,605858,0.00016199,98.14549024
35274,浴火重生,1,605859,0.00016199,98.14565224
35275,浴火鳳凰,1,605860,0.00016199,98.14581423
35276,浴血戰,1,605861,0.00016199,98.14597623
35277,浩南,1,605862,0.00016199,98.14613822
35278,浩繁,1,605863,0.00016199,98.14630021
35279,浩繁食指,1,605864,0.00016199,98.14646221
35280,烘,1,605865,0.00016199,98.14662420
35281,烘乾,1,605866,0.00016199,98.14678620
35282,烘熱,1,605867,0.00016199,98.14694819
35283,烤乳豬,1,605868,0.00016199,98.14711019
35284,烤煉,1,605869,0.00016199,98.14727218
35285,烤漆,1,605870,0.00016199,98.14743417
35286,烤餅機,1,605871,0.00016199,98.14759617
35287,烙下,1,605872,0.00016199,98.14775816
35288,烙印,1,605873,0.00016199,98.14792016
35289,烙痕,1,605874,0.00016199,98.14808215
35290,烈日,1,605875,0.00016199,98.14824414
35291,烈火,1,605876,0.00016199,98.14840614
35292,烈酒,1,605877,0.00016199,98.14856813
35293,烈嶼師,1,605878,0.00016199,98.14873013
35294,烏,1,605879,0.00016199,98.14889212
35295,烏干達,1,605880,0.00016199,98.14905412
35296,烏日,1,605881,0.00016199,98.14921611
35297,烏丘,1,605882,0.00016199,98.14937810
35298,烏必索,1,605883,0.00016199,98.14954010
35299,烏有,1,605884,0.00016199,98.14970209
35300,烏利希．亞伯博士,1,605885,0.00016199,98.14986409
35301,烏來,1,605886,0.00016199,98.15002608
35302,烏茲別克,1,605887,0.00016199,98.15018808
35303,烏國,1,605888,0.00016199,98.15035007
35304,烏雲,1,605889,0.00016199,98.15051206
35305,烏雲密布,1,605890,0.00016199,98.15067406
35306,烏瑪舒曼,1,605891,0.00016199,98.15083605
35307,烏魯力,1,605892,0.00016199,98.15099805
35308,烏魯索夫,1,605893,0.00016199,98.15116004
35309,烏頭翁,1,605894,0.00016199,98.15132203
35310,烏龍密探擺黑幫,1,605895,0.00016199,98.15148403
35311,特立,1,605896,0.00016199,98.15164602
35312,特任官,1,605897,0.00016199,98.15180802
35313,特吉拉酒,1,605898,0.00016199,98.15197001
35314,特別助理,1,605899,0.00016199,98.15213201
35315,特別股,1,605900,0.00016199,98.15229400
35316,特別獎,1,605901,0.00016199,98.15245599
35317,特快火車,1,605902,0.00016199,98.15261799
35318,特使,1,605903,0.00016199,98.15277998
35319,特定碼,1,605904,0.00016199,98.15294198
35320,特派,1,605905,0.00016199,98.15310397
35321,特洛伊人,1,605906,0.00016199,98.15326597
35322,特洛伊城,1,605907,0.00016199,98.15342796
35323,特洛普學校,1,605908,0.00016199,98.15358995
35324,特科,1,605909,0.00016199,98.15375195
35325,特效藥,1,605910,0.00016199,98.15391394
35326,特案,1,605911,0.00016199,98.15407594
35327,特殊性,1,605912,0.00016199,98.15423793
35328,特殊倉儲,1,605913,0.00016199,98.15439992
35329,特殊感,1,605914,0.00016199,98.15456192
35330,特訓,1,605915,0.00016199,98.15472391
35331,特教,1,605916,0.00016199,98.15488591
35332,特許,1,605917,0.00016199,98.15504790
35333,特赦,1,605918,0.00016199,98.15520990
35334,特惠價,1,605919,0.00016199,98.15537189
35335,特勤人員,1,605920,0.00016199,98.15553388
35336,特種空勤團,1,605921,0.00016199,98.15569588
35337,特種營業場所,1,605922,0.00016199,98.15585787
35338,特遣,1,605923,0.00016199,98.15601987
35339,特價品,1,605924,0.00016199,98.15618186
35340,特獎,1,605925,0.00016199,98.15634386
35341,特賣場,1,605926,0.00016199,98.15650585
35342,特警,1,605927,0.00016199,98.15666784
35343,狼犬酷威,1,605928,0.00016199,98.15682984
35344,狼王的女兒,1,605929,0.00016199,98.15699183
35345,狼吞虎嚥,1,605930,0.00016199,98.15715383
35346,狼狽,1,605931,0.00016199,98.15731582
35347,狼籍,1,605932,0.00016199,98.15747781
35348,狹,1,605933,0.00016199,98.15763981
35349,狹路,1,605934,0.00016199,98.15780180
35350,玆,1,605935,0.00016199,98.15796380
35351,班尼頓,1,605936,0.00016199,98.15812579
35352,班用機槍,1,605937,0.00016199,98.15828779
35353,班克斯,1,605938,0.00016199,98.15844978
35354,班車,1,605939,0.00016199,98.15861177
35355,班派斯,1,605940,0.00016199,98.15877377
35356,班恩豪華飯店,1,605941,0.00016199,98.15893576
35357,班馬科,1,605942,0.00016199,98.15909776
35358,班第奧格拉峭壁,1,605943,0.00016199,98.15925975
35359,班傑明．魏斯特,1,605944,0.00016199,98.15942175
35360,班聯會,1,605945,0.00016199,98.15958374
35361,琉園,1,605946,0.00016199,98.15974573
35362,珠子,1,605947,0.00016199,98.15990773
35363,珠光,1,605948,0.00016199,98.16006972
35364,珠江電影製片公司,1,605949,0.00016199,98.16023172
35365,珠海,1,605950,0.00016199,98.16039371
35366,珠藝,1,605951,0.00016199,98.16055570
35367,畜,1,605952,0.00016199,98.16071770
35368,畜生,1,605953,0.00016199,98.16087969
35369,畜牧場,1,605954,0.00016199,98.16104169
35370,畜類,1,605955,0.00016199,98.16120368
35371,畚斗,1,605956,0.00016199,98.16136568
35372,留不留,1,605957,0.00016199,98.16152767
35373,留存,1,605958,0.00016199,98.16168966
35374,留守,1,605959,0.00016199,98.16185166
35375,留言版,1,605960,0.00016199,98.16201365
35376,留待,1,605961,0.00016199,98.16217565
35377,留美,1,605962,0.00016199,98.16233764
35378,留情,1,605963,0.00016199,98.16249964
35379,留鳥,1,605964,0.00016199,98.16266163
35380,留著,1,605965,0.00016199,98.16282362
35381,留聲機,1,605966,0.00016199,98.16298562
35382,疾言厲色,1,605967,0.00016199,98.16314761
35383,疾呼,1,605968,0.00016199,98.16330961
35384,疾疫,1,605969,0.00016199,98.16347160
35385,疾速,1,605970,0.00016199,98.16363359
35386,疾馳,1,605971,0.00016199,98.16379559
35387,疾駛,1,605972,0.00016199,98.16395758
35388,病入膏肓,1,605973,0.00016199,98.16411958
35389,病牛,1,605974,0.00016199,98.16428157
35390,病灶,1,605975,0.00016199,98.16444357
35391,病況,1,605976,0.00016199,98.16460556
35392,病者,1,605977,0.00016199,98.16476755
35393,病故,1,605978,0.00016199,98.16492955
35394,病理學,1,605979,0.00016199,98.16509154
35395,病理學家,1,605980,0.00016199,98.16525354
35396,病程,1,605981,0.00016199,98.16541553
35397,病源,1,605982,0.00016199,98.16557753
35398,病號,1,605983,0.00016199,98.16573952
35399,病態性,1,605984,0.00016199,98.16590151
35400,病歷,1,605985,0.00016199,98.16606351
35401,疲於奔命,1,605986,0.00016199,98.16622550
35402,疲倦感,1,605987,0.00016199,98.16638750
35403,疲弱,1,605988,0.00016199,98.16654949
35404,疲累,1,605989,0.00016199,98.16671149
35405,疲累感,1,605990,0.00016199,98.16687348
35406,疲態,1,605991,0.00016199,98.16703547
35407,疲憊不堪,1,605992,0.00016199,98.16719747
35408,疼惜七股鄉土協進會,1,605993,0.00016199,98.16735946
35409,疹,1,605994,0.00016199,98.16752146
35410,益形困難,1,605995,0.00016199,98.16768345
35411,益處,1,605996,0.00016199,98.16784544
35412,益發,1,605997,0.00016199,98.16800744
35413,益損,1,605998,0.00016199,98.16816943
35414,眩目,1,605999,0.00016199,98.16833143
35415,眩暈,1,606000,0.00016199,98.16849342
35416,眩麗,1,606001,0.00016199,98.16865542
35417,真田重藏,1,606002,0.00016199,98.16881741
35418,真皮坐椅,1,606003,0.00016199,98.16897940
35419,真皮層,1,606004,0.00016199,98.16914140
35420,真有,1,606005,0.00016199,98.16930339
35421,真宛然影藝會,1,606006,0.00016199,98.16946539
35422,真知灼見,1,606007,0.00016199,98.16962738
35423,真相大白,1,606008,0.00016199,98.16978938
35424,真相委員會,1,606009,0.00016199,98.16995137
35425,真相與和解委員會,1,606010,0.00016199,98.17011336
35426,真面目,1,606011,0.00016199,98.17027536
35427,真個是,1,606012,0.00016199,98.17043735
35428,真真實實,1,606013,0.00016199,98.17059935
35429,真理報,1,606014,0.00016199,98.17076134
35430,真實與假面,1,606015,0.00016199,98.17092333
35431,真實與假面—影劇臉譜,1,606016,0.00016199,98.17108533
35432,真槍實彈,1,606017,0.00016199,98.17124732
35433,真摯,1,606018,0.00016199,98.17140932
35434,真憑實據,1,606019,0.00016199,98.17157131
35435,真龍天子,1,606020,0.00016199,98.17173331
35436,眨,1,606021,0.00016199,98.17189530
35437,眨了眨,1,606022,0.00016199,98.17205729
35438,矩,1,606023,0.00016199,98.17221929
35439,砸毀,1,606024,0.00016199,98.17238128
35440,破天荒,1,606025,0.00016199,98.17254328
35441,破片,1,606026,0.00016199,98.17270527
35442,破冰艦,1,606027,0.00016199,98.17286727
35443,破例,1,606028,0.00016199,98.17302926
35444,破門而入,1,606029,0.00016199,98.17319125
35445,破屋,1,606030,0.00016199,98.17335325
35446,破洞,1,606031,0.00016199,98.17351524
35447,破音字,1,606032,0.00016199,98.17367724
35448,破案率,1,606033,0.00016199,98.17383923
35449,破浪而出,1,606034,0.00016199,98.17400122
35450,破破爛爛,1,606035,0.00016199,98.17416322
35451,破敗,1,606036,0.00016199,98.17432521
35452,破產人,1,606037,0.00016199,98.17448721
35453,破損,1,606038,0.00016199,98.17464920
35454,破滅,1,606039,0.00016199,98.17481120
35455,破綻,1,606040,0.00016199,98.17497319
35456,破曉,1,606041,0.00016199,98.17513518
35457,破壞性,1,606042,0.00016199,98.17529718
35458,破壞者,1,606043,0.00016199,98.17545917
35459,破爛,1,606044,0.00016199,98.17562117
35460,砲口,1,606045,0.00016199,98.17578316
35461,砲手,1,606046,0.00016199,98.17594516
35462,砲打,1,606047,0.00016199,98.17610715
35463,砲指部,1,606048,0.00016199,98.17626914
35464,砲塔,1,606049,0.00016199,98.17643114
35465,砲艇,1,606050,0.00016199,98.17659313
35466,砲擊,1,606051,0.00016199,98.17675513
35467,祕笈,1,606052,0.00016199,98.17691712
35468,祖宗,1,606053,0.00016199,98.17707911
35469,祖孫,1,606054,0.00016199,98.17724111
35470,祖廟,1,606055,0.00016199,98.17740310
35471,祖德,1,606056,0.00016199,98.17756510
35472,祖籍,1,606057,0.00016199,98.17772709
35473,神女,1,606058,0.00016199,98.17788909
35474,神戶,1,606059,0.00016199,98.17805108
35475,神犬,1,606060,0.00016199,98.17821307
35476,神乎其技,1,606061,0.00016199,98.17837507
35477,神仙企鵝,1,606062,0.00016199,98.17853706
35478,神出鬼沒,1,606063,0.00016199,98.17869906
35479,神田錦田町,1,606064,0.00016199,98.17886105
35480,神州,1,606065,0.00016199,98.17902305
35481,神色自若,1,606066,0.00016199,98.17918504
35482,神位,1,606067,0.00016199,98.17934703
35483,神技,1,606068,0.00016199,98.17950903
35484,神釆,1,606069,0.00016199,98.17967102
35485,神岡,1,606070,0.00016199,98.17983302
35486,神往,1,606071,0.00016199,98.17999501
35487,神社,1,606072,0.00016199,98.18015700
35488,神采飛揚,1,606073,0.00016199,98.18031900
35489,神勇,1,606074,0.00016199,98.18048099
35490,神效,1,606075,0.00016199,98.18064299
35491,神氣,1,606076,0.00016199,98.18080498
35492,神祕感,1,606077,0.00016199,98.18096698
35493,神祗,1,606078,0.00016199,98.18112897
35494,神秘感,1,606079,0.00016199,98.18129096
35495,神馬,1,606080,0.00016199,98.18145296
35496,神偷燕子李三,1,606081,0.00016199,98.18161495
35497,神眼,1,606082,0.00016199,98.18177695
35498,神統管,1,606083,0.00016199,98.18193894
35499,神速,1,606084,0.00016199,98.18210094
35500,神意,1,606085,0.00016199,98.18226293
35501,神殿,1,606086,0.00016199,98.18242492
35502,神經內科,1,606087,0.00016199,98.18258692
35503,神經外科,1,606088,0.00016199,98.18274891
35504,神經根,1,606089,0.00016199,98.18291091
35505,神經衰弱,1,606090,0.00016199,98.18307290
35506,神經管,1,606091,0.00016199,98.18323489
35507,神經學,1,606092,0.00016199,98.18339689
35508,神經錯亂,1,606093,0.00016199,98.18355888
35509,神經叢,1,606094,0.00016199,98.18372088
35510,神聖性,1,606095,0.00016199,98.18388287
35511,神道主義,1,606096,0.00016199,98.18404487
35512,神馳,1,606097,0.00016199,98.18420686
35513,神像,1,606098,0.00016199,98.18436885
35514,神態,1,606099,0.00016199,98.18453085
35515,神魂顛倒,1,606100,0.00016199,98.18469284
35516,神劇,1,606101,0.00016199,98.18485484
35517,神器,1,606102,0.00016199,98.18501683
35518,神壇輔導要點草案,1,606103,0.00016199,98.18517883
35519,神轎,1,606104,0.00016199,98.18534082
35520,神靈,1,606105,0.00016199,98.18550281
35521,祝基瀅,1,606106,0.00016199,98.18566481
35522,祝禱,1,606107,0.00016199,98.18582680
35523,祗要,1,606108,0.00016199,98.18598880
35524,秤重,1,606109,0.00016199,98.18615079
35525,秤鉈,1,606110,0.00016199,98.18631278
35526,租來,1,606111,0.00016199,98.18647478
35527,租屋,1,606112,0.00016199,98.18663677
35528,租售,1,606113,0.00016199,98.18679877
35529,租售報導,1,606114,0.00016199,98.18696076
35530,租稅公平原則,1,606115,0.00016199,98.18712276
35531,租貸,1,606116,0.00016199,98.18728475
35532,租賃權,1,606117,0.00016199,98.18744674
35533,秦始皇,1,606118,0.00016199,98.18760874
35534,秦怡,1,606119,0.00016199,98.18777073
35535,秦偉,1,606120,0.00016199,98.18793273
35536,秦漢,1,606121,0.00016199,98.18809472
35537,秘招,1,606122,0.00016199,98.18825672
35538,秘書室,1,606123,0.00016199,98.18841871
35539,秘道,1,606124,0.00016199,98.18858070
35540,秘聞,1,606125,0.00016199,98.18874270
35541,秘雕,1,606126,0.00016199,98.18890469
35542,窄化,1,606127,0.00016199,98.18906669
35543,站出來,1,606128,0.00016199,98.18922868
35544,站位,1,606129,0.00016199,98.18939067
35545,站長,1,606130,0.00016199,98.18955267
35546,笑吟吟,1,606131,0.00016199,98.18971466
35547,笑呵呵,1,606132,0.00016199,98.18987666
35548,笑容可掬,1,606133,0.00016199,98.19003865
35549,笑起來,1,606134,0.00016199,98.19020065
35550,笑嘻嘻,1,606135,0.00016199,98.19036264
35551,笑臉,1,606136,0.00016199,98.19052463
35552,笑點,1,606137,0.00016199,98.19068663
35553,笑翻了,1,606138,0.00016199,98.19084862
35554,笑彎了一根扁擔,1,606139,0.00016199,98.19101062
35555,笑靨,1,606140,0.00016199,98.19117261
35556,粉公害,1,606141,0.00016199,98.19133461
35557,粉由,1,606142,0.00016199,98.19149660
35558,粉妝玉琢,1,606143,0.00016199,98.19165859
35559,粉牡丹,1,606144,0.00016199,98.19182059
35560,粉底乳,1,606145,0.00016199,98.19198258
35561,粉底霜,1,606146,0.00016199,98.19214458
35562,粉底粧,1,606147,0.00016199,98.19230657
35563,粉狀,1,606148,0.00016199,98.19246856
35564,粉粉,1,606149,0.00016199,98.19263056
35565,粉彩,1,606150,0.00016199,98.19279255
35566,粉彩色系,1,606151,0.00016199,98.19295455
35567,粉紫色,1,606152,0.00016199,98.19311654
35568,粉絲,1,606153,0.00016199,98.19327854
35569,粉圓,1,606154,0.00016199,98.19344053
35570,粉飾太平,1,606155,0.00016199,98.19360252
35571,粉餅,1,606156,0.00016199,98.19376452
35572,粉墨登場,1,606157,0.00016199,98.19392651
35573,紡,1,606158,0.00016199,98.19408851
35574,紡拓大樓,1,606159,0.00016199,98.19425050
35575,紡品,1,606160,0.00016199,98.19441250
35576,紡織品,1,606161,0.00016199,98.19457449
35577,紡纖類股,1,606162,0.00016199,98.19473648
35578,紗幕,1,606163,0.00016199,98.19489848
35579,紗網,1,606164,0.00016199,98.19506047
35580,紗龍,1,606165,0.00016199,98.19522247
35581,紋眉,1,606166,0.00016199,98.19538446
35582,紋唇,1,606167,0.00016199,98.19554646
35583,紋眼線,1,606168,0.00016199,98.19570845
35584,素形材,1,606169,0.00016199,98.19587044
35585,素面,1,606170,0.00016199,98.19603244
35586,素淨,1,606171,0.00016199,98.19619443
35587,素腰花,1,606172,0.00016199,98.19635643
35588,索引卡,1,606173,0.00016199,98.19651842
35589,索甲仁波切,1,606174,0.00016199,98.19668041
35590,索米爾,1,606175,0.00016199,98.19684241
35591,索米爾峽灣,1,606176,0.00016199,98.19700440
35592,索票,1,606177,0.00016199,98.19716640
35593,索然,1,606178,0.00016199,98.19732839
35594,索德貝格,1,606179,0.00016199,98.19749039
35595,索賠,1,606180,0.00016199,98.19765238
35596,索隱,1,606181,0.00016199,98.19781437
35597,索羅斯,1,606182,0.00016199,98.19797637
35598,純水,1,606183,0.00016199,98.19813836
35599,純白,1,606184,0.00016199,98.19830036
35600,純品康納果汁,1,606185,0.00016199,98.19846235
35601,純純,1,606186,0.00016199,98.19862435
35602,純理性,1,606187,0.00016199,98.19878634
35603,純然,1,606188,0.00016199,98.19894833
35604,純種,1,606189,0.00016199,98.19911033
35605,純銀,1,606190,0.00016199,98.19927232
35606,純銀筆,1,606191,0.00016199,98.19943432
35607,純潔,1,606192,0.00016199,98.19959631
35608,純屬,1,606193,0.00016199,98.19975830
35609,紐西蘭式,1,606194,0.00016199,98.19992030
35610,紐哈芬學校,1,606195,0.00016199,98.20008229
35611,紐約市,1,606196,0.00016199,98.20024429
35612,紐約市東村,1,606197,0.00016199,98.20040628
35613,紐約州,1,606198,0.00016199,98.20056828
35614,紐約夜未眠,1,606199,0.00016199,98.20073027
35615,紐約客,1,606200,0.00016199,98.20089226
35616,紐約商品交易所,1,606201,0.00016199,98.20105426
35617,紐約博物館,1,606202,0.00016199,98.20121625
35618,紐約戰場,1,606203,0.00016199,98.20137825
35619,紐約證券交易所,1,606204,0.00016199,98.20154024
35620,紐奧良市,1,606205,0.00016199,98.20170224
35621,紐新,1,606206,0.00016199,98.20186423
35622,紐幣,1,606207,0.00016199,98.20202622
35623,紐澤西,1,606208,0.00016199,98.20218822
35624,紐澤西州,1,606209,0.00016199,98.20235021
35625,紐澤西州長,1,606210,0.00016199,98.20251221
35626,級數,1,606211,0.00016199,98.20267420
35627,納札巴耶夫,1,606212,0.00016199,98.20283619
35628,納吉,1,606213,0.00016199,98.20299819
35629,納涼會,1,606214,0.00016199,98.20316018
35630,紙上談兵,1,606215,0.00016199,98.20332218
35631,紙巾,1,606216,0.00016199,98.20348417
35632,紙末,1,606217,0.00016199,98.20364617
35633,紙板,1,606218,0.00016199,98.20380816
35634,紙盆,1,606219,0.00016199,98.20397015
35635,紙筆,1,606220,0.00016199,98.20413215
35636,紙鈔,1,606221,0.00016199,98.20429414
35637,紙漿,1,606222,0.00016199,98.20445614
35638,紙箱,1,606223,0.00016199,98.20461813
35639,紙膠布,1,606224,0.00016199,98.20478013
35640,紙質,1,606225,0.00016199,98.20494212
35641,紙錢,1,606226,0.00016199,98.20510411
35642,紛呈,1,606227,0.00016199,98.20526611
35643,紛紜,1,606228,0.00016199,98.20542810
35644,紛攘,1,606229,0.00016199,98.20559010
35645,缺水,1,606230,0.00016199,98.20575209
35646,缺血性,1,606231,0.00016199,98.20591408
35647,缺缺,1,606232,0.00016199,98.20607608
35648,翅,1,606233,0.00016199,98.20623807
35649,翁永全,1,606234,0.00016199,98.20640007
35650,翁有義,1,606235,0.00016199,98.20656206
35651,翁芳敏,1,606236,0.00016199,98.20672406
35652,翁金珠,1,606237,0.00016199,98.20688605
35653,翁媳,1,606238,0.00016199,98.20704804
35654,翁禎霞,1,606239,0.00016199,98.20721004
35655,翁靜玉,1,606240,0.00016199,98.20737203
35656,耕亦,1,606241,0.00016199,98.20753403
35657,耗去,1,606242,0.00016199,98.20769602
35658,耗弱,1,606243,0.00016199,98.20785802
35659,耗資,1,606244,0.00016199,98.20802001
35660,脂肪肝,1,606245,0.00016199,98.20818200
35661,脂類,1,606246,0.00016199,98.20834400
35662,胭脂,1,606247,0.00016199,98.20850599
35663,胭脂色,1,606248,0.00016199,98.20866799
35664,胭脂紅,1,606249,0.00016199,98.20882998
35665,胴,1,606250,0.00016199,98.20899197
35666,胴體,1,606251,0.00016199,98.20915397
35667,脆化,1,606252,0.00016199,98.20931596
35668,胸有成竹,1,606253,0.00016199,98.20947796
35669,胸前,1,606254,0.00016199,98.20963995
35670,胸針,1,606255,0.00016199,98.20980195
35671,胸骨,1,606256,0.00016199,98.20996394
35672,胸椎,1,606257,0.00016199,98.21012593
35673,胸腺嘧啶,1,606258,0.00016199,98.21028793
35674,胸線,1,606259,0.00016199,98.21044992
35675,胸膛,1,606260,0.00016199,98.21061192
35676,胸懷,1,606261,0.00016199,98.21077391
35677,胳膊,1,606262,0.00016199,98.21093591
35678,脈動,1,606263,0.00016199,98.21109790
35679,能力感,1,606264,0.00016199,98.21125989
35680,能量者,1,606265,0.00016199,98.21142189
35681,能量橋,1,606266,0.00016199,98.21158388
35682,能量醫學人士,1,606267,0.00016199,98.21174588
35683,能源開發,1,606268,0.00016199,98.21190787
35684,脊,1,606269,0.00016199,98.21206986
35685,臭包,1,606270,0.00016199,98.21223186
35686,臭豆腐,1,606271,0.00016199,98.21239385
35687,臭味相投,1,606272,0.00016199,98.21255585
35688,臭氣,1,606273,0.00016199,98.21271784
35689,臭蟲,1,606274,0.00016199,98.21287984
35690,舐,1,606275,0.00016199,98.21304183
35691,航太,1,606276,0.00016199,98.21320382
35692,航太工業區,1,606277,0.00016199,98.21336582
35693,航太科技,1,606278,0.00016199,98.21352781
35694,航次,1,606279,0.00016199,98.21368981
35695,航空用地,1,606280,0.00016199,98.21385180
35696,航空自衛隊,1,606281,0.00016199,98.21401380
35697,航空兵,1,606282,0.00016199,98.21417579
35698,航空對話,1,606283,0.00016199,98.21433778
35699,航空暨太空總署,1,606284,0.00016199,98.21449978
35700,航政司,1,606285,0.00016199,98.21466177
35701,航約,1,606286,0.00016199,98.21482377
35702,航海,1,606287,0.00016199,98.21498576
35703,航站大廈,1,606288,0.00016199,98.21514775
35704,航速,1,606289,0.00016199,98.21530975
35705,航運股,1,606290,0.00016199,98.21547174
35706,航運業,1,606291,0.00016199,98.21563374
35707,航運類股,1,606292,0.00016199,98.21579573
35708,航管塔台,1,606293,0.00016199,98.21595773
35709,航警,1,606294,0.00016199,98.21611972
35710,航權,1,606295,0.00016199,98.21628171
35711,茫,1,606296,0.00016199,98.21644371
35712,茫茫,1,606297,0.00016199,98.21660570
35713,荒地,1,606298,0.00016199,98.21676770
35714,荒原路華,1,606299,0.00016199,98.21692969
35715,荒唐,1,606300,0.00016199,98.21709169
35716,荒亂,1,606301,0.00016199,98.21725368
35717,荒誕,1,606302,0.00016199,98.21741567
35718,荒蕪,1,606303,0.00016199,98.21757767
35719,荒謬處,1,606304,0.00016199,98.21773966
35720,荒謬劇場,1,606305,0.00016199,98.21790166
35721,草屯區,1,606306,0.00016199,98.21806365
35722,草屯療養院,1,606307,0.00016199,98.21822564
35723,草屯鎮農會,1,606308,0.00016199,98.21838764
35724,草本,1,606309,0.00016199,98.21854963
35725,草坪,1,606310,0.00016199,98.21871163
35726,草食性,1,606311,0.00016199,98.21887362
35727,草食動物,1,606312,0.00016199,98.21903562
35728,草根會,1,606313,0.00016199,98.21919761
35729,草草,1,606314,0.00016199,98.21935960
35730,草草了事,1,606315,0.00016199,98.21952160
35731,草莽,1,606316,0.00016199,98.21968359
35732,草圖,1,606317,0.00016199,98.21984559
35733,草蓆,1,606318,0.00016199,98.22000758
35734,草簽,1,606319,0.00016199,98.22016958
35735,草藥,1,606320,0.00016199,98.22033157
35736,草藥舖,1,606321,0.00016199,98.22049356
35737,茵蘊,1,606322,0.00016199,98.22065556
35738,茲事體大,1,606323,0.00016199,98.22081755
35739,茹毛飲血,1,606324,0.00016199,98.22097955
35740,茶水間,1,606325,0.00016199,98.22114154
35741,茶包,1,606326,0.00016199,98.22130354
35742,茶具,1,606327,0.00016199,98.22146553
35743,茶味,1,606328,0.00016199,98.22162752
35744,茶花,1,606329,0.00016199,98.22178952
35745,茶花女,1,606330,0.00016199,98.22195151
35746,茶園,1,606331,0.00016199,98.22211351
35747,茶葉蛋,1,606332,0.00016199,98.22227550
35748,茶道,1,606333,0.00016199,98.22243749
35749,茶點,1,606334,0.00016199,98.22259949
35750,荀白克,1,606335,0.00016199,98.22276148
35751,荀伯格,1,606336,0.00016199,98.22292348
35752,荀絲,1,606337,0.00016199,98.22308547
35753,茱莉安摩爾,1,606338,0.00016199,98.22324747
35754,茱麗葉畢諾許,1,606339,0.00016199,98.22340946
35755,蚊蟲,1,606340,0.00016199,98.22357145
35756,蚊蠅,1,606341,0.00016199,98.22373345
35757,衰減,1,606342,0.00016199,98.22389544
35758,衰微,1,606343,0.00016199,98.22405744
35759,衷柏宣,1,606344,0.00016199,98.22421943
35760,袁世民,1,606345,0.00016199,98.22438143
35761,袁雪芬,1,606346,0.00016199,98.22454342
35762,袁詠儀,1,606347,0.00016199,98.22470541
35763,衹有,1,606348,0.00016199,98.22486741
35764,記下,1,606349,0.00016199,98.22502940
35765,記不記得,1,606350,0.00016199,98.22519140
35766,記仇,1,606351,0.00016199,98.22535339
35767,記事簿,1,606352,0.00016199,98.22551538
35768,記恨,1,606353,0.00016199,98.22567738
35769,記憶猶新,1,606354,0.00016199,98.22583937
35770,記憶體卡,1,606355,0.00016199,98.22600137
35771,記憶體模組,1,606356,0.00016199,98.22616336
35772,記錯,1,606357,0.00016199,98.22632536
35773,記錄性,1,606358,0.00016199,98.22648735
35774,討打,1,606359,0.00016199,98.22664934
35775,討生活,1,606360,0.00016199,98.22681134
35776,討海人,1,606361,0.00016199,98.22697333
35777,討教,1,606362,0.00016199,98.22713533
35778,討喜,1,606363,0.00016199,98.22729732
35779,討飯,1,606364,0.00016199,98.22745932
35780,討價還價,1,606365,0.00016199,98.22762131
35781,討論區,1,606366,0.00016199,98.22778330
35782,討錢,1,606367,0.00016199,98.22794530
35783,訕笑,1,606368,0.00016199,98.22810729
35784,訊問,1,606369,0.00016199,98.22826929
35785,訊源,1,606370,0.00016199,98.22843128
35786,訊號燈,1,606371,0.00016199,98.22859327
35787,訓育委員會,1,606372,0.00016199,98.22875527
35788,訓隊員,1,606373,0.00016199,98.22891726
35789,訓誡,1,606374,0.00016199,98.22907926
35790,訓練曳光彈,1,606375,0.00016199,98.22924125
35791,訓練有素,1,606376,0.00016199,98.22940325
35792,訓練所,1,606377,0.00016199,98.22956524
35793,訓練員,1,606378,0.00016199,98.22972723
35794,訓練部,1,606379,0.00016199,98.22988923
35795,訖,1,606380,0.00016199,98.23005122
35796,豈知,1,606381,0.00016199,98.23021322
35797,豈料,1,606382,0.00016199,98.23037521
35798,豹,1,606383,0.00016199,98.23053721
35799,財金,1,606384,0.00016199,98.23069920
35800,財政主義,1,606385,0.00016199,98.23086119
35801,財政局,1,606386,0.00016199,98.23102319
35802,財政委員會,1,606387,0.00016199,98.23118518
35803,財政所,1,606388,0.00016199,98.23134718
35804,財政課,1,606389,0.00016199,98.23150917
35805,財神百貨,1,606390,0.00016199,98.23167116
35806,財訊快報,1,606391,0.00016199,98.23183316
35807,財迷心竅,1,606392,0.00016199,98.23199515
35808,財務中心,1,606393,0.00016199,98.23215715
35809,財務公司,1,606394,0.00016199,98.23231914
35810,財務分析師,1,606395,0.00016199,98.23248114
35811,財務規畫,1,606396,0.00016199,98.23264313
35812,財務部,1,606397,0.00016199,98.23280512
35813,財務報表書,1,606398,0.00016199,98.23296712
35814,財產移轉法,1,606399,0.00016199,98.23312911
35815,財貨,1,606400,0.00016199,98.23329111
35816,財會碩士,1,606401,0.00016199,98.23345310
35817,財團法人中台文教基金會,1,606402,0.00016199,98.23361510
35818,財團法人紀念李建成先生文教基金會,1,606403,0.00016199,98.23377709
35819,貢丸,1,606404,0.00016199,98.23393908
35820,起不了,1,606405,0.00016199,98.23410108
35821,起司,1,606406,0.00016199,98.23426307
35822,起用,1,606407,0.00016199,98.23442507
35823,起兵,1,606408,0.00016199,98.23458706
35824,起見,1,606409,0.00016199,98.23474905
35825,起亞汽車,1,606410,0.00016199,98.23491105
35826,起亞車廠,1,606411,0.00016199,98.23507304
35827,起居,1,606412,0.00016199,98.23523504
35828,起居室,1,606413,0.00016199,98.23539703
35829,起泡,1,606414,0.00016199,98.23555903
35830,起勁,1,606415,0.00016199,98.23572102
35831,起降,1,606416,0.00016199,98.23588301
35832,起站,1,606417,0.00016199,98.23604501
35833,起訖,1,606418,0.00016199,98.23620700
35834,起起伏伏,1,606419,0.00016199,98.23636900
35835,起起落落,1,606420,0.00016199,98.23653099
35836,起造人,1,606421,0.00016199,98.23669299
35837,起訴案,1,606422,0.00016199,98.23685498
35838,起腳,1,606423,0.00016199,98.23701697
35839,起落架,1,606424,0.00016199,98.23717897
35840,起跳,1,606425,0.00016199,98.23734096
35841,起漲,1,606426,0.00016199,98.23750296
35842,起疑,1,606427,0.00016199,98.23766495
35843,起霸,1,606428,0.00016199,98.23782694
35844,躬,1,606429,0.00016199,98.23798894
35845,辱,1,606430,0.00016199,98.23815093
35846,辱罵,1,606431,0.00016199,98.23831293
35847,送上,1,606432,0.00016199,98.23847492
35848,送水,1,606433,0.00016199,98.23863692
35849,送去,1,606434,0.00016199,98.23879891
35850,送交,1,606435,0.00016199,98.23896090
35851,送件,1,606436,0.00016199,98.23912290
35852,送洗,1,606437,0.00016199,98.23928489
35853,送風箱,1,606438,0.00016199,98.23944689
35854,送荊釵,1,606439,0.00016199,98.23960888
35855,送貨,1,606440,0.00016199,98.23977088
35856,送電,1,606441,0.00016199,98.23993287
35857,送審,1,606442,0.00016199,98.24009486
35858,送請,1,606443,0.00016199,98.24025686
35859,送辦,1,606444,0.00016199,98.24041885
35860,送驗,1,606445,0.00016199,98.24058085
35861,逆光,1,606446,0.00016199,98.24074284
35862,逆流,1,606447,0.00016199,98.24090483
35863,迷上,1,606448,0.00016199,98.24106683
35864,迷你卡,1,606449,0.00016199,98.24122882
35865,迷你跳舞蘭,1,606450,0.00016199,98.24139082
35866,迷狂式,1,606451,0.00016199,98.24155281
35867,迷津,1,606452,0.00016199,98.24171481
35868,迷茫,1,606453,0.00016199,98.24187680
35869,迷途,1,606454,0.00016199,98.24203879
35870,迷漫,1,606455,0.00016199,98.24220079
35871,迷糊仗,1,606456,0.00016199,98.24236278
35872,退伍金,1,606457,0.00016199,98.24252478
35873,退休金制度,1,606458,0.00016199,98.24268677
35874,退休金定額免稅方案,1,606459,0.00016199,98.24284877
35875,退休準備金,1,606460,0.00016199,98.24301076
35876,退守,1,606461,0.00016199,98.24317275
35877,退位,1,606462,0.00016199,98.24333475
35878,退房,1,606463,0.00016199,98.24349674
35879,退修,1,606464,0.00016199,98.24365874
35880,退席,1,606465,0.00016199,98.24382073
35881,退書率,1,606466,0.00016199,98.24398272
35882,退消,1,606467,0.00016199,98.24414472
35883,退訓,1,606468,0.00016199,98.24430671
35884,退除役官兵,1,606469,0.00016199,98.24446871
35885,退除役官兵俸,1,606470,0.00016199,98.24463070
35886,退貨,1,606471,0.00016199,98.24479270
35887,退貨率,1,606472,0.00016199,98.24495469
35888,退麻醉劑,1,606473,0.00016199,98.24511668
35889,退潮,1,606474,0.00016199,98.24527868
35890,退燒,1,606475,0.00016199,98.24544067
35891,退選,1,606476,0.00016199,98.24560267
35892,退避,1,606477,0.00016199,98.24576466
35893,退讓,1,606478,0.00016199,98.24592666
35894,迴氣蕩漾,1,606479,0.00016199,98.24608865
35895,迴紋針,1,606480,0.00016199,98.24625064
35896,迴紋針成型機,1,606481,0.00016199,98.24641264
35897,迴蕩,1,606482,0.00016199,98.24657463
35898,逃入,1,606483,0.00016199,98.24673663
35899,逃之夭夭,1,606484,0.00016199,98.24689862
35900,逃命線,1,606485,0.00016199,98.24706061
35901,逃命罷,1,606486,0.00016199,98.24722261
35902,逃掉,1,606487,0.00016199,98.24738460
35903,逃開,1,606488,0.00016199,98.24754660
35904,逃過,1,606489,0.00016199,98.24770859
35905,逃學,1,606490,0.00016199,98.24787059
35906,追上,1,606491,0.00016199,98.24803258
35907,追本溯源,1,606492,0.00016199,98.24819457
35908,追印,1,606493,0.00016199,98.24835657
35909,追回,1,606494,0.00016199,98.24851856
35910,追到,1,606495,0.00016199,98.24868056
35911,追念,1,606496,0.00016199,98.24884255
35912,追根究袛,1,606497,0.00016199,98.24900455
35913,追高,1,606498,0.00016199,98.24916654
35914,追訴,1,606499,0.00016199,98.24932853
35915,追訴權,1,606500,0.00016199,98.24949053
35916,追詢,1,606501,0.00016199,98.24965252
35917,追撞,1,606502,0.00016199,98.24981452
35918,追隨者,1,606503,0.00016199,98.24997651
35919,追懷,1,606504,0.00016199,98.25013851
35920,迸出,1,606505,0.00016199,98.25030050
35921,郝思嘉,1,606506,0.00016199,98.25046249
35922,郝柏可,1,606507,0.00016199,98.25062449
35923,酒友,1,606508,0.00016199,98.25078648
35924,酒性,1,606509,0.00016199,98.25094848
35925,酒紅,1,606510,0.00016199,98.25111047
35926,酒席,1,606511,0.00016199,98.25127246
35927,酒桶型,1,606512,0.00016199,98.25143446
35928,酒壺,1,606513,0.00016199,98.25159645
35929,酒量,1,606514,0.00016199,98.25175845
35930,酒筵,1,606515,0.00016199,98.25192044
35931,酒櫃,1,606516,0.00016199,98.25208244
35932,酒釀,1,606517,0.00016199,98.25224443
35933,配用,1,606518,0.00016199,98.25240642
35934,配合款,1,606519,0.00016199,98.25256842
35935,配車,1,606520,0.00016199,98.25273041
35936,配音版,1,606521,0.00016199,98.25289241
35937,配售,1,606522,0.00016199,98.25305440
35938,配帶,1,606523,0.00016199,98.25321640
35939,配票,1,606524,0.00016199,98.25337839
35940,配換,1,606525,0.00016199,98.25354038
35941,配飾,1,606526,0.00016199,98.25370238
35942,配圖,1,606527,0.00016199,98.25386437
35943,配銷,1,606528,0.00016199,98.25402637
35944,配器,1,606529,0.00016199,98.25418836
35945,配戴,1,606530,0.00016199,98.25435035
35946,配額,1,606531,0.00016199,98.25451235
35947,配屬,1,606532,0.00016199,98.25467434
35948,釘子,1,606533,0.00016199,98.25483634
35949,釘緊,1,606534,0.00016199,98.25499833
35950,針灸師,1,606535,0.00016199,98.25516033
35951,針刺,1,606536,0.00016199,98.25532232
35952,針砭,1,606537,0.00016199,98.25548431
35953,針筒,1,606538,0.00016199,98.25564631
35954,針葉林,1,606539,0.00016199,98.25580830
35955,閃出,1,606540,0.00016199,98.25597030
35956,閃失,1,606541,0.00016199,98.25613229
35957,閃光,1,606542,0.00016199,98.25629429
35958,閃現,1,606543,0.00016199,98.25645628
35959,閃躲,1,606544,0.00016199,98.25661827
35960,閃過,1,606545,0.00016199,98.25678027
35961,閃避,1,606546,0.00016199,98.25694226
35962,閃耀,1,606547,0.00016199,98.25710426
35963,院士,1,606548,0.00016199,98.25726625
35964,院址,1,606549,0.00016199,98.25742824
35965,院所,1,606550,0.00016199,98.25759024
35966,院區,1,606551,0.00016199,98.25775223
35967,院琴師,1,606552,0.00016199,98.25791423
35968,院畫,1,606553,0.00016199,98.25807622
35969,陣亡者,1,606554,0.00016199,98.25823822
35970,陣子,1,606555,0.00016199,98.25840021
35971,陣形,1,606556,0.00016199,98.25856220
35972,陣型,1,606557,0.00016199,98.25872420
35973,陣痛,1,606558,0.00016199,98.25888619
35974,陣腳,1,606559,0.00016199,98.25904819
35975,陡坡,1,606560,0.00016199,98.25921018
35976,陡峭,1,606561,0.00016199,98.25937218
35977,陡峻,1,606562,0.00016199,98.25953417
35978,除夕,1,606563,0.00016199,98.25969616
35979,除法,1,606564,0.00016199,98.25985816
35980,除卻,1,606565,0.00016199,98.26002015
35981,除紋霜,1,606566,0.00016199,98.26018215
35982,除臭劑,1,606567,0.00016199,98.26034414
35983,除霉,1,606568,0.00016199,98.26050613
35984,除錯,1,606569,0.00016199,98.26066813
35985,除穢布新,1,606570,0.00016199,98.26083012
35986,除權交易日,1,606571,0.00016199,98.26099212
35987,馬丁．帕爾,1,606572,0.00016199,98.26115411
35988,馬丁．盧,1,606573,0.00016199,98.26131611
35989,馬丁布瑞斯特,1,606574,0.00016199,98.26147810
35990,馬丁隊長,1,606575,0.00016199,98.26164009
35991,馬力歐,1,606576,0.00016199,98.26180209
35992,馬口鐵,1,606577,0.00016199,98.26196408
35993,馬元,1,606578,0.00016199,98.26212608
35994,馬公市,1,606579,0.00016199,98.26228807
35995,馬公港,1,606580,0.00016199,98.26245007
35996,馬天尼,1,606581,0.00016199,98.26261206
35997,馬文,1,606582,0.00016199,98.26277405
35998,馬可仕,1,606583,0.00016199,98.26293605
35999,馬列街,1,606584,0.00016199,98.26309804
36000,馬自達,1,606585,0.00016199,98.26326004
36001,馬克．莫里斯,1,606586,0.00016199,98.26342203
36002,馬克西穆斯,1,606587,0.00016199,98.26358402
36003,馬克杜威,1,606588,0.00016199,98.26374602
36004,馬克維茲,1,606589,0.00016199,98.26390801
36005,馬利,1,606590,0.00016199,98.26407001
36006,馬利可波郡,1,606591,0.00016199,98.26423200
36007,馬屁,1,606592,0.00016199,98.26439400
36008,馬貝瑞,1,606593,0.00016199,98.26455599
36009,馬車,1,606594,0.00016199,98.26471798
36010,馬里布,1,606595,0.00016199,98.26487998
36011,馬里奧．莫里納,1,606596,0.00016199,98.26504197
36012,馬里歐．莫藍戴,1,606597,0.00016199,98.26520397
36013,馬來,1,606598,0.00016199,98.26536596
36014,馬來西亞族,1,606599,0.00016199,98.26552796
36015,馬來菜,1,606600,0.00016199,98.26568995
36016,馬到成功,1,606601,0.00016199,98.26585194
36017,馬拉松,1,606602,0.00016199,98.26601394
36018,馬拉松賽,1,606603,0.00016199,98.26617593
36019,馬拉威島,1,606604,0.00016199,98.26633793
36020,馬哈迪,1,606605,0.00016199,98.26649992
36021,馬紀壯,1,606606,0.00016199,98.26666191
36022,馬英力,1,606607,0.00016199,98.26682391
36023,馬修莫汀,1,606608,0.00016199,98.26698590
36024,馬振華,1,606609,0.00016199,98.26714790
36025,馬格蘭通訊杜,1,606610,0.00016199,98.26730989
36026,馬爹利干邑白蘭地,1,606611,0.00016199,98.26747189
36027,馬祖島,1,606612,0.00016199,98.26763388
36028,馬健明,1,606613,0.00016199,98.26779587
36029,馬偕醫院,1,606614,0.00016199,98.26795787
36030,馬勒維奇,1,606615,0.00016199,98.26811986
36031,馬國,1,606616,0.00016199,98.26828186
36032,馬球,1,606617,0.00016199,98.26844385
36033,馬術,1,606618,0.00016199,98.26860585
36034,馬傑岩,1,606619,0.00016199,98.26876784
36035,馬斯奈,1,606620,0.00016199,98.26892983
36036,馬華公會,1,606621,0.00016199,98.26909183
36037,馬雅,1,606622,0.00016199,98.26925382
36038,馬雅人,1,606623,0.00016199,98.26941582
36039,馬歇,1,606624,0.00016199,98.26957781
36040,馬道容,1,606625,0.00016199,98.26973980
36041,馬達加斯加島,1,606626,0.00016199,98.26990180
36042,馬達法辛烷值,1,606627,0.00016199,98.27006379
36043,馬鈴薯,1,606628,0.00016199,98.27022579
36044,馬漢,1,606629,0.00016199,98.27038778
36045,馬槽,1,606630,0.00016199,98.27054978
36046,馬澄坤,1,606631,0.00016199,98.27071177
36047,馬鞍,1,606632,0.00016199,98.27087376
36048,馬蹄型,1,606633,0.00016199,98.27103576
36049,馬龍,1,606634,0.00016199,98.27119775
36050,馬戲,1,606635,0.00016199,98.27135975
36051,馬戲團,1,606636,0.00016199,98.27152174
36052,馬聯工業,1,606637,0.00016199,98.27168374
36053,馬聯工業公司,1,606638,0.00016199,98.27184573
36054,馬賽之肺,1,606639,0.00016199,98.27200772
36055,馬賽機場,1,606640,0.00016199,98.27216972
36056,馬薩伊,1,606641,0.00016199,98.27233171
36057,馬鈺龍,1,606642,0.00016199,98.27249371
36058,骨本,1,606643,0.00016199,98.27265570
36059,骨灰,1,606644,0.00016199,98.27281769
36060,骨血,1,606645,0.00016199,98.27297969
36061,骨氣,1,606646,0.00016199,98.27314168
36062,骨牌,1,606647,0.00016199,98.27330368
36063,骨碌碌,1,606648,0.00016199,98.27346567
36064,骨董店,1,606649,0.00016199,98.27362767
36065,骨董商,1,606650,0.00016199,98.27378966
36066,骨盤,1,606651,0.00016199,98.27395165
36067,骨骸,1,606652,0.00016199,98.27411365
36068,骨髓性,1,606653,0.00016199,98.27427564
36069,骨髓移植,1,606654,0.00016199,98.27443764
36070,高��,1,606655,0.00016199,98.27459963
36071,高三,1,606656,0.00016199,98.27476163
36072,高大宜,1,606657,0.00016199,98.27492362
36073,高大鵬,1,606658,0.00016199,98.27508561
36074,高山湖泊,1,606659,0.00016199,98.27524761
36075,高升,1,606660,0.00016199,98.27540960
36076,高手級,1,606661,0.00016199,98.27557160
36077,高本堪東方旅遊博物館,1,606662,0.00016199,98.27573359
36078,高名潞,1,606663,0.00016199,98.27589558
36079,高年級,1,606664,0.00016199,98.27605758
36080,高年億,1,606665,0.00016199,98.27621957
36081,高血脂症,1,606666,0.00016199,98.27638157
36082,高血壓病,1,606667,0.00016199,98.27654356
36083,高低音,1,606668,0.00016199,98.27670556
36084,高低溫,1,606669,0.00016199,98.27686755
36085,高更,1,606670,0.00016199,98.27702954
36086,高孟定,1,606671,0.00016199,98.27719154
36087,高性能,1,606672,0.00016199,98.27735353
36088,高空偵察機,1,606673,0.00016199,98.27751553
36089,高信疆,1,606674,0.00016199,98.27767752
36090,高品質,1,606675,0.00016199,98.27783952
36091,高美展,1,606676,0.00016199,98.27800151
36092,高美館,1,606677,0.00016199,98.27816350
36093,高音區,1,606678,0.00016199,98.27832550
36094,高音部,1,606679,0.00016199,98.27848749
36095,高音質,1,606680,0.00016199,98.27864949
36096,高音譜記號,1,606681,0.00016199,98.27881148
36097,高飛,1,606682,0.00016199,98.27897348
36098,高飛球,1,606683,0.00016199,98.27913547
36099,高剛性,1,606684,0.00016199,98.27929746
36100,高原區,1,606685,0.00016199,98.27945946
36101,高原期,1,606686,0.00016199,98.27962145
36102,高峰路,1,606687,0.00016199,98.27978345
36103,高徒,1,606688,0.00016199,98.27994544
36104,高校,1,606689,0.00016199,98.28010743
36105,高校生,1,606690,0.00016199,98.28026943
36106,高高興興,1,606691,0.00016199,98.28043142
36107,高堅育,1,606692,0.00016199,98.28059342
36108,高密度,1,606693,0.00016199,98.28075541
36109,高強,1,606694,0.00016199,98.28091741
36110,高速度化,1,606695,0.00016199,98.28107940
36111,高速混合氣流向保焰板,1,606696,0.00016199,98.28124139
36112,高速遊艇,1,606697,0.00016199,98.28140339
36113,高速鐵路,1,606698,0.00016199,98.28156538
36114,高野公司,1,606699,0.00016199,98.28172738
36115,高單位,1,606700,0.00016199,98.28188937
36116,高揚,1,606701,0.00016199,98.28205137
36117,高等院校,1,606702,0.00016199,98.28221336
36118,高雄市民,1,606703,0.00016199,98.28237535
36119,高雄市立凱旋醫院,1,606704,0.00016199,98.28253735
36120,高雄市立圖書館,1,606705,0.00016199,98.28269934
36121,高雄市府,1,606706,0.00016199,98.28286134
36122,高雄市長,1,606707,0.00016199,98.28302333
36123,高雄市醫師公會,1,606708,0.00016199,98.28318532
36124,高雄企銀,1,606709,0.00016199,98.28334732
36125,高雄漢神,1,606710,0.00016199,98.28350931
36126,高雄縣政府,1,606711,0.00016199,98.28367131
36127,高雄縣調站,1,606712,0.00016199,98.28383330
36128,高雄縣議會,1,606713,0.00016199,98.28399530
36129,高雄醫師會誌,1,606714,0.00016199,98.28415729
36130,高雄醫學院,1,606715,0.00016199,98.28431928
36131,高感度麥克風,1,606716,0.00016199,98.28448128
36132,高照訓,1,606717,0.00016199,98.28464327
36133,高粱,1,606718,0.00016199,98.28480527
36134,高粱酒,1,606719,0.00016199,98.28496726
36135,高經濟作物,1,606720,0.00016199,98.28512926
36136,高腳椅,1,606721,0.00016199,98.28529125
36137,高跟鞋的誘惑,1,606722,0.00016199,98.28545324
36138,高僧,1,606723,0.00016199,98.28561524
36139,高圖斯電腦公司,1,606724,0.00016199,98.28577723
36140,高爾夫球明星,1,606725,0.00016199,98.28593923
36141,高爾夫球鞋,1,606726,0.00016199,98.28610122
36142,高爾夫球證,1,606727,0.00016199,98.28626321
36143,高爾肌腱器,1,606728,0.00016199,98.28642521
36144,高爾基肌腱器,1,606729,0.00016199,98.28658720
36145,高價位,1,606730,0.00016199,98.28674920
36146,高層次,1,606731,0.00016199,98.28691119
36147,高橋英次,1,606732,0.00016199,98.28707319
36148,高橋留美子,1,606733,0.00016199,98.28723518
36149,高興昌,1,606734,0.00016199,98.28739717
36150,高瞻遠矚,1,606735,0.00016199,98.28755917
36151,高醫青年,1,606736,0.00016199,98.28772116
36152,高爆彈,1,606737,0.00016199,98.28788316
36153,高爆燒夷自毀彈,1,606738,0.00016199,98.28804515
36154,高爆燒夷彈,1,606739,0.00016199,98.28820715
36155,高懸,1,606740,0.00016199,98.28836914
36156,高齡化,1,606741,0.00016199,98.28853113
36157,高鐵,1,606742,0.00016199,98.28869313
36158,鬼太鼓座,1,606743,0.00016199,98.28885512
36159,鬼月,1,606744,0.00016199,98.28901712
36160,鬼仔,1,606745,0.00016199,98.28917911
36161,鬼佬,1,606746,0.00016199,98.28934110
36162,鬼門關,1,606747,0.00016199,98.28950310
36163,鬼馬小精靈,1,606748,0.00016199,98.28966509
36164,鬼婆婆,1,606749,0.00016199,98.28982709
36165,鬼話,1,606750,0.00016199,98.28998908
36166,鬼魂,1,606751,0.00016199,98.29015108
36167,鬼影幢幢,1,606752,0.00016199,98.29031307
36168,鬼魅,1,606753,0.00016199,98.29047506
36169,乾女兒,1,606754,0.00016199,98.29063706
36170,乾冷,1,606755,0.00016199,98.29079905
36171,乾性,1,606756,0.00016199,98.29096105
36172,乾洗店,1,606757,0.00016199,98.29112304
36173,乾笑,1,606758,0.00016199,98.29128504
36174,乾乾澀澀,1,606759,0.00016199,98.29144703
36175,乾涸,1,606760,0.00016199,98.29160902
36176,乾細,1,606761,0.00016199,98.29177102
36177,乾裂,1,606762,0.00016199,98.29193301
36178,乾隆,1,606763,0.00016199,98.29209501
36179,乾酪,1,606764,0.00016199,98.29225700
36180,乾熱,1,606765,0.00016199,98.29241899
36181,乾蔥,1,606766,0.00016199,98.29258099
36182,乾澀,1,606767,0.00016199,98.29274298
36183,乾燥性,1,606768,0.00016199,98.29290498
36184,乾燥花,1,606769,0.00016199,98.29306697
36185,偽虎鯨,1,606770,0.00016199,98.29322897
36186,偽造文書,1,606771,0.00016199,98.29339096
36187,偽陽病,1,606772,0.00016199,98.29355295
36188,偽裝帽,1,606773,0.00016199,98.29371495
36189,停用,1,606774,0.00016199,98.29387694
36190,停住,1,606775,0.00016199,98.29403894
36191,停佇,1,606776,0.00016199,98.29420093
36192,停車位,1,606777,0.00016199,98.29436293
36193,停板,1,606778,0.00016199,98.29452492
36194,停航,1,606779,0.00016199,98.29468691
36195,停停走走,1,606780,0.00016199,98.29484891
36196,停產,1,606781,0.00016199,98.29501090
36197,停損點,1,606782,0.00016199,98.29517290
36198,停會,1,606783,0.00016199,98.29533489
36199,停歇業,1,606784,0.00016199,98.29549688
36200,停過,1,606785,0.00016199,98.29565888
36201,停滿,1,606786,0.00016199,98.29582087
36202,停管處長,1,606787,0.00016199,98.29598287
36203,停戰,1,606788,0.00016199,98.29614486
36204,停賽,1,606789,0.00016199,98.29630686
36205,假人,1,606790,0.00016199,98.29646885
36206,假以時日,1,606791,0.00016199,98.29663084
36207,假扣押,1,606792,0.00016199,98.29679284
36208,假定,1,606793,0.00016199,98.29695483
36209,假冒者,1,606794,0.00016199,98.29711683
36210,假面,1,606795,0.00016199,98.29727882
36211,假音,1,606796,0.00016199,98.29744082
36212,假條,1,606797,0.00016199,98.29760281
36213,假處分,1,606798,0.00016199,98.29776480
36214,假設性,1,606799,0.00016199,98.29792680
36215,假造,1,606800,0.00016199,98.29808879
36216,假意,1,606801,0.00016199,98.29825079
36217,假想,1,606802,0.00016199,98.29841278
36218,假想敵,1,606803,0.00016199,98.29857477
36219,做工,1,606804,0.00016199,98.29873677
36220,做主,1,606805,0.00016199,98.29889876
36221,做何感想,1,606806,0.00016199,98.29906076
36222,做作,1,606807,0.00016199,98.29922275
36223,做來,1,606808,0.00016199,98.29938475
36224,做到,1,606809,0.00016199,98.29954674
36225,做東,1,606810,0.00016199,98.29970873
36226,做活兒,1,606811,0.00016199,98.29987073
36227,做假,1,606812,0.00016199,98.30003272
36228,做做,1,606813,0.00016199,98.30019472
36229,做球,1,606814,0.00016199,98.30035671
36230,做球手,1,606815,0.00016199,98.30051871
36231,做絕,1,606816,0.00016199,98.30068070
36232,做飯,1,606817,0.00016199,98.30084269
36233,做罷,1,606818,0.00016199,98.30100469
36234,做錯,1,606819,0.00016199,98.30116668
36235,做證,1,606820,0.00016199,98.30132868
36236,做體操,1,606821,0.00016199,98.30149067
36237,偉仁,1,606822,0.00016199,98.30165266
36238,偉達資訊,1,606823,0.00016199,98.30181466
36239,偉聯,1,606824,0.00016199,98.30197665
36240,偉聯運輸,1,606825,0.00016199,98.30213865
36241,健行路,1,606826,0.00016199,98.30230064
36242,健身中心,1,606827,0.00016199,98.30246264
36243,健身車,1,606828,0.00016199,98.30262463
36244,健身器材,1,606829,0.00016199,98.30278662
36245,健朗,1,606830,0.00016199,98.30294862
36246,健康器材,1,606831,0.00016199,98.30311061
36247,健康諮詢中心,1,606832,0.00016199,98.30327261
36248,健康餐,1,606833,0.00016199,98.30343460
36249,健診諮詢中心,1,606834,0.00016199,98.30359660
36250,健談,1,606835,0.00016199,98.30375859
36251,健寶,1,606836,0.00016199,98.30392058
36252,偶一為之,1,606837,0.00016199,98.30408258
36253,偶缺,1,606838,0.00016199,98.30424457
36254,偵查庭,1,606839,0.00016199,98.30440657
36255,偵破,1,606840,0.00016199,98.30456856
36256,偵測程,1,606841,0.00016199,98.30473055
36257,偵結,1,606842,0.00016199,98.30489255
36258,偵察隊,1,606843,0.00016199,98.30505454
36259,偵察機,1,606844,0.00016199,98.30521654
36260,偵審,1,606845,0.00016199,98.30537853
36261,側面氣囊,1,606846,0.00016199,98.30554053
36262,側傾,1,606847,0.00016199,98.30570252
36263,側裝式,1,606848,0.00016199,98.30586451
36264,側躺,1,606849,0.00016199,98.30602651
36265,偷天換日,1,606850,0.00016199,98.30618850
36266,偷走,1,606851,0.00016199,98.30635050
36267,偷車,1,606852,0.00016199,98.30651249
36268,偷拍,1,606853,0.00016199,98.30667449
36269,偷看,1,606854,0.00016199,98.30683648
36270,偷偷摸摸,1,606855,0.00016199,98.30699847
36271,偷理,1,606856,0.00016199,98.30716047
36272,偷盜,1,606857,0.00016199,98.30732246
36273,偷腥,1,606858,0.00016199,98.30748446
36274,偷腥家族,1,606859,0.00016199,98.30764645
36275,偷瞄,1,606860,0.00016199,98.30780845
36276,偏方,1,606861,0.00016199,98.30797044
36277,偏光鏡,1,606862,0.00016199,98.30813243
36278,偏位式,1,606863,0.00016199,98.30829443
36279,偏見者,1,606864,0.00016199,98.30845642
36280,偏高,1,606865,0.00016199,98.30861842
36281,偏執,1,606866,0.00016199,98.30878041
36282,偏斜,1,606867,0.00016199,98.30894240
36283,偏移,1,606868,0.00016199,98.30910440
36284,偏袒,1,606869,0.00016199,98.30926639
36285,偏頗,1,606870,0.00016199,98.30942839
36286,倏忽來去,1,606871,0.00016199,98.30959038
36287,剪回,1,606872,0.00016199,98.30975238
36288,剪成,1,606873,0.00016199,98.30991437
36289,剪紙,1,606874,0.00016199,98.31007636
36290,剪集,1,606875,0.00016199,98.31023836
36291,剪綵,1,606876,0.00016199,98.31040035
36292,剪影,1,606877,0.00016199,98.31056235
36293,副分局長,1,606878,0.00016199,98.31072434
36294,副主廚,1,606879,0.00016199,98.31088634
36295,副司令,1,606880,0.00016199,98.31104833
36296,副司長,1,606881,0.00016199,98.31121032
36297,副州長,1,606882,0.00016199,98.31137232
36298,副社長,1,606883,0.00016199,98.31153431
36299,副首長,1,606884,0.00016199,98.31169631
36300,副執行長,1,606885,0.00016199,98.31185830
36301,副產品,1,606886,0.00016199,98.31202029
36302,副組長,1,606887,0.00016199,98.31218229
36303,副部長,1,606888,0.00016199,98.31234428
36304,副都市中心,1,606889,0.00016199,98.31250628
36305,副隊長,1,606890,0.00016199,98.31266827
36306,副經理,1,606891,0.00016199,98.31283027
36307,副團長,1,606892,0.00016199,98.31299226
36308,副歌,1,606893,0.00016199,98.31315425
36309,副領隊,1,606894,0.00016199,98.31331625
36310,副樑,1,606895,0.00016199,98.31347824
36311,副總編輯,1,606896,0.00016199,98.31364024
36312,副職,1,606897,0.00016199,98.31380223
36313,勒死,1,606898,0.00016199,98.31396423
36314,勘查,1,606899,0.00016199,98.31412622
36315,動一動,1,606900,0.00016199,98.31428821
36316,動人心弦,1,606901,0.00016199,98.31445021
36317,動力型,1,606902,0.00016199,98.31461220
36318,動也不動,1,606903,0.00016199,98.31477420
36319,動心,1,606904,0.00016199,98.31493619
36320,動手腳,1,606905,0.00016199,98.31509818
36321,動支,1,606906,0.00016199,98.31526018
36322,動來動去,1,606907,0.00016199,98.31542217
36323,動物角,1,606908,0.00016199,98.31558417
36324,動物界,1,606909,0.00016199,98.31574616
36325,動物實驗,1,606910,0.00016199,98.31590816
36326,動怒,1,606911,0.00016199,98.31607015
36327,動員率,1,606912,0.00016199,98.31623214
36328,動脈阻塞,1,606913,0.00016199,98.31639414
36329,動得快,1,606914,0.00016199,98.31655613
36330,動情激素,1,606915,0.00016199,98.31671813
36331,動產,1,606916,0.00016199,98.31688012
36332,動植物園,1,606917,0.00016199,98.31704212
36333,動畫片,1,606918,0.00016199,98.31720411
36334,動畫界,1,606919,0.00016199,98.31736610
36335,動畫檔,1,606920,0.00016199,98.31752810
36336,動詞,1,606921,0.00016199,98.31769009
36337,動態化,1,606922,0.00016199,98.31785209
36338,動態式,1,606923,0.00016199,98.31801408
36339,動態影像,1,606924,0.00016199,98.31817607
36340,動態隨機存取記憶體,1,606925,0.00016199,98.31833807
36341,動線,1,606926,0.00016199,98.31850006
36342,動議,1,606927,0.00016199,98.31866206
36343,匏瓜,1,606928,0.00016199,98.31882405
36344,區別性,1,606929,0.00016199,98.31898605
36345,區里,1,606930,0.00016199,98.31914804
36346,區居,1,606931,0.00016199,98.31931003
36347,區段徵收,1,606932,0.00016199,98.31947203
36348,區域性,1,606933,0.00016199,98.31963402
36349,區域性金融風暴,1,606934,0.00016199,98.31979602
36350,區域網路,1,606935,0.00016199,98.31995801
36351,區域線,1,606936,0.00016199,98.32012001
36352,區運,1,606937,0.00016199,98.32028200
36353,匾,1,606938,0.00016199,98.32044399
36354,匾額,1,606939,0.00016199,98.32060599
36355,參考值,1,606940,0.00016199,98.32076798
36356,參考價,1,606941,0.00016199,98.32092998
36357,參事,1,606942,0.00016199,98.32109197
36358,參拍,1,606943,0.00016199,98.32125396
36359,參股,1,606944,0.00016199,98.32141596
36360,參軍,1,606945,0.00016199,98.32157795
36361,參差不齊,1,606946,0.00016199,98.32173995
36362,參宿四星,1,606947,0.00016199,98.32190194
36363,參與性,1,606948,0.00016199,98.32206394
36364,參與度,1,606949,0.00016199,98.32222593
36365,參與權,1,606950,0.00016199,98.32238792
36366,參數值,1,606951,0.00016199,98.32254992
36367,參謀,1,606952,0.00016199,98.32271191
36368,參謀本部聯五助次,1,606953,0.00016199,98.32287391
36369,參賽人,1,606954,0.00016199,98.32303590
36370,曼,1,606955,0.00016199,98.32319790
36371,曼力,1,606956,0.00016199,98.32335989
36372,曼谷大飯店,1,606957,0.00016199,98.32352188
36373,曼哈頓,1,606958,0.00016199,98.32368388
36374,曼都華,1,606959,0.00016199,98.32384587
36375,曼都髮型,1,606960,0.00016199,98.32400787
36376,曼徹斯特公司,1,606961,0.00016199,98.32416986
36377,曼徹斯特投資公司,1,606962,0.00016199,98.32433185
36378,商用,1,606963,0.00016199,98.32449385
36379,商店街,1,606964,0.00016199,98.32465584
36380,商品化,1,606965,0.00016199,98.32481784
36381,商品標示法,1,606966,0.00016199,98.32497983
36382,商界,1,606967,0.00016199,98.32514183
36383,商旅,1,606968,0.00016199,98.32530382
36384,商討,1,606969,0.00016199,98.32546581
36385,商務中心,1,606970,0.00016199,98.32562781
36386,商務車,1,606971,0.00016199,98.32578980
36387,商務套房,1,606972,0.00016199,98.32595180
36388,商情,1,606973,0.00016199,98.32611379
36389,商會,1,606974,0.00016199,98.32627579
36390,商業本票,1,606975,0.00016199,98.32643778
36391,商業性,1,606976,0.00016199,98.32659977
36392,商業週刊,1,606977,0.00016199,98.32676177
36393,商業會計法,1,606978,0.00016199,98.32692376
36394,商業預定地,1,606979,0.00016199,98.32708576
36395,商路,1,606980,0.00016199,98.32724775
36396,商標法,1,606981,0.00016199,98.32740974
36397,商談會,1,606982,0.00016199,98.32757174
36398,商勸,1,606983,0.00016199,98.32773373
36399,啦嘛,1,606984,0.00016199,98.32789573
36400,啄木鳥,1,606985,0.00016199,98.32805772
36401,啄食,1,606986,0.00016199,98.32821972
36402,啞口無言,1,606987,0.00016199,98.32838171
36403,啞巴剌,1,606988,0.00016199,98.32854370
36404,啞鈴,1,606989,0.00016199,98.32870570
36405,啃吮,1,606990,0.00016199,98.32886769
36406,啊！蟑螂,1,606991,0.00016199,98.32902969
36407,唱反調,1,606992,0.00016199,98.32919168
36408,唱片公司,1,606993,0.00016199,98.32935368
36409,唱片行,1,606994,0.00016199,98.32951567
36410,唱出來,1,606995,0.00016199,98.32967766
36411,唱奏,1,606996,0.00016199,98.32983966
36412,唱起來,1,606997,0.00016199,98.33000165
36413,唱現場,1,606998,0.00016199,98.33016365
36414,唱詞,1,606999,0.00016199,98.33032564
36415,唱詩班,1,607000,0.00016199,98.33048763
36416,唱遊,1,607001,0.00016199,98.33064963
36417,啖,1,607002,0.00016199,98.33081162
36418,問心無愧,1,607003,0.00016199,98.33097362
36419,問市,1,607004,0.00016199,98.33113561
36420,問津者,1,607005,0.00016199,98.33129761
36421,問候卡,1,607006,0.00016199,98.33145960
36422,問訊,1,607007,0.00016199,98.33162159
36423,問題性,1,607008,0.00016199,98.33178359
36424,問題點,1,607009,0.00016199,98.33194558
36425,唯才是用,1,607010,0.00016199,98.33210758
36426,唯利是圖,1,607011,0.00016199,98.33226957
36427,唯妙唯肖,1,607012,0.00016199,98.33243157
36428,唯我獨尊,1,607013,0.00016199,98.33259356
36429,唯讀型,1,607014,0.00016199,98.33275555
36430,啤酒屋,1,607015,0.00016199,98.33291755
36431,唸珠,1,607016,0.00016199,98.33307954
36432,唸起來,1,607017,0.00016199,98.33324154
36433,唸經,1,607018,0.00016199,98.33340353
36434,售車,1,607019,0.00016199,98.33356553
36435,售屋,1,607020,0.00016199,98.33372752
36436,售票口,1,607021,0.00016199,98.33388951
36437,售票點,1,607022,0.00016199,98.33405151
36438,售貨小姐,1,607023,0.00016199,98.33421350
36439,啜飲,1,607024,0.00016199,98.33437550
36440,唬,1,607025,0.00016199,98.33453749
36441,唬人,1,607026,0.00016199,98.33469948
36442,圈外人,1,607027,0.00016199,98.33486148
36443,圈套,1,607028,0.00016199,98.33502347
36444,圈套式,1,607029,0.00016199,98.33518547
36445,圈簧,1,607030,0.00016199,98.33534746
36446,國力,1,607031,0.00016199,98.33550946
36447,國大代表,1,607032,0.00016199,98.33567145
36448,國中小學,1,607033,0.00016199,98.33583344
36449,國內生產毛額,1,607034,0.00016199,98.33599544
36450,國內商港,1,607035,0.00016199,98.33615743
36451,國內債券附買回交易,1,607036,0.00016199,98.33631943
36452,國內廠,1,607037,0.00016199,98.33648142
36453,國王學院,1,607038,0.00016199,98.33664342
36454,國民住宅,1,607039,0.00016199,98.33680541
36455,國民身分證,1,607040,0.00016199,98.33696740
36456,國民車,1,607041,0.00016199,98.33712940
36457,國民旅遊專輯,1,607042,0.00016199,98.33729139
36458,國民黨員,1,607043,0.00016199,98.33745339
36459,國立,1,607044,0.00016199,98.33761538
36460,國立中央圖書館,1,607045,0.00016199,98.33777737
36461,國立自然科學博物館,1,607046,0.00016199,98.33793937
36462,國立師範大學,1,607047,0.00016199,98.33810136
36463,國光劇團,1,607048,0.00016199,98.33826336
36464,國共分裂,1,607049,0.00016199,98.33842535
36465,國宅,1,607050,0.00016199,98.33858735
36466,國安會,1,607051,0.00016199,98.33874934
36467,國有地,1,607052,0.00016199,98.33891133
36468,國有財產局,1,607053,0.00016199,98.33907333
36469,國技,1,607054,0.00016199,98.33923532
36470,國防工業,1,607055,0.00016199,98.33939732
36471,國防委員會,1,607056,0.00016199,98.33955931
36472,國事,1,607057,0.00016199,98.33972131
36473,國協,1,607058,0.00016199,98.33988330
36474,國姓橋,1,607059,0.00016199,98.34004529
36475,國東半島,1,607060,0.00016199,98.34020729
36476,國門,1,607061,0.00016199,98.34036928
36477,國建班,1,607062,0.00016199,98.34053128
36478,國是,1,607063,0.00016199,98.34069327
36479,國是會議,1,607064,0.00016199,98.34085526
36480,國科會主委,1,607065,0.00016199,98.34101726
36481,國軍退除役官兵俸,1,607066,0.00016199,98.34117925
36482,國家地理雜誌,1,607067,0.00016199,98.34134125
36483,國家安全局,1,607068,0.00016199,98.34150324
36484,國家杯,1,607069,0.00016199,98.34166524
36485,國家紀念日,1,607070,0.00016199,98.34182723
36486,國家風景區標準,1,607071,0.00016199,98.34198922
36487,國家培訓隊,1,607072,0.00016199,98.34215122
36488,國家隊,1,607073,0.00016199,98.34231321
36489,國家賠償,1,607074,0.00016199,98.34247521
36490,國家賠償法,1,607075,0.00016199,98.34263720
36491,國家聯盟賽,1,607076,0.00016199,98.34279920
36492,國家藝術修復院,1,607077,0.00016199,98.34296119
36493,國庫署長,1,607078,0.00016199,98.34312318
36494,國恥,1,607079,0.00016199,98.34328518
36495,國泰民安,1,607080,0.00016199,98.34344717
36496,國泰建設,1,607081,0.00016199,98.34360917
36497,國泰航空,1,607082,0.00016199,98.34377116
36498,國情,1,607083,0.00016199,98.34393315
36499,國教司,1,607084,0.00016199,98.34409515
36500,國產化,1,607085,0.00016199,98.34425714
36501,國產車,1,607086,0.00016199,98.34441914
36502,國產品,1,607087,0.00016199,98.34458113
36503,國產貨,1,607088,0.00016199,98.34474313
36504,國眾,1,607089,0.00016199,98.34490512
36505,國貨,1,607090,0.00016199,98.34506711
36506,國造,1,607091,0.00016199,98.34522911
36507,國畫,1,607092,0.00016199,98.34539110
36508,國策,1,607093,0.00016199,98.34555310
36509,國華,1,607094,0.00016199,98.34571509
36510,國華航空,1,607095,0.00016199,98.34587709
36511,國華航空公司,1,607096,0.00016199,98.34603908
36512,國新投資,1,607097,0.00016199,98.34620107
36513,國會山莊,1,607098,0.00016199,98.34636307
36514,國會議長,1,607099,0.00016199,98.34652506
36515,國語日報,1,607100,0.00016199,98.34668706
36516,國賓,1,607101,0.00016199,98.34684905
36517,國際母奶會,1,607102,0.00016199,98.34701104
36518,國際全球資訊網,1,607103,0.00016199,98.34717304
36519,國際收支帳,1,607104,0.00016199,98.34733503
36520,國際自然生態保育組織,1,607105,0.00016199,98.34749703
36521,國際法,1,607106,0.00016199,98.34765902
36522,國際版,1,607107,0.00016199,98.34782102
36523,國際花友會,1,607108,0.00016199,98.34798301
36524,國際品保證書,1,607109,0.00016199,98.34814500
36525,國際政治研究所,1,607110,0.00016199,98.34830700
36526,國際級,1,607111,0.00016199,98.34846899
36527,國際商港,1,607112,0.00016199,98.34863099
36528,國際商業機器公司,1,607113,0.00016199,98.34879298
36529,國際組織,1,607114,0.00016199,98.34895498
36530,國際貨幣基金,1,607115,0.00016199,98.34911697
36531,國際期刊,1,607116,0.00016199,98.34927896
36532,國際渦輪發動機公司,1,607117,0.00016199,98.34944096
36533,國際牌按摩棒,1,607118,0.00016199,98.34960295
36534,國際貿易局,1,607119,0.00016199,98.34976495
36535,國際貿易促進會,1,607120,0.00016199,98.34992694
36536,國際匯市,1,607121,0.00016199,98.35008893
36537,國際經貿組織,1,607122,0.00016199,98.35025093
36538,國際電話費,1,607123,0.00016199,98.35041292
36539,國際網球賽,1,607124,0.00016199,98.35057492
36540,國際影展,1,607125,0.00016199,98.35073691
36541,國際影展化,1,607126,0.00016199,98.35089891
36542,國際數據集團,1,607127,0.00016199,98.35106090
36543,國際標,1,607128,0.00016199,98.35122289
36544,國際潛水執照,1,607129,0.00016199,98.35138489
36545,國際衛星電視,1,607130,0.00016199,98.35154688
36546,國際關係,1,607131,0.00016199,98.35170888
36547,國際關係研究中心,1,607132,0.00016199,98.35187087
36548,國劇,1,607133,0.00016199,98.35203287
36549,國慶,1,607134,0.00016199,98.35219486
36550,國學,1,607135,0.00016199,98.35235685
36551,國曆,1,607136,0.00016199,98.35251885
36552,國興衛視,1,607137,0.00016199,98.35268084
36553,國營事業,1,607138,0.00016199,98.35284284
36554,國營會,1,607139,0.00016199,98.35300483
36555,國聯太空人,1,607140,0.00016199,98.35316682
36556,國寶級,1,607141,0.00016199,98.35332882
36557,國寶魚,1,607142,0.00016199,98.35349081
36558,堅持不下,1,607143,0.00016199,98.35365281
36559,堅穩,1,607144,0.00016199,98.35381480
36560,堆成,1,607145,0.00016199,98.35397680
36561,堆砌,1,607146,0.00016199,98.35413879
36562,堆滿,1,607147,0.00016199,98.35430078
36563,堆積木,1,607148,0.00016199,98.35446278
36564,堆積如山,1,607149,0.00016199,98.35462477
36565,堆積物,1,607150,0.00016199,98.35478677
36566,埠,1,607151,0.00016199,98.35494876
36567,基士．德勒茲,1,607152,0.00016199,98.35511076
36568,基化,1,607153,0.00016199,98.35527275
36569,基本上,1,607154,0.00016199,98.35543474
36570,基本色,1,607155,0.00016199,98.35559674
36571,基本法,1,607156,0.00016199,98.35575873
36572,基本金屬,1,607157,0.00016199,98.35592073
36573,基本型,1,607158,0.00016199,98.35608272
36574,基本頻道,1,607159,0.00016199,98.35624471
36575,基洛夫,1,607160,0.00016199,98.35640671
36576,基期,1,607161,0.00016199,98.35656870
36577,基隆中學,1,607162,0.00016199,98.35673070
36578,基隆市軍人服務站,1,607163,0.00016199,98.35689269
36579,基隆報關公會,1,607164,0.00016199,98.35705469
36580,基隆路,1,607165,0.00016199,98.35721668
36581,基塔許城,1,607166,0.00016199,98.35737867
36582,基準值,1,607167,0.00016199,98.35754067
36583,基督山恩仇記,1,607168,0.00016199,98.35770266
36584,基督教科學箴言報,1,607169,0.00016199,98.35786466
36585,基徹爾,1,607170,0.00016199,98.35802665
36586,基爾羅伊市,1,607171,0.00016199,98.35818865
36587,基礎地,1,607172,0.00016199,98.35835064
36588,堂兄,1,607173,0.00016199,98.35851263
36589,堂奧,1,607174,0.00016199,98.35867463
36590,堵塞,1,607175,0.00016199,98.35883662
36591,執行性,1,607176,0.00016199,98.35899862
36592,執行秘書,1,607177,0.00016199,98.35916061
36593,執行副總,1,607178,0.00016199,98.35932260
36594,執行董事,1,607179,0.00016199,98.35948460
36595,執行總監,1,607180,0.00016199,98.35964659
36596,執事者,1,607181,0.00016199,98.35980859
36597,執法單位,1,607182,0.00016199,98.35997058
36598,執政者,1,607183,0.00016199,98.36013258
36599,執教,1,607184,0.00016199,98.36029457
36600,執掌,1,607185,0.00016199,98.36045656
36601,執筆,1,607186,0.00016199,98.36061856
36602,執業牌,1,607187,0.00016199,98.36078055
36603,培克斯號,1,607188,0.00016199,98.36094255
36604,培根麵,1,607189,0.00016199,98.36110454
36605,培訓隊,1,607190,0.00016199,98.36126654
36606,培基,1,607191,0.00016199,98.36142853
36607,奢華,1,607192,0.00016199,98.36159052
36608,婉兒,1,607193,0.00016199,98.36175252
36609,婦女界,1,607194,0.00016199,98.36191451
36610,婦產科醫學會國際研討會,1,607195,0.00016199,98.36207651
36611,婦孺,1,607196,0.00016199,98.36223850
36612,娼妓,1,607197,0.00016199,98.36240050
36613,娼賭,1,607198,0.00016199,98.36256249
36614,婚外情,1,607199,0.00016199,98.36272448
36615,婚前性行為,1,607200,0.00016199,98.36288648
36616,婚嫁,1,607201,0.00016199,98.36304847
36617,婆娑,1,607202,0.00016199,98.36321047
36618,婆羅洲,1,607203,0.00016199,98.36337246
36619,孰知,1,607204,0.00016199,98.36353445
36620,孰料,1,607205,0.00016199,98.36369645
36621,寅,1,607206,0.00016199,98.36385844
36622,寄主蟲,1,607207,0.00016199,98.36402044
36623,寄出,1,607208,0.00016199,98.36418243
36624,寄生菌,1,607209,0.00016199,98.36434443
36625,寄命,1,607210,0.00016199,98.36450642
36626,寄居,1,607211,0.00016199,98.36466841
36627,寄居蟹,1,607212,0.00016199,98.36483041
36628,寄信人,1,607213,0.00016199,98.36499240
36629,寄送,1,607214,0.00016199,98.36515440
36630,寂,1,607215,0.00016199,98.36531639
36631,寂寥,1,607216,0.00016199,98.36547839
36632,寂靜,1,607217,0.00016199,98.36564038
36633,宿敵,1,607218,0.00016199,98.36580237
36634,密不可分,1,607219,0.00016199,98.36596437
36635,密不透風,1,607220,0.00016199,98.36612636
36636,密布,1,607221,0.00016199,98.36628836
36637,密合,1,607222,0.00016199,98.36645035
36638,密西西比,1,607223,0.00016199,98.36661234
36639,密西西比州大,1,607224,0.00016199,98.36677434
36640,密西根小學,1,607225,0.00016199,98.36693633
36641,密佈,1,607226,0.00016199,98.36709833
36642,密林,1,607227,0.00016199,98.36726032
36643,密封形,1,607228,0.00016199,98.36742232
36644,密探,1,607229,0.00016199,98.36758431
36645,密勤局,1,607230,0.00016199,98.36774630
36646,密電,1,607231,0.00016199,98.36790830
36647,密爾福,1,607232,0.00016199,98.36807029
36648,密談,1,607233,0.00016199,98.36823229
36649,密錄,1,607234,0.00016199,98.36839428
36650,尉遲恭,1,607235,0.00016199,98.36855628
36651,專刊,1,607236,0.00016199,98.36871827
36652,專用道,1,607237,0.00016199,98.36888026
36653,專任,1,607238,0.00016199,98.36904226
36654,專有,1,607239,0.00016199,98.36920425
36655,專利法,1,607240,0.00016199,98.36936625
36656,專利品,1,607241,0.00016199,98.36952824
36657,專利商標審查基準,1,607242,0.00016199,98.36969023
36658,專利處,1,607243,0.00016199,98.36985223
36659,專制,1,607244,0.00016199,98.37001422
36660,專科學校,1,607245,0.00016199,98.37017622
36661,專家獎,1,607246,0.00016199,98.37033821
36662,專案人員,1,607247,0.00016199,98.37050021
36663,專款,1,607248,0.00016199,98.37066220
36664,專項,1,607249,0.00016199,98.37082419
36665,專業型,1,607250,0.00016199,98.37098619
36666,專業區,1,607251,0.00016199,98.37114818
36667,專稿,1,607252,0.00016199,98.37131018
36668,專賣場,1,607253,0.00016199,98.37147217
36669,專擅,1,607254,0.00016199,98.37163417
36670,專營,1,607255,0.00016199,98.37179616
36671,專櫃人員,1,607256,0.00016199,98.37195815
36672,專權,1,607257,0.00016199,98.37212015
36673,將才,1,607258,0.00016199,98.37228214
36674,將本求利,1,607259,0.00016199,98.37244414
36675,將有,1,607260,0.00016199,98.37260613
36676,將至,1,607261,0.00016199,98.37276812
36677,將官班,1,607262,0.00016199,98.37293012
36678,將門,1,607263,0.00016199,98.37309211
36679,將門獅子吼,1,607264,0.00016199,98.37325411
36680,將要,1,607265,0.00016199,98.37341610
36681,將軍鄉,1,607266,0.00016199,98.37357810
36682,屠,1,607267,0.00016199,98.37374009
36683,屠宰公會,1,607268,0.00016199,98.37390208
36684,屠格涅夫,1,607269,0.00016199,98.37406408
36685,屠戮,1,607270,0.00016199,98.37422607
36686,崇,1,607271,0.00016199,98.37438807
36687,崇山,1,607272,0.00016199,98.37455006
36688,崇仰路,1,607273,0.00016199,98.37471206
36689,崇光百貨,1,607274,0.00016199,98.37487405
36690,崇拜者,1,607275,0.00016199,98.37503604
36691,崛,1,607276,0.00016199,98.37519804
36692,崖底,1,607277,0.00016199,98.37536003
36693,崖壁,1,607278,0.00016199,98.37552203
36694,崖邊,1,607279,0.00016199,98.37568402
36695,崢嶸,1,607280,0.00016199,98.37584601
36696,崑,1,607281,0.00016199,98.37600801
36697,崑崙山,1,607282,0.00016199,98.37617000
36698,崩裂,1,607283,0.00016199,98.37633200
36699,崩跌,1,607284,0.00016199,98.37649399
36700,崩塌,1,607285,0.00016199,98.37665599
36701,崩解,1,607286,0.00016199,98.37681798
36702,崩壞,1,607287,0.00016199,98.37697997
36703,崔西烏曼,1,607288,0.00016199,98.37714197
36704,崔苔菁,1,607289,0.00016199,98.37730396
36705,崔國雄,1,607290,0.00016199,98.37746596
36706,崔德龍,1,607291,0.00016199,98.37762795
36707,崗山,1,607292,0.00016199,98.37778995
36708,巢裏,1,607293,0.00016199,98.37795194
36709,常久,1,607294,0.00016199,98.37811393
36710,常州,1,607295,0.00016199,98.37827593
36711,常委,1,607296,0.00016199,98.37843792
36712,常秉祥,1,607297,0.00016199,98.37859992
36713,常春藤,1,607298,0.00016199,98.37876191
36714,常務次長,1,607299,0.00016199,98.37892390
36715,常務委員,1,607300,0.00016199,98.37908590
36716,常務理事,1,607301,0.00016199,98.37924789
36717,常設化,1,607302,0.00016199,98.37940989
36718,常設性,1,607303,0.00016199,98.37957188
36719,常楓,1,607304,0.00016199,98.37973388
36720,常溫,1,607305,0.00016199,98.37989587
36721,常董事,1,607306,0.00016199,98.38005786
36722,常態性,1,607307,0.00016199,98.38021986
36723,常綠喬木,1,607308,0.00016199,98.38038185
36724,常綠闊葉樹,1,607309,0.00016199,98.38054385
36725,常駐,1,607310,0.00016199,98.38070584
36726,帶子,1,607311,0.00016199,98.38086784
36727,帶位,1,607312,0.00016199,98.38102983
36728,帶原,1,607313,0.00016199,98.38119182
36729,帶原率,1,607314,0.00016199,98.38135382
36730,帶氧血,1,607315,0.00016199,98.38151581
36731,帶起來,1,607316,0.00016199,98.38167781
36732,帶帶看,1,607317,0.00016199,98.38183980
36733,帶領者,1,607318,0.00016199,98.38200179
36734,帶離,1,607319,0.00016199,98.38216379
36735,帳戶號碼,1,607320,0.00016199,98.38232578
36736,帳房,1,607321,0.00016199,98.38248778
36737,帳款,1,607322,0.00016199,98.38264977
36738,帳蓬式,1,607323,0.00016199,98.38281177
36739,康乃狄克,1,607324,0.00016199,98.38297376
36740,康乃爾,1,607325,0.00016199,98.38313575
36741,康大資訊公司,1,607326,0.00016199,98.38329775
36742,康那克,1,607327,0.00016199,98.38345974
36743,康和,1,607328,0.00016199,98.38362174
36744,康定級二代艦,1,607329,0.00016199,98.38378373
36745,康定斯基,1,607330,0.00016199,98.38394573
36746,康定號巡防艦,1,607331,0.00016199,98.38410772
36747,康果爾德,1,607332,0.00016199,98.38426971
36748,康柏,1,607333,0.00016199,98.38443171
36749,康柏公司,1,607334,0.00016199,98.38459370
36750,康泰時攝影俱樂部,1,607335,0.00016199,98.38475570
36751,康得斯迪,1,607336,0.00016199,98.38491769
36752,康復,1,607337,0.00016199,98.38507968
36753,康嘉偉,1,607338,0.00016199,98.38524168
36754,康寧,1,607339,0.00016199,98.38540367
36755,康寧三寶,1,607340,0.00016199,98.38556567
36756,康德,1,607341,0.00016199,98.38572766
36757,康樂,1,607342,0.00016199,98.38588966
36758,康懋達,1,607343,0.00016199,98.38605165
36759,張三郎賣茶,1,607344,0.00016199,98.38621364
36760,張大千,1,607345,0.00016199,98.38637564
36761,張大春工作室,1,607346,0.00016199,98.38653763
36762,張子弘,1,607347,0.00016199,98.38669963
36763,張川田,1,607348,0.00016199,98.38686162
36764,張天麟,1,607349,0.00016199,98.38702362
36765,張少校,1,607350,0.00016199,98.38718561
36766,張文英,1,607351,0.00016199,98.38734760
36767,張文雄,1,607352,0.00016199,98.38750960
36768,張文輝,1,607353,0.00016199,98.38767159
36769,張世昌,1,607354,0.00016199,98.38783359
36770,張本賢,1,607355,0.00016199,98.38799558
36771,張正義,1,607356,0.00016199,98.38815757
36772,張玉法,1,607357,0.00016199,98.38831957
36773,張玉嬿,1,607358,0.00016199,98.38848156
36774,張立義,1,607359,0.00016199,98.38864356
36775,張安平,1,607360,0.00016199,98.38880555
36776,張安樂,1,607361,0.00016199,98.38896755
36777,張艾嘉,1,607362,0.00016199,98.38912954
36778,張伯欣,1,607363,0.00016199,98.38929153
36779,張克帆,1,607364,0.00016199,98.38945353
36780,張步桃,1,607365,0.00016199,98.38961552
36781,張秀政,1,607366,0.00016199,98.38977752
36782,張育誠,1,607367,0.00016199,98.38993951
36783,張忠謀,1,607368,0.00016199,98.39010151
36784,張怡文,1,607369,0.00016199,98.39026350
36785,張明在,1,607370,0.00016199,98.39042549
36786,張治亞,1,607371,0.00016199,98.39058749
36787,張炎元,1,607372,0.00016199,98.39074948
36788,張俊宏,1,607373,0.00016199,98.39091148
36789,張俊雄,1,607374,0.00016199,98.39107347
36790,張春芳,1,607375,0.00016199,98.39123547
36791,張柏東,1,607376,0.00016199,98.39139746
36792,張修治,1,607377,0.00016199,98.39155945
36793,張振字,1,607378,0.00016199,98.39172145
36794,張振隆,1,607379,0.00016199,98.39188344
36795,張國安,1,607380,0.00016199,98.39204544
36796,張國榮,1,607381,0.00016199,98.39220743
36797,張張,1,607382,0.00016199,98.39236942
36798,張教練,1,607383,0.00016199,98.39253142
36799,張清,1,607384,0.00016199,98.39269341
36800,張雪惠,1,607385,0.00016199,98.39285541
36801,張凱蒂,1,607386,0.00016199,98.39301740
36802,張博雅,1,607387,0.00016199,98.39317940
36803,張堯勇,1,607388,0.00016199,98.39334139
36804,張景瑞,1,607389,0.00016199,98.39350338
36805,張隆盛,1,607390,0.00016199,98.39366538
36806,張殿,1,607391,0.00016199,98.39382737
36807,張照堂,1,607392,0.00016199,98.39398937
36808,張瑞芳,1,607393,0.00016199,98.39415136
36809,張筧,1,607394,0.00016199,98.39431336
36810,張義宮,1,607395,0.00016199,98.39447535
36811,張嘉添,1,607396,0.00016199,98.39463734
36812,張廖簡,1,607397,0.00016199,98.39479934
36813,張榮仁,1,607398,0.00016199,98.39496133
36814,張榮味,1,607399,0.00016199,98.39512333
36815,張蒼松,1,607400,0.00016199,98.39528532
36816,張鳳育,1,607401,0.00016199,98.39544731
36817,張德培,1,607402,0.00016199,98.39560931
36818,張震,1,607403,0.00016199,98.39577130
36819,張學倫,1,607404,0.00016199,98.39593330
36820,張憲安,1,607405,0.00016199,98.39609529
36821,張憲銘,1,607406,0.00016199,98.39625729
36822,張曉卿,1,607407,0.00016199,98.39641928
36823,張燈,1,607408,0.00016199,98.39658127
36824,張錦弘,1,607409,0.00016199,98.39674327
36825,張麗君,1,607410,0.00016199,98.39690526
36826,張麗莉,1,607411,0.00016199,98.39706726
36827,張寶珠,1,607412,0.00016199,98.39722925
36828,張露,1,607413,0.00016199,98.39739125
36829,強力拖吊,1,607414,0.00016199,98.39755324
36830,強力膠,1,607415,0.00016199,98.39771523
36831,強化壓克力,1,607416,0.00016199,98.39787723
36832,強心針,1,607417,0.00016199,98.39803922
36833,強打,1,607418,0.00016199,98.39820122
36834,強打者,1,607419,0.00016199,98.39836321
36835,強生,1,607420,0.00016199,98.39852520
36836,強有力,1,607421,0.00016199,98.39868720
36837,強壯,1,607422,0.00016199,98.39884919
36838,強制汽車責任保險法,1,607423,0.00016199,98.39901119
36839,強制執行,1,607424,0.00016199,98.39917318
36840,強制執行法,1,607425,0.00016199,98.39933518
36841,強流,1,607426,0.00016199,98.39949717
36842,強迫式,1,607427,0.00016199,98.39965916
36843,強棒,1,607428,0.00016199,98.39982116
36844,強盜集團,1,607429,0.00016199,98.39998315
36845,強韌度,1,607430,0.00016199,98.40014515
36846,強奪,1,607431,0.00016199,98.40030714
36847,強豪,1,607432,0.00016199,98.40046914
36848,強暴者,1,607433,0.00016199,98.40063113
36849,強震,1,607434,0.00016199,98.40079312
36850,強擊機,1,607435,0.00016199,98.40095512
36851,強檔,1,607436,0.00016199,98.40111711
36852,彗者,1,607437,0.00016199,98.40127911
36853,彗星來的那一年,1,607438,0.00016199,98.40144110
36854,彬山公司,1,607439,0.00016199,98.40160309
36855,彬山企業公司,1,607440,0.00016199,98.40176509
36856,彬彬,1,607441,0.00016199,98.40192708
36857,彩色掃瞄器,1,607442,0.00016199,98.40208908
36858,彩妝師,1,607443,0.00016199,98.40225107
36859,彩券,1,607444,0.00016199,98.40241307
36860,彩虹,1,607445,0.00016199,98.40257506
36861,彩虹攝影藝廊,1,607446,0.00016199,98.40273705
36862,彩帶,1,607447,0.00016199,98.40289905
36863,彩照,1,607448,0.00016199,98.40306104
36864,彩圖,1,607449,0.00016199,98.40322304
36865,得失,1,607450,0.00016199,98.40338503
36866,得失心,1,607451,0.00016199,98.40354703
36867,得志型,1,607452,0.00016199,98.40370902
36868,得益,1,607453,0.00016199,98.40387101
36869,得康牌,1,607454,0.00016199,98.40403301
36870,得救,1,607455,0.00016199,98.40419500
36871,得意洋洋,1,607456,0.00016199,98.40435700
36872,得贏,1,607457,0.00016199,98.40451899
36873,從一而終,1,607458,0.00016199,98.40468098
36874,從上到下,1,607459,0.00016199,98.40484298
36875,從此以後,1,607460,0.00016199,98.40500497
36876,從長計議,1,607461,0.00016199,98.40516697
36877,從軍,1,607462,0.00016199,98.40532896
36878,從容不迫,1,607463,0.00016199,98.40549096
36879,從從容容,1,607464,0.00016199,98.40565295
36880,從善如流,1,607465,0.00016199,98.40581494
36881,御林樣萬萬歲,1,607466,0.00016199,98.40597694
36882,御花園,1,607467,0.00016199,98.40613893
36883,御前秘方,1,607468,0.00016199,98.40630093
36884,御座,1,607469,0.00016199,98.40646292
36885,徜佯,1,607470,0.00016199,98.40662492
36886,悠哉,1,607471,0.00016199,98.40678691
36887,悠悠,1,607472,0.00016199,98.40694890
36888,悠游自在,1,607473,0.00016199,98.40711090
36889,惋惜不已,1,607474,0.00016199,98.40727289
36890,惦念,1,607475,0.00016199,98.40743489
36891,悽惶,1,607476,0.00016199,98.40759688
36892,悽慘,1,607477,0.00016199,98.40775887
36893,情人節,1,607478,0.00016199,98.40792087
36894,情不自禁,1,607479,0.00016199,98.40808286
36895,情如手足,1,607480,0.00016199,98.40824486
36896,情有可原,1,607481,0.00016199,98.40840685
36897,情何以堪,1,607482,0.00016199,98.40856885
36898,情治,1,607483,0.00016199,98.40873084
36899,情侶裝,1,607484,0.00016199,98.40889283
36900,情面,1,607485,0.00016199,98.40905483
36901,情海,1,607486,0.00016199,98.40921682
36902,情商,1,607487,0.00016199,98.40937882
36903,情婦,1,607488,0.00016199,98.40954081
36904,情欲,1,607489,0.00016199,98.40970281
36905,情理,1,607490,0.00016199,98.40986480
36906,情場,1,607491,0.00016199,98.41002679
36907,情報人員,1,607492,0.00016199,98.41018879
36908,情報官員,1,607493,0.00016199,98.41035078
36909,情報員,1,607494,0.00016199,98.41051278
36910,情感戲,1,607495,0.00016199,98.41067477
36911,情愛,1,607496,0.00016199,98.41083676
36912,情網難逃,1,607497,0.00016199,98.41099876
36913,情緒．心情．感覺,1,607498,0.00016199,98.41116075
36914,情慾影片,1,607499,0.00016199,98.41132275
36915,情敵,1,607500,0.00016199,98.41148474
36916,情緣,1,607501,0.00016199,98.41164674
36917,情趣商店,1,607502,0.00016199,98.41180873
36918,情鍾,1,607503,0.00016199,98.41197072
36919,情關,1,607504,0.00016199,98.41213272
36920,情竇初開,1,607505,0.00016199,98.41229471
36921,悸動,1,607506,0.00016199,98.41245671
36922,戛然而止,1,607507,0.00016199,98.41261870
36923,掠過,1,607508,0.00016199,98.41278070
36924,掠奪,1,607509,0.00016199,98.41294269
36925,控方,1,607510,0.00016199,98.41310468
36926,控台,1,607511,0.00016199,98.41326668
36927,控制台,1,607512,0.00016199,98.41342867
36928,控制面,1,607513,0.00016199,98.41359067
36929,控制鍵,1,607514,0.00016199,98.41375266
36930,控盤,1,607515,0.00016199,98.41391465
36931,捲土重來,1,607516,0.00016199,98.41407665
36932,捲片馬達,1,607517,0.00016199,98.41423864
36933,捲曲,1,607518,0.00016199,98.41440064
36934,捲動,1,607519,0.00016199,98.41456263
36935,捲筒,1,607520,0.00016199,98.41472463
36936,捲進,1,607521,0.00016199,98.41488662
36937,捲雲,1,607522,0.00016199,98.41504861
36938,探戈,1,607523,0.00016199,98.41521061
36939,探求,1,607524,0.00016199,98.41537260
36940,探底,1,607525,0.00016199,98.41553460
36941,探知,1,607526,0.00016199,98.41569659
36942,探勘,1,607527,0.00016199,98.41585859
36943,探訪函,1,607528,0.00016199,98.41602058
36944,探源,1,607529,0.00016199,98.41618257
36945,探詢,1,607530,0.00016199,98.41634457
36946,接二連三,1,607531,0.00016199,98.41650656
36947,接下,1,607532,0.00016199,98.41666856
36948,接手者,1,607533,0.00016199,98.41683055
36949,接生,1,607534,0.00016199,98.41699254
36950,接用,1,607535,0.00016199,98.41715454
36951,接回,1,607536,0.00016199,98.41731653
36952,接地線,1,607537,0.00016199,98.41747853
36953,接地點,1,607538,0.00016199,98.41764052
36954,接收者,1,607539,0.00016199,98.41780252
36955,接見,1,607540,0.00016199,98.41796451
36956,接受力,1,607541,0.00016199,98.41812650
36957,接受度,1,607542,0.00016199,98.41828850
36958,接受器,1,607543,0.00016199,98.41845049
36959,接往,1,607544,0.00016199,98.41861249
36960,接迎,1,607545,0.00016199,98.41877448
36961,接殺,1,607546,0.00016199,98.41893648
36962,接球,1,607547,0.00016199,98.41909847
36963,接腳,1,607548,0.00016199,98.41926046
36964,接演,1,607549,0.00016199,98.41942246
36965,接駁,1,607550,0.00016199,98.41958445
36966,接機,1,607551,0.00016199,98.41974645
36967,接踵而來,1,607552,0.00016199,98.41990844
36968,接辦,1,607553,0.00016199,98.42007044
36969,接點,1,607554,0.00016199,98.42023243
36970,接觸式影晶,1,607555,0.00016199,98.42039442
36971,接觸傳染,1,607556,0.00016199,98.42055642
36972,接聽,1,607557,0.00016199,98.42071841
36973,捷,1,607558,0.00016199,98.42088041
36974,捷幼公司,1,607559,0.00016199,98.42104240
36975,捷幼實業股份有限公司,1,607560,0.00016199,98.42120439
36976,捷克人,1,607561,0.00016199,98.42136639
36977,捷克卡羅威發利國際電影節特別獎,1,607562,0.00016199,98.42152838
36978,捷克隊,1,607563,0.00016199,98.42169038
36979,捷勤公司,1,607564,0.00016199,98.42185237
36980,捷勤企業,1,607565,0.00016199,98.42201437
36981,捷運內湖延伸線,1,607566,0.00016199,98.42217636
36982,捷運木柵線,1,607567,0.00016199,98.42233835
36983,捷運站,1,607568,0.00016199,98.42250035
36984,捧腹,1,607569,0.00016199,98.42266234
36985,措,1,607570,0.00016199,98.42282434
36986,措手不及,1,607571,0.00016199,98.42298633
36987,措辭,1,607572,0.00016199,98.42314833
36988,捱,1,607573,0.00016199,98.42331032
36989,掩耳,1,607574,0.00016199,98.42347231
36990,掩肥,1,607575,0.00016199,98.42363431
36991,掩映,1,607576,0.00016199,98.42379630
36992,掩飾,1,607577,0.00016199,98.42395830
36993,掩體,1,607578,0.00016199,98.42412029
36994,掉淚,1,607579,0.00016199,98.42428228
36995,掉進,1,607580,0.00016199,98.42444428
36996,掉錢,1,607581,0.00016199,98.42460627
36997,掃地,1,607582,0.00016199,98.42476827
36998,掃把,1,607583,0.00016199,98.42493026
36999,掃射,1,607584,0.00016199,98.42509226
37000,掃掃地,1,607585,0.00016199,98.42525425
37001,掃清,1,607586,0.00016199,98.42541624
37002,掃描機,1,607587,0.00016199,98.42557824
37003,掃視,1,607588,0.00016199,98.42574023
37004,掃進,1,607589,0.00016199,98.42590223
37005,掃落,1,607590,0.00016199,98.42606422
37006,掃雷,1,607591,0.00016199,98.42622622
37007,掃雷艇,1,607592,0.00016199,98.42638821
37008,掃瞄,1,607593,0.00016199,98.42655020
37009,掃瞄器,1,607594,0.00016199,98.42671220
37010,掛上,1,607595,0.00016199,98.42687419
37011,掛掉,1,607596,0.00016199,98.42703619
37012,掛號台,1,607597,0.00016199,98.42719818
37013,掛鉤,1,607598,0.00016199,98.42736017
37014,掛糊,1,607599,0.00016199,98.42752217
37015,推入,1,607600,0.00016199,98.42768416
37016,推力,1,607601,0.00016199,98.42784616
37017,推土機,1,607602,0.00016199,98.42800815
37018,推至,1,607603,0.00016199,98.42817015
37019,推挽式,1,607604,0.00016199,98.42833214
37020,推崇備至,1,607605,0.00016199,98.42849413
37021,推理,1,607606,0.00016199,98.42865613
37022,推想,1,607607,0.00016199,98.42881812
37023,推演,1,607608,0.00016199,98.42898012
37024,推廣科,1,607609,0.00016199,98.42914211
37025,推薦權,1,607610,0.00016199,98.42930411
37026,授乳期,1,607611,0.00016199,98.42946610
37027,授信,1,607612,0.00016199,98.42962809
37028,授意,1,607613,0.00016199,98.42979009
37029,採瓜,1,607614,0.00016199,98.42995208
37030,採光,1,607615,0.00016199,98.43011408
37031,採收,1,607616,0.00016199,98.43027607
37032,採果行,1,607617,0.00016199,98.43043806
37033,採信,1,607618,0.00016199,98.43060006
37034,採茶,1,607619,0.00016199,98.43076205
37035,採討,1,607620,0.00016199,98.43092405
37036,採訪組,1,607621,0.00016199,98.43108604
37037,採訪團,1,607622,0.00016199,98.43124804
37038,採買,1,607623,0.00016199,98.43141003
37039,採購團,1,607624,0.00016199,98.43157202
37040,採購學,1,607625,0.00016199,98.43173402
37041,排山倒海,1,607626,0.00016199,98.43189601
37042,排比,1,607627,0.00016199,98.43205801
37043,排外,1,607628,0.00016199,98.43222000
37044,排卵期,1,607629,0.00016199,98.43238200
37045,排卵藥,1,607630,0.00016199,98.43254399
37046,排放量,1,607631,0.00016199,98.43270598
37047,排泄,1,607632,0.00016199,98.43286798
37048,排氣孔,1,607633,0.00016199,98.43302997
37049,排氣管,1,607634,0.00016199,98.43319197
37050,排翅,1,607635,0.00016199,98.43335396
37051,排骨,1,607636,0.00016199,98.43351595
37052,排球,1,607637,0.00016199,98.43367795
37053,排開,1,607638,0.00016199,98.43383994
37054,排煙,1,607639,0.00016199,98.43400194
37055,排解,1,607640,0.00016199,98.43416393
37056,排滿,1,607641,0.00016199,98.43432593
37057,排戲,1,607642,0.00016199,98.43448792
37058,排檔,1,607643,0.00016199,98.43464991
37059,排檔座,1,607644,0.00016199,98.43481191
37060,排檔頭,1,607645,0.00016199,98.43497390
37061,排檔鎖,1,607646,0.00016199,98.43513590
37062,排灣族,1,607647,0.00016199,98.43529789
37063,掏出來,1,607648,0.00016199,98.43545989
37064,掏空,1,607649,0.00016199,98.43562188
37065,掀開,1,607650,0.00016199,98.43578387
37066,捨己為人,1,607651,0.00016199,98.43594587
37067,捺,1,607652,0.00016199,98.43610786
37068,救火隊長,1,607653,0.00016199,98.43626986
37069,救世主,1,607654,0.00016199,98.43643185
37070,救世主塔,1,607655,0.00016199,98.43659384
37071,救生衣,1,607656,0.00016199,98.43675584
37072,救生圈,1,607657,0.00016199,98.43691783
37073,救助隊,1,607658,0.00016199,98.43707983
37074,救起來,1,607659,0.00016199,98.43724182
37075,救援成功,1,607660,0.00016199,98.43740382
37076,救濟金,1,607661,0.00016199,98.43756581
37077,救難組織,1,607662,0.00016199,98.43772780
37078,教人,1,607663,0.00016199,98.43788980
37079,教父,1,607664,0.00016199,98.43805179
37080,教父級,1,607665,0.00016199,98.43821379
37081,教育文化處,1,607666,0.00016199,98.43837578
37082,教育部文化局,1,607667,0.00016199,98.43853778
37083,教育審查小組,1,607668,0.00016199,98.43869977
37084,教宗,1,607669,0.00016199,98.43886176
37085,教長,1,607670,0.00016199,98.43902376
37086,教派,1,607671,0.00016199,98.43918575
37087,教皇,1,607672,0.00016199,98.43934775
37088,教胞,1,607673,0.00016199,98.43950974
37089,教徒,1,607674,0.00016199,98.43967173
37090,教義,1,607675,0.00016199,98.43983373
37091,教誨,1,607676,0.00016199,98.43999572
37092,教誨師,1,607677,0.00016199,98.44015772
37093,教練機,1,607678,0.00016199,98.44031971
37094,教課,1,607679,0.00016199,98.44048171
37095,教養,1,607680,0.00016199,98.44064370
37096,教學法,1,607681,0.00016199,98.44080569
37097,教學相長,1,607682,0.00016199,98.44096769
37098,教學研究會,1,607683,0.00016199,98.44112968
37099,教導有方,1,607684,0.00016199,98.44129168
37100,教頭,1,607685,0.00016199,98.44145367
37101,教職,1,607686,0.00016199,98.44161567
37102,敗因,1,607687,0.00016199,98.44177766
37103,敗則為寇,1,607688,0.00016199,98.44193965
37104,敗漏,1,607689,0.00016199,98.44210165
37105,敗銹,1,607690,0.00016199,98.44226364
37106,啟示錄,1,607691,0.00016199,98.44242564
37107,啟阜,1,607692,0.00016199,98.44258763
37108,啟迪,1,607693,0.00016199,98.44274962
37109,啟迪性,1,607694,0.00016199,98.44291162
37110,啟發性,1,607695,0.00016199,98.44307361
37111,啟程,1,607696,0.00016199,98.44323561
37112,啟蒙國際文教機構,1,607697,0.00016199,98.44339760
37113,啟駕,1,607698,0.00016199,98.44355960
37114,敘事,1,607699,0.00016199,98.44372159
37115,敘事詩,1,607700,0.00016199,98.44388358
37116,敘敘舊,1,607701,0.00016199,98.44404558
37117,敘舊,1,607702,0.00016199,98.44420757
37118,斜角,1,607703,0.00016199,98.44436957
37119,斜坡,1,607704,0.00016199,98.44453156
37120,斜倚,1,607705,0.00016199,98.44469356
37121,斜視,1,607706,0.00016199,98.44485555
37122,斬獲,1,607707,0.00016199,98.44501754
37123,斬斷,1,607708,0.00016199,98.44517954
37124,族名,1,607709,0.00016199,98.44534153
37125,族群融合,1,607710,0.00016199,98.44550353
37126,旋,1,607711,0.00016199,98.44566552
37127,旋風咒,1,607712,0.00016199,98.44582752
37128,旋渦浴,1,607713,0.00016199,98.44598951
37129,旋轉起來,1,607714,0.00016199,98.44615150
37130,旋轉椅子,1,607715,0.00016199,98.44631350
37131,旋轉盤,1,607716,0.00016199,98.44647549
37132,晝,1,607717,0.00016199,98.44663749
37133,晝行性,1,607718,0.00016199,98.44679948
37134,晝夜,1,607719,0.00016199,98.44696147
37135,晚安,1,607720,0.00016199,98.44712347
37136,晚秋,1,607721,0.00016199,98.44728546
37137,晚場,1,607722,0.00016199,98.44744746
37138,晚輩,1,607723,0.00016199,98.44760945
37139,晚歸,1,607724,0.00016199,98.44777145
37140,晨昏顛倒,1,607725,0.00016199,98.44793344
37141,晨星出版社,1,607726,0.00016199,98.44809543
37142,晨操,1,607727,0.00016199,98.44825743
37143,晨藹,1,607728,0.00016199,98.44841942
37144,晦暗,1,607729,0.00016199,98.44858142
37145,曹啟泰,1,607730,0.00016199,98.44874341
37146,曹族,1,607731,0.00016199,98.44890541
37147,曹植,1,607732,0.00016199,98.44906740
37148,曹新華,1,607733,0.00016199,98.44922939
37149,曹翠芬,1,607734,0.00016199,98.44939139
37150,曹興誠,1,607735,0.00016199,98.44955338
37151,曹靄琳,1,607736,0.00016199,98.44971538
37152,望女成鳳,1,607737,0.00016199,98.44987737
37153,望子成龍,1,607738,0.00016199,98.45003936
37154,望去,1,607739,0.00016199,98.45020136
37155,望治,1,607740,0.00016199,98.45036335
37156,望能,1,607741,0.00016199,98.45052535
37157,望遠鏡,1,607742,0.00016199,98.45068734
37158,梁,1,607743,0.00016199,98.45084934
37159,梁丹丰,1,607744,0.00016199,98.45101133
37160,梁玉塵,1,607745,0.00016199,98.45117332
37161,梁光明,1,607746,0.00016199,98.45133532
37162,梁成金,1,607747,0.00016199,98.45149731
37163,梁金成,1,607748,0.00016199,98.45165931
37164,梁茂財,1,607749,0.00016199,98.45182130
37165,梁振英,1,607750,0.00016199,98.45198330
37166,梁振英不動產顧問公司,1,607751,0.00016199,98.45214529
37167,梁朝偉,1,607752,0.00016199,98.45230728
37168,梁華棟,1,607753,0.00016199,98.45246928
37169,梁勤佳,1,607754,0.00016199,98.45263127
37170,梁新煌,1,607755,0.00016199,98.45279327
37171,梁樂觀,1,607756,0.00016199,98.45295526
37172,梵文,1,607757,0.00016199,98.45311725
37173,梵帝崗,1,607758,0.00016199,98.45327925
37174,梵樂,1,607759,0.00016199,98.45344124
37175,梵唄,1,607760,0.00016199,98.45360324
37176,梧州,1,607761,0.00016199,98.45376523
37177,梧棲球場,1,607762,0.00016199,98.45392723
37178,梗,1,607763,0.00016199,98.45408922
37179,棄犬,1,607764,0.00016199,98.45425121
37180,梭,1,607765,0.00016199,98.45441321
37181,梭德氏娃,1,607766,0.00016199,98.45457520
37182,梭羅,1,607767,0.00016199,98.45473720
37183,梅林工作室,1,607768,0.00016199,98.45489919
37184,梅林新娘會館,1,607769,0.00016199,98.45506119
37185,梅花,1,607770,0.00016199,98.45522318
37186,梅花三弄,1,607771,0.00016199,98.45538517
37187,梅花肉,1,607772,0.00016199,98.45554717
37188,梅花陣,1,607773,0.00016199,98.45570916
37189,梅雨季節,1,607774,0.00016199,98.45587116
37190,梅泰德,1,607775,0.00016199,98.45603315
37191,梅森,1,607776,0.00016199,98.45619514
37192,梅爾哈里斯,1,607777,0.00016199,98.45635714
37193,梔子花,1,607778,0.00016199,98.45651913
37194,條石,1,607779,0.00016199,98.45668113
37195,條式標示,1,607780,0.00016199,98.45684312
37196,條條,1,607781,0.00016199,98.45700512
37197,條理分明,1,607782,0.00016199,98.45716711
37198,條頓,1,607783,0.00016199,98.45732910
37199,條碼,1,607784,0.00016199,98.45749110
37200,梨山,1,607785,0.00016199,98.45765309
37201,梨園舞坊,1,607786,0.00016199,98.45781509
37202,梨園戲,1,607787,0.00016199,98.45797708
37203,欲言又止,1,607788,0.00016199,98.45813908
37204,欲罷不能,1,607789,0.00016199,98.45830107
37205,殺人未遂,1,607790,0.00016199,98.45846306
37206,殺入,1,607791,0.00016199,98.45862506
37207,殺父,1,607792,0.00016199,98.45878705
37208,殺伐,1,607793,0.00016199,98.45894905
37209,殺低,1,607794,0.00016199,98.45911104
37210,殺青,1,607795,0.00016199,98.45927303
37211,殺戮時刻,1,607796,0.00016199,98.45943503
37212,毫不,1,607797,0.00016199,98.45959702
37213,毫不在乎,1,607798,0.00016199,98.45975902
37214,毫不費力,1,607799,0.00016199,98.45992101
37215,毫無外援,1,607800,0.00016199,98.46008301
37216,毫無意義,1,607801,0.00016199,98.46024500
37217,毫無損失,1,607802,0.00016199,98.46040699
37218,毫無價值,1,607803,0.00016199,98.46056899
37219,毫無關係,1,607804,0.00016199,98.46073098
37220,氫氣,1,607805,0.00016199,98.46089298
37221,氫氧基皮質酮,1,607806,0.00016199,98.46105497
37222,涼台,1,607807,0.00016199,98.46121697
37223,涼性,1,607808,0.00016199,98.46137896
37224,涼拌,1,607809,0.00016199,98.46154095
37225,涼風,1,607810,0.00016199,98.46170295
37226,涼涼,1,607811,0.00016199,98.46186494
37227,涼寒,1,607812,0.00016199,98.46202694
37228,涼補,1,607813,0.00016199,98.46218893
37229,淳樸,1,607814,0.00016199,98.46235092
37230,液化瓦斯,1,607815,0.00016199,98.46251292
37231,液晶,1,607816,0.00016199,98.46267491
37232,液晶顯示,1,607817,0.00016199,98.46283691
37233,淡化霜,1,607818,0.00016199,98.46299890
37234,淡水山海關,1,607819,0.00016199,98.46316090
37235,淡水港,1,607820,0.00016199,98.46332289
37236,淡水鎮區,1,607821,0.00016199,98.46348488
37237,淡色,1,607822,0.00016199,98.46364688
37238,淡妝,1,607823,0.00016199,98.46380887
37239,淡柔,1,607824,0.00016199,98.46397087
37240,淡紅,1,607825,0.00016199,98.46413286
37241,淡海,1,607826,0.00016199,98.46429486
37242,淡粉紅,1,607827,0.00016199,98.46445685
37243,淡彩,1,607828,0.00016199,98.46461884
37244,淡雅,1,607829,0.00016199,98.46478084
37245,淡黃色,1,607830,0.00016199,98.46494283
37246,淡漠,1,607831,0.00016199,98.46510483
37247,淡褐色,1,607832,0.00016199,98.46526682
37248,淌,1,607833,0.00016199,98.46542881
37249,淤塞,1,607834,0.00016199,98.46559081
37250,淤積,1,607835,0.00016199,98.46575280
37251,添加上去,1,607836,0.00016199,98.46591480
37252,添加劑,1,607837,0.00016199,98.46607679
37253,添增,1,607838,0.00016199,98.46623879
37254,淺陋,1,607839,0.00016199,98.46640078
37255,淺粉紅,1,607840,0.00016199,98.46656277
37256,淺野裕子,1,607841,0.00016199,98.46672477
37257,淺野道場,1,607842,0.00016199,98.46688676
37258,淺碟型,1,607843,0.00016199,98.46704876
37259,淺盤,1,607844,0.00016199,98.46721075
37260,淺橘,1,607845,0.00016199,98.46737275
37261,淺藍色,1,607846,0.00016199,98.46753474
37262,淺灘,1,607847,0.00016199,98.46769673
37263,清不清楚,1,607848,0.00016199,98.46785873
37264,清水虔,1,607849,0.00016199,98.46802072
37265,清水鎮,1,607850,0.00016199,98.46818272
37266,清冊,1,607851,0.00016199,98.46834471
37267,清秀,1,607852,0.00016199,98.46850670
37268,清明節,1,607853,0.00016199,98.46866870
37269,清幽,1,607854,0.00016199,98.46883069
37270,清泉崗,1,607855,0.00016199,98.46899269
37271,清泉崗機場,1,607856,0.00016199,98.46915468
37272,清洗起來,1,607857,0.00016199,98.46931668
37273,清風,1,607858,0.00016199,98.46947867
37274,清風徐徐,1,607859,0.00016199,98.46964066
37275,清倉,1,607860,0.00016199,98.46980266
37276,清純,1,607861,0.00016199,98.46996465
37277,清脆,1,607862,0.00016199,98.47012665
37278,清酒,1,607863,0.00016199,98.47028864
37279,清掃費,1,607864,0.00016199,98.47045064
37280,清教徒,1,607865,0.00016199,98.47061263
37281,清爽型,1,607866,0.00016199,98.47077462
37282,清理費,1,607867,0.00016199,98.47093662
37283,清透,1,607868,0.00016199,98.47109861
37284,清粥小菜,1,607869,0.00016199,98.47126061
37285,清華大學,1,607870,0.00016199,98.47142260
37286,清越,1,607871,0.00016199,98.47158459
37287,清雅,1,607872,0.00016199,98.47174659
37288,清新自然,1,607873,0.00016199,98.47190858
37289,清福,1,607874,0.00016199,98.47207058
37290,清潔力,1,607875,0.00016199,98.47223257
37291,清潔凝膠,1,607876,0.00016199,98.47239457
37292,清點,1,607877,0.00016199,98.47255656
37293,淋上,1,607878,0.00016199,98.47271855
37294,淋巴液,1,607879,0.00016199,98.47288055
37295,淋巴腺,1,607880,0.00016199,98.47304254
37296,淋濕,1,607881,0.00016199,98.47320454
37297,淹漫,1,607882,0.00016199,98.47336653
37298,混仗,1,607883,0.00016199,98.47352853
37299,混合物,1,607884,0.00016199,98.47369052
37300,混合酒,1,607885,0.00016199,98.47385251
37301,混身,1,607886,0.00016199,98.47401451
37302,混泥土,1,607887,0.00016199,98.47417650
37303,混音,1,607888,0.00016199,98.47433850
37304,混音器,1,607889,0.00016199,98.47450049
37305,混紡,1,607890,0.00016199,98.47466249
37306,混紡紗,1,607891,0.00016199,98.47482448
37307,混練,1,607892,0.00016199,98.47498647
37308,混戰,1,607893,0.00016199,98.47514847
37309,混雜,1,607894,0.00016199,98.47531046
37310,淵源,1,607895,0.00016199,98.47547246
37311,淒慘,1,607896,0.00016199,98.47563445
37312,淒艷,1,607897,0.00016199,98.47579644
37313,涵義,1,607898,0.00016199,98.47595844
37314,涵蓋力,1,607899,0.00016199,98.47612043
37315,淚光,1,607900,0.00016199,98.47628243
37316,淚液,1,607901,0.00016199,98.47644442
37317,淚眼,1,607902,0.00016199,98.47660642
37318,淚腺,1,607903,0.00016199,98.47676841
37319,淫料,1,607904,0.00016199,98.47693040
37320,淘金,1,607905,0.00016199,98.47709240
37321,淘金者,1,607906,0.00016199,98.47725439
37322,淘洗,1,607907,0.00016199,98.47741639
37323,淘氣,1,607908,0.00016199,98.47757838
37324,深山,1,607909,0.00016199,98.47774038
37325,深井,1,607910,0.00016199,98.47790237
37326,深化,1,607911,0.00016199,98.47806436
37327,深及,1,607912,0.00016199,98.47822636
37328,深以為咎,1,607913,0.00016199,98.47838835
37329,深圳,1,607914,0.00016199,98.47855035
37330,深宅,1,607915,0.00016199,98.47871234
37331,深灰色,1,607916,0.00016199,98.47887433
37332,深究,1,607917,0.00016199,98.47903633
37333,深具,1,607918,0.00016199,98.47919832
37334,深知,1,607919,0.00016199,98.47936032
37335,深表,1,607920,0.00016199,98.47952231
37336,深表遺憾,1,607921,0.00016199,98.47968431
37337,深長,1,607922,0.00016199,98.47984630
37338,深信不疑,1,607923,0.00016199,98.48000829
37339,深度性,1,607924,0.00016199,98.48017029
37340,深紅,1,607925,0.00016199,98.48033228
37341,深重,1,607926,0.00016199,98.48049428
37342,深海,1,607927,0.00016199,98.48065627
37343,深烙,1,607928,0.00016199,98.48081827
37344,深耕,1,607929,0.00016199,98.48098026
37345,深情,1,607930,0.00016199,98.48114225
37346,深情款款,1,607931,0.00016199,98.48130425
37347,深痛惡絕,1,607932,0.00016199,98.48146624
37348,深紫,1,607933,0.00016199,98.48162824
37349,深奧,1,607934,0.00016199,98.48179023
37350,深意,1,607935,0.00016199,98.48195222
37351,深暗,1,607936,0.00016199,98.48211422
37352,深濃,1,607937,0.00016199,98.48227621
37353,深諳,1,607938,0.00016199,98.48243821
37354,深藏,1,607939,0.00016199,98.48260020
37355,深藍,1,607940,0.00016199,98.48276220
37356,深邃,1,607941,0.00016199,98.48292419
37357,深鎖,1,607942,0.00016199,98.48308618
37358,深覺,1,607943,0.00016199,98.48324818
37359,淨利率,1,607944,0.00016199,98.48341017
37360,淨空,1,607945,0.00016199,98.48357217
37361,淨值比,1,607946,0.00016199,98.48373416
37362,淨損,1,607947,0.00016199,98.48389616
37363,淨潔,1,607948,0.00016199,98.48405815
37364,淨賺,1,607949,0.00016199,98.48422014
37365,淨覺,1,607950,0.00016199,98.48438214
37366,淬取,1,607951,0.00016199,98.48454413
37367,淬礪,1,607952,0.00016199,98.48470613
37368,烹,1,607953,0.00016199,98.48486812
37369,烹食,1,607954,0.00016199,98.48503011
37370,烹飪法,1,607955,0.00016199,98.48519211
37371,烹飪學校,1,607956,0.00016199,98.48535410
37372,焊,1,607957,0.00016199,98.48551610
37373,焊製,1,607958,0.00016199,98.48567809
37374,焊鐵,1,607959,0.00016199,98.48584009
37375,烽火,1,607960,0.00016199,98.48600208
37376,烽火連綿,1,607961,0.00016199,98.48616407
37377,爽口,1,607962,0.00016199,98.48632607
37378,爽約,1,607963,0.00016199,98.48648806
37379,爽朗,1,607964,0.00016199,98.48665006
37380,爽烈,1,607965,0.00016199,98.48681205
37381,爽適,1,607966,0.00016199,98.48697405
37382,牽引式榴砲,1,607967,0.00016199,98.48713604
37383,牽紅線,1,607968,0.00016199,98.48729803
37384,牽掛,1,607969,0.00016199,98.48746003
37385,牽累,1,607970,0.00016199,98.48762202
37386,牽連,1,607971,0.00016199,98.48778402
37387,猜火車,1,607972,0.00016199,98.48794601
37388,猜臆,1,607973,0.00016199,98.48810800
37389,猛力,1,607974,0.00016199,98.48827000
37390,猛打,1,607975,0.00016199,98.48843199
37391,猛攻,1,607976,0.00016199,98.48859399
37392,猛烈,1,607977,0.00016199,98.48875598
37393,猛獸,1,607978,0.00016199,98.48891798
37394,猖狂,1,607979,0.00016199,98.48907997
37395,猙獰,1,607980,0.00016199,98.48924196
37396,率直敢言,1,607981,0.00016199,98.48940396
37397,率隊,1,607982,0.00016199,98.48956595
37398,率意,1,607983,0.00016199,98.48972795
37399,率團,1,607984,0.00016199,98.48988994
37400,球伍,1,607985,0.00016199,98.49005194
37401,球服,1,607986,0.00016199,98.49021393
37402,球狀,1,607987,0.00016199,98.49037592
37403,球狀粒子,1,607988,0.00016199,98.49053792
37404,球迷卡,1,607989,0.00016199,98.49069991
37405,球感,1,607990,0.00016199,98.49086191
37406,球會,1,607991,0.00016199,98.49102390
37407,球運,1,607992,0.00016199,98.49118589
37408,球鞋,1,607993,0.00016199,98.49134789
37409,球壇,1,607994,0.00016199,98.49150988
37410,球類,1,607995,0.00016199,98.49167188
37411,球體,1,607996,0.00016199,98.49183387
37412,理工,1,607997,0.00016199,98.49199587
37413,理不理,1,607998,0.00016199,98.49215786
37414,理化,1,607999,0.00016199,98.49231985
37415,理光,1,608000,0.00016199,98.49248185
37416,理事會,1,608001,0.00016199,98.49264384
37417,理性化,1,608002,0.00016199,98.49280584
37418,理性消費,1,608003,0.00016199,98.49296783
37419,理查．費曼,1,608004,0.00016199,98.49312983
37420,理查‧史特勞斯,1,608005,0.00016199,98.49329182
37421,理查佛萊契,1,608006,0.00016199,98.49345381
37422,理財中心,1,608007,0.00016199,98.49361581
37423,理財聖經,1,608008,0.00016199,98.49377780
37424,理財觀,1,608009,0.00016199,98.49393980
37425,理想化,1,608010,0.00016199,98.49410179
37426,理想性,1,608011,0.00016199,98.49426378
37427,理當,1,608012,0.00016199,98.49442578
37428,理監事會議,1,608013,0.00016199,98.49458777
37429,理數,1,608014,0.00016199,98.49474977
37430,理論上,1,608015,0.00016199,98.49491176
37431,理論性,1,608016,0.00016199,98.49507376
37432,現下,1,608017,0.00016199,98.49523575
37433,現代灰姑娘,1,608018,0.00016199,98.49539774
37434,現代性,1,608019,0.00016199,98.49555974
37435,現代美術館,1,608020,0.00016199,98.49572173
37436,現代音樂,1,608021,0.00016199,98.49588373
37437,現代博物館,1,608022,0.00016199,98.49604572
37438,現代感,1,608023,0.00016199,98.49620772
37439,現代劇場,1,608024,0.00016199,98.49636971
37440,現代藝術,1,608025,0.00016199,98.49653170
37441,現行犯,1,608026,0.00016199,98.49669370
37442,現址,1,608027,0.00016199,98.49685569
37443,現金股利,1,608028,0.00016199,98.49701769
37444,現金增資,1,608029,0.00016199,98.49717968
37445,現值,1,608030,0.00016199,98.49734167
37446,現現,1,608031,0.00016199,98.49750367
37447,現貨價,1,608032,0.00016199,98.49766566
37448,現場感,1,608033,0.00016199,98.49782766
37449,現實性,1,608034,0.00016199,98.49798965
37450,現增,1,608035,0.00016199,98.49815165
37451,瓶裝,1,608036,0.00016199,98.49831364
37452,瓶鼻海豚,1,608037,0.00016199,98.49847563
37453,瓶嘴,1,608038,0.00016199,98.49863763
37454,瓷土粉,1,608039,0.00016199,98.49879962
37455,甜肉,1,608040,0.00016199,98.49896162
37456,甜言蜜語,1,608041,0.00016199,98.49912361
37457,甜味,1,608042,0.00016199,98.49928561
37458,甜性,1,608043,0.00016199,98.49944760
37459,甜食,1,608044,0.00016199,98.49960959
37460,甜甜圈,1,608045,0.00016199,98.49977159
37461,甜菜根,1,608046,0.00016199,98.49993358
37462,甜潤感,1,608047,0.00016199,98.50009558
37463,甜膩,1,608048,0.00016199,98.50025757
37464,甜點店,1,608049,0.00016199,98.50041956
37465,產生器,1,608050,0.00016199,98.50058156
37466,產季,1,608051,0.00016199,98.50074355
37467,產官,1,608052,0.00016199,98.50090555
37468,產品化,1,608053,0.00016199,98.50106754
37469,產品面,1,608054,0.00016199,98.50122954
37470,產品區,1,608055,0.00016199,98.50139153
37471,產品經理,1,608056,0.00016199,98.50155352
37472,產品輸入商社,1,608057,0.00016199,98.50171552
37473,產界,1,608058,0.00016199,98.50187751
37474,產期,1,608059,0.00016199,98.50203951
37475,產業空洞化,1,608060,0.00016199,98.50220150
37476,產經,1,608061,0.00016199,98.50236350
37477,產壽險,1,608062,0.00016199,98.50252549
37478,產製,1,608063,0.00016199,98.50268748
37479,產銷值,1,608064,0.00016199,98.50284948
37480,產險業,1,608065,0.00016199,98.50301147
37481,產齡,1,608066,0.00016199,98.50317347
37482,略知,1,608067,0.00016199,98.50333546
37483,略勝一籌,1,608068,0.00016199,98.50349746
37484,畦,1,608069,0.00016199,98.50365945
37485,畢生,1,608070,0.00016199,98.50382144
37486,畢斯里,1,608071,0.00016199,98.50398344
37487,畢業典禮,1,608072,0.00016199,98.50414543
37488,畢業留言手冊,1,608073,0.00016199,98.50430743
37489,畢雷諾斯,1,608074,0.00016199,98.50446942
37490,異口同聲,1,608075,0.00016199,98.50463141
37491,異己,1,608076,0.00016199,98.50479341
37492,異次元,1,608077,0.00016199,98.50495540
37493,異色,1,608078,0.00016199,98.50511740
37494,異物,1,608079,0.00016199,98.50527939
37495,異常症,1,608080,0.00016199,98.50544139
37496,異鄉,1,608081,0.00016199,98.50560338
37497,異想天開,1,608082,0.00016199,98.50576537
37498,異業,1,608083,0.00016199,98.50592737
37499,疏疏落落,1,608084,0.00016199,98.50608936
37500,疏散,1,608085,0.00016199,98.50625136
37501,疏解,1,608086,0.00016199,98.50641335
37502,疏漏,1,608087,0.00016199,98.50657535
37503,疏遠,1,608088,0.00016199,98.50673734
37504,疏離,1,608089,0.00016199,98.50689933
37505,疏離感,1,608090,0.00016199,98.50706133
37506,皎潔,1,608091,0.00016199,98.50722332
37507,盔,1,608092,0.00016199,98.50738532
37508,盛名遠播,1,608093,0.00016199,98.50754731
37509,盛年,1,608094,0.00016199,98.50770930
37510,盛行率,1,608095,0.00016199,98.50787130
37511,盛事,1,608096,0.00016199,98.50803329
37512,盛岡市,1,608097,0.00016199,98.50819529
37513,盛放,1,608098,0.00016199,98.50835728
37514,盛怒,1,608099,0.00016199,98.50851928
37515,盛氣凌人,1,608100,0.00016199,98.50868127
37516,盛起,1,608101,0.00016199,98.50884326
37517,盛讚,1,608102,0.00016199,98.50900526
37518,眷村改建基金,1,608103,0.00016199,98.50916725
37519,眾目睽睽,1,608104,0.00016199,98.50932925
37520,眾星拱月,1,608105,0.00016199,98.50949124
37521,眾院,1,608106,0.00016199,98.50965324
37522,眾議員,1,608107,0.00016199,98.50981523
37523,眾議院,1,608108,0.00016199,98.50997722
37524,眼中釘,1,608109,0.00016199,98.51013922
37525,眼角,1,608110,0.00016199,98.51030121
37526,眼角膜,1,608111,0.00016199,98.51046321
37527,眼底,1,608112,0.00016199,98.51062520
37528,眼盲,1,608113,0.00016199,98.51078719
37529,眼花,1,608114,0.00016199,98.51094919
37530,眼屎,1,608115,0.00016199,98.51111118
37531,眼紅,1,608116,0.00016199,98.51127318
37532,眼珠,1,608117,0.00016199,98.51143517
37533,眼圈,1,608118,0.00016199,98.51159717
37534,眼彩,1,608119,0.00016199,98.51175916
37535,眼眸,1,608120,0.00016199,98.51192115
37536,眼蛙,1,608121,0.00016199,98.51208315
37537,眼歲,1,608122,0.00016199,98.51224514
37538,眼睜睜,1,608123,0.00016199,98.51240714
37539,眼摺,1,608124,0.00016199,98.51256913
37540,眼福,1,608125,0.00016199,98.51273113
37541,眼影膏,1,608126,0.00016199,98.51289312
37542,眼線刷,1,608127,0.00016199,98.51305511
37543,眼瞳,1,608128,0.00016199,98.51321711
37544,眼瞼,1,608129,0.00016199,98.51337910
37545,眼藥水,1,608130,0.00016199,98.51354110
37546,眶,1,608131,0.00016199,98.51370309
37547,眸,1,608132,0.00016199,98.51386508
37548,眺,1,608133,0.00016199,98.51402708
37549,硫黃味,1,608134,0.00016199,98.51418907
37550,硫酸亞,1,608135,0.00016199,98.51435107
37551,祥林嫂,1,608136,0.00016199,98.51451306
37552,祥龍獻瑞,1,608137,0.00016199,98.51467506
37553,票友,1,608138,0.00016199,98.51483705
37554,票倉,1,608139,0.00016199,98.51499904
37555,票載日,1,608140,0.00016199,98.51516104
37556,票數,1,608141,0.00016199,98.51532303
37557,票據,1,608142,0.00016199,98.51548503
37558,票櫃,1,608143,0.00016199,98.51564702
37559,票匭,1,608144,0.00016199,98.51580902
37560,祭文,1,608145,0.00016199,98.51597101
37561,祭日,1,608146,0.00016199,98.51613300
37562,祭司,1,608147,0.00016199,98.51629500
37563,祭禱,1,608148,0.00016199,98.51645699
37564,移入,1,608149,0.00016199,98.51661899
37565,移出,1,608150,0.00016199,98.51678098
37566,移位,1,608151,0.00016199,98.51694297
37567,移走,1,608152,0.00016199,98.51710497
37568,移居,1,608153,0.00016199,98.51726696
37569,移花接木,1,608154,0.00016199,98.51742896
37570,移航,1,608155,0.00016199,98.51759095
37571,移除,1,608156,0.00016199,98.51775295
37572,移動力,1,608157,0.00016199,98.51791494
37573,移殖,1,608158,0.00016199,98.51807693
37574,移開,1,608159,0.00016199,98.51823893
37575,移調,1,608160,0.00016199,98.51840092
37576,移樽就教,1,608161,0.00016199,98.51856292
37577,窒礙,1,608162,0.00016199,98.51872491
37578,窒礙難行,1,608163,0.00016199,98.51888691
37579,笨拙感,1,608164,0.00016199,98.51904890
37580,笨頭笨腦,1,608165,0.00016199,98.51921089
37581,笛聲,1,608166,0.00016199,98.51937289
37582,第一夫人,1,608167,0.00016199,98.51953488
37583,第一夫人的保鏢,1,608168,0.00016199,98.51969688
37584,第一次上街買東西,1,608169,0.00016199,98.51985887
37585,第一波士頓公司,1,608170,0.00016199,98.52002086
37586,第一信託公司,1,608171,0.00016199,98.52018286
37587,第一副總裁,1,608172,0.00016199,98.52034485
37588,第一眼,1,608173,0.00016199,98.52050685
37589,第一集團軍,1,608174,0.00016199,98.52066884
37590,第一類股,1,608175,0.00016199,98.52083084
37591,第一勸業銀行,1,608176,0.00016199,98.52099283
37592,第七號情報員,1,608177,0.00016199,98.52115482
37593,第二十梯次好書大家讀,1,608178,0.00016199,98.52131682
37594,第二類股,1,608179,0.00016199,98.52147881
37595,第十九梯次好書大家讀,1,608180,0.00016199,98.52164081
37596,第三世界,1,608181,0.00016199,98.52180280
37597,第三波,1,608182,0.00016199,98.52196480
37598,第三波文化,1,608183,0.00016199,98.52212679
37599,第三波出版集團,1,608184,0.00016199,98.52228878
37600,第三者,1,608185,0.00016199,98.52245078
37601,第三點,1,608186,0.00016199,98.52261277
37602,第六感生死戀,1,608187,0.00016199,98.52277477
37603,符號化,1,608188,0.00016199,98.52293676
37604,粒狀汙染物,1,608189,0.00016199,98.52309875
37605,粗大,1,608190,0.00016199,98.52326075
37606,粗估,1,608191,0.00016199,98.52342274
37607,粗壯,1,608192,0.00016199,98.52358474
37608,粗厚,1,608193,0.00016199,98.52374673
37609,粗梨,1,608194,0.00016199,98.52390873
37610,粗粗,1,608195,0.00016199,98.52407072
37611,粗粗短短,1,608196,0.00016199,98.52423271
37612,粗野,1,608197,0.00016199,98.52439471
37613,粗棉布,1,608198,0.00016199,98.52455670
37614,粗暴,1,608199,0.00016199,98.52471870
37615,粗礪,1,608200,0.00016199,98.52488069
37616,粗鹽,1,608201,0.00016199,98.52504269
37617,絆倒,1,608202,0.00016199,98.52520468
37618,絆馬手,1,608203,0.00016199,98.52536667
37619,統一木瓜牛奶,1,608204,0.00016199,98.52552867
37620,統一集團,1,608205,0.00016199,98.52569066
37621,統一獅隊,1,608206,0.00016199,98.52585266
37622,統一實,1,608207,0.00016199,98.52601465
37623,統一實業,1,608208,0.00016199,98.52617664
37624,統一證券,1,608209,0.00016199,98.52633864
37625,統一證券公司,1,608210,0.00016199,98.52650063
37626,統包,1,608211,0.00016199,98.52666263
37627,統合理論,1,608212,0.00016199,98.52682462
37628,統治權,1,608213,0.00016199,98.52698662
37629,統英建設,1,608214,0.00016199,98.52714861
37630,統英建設公司,1,608215,0.00016199,98.52731060
37631,統計局,1,608216,0.00016199,98.52747260
37632,統御,1,608217,0.00016199,98.52763459
37633,統領,1,608218,0.00016199,98.52779659
37634,紮,1,608219,0.00016199,98.52795858
37635,紮入,1,608220,0.00016199,98.52812058
37636,紮根,1,608221,0.00016199,98.52828257
37637,紮營,1,608222,0.00016199,98.52844456
37638,細心呵護,1,608223,0.00016199,98.52860656
37639,細水長流,1,608224,0.00016199,98.52876855
37640,細作,1,608225,0.00016199,98.52893055
37641,細雨,1,608226,0.00016199,98.52909254
37642,細則,1,608227,0.00016199,98.52925454
37643,細挑慢選,1,608228,0.00016199,98.52941653
37644,細看,1,608229,0.00016199,98.52957852
37645,細胞粒線體,1,608230,0.00016199,98.52974052
37646,細胞群,1,608231,0.00016199,98.52990251
37647,細胞癌,1,608232,0.00016199,98.53006451
37648,細述,1,608233,0.00016199,98.53022650
37649,細菌性,1,608234,0.00016199,98.53038849
37650,細微微,1,608235,0.00016199,98.53055049
37651,細語,1,608236,0.00016199,98.53071248
37652,細說從頭漢聲,1,608237,0.00016199,98.53087448
37653,細線,1,608238,0.00016199,98.53103647
37654,細談,1,608239,0.00016199,98.53119847
37655,紳士,1,608240,0.00016199,98.53136046
37656,組出,1,608241,0.00016199,98.53152245
37657,組合起來,1,608242,0.00016199,98.53168445
37658,組建,1,608243,0.00016199,98.53184644
37659,組裝軟,1,608244,0.00016199,98.53200844
37660,組織法,1,608245,0.00016199,98.53217043
37661,組織軍情局,1,608246,0.00016199,98.53233243
37662,組織條例,1,608247,0.00016199,98.53249442
37663,組織規程,1,608248,0.00016199,98.53265641
37664,組黨,1,608249,0.00016199,98.53281841
37665,組鑲,1,608250,0.00016199,98.53298040
37666,累倒,1,608251,0.00016199,98.53314240
37667,終了,1,608252,0.00016199,98.53330439
37668,終日,1,608253,0.00016199,98.53346638
37669,終身大事,1,608254,0.00016199,98.53362838
37670,終其一生,1,608255,0.00016199,98.53379037
37671,終極保鑣,1,608256,0.00016199,98.53395237
37672,終極動員令,1,608257,0.00016199,98.53411436
37673,終極標靶,1,608258,0.00016199,98.53427636
37674,終極證人,1,608259,0.00016199,98.53443835
37675,終點處,1,608260,0.00016199,98.53460034
37676,終歸,1,608261,0.00016199,98.53476234
37677,羞怯,1,608262,0.00016199,98.53492433
37678,羞怯怯,1,608263,0.00016199,98.53508633
37679,羞恥,1,608264,0.00016199,98.53524832
37680,羞赧,1,608265,0.00016199,98.53541032
37681,羞愧,1,608266,0.00016199,98.53557231
37682,羚羊中隊,1,608267,0.00016199,98.53573430
37683,羚羊式,1,608268,0.00016199,98.53589630
37684,習以為常,1,608269,0.00016199,98.53605829
37685,習武,1,608270,0.00016199,98.53622029
37686,習慣上,1,608271,0.00016199,98.53638228
37687,習稱,1,608272,0.00016199,98.53654427
37688,習題,1,608273,0.00016199,98.53670627
37689,習藝,1,608274,0.00016199,98.53686826
37690,聊天館,1,608275,0.00016199,98.53703026
37691,聊起來,1,608276,0.00016199,98.53719225
37692,聊興,1,608277,0.00016199,98.53735425
37693,聆,1,608278,0.00016199,98.53751624
37694,聆吟,1,608279,0.00016199,98.53767823
37695,聆者,1,608280,0.00016199,98.53784023
37696,聆賞者,1,608281,0.00016199,98.53800222
37697,脣,1,608282,0.00016199,98.53816422
37698,脣部,1,608283,0.00016199,98.53832621
37699,脣膏,1,608284,0.00016199,98.53848821
37700,脣線筆,1,608285,0.00016199,98.53865020
37701,脫口秀,1,608286,0.00016199,98.53881219
37702,脫水食品,1,608287,0.00016199,98.53897419
37703,脫色,1,608288,0.00016199,98.53913618
37704,脫衣舞,1,608289,0.00016199,98.53929818
37705,脫衣舞秀,1,608290,0.00016199,98.53946017
37706,脫衣舞孃,1,608291,0.00016199,98.53962216
37707,脫俗,1,608292,0.00016199,98.53978416
37708,脫脂,1,608293,0.00016199,98.53994615
37709,脫殼穿甲彈,1,608294,0.00016199,98.54010815
37710,脫線,1,608295,0.00016199,98.54027014
37711,脫韁野馬,1,608296,0.00016199,98.54043214
37712,舵,1,608297,0.00016199,98.54059413
37713,舶來品,1,608298,0.00016199,98.54075612
37714,船主,1,608299,0.00016199,98.54091812
37715,船仔頭,1,608300,0.00016199,98.54108011
37716,船身,1,608301,0.00016199,98.54124211
37717,船底,1,608302,0.00016199,98.54140410
37718,船東,1,608303,0.00016199,98.54156610
37719,船務,1,608304,0.00016199,98.54172809
37720,船務部,1,608305,0.00016199,98.54189008
37721,船期,1,608306,0.00016199,98.54205208
37722,船運,1,608307,0.00016199,98.54221407
37723,船邊,1,608308,0.00016199,98.54237607
37724,船齡,1,608309,0.00016199,98.54253806
37725,船體,1,608310,0.00016199,98.54270005
37726,莎凡娜,1,608311,0.00016199,98.54286205
37727,莎士比亞的妹妹們,1,608312,0.00016199,98.54302404
37728,莎拉潔卡帕克,1,608313,0.00016199,98.54318604
37729,莎莉杜根,1,608314,0.00016199,98.54334803
37730,莞爾一笑,1,608315,0.00016199,98.54351003
37731,荸薺,1,608316,0.00016199,98.54367202
37732,莽撞,1,608317,0.00016199,98.54383401
37733,莫不,1,608318,0.00016199,98.54399601
37734,莫氏樹蛙,1,608319,0.00016199,98.54415800
37735,莫可奈何,1,608320,0.00016199,98.54432000
37736,莫市,1,608321,0.00016199,98.54448199
37737,莫里納,1,608322,0.00016199,98.54464399
37738,莫非,1,608323,0.00016199,98.54480598
37739,莫衷一是,1,608324,0.00016199,98.54496797
37740,莫高,1,608325,0.00016199,98.54512997
37741,莫斯科大學,1,608326,0.00016199,98.54529196
37742,莫須有,1,608327,0.00016199,98.54545396
37743,莫爾定律,1,608328,0.00016199,98.54561595
37744,莫屬,1,608329,0.00016199,98.54577794
37745,莊玉隆,1,608330,0.00016199,98.54593994
37746,莊光敏,1,608331,0.00016199,98.54610193
37747,莊宗慶,1,608332,0.00016199,98.54626393
37748,莊芳銘,1,608333,0.00016199,98.54642592
37749,莊重,1,608334,0.00016199,98.54658792
37750,莊啟宗,1,608335,0.00016199,98.54674991
37751,莊淑旂,1,608336,0.00016199,98.54691190
37752,莊稼漢,1,608337,0.00016199,98.54707390
37753,莊邁斯,1,608338,0.00016199,98.54723589
37754,莊靈,1,608339,0.00016199,98.54739789
37755,莓子,1,608340,0.00016199,98.54755988
37756,莉,1,608341,0.00016199,98.54772188
37757,莉亞湯普遜,1,608342,0.00016199,98.54788387
37758,莉莉泰勒,1,608343,0.00016199,98.54804586
37759,莉蒂亞,1,608344,0.00016199,98.54820786
37760,荷重,1,608345,0.00016199,98.54836985
37761,荷商,1,608346,0.00016199,98.54853185
37762,荷商銀行,1,608347,0.00016199,98.54869384
37763,荷莉,1,608348,0.00016199,98.54885583
37764,荷荷芭油,1,608349,0.00016199,98.54901783
37765,荷塘,1,608350,0.00016199,98.54917982
37766,荷葉,1,608351,0.00016199,98.54934182
37767,荷蓋德,1,608352,0.00016199,98.54950381
37768,荷蘭市立劇院,1,608353,0.00016199,98.54966581
37769,荷蘭風,1,608354,0.00016199,98.54982780
37770,荷蘭航空,1,608355,0.00016199,98.54998979
37771,荷蘭福克,1,608356,0.00016199,98.55015179
37772,荷蘭銀行,1,608357,0.00016199,98.55031378
37773,莆田,1,608358,0.00016199,98.55047578
37774,莧菜,1,608359,0.00016199,98.55063777
37775,處女地,1,608360,0.00016199,98.55079977
37776,處女秀,1,608361,0.00016199,98.55096176
37777,處方箋,1,608362,0.00016199,98.55112375
37778,處在,1,608363,0.00016199,98.55128575
37779,處事,1,608364,0.00016199,98.55144774
37780,處理費,1,608365,0.00016199,98.55160974
37781,處理機,1,608366,0.00016199,98.55177173
37782,處落,1,608367,0.00016199,98.55193372
37783,處變不驚,1,608368,0.00016199,98.55209572
37784,蛇山,1,608369,0.00016199,98.55225771
37785,蛇窯,1,608370,0.00016199,98.55241971
37786,蛇頭,1,608371,0.00016199,98.55258170
37787,蛇蠍,1,608372,0.00016199,98.55274370
37788,蚵架,1,608373,0.00016199,98.55290569
37789,蛋白��,1,608374,0.00016199,98.55306768
37790,蛋液,1,608375,0.00016199,98.55322968
37791,蛋清,1,608376,0.00016199,98.55339167
37792,蛋殼色,1,608377,0.00016199,98.55355367
37793,蛋糕店,1,608378,0.00016199,98.55371566
37794,術語,1,608379,0.00016199,98.55387766
37795,被剋,1,608380,0.00016199,98.55403965
37796,被捕,1,608381,0.00016199,98.55420164
37797,被動式,1,608382,0.00016199,98.55436364
37798,被覆碳化鎢,1,608383,0.00016199,98.55452563
37799,被壞,1,608384,0.00016199,98.55468763
37800,被繼承人,1,608385,0.00016199,98.55484962
37801,袒胸,1,608386,0.00016199,98.55501161
37802,袒露,1,608387,0.00016199,98.55517361
37803,袖,1,608388,0.00016199,98.55533560
37804,袖子,1,608389,0.00016199,98.55549760
37805,袖手旁觀,1,608390,0.00016199,98.55565959
37806,袖珍,1,608391,0.00016199,98.55582159
37807,袖珍化,1,608392,0.00016199,98.55598358
37808,袖珍型,1,608393,0.00016199,98.55614557
37809,袖珍書,1,608394,0.00016199,98.55630757
37810,袍子,1,608395,0.00016199,98.55646956
37811,袋狀,1,608396,0.00016199,98.55663156
37812,袋狀物,1,608397,0.00016199,98.55679355
37813,袋袋相傳,1,608398,0.00016199,98.55695555
37814,覓尋,1,608399,0.00016199,98.55711754
37815,規規矩矩,1,608400,0.00016199,98.55727953
37816,規劃案,1,608401,0.00016199,98.55744153
37817,規劃圖,1,608402,0.00016199,98.55760352
37818,訪友,1,608403,0.00016199,98.55776552
37819,訪日團,1,608404,0.00016199,98.55792751
37820,訪調,1,608405,0.00016199,98.55808951
37821,訝然,1,608406,0.00016199,98.55825150
37822,許乃義,1,608407,0.00016199,98.55841349
37823,許文榮,1,608408,0.00016199,98.55857549
37824,許正雄,1,608409,0.00016199,98.55873748
37825,許秀琴,1,608410,0.00016199,98.55889948
37826,許宗而,1,608411,0.00016199,98.55906147
37827,許幸,1,608412,0.00016199,98.55922346
37828,許昌平,1,608413,0.00016199,98.55938546
37829,許俊傑,1,608414,0.00016199,98.55954745
37830,許春蓮,1,608415,0.00016199,98.55970945
37831,許柯生,1,608416,0.00016199,98.55987144
37832,許厝港,1,608417,0.00016199,98.56003344
37833,許家綾,1,608418,0.00016199,98.56019543
37834,許素葉,1,608419,0.00016199,98.56035742
37835,許能昭,1,608420,0.00016199,98.56051942
37836,許堂仁,1,608421,0.00016199,98.56068141
37837,許啟智,1,608422,0.00016199,98.56084341
37838,許梅芳,1,608423,0.00016199,98.56100540
37839,許淑貞,1,608424,0.00016199,98.56116740
37840,許淑惠,1,608425,0.00016199,98.56132939
37841,許惠玉,1,608426,0.00016199,98.56149138
37842,許斐荼,1,608427,0.00016199,98.56165338
37843,許義始,1,608428,0.00016199,98.56181537
37844,許榮助保肝丸,1,608429,0.00016199,98.56197737
37845,許德南,1,608430,0.00016199,98.56213936
37846,許適,1,608431,0.00016199,98.56230135
37847,許霆,1,608432,0.00016199,98.56246335
37848,許鞍華,1,608433,0.00016199,98.56262534
37849,許歷農,1,608434,0.00016199,98.56278734
37850,許聲胤,1,608435,0.00016199,98.56294933
37851,許願,1,608436,0.00016199,98.56311133
37852,設下,1,608437,0.00016199,98.56327332
37853,設身處地,1,608438,0.00016199,98.56343531
37854,設制,1,608439,0.00016199,98.56359731
37855,設為,1,608440,0.00016199,98.56375930
37856,設計大師,1,608441,0.00016199,98.56392130
37857,設計系,1,608442,0.00016199,98.56408329
37858,設計費,1,608443,0.00016199,98.56424529
37859,設計圖,1,608444,0.00016199,98.56440728
37860,設計管理學院,1,608445,0.00016199,98.56456927
37861,設計賽,1,608446,0.00016199,98.56473127
37862,設備圖,1,608447,0.00016199,98.56489326
37863,設點,1,608448,0.00016199,98.56505526
37864,訛詐,1,608449,0.00016199,98.56521725
37865,豚,1,608450,0.00016199,98.56537924
37866,販促部,1,608451,0.00016199,98.56554124
37867,販毒,1,608452,0.00016199,98.56570323
37868,販售者,1,608453,0.00016199,98.56586523
37869,販賣部,1,608454,0.00016199,98.56602722
37870,責失,1,608455,0.00016199,98.56618922
37871,責成,1,608456,0.00016199,98.56635121
37872,責備,1,608457,0.00016199,98.56651320
37873,貫例,1,608458,0.00016199,98.56667520
37874,貨方,1,608459,0.00016199,98.56683719
37875,貨物稅,1,608460,0.00016199,98.56699919
37876,貨架,1,608461,0.00016199,98.56716118
37877,貨船,1,608462,0.00016199,98.56732318
37878,貨棧,1,608463,0.00016199,98.56748517
37879,貨款,1,608464,0.00016199,98.56764716
37880,貨殖,1,608465,0.00016199,98.56780916
37881,貨運行,1,608466,0.00016199,98.56797115
37882,貨運專區,1,608467,0.00016199,98.56813315
37883,貨幣市場,1,608468,0.00016199,98.56829514
37884,貨幣供給年增率,1,608469,0.00016199,98.56845713
37885,貨幣供給額,1,608470,0.00016199,98.56861913
37886,貨幣政策,1,608471,0.00016199,98.56878112
37887,貨幣基金,1,608472,0.00016199,98.56894312
37888,貨輪,1,608473,0.00016199,98.56910511
37889,貨櫃船,1,608474,0.00016199,98.56926711
37890,貨櫃量,1,608475,0.00016199,98.56942910
37891,貨櫃集散站,1,608476,0.00016199,98.56959109
37892,貪心,1,608477,0.00016199,98.56975309
37893,貪吃,1,608478,0.00016199,98.56991508
37894,貪污治罪條例,1,608479,0.00016199,98.57007708
37895,貪官,1,608480,0.00016199,98.57023907
37896,貪瀆案,1,608481,0.00016199,98.57040107
37897,貧者,1,608482,0.00016199,98.57056306
37898,貧弱,1,608483,0.00016199,98.57072505
37899,貧錢,1,608484,0.00016199,98.57088705
37900,趾,1,608485,0.00016199,98.57104904
37901,趺,1,608486,0.00016199,98.57121104
37902,軟水,1,608487,0.00016199,98.57137303
37903,軟世,1,608488,0.00016199,98.57153502
37904,軟世雜誌,1,608489,0.00016199,98.57169702
37905,軟骨,1,608490,0.00016199,98.57185901
37906,軟骨棒,1,608491,0.00016199,98.57202101
37907,軟組織,1,608492,0.00016199,98.57218300
37908,軟頂天窗,1,608493,0.00016199,98.57234500
37909,軟頂車,1,608494,0.00016199,98.57250699
37910,軟質,1,608495,0.00016199,98.57266898
37911,軟篷,1,608496,0.00016199,98.57283098
37912,軟篷天窗,1,608497,0.00016199,98.57299297
37913,軟體工業區,1,608498,0.00016199,98.57315497
37914,軟體世界雜誌,1,608499,0.00016199,98.57331696
37915,軟體基金會,1,608500,0.00016199,98.57347896
37916,軟体,1,608501,0.00016199,98.57364095
37917,這陣子,1,608502,0.00016199,98.57380294
37918,這塊,1,608503,0.00016199,98.57396494
37919,這會兒,1,608504,0.00016199,98.57412693
37920,這道,1,608505,0.00016199,98.57428893
37921,這樁,1,608506,0.00016199,98.57445092
37922,這檔子事兒,1,608507,0.00016199,98.57461291
37923,這類,1,608508,0.00016199,98.57477491
37924,逍遙天堂,1,608509,0.00016199,98.57493690
37925,通天達,1,608510,0.00016199,98.57509890
37926,通令,1,608511,0.00016199,98.57526089
37927,通古斯加爆炸事件,1,608512,0.00016199,98.57542289
37928,通告,1,608513,0.00016199,98.57558488
37929,通性,1,608514,0.00016199,98.57574687
37930,通信電纜,1,608515,0.00016199,98.57590887
37931,通姦,1,608516,0.00016199,98.57607086
37932,通姦罪,1,608517,0.00016199,98.57623286
37933,通紅,1,608518,0.00016199,98.57639485
37934,通風碟,1,608519,0.00016199,98.57655685
37935,通風管,1,608520,0.00016199,98.57671884
37936,通宵,1,608521,0.00016199,98.57688083
37937,通氣,1,608522,0.00016199,98.57704283
37938,通訊匣,1,608523,0.00016199,98.57720482
37939,通訊界,1,608524,0.00016199,98.57736682
37940,通訊埠,1,608525,0.00016199,98.57752881
37941,通訊量,1,608526,0.00016199,98.57769080
37942,通訊器,1,608527,0.00016199,98.57785280
37943,通商,1,608528,0.00016199,98.57801479
37944,通婚,1,608529,0.00016199,98.57817679
37945,通透性,1,608530,0.00016199,98.57833878
37946,通順,1,608531,0.00016199,98.57850078
37947,通勤鐵路,1,608532,0.00016199,98.57866277
37948,通牒,1,608533,0.00016199,98.57882476
37949,通話費,1,608534,0.00016199,98.57898676
37950,通稱,1,608535,0.00016199,98.57914875
37951,通緝,1,608536,0.00016199,98.57931075
37952,逗留,1,608537,0.00016199,98.57947274
37953,連日來,1,608538,0.00016199,98.57963474
37954,連外道路,1,608539,0.00016199,98.57979673
37955,連亙,1,608540,0.00016199,98.57995872
37956,連同,1,608541,0.00016199,98.58012072
37957,連江,1,608542,0.00016199,98.58028271
37958,連江縣,1,608543,0.00016199,98.58044471
37959,連宋情結,1,608544,0.00016199,98.58060670
37960,連長室,1,608545,0.00016199,98.58076869
37961,連袂,1,608546,0.00016199,98.58093069
37962,連動性,1,608547,0.00016199,98.58109268
37963,連接埠,1,608548,0.00016199,98.58125468
37964,連理,1,608549,0.00016199,98.58141667
37965,連莊,1,608550,0.00016199,98.58157867
37966,連絡道路,1,608551,0.00016199,98.58174066
37967,連雅文,1,608552,0.00016199,98.58190265
37968,連雅堂,1,608553,0.00016199,98.58206465
37969,連歌劇院,1,608554,0.00016199,98.58222664
37970,連線者,1,608555,0.00016199,98.58238864
37971,連橫,1,608556,0.00016199,98.58255063
37972,連錫銘,1,608557,0.00016199,98.58271263
37973,連翻,1,608558,0.00016199,98.58287462
37974,連鎖化,1,608559,0.00016199,98.58303661
37975,連鎖反應,1,608560,0.00016199,98.58319861
37976,連鎖店協會,1,608561,0.00016199,98.58336060
37977,連繫,1,608562,0.00016199,98.58352260
37978,連續性,1,608563,0.00016199,98.58368459
37979,連續攝影,1,608564,0.00016199,98.58384658
37980,連體嬰,1,608565,0.00016199,98.58400858
37981,速度表,1,608566,0.00016199,98.58417057
37982,速度感,1,608567,0.00016199,98.58433257
37983,速速,1,608568,0.00016199,98.58449456
37984,速讀,1,608569,0.00016199,98.58465656
37985,逝去,1,608570,0.00016199,98.58481855
37986,逐一,1,608571,0.00016199,98.58498054
37987,逐級,1,608572,0.00016199,98.58514254
37988,逐漸式,1,608573,0.00016199,98.58530453
37989,逕付,1,608574,0.00016199,98.58546653
37990,逕行,1,608575,0.00016199,98.58562852
37991,逕送,1,608576,0.00016199,98.58579052
37992,逞,1,608577,0.00016199,98.58595251
37993,逞威,1,608578,0.00016199,98.58611450
37994,逞強,1,608579,0.00016199,98.58627650
37995,造反,1,608580,0.00016199,98.58643849
37996,造出,1,608581,0.00016199,98.58660049
37997,造因,1,608582,0.00016199,98.58676248
37998,造舟,1,608583,0.00016199,98.58692448
37999,造物,1,608584,0.00016199,98.58708647
38000,造型表,1,608585,0.00016199,98.58724846
38001,造船廠,1,608586,0.00016199,98.58741046
38002,造陸,1,608587,0.00016199,98.58757245
38003,造詣,1,608588,0.00016199,98.58773445
38004,造橋,1,608589,0.00016199,98.58789644
38005,透入,1,608590,0.00016199,98.58805843
38006,透抽,1,608591,0.00016199,98.58822043
38007,透明膠帶,1,608592,0.00016199,98.58838242
38008,透視感,1,608593,0.00016199,98.58854442
38009,透黃,1,608594,0.00016199,98.58870641
38010,透漏,1,608595,0.00016199,98.58886841
38011,逢甲大學,1,608596,0.00016199,98.58903040
38012,逢迎,1,608597,0.00016199,98.58919239
38013,逛完,1,608598,0.00016199,98.58935439
38014,部位沖擊按摩,1,608599,0.00016199,98.58951638
38015,部品,1,608600,0.00016199,98.58967838
38016,部編,1,608601,0.00016199,98.58984037
38017,郭子乾,1,608602,0.00016199,98.59000237
38018,郭本厚,1,608603,0.00016199,98.59016436
38019,郭玉瑩,1,608604,0.00016199,98.59032635
38020,郭伊珍,1,608605,0.00016199,98.59048835
38021,郭李建夫,1,608606,0.00016199,98.59065034
38022,郭東隆,1,608607,0.00016199,98.59081234
38023,郭武雄,1,608608,0.00016199,98.59097433
38024,郭金仁,1,608609,0.00016199,98.59113632
38025,郭俊銘,1,608610,0.00016199,98.59129832
38026,郭建宏,1,608611,0.00016199,98.59146031
38027,郭紹綱,1,608612,0.00016199,98.59162231
38028,郭智輝,1,608613,0.00016199,98.59178430
38029,郭隆富,1,608614,0.00016199,98.59194630
38030,郭源治,1,608615,0.00016199,98.59210829
38031,郭榮祺,1,608616,0.00016199,98.59227028
38032,都市化,1,608617,0.00016199,98.59243228
38033,都市律爾,1,608618,0.00016199,98.59259427
38034,都在,1,608619,0.00016199,98.59275627
38035,都尉,1,608620,0.00016199,98.59291826
38036,都會式,1,608621,0.00016199,98.59308026
38037,都會型,1,608622,0.00016199,98.59324225
38038,野手,1,608623,0.00016199,98.59340424
38039,野火,1,608624,0.00016199,98.59356624
38040,野台戲,1,608625,0.00016199,98.59372823
38041,野生動物諮詢小組,1,608626,0.00016199,98.59389023
38042,野生動物諮詢委員會,1,608627,0.00016199,98.59405222
38043,野地,1,608628,0.00016199,98.59421421
38044,野村,1,608629,0.00016199,98.59437621
38045,野村克則,1,608630,0.00016199,98.59453820
38046,野村投資管理有限公司,1,608631,0.00016199,98.59470020
38047,野性的思維,1,608632,0.00016199,98.59486219
38048,野草,1,608633,0.00016199,98.59502419
38049,野草莓,1,608634,0.00016199,98.59518618
38050,野豹,1,608635,0.00016199,98.59534817
38051,野豬,1,608636,0.00016199,98.59551017
38052,野獸國,1,608637,0.00016199,98.59567216
38053,野蠻遊戲,1,608638,0.00016199,98.59583416
38054,釣竿,1,608639,0.00016199,98.59599615
38055,釣魚台事件,1,608640,0.00016199,98.59615815
38056,釣餌,1,608641,0.00016199,98.59632014
38057,釣線,1,608642,0.00016199,98.59648213
38058,閉門造車,1,608643,0.00016199,98.59664413
38059,閉門羹,1,608644,0.00016199,98.59680612
38060,閉迴路,1,608645,0.00016199,98.59696812
38061,閉幕片,1,608646,0.00016199,98.59713011
38062,閉靜,1,608647,0.00016199,98.59729210
38063,閉藏,1,608648,0.00016199,98.59745410
38064,閉鎖,1,608649,0.00016199,98.59761609
38065,閉關,1,608650,0.00016199,98.59777809
38066,陪酒,1,608651,0.00016199,98.59794008
38067,陪產假,1,608652,0.00016199,98.59810208
38068,陪葬品,1,608653,0.00016199,98.59826407
38069,陪審員,1,608654,0.00016199,98.59842606
38070,陪審團,1,608655,0.00016199,98.59858806
38071,陪練員,1,608656,0.00016199,98.59875005
38072,陳千惠,1,608657,0.00016199,98.59891205
38073,陳子昂,1,608658,0.00016199,98.59907404
38074,陳中,1,608659,0.00016199,98.59923604
38075,陳中全,1,608660,0.00016199,98.59939803
38076,陳孔立,1,608661,0.00016199,98.59956002
38077,陳文宗,1,608662,0.00016199,98.59972202
38078,陳文雄,1,608663,0.00016199,98.59988401
38079,陳文禮,1,608664,0.00016199,98.60004601
38080,陳方平,1,608665,0.00016199,98.60020800
38081,陳木勝,1,608666,0.00016199,98.60036999
38082,陳氏系統,1,608667,0.00016199,98.60053199
38083,陳氏系統公司,1,608668,0.00016199,98.60069398
38084,陳水源,1,608669,0.00016199,98.60085598
38085,陳弘元,1,608670,0.00016199,98.60101797
38086,陳正杰,1,608671,0.00016199,98.60117997
38087,陳永和命案,1,608672,0.00016199,98.60134196
38088,陳玉書,1,608673,0.00016199,98.60150395
38089,陳玉慧,1,608674,0.00016199,98.60166595
38090,陳立凱,1,608675,0.00016199,98.60182794
38091,陳兆祥,1,608676,0.00016199,98.60198994
38092,陳如枝,1,608677,0.00016199,98.60215193
38093,陳安之,1,608678,0.00016199,98.60231393
38094,陳年,1,608679,0.00016199,98.60247592
38095,陳年紹興,1,608680,0.00016199,98.60263791
38096,陳志朋,1,608681,0.00016199,98.60279991
38097,陳沖,1,608682,0.00016199,98.60296190
38098,陳協同,1,608683,0.00016199,98.60312390
38099,陳宗仁,1,608684,0.00016199,98.60328589
38100,陳居德,1,608685,0.00016199,98.60344788
38101,陳忠強,1,608686,0.00016199,98.60360988
38102,陳明文,1,608687,0.00016199,98.60377187
38103,陳東龍,1,608688,0.00016199,98.60393387
38104,陳河,1,608689,0.00016199,98.60409586
38105,陳芬蘭,1,608690,0.00016199,98.60425786
38106,陳金成,1,608691,0.00016199,98.60441985
38107,陳金松,1,608692,0.00016199,98.60458184
38108,陳金章,1,608693,0.00016199,98.60474384
38109,陳金森,1,608694,0.00016199,98.60490583
38110,陳亮全,1,608695,0.00016199,98.60506783
38111,陳亮運,1,608696,0.00016199,98.60522982
38112,陳信正,1,608697,0.00016199,98.60539182
38113,陳保元,1,608698,0.00016199,98.60555381
38114,陳俊合,1,608699,0.00016199,98.60571580
38115,陳俊彬,1,608700,0.00016199,98.60587780
38116,陳屍,1,608701,0.00016199,98.60603979
38117,陳建元,1,608702,0.00016199,98.60620179
38118,陳建良,1,608703,0.00016199,98.60636378
38119,陳恆榮,1,608704,0.00016199,98.60652577
38120,陳昭姿,1,608705,0.00016199,98.60668777
38121,陳為民,1,608706,0.00016199,98.60684976
38122,陳癸淼,1,608707,0.00016199,98.60701176
38123,陳美文,1,608708,0.00016199,98.60717375
38124,陳美珍,1,608709,0.00016199,98.60733575
38125,陳美娥,1,608710,0.00016199,98.60749774
38126,陳胡姚,1,608711,0.00016199,98.60765973
38127,陳飛龍,1,608712,0.00016199,98.60782173
38128,陳香蘭,1,608713,0.00016199,98.60798372
38129,陳夏生,1,608714,0.00016199,98.60814572
38130,陳振榮,1,608715,0.00016199,98.60830771
38131,陳浩南,1,608716,0.00016199,98.60846971
38132,陳素玲,1,608717,0.00016199,98.60863170
38133,陳素蘭,1,608718,0.00016199,98.60879369
38134,陳偉城,1,608719,0.00016199,98.60895569
38135,陳健楷,1,608720,0.00016199,98.60911768
38136,陳國桂,1,608721,0.00016199,98.60927968
38137,陳國義,1,608722,0.00016199,98.60944167
38138,陳培瑋,1,608723,0.00016199,98.60960366
38139,陳梅毛,1,608724,0.00016199,98.60976566
38140,陳清源,1,608725,0.00016199,98.60992765
38141,陳清寶,1,608726,0.00016199,98.61008965
38142,陳勝,1,608727,0.00016199,98.61025164
38143,陳惠敏,1,608728,0.00016199,98.61041364
38144,陳智華,1,608729,0.00016199,98.61057563
38145,陳朝容,1,608730,0.00016199,98.61073762
38146,陳華焜,1,608731,0.00016199,98.61089962
38147,陳訴,1,608732,0.00016199,98.61106161
38148,陳進興,1,608733,0.00016199,98.61122361
38149,陳隆順,1,608734,0.00016199,98.61138560
38150,陳萬能,1,608735,0.00016199,98.61154760
38151,陳裕德,1,608736,0.00016199,98.61170959
38152,陳誠,1,608737,0.00016199,98.61187158
38153,陳跡,1,608738,0.00016199,98.61203358
38154,陳達,1,608739,0.00016199,98.61219557
38155,陳靖允,1,608740,0.00016199,98.61235757
38156,陳嘉夫,1,608741,0.00016199,98.61251956
38157,陳嘉寧,1,608742,0.00016199,98.61268155
38158,陳漢清,1,608743,0.00016199,98.61284355
38159,陳腐,1,608744,0.00016199,98.61300554
38160,陳儀煇,1,608745,0.00016199,98.61316754
38161,陳德良,1,608746,0.00016199,98.61332953
38162,陳慧玲,1,608747,0.00016199,98.61349153
38163,陳諸浩,1,608748,0.00016199,98.61365352
38164,陳憲欽,1,608749,0.00016199,98.61381551
38165,陳樹都,1,608750,0.00016199,98.61397751
38166,陳樹楷,1,608751,0.00016199,98.61413950
38167,陳興華,1,608752,0.00016199,98.61430150
38168,陳豫,1,608753,0.00016199,98.61446349
38169,陳錦龍,1,608754,0.00016199,98.61462549
38170,陳靜,1,608755,0.00016199,98.61478748
38171,陳濟元,1,608756,0.00016199,98.61494947
38172,陳璧,1,608757,0.00016199,98.61511147
38173,陳舊,1,608758,0.00016199,98.61527346
38174,陳舊性,1,608759,0.00016199,98.61543546
38175,陳鏗榮,1,608760,0.00016199,98.61559745
38176,陳麗玉,1,608761,0.00016199,98.61575945
38177,陸上自衛隊,1,608762,0.00016199,98.61592144
38178,陸文毅,1,608763,0.00016199,98.61608343
38179,陸委會主委,1,608764,0.00016199,98.61624543
38180,陸委會副主委,1,608765,0.00016199,98.61640742
38181,陸航隊,1,608766,0.00016199,98.61656942
38182,陸陸湧湧,1,608767,0.00016199,98.61673141
38183,陸陸續續,1,608768,0.00016199,98.61689340
38184,陸塊,1,608769,0.00016199,98.61705540
38185,陸運,1,608770,0.00016199,98.61721739
38186,陸戰師,1,608771,0.00016199,98.61737939
38187,陸總,1,608772,0.00016199,98.61754138
38188,陸總部,1,608773,0.00016199,98.61770338
38189,陰天,1,608774,0.00016199,98.61786537
38190,陰冷,1,608775,0.00016199,98.61802736
38191,陰沈,1,608776,0.00016199,98.61818936
38192,陰私,1,608777,0.00016199,98.61835135
38193,陰柔美,1,608778,0.00016199,98.61851335
38194,陰狠,1,608779,0.00016199,98.61867534
38195,陰唇,1,608780,0.00016199,98.61883734
38196,陰乾,1,608781,0.00016199,98.61899933
38197,陰涼,1,608782,0.00016199,98.61916132
38198,陰晴,1,608783,0.00016199,98.61932332
38199,陰森,1,608784,0.00016199,98.61948531
38200,陰道痙攣症,1,608785,0.00016199,98.61964731
38201,陰魂,1,608786,0.00016199,98.61980930
38202,陰魂不散,1,608787,0.00016199,98.61997129
38203,陰謀秘戰,1,608788,0.00016199,98.62013329
38204,陰險,1,608789,0.00016199,98.62029528
38205,陶允正,1,608790,0.00016199,98.62045728
38206,陶朱公,1,608791,0.00016199,98.62061927
38207,陶培德,1,608792,0.00016199,98.62078127
38208,陶淵明,1,608793,0.00016199,98.62094326
38209,陶陶餐廳,1,608794,0.00016199,98.62110525
38210,陶晶瑩,1,608795,0.00016199,98.62126725
38211,陶瑞,1,608796,0.00016199,98.62142924
38212,陶藝,1,608797,0.00016199,98.62159124
38213,陷害,1,608798,0.00016199,98.62175323
38214,陷落,1,608799,0.00016199,98.62191523
38215,雪中送炭,1,608800,0.00016199,98.62207722
38216,雪心菜,1,608801,0.00016199,98.62223921
38217,雪水,1,608802,0.00016199,98.62240121
38218,雪片,1,608803,0.00016199,98.62256320
38219,雪伍德．羅蘭德,1,608804,0.00016199,98.62272520
38220,雪衣,1,608805,0.00016199,98.62288719
38221,雪佛蘭轎車,1,608806,0.00016199,98.62304918
38222,雪泥,1,608807,0.00016199,98.62321118
38223,雪花,1,608808,0.00016199,98.62337317
38224,雪亮,1,608809,0.00016199,98.62353517
38225,雪城,1,608810,0.00016199,98.62369716
38226,雪面銅版紙,1,608811,0.00016199,98.62385916
38227,雪恥,1,608812,0.00016199,98.62402115
38228,雪梨人,1,608813,0.00016199,98.62418314
38229,雪梨大學,1,608814,0.00016199,98.62434514
38230,雪球,1,608815,0.00016199,98.62450713
38231,雪莉史川格菲,1,608816,0.00016199,98.62466913
38232,雪智城,1,608817,0.00016199,98.62483112
38233,雪菲爾號,1,608818,0.00016199,98.62499312
38234,雪蛤魚翅盅,1,608819,0.00016199,98.62515511
38235,雪裡紅,1,608820,0.00016199,98.62531710
38236,雪歌妮薇佛,1,608821,0.00016199,98.62547910
38237,雪鐵龍,1,608822,0.00016199,98.62564109
38238,章念馳,1,608823,0.00016199,98.62580309
38239,章倩萍,1,608824,0.00016199,98.62596508
38240,章魚,1,608825,0.00016199,98.62612707
38241,竟夜,1,608826,0.00016199,98.62628907
38242,頂天立地,1,608827,0.00016199,98.62645106
38243,頂好超市,1,608828,0.00016199,98.62661306
38244,頂住,1,608829,0.00016199,98.62677505
38245,頂果仁波切,1,608830,0.00016199,98.62693705
38246,頂峰,1,608831,0.00016199,98.62709904
38247,頂篷,1,608832,0.00016199,98.62726103
38248,頂讓,1,608833,0.00016199,98.62742303
38249,魚丸,1,608834,0.00016199,98.62758502
38250,魚子,1,608835,0.00016199,98.62774702
38251,魚山,1,608836,0.00016199,98.62790901
38252,魚山鄉,1,608837,0.00016199,98.62807101
38253,魚水交歡,1,608838,0.00016199,98.62823300
38254,魚火鍋,1,608839,0.00016199,98.62839499
38255,魚片,1,608840,0.00016199,98.62855699
38256,魚目混珠,1,608841,0.00016199,98.62871898
38257,魚池之殃,1,608842,0.00016199,98.62888098
38258,魚池鄉,1,608843,0.00016199,98.62904297
38259,魚肉,1,608844,0.00016199,98.62920496
38260,魚尾獅,1,608845,0.00016199,98.62936696
38261,魚肝,1,608846,0.00016199,98.62952895
38262,魚肝油,1,608847,0.00016199,98.62969095
38263,魚肚,1,608848,0.00016199,98.62985294
38264,魚貫,1,608849,0.00016199,98.63001494
38265,魚場,1,608850,0.00016199,98.63017693
38266,魚湯,1,608851,0.00016199,98.63033892
38267,魚量,1,608852,0.00016199,98.63050092
38268,魚腮,1,608853,0.00016199,98.63066291
38269,魚腹,1,608854,0.00016199,98.63082491
38270,魚雷,1,608855,0.00016199,98.63098690
38271,魚雷快艇,1,608856,0.00016199,98.63114890
38272,魚雷發射管,1,608857,0.00016199,98.63131089
38273,魚獲,1,608858,0.00016199,98.63147288
38274,魚體,1,608859,0.00016199,98.63163488
38275,鳥不拉屎,1,608860,0.00016199,98.63179687
38276,鳥居,1,608861,0.00016199,98.63195887
38277,鳥鳴,1,608862,0.00016199,98.63212086
38278,鳥鳴器,1,608863,0.00016199,98.63228285
38279,鳥糞嘌呤,1,608864,0.00016199,98.63244485
38280,鳥囀,1,608865,0.00016199,98.63260684
38281,鳥籠,1,608866,0.00016199,98.63276884
38282,鹿皮,1,608867,0.00016199,98.63293083
38283,鹿兒島市,1,608868,0.00016199,98.63309283
38284,鹿鼎大帝,1,608869,0.00016199,98.63325482
38285,麥加利,1,608870,0.00016199,98.63341681
38286,麥可,1,608871,0.00016199,98.63357881
38287,麥可．傑克森,1,608872,0.00016199,98.63374080
38288,麥可．黃,1,608873,0.00016199,98.63390280
38289,麥可貝,1,608874,0.00016199,98.63406479
38290,麥米蘭,1,608875,0.00016199,98.63422679
38291,麥考．懷玆,1,608876,0.00016199,98.63438878
38292,麥佛遜懸載系統,1,608877,0.00016199,98.63455077
38293,麥克．布瑞爾,1,608878,0.00016199,98.63471277
38294,麥克匹克,1,608879,0.00016199,98.63487476
38295,麥克阿瑟,1,608880,0.00016199,98.63503676
38296,麥克紐威爾,1,608881,0.00016199,98.63519875
38297,麥克萊門,1,608882,0.00016199,98.63536074
38298,麥克瑞,1,608883,0.00016199,98.63552274
38299,麥克芮爾,1,608884,0.00016199,98.63568473
38300,麥肯廣告,1,608885,0.00016199,98.63584673
38301,麥金塔系統,1,608886,0.00016199,98.63600872
38302,麥帥,1,608887,0.00016199,98.63617072
38303,麥迪遜,1,608888,0.00016199,98.63633271
38304,麥香紅茶,1,608889,0.00016199,98.63649470
38305,麥格,1,608890,0.00016199,98.63665670
38306,麥堤,1,608891,0.00016199,98.63681869
38307,麥斯威爾,1,608892,0.00016199,98.63698069
38308,麥當勞式,1,608893,0.00016199,98.63714268
38309,麥類,1,608894,0.00016199,98.63730468
38310,麻,1,608895,0.00016199,98.63746667
38311,麻子臉,1,608896,0.00016199,98.63762866
38312,麻竹,1,608897,0.00016199,98.63779066
38313,麻豆鎮,1,608898,0.00016199,98.63795265
38314,麻油,1,608899,0.00016199,98.63811465
38315,麻油蛋,1,608900,0.00016199,98.63827664
38316,麻油蝦,1,608901,0.00016199,98.63843863
38317,麻油雞,1,608902,0.00016199,98.63860063
38318,麻風病,1,608903,0.00016199,98.63876262
38319,麻將桌,1,608904,0.00016199,98.63892462
38320,麻雀變鳳凰,1,608905,0.00016199,98.63908661
38321,麻辣,1,608906,0.00016199,98.63924861
38322,麻醉性,1,608907,0.00016199,98.63941060
38323,麻醉藥品管制條例,1,608908,0.00016199,98.63957259
38324,麻薩諸塞,1,608909,0.00016199,98.63973459
38325,麻醬,1,608910,0.00016199,98.63989658
38326,傢俱,1,608911,0.00016199,98.64005858
38327,傍水,1,608912,0.00016199,98.64022057
38328,傅士炎,1,608913,0.00016199,98.64038257
38329,傅佩榮,1,608914,0.00016199,98.64054456
38330,傅怡嘉,1,608915,0.00016199,98.64070655
38331,傅俊璠,1,608916,0.00016199,98.64086855
38332,傅崑成,1,608917,0.00016199,98.64103054
38333,傅薇,1,608918,0.00016199,98.64119254
38334,備有,1,608919,0.00016199,98.64135453
38335,備忘,1,608920,0.00016199,98.64151653
38336,備受肯定,1,608921,0.00016199,98.64167852
38337,備急,1,608922,0.00016199,98.64184051
38338,備查,1,608923,0.00016199,98.64200251
38339,備配,1,608924,0.00016199,98.64216450
38340,備詢,1,608925,0.00016199,98.64232650
38341,備戰,1,608926,0.00016199,98.64248849
38342,備戰期,1,608927,0.00016199,98.64265048
38343,傑夫．范．甘迪,1,608928,0.00016199,98.64281248
38344,傑夫丹尼爾,1,608929,0.00016199,98.64297447
38345,傑夫高布倫,1,608930,0.00016199,98.64313647
38346,傑米諾,1,608931,0.00016199,98.64329846
38347,傑西,1,608932,0.00016199,98.64346046
38348,傑佛瑞,1,608933,0.00016199,98.64362245
38349,傑哈德巴狄厄,1,608934,0.00016199,98.64378444
38350,傑黑思凱,1,608935,0.00016199,98.64394644
38351,傑瑞,1,608936,0.00016199,98.64410843
38352,傑瑞米．邊沁,1,608937,0.00016199,98.64427043
38353,傀儡,1,608938,0.00016199,98.64443242
38354,傀儡戲,1,608939,0.00016199,98.64459442
38355,傘兵,1,608940,0.00016199,98.64475641
38356,最低工資,1,608941,0.00016199,98.64491840
38357,最佳女主角獎,1,608942,0.00016199,98.64508040
38358,凱,1,608943,0.00016199,98.64524239
38359,凱化,1,608944,0.00016199,98.64540439
38360,凱化貿易,1,608945,0.00016199,98.64556638
38361,凱夫勒纖維,1,608946,0.00016199,98.64572837
38362,凱文柯斯納,1,608947,0.00016199,98.64589037
38363,凱文雷諾,1,608948,0.00016199,98.64605236
38364,凱因斯,1,608949,0.00016199,98.64621436
38365,凱克斯堡事件,1,608950,0.00016199,98.64637635
38366,凱迪拉克,1,608951,0.00016199,98.64653835
38367,凱悅大飯店,1,608952,0.00016199,98.64670034
38368,凱旋,1,608953,0.00016199,98.64686233
38369,凱斯,1,608954,0.00016199,98.64702433
38370,凱楠公司,1,608955,0.00016199,98.64718632
38371,凱蒂,1,608956,0.00016199,98.64734832
38372,凱撒,1,608957,0.00016199,98.64751031
38373,凱撒琳二世,1,608958,0.00016199,98.64767231
38374,凱撒琳大帝,1,608959,0.00016199,98.64783430
38375,凱撒獎,1,608960,0.00016199,98.64799629
38376,凱樂因,1,608961,0.00016199,98.64815829
38377,凱衛特,1,608962,0.00016199,98.64832028
38378,凱歸,1,608963,0.00016199,98.64848228
38379,割掉,1,608964,0.00016199,98.64864427
38380,割開,1,608965,0.00016199,98.64880626
38381,割傷,1,608966,0.00016199,98.64896826
38382,割讓,1,608967,0.00016199,98.64913025
38383,剴切,1,608968,0.00016199,98.64929225
38384,創出,1,608969,0.00016199,98.64945424
38385,創巨,1,608970,0.00016199,98.64961624
38386,創投,1,608971,0.00016199,98.64977823
38387,創始者,1,608972,0.00016199,98.64994022
38388,創痕,1,608973,0.00016199,98.65010222
38389,創報人,1,608974,0.00016199,98.65026421
38390,創意人,1,608975,0.00016199,98.65042621
38391,創意者,1,608976,0.00016199,98.65058820
38392,創新性,1,608977,0.00016199,98.65075020
38393,創黨,1,608978,0.00016199,98.65091219
38394,勞力密集加工特區,1,608979,0.00016199,98.65107418
38395,勞工局,1,608980,0.00016199,98.65123618
38396,勞工委員會,1,608981,0.00016199,98.65139817
38397,勞工部長,1,608982,0.00016199,98.65156017
38398,勞工運動,1,608983,0.00016199,98.65172216
38399,勞勃狄尼洛,1,608984,0.00016199,98.65188415
38400,勞軍團,1,608985,0.00016199,98.65204615
38401,勞倫遜,1,608986,0.00016199,98.65220814
38402,勞師動眾,1,608987,0.00016199,98.65237014
38403,勞務,1,608988,0.00016199,98.65253213
38404,勞動基準法,1,608989,0.00016199,98.65269413
38405,勞教委員,1,608990,0.00016199,98.65285612
38406,勞斯萊斯,1,608991,0.00016199,98.65301811
38407,勞煩,1,608992,0.00016199,98.65318011
38408,勞資,1,608993,0.00016199,98.65334210
38409,勞資糾紛,1,608994,0.00016199,98.65350410
38410,勞頓,1,608995,0.00016199,98.65366609
38411,勞燕分飛,1,608996,0.00016199,98.65382809
38412,勝大莊,1,608997,0.00016199,98.65399008
38413,勝仗,1,608998,0.00016199,98.65415207
38414,勝利女神,1,608999,0.00016199,98.65431407
38415,勝局,1,609000,0.00016199,98.65447606
38416,勝投王,1,609001,0.00016199,98.65463806
38417,勝果,1,609002,0.00016199,98.65480005
38418,勝負手,1,609003,0.00016199,98.65496204
38419,勝境,1,609004,0.00016199,98.65512404
38420,博上富康,1,609005,0.00016199,98.65528603
38421,博士兒兒童電腦多媒體,1,609006,0.00016199,98.65544803
38422,博士聯合才藝中心,1,609007,0.00016199,98.65561002
38423,博多人形,1,609008,0.00016199,98.65577202
38424,博多車站,1,609009,0.00016199,98.65593401
38425,博多區,1,609010,0.00016199,98.65609600
38426,博多港祭,1,609011,0.00016199,98.65625800
38427,博奕,1,609012,0.00016199,98.65641999
38428,博偉公司,1,609013,0.00016199,98.65658199
38429,博偉電影公司,1,609014,0.00016199,98.65674398
38430,博斯普魯斯海峽,1,609015,0.00016199,98.65690598
38431,博愛,1,609016,0.00016199,98.65706797
38432,博愛特區,1,609017,0.00016199,98.65722996
38433,博新,1,609018,0.00016199,98.65739196
38434,博新公司,1,609019,0.00016199,98.65755395
38435,博碩士,1,609020,0.00016199,98.65771595
38436,博德曼,1,609021,0.00016199,98.65787794
38437,博覽,1,609022,0.00016199,98.65803993
38438,博覽家,1,609023,0.00016199,98.65820193
38439,厥,1,609024,0.00016199,98.65836392
38440,喀里幾多島,1,609025,0.00016199,98.65852592
38441,喀哩幾多島,1,609026,0.00016199,98.65868791
38442,喧賓奪主,1,609027,0.00016199,98.65884991
38443,啼不住,1,609028,0.00016199,98.65901190
38444,啼笑皆非,1,609029,0.00016199,98.65917389
38445,喊叫,1,609030,0.00016199,98.65933589
38446,喊喊,1,609031,0.00016199,98.65949788
38447,喝完,1,609032,0.00016199,98.65965988
38448,喝釆,1,609033,0.00016199,98.65982187
38449,喝茶,1,609034,0.00016199,98.65998387
38450,喝啤酒大賽,1,609035,0.00016199,98.66014586
38451,喝啤酒比賽,1,609036,0.00016199,98.66030785
38452,喝喜酒,1,609037,0.00016199,98.66046985
38453,喝飲,1,609038,0.00016199,98.66063184
38454,喘氣,1,609039,0.00016199,98.66079384
38455,喘喘氣,1,609040,0.00016199,98.66095583
38456,喜出望外,1,609041,0.00016199,98.66111782
38457,喜好者,1,609042,0.00016199,98.66127982
38458,喜孜孜,1,609043,0.00016199,98.66144181
38459,喜怒,1,609044,0.00016199,98.66160381
38460,喜怒無常,1,609045,0.00016199,98.66176580
38461,喜美汽車,1,609046,0.00016199,98.66192780
38462,喜氣,1,609047,0.00016199,98.66208979
38463,喜訊,1,609048,0.00016199,98.66225178
38464,喜馬拉雅山,1,609049,0.00016199,98.66241378
38465,喜惡,1,609050,0.00016199,98.66257577
38466,喜極而泣,1,609051,0.00016199,98.66273777
38467,喪禮,1,609052,0.00016199,98.66289976
38468,喇叭花,1,609053,0.00016199,98.66306176
38469,喇叭鎖,1,609054,0.00016199,98.66322375
38470,喃喃,1,609055,0.00016199,98.66338574
38471,單人房,1,609056,0.00016199,98.66354774
38472,單人砲塔,1,609057,0.00016199,98.66370973
38473,單刀直入,1,609058,0.00016199,98.66387173
38474,單方,1,609059,0.00016199,98.66403372
38475,單方面,1,609060,0.00016199,98.66419571
38476,單日,1,609061,0.00016199,98.66435771
38477,單比特數碼,1,609062,0.00016199,98.66451970
38478,單凸輪軸,1,609063,0.00016199,98.66468170
38479,單件,1,609064,0.00016199,98.66484369
38480,單向,1,609065,0.00016199,98.66500569
38481,單向式,1,609066,0.00016199,98.66516768
38482,單行本,1,609067,0.00016199,98.66532967
38483,單行道,1,609068,0.00016199,98.66549167
38484,單兵,1,609069,0.00016199,98.66565366
38485,單季,1,609070,0.00016199,98.66581566
38486,單挑,1,609071,0.00016199,98.66597765
38487,單軌制,1,609072,0.00016199,98.66613965
38488,單飛,1,609073,0.00016199,98.66630164
38489,單格,1,609074,0.00016199,98.66646363
38490,單格攝影,1,609075,0.00016199,98.66662563
38491,單側無腎症,1,609076,0.00016199,98.66678762
38492,單眼皮,1,609077,0.00016199,98.66694962
38493,單場,1,609078,0.00016199,98.66711161
38494,單晶片,1,609079,0.00016199,98.66727360
38495,單項,1,609080,0.00016199,98.66743560
38496,單層,1,609081,0.00016199,98.66759759
38497,單數,1,609082,0.00016199,98.66775959
38498,單賣,1,609083,0.00016199,98.66792158
38499,單憑,1,609084,0.00016199,98.66808358
38500,單薄,1,609085,0.00016199,98.66824557
38501,單點,1,609086,0.00016199,98.66840756
38502,單體式,1,609087,0.00016199,98.66856956
38503,唾手可得,1,609088,0.00016199,98.66873155
38504,唾液,1,609089,0.00016199,98.66889355
38505,唾液腺,1,609090,0.00016199,98.66905554
38506,喬夫公司,1,609091,0.00016199,98.66921754
38507,喬夫科技公司,1,609092,0.00016199,98.66937953
38508,喬可欣,1,609093,0.00016199,98.66954152
38509,喬尼達,1,609094,0.00016199,98.66970352
38510,喬安．瓦加,1,609095,0.00016199,98.66986551
38511,喬艾爾菲斯,1,609096,0.00016199,98.67002751
38512,喬依舒邁克,1,609097,0.00016199,98.67018950
38513,喬治．本恩斯,1,609098,0.00016199,98.67035150
38514,喬治‧夏勒,1,609099,0.00016199,98.67051349
38515,喬治中學,1,609100,0.00016199,98.67067548
38516,喬治布希,1,609101,0.00016199,98.67083748
38517,喬治克隆尼,1,609102,0.00016199,98.67099947
38518,喬治城,1,609103,0.00016199,98.67116147
38519,喬治城大學,1,609104,0.00016199,98.67132346
38520,喬治華盛頓大學,1,609105,0.00016199,98.67148545
38521,喬拿森．葛雷爾,1,609106,0.00016199,98.67164745
38522,喬琪雅凱特,1,609107,0.00016199,98.67180944
38523,喬瑟夫聖塔傑諾,1,609108,0.00016199,98.67197144
38524,喬達彌,1,609109,0.00016199,98.67213343
38525,喬爾柯恩,1,609110,0.00016199,98.67229543
38526,喉,1,609111,0.00016199,98.67245742
38527,喉部,1,609112,0.00016199,98.67261941
38528,喉結,1,609113,0.00016199,98.67278141
38529,喉頭,1,609114,0.00016199,98.67294340
38530,喉嚨痛,1,609115,0.00016199,98.67310540
38531,喙,1,609116,0.00016199,98.67326739
38532,圍巾,1,609117,0.00016199,98.67342939
38533,圍場,1,609118,0.00016199,98.67359138
38534,圍裙,1,609119,0.00016199,98.67375337
38535,圍觀,1,609120,0.00016199,98.67391537
38536,堪查,1,609121,0.00016199,98.67407736
38537,堪察,1,609122,0.00016199,98.67423936
38538,堪薩斯城,1,609123,0.00016199,98.67440135
38539,場內,1,609124,0.00016199,98.67456334
38540,場次,1,609125,0.00016199,98.67472534
38541,場場,1,609126,0.00016199,98.67488733
38542,堤,1,609127,0.00016199,98.67504933
38543,堤八尾木,1,609128,0.00016199,98.67521132
38544,堤岸,1,609129,0.00016199,98.67537332
38545,報人,1,609130,0.00016199,98.67553531
38546,報名處,1,609131,0.00016199,98.67569730
38547,報名費,1,609132,0.00016199,98.67585930
38548,報考,1,609133,0.00016199,98.67602129
38549,報告書,1,609134,0.00016199,98.67618329
38550,報系,1,609135,0.00016199,98.67634528
38551,報到處,1,609136,0.00016199,98.67650728
38552,報表紙,1,609137,0.00016199,98.67666927
38553,報怨,1,609138,0.00016199,98.67683126
38554,報章雜誌,1,609139,0.00016199,98.67699326
38555,報復性,1,609140,0.00016199,98.67715525
38556,報載,1,609141,0.00016199,98.67731725
38557,報酬金,1,609142,0.00016199,98.67747924
38558,報請,1,609143,0.00016199,98.67764123
38559,報銷,1,609144,0.00016199,98.67780323
38560,報導文學推薦獎,1,609145,0.00016199,98.67796522
38561,報導攝影,1,609146,0.00016199,98.67812722
38562,堡壘式,1,609147,0.00016199,98.67828921
38563,壹,1,609148,0.00016199,98.67845121
38564,壹周刊,1,609149,0.00016199,98.67861320
38565,壹週刊,1,609150,0.00016199,98.67877519
38566,壺,1,609151,0.00016199,98.67893719
38567,奠,1,609152,0.00016199,98.67909918
38568,奠基者,1,609153,0.00016199,98.67926118
38569,媚俗,1,609154,0.00016199,98.67942317
38570,媚艷,1,609155,0.00016199,98.67958517
38571,媒人,1,609156,0.00016199,98.67974716
38572,媒婆,1,609157,0.00016199,98.67990915
38573,媒體量,1,609158,0.00016199,98.68007115
38574,媒體熱,1,609159,0.00016199,98.68023314
38575,孳生源,1,609160,0.00016199,98.68039514
38576,寒天,1,609161,0.00016199,98.68055713
38577,寒舍,1,609162,0.00016199,98.68071912
38578,寒倫蓋提國家公園,1,609163,0.00016199,98.68088112
38579,寒氣,1,609164,0.00016199,98.68104311
38580,寒涼,1,609165,0.00016199,98.68120511
38581,寒暑,1,609166,0.00016199,98.68136710
38582,寒暑假,1,609167,0.00016199,98.68152910
38583,寒酸,1,609168,0.00016199,98.68169109
38584,富士,1,609169,0.00016199,98.68185308
38585,富士軟片公司,1,609170,0.00016199,98.68201508
38586,富比士,1,609171,0.00016199,98.68217707
38587,富比世雜誌,1,609172,0.00016199,98.68233907
38588,富加島,1,609173,0.00016199,98.68250106
38589,富田,1,609174,0.00016199,98.68266306
38590,富有者,1,609175,0.00016199,98.68282505
38591,富克斯,1,609176,0.00016199,98.68298704
38592,富邦金融大樓,1,609177,0.00016199,98.68314904
38593,富邦保,1,609178,0.00016199,98.68331103
38594,富邦保險,1,609179,0.00016199,98.68347303
38595,富邦產物保險公司,1,609180,0.00016199,98.68363502
38596,富邦證券,1,609181,0.00016199,98.68379701
38597,富者,1,609182,0.00016199,98.68395901
38598,富庶,1,609183,0.00016199,98.68412100
38599,富強,1,609184,0.00016199,98.68428300
38600,富達麥哲倫基金,1,609185,0.00016199,98.68444499
38601,富達集團,1,609186,0.00016199,98.68460699
38602,富豪汽車,1,609187,0.00016199,98.68476898
38603,富營,1,609188,0.00016199,98.68493097
38604,富蘭克林投資顧問公司,1,609189,0.00016199,98.68509297
38605,富蘭克林投顧經理,1,609190,0.00016199,98.68525496
38606,富蘭克林基金公司,1,609191,0.00016199,98.68541696
38607,寓,1,609192,0.00016199,98.68557895
38608,尊威,1,609193,0.00016199,98.68574095
38609,尊榮服務,1,609194,0.00016199,98.68590294
38610,尊爵會員,1,609195,0.00016199,98.68606493
38611,尋仇,1,609196,0.00016199,98.68622693
38612,尋死,1,609197,0.00016199,98.68638892
38613,尋找台北古城,1,609198,0.00016199,98.68655092
38614,尋找台南古城,1,609199,0.00016199,98.68671291
38615,尋索,1,609200,0.00016199,98.68687490
38616,尋訪,1,609201,0.00016199,98.68703690
38617,尋尋覓覓,1,609202,0.00016199,98.68719889
38618,就地取材,1,609203,0.00016199,98.68736089
38619,就位,1,609204,0.00016199,98.68752288
38620,就近,1,609205,0.00016199,98.68768488
38621,就業成本指數,1,609206,0.00016199,98.68784687
38622,就業指數,1,609207,0.00016199,98.68800886
38623,就業情報雜誌,1,609208,0.00016199,98.68817086
38624,就算是,1,609209,0.00016199,98.68833285
38625,就學,1,609210,0.00016199,98.68849485
38626,就職日,1,609211,0.00016199,98.68865684
38627,嵌,1,609212,0.00016199,98.68881884
38628,嵐,1,609213,0.00016199,98.68898083
38629,幅射能,1,609214,0.00016199,98.68914282
38630,帽客,1,609215,0.00016199,98.68930482
38631,帽蓆,1,609216,0.00016199,98.68946681
38632,幾千,1,609217,0.00016199,98.68962881
38633,幾分之一,1,609218,0.00016199,98.68979080
38634,幾世勇四郎,1,609219,0.00016199,98.68995279
38635,幾年來,1,609220,0.00016199,98.69011479
38636,幾行,1,609221,0.00016199,98.69027678
38637,幾步,1,609222,0.00016199,98.69043878
38638,廂型車,1,609223,0.00016199,98.69060077
38639,弼,1,609224,0.00016199,98.69076277
38640,彭百顯,1,609225,0.00016199,98.69092476
38641,彭佳嶼,1,609226,0.00016199,98.69108675
38642,彭東雄,1,609227,0.00016199,98.69124875
38643,彭威晶,1,609228,0.00016199,98.69141074
38644,彭偉文,1,609229,0.00016199,98.69157274
38645,彭偉華,1,609230,0.00016199,98.69173473
38646,彭紹瑾,1,609231,0.00016199,98.69189673
38647,彭博商業資訊,1,609232,0.00016199,98.69205872
38648,彭富欽,1,609233,0.00016199,98.69222071
38649,彭慧昊,1,609234,0.00016199,98.69238271
38650,彭樹君,1,609235,0.00016199,98.69254470
38651,彭麗真,1,609236,0.00016199,98.69270670
38652,復工,1,609237,0.00016199,98.69286869
38653,復仇女神,1,609238,0.00016199,98.69303068
38654,復旦橋,1,609239,0.00016199,98.69319268
38655,復育計畫,1,609240,0.00016199,98.69335467
38656,復活節清唱,1,609241,0.00016199,98.69351667
38657,復連式,1,609242,0.00016199,98.69367866
38658,復發,1,609243,0.00016199,98.69384066
38659,復發率,1,609244,0.00016199,98.69400265
38660,復業,1,609245,0.00016199,98.69416464
38661,復興國小,1,609246,0.00016199,98.69432664
38662,復興國劇團,1,609247,0.00016199,98.69448863
38663,復興基地,1,609248,0.00016199,98.69465063
38664,復賽,1,609249,0.00016199,98.69481262
38665,復雜,1,609250,0.00016199,98.69497462
38666,復議,1,609251,0.00016199,98.69513661
38667,復權,1,609252,0.00016199,98.69529860
38668,循序性,1,609253,0.00016199,98.69546060
38669,循序漸進,1,609254,0.00016199,98.69562259
38670,循環渦,1,609255,0.00016199,98.69578459
38671,惑,1,609256,0.00016199,98.69594658
38672,惡女,1,609257,0.00016199,98.69610857
38673,惡名,1,609258,0.00016199,98.69627057
38674,惡行,1,609259,0.00016199,98.69643256
38675,惡言相向,1,609260,0.00016199,98.69659456
38676,惡性犯規,1,609261,0.00016199,98.69675655
38677,惡毒,1,609262,0.00016199,98.69691855
38678,惡臭,1,609263,0.00016199,98.69708054
38679,惡鬥,1,609264,0.00016199,98.69724253
38680,惡鬼,1,609265,0.00016199,98.69740453
38681,惡勢力,1,609266,0.00016199,98.69756652
38682,惡夢,1,609267,0.00016199,98.69772852
38683,惡魔島,1,609268,0.00016199,98.69789051
38684,悲心,1,609269,0.00016199,98.69805251
38685,悲壯感,1,609270,0.00016199,98.69821450
38686,悲從中來,1,609271,0.00016199,98.69837649
38687,悲劇性,1,609272,0.00016199,98.69853849
38688,悲歡離合,1,609273,0.00016199,98.69870048
38689,悲觀型,1,609274,0.00016199,98.69886248
38690,悶棍,1,609275,0.00016199,98.69902447
38691,悶熱,1,609276,0.00016199,98.69918647
38692,悶聲,1,609277,0.00016199,98.69934846
38693,惠巧整體設計公司,1,609278,0.00016199,98.69951045
38694,惠州,1,609279,0.00016199,98.69967245
38695,惠特曼,1,609280,0.00016199,98.69983444
38696,惠普公司,1,609281,0.00016199,98.69999644
38697,惠頓,1,609282,0.00016199,98.70015843
38698,愣,1,609283,0.00016199,98.70032042
38699,惺忪,1,609284,0.00016199,98.70048242
38700,慨嘆,1,609285,0.00016199,98.70064441
38701,慨歎,1,609286,0.00016199,98.70080641
38702,惱怒,1,609287,0.00016199,98.70096840
38703,惶惶,1,609288,0.00016199,98.70113040
38704,愒,1,609289,0.00016199,98.70129239
38705,掣,1,609290,0.00016199,98.70145438
38706,掌中戲,1,609291,0.00016199,98.70161638
38707,掌心雷,1,609292,0.00016199,98.70177837
38708,掌有,1,609293,0.00016199,98.70194037
38709,掌兵符,1,609294,0.00016199,98.70210236
38710,掌骨,1,609295,0.00016199,98.70226436
38711,掌控感,1,609296,0.00016199,98.70242635
38712,掌舵,1,609297,0.00016199,98.70258834
38713,掌舵人,1,609298,0.00016199,98.70275034
38714,掌操,1,609299,0.00016199,98.70291233
38715,掌櫃,1,609300,0.00016199,98.70307433
38716,掌權,1,609301,0.00016199,98.70323632
38717,描述語言,1,609302,0.00016199,98.70339831
38718,描畫,1,609303,0.00016199,98.70356031
38719,描摹,1,609304,0.00016199,98.70372230
38720,描邊字型,1,609305,0.00016199,98.70388430
38721,揀,1,609306,0.00016199,98.70404629
38722,揉,1,609307,0.00016199,98.70420829
38723,揉成,1,609308,0.00016199,98.70437028
38724,揉捏,1,609309,0.00016199,98.70453227
38725,插足,1,609310,0.00016199,98.70469427
38726,插股,1,609311,0.00016199,98.70485626
38727,插掛,1,609312,0.00016199,98.70501826
38728,插進,1,609313,0.00016199,98.70518025
38729,插隊,1,609314,0.00016199,98.70534225
38730,插圖,1,609315,0.00016199,98.70550424
38731,提包,1,609316,0.00016199,98.70566623
38732,提卡,1,609317,0.00016199,98.70582823
38733,提供人,1,609318,0.00016199,98.70599022
38734,提姆,1,609319,0.00016199,98.70615222
38735,提姆達利,1,609320,0.00016199,98.70631421
38736,提昇案,1,609321,0.00016199,98.70647620
38737,提洪,1,609322,0.00016199,98.70663820
38738,提倡者,1,609323,0.00016199,98.70680019
38739,提筆,1,609324,0.00016199,98.70696219
38740,提督,1,609325,0.00016199,98.70712418
38741,提過,1,609326,0.00016199,98.70728618
38742,握手言和,1,609327,0.00016199,98.70744817
38743,握把,1,609328,0.00016199,98.70761016
38744,握柄,1,609329,0.00016199,98.70777216
38745,揭去,1,609330,0.00016199,98.70793415
38746,揭示,1,609331,0.00016199,98.70809615
38747,揭露者,1,609332,0.00016199,98.70825814
38748,揮之不去,1,609333,0.00016199,98.70842014
38749,揮揮手,1,609334,0.00016199,98.70858213
38750,揮發,1,609335,0.00016199,98.70874412
38751,援用,1,609336,0.00016199,98.70890612
38752,援例,1,609337,0.00016199,98.70906811
38753,換回,1,609338,0.00016199,98.70923011
38754,換角,1,609339,0.00016199,98.70939210
38755,換季,1,609340,0.00016199,98.70955409
38756,換場制,1,609341,0.00016199,98.70971609
38757,換換,1,609342,0.00016199,98.70987808
38758,換發,1,609343,0.00016199,98.71004008
38759,換跑道,1,609344,0.00016199,98.71020207
38760,摒,1,609345,0.00016199,98.71036407
38761,摒住,1,609346,0.00016199,98.71052606
38762,摒棄,1,609347,0.00016199,98.71068805
38763,揹負,1,609348,0.00016199,98.71085005
38764,敞,1,609349,0.00016199,98.71101204
38765,敞人,1,609350,0.00016199,98.71117404
38766,敞蓬車,1,609351,0.00016199,98.71133603
38767,敞篷車,1,609352,0.00016199,98.71149803
38768,敦,1,609353,0.00016199,98.71166002
38769,敦化大廈,1,609354,0.00016199,98.71182201
38770,敦南,1,609355,0.00016199,98.71198401
38771,敦南館,1,609356,0.00016199,98.71214600
38772,敦厚,1,609357,0.00016199,98.71230800
38773,敦煌市,1,609358,0.00016199,98.71246999
38774,敦煌石窟,1,609359,0.00016199,98.71263198
38775,敦煌書局,1,609360,0.00016199,98.71279398
38776,敦聘,1,609361,0.00016199,98.71295597
38777,敢不敢,1,609362,0.00016199,98.71311797
38778,敢做,1,609363,0.00016199,98.71327996
38779,散心,1,609364,0.00016199,98.71344196
38780,散村,1,609365,0.00016199,98.71360395
38781,散客,1,609366,0.00016199,98.71376594
38782,散場,1,609367,0.00016199,98.71392794
38783,散亂,1,609368,0.00016199,98.71408993
38784,散亂心,1,609369,0.00016199,98.71425193
38785,散裝,1,609370,0.00016199,98.71441392
38786,散盡,1,609371,0.00016199,98.71457592
38787,散離,1,609372,0.00016199,98.71473791
38788,散雜貨,1,609373,0.00016199,98.71489990
38789,斑斑,1,609374,0.00016199,98.71506190
38790,斑鳩,1,609375,0.00016199,98.71522389
38791,斐瑟,1,609376,0.00016199,98.71538589
38792,斯洛克,1,609377,0.00016199,98.71554788
38793,斯特,1,609378,0.00016199,98.71570987
38794,斯高耀,1,609379,0.00016199,98.71587187
38795,斯雀契,1,609380,0.00016199,98.71603386
38796,斯德哥爾摩,1,609381,0.00016199,98.71619586
38797,斯德哥爾摩市,1,609382,0.00016199,98.71635785
38798,普及化,1,609383,0.00016199,98.71651985
38799,普利托里亞,1,609384,0.00016199,98.71668184
38800,普希金,1,609385,0.00016199,98.71684383
38801,普里阿摩斯,1,609386,0.00016199,98.71700583
38802,普里阿摩斯寶藏,1,609387,0.00016199,98.71716782
38803,普林斯頓大學,1,609388,0.00016199,98.71732982
38804,普契尼,1,609389,0.00016199,98.71749181
38805,普洛特,1,609390,0.00016199,98.71765381
38806,普通人,1,609391,0.00016199,98.71781580
38807,普通公司債,1,609392,0.00016199,98.71797779
38808,普通列車,1,609393,0.00016199,98.71813979
38809,普惠公司,1,609394,0.00016199,98.71830178
38810,普遍性,1,609395,0.00016199,98.71846378
38811,普遍級,1,609396,0.00016199,98.71862577
38812,普羅大眾,1,609397,0.00016199,98.71878776
38813,普羅旺斯,1,609398,0.00016199,98.71894976
38814,晴,1,609399,0.00016199,98.71911175
38815,晴天,1,609400,0.00016199,98.71927375
38816,晴天霹靂,1,609401,0.00016199,98.71943574
38817,晴雨,1,609402,0.00016199,98.71959774
38818,晴朗,1,609403,0.00016199,98.71975973
38819,晶,1,609404,0.00016199,98.71992172
38820,晶亮,1,609405,0.00016199,98.72008372
38821,晶透,1,609406,0.00016199,98.72024571
38822,晶瑩剔透,1,609407,0.00016199,98.72040771
38823,晶體機,1,609408,0.00016199,98.72056970
38824,景文高中,1,609409,0.00016199,98.72073170
38825,景美女中,1,609410,0.00016199,98.72089369
38826,景氣回升股,1,609411,0.00016199,98.72105568
38827,景氣對策燈號,1,609412,0.00016199,98.72121768
38828,景泰日認,1,609413,0.00016199,98.72137967
38829,景泰投顧,1,609414,0.00016199,98.72154167
38830,景境,1,609415,0.00016199,98.72170366
38831,景福街,1,609416,0.00016199,98.72186565
38832,智障,1,609417,0.00016199,98.72202765
38833,智慧女神,1,609418,0.00016199,98.72218964
38834,智慧心,1,609419,0.00016199,98.72235164
38835,智慧型電話,1,609420,0.00016199,98.72251363
38836,智慧財產權協定,1,609421,0.00016199,98.72267563
38837,智囊,1,609422,0.00016199,98.72283762
38838,晾,1,609423,0.00016199,98.72299961
38839,晾一晾,1,609424,0.00016199,98.72316161
38840,曾介宗,1,609425,0.00016199,98.72332360
38841,曾文惠,1,609426,0.00016199,98.72348560
38842,曾正召,1,609427,0.00016199,98.72364759
38843,曾秀保,1,609428,0.00016199,98.72380959
38844,曾武雄,1,609429,0.00016199,98.72397158
38845,曾建成,1,609430,0.00016199,98.72413357
38846,曾為,1,609431,0.00016199,98.72429557
38847,曾茂松,1,609432,0.00016199,98.72445756
38848,曾桂香,1,609433,0.00016199,98.72461956
38849,曾梁興,1,609434,0.00016199,98.72478155
38850,曾貴章,1,609435,0.00016199,98.72494354
38851,曾維茂,1,609436,0.00016199,98.72510554
38852,曾廣田,1,609437,0.00016199,98.72526753
38853,曾慧燕,1,609438,0.00016199,98.72542953
38854,曾豐仁,1,609439,0.00016199,98.72559152
38855,曾蘭淑,1,609440,0.00016199,98.72575352
38856,替身,1,609441,0.00016199,98.72591551
38857,期中考,1,609442,0.00016199,98.72607750
38858,期中報告,1,609443,0.00016199,98.72623950
38859,期貨交所,1,609444,0.00016199,98.72640149
38860,期貨交易所,1,609445,0.00016199,98.72656349
38861,朝夕相處,1,609446,0.00016199,98.72672548
38862,朝山,1,609447,0.00016199,98.72688748
38863,朝日生啤酒,1,609448,0.00016199,98.72704947
38864,朝日新聞,1,609449,0.00016199,98.72721146
38865,朝向,1,609450,0.00016199,98.72737346
38866,朝氣蓬勃,1,609451,0.00016199,98.72753545
38867,朝野對話,1,609452,0.00016199,98.72769745
38868,朝陽,1,609453,0.00016199,98.72785944
38869,朝聖地,1,609454,0.00016199,98.72802144
38870,朝聖者,1,609455,0.00016199,98.72818343
38871,棕紅色,1,609456,0.00016199,98.72834542
38872,棕愛一生,1,609457,0.00016199,98.72850742
38873,棕櫚葉,1,609458,0.00016199,98.72866941
38874,棗,1,609459,0.00016199,98.72883141
38875,棗李,1,609460,0.00016199,98.72899340
38876,椅背,1,609461,0.00016199,98.72915539
38877,棟樑,1,609462,0.00016199,98.72931739
38878,森林王子,1,609463,0.00016199,98.72947938
38879,森林步道,1,609464,0.00016199,98.72964138
38880,森林性,1,609465,0.00016199,98.72980337
38881,森林遊樂區,1,609466,0.00016199,98.72996537
38882,森森,1,609467,0.00016199,98.73012736
38883,棧戀,1,609468,0.00016199,98.73028935
38884,棒球卡,1,609469,0.00016199,98.73045135
38885,棒球賽,1,609470,0.00016199,98.73061334
38886,棒壇,1,609471,0.00016199,98.73077534
38887,棲所,1,609472,0.00016199,98.73093733
38888,棲息區,1,609473,0.00016199,98.73109933
38889,棋,1,609474,0.00016199,98.73126132
38890,棋差一著,1,609475,0.00016199,98.73142331
38891,棋藝,1,609476,0.00016199,98.73158531
38892,棍手,1,609477,0.00016199,98.73174730
38893,植入,1,609478,0.00016199,98.73190930
38894,植物油,1,609479,0.00016199,98.73207129
38895,植物學,1,609480,0.00016199,98.73223328
38896,植物體,1,609481,0.00016199,98.73239528
38897,椎間盤,1,609482,0.00016199,98.73255727
38898,椎間盤突出,1,609483,0.00016199,98.73271927
38899,棉布,1,609484,0.00016199,98.73288126
38900,棉布衫,1,609485,0.00016199,98.73304326
38901,棉花棒,1,609486,0.00016199,98.73320525
38902,棉條,1,609487,0.00016199,98.73336724
38903,棉麻,1,609488,0.00016199,98.73352924
38904,棉襪,1,609489,0.00016199,98.73369123
38905,棚子,1,609490,0.00016199,98.73385323
38906,欺人太甚,1,609491,0.00016199,98.73401522
38907,欺罔,1,609492,0.00016199,98.73417722
38908,欺侮,1,609493,0.00016199,98.73433921
38909,欺凌,1,609494,0.00016199,98.73450120
38910,欽,1,609495,0.00016199,98.73466320
38911,欽羨,1,609496,0.00016199,98.73482519
38912,殘垣斷壁,1,609497,0.00016199,98.73498719
38913,殘破,1,609498,0.00016199,98.73514918
38914,殘缺不全,1,609499,0.00016199,98.73531117
38915,殘障奧運會,1,609500,0.00016199,98.73547317
38916,殘廢者,1,609501,0.00016199,98.73563516
38917,殘餘物,1,609502,0.00016199,98.73579716
38918,殼,1,609503,0.00016199,98.73595915
38919,氯化鈣,1,609504,0.00016199,98.73612115
38920,氯化鈉,1,609505,0.00016199,98.73628314
38921,氯黴素,1,609506,0.00016199,98.73644513
38922,氬氣,1,609507,0.00016199,98.73660713
38923,港人治港,1,609508,0.00016199,98.73676912
38924,港口村,1,609509,0.00016199,98.73693112
38925,港台,1,609510,0.00016199,98.73709311
38926,港市合一,1,609511,0.00016199,98.73725511
38927,港府,1,609512,0.00016199,98.73741710
38928,港埠,1,609513,0.00016199,98.73757909
38929,港都,1,609514,0.00016199,98.73774109
38930,港督,1,609515,0.00016199,98.73790308
38931,港際整合,1,609516,0.00016199,98.73806508
38932,港橋,1,609517,0.00016199,98.73822707
38933,港聯,1,609518,0.00016199,98.73838906
38934,游刃有餘,1,609519,0.00016199,98.73855106
38935,游手好閒,1,609520,0.00016199,98.73871305
38936,游文雄,1,609521,0.00016199,98.73887505
38937,游其昌,1,609522,0.00016199,98.73903704
38938,游牧民族,1,609523,0.00016199,98.73919904
38939,游牧者,1,609524,0.00016199,98.73936103
38940,游客,1,609525,0.00016199,98.73952302
38941,游建華,1,609526,0.00016199,98.73968502
38942,游國村,1,609527,0.00016199,98.73984701
38943,游移,1,609528,0.00016199,98.74000901
38944,游智文,1,609529,0.00016199,98.74017100
38945,游登茂,1,609530,0.00016199,98.74033300
38946,游擊,1,609531,0.00016199,98.74049499
38947,游擊手,1,609532,0.00016199,98.74065698
38948,游擊戰式,1,609533,0.00016199,98.74081898
38949,游離子,1,609534,0.00016199,98.74098097
38950,渡假山莊,1,609535,0.00016199,98.74114297
38951,渡假村,1,609536,0.00016199,98.74130496
38952,渲,1,609537,0.00016199,98.74146695
38953,湧往,1,609538,0.00016199,98.74162895
38954,湧昇流,1,609539,0.00016199,98.74179094
38955,渠,1,609540,0.00016199,98.74195294
38956,渥克咖啡劇場,1,609541,0.00016199,98.74211493
38957,渥克劇團,1,609542,0.00016199,98.74227693
38958,減力,1,609543,0.00016199,98.74243892
38959,減小,1,609544,0.00016199,98.74260091
38960,減去,1,609545,0.00016199,98.74276291
38961,減肥中心,1,609546,0.00016199,98.74292490
38962,減肥期,1,609547,0.00016199,98.74308690
38963,減肥菜,1,609548,0.00016199,98.74324889
38964,減重班,1,609549,0.00016199,98.74341089
38965,減除,1,609550,0.00016199,98.74357288
38966,減速,1,609551,0.00016199,98.74373487
38967,減短,1,609552,0.00016199,98.74389687
38968,減量,1,609553,0.00016199,98.74405886
38969,減廢,1,609554,0.00016199,98.74422086
38970,減震器,1,609555,0.00016199,98.74438285
38971,湛藍,1,609556,0.00016199,98.74454484
38972,湘,1,609557,0.00016199,98.74470684
38973,湖井頭,1,609558,0.00016199,98.74486883
38974,湖水綠,1,609559,0.00016199,98.74503083
38975,湖沼,1,609560,0.00016199,98.74519282
38976,湖畔,1,609561,0.00016199,98.74535482
38977,湖濱高中,1,609562,0.00016199,98.74551681
38978,渭,1,609563,0.00016199,98.74567880
38979,湯汁,1,609564,0.00016199,98.74584080
38980,湯姆,1,609565,0.00016199,98.74600279
38981,湯姆漢克斯,1,609566,0.00016199,98.74616479
38982,湯姆福特,1,609567,0.00016199,98.74632678
38983,湯姆薛狄艾克,1,609568,0.00016199,98.74648878
38984,湯底,1,609569,0.00016199,98.74665077
38985,湯品,1,609570,0.00016199,98.74681276
38986,湯思泮,1,609571,0.00016199,98.74697476
38987,湯英伸,1,609572,0.00016199,98.74713675
38988,湯瑪士,1,609573,0.00016199,98.74729875
38989,湯瑪士‧富朗,1,609574,0.00016199,98.74746074
38990,湯瑪斯．李科納,1,609575,0.00016199,98.74762273
38991,湯瑪斯．柯蘭,1,609576,0.00016199,98.74778473
38992,湯瓢,1,609577,0.00016199,98.74794672
38993,渴,1,609578,0.00016199,98.74810872
38994,湍,1,609579,0.00016199,98.74827071
38995,湍流,1,609580,0.00016199,98.74843271
38996,渺茫,1,609581,0.00016199,98.74859470
38997,測不準,1,609582,0.00016199,98.74875669
38998,測出,1,609583,0.00016199,98.74891869
38999,測定儀,1,609584,0.00016199,98.74908068
39000,測知,1,609585,0.00016199,98.74924268
39001,測距點,1,609586,0.00016199,98.74940467
39002,測試版,1,609587,0.00016199,98.74956667
39003,測試者,1,609588,0.00016199,98.74972866
39004,測謊機,1,609589,0.00016199,98.74989065
39005,渾厚,1,609590,0.00016199,98.75005265
39006,渾海,1,609591,0.00016199,98.75021464
39007,渾蛋,1,609592,0.00016199,98.75037664
39008,渾然,1,609593,0.00016199,98.75053863
39009,渾然天成,1,609594,0.00016199,98.75070062
39010,渾圓,1,609595,0.00016199,98.75086262
39011,滋長,1,609596,0.00016199,98.75102461
39012,滋潤乳液,1,609597,0.00016199,98.75118661
39013,滋潤型,1,609598,0.00016199,98.75134860
39014,滋養層,1,609599,0.00016199,98.75151060
39015,湎茲,1,609600,0.00016199,98.75167259
39016,湄林,1,609601,0.00016199,98.75183458
39017,湄林村,1,609602,0.00016199,98.75199658
39018,焚化,1,609603,0.00016199,98.75215857
39019,焚化爐推動小組,1,609604,0.00016199,98.75232057
39020,焚牛場,1,609605,0.00016199,98.75248256
39021,焚香,1,609606,0.00016199,98.75264456
39022,焦土戰,1,609607,0.00016199,98.75280655
39023,焦平面快門,1,609608,0.00016199,98.75296854
39024,焰,1,609609,0.00016199,98.75313054
39025,無干,1,609610,0.00016199,98.75329253
39026,無不,1,609611,0.00016199,98.75345453
39027,無分先後,1,609612,0.00016199,98.75361652
39028,無孔不入,1,609613,0.00016199,98.75377852
39029,無心,1,609614,0.00016199,98.75394051
39030,無他,1,609615,0.00016199,98.75410250
39031,無可否認,1,609616,0.00016199,98.75426450
39032,無可救藥,1,609617,0.00016199,98.75442649
39033,無可避免,1,609618,0.00016199,98.75458849
39034,無用武之地,1,609619,0.00016199,98.75475048
39035,無名指,1,609620,0.00016199,98.75491247
39036,無米可炊,1,609621,0.00016199,98.75507447
39037,無自用住宅首次購屋貸款額度,1,609622,0.00016199,98.75523646
39038,無自用住宅購買自用住宅貸款,1,609623,0.00016199,98.75539846
39039,無利可圖,1,609624,0.00016199,98.75556045
39040,無忌,1,609625,0.00016199,98.75572245
39041,無足輕重,1,609626,0.00016199,98.75588444
39042,無依無靠,1,609627,0.00016199,98.75604643
39043,無往不利,1,609628,0.00016199,98.75620843
39044,無拘無束,1,609629,0.00016199,98.75637042
39045,無法招架,1,609630,0.00016199,98.75653242
39046,無垠,1,609631,0.00016199,98.75669441
39047,無度,1,609632,0.00016199,98.75685641
39048,無故,1,609633,0.00016199,98.75701840
39049,無段變速自排,1,609634,0.00016199,98.75718039
39050,無畏,1,609635,0.00016199,98.75734239
39051,無計可施,1,609636,0.00016199,98.75750438
39052,無師自通,1,609637,0.00016199,98.75766638
39053,無涉,1,609638,0.00016199,98.75782837
39054,無疾而終,1,609639,0.00016199,98.75799036
39055,無酒精檸檬啤酒,1,609640,0.00016199,98.75815236
39056,無從,1,609641,0.00016199,98.75831435
39057,無條件,1,609642,0.00016199,98.75847635
39058,無涯,1,609643,0.00016199,98.75863834
39059,無牽無掛,1,609644,0.00016199,98.75880034
39060,無產階級,1,609645,0.00016199,98.75896233
39061,無閉鎖凸耳,1,609646,0.00016199,98.75912432
39062,無幾,1,609647,0.00016199,98.75928632
39063,無期徒刑,1,609648,0.00016199,98.75944831
39064,無給職,1,609649,0.00016199,98.75961031
39065,無菌,1,609650,0.00016199,98.75977230
39066,無量,1,609651,0.00016199,98.75993430
39067,無量心,1,609652,0.00016199,98.76009629
39068,無須,1,609653,0.00016199,98.76025828
39069,無意間,1,609654,0.00016199,98.76042028
39070,無意識,1,609655,0.00016199,98.76058227
39071,無業,1,609656,0.00016199,98.76074427
39072,無話可說,1,609657,0.00016199,98.76090626
39073,無過失責任,1,609658,0.00016199,98.76106825
39074,無語,1,609659,0.00016199,98.76123025
39075,無障礙設施,1,609660,0.00016199,98.76139224
39076,無際,1,609661,0.00016199,98.76155424
39077,無價之寶,1,609662,0.00016199,98.76171623
39078,無線電視,1,609663,0.00016199,98.76187823
39079,無線對講機,1,609664,0.00016199,98.76204022
39080,無憾,1,609665,0.00016199,98.76220221
39081,無機,1,609666,0.00016199,98.76236421
39082,無機物質,1,609667,0.00016199,98.76252620
39083,無濟於事,1,609668,0.00016199,98.76268820
39084,無聲無息,1,609669,0.00016199,98.76285019
39085,無禮,1,609670,0.00016199,98.76301219
39086,無雙,1,609671,0.00016199,98.76317418
39087,無厘頭,1,609672,0.00016199,98.76333617
39088,然則,1,609673,0.00016199,98.76349817
39089,煮出來,1,609674,0.00016199,98.76366016
39090,煮沸,1,609675,0.00016199,98.76382216
39091,煮南瓜,1,609676,0.00016199,98.76398415
39092,煮食,1,609677,0.00016199,98.76414614
39093,煮蛋,1,609678,0.00016199,98.76430814
39094,煮開,1,609679,0.00016199,98.76447013
39095,牌友,1,609680,0.00016199,98.76463213
39096,牌告匯價,1,609681,0.00016199,98.76479412
39097,牌局,1,609682,0.00016199,98.76495612
39098,牌型,1,609683,0.00016199,98.76511811
39099,牌匾,1,609684,0.00016199,98.76528010
39100,牌價,1,609685,0.00016199,98.76544210
39101,犀,1,609686,0.00016199,98.76560409
39102,犀牛角,1,609687,0.00016199,98.76576609
39103,猶大,1,609688,0.00016199,98.76592808
39104,猶太區,1,609689,0.00016199,98.76609008
39105,猶太教,1,609690,0.00016199,98.76625207
39106,猶他,1,609691,0.00016199,98.76641406
39107,猶然,1,609692,0.00016199,98.76657606
39108,猴子洞,1,609693,0.00016199,98.76673805
39109,猴急,1,609694,0.00016199,98.76690005
39110,琢磨,1,609695,0.00016199,98.76706204
39111,琥碧戈德柏,1,609696,0.00016199,98.76722403
39112,琵鷺,1,609697,0.00016199,98.76738603
39113,琴弦,1,609698,0.00016199,98.76754802
39114,琴酒,1,609699,0.00016199,98.76771002
39115,琴藝,1,609700,0.00016199,98.76787201
39116,畫下,1,609701,0.00016199,98.76803401
39117,畫上,1,609702,0.00016199,98.76819600
39118,畫不畫,1,609703,0.00016199,98.76835799
39119,畫史,1,609704,0.00016199,98.76851999
39120,畫史上,1,609705,0.00016199,98.76868198
39121,畫卷,1,609706,0.00016199,98.76884398
39122,畫者,1,609707,0.00016199,98.76900597
39123,畫品,1,609708,0.00016199,98.76916797
39124,畫架,1,609709,0.00016199,98.76932996
39125,畫派,1,609710,0.00016199,98.76949195
39126,畫眉,1,609711,0.00016199,98.76965395
39127,畫眉月,1,609712,0.00016199,98.76981594
39128,畫院,1,609713,0.00016199,98.76997794
39129,畫意主義,1,609714,0.00016199,98.77013993
39130,畫滿,1,609715,0.00016199,98.77030192
39131,畫論家,1,609716,0.00016199,98.77046392
39132,畫龍點睛,1,609717,0.00016199,98.77062591
39133,番茄,1,609718,0.00016199,98.77078791
39134,番麥花,1,609719,0.00016199,98.77094990
39135,痛不欲生,1,609720,0.00016199,98.77111190
39136,痛失,1,609721,0.00016199,98.77127389
39137,痛定思痛,1,609722,0.00016199,98.77143588
39138,痛哭流涕,1,609723,0.00016199,98.77159788
39139,痛楚,1,609724,0.00016199,98.77175987
39140,登山口,1,609725,0.00016199,98.77192187
39141,登山步道,1,609726,0.00016199,98.77208386
39142,登山車,1,609727,0.00016199,98.77224586
39143,登山繩,1,609728,0.00016199,98.77240785
39144,登門,1,609729,0.00016199,98.77256984
39145,登幽州臺歌,1,609730,0.00016199,98.77273184
39146,登堂入室,1,609731,0.00016199,98.77289383
39147,登錄表,1,609732,0.00016199,98.77305583
39148,登錄單,1,609733,0.00016199,98.77321782
39149,發人深省,1,609734,0.00016199,98.77337981
39150,發心,1,609735,0.00016199,98.77354181
39151,發文,1,609736,0.00016199,98.77370380
39152,發火,1,609737,0.00016199,98.77386580
39153,發片量,1,609738,0.00016199,98.77402779
39154,發包單位,1,609739,0.00016199,98.77418979
39155,發卡,1,609740,0.00016199,98.77435178
39156,發光,1,609741,0.00016199,98.77451377
39157,發回,1,609742,0.00016199,98.77467577
39158,發佈,1,609743,0.00016199,98.77483776
39159,發呆,1,609744,0.00016199,98.77499976
39160,發育生物學,1,609745,0.00016199,98.77516175
39161,發育期,1,609746,0.00016199,98.77532375
39162,發車,1,609747,0.00016199,98.77548574
39163,發明人,1,609748,0.00016199,98.77564773
39164,發明品,1,609749,0.00016199,98.77580973
39165,發泡,1,609750,0.00016199,98.77597172
39166,發表性,1,609751,0.00016199,98.77613372
39167,發怒,1,609752,0.00016199,98.77629571
39168,發炮,1,609753,0.00016199,98.77645770
39169,發射波,1,609754,0.00016199,98.77661970
39170,發展中國家,1,609755,0.00016199,98.77678169
39171,發展學,1,609756,0.00016199,98.77694369
39172,發動機艙,1,609757,0.00016199,98.77710568
39173,發動權,1,609758,0.00016199,98.77726768
39174,發問,1,609759,0.00016199,98.77742967
39175,發崛,1,609760,0.00016199,98.77759166
39176,發情,1,609761,0.00016199,98.77775366
39177,發球,1,609762,0.00016199,98.77791565
39178,發祥地,1,609763,0.00016199,98.77807765
39179,發貨,1,609764,0.00016199,98.77823964
39180,發愣,1,609765,0.00016199,98.77840164
39181,發愁,1,609766,0.00016199,98.77856363
39182,發號施令,1,609767,0.00016199,98.77872562
39183,發福,1,609768,0.00016199,98.77888762
39184,發憤,1,609769,0.00016199,98.77904961
39185,發熱,1,609770,0.00016199,98.77921161
39186,發稿,1,609771,0.00016199,98.77937360
39187,發奮,1,609772,0.00016199,98.77953559
39188,發燒書,1,609773,0.00016199,98.77969759
39189,發燒級,1,609774,0.00016199,98.77985958
39190,發燒圈,1,609775,0.00016199,98.78002158
39191,發聲,1,609776,0.00016199,98.78018357
39192,發願,1,609777,0.00016199,98.78034557
39193,發顫,1,609778,0.00016199,98.78050756
39194,發紺,1,609779,0.00016199,98.78066955
39195,皴擦,1,609780,0.00016199,98.78083155
39196,盜用,1,609781,0.00016199,98.78099354
39197,盜俠,1,609782,0.00016199,98.78115554
39198,盜帥,1,609783,0.00016199,98.78131753
39199,盜匪,1,609784,0.00016199,98.78147953
39200,盜掘,1,609785,0.00016199,98.78164152
39201,盜採,1,609786,0.00016199,98.78180351
39202,盜獵,1,609787,0.00016199,98.78196551
39203,盜獵者,1,609788,0.00016199,98.78212750
39204,睏,1,609789,0.00016199,98.78228950
39205,短天期國庫券,1,609790,0.00016199,98.78245149
39206,短利,1,609791,0.00016199,98.78261349
39207,短股盈餘,1,609792,0.00016199,98.78277548
39208,短淺,1,609793,0.00016199,98.78293747
39209,短票票券,1,609794,0.00016199,98.78309947
39210,短袖,1,609795,0.00016199,98.78326146
39211,短期票券,1,609796,0.00016199,98.78342346
39212,短評,1,609797,0.00016199,98.78358545
39213,短跑,1,609798,0.00016199,98.78374744
39214,短裙,1,609799,0.00016199,98.78390944
39215,短道速度滑冰,1,609800,0.00016199,98.78407143
39216,短劇,1,609801,0.00016199,98.78423343
39217,短暫性,1,609802,0.00016199,98.78439542
39218,短盤,1,609803,0.00016199,98.78455742
39219,短線技術指標,1,609804,0.00016199,98.78471941
39220,短髮,1,609805,0.00016199,98.78488140
39221,硬皮病,1,609806,0.00016199,98.78504340
39222,硬式,1,609807,0.00016199,98.78520539
39223,硬床,1,609808,0.00016199,98.78536739
39224,硬性,1,609809,0.00016199,98.78552938
39225,硬是,1,609810,0.00016199,98.78569138
39226,硬要,1,609811,0.00016199,98.78585337
39227,硬食,1,609812,0.00016199,98.78601536
39228,硬挺,1,609813,0.00016199,98.78617736
39229,硬幹,1,609814,0.00016199,98.78633935
39230,硬碰硬,1,609815,0.00016199,98.78650135
39231,硬碟片,1,609816,0.00016199,98.78666334
39232,硬質,1,609817,0.00016199,98.78682533
39233,硬闖,1,609818,0.00016199,98.78698733
39234,稍加,1,609819,0.00016199,98.78714932
39235,稍停,1,609820,0.00016199,98.78731132
39236,稍做,1,609821,0.00016199,98.78747331
39237,稍減,1,609822,0.00016199,98.78763531
39238,程仁宏,1,609823,0.00016199,98.78779730
39239,程式工具,1,609824,0.00016199,98.78795929
39240,程式性,1,609825,0.00016199,98.78812129
39241,程式語言,1,609826,0.00016199,98.78828328
39242,程竺津,1,609827,0.00016199,98.78844528
39243,程紹淳,1,609828,0.00016199,98.78860727
39244,程邃,1,609829,0.00016199,98.78876927
39245,稅前純益,1,609830,0.00016199,98.78893126
39246,稅前獲利,1,609831,0.00016199,98.78909325
39247,稅前虧損,1,609832,0.00016199,98.78925525
39248,稅後淨損,1,609833,0.00016199,98.78941724
39249,稅後虧損,1,609834,0.00016199,98.78957924
39250,稅捐,1,609835,0.00016199,98.78974123
39251,稅捐處長,1,609836,0.00016199,98.78990322
39252,稅捐機關稽徵法,1,609837,0.00016199,98.79006522
39253,稅務,1,609838,0.00016199,98.79022721
39254,稅距,1,609839,0.00016199,98.79038921
39255,稅瘟,1,609840,0.00016199,98.79055120
39256,稀世珍寶,1,609841,0.00016199,98.79071320
39257,稀奇古怪,1,609842,0.00016199,98.79087519
39258,稀鬆,1,609843,0.00016199,98.79103718
39259,稀鬆平常,1,609844,0.00016199,98.79119918
39260,窘迫,1,609845,0.00016199,98.79136117
39261,窗型,1,609846,0.00016199,98.79152317
39262,童子軍,1,609847,0.00016199,98.79168516
39263,童子軍團長,1,609848,0.00016199,98.79184716
39264,童兆陽,1,609849,0.00016199,98.79200915
39265,童星,1,609850,0.00016199,98.79217114
39266,童音,1,609851,0.00016199,98.79233314
39267,童真,1,609852,0.00016199,98.79249513
39268,童話式,1,609853,0.00016199,98.79265713
39269,童話書,1,609854,0.00016199,98.79281912
39270,竣,1,609855,0.00016199,98.79298111
39271,竣工,1,609856,0.00016199,98.79314311
39272,等一下,1,609857,0.00016199,98.79330510
39273,等一會兒,1,609858,0.00016199,98.79346710
39274,等同,1,609859,0.00016199,98.79362909
39275,等來等去,1,609860,0.00016199,98.79379109
39276,等待果陀,1,609861,0.00016199,98.79395308
39277,等倍,1,609862,0.00016199,98.79411507
39278,等值,1,609863,0.00016199,98.79427707
39279,等號,1,609864,0.00016199,98.79443906
39280,等職,1,609865,0.00016199,98.79460106
39281,策略聯盟,1,609866,0.00016199,98.79476305
39282,筆力,1,609867,0.00016199,98.79492505
39283,筆下超生,1,609868,0.00016199,98.79508704
39284,筆記狂,1,609869,0.00016199,98.79524903
39285,筆記簿,1,609870,0.00016199,98.79541103
39286,筆筆,1,609871,0.00016199,98.79557302
39287,筆試,1,609872,0.00016199,98.79573502
39288,筆劃,1,609873,0.00016199,98.79589701
39289,筆繪插圖,1,609874,0.00016199,98.79605900
39290,答錄機,1,609875,0.00016199,98.79622100
39291,筍,1,609876,0.00016199,98.79638299
39292,筍干,1,609877,0.00016199,98.79654499
39293,筍絲,1,609878,0.00016199,98.79670698
39294,筋肉,1,609879,0.00016199,98.79686898
39295,筋韌,1,609880,0.00016199,98.79703097
39296,筏,1,609881,0.00016199,98.79719296
39297,粟棕,1,609882,0.00016199,98.79735496
39298,粥少僧多,1,609883,0.00016199,98.79751695
39299,絞刑,1,609884,0.00016199,98.79767895
39300,絞刑台,1,609885,0.00016199,98.79784094
39301,絞痛,1,609886,0.00016199,98.79800294
39302,結不結婚,1,609887,0.00016199,98.79816493
39303,結伴,1,609888,0.00016199,98.79832692
39304,結尾,1,609889,0.00016199,98.79848892
39305,結拜,1,609890,0.00016199,98.79865091
39306,結核,1,609891,0.00016199,98.79881291
39307,結核症,1,609892,0.00016199,98.79897490
39308,結案,1,609893,0.00016199,98.79913689
39309,結訓,1,609894,0.00016199,98.79929889
39310,結球白菜,1,609895,0.00016199,98.79946088
39311,結結巴巴,1,609896,0.00016199,98.79962288
39312,結結實實,1,609897,0.00016199,98.79978487
39313,結匯,1,609898,0.00016199,98.79994687
39314,結夥,1,609899,0.00016199,98.80010886
39315,結夥強盜案,1,609900,0.00016199,98.80027085
39316,結實度,1,609901,0.00016199,98.80043285
39317,結實感,1,609902,0.00016199,98.80059484
39318,結構化,1,609903,0.00016199,98.80075684
39319,結構化資料,1,609904,0.00016199,98.80091883
39320,結構圖,1,609905,0.00016199,98.80108083
39321,結構體,1,609906,0.00016199,98.80124282
39322,結黨,1,609907,0.00016199,98.80140481
39323,絨毛腔,1,609908,0.00016199,98.80156681
39324,絨毛膜取樣術,1,609909,0.00016199,98.80172880
39325,絨布,1,609910,0.00016199,98.80189080
39326,絨球,1,609911,0.00016199,98.80205279
39327,絕口不提,1,609912,0.00016199,98.80221478
39328,絕不,1,609913,0.00016199,98.80237678
39329,絕不是,1,609914,0.00016199,98.80253877
39330,絕少,1,609915,0.00016199,98.80270077
39331,絕世,1,609916,0.00016199,98.80286276
39332,絕地雙尊,1,609917,0.00016199,98.80302476
39333,絕作,1,609918,0.00016199,98.80318675
39334,絕命殺陣,1,609919,0.00016199,98.80334874
39335,絕活,1,609920,0.00016199,98.80351074
39336,絕倒,1,609921,0.00016199,98.80367273
39337,絕配,1,609922,0.00016199,98.80383473
39338,絕無,1,609923,0.00016199,98.80399672
39339,絕無僅有,1,609924,0.00016199,98.80415872
39340,絕跡,1,609925,0.00016199,98.80432071
39341,絕對是,1,609926,0.00016199,98.80448270
39342,絕對值,1,609927,0.00016199,98.80464470
39343,紫外光,1,609928,0.00016199,98.80480669
39344,紫玉,1,609929,0.00016199,98.80496869
39345,紫色系,1,609930,0.00016199,98.80513068
39346,紫紅,1,609931,0.00016199,98.80529267
39347,紫紅色,1,609932,0.00016199,98.80545467
39348,絮絮,1,609933,0.00016199,98.80561666
39349,絲瓜,1,609934,0.00016199,98.80577866
39350,絲帶,1,609935,0.00016199,98.80594065
39351,絲棉,1,609936,0.00016199,98.80610265
39352,絲絲,1,609937,0.00016199,98.80626464
39353,絲絲入扣,1,609938,0.00016199,98.80642663
39354,絲綢,1,609939,0.00016199,98.80658863
39355,絲質,1,609940,0.00016199,98.80675062
39356,絲襪,1,609941,0.00016199,98.80691262
39357,絡,1,609942,0.00016199,98.80707461
39358,絡腮鬍子,1,609943,0.00016199,98.80723661
39359,絡繹不絕,1,609944,0.00016199,98.80739860
39360,給合,1,609945,0.00016199,98.80756059
39361,給藥,1,609946,0.00016199,98.80772259
39362,善化服務所,1,609947,0.00016199,98.80788458
39363,善因,1,609948,0.00016199,98.80804658
39364,善有善報,1,609949,0.00016199,98.80820857
39365,善行,1,609950,0.00016199,98.80837056
39366,善良管理人,1,609951,0.00016199,98.80853256
39367,善果,1,609952,0.00016199,98.80869455
39368,善待,1,609953,0.00016199,98.80885655
39369,善根,1,609954,0.00016199,98.80901854
39370,善業,1,609955,0.00016199,98.80918054
39371,善解,1,609956,0.00016199,98.80934253
39372,善道,1,609957,0.00016199,98.80950452
39373,善體人意,1,609958,0.00016199,98.80966652
39374,翔,1,609959,0.00016199,98.80982851
39375,腕表,1,609960,0.00016199,98.80999051
39376,腔調,1,609961,0.00016199,98.81015250
39377,腎上腺素,1,609962,0.00016199,98.81031450
39378,腎毒性,1,609963,0.00016199,98.81047649
39379,腎絲球,1,609964,0.00016199,98.81063848
39380,脹氣,1,609965,0.00016199,98.81080048
39381,脹痛,1,609966,0.00016199,98.81096247
39382,腆靦,1,609967,0.00016199,98.81112447
39383,脾,1,609968,0.00016199,98.81128646
39384,腴,1,609969,0.00016199,98.81144846
39385,腴潤,1,609970,0.00016199,98.81161045
39386,舒,1,609971,0.00016199,98.81177244
39387,舒克德,1,609972,0.00016199,98.81193444
39388,舒娃茲柯芙,1,609973,0.00016199,98.81209643
39389,舒麥勒,1,609974,0.00016199,98.81225843
39390,舒發,1,609975,0.00016199,98.81242042
39391,舒筋活血,1,609976,0.00016199,98.81258241
39392,舒筋活血散,1,609977,0.00016199,98.81274441
39393,舒邁克,1,609978,0.00016199,98.81290640
39394,舒繡文,1,609979,0.00016199,98.81306840
39395,菩提,1,609980,0.00016199,98.81323039
39396,菩提證果,1,609981,0.00016199,98.81339239
39397,菸毒犯,1,609982,0.00016199,98.81355438
39398,萍水相逢,1,609983,0.00016199,98.81371637
39399,菁英份子,1,609984,0.00016199,98.81387837
39400,華文漪,1,609985,0.00016199,98.81404036
39401,華加志,1,609986,0.00016199,98.81420236
39402,華北,1,609987,0.00016199,98.81436435
39403,華而不實,1,609988,0.00016199,98.81452635
39404,華沙音樂院,1,609989,0.00016199,98.81468834
39405,華邦,1,609990,0.00016199,98.81485033
39406,華邦股票,1,609991,0.00016199,98.81501233
39407,華邦電子,1,609992,0.00016199,98.81517432
39408,華亞科學園區,1,609993,0.00016199,98.81533632
39409,華岡,1,609994,0.00016199,98.81549831
39410,華信銀,1,609995,0.00016199,98.81566030
39411,華南經濟新聞,1,609996,0.00016199,98.81582230
39412,華南銀行,1,609997,0.00016199,98.81598429
39413,華屋,1,609998,0.00016199,98.81614629
39414,華映,1,609999,0.00016199,98.81630828
39415,華映股票,1,610000,0.00016199,98.81647028
39416,華美,1,610001,0.00016199,98.81663227
39417,華倫伯菲特,1,610002,0.00016199,98.81679426
39418,華容道,1,610003,0.00016199,98.81695626
39419,華泰電子,1,610004,0.00016199,98.81711825
39420,華特迪士尼,1,610005,0.00016199,98.81728025
39421,華納台灣分公司,1,610006,0.00016199,98.81744224
39422,華勒沙,1,610007,0.00016199,98.81760424
39423,華康,1,610008,0.00016199,98.81776623
39424,華康公司,1,610009,0.00016199,98.81792822
39425,華得廣告,1,610010,0.00016199,98.81809022
39426,華盛頓公約組織,1,610011,0.00016199,98.81825221
39427,華盛頓國家教堂,1,610012,0.00016199,98.81841421
39428,華盛頓郵報,1,610013,0.00016199,98.81857620
39429,華票,1,610014,0.00016199,98.81873819
39430,華塑集團,1,610015,0.00016199,98.81890019
39431,華新,1,610016,0.00016199,98.81906218
39432,華新麗華,1,610017,0.00016199,98.81922418
39433,華頓學院,1,610018,0.00016199,98.81938617
39434,華歌爾內衣公司,1,610019,0.00016199,98.81954817
39435,華爾滋,1,610020,0.00016199,98.81971016
39436,華語,1,610021,0.00016199,98.81987215
39437,華衛台,1,610022,0.00016199,98.82003415
39438,華衛音樂台,1,610023,0.00016199,98.82019614
39439,華駝,1,610024,0.00016199,98.82035814
39440,華燈初上,1,610025,0.00016199,98.82052013
39441,華興,1,610026,0.00016199,98.82068213
39442,華興名園,1,610027,0.00016199,98.82084412
39443,華懋,1,610028,0.00016199,98.82100611
39444,著力,1,610029,0.00016199,98.82116811
39445,著地,1,610030,0.00016199,98.82133010
39446,著地力,1,610031,0.00016199,98.82149210
39447,著色,1,610032,0.00016199,98.82165409
39448,著色畫,1,610033,0.00016199,98.82181608
39449,著作權,1,610034,0.00016199,98.82197808
39450,著作權法,1,610035,0.00016199,98.82214007
39451,著吾庸議,1,610036,0.00016199,98.82230207
39452,著涼,1,610037,0.00016199,98.82246406
39453,著眼點,1,610038,0.00016199,98.82262606
39454,著陸,1,610039,0.00016199,98.82278805
39455,著墨,1,610040,0.00016199,98.82295004
39456,萊比錫,1,610041,0.00016199,98.82311204
39457,萊布尼茲,1,610042,0.00016199,98.82327403
39458,萊辛格‧艾德加,1,610043,0.00016199,98.82343603
39459,萊姆綠,1,610044,0.00016199,98.82359802
39460,萊特兄弟,1,610045,0.00016199,98.82376002
39461,萊特機場,1,610046,0.00016199,98.82392201
39462,萊爾富超商,1,610047,0.00016199,98.82408400
39463,菌種,1,610048,0.00016199,98.82424600
39464,菲利,1,610049,0.00016199,98.82440799
39465,菲利普島,1,610050,0.00016199,98.82456999
39466,菲迪亞斯,1,610051,0.00016199,98.82473198
39467,菲傭,1,610052,0.00016199,98.82489397
39468,菲爾傑諾,1,610053,0.00016199,98.82505597
39469,菲薄,1,610054,0.00016199,98.82521796
39470,菊八開,1,610055,0.00016199,98.82537996
39471,菊豆,1,610056,0.00016199,98.82554195
39472,菜刀,1,610057,0.00016199,98.82570395
39473,菜市場,1,610058,0.00016199,98.82586594
39474,菜汁,1,610059,0.00016199,98.82602793
39475,菜瓜,1,610060,0.00016199,98.82618993
39476,菜材,1,610061,0.00016199,98.82635192
39477,菜豆,1,610062,0.00016199,98.82651392
39478,菜花,1,610063,0.00016199,98.82667591
39479,菜料,1,610064,0.00016199,98.82683791
39480,菜鳥,1,610065,0.00016199,98.82699990
39481,菜蔬,1,610066,0.00016199,98.82716189
39482,菜頭,1,610067,0.00016199,98.82732389
39483,虛心,1,610068,0.00016199,98.82748588
39484,虛名,1,610069,0.00016199,98.82764788
39485,虛空,1,610070,0.00016199,98.82780987
39486,虛度,1,610071,0.00016199,98.82797186
39487,虛虛實實,1,610072,0.00016199,98.82813386
39488,虛榮心,1,610073,0.00016199,98.82829585
39489,虛應故事,1,610074,0.00016199,98.82845785
39490,虛擬記憶體,1,610075,0.00016199,98.82861984
39491,虛擬實境,1,610076,0.00016199,98.82878184
39492,虛擬機器,1,610077,0.00016199,98.82894383
39493,蛟龍,1,610078,0.00016199,98.82910582
39494,蛙人,1,610079,0.00016199,98.82926782
39495,蛙式,1,610080,0.00016199,98.82942981
39496,蛙眼,1,610081,0.00016199,98.82959181
39497,蛙鏡,1,610082,0.00016199,98.82975380
39498,蛛絲馬跡,1,610083,0.00016199,98.82991580
39499,蛤,1,610084,0.00016199,98.83007779
39500,街衢,1,610085,0.00016199,98.83023978
39501,裁切,1,610086,0.00016199,98.83040178
39502,裁切器,1,610087,0.00016199,98.83056377
39503,裁成,1,610088,0.00016199,98.83072577
39504,裁判長,1,610089,0.00016199,98.83088776
39505,裁決,1,610090,0.00016199,98.83104975
39506,裁奪,1,610091,0.00016199,98.83121175
39507,裁製,1,610092,0.00016199,98.83137374
39508,裁編,1,610093,0.00016199,98.83153574
39509,裂開,1,610094,0.00016199,98.83169773
39510,視同,1,610095,0.00016199,98.83185973
39511,視作,1,610096,0.00016199,98.83202172
39512,視度,1,610097,0.00016199,98.83218371
39513,視查,1,610098,0.00016199,98.83234571
39514,視若無睹,1,610099,0.00016199,98.83250770
39515,視訊捕捉卡,1,610100,0.00016199,98.83266970
39516,視訊輸入端子,1,610101,0.00016199,98.83283169
39517,視訊檔,1,610102,0.00016199,98.83299369
39518,視窗式,1,610103,0.00016199,98.83315568
39519,視窗系統,1,610104,0.00016199,98.83331767
39520,視窗軟體,1,610105,0.00016199,98.83347967
39521,視覺式,1,610106,0.00016199,98.83364166
39522,視覺效果,1,610107,0.00016199,98.83380366
39523,註腳,1,610108,0.00016199,98.83396565
39524,註釋,1,610109,0.00016199,98.83412764
39525,評介,1,610110,0.00016199,98.83428964
39526,評估法,1,610111,0.00016199,98.83445163
39527,評估單位,1,610112,0.00016199,98.83461363
39528,評語,1,610113,0.00016199,98.83477562
39529,評審會,1,610114,0.00016199,98.83493762
39530,評論者,1,610115,0.00016199,98.83509961
39531,評擊,1,610116,0.00016199,98.83526160
39532,評聲,1,610117,0.00016199,98.83542360
39533,評賽,1,610118,0.00016199,98.83558559
39534,評議委員會,1,610119,0.00016199,98.83574759
39535,評鑒,1,610120,0.00016199,98.83590958
39536,詞令,1,610121,0.00016199,98.83607158
39537,詞曲,1,610122,0.00016199,98.83623357
39538,詞彩,1,610123,0.00016199,98.83639556
39539,証,1,610124,0.00016199,98.83655756
39540,証言,1,610125,0.00016199,98.83671955
39541,証據,1,610126,0.00016199,98.83688155
39542,詔安里,1,610127,0.00016199,98.83704354
39543,詛咒,1,610128,0.00016199,98.83720554
39544,詐騙,1,610129,0.00016199,98.83736753
39545,詆毀,1,610130,0.00016199,98.83752952
39546,訴訟,1,610131,0.00016199,98.83769152
39547,診查,1,610132,0.00016199,98.83785351
39548,象牙白獅,1,610133,0.00016199,98.83801551
39549,象牙色,1,610134,0.00016199,98.83817750
39550,象徵性,1,610135,0.00016199,98.83833949
39551,貯積,1,610136,0.00016199,98.83850149
39552,貯藏庫,1,610137,0.00016199,98.83866348
39553,貯藏槽,1,610138,0.00016199,98.83882548
39554,貼上,1,610139,0.00016199,98.83898747
39555,貼片,1,610140,0.00016199,98.83914947
39556,貼布,1,610141,0.00016199,98.83931146
39557,貼皮,1,610142,0.00016199,98.83947345
39558,貼息,1,610143,0.00016199,98.83963545
39559,貼貼,1,610144,0.00016199,98.83979744
39560,貼圖,1,610145,0.00016199,98.83995944
39561,貽害,1,610146,0.00016199,98.84012143
39562,貽笑,1,610147,0.00016199,98.84028343
39563,賁馨儀,1,610148,0.00016199,98.84044542
39564,費里尼,1,610149,0.00016199,98.84060741
39565,費神,1,610150,0.00016199,98.84076941
39566,費國禎,1,610151,0.00016199,98.84093140
39567,費雪迪斯考,1,610152,0.00016199,98.84109340
39568,費爾德,1,610153,0.00016199,98.84125539
39569,費盡心思,1,610154,0.00016199,98.84141738
39570,費德勒,1,610155,0.00016199,98.84157938
39571,費鴻泰,1,610156,0.00016199,98.84174137
39572,賀卡,1,610157,0.00016199,98.84190337
39573,賀伯,1,610158,0.00016199,98.84206536
39574,賀博颱風,1,610159,0.00016199,98.84222736
39575,賀節,1,610160,0.00016199,98.84238935
39576,賀鳴珩,1,610161,0.00016199,98.84255134
39577,賀羅德,1,610162,0.00016199,98.84271334
39578,賀辭,1,610163,0.00016199,98.84287533
39579,貴乃花,1,610164,0.00016199,98.84303733
39580,貴州,1,610165,0.00016199,98.84319932
39581,貴庚,1,610166,0.00016199,98.84336132
39582,貴婦,1,610167,0.00016199,98.84352331
39583,貴婦人,1,610168,0.00016199,98.84368530
39584,貴族學校,1,610169,0.00016199,98.84384730
39585,貴賓金融卡,1,610170,0.00016199,98.84400929
39586,貴賓級,1,610171,0.00016199,98.84417129
39587,貴賤,1,610172,0.00016199,98.84433328
39588,貴點兒,1,610173,0.00016199,98.84449527
39589,買去,1,610174,0.00016199,98.84465727
39590,買回,1,610175,0.00016199,98.84481926
39591,買來買去,1,610176,0.00016199,98.84498126
39592,買昂貴,1,610177,0.00016199,98.84514325
39593,買表,1,610178,0.00016199,98.84530525
39594,買客,1,610179,0.00016199,98.84546724
39595,買得起,1,610180,0.00016199,98.84562923
39596,買單,1,610181,0.00016199,98.84579123
39597,買貴,1,610182,0.00016199,98.84595322
39598,買醉,1,610183,0.00016199,98.84611522
39599,貶抑,1,610184,0.00016199,98.84627721
39600,貶損,1,610185,0.00016199,98.84643921
39601,貿,1,610186,0.00016199,98.84660120
39602,貿易制裁,1,610187,0.00016199,98.84676319
39603,貿易促進會,1,610188,0.00016199,98.84692519
39604,貿易障礙,1,610189,0.00016199,98.84708718
39605,貿易類股,1,610190,0.00016199,98.84724918
39606,越共,1,610191,0.00016199,98.84741117
39607,越來越多,1,610192,0.00016199,98.84757316
39608,越南廠,1,610193,0.00016199,98.84773516
39609,越洋長途電話,1,610194,0.00016199,98.84789715
39610,越洲,1,610195,0.00016199,98.84805915
39611,越野,1,610196,0.00016199,98.84822114
39612,越新工業園區,1,610197,0.00016199,98.84838314
39613,越過死亡線,1,610198,0.00016199,98.84854513
39614,越戰,1,610199,0.00016199,98.84870712
39615,超友誼,1,610200,0.00016199,98.84886912
39616,超乎常人,1,610201,0.00016199,98.84903111
39617,超生,1,610202,0.00016199,98.84919311
39618,超收量,1,610203,0.00016199,98.84935510
39619,超收購量,1,610204,0.00016199,98.84951710
39620,超低空,1,610205,0.00016199,98.84967909
39621,超我,1,610206,0.00016199,98.84984108
39622,超卓,1,610207,0.00016199,98.85000308
39623,超前,1,610208,0.00016199,98.85016507
39624,超秒,1,610209,0.00016199,98.85032707
39625,超音速隊,1,610210,0.00016199,98.85048906
39626,超值價,1,610211,0.00016199,98.85065105
39627,超級大奶媽,1,610212,0.00016199,98.85081305
39628,超級大國民,1,610213,0.00016199,98.85097504
39629,超級市民,1,610214,0.00016199,98.85113704
39630,超級任天堂,1,610215,0.00016199,98.85129903
39631,超級星期天,1,610216,0.00016199,98.85146103
39632,超級馬里歐六十四,1,610217,0.00016199,98.85162302
39633,超級唱片榜,1,610218,0.00016199,98.85178501
39634,超級瑪俐,1,610219,0.00016199,98.85194701
39635,超級廣告,1,610220,0.00016199,98.85210900
39636,超級警探,1,610221,0.00016199,98.85227100
39637,超商,1,610222,0.00016199,98.85243299
39638,超強,1,610223,0.00016199,98.85259499
39639,超理性,1,610224,0.00016199,98.85275698
39640,超現實主義,1,610225,0.00016199,98.85291897
39641,超產,1,610226,0.00016199,98.85308097
39642,超細纖維,1,610227,0.00016199,98.85324296
39643,超連結,1,610228,0.00016199,98.85340496
39644,超速,1,610229,0.00016199,98.85356695
39645,超速快感,1,610230,0.00016199,98.85372894
39646,超然性,1,610231,0.00016199,98.85389094
39647,超絕,1,610232,0.00016199,98.85405293
39648,超貸,1,610233,0.00016199,98.85421493
39649,超勤,1,610234,0.00016199,98.85437692
39650,超群,1,610235,0.00016199,98.85453892
39651,超實感,1,610236,0.00016199,98.85470091
39652,超漲區,1,610237,0.00016199,98.85486290
39653,超編,1,610238,0.00016199,98.85502490
39654,超薄,1,610239,0.00016199,98.85518689
39655,超鏈結,1,610240,0.00016199,98.85534889
39656,超翊公司,1,610241,0.00016199,98.85551088
39657,趁火打劫,1,610242,0.00016199,98.85567288
39658,趁亂,1,610243,0.00016199,98.85583487
39659,跑入,1,610244,0.00016199,98.85599686
39660,跑不動,1,610245,0.00016199,98.85615886
39661,跑出,1,610246,0.00016199,98.85632085
39662,跑出去,1,610247,0.00016199,98.85648285
39663,跑車化,1,610248,0.00016199,98.85664484
39664,跑來,1,610249,0.00016199,98.85680683
39665,跑動,1,610250,0.00016199,98.85696883
39666,跑帶,1,610251,0.00016199,98.85713082
39667,跑單幫,1,610252,0.00016199,98.85729282
39668,跑短線,1,610253,0.00016199,98.85745481
39669,跑距,1,610254,0.00016199,98.85761681
39670,跑跑走走,1,610255,0.00016199,98.85777880
39671,跑跑看,1,610256,0.00016199,98.85794079
39672,跑跑停停,1,610257,0.00016199,98.85810279
39673,跌打損傷,1,610258,0.00016199,98.85826478
39674,跌回,1,610259,0.00016199,98.85842678
39675,跌破眼鏡,1,610260,0.00016199,98.85858877
39676,跌掉,1,610261,0.00016199,98.85875077
39677,跌深反彈,1,610262,0.00016199,98.85891276
39678,跌落谷底,1,610263,0.00016199,98.85907475
39679,跛仔腳山,1,610264,0.00016199,98.85923675
39680,跛腳,1,610265,0.00016199,98.85939874
39681,軼,1,610266,0.00016199,98.85956074
39682,辜公亮文教基金會,1,610267,0.00016199,98.85972273
39683,辜負,1,610268,0.00016199,98.85988472
39684,逮回,1,610269,0.00016199,98.86004672
39685,週末的狂熱,1,610270,0.00016199,98.86020871
39686,週到,1,610271,0.00016199,98.86037071
39687,週旋,1,610272,0.00016199,98.86053270
39688,週產期,1,610273,0.00016199,98.86069470
39689,週圍,1,610274,0.00016199,98.86085669
39690,週報,1,610275,0.00016199,98.86101868
39691,週歲,1,610276,0.00016199,98.86118068
39692,週線,1,610277,0.00016199,98.86134267
39693,週線圖,1,610278,0.00016199,98.86150467
39694,週遭,1,610279,0.00016199,98.86166666
39695,逸,1,610280,0.00016199,98.86182866
39696,逸刀流,1,610281,0.00016199,98.86199065
39697,逸出,1,610282,0.00016199,98.86215264
39698,逸盛,1,610283,0.00016199,98.86231464
39699,逸散,1,610284,0.00016199,98.86247663
39700,進口品,1,610285,0.00016199,98.86263863
39701,進口商,1,610286,0.00016199,98.86280062
39702,進口貨,1,610287,0.00016199,98.86296261
39703,進口量,1,610288,0.00016199,98.86312461
39704,進口額,1,610289,0.00016199,98.86328660
39705,進不了,1,610290,0.00016199,98.86344860
39706,進不去,1,610291,0.00016199,98.86361059
39707,進片,1,610292,0.00016199,98.86377259
39708,進占,1,610293,0.00016199,98.86393458
39709,進位,1,610294,0.00016199,98.86409657
39710,進住,1,610295,0.00016199,98.86425857
39711,進取,1,610296,0.00016199,98.86442056
39712,進城,1,610297,0.00016199,98.86458256
39713,進香團,1,610298,0.00016199,98.86474455
39714,進倉證,1,610299,0.00016199,98.86490655
39715,進涉,1,610300,0.00016199,98.86506854
39716,進退不得,1,610301,0.00016199,98.86523053
39717,進帳,1,610302,0.00016199,98.86539253
39718,進進出出,1,610303,0.00016199,98.86555452
39719,進境,1,610304,0.00016199,98.86571652
39720,進網,1,610305,0.00016199,98.86587851
39721,進豪三容流鍋爐,1,610306,0.00016199,98.86604051
39722,進豪三峰型貫流鍋爐,1,610307,0.00016199,98.86620250
39723,進豪三桃爐,1,610308,0.00016199,98.86636449
39724,進餐,1,610309,0.00016199,98.86652649
39725,進擊,1,610310,0.00016199,98.86668848
39726,郵包,1,610311,0.00016199,98.86685048
39727,郵政,1,610312,0.00016199,98.86701247
39728,郵政儲金,1,610313,0.00016199,98.86717446
39729,郵差,1,610314,0.00016199,98.86733646
39730,郵報,1,610315,0.00016199,98.86749845
39731,郵匯基金,1,610316,0.00016199,98.86766045
39732,郵資,1,610317,0.00016199,98.86782244
39733,郵購目錄,1,610318,0.00016199,98.86798444
39734,鄉民代表,1,610319,0.00016199,98.86814643
39735,鄉民代表會,1,610320,0.00016199,98.86830842
39736,鄉里,1,610321,0.00016199,98.86847042
39737,鄉居,1,610322,0.00016199,98.86863241
39738,鄉音四重唱,1,610323,0.00016199,98.86879441
39739,鄉原,1,610324,0.00016199,98.86895640
39740,鄉愿,1,610325,0.00016199,98.86911840
39741,鄉鎮市公所,1,610326,0.00016199,98.86928039
39742,鄉鎮市長,1,610327,0.00016199,98.86944238
39743,鄉鎮緊急零星工程補助款,1,610328,0.00016199,98.86960438
39744,酣,1,610329,0.00016199,98.86976637
39745,酣烈,1,610330,0.00016199,98.86992837
39746,酥脆,1,610331,0.00016199,98.87009036
39747,酥軟,1,610332,0.00016199,98.87025235
39748,量才適任,1,610333,0.00016199,98.87041435
39749,量化,1,610334,0.00016199,98.87057634
39750,量刑,1,610335,0.00016199,98.87073834
39751,量身,1,610336,0.00016199,98.87090033
39752,量身定作,1,610337,0.00016199,98.87106233
39753,量身設計,1,610338,0.00016199,98.87122432
39754,量杯,1,610339,0.00016199,98.87138631
39755,量匙,1,610340,0.00016199,98.87154831
39756,量產化,1,610341,0.00016199,98.87171030
39757,量測,1,610342,0.00016199,98.87187230
39758,量詞,1,610343,0.00016199,98.87203429
39759,量價,1,610344,0.00016199,98.87219629
39760,鈕因因,1,610345,0.00016199,98.87235828
39761,鈕承澤,1,610346,0.00016199,98.87252027
39762,鈣片,1,610347,0.00016199,98.87268227
39763,鈍吻鱷,1,610348,0.00016199,98.87284426
39764,鈍器,1,610349,0.00016199,98.87300626
39765,鈑噴廠,1,610350,0.00016199,98.87316825
39766,開大小,1,610351,0.00016199,98.87333024
39767,開山,1,610352,0.00016199,98.87349224
39768,開工率,1,610353,0.00016199,98.87365423
39769,開心果,1,610354,0.00016199,98.87381623
39770,開台,1,610355,0.00016199,98.87397822
39771,開立公司,1,610356,0.00016199,98.87414022
39772,開列,1,610357,0.00016199,98.87430221
39773,開夜車,1,610358,0.00016199,98.87446420
39774,開宗明義,1,610359,0.00016199,98.87462620
39775,開放性,1,610360,0.00016199,98.87478819
39776,開放空間文教基金會,1,610361,0.00016199,98.87495019
39777,開放型,1,610362,0.00016199,98.87511218
39778,開放度,1,610363,0.00016199,98.87527418
39779,開枝散葉,1,610364,0.00016199,98.87543617
39780,開門見山,1,610365,0.00016199,98.87559816
39781,開南商工,1,610366,0.00016199,98.87576016
39782,開赴,1,610367,0.00016199,98.87592215
39783,開砲,1,610368,0.00016199,98.87608415
39784,開迴路,1,610369,0.00016199,98.87624614
39785,開動,1,610370,0.00016199,98.87640813
39786,開曼鱷,1,610371,0.00016199,98.87657013
39787,開國元勳,1,610372,0.00016199,98.87673212
39788,開採,1,610373,0.00016199,98.87689412
39789,開脫,1,610374,0.00016199,98.87705611
39790,開閉,1,610375,0.00016199,98.87721811
39791,開閉幕,1,610376,0.00016199,98.87738010
39792,開麥拉眼,1,610377,0.00016199,98.87754209
39793,開喜,1,610378,0.00016199,98.87770409
39794,開單,1,610379,0.00016199,98.87786608
39795,開場白,1,610380,0.00016199,98.87802808
39796,開發區,1,610381,0.00016199,98.87819007
39797,開窗術,1,610382,0.00016199,98.87835207
39798,開溜,1,610383,0.00016199,98.87851406
39799,開落,1,610384,0.00016199,98.87867605
39800,開演,1,610385,0.00016199,98.87883805
39801,開端,1,610386,0.00016199,98.87900004
39802,開聞岳,1,610387,0.00016199,98.87916204
39803,開標室,1,610388,0.00016199,98.87932403
39804,開學,1,610389,0.00016199,98.87948602
39805,開導,1,610390,0.00016199,98.87964802
39806,開燈,1,610391,0.00016199,98.87981001
39807,開辦費,1,610392,0.00016199,98.87997201
39808,開錯門中門,1,610393,0.00016199,98.88013400
39809,開羅,1,610394,0.00016199,98.88029600
39810,開羅紫玫塊,1,610395,0.00016199,98.88045799
39811,間不容髮,1,610396,0.00016199,98.88061998
39812,間接加熱法,1,610397,0.00016199,98.88078198
39813,間接性,1,610398,0.00016199,98.88094397
39814,間接稅,1,610399,0.00016199,98.88110597
39815,間歇,1,610400,0.00016199,98.88126796
39816,間歇泉,1,610401,0.00016199,98.88142996
39817,間隙,1,610402,0.00016199,98.88159195
39818,間盤,1,610403,0.00016199,98.88175394
39819,間諜機,1,610404,0.00016199,98.88191594
39820,閒來,1,610405,0.00016199,98.88207793
39821,閒情,1,610406,0.00016199,98.88223993
39822,閒聊,1,610407,0.00016199,98.88240192
39823,閒聊天,1,610408,0.00016199,98.88256391
39824,閒逛,1,610409,0.00016199,98.88272591
39825,閒散,1,610410,0.00016199,98.88288790
39826,閒閒,1,610411,0.00016199,98.88304990
39827,閒置率,1,610412,0.00016199,98.88321189
39828,閒話,1,610413,0.00016199,98.88337389
39829,閒談,1,610414,0.00016199,98.88353588
39830,閒靜,1,610415,0.00016199,98.88369787
39831,隊中,1,610416,0.00016199,98.88385987
39832,隊史館,1,610417,0.00016199,98.88402186
39833,隊衣,1,610418,0.00016199,98.88418386
39834,隊型,1,610419,0.00016199,98.88434585
39835,隊徽,1,610420,0.00016199,98.88450785
39836,階下囚,1,610421,0.00016199,98.88466984
39837,階段性,1,610422,0.00016199,98.88483183
39838,階梯式,1,610423,0.00016199,98.88499383
39839,階梯狀,1,610424,0.00016199,98.88515582
39840,階層式網路,1,610425,0.00016199,98.88531782
39841,階調,1,610426,0.00016199,98.88547981
39842,隋煬帝,1,610427,0.00016199,98.88564180
39843,陽介仁,1,610428,0.00016199,98.88580380
39844,陽字號驅逐艦,1,610429,0.00016199,98.88596579
39845,陽奉陰違,1,610430,0.00016199,98.88612779
39846,陽始,1,610431,0.00016199,98.88628978
39847,陽孟,1,610432,0.00016199,98.88645178
39848,陽性率,1,610433,0.00016199,98.88661377
39849,陽明山國家公園,1,610434,0.00016199,98.88677576
39850,陽明醫院,1,610435,0.00016199,98.88693776
39851,陽明醫學院,1,610436,0.00016199,98.88709975
39852,陽剛性,1,610437,0.00016199,98.88726175
39853,陽剛美,1,610438,0.00016199,98.88742374
39854,陽傘,1,610439,0.00016199,98.88758574
39855,陽臺,1,610440,0.00016199,98.88774773
39856,隅半島,1,610441,0.00016199,98.88790972
39857,隅田川,1,610442,0.00016199,98.88807172
39858,隆胸,1,610443,0.00016199,98.88823371
39859,雅夫林斯基,1,610444,0.00016199,98.88839571
39860,雅加達,1,610445,0.00016199,98.88855770
39861,雅正齋,1,610446,0.00016199,98.88871969
39862,雅石協會,1,610447,0.00016199,98.88888169
39863,雅典娜神廟,1,610448,0.00016199,98.88904368
39864,雅典國家博物館,1,610449,0.00016199,98.88920568
39865,雅斯香濱,1,610450,0.00016199,98.88936767
39866,雅斯培,1,610451,0.00016199,98.88952967
39867,雅號,1,610452,0.00016199,98.88969166
39868,雅頓,1,610453,0.00016199,98.88985365
39869,雅頓化妝品,1,610454,0.00016199,98.89001565
39870,雅聚,1,610455,0.00016199,98.89017764
39871,雅蓉,1,610456,0.00016199,98.89033964
39872,雅鉻雷射,1,610457,0.00016199,98.89050163
39873,雅藝石,1,610458,0.00016199,98.89066363
39874,雄二飛彈,1,610459,0.00016199,98.89082562
39875,雄才大略,1,610460,0.00016199,98.89098761
39876,雄心壯志,1,610461,0.00016199,98.89114961
39877,雄壯,1,610462,0.00016199,98.89131160
39878,雄虎,1,610463,0.00016199,98.89147360
39879,雄雌,1,610464,0.00016199,98.89163559
39880,雄獸,1,610465,0.00016199,98.89179758
39881,集中市場,1,610466,0.00016199,98.89195958
39882,集中區,1,610467,0.00016199,98.89212157
39883,集中場,1,610468,0.00016199,98.89228357
39884,集中營,1,610469,0.00016199,98.89244556
39885,集英杜,1,610470,0.00016199,98.89260756
39886,集盛,1,610471,0.00016199,98.89276955
39887,集散站,1,610472,0.00016199,98.89293154
39888,集結區,1,610473,0.00016199,98.89309354
39889,集集,1,610474,0.00016199,98.89325553
39890,集集支線,1,610475,0.00016199,98.89341753
39891,集團股,1,610476,0.00016199,98.89357952
39892,集團軍,1,610477,0.00016199,98.89374152
39893,集聚,1,610478,0.00016199,98.89390351
39894,集權,1,610479,0.00016199,98.89406550
39895,雇員,1,610480,0.00016199,98.89422750
39896,雇請,1,610481,0.00016199,98.89438949
39897,雯,1,610482,0.00016199,98.89455149
39898,雲朵,1,610483,0.00016199,98.89471348
39899,雲林人,1,610484,0.00016199,98.89487548
39900,雲林工專,1,610485,0.00016199,98.89503747
39901,雲林同鄉會,1,610486,0.00016199,98.89519946
39902,雲林科技,1,610487,0.00016199,98.89536146
39903,雲林區,1,610488,0.00016199,98.89552345
39904,雲林縣長,1,610489,0.00016199,98.89568545
39905,雲宵,1,610490,0.00016199,98.89584744
39906,雲宵飛車,1,610491,0.00016199,98.89600943
39907,雲氣,1,610492,0.00016199,98.89617143
39908,雲堆,1,610493,0.00016199,98.89633342
39909,雲雀式,1,610494,0.00016199,98.89649542
39910,雲集,1,610495,0.00016199,98.89665741
39911,雲嘉南地區,1,610496,0.00016199,98.89681941
39912,雲端,1,610497,0.00016199,98.89698140
39913,韌勁,1,610498,0.00016199,98.89714339
39914,項金平,1,610499,0.00016199,98.89730539
39915,順手拈來,1,610500,0.00016199,98.89746738
39916,順水人情,1,610501,0.00016199,98.89762938
39917,順利園餐廳,1,610502,0.00016199,98.89779137
39918,順其自然,1,610503,0.00016199,98.89795337
39919,順風耳,1,610504,0.00016199,98.89811536
39920,順差,1,610505,0.00016199,98.89827735
39921,順時針,1,610506,0.00016199,98.89843935
39922,順帶,1,610507,0.00016199,98.89860134
39923,順帶一提,1,610508,0.00016199,98.89876334
39924,順理成章,1,610509,0.00016199,98.89892533
39925,順眼,1,610510,0.00016199,98.89908732
39926,順移,1,610511,0.00016199,98.89924932
39927,順順利利,1,610512,0.00016199,98.89941131
39928,順勢操作,1,610513,0.00016199,98.89957331
39929,順遂,1,610514,0.00016199,98.89973530
39930,順德,1,610515,0.00016199,98.89989730
39931,順賢,1,610516,0.00016199,98.90005929
39932,須知,1,610517,0.00016199,98.90022128
39933,飯店業,1,610518,0.00016199,98.90038328
39934,飯桶,1,610519,0.00016199,98.90054527
39935,飯菜,1,610520,0.00016199,98.90070727
39936,飯廳,1,610521,0.00016199,98.90086926
39937,飲水製造機,1,610522,0.00016199,98.90103126
39938,飲泣,1,610523,0.00016199,98.90119325
39939,飲食文化,1,610524,0.00016199,98.90135524
39940,飲食店,1,610525,0.00016199,98.90151724
39941,飲食法,1,610526,0.00016199,98.90167923
39942,飲酒作樂,1,610527,0.00016199,98.90184123
39943,飲饌,1,610528,0.00016199,98.90200322
39944,馮在政,1,610529,0.00016199,98.90216521
39945,馮國勤,1,610530,0.00016199,98.90232721
39946,馮雅蓉,1,610531,0.00016199,98.90248920
39947,黃子欽,1,610532,0.00016199,98.90265120
39948,黃小琥,1,610533,0.00016199,98.90281319
39949,黃山晨霧,1,610534,0.00016199,98.90297519
39950,黃山雲,1,610535,0.00016199,98.90313718
39951,黃少芳,1,610536,0.00016199,98.90329917
39952,黃文岳,1,610537,0.00016199,98.90346117
39953,黃右,1,610538,0.00016199,98.90362316
39954,黃正雄,1,610539,0.00016199,98.90378516
39955,黃禾,1,610540,0.00016199,98.90394715
39956,黃光國,1,610541,0.00016199,98.90410915
39957,黃安定,1,610542,0.00016199,98.90427114
39958,黃旭昇,1,610543,0.00016199,98.90443313
39959,黃至盛,1,610544,0.00016199,98.90459513
39960,黃西玲,1,610545,0.00016199,98.90475712
39961,黃杉楹,1,610546,0.00016199,98.90491912
39962,黃杉榕,1,610547,0.00016199,98.90508111
39963,黃豆,1,610548,0.00016199,98.90524310
39964,黃宗詩,1,610549,0.00016199,98.90540510
39965,黃忠義,1,610550,0.00016199,98.90556709
39966,黃怡仁,1,610551,0.00016199,98.90572909
39967,黃怡聞,1,610552,0.00016199,98.90589108
39968,黃承亮,1,610553,0.00016199,98.90605308
39969,黃花,1,610554,0.00016199,98.90621507
39970,黃金地段,1,610555,0.00016199,98.90637706
39971,黃金店面,1,610556,0.00016199,98.90653906
39972,黃金時代,1,610557,0.00016199,98.90670105
39973,黃金時期,1,610558,0.00016199,98.90686305
39974,黃金樟,1,610559,0.00016199,98.90702504
39975,黃俊傑,1,610560,0.00016199,98.90718704
39976,黃泉,1,610561,0.00016199,98.90734903
39977,黃郁娟,1,610562,0.00016199,98.90751102
39978,黃郁舜,1,610563,0.00016199,98.90767302
39979,黃哲諒,1,610564,0.00016199,98.90783501
39980,黃庭堅,1,610565,0.00016199,98.90799701
39981,黃根,1,610566,0.00016199,98.90815900
39982,黃烈火,1,610567,0.00016199,98.90832099
39983,黃益亮,1,610568,0.00016199,98.90848299
39984,黃偉堂,1,610569,0.00016199,98.90864498
39985,黃國精,1,610570,0.00016199,98.90880698
39986,黃國鐘,1,610571,0.00016199,98.90896897
39987,黃專,1,610572,0.00016199,98.90913097
39988,黃梅戲,1,610573,0.00016199,98.90929296
39989,黃袍加身,1,610574,0.00016199,98.90945495
39990,黃巽君,1,610575,0.00016199,98.90961695
39991,黃智勇,1,610576,0.00016199,98.90977894
39992,黃智源,1,610577,0.00016199,98.90994094
39993,黃棕,1,610578,0.00016199,98.91010293
39994,黃欽智,1,610579,0.00016199,98.91026493
39995,黃湯,1,610580,0.00016199,98.91042692
39996,黃渝洲,1,610581,0.00016199,98.91058891
39997,黃華相,1,610582,0.00016199,98.91075091
39998,黃逸松,1,610583,0.00016199,98.91091290
39999,黃塗山,1,610584,0.00016199,98.91107490
40000,黃瑞松,1,610585,0.00016199,98.91123689
40001,黃蜂,1,610586,0.00016199,98.91139888
40002,黃裕登,1,610587,0.00016199,98.91156088
40003,黃道,1,610588,0.00016199,98.91172287
40004,黃鼠狼,1,610589,0.00016199,98.91188487
40005,黃種人,1,610590,0.00016199,98.91204686
40006,黃維貞,1,610591,0.00016199,98.91220886
40007,黃緒勳,1,610592,0.00016199,98.91237085
40008,黃銅,1,610593,0.00016199,98.91253284
40009,黃鳳山,1,610594,0.00016199,98.91269484
40010,黃鳳蓮,1,610595,0.00016199,98.91285683
40011,黃蓮,1,610596,0.00016199,98.91301883
40012,黃燈,1,610597,0.00016199,98.91318082
40013,黃蕙蘭,1,610598,0.00016199,98.91334282
40014,黃靜雪,1,610599,0.00016199,98.91350481
40015,黃競秋,1,610600,0.00016199,98.91366680
40016,黃顯祐,1,610601,0.00016199,98.91382880
40017,黃體素,1,610602,0.00016199,98.91399079
40018,黃琡珺,1,610603,0.00016199,98.91415279
40019,黑人政府,1,610604,0.00016199,98.91431478
40020,黑戶,1,610605,0.00016199,98.91447677
40021,黑毛,1,610606,0.00016199,98.91463877
40022,黑牛,1,610607,0.00016199,98.91480076
40023,黑田,1,610608,0.00016199,98.91496276
40024,黑白兩道,1,610609,0.00016199,98.91512475
40025,黑石,1,610610,0.00016199,98.91528675
40026,黑名單,1,610611,0.00016199,98.91544874
40027,黑色大冒險,1,610612,0.00016199,98.91561073
40028,黑色系,1,610613,0.00016199,98.91577273
40029,黑色素,1,610614,0.00016199,98.91593472
40030,黑色喜劇,1,610615,0.00016199,98.91609672
40031,黑衣,1,610616,0.00016199,98.91625871
40032,黑希歇斯博物館,1,610617,0.00016199,98.91642071
40033,黑夜白賊,1,610618,0.00016199,98.91658270
40034,黑店,1,610619,0.00016199,98.91674469
40035,黑板,1,610620,0.00016199,98.91690669
40036,黑板樹,1,610621,0.00016199,98.91706868
40037,黑社會片,1,610622,0.00016199,98.91723068
40038,黑洞,1,610623,0.00016199,98.91739267
40039,黑格爾,1,610624,0.00016199,98.91755466
40040,黑神地區,1,610625,0.00016199,98.91771666
40041,黑棕,1,610626,0.00016199,98.91787865
40042,黑牌,1,610627,0.00016199,98.91804065
40043,黑黑,1,610628,0.00016199,98.91820264
40044,黑暗時代,1,610629,0.00016199,98.91836464
40045,黑暗時期,1,610630,0.00016199,98.91852663
40046,黑暗期,1,610631,0.00016199,98.91868862
40047,黑聖母,1,610632,0.00016199,98.91885062
40048,黑裙,1,610633,0.00016199,98.91901261
40049,黑道份子,1,610634,0.00016199,98.91917461
40050,黑道圈,1,610635,0.00016199,98.91933660
40051,黑潮流,1,610636,0.00016199,98.91949860
40052,黑箱,1,610637,0.00016199,98.91966059
40053,黑褐色,1,610638,0.00016199,98.91982258
40054,黑髮,1,610639,0.00016199,98.91998458
40055,黑髮女人,1,610640,0.00016199,98.92014657
40056,黑糖炒章魚,1,610641,0.00016199,98.92030857
40057,黑幫份子,1,610642,0.00016199,98.92047056
40058,黑燦,1,610643,0.00016199,98.92063255
40059,黑鍋,1,610644,0.00016199,98.92079455
40060,黑點,1,610645,0.00016199,98.92095654
40061,黑黝黝,1,610646,0.00016199,98.92111854
40062,黑邊,1,610647,0.00016199,98.92128053
40063,黑喑期,1,610648,0.00016199,98.92144253
40064,亂中有序,1,610649,0.00016199,98.92160452
40065,亂世,1,610650,0.00016199,98.92176651
40066,亂仗,1,610651,0.00016199,98.92192851
40067,亂成一團,1,610652,0.00016199,98.92209050
40068,亂局,1,610653,0.00016199,98.92225250
40069,亂來,1,610654,0.00016199,98.92241449
40070,亂軍,1,610655,0.00016199,98.92257649
40071,亂晃,1,610656,0.00016199,98.92273848
40072,亂動,1,610657,0.00016199,98.92290047
40073,亂搞,1,610658,0.00016199,98.92306247
40074,亂賊,1,610659,0.00016199,98.92322446
40075,亂竄,1,610660,0.00016199,98.92338646
40076,傭,1,610661,0.00016199,98.92354845
40077,債台,1,610662,0.00016199,98.92371045
40078,債券附買回交易,1,610663,0.00016199,98.92387244
40079,債券型,1,610664,0.00016199,98.92403443
40080,債券型海外共同基金,1,610665,0.00016199,98.92419643
40081,債券基金,1,610666,0.00016199,98.92435842
40082,債格,1,610667,0.00016199,98.92452042
40083,傲視群雄,1,610668,0.00016199,98.92468241
40084,傲慢,1,610669,0.00016199,98.92484440
40085,傳收,1,610670,0.00016199,98.92500640
40086,傳呼協定,1,610671,0.00016199,98.92516839
40087,傳宗接代,1,610672,0.00016199,98.92533039
40088,傳承者,1,610673,0.00016199,98.92549238
40089,傳放,1,610674,0.00016199,98.92565438
40090,傳述,1,610675,0.00016199,98.92581637
40091,傳真度,1,610676,0.00016199,98.92597836
40092,傳記,1,610677,0.00016199,98.92614036
40093,傳記書,1,610678,0.00016199,98.92630235
40094,傳動,1,610679,0.00016199,98.92646435
40095,傳球者,1,610680,0.00016199,98.92662634
40096,傳球鍵,1,610681,0.00016199,98.92678834
40097,傳統性,1,610682,0.00016199,98.92695033
40098,傳統戲劇,1,610683,0.00016199,98.92711232
40099,傳統攝影,1,610684,0.00016199,98.92727432
40100,傳遍,1,610685,0.00016199,98.92743631
40101,傳福音,1,610686,0.00016199,98.92759831
40102,傳誦,1,610687,0.00016199,98.92776030
40103,傳劍和尚,1,610688,0.00016199,98.92792229
40104,傳播者,1,610689,0.00016199,98.92808429
40105,傳銷商,1,610690,0.00016199,98.92824628
40106,傳輸率,1,610691,0.00016199,98.92840828
40107,傳輸費,1,610692,0.00016199,98.92857027
40108,僅存,1,610693,0.00016199,98.92873227
40109,僅定,1,610694,0.00016199,98.92889426
40110,僅限,1,610695,0.00016199,98.92905625
40111,僅憑,1,610696,0.00016199,98.92921825
40112,傾圯,1,610697,0.00016199,98.92938024
40113,傾角,1,610698,0.00016199,98.92954224
40114,傾軋,1,610699,0.00016199,98.92970423
40115,傾盆,1,610700,0.00016199,98.92986623
40116,傾側,1,610701,0.00016199,98.93002822
40117,傾斜度,1,610702,0.00016199,98.93019021
40118,傾銷,1,610703,0.00016199,98.93035221
40119,傾瀉,1,610704,0.00016199,98.93051420
40120,催,1,610705,0.00016199,98.93067620
40121,催化劑,1,610706,0.00016199,98.93083819
40122,催收,1,610707,0.00016199,98.93100018
40123,催乳激素,1,610708,0.00016199,98.93116218
40124,傷人,1,610709,0.00016199,98.93132417
40125,傷亡者,1,610710,0.00016199,98.93148617
40126,傷心酒店,1,610711,0.00016199,98.93164816
40127,傷心歌傷心肝,1,610712,0.00016199,98.93181016
40128,傷風,1,610713,0.00016199,98.93197215
40129,傷痕文學,1,610714,0.00016199,98.93213414
40130,傷痛,1,610715,0.00016199,98.93229614
40131,傷勢,1,610716,0.00016199,98.93245813
40132,傻瓜,1,610717,0.00016199,98.93262013
40133,傻瓜相機,1,610718,0.00016199,98.93278212
40134,傻事,1,610719,0.00016199,98.93294412
40135,傻笑,1,610720,0.00016199,98.93310611
40136,剿匪,1,610721,0.00016199,98.93326810
40137,剿滅,1,610722,0.00016199,98.93343010
40138,剷,1,610723,0.00016199,98.93359209
40139,剷平,1,610724,0.00016199,98.93375409
40140,募捐,1,610725,0.00016199,98.93391608
40141,募資,1,610726,0.00016199,98.93407807
40142,勤快,1,610727,0.00016199,98.93424007
40143,勤勉,1,610728,0.00016199,98.93440206
40144,勤政,1,610729,0.00016199,98.93456406
40145,勤儉,1,610730,0.00016199,98.93472605
40146,勤練,1,610731,0.00016199,98.93488805
40147,勢如破竹,1,610732,0.00016199,98.93505004
40148,勢利眼,1,610733,0.00016199,98.93521203
40149,勢均力敵,1,610734,0.00016199,98.93537403
40150,勢態,1,610735,0.00016199,98.93553602
40151,匯出入,1,610736,0.00016199,98.93569802
40152,匯流,1,610737,0.00016199,98.93586001
40153,匯差,1,610738,0.00016199,98.93602201
40154,匯演,1,610739,0.00016199,98.93618400
40155,匯聚,1,610740,0.00016199,98.93634599
40156,匯銀,1,610741,0.00016199,98.93650799
40157,嗟嘆,1,610742,0.00016199,98.93666998
40158,嗨,1,610743,0.00016199,98.93683198
40159,嗓子,1,610744,0.00016199,98.93699397
40160,嗓音,1,610745,0.00016199,98.93715596
40161,嗜血桿菌,1,610746,0.00016199,98.93731796
40162,嗣,1,610747,0.00016199,98.93747995
40163,嗤,1,610748,0.00016199,98.93764195
40164,嗤嗤蠅,1,610749,0.00016199,98.93780394
40165,嗚呼哀哉,1,610750,0.00016199,98.93796594
40166,嗚嗚,1,610751,0.00016199,98.93812793
40167,嗡聲,1,610752,0.00016199,98.93828992
40168,嗅到,1,610753,0.00016199,98.93845192
40169,嗅嗅,1,610754,0.00016199,98.93861391
40170,嗥叫,1,610755,0.00016199,98.93877591
40171,園子,1,610756,0.00016199,98.93893790
40172,園長,1,610757,0.00016199,98.93909990
40173,園區土地,1,610758,0.00016199,98.93926189
40174,園藝,1,610759,0.00016199,98.93942388
40175,圓山,1,610760,0.00016199,98.93958588
40176,圓山飯店,1,610761,0.00016199,98.93974787
40177,圓孔,1,610762,0.00016199,98.93990987
40178,圓正寺,1,610763,0.00016199,98.94007186
40179,圓形局部測光,1,610764,0.00016199,98.94023385
40180,圓板,1,610765,0.00016199,98.94039585
40181,圓俏,1,610766,0.00016199,98.94055784
40182,圓柱,1,610767,0.00016199,98.94071984
40183,圓柱形,1,610768,0.00016199,98.94088183
40184,圓桌,1,610769,0.00016199,98.94104383
40185,圓頂,1,610770,0.00016199,98.94120582
40186,圓筒狀,1,610771,0.00016199,98.94136781
40187,圓圓胖胖,1,610772,0.00016199,98.94152981
40188,圓滾滾,1,610773,0.00016199,98.94169180
40189,圓滿無缺,1,610774,0.00016199,98.94185380
40190,圓領,1,610775,0.00016199,98.94201579
40191,圓熟,1,610776,0.00016199,98.94217779
40192,圓盤,1,610777,0.00016199,98.94233978
40193,圓盤狀,1,610778,0.00016199,98.94250177
40194,圓錐型,1,610779,0.00016199,98.94266377
40195,圓環東路,1,610780,0.00016199,98.94282576
40196,圓鍬,1,610781,0.00016199,98.94298776
40197,塞住,1,610782,0.00016199,98.94314975
40198,塞尚,1,610783,0.00016199,98.94331174
40199,塞拉耶佛,1,610784,0.00016199,98.94347374
40200,塞浦路斯,1,610785,0.00016199,98.94363573
40201,塞進,1,610786,0.00016199,98.94379773
40202,塞萬提斯,1,610787,0.00016199,98.94395972
40203,塞爾,1,610788,0.00016199,98.94412172
40204,塞種人,1,610789,0.00016199,98.94428371
40205,塞劑,1,610790,0.00016199,98.94444570
40206,塑化股,1,610791,0.00016199,98.94460770
40207,塑身,1,610792,0.00016199,98.94476969
40208,塑料,1,610793,0.00016199,98.94493169
40209,塑膠片,1,610794,0.00016199,98.94509368
40210,塑膠布,1,610795,0.00016199,98.94525568
40211,塑膠件,1,610796,0.00016199,98.94541767
40212,塑膠股,1,610797,0.00016199,98.94557966
40213,塑膠罐,1,610798,0.00016199,98.94574166
40214,塘鵝,1,610799,0.00016199,98.94590365
40215,塗改,1,610800,0.00016199,98.94606565
40216,塗料,1,610801,0.00016199,98.94622764
40217,塗塗,1,610802,0.00016199,98.94638963
40218,塗裝線,1,610803,0.00016199,98.94655163
40219,塗繪,1,610804,0.00016199,98.94671362
40220,塔克,1,610805,0.00016199,98.94687562
40221,塔克辛廣場,1,610806,0.00016199,98.94703761
40222,塔拉瓦島,1,610807,0.00016199,98.94719961
40223,塔林,1,610808,0.00016199,98.94736160
40224,塔索夫人,1,610809,0.00016199,98.94752359
40225,塔羅牌,1,610810,0.00016199,98.94768559
40226,填土,1,610811,0.00016199,98.94784758
40227,填充,1,610812,0.00016199,98.94800958
40228,填平,1,610813,0.00016199,98.94817157
40229,填倒,1,610814,0.00016199,98.94833357
40230,填埋,1,610815,0.00016199,98.94849556
40231,填海,1,610816,0.00016199,98.94865755
40232,填單,1,610817,0.00016199,98.94881955
40233,填飽,1,610818,0.00016199,98.94898154
40234,塌,1,610819,0.00016199,98.94914354
40235,塌陷,1,610820,0.00016199,98.94930553
40236,塭子圳,1,610821,0.00016199,98.94946753
40237,奧古斯都,1,610822,0.00016199,98.94962952
40238,奧地利伯根騰戲劇節,1,610823,0.00016199,98.94979151
40239,奧多,1,610824,0.00016199,98.94995351
40240,奧克拉荷馬,1,610825,0.00016199,98.95011550
40241,奧克蘭運動家隊,1,610826,0.00016199,98.95027750
40242,奧利維史堤克,1,610827,0.00016199,98.95043949
40243,奧委會,1,610828,0.00016199,98.95060148
40244,奧底尼瓜號,1,610829,0.00016199,98.95076348
40245,奧林匹克委員會,1,610830,0.00016199,98.95092547
40246,奧林匹克鼓號曲,1,610831,0.00016199,98.95108747
40247,奧武山棒球場,1,610832,0.00016199,98.95124946
40248,奧迪車,1,610833,0.00016199,98.95141146
40249,奧迪車系,1,610834,0.00016199,98.95157345
40250,奧迪芬,1,610835,0.00016199,98.95173544
40251,奧恩河,1,610836,0.00016199,98.95189744
40252,奧秘,1,610837,0.00016199,98.95205943
40253,奧國,1,610838,0.00016199,98.95222143
40254,奧莉薇高德史密斯,1,610839,0.00016199,98.95238342
40255,奧援,1,610840,0.00016199,98.95254542
40256,奧斯卡金獎,1,610841,0.00016199,98.95270741
40257,奧斯卡獎,1,610842,0.00016199,98.95286940
40258,奧斯陸,1,610843,0.00016199,98.95303140
40259,奧會,1,610844,0.00016199,98.95319339
40260,奧瑞崗州,1,610845,0.00016199,98.95335539
40261,奧運史,1,610846,0.00016199,98.95351738
40262,奧運村,1,610847,0.00016199,98.95367937
40263,奧運傳奇,1,610848,0.00016199,98.95384137
40264,奧戴爾,1,610849,0.00016199,98.95400336
40265,嫌惡,1,610850,0.00016199,98.95416536
40266,嫌隙,1,610851,0.00016199,98.95432735
40267,媳,1,610852,0.00016199,98.95448935
40268,幹完,1,610853,0.00016199,98.95465134
40269,幹勁,1,610854,0.00016199,98.95481333
40270,幹活,1,610855,0.00016199,98.95497533
40271,幹活兒,1,610856,0.00016199,98.95513732
40272,幹員,1,610857,0.00016199,98.95529932
40273,幹探,1,610858,0.00016199,98.95546131
40274,幹掉,1,610859,0.00016199,98.95562331
40275,廉政,1,610860,0.00016199,98.95578530
40276,廉政處,1,610861,0.00016199,98.95594729
40277,廈門,1,610862,0.00016199,98.95610929
40278,廈門大學,1,610863,0.00016199,98.95627128
40279,廈門島,1,610864,0.00016199,98.95643328
40280,徬徨,1,610865,0.00016199,98.95659527
40281,微乎其微,1,610866,0.00016199,98.95675726
40282,微末,1,610867,0.00016199,98.95691926
40283,微生物,1,610868,0.00016199,98.95708125
40284,微生物學家,1,610869,0.00016199,98.95724325
40285,微汙,1,610870,0.00016199,98.95740524
40286,微血管壁,1,610871,0.00016199,98.95756724
40287,微波,1,610872,0.00016199,98.95772923
40288,微弱,1,610873,0.00016199,98.95789122
40289,微粒體乙醇氧化系統,1,610874,0.00016199,98.95805322
40290,微晶片,1,610875,0.00016199,98.95821521
40291,微量,1,610876,0.00016199,98.95837721
40292,微電腦傳真,1,610877,0.00016199,98.95853920
40293,微調,1,610878,0.00016199,98.95870120
40294,微濕,1,610879,0.00016199,98.95886319
40295,愚,1,610880,0.00016199,98.95902518
40296,愚公移山,1,610881,0.00016199,98.95918718
40297,愚民政策,1,610882,0.00016199,98.95934917
40298,愚弄,1,610883,0.00016199,98.95951117
40299,愚笨,1,610884,0.00016199,98.95967316
40300,愚鈍,1,610885,0.00016199,98.95983515
40301,愚痴,1,610886,0.00016199,98.95999715
40302,意大利,1,610887,0.00016199,98.96015914
40303,意大利人,1,610888,0.00016199,98.96032114
40304,意向,1,610889,0.00016199,98.96048313
40305,意味深長,1,610890,0.00016199,98.96064513
40306,意料之中,1,610891,0.00016199,98.96080712
40307,意特斯堪,1,610892,0.00016199,98.96096911
40308,意識流,1,610893,0.00016199,98.96113111
40309,慈天宮,1,610894,0.00016199,98.96129310
40310,慈悲行,1,610895,0.00016199,98.96145510
40311,慈善家,1,610896,0.00016199,98.96161709
40312,慈善晚會,1,610897,0.00016199,98.96177909
40313,慈善演唱會,1,610898,0.00016199,98.96194108
40314,慈濟,1,610899,0.00016199,98.96210307
40315,慈濟宮丙子科上白礁割香大典,1,610900,0.00016199,98.96226507
40316,感化,1,610901,0.00016199,98.96242706
40317,感召,1,610902,0.00016199,98.96258906
40318,感受性,1,610903,0.00016199,98.96275105
40319,感官之旅,1,610904,0.00016199,98.96291304
40320,感冒藥,1,610905,0.00016199,98.96307504
40321,感染力,1,610906,0.00016199,98.96323703
40322,感染性,1,610907,0.00016199,98.96339903
40323,感染度,1,610908,0.00016199,98.96356102
40324,感染病,1,610909,0.00016199,98.96372302
40325,感恩節,1,610910,0.00016199,98.96388501
40326,感興趣,1,610911,0.00016199,98.96404700
40327,感應度,1,610912,0.00016199,98.96420900
40328,感謝你的愛,1,610913,0.00016199,98.96437099
40329,感謝函,1,610914,0.00016199,98.96453299
40330,想入非非,1,610915,0.00016199,98.96469498
40331,想不通,1,610916,0.00016199,98.96485698
40332,想不透,1,610917,0.00016199,98.96501897
40333,想不想,1,610918,0.00016199,98.96518096
40334,想必是,1,610919,0.00016199,98.96534296
40335,想用,1,610920,0.00016199,98.96550495
40336,想成,1,610921,0.00016199,98.96566695
40337,想通,1,610922,0.00016199,98.96582894
40338,想著想著,1,610923,0.00016199,98.96599093
40339,想當然爾,1,610924,0.00016199,98.96615293
40340,想過,1,610925,0.00016199,98.96631492
40341,想盡,1,610926,0.00016199,98.96647692
40342,想盡辦法,1,610927,0.00016199,98.96663891
40343,想辦法,1,610928,0.00016199,98.96680091
40344,愛丁堡,1,610929,0.00016199,98.96696290
40345,愛上明尼蘇達,1,610930,0.00016199,98.96712489
40346,愛女,1,610931,0.00016199,98.96728689
40347,愛用,1,610932,0.00016199,98.96744888
40348,愛用度,1,610933,0.00016199,98.96761088
40349,愛吃,1,610934,0.00016199,98.96777287
40350,愛知縣,1,610935,0.00016199,98.96793487
40351,愛迪達,1,610936,0.00016199,98.96809686
40352,愛將,1,610937,0.00016199,98.96825885
40353,愛情叩應,1,610938,0.00016199,98.96842085
40354,愛情長跑,1,610939,0.00016199,98.96858284
40355,愛情神話,1,610940,0.00016199,98.96874484
40356,愛情戲,1,610941,0.00016199,98.96890683
40357,愛情觀,1,610942,0.00016199,98.96906882
40358,愛場戲,1,610943,0.00016199,98.96923082
40359,愛斯基摩人,1,610944,0.00016199,98.96939281
40360,愛斯基摩式皮艇,1,610945,0.00016199,98.96955481
40361,愛滋,1,610946,0.00016199,98.96971680
40362,愛愈深心愈凝,1,610947,0.00016199,98.96987880
40363,愛爾福特,1,610948,0.00016199,98.97004079
40364,愛爾蘭奶酒,1,610949,0.00016199,98.97020278
40365,愛與哀愁,1,610950,0.00016199,98.97036478
40366,愛說笑,1,610951,0.00016199,98.97052677
40367,愛德華,1,610952,0.00016199,98.97068877
40368,愛德華．威斯頓,1,610953,0.00016199,98.97085076
40369,愛樂管弦樂團,1,610954,0.00016199,98.97101276
40370,愛戴,1,610955,0.00016199,98.97117475
40371,愛麗絲夢遊記,1,610956,0.00016199,98.97133674
40372,愛戀,1,610957,0.00016199,98.97149874
40373,惹不起,1,610958,0.00016199,98.97166073
40374,惹出,1,610959,0.00016199,98.97182273
40375,惹來,1,610960,0.00016199,98.97198472
40376,惹眼,1,610961,0.00016199,98.97214671
40377,惹麻煩,1,610962,0.00016199,98.97230871
40378,愈來愈少,1,610963,0.00016199,98.97247070
40379,愈來愈多,1,610964,0.00016199,98.97263270
40380,愈夜愈美麗,1,610965,0.00016199,98.97279469
40381,愈幫愈忙,1,610966,0.00016199,98.97295669
40382,慎防,1,610967,0.00016199,98.97311868
40383,慎昌鐘表公司,1,610968,0.00016199,98.97328067
40384,慎思,1,610969,0.00016199,98.97344267
40385,慎重其事,1,610970,0.00016199,98.97360466
40386,慎康公司,1,610971,0.00016199,98.97376666
40387,慎終追遠,1,610972,0.00016199,98.97392865
40388,慎選,1,610973,0.00016199,98.97409065
40389,愴然,1,610974,0.00016199,98.97425264
40390,搓圓仔湯,1,610975,0.00016199,98.97441463
40391,搞起來,1,610976,0.00016199,98.97457663
40392,搞混,1,610977,0.00016199,98.97473862
40393,搞亂,1,610978,0.00016199,98.97490062
40394,搞錯,1,610979,0.00016199,98.97506261
40395,搞懂,1,610980,0.00016199,98.97522460
40396,搭便車,1,610981,0.00016199,98.97538660
40397,搭班,1,610982,0.00016199,98.97554859
40398,搭設,1,610983,0.00016199,98.97571059
40399,搬來搬去,1,610984,0.00016199,98.97587258
40400,搬移,1,610985,0.00016199,98.97603458
40401,搬運車,1,610986,0.00016199,98.97619657
40402,搏擊,1,610987,0.00016199,98.97635856
40403,搜刮,1,610988,0.00016199,98.97652056
40404,搜奇,1,610989,0.00016199,98.97668255
40405,搜括,1,610990,0.00016199,98.97684455
40406,搜掠,1,610991,0.00016199,98.97700654
40407,搜羅,1,610992,0.00016199,98.97716854
40408,損失率,1,610993,0.00016199,98.97733053
40409,損益平衡點,1,610994,0.00016199,98.97749252
40410,搶手貨,1,610995,0.00016199,98.97765452
40411,搶回,1,610996,0.00016199,98.97781651
40412,搶佔,1,610997,0.00016199,98.97797851
40413,搶食,1,610998,0.00016199,98.97814050
40414,搶造,1,610999,0.00016199,98.97830250
40415,搶稅,1,611000,0.00016199,98.97846449
40416,搶灘,1,611001,0.00016199,98.97862648
40417,搖一搖,1,611002,0.00016199,98.97878848
40418,搖手,1,611003,0.00016199,98.97895047
40419,搖幌,1,611004,0.00016199,98.97911247
40420,搖搖,1,611005,0.00016199,98.97927446
40421,搖搖晃晃,1,611006,0.00016199,98.97943645
40422,搖搖欲墜,1,611007,0.00016199,98.97959845
40423,搖搖擺擺,1,611008,0.00016199,98.97976044
40424,搖滾樂,1,611009,0.00016199,98.97992244
40425,搖滾樂團,1,611010,0.00016199,98.98008443
40426,搖錢樹,1,611011,0.00016199,98.98024643
40427,搖擺狂潮,1,611012,0.00016199,98.98040842
40428,搗,1,611013,0.00016199,98.98057041
40429,搗蛋,1,611014,0.00016199,98.98073241
40430,搗蛋鬼,1,611015,0.00016199,98.98089440
40431,搗亂,1,611016,0.00016199,98.98105640
40432,搗碎,1,611017,0.00016199,98.98121839
40433,搆,1,611018,0.00016199,98.98138039
40434,敬仰,1,611019,0.00016199,98.98154238
40435,敬奉,1,611020,0.00016199,98.98170437
40436,敬祝,1,611021,0.00016199,98.98186637
40437,敬酒圖,1,611022,0.00016199,98.98202836
40438,敬陪末座,1,611023,0.00016199,98.98219036
40439,敬賀,1,611024,0.00016199,98.98235235
40440,敬意,1,611025,0.00016199,98.98251434
40441,敬愛,1,611026,0.00016199,98.98267634
40442,敬業,1,611027,0.00016199,98.98283833
40443,敬謝不敏,1,611028,0.00016199,98.98300033
40444,新一代,1,611029,0.00016199,98.98316232
40445,新人際關係數據機,1,611030,0.00016199,98.98332432
40446,新人類,1,611031,0.00016199,98.98348631
40447,新力公司,1,611032,0.00016199,98.98364830
40448,新力軍,1,611033,0.00016199,98.98381030
40449,新工處,1,611034,0.00016199,98.98397229
40450,新井悠一,1,611035,0.00016199,98.98413429
40451,新月形,1,611036,0.00016199,98.98429628
40452,新月型,1,611037,0.00016199,98.98445828
40453,新片,1,611038,0.00016199,98.98462027
40454,新王,1,611039,0.00016199,98.98478226
40455,新世代,1,611040,0.00016199,98.98494426
40456,新以壽公司,1,611041,0.00016199,98.98510625
40457,新加坡河,1,611042,0.00016199,98.98526825
40458,新加坡股市,1,611043,0.00016199,98.98543024
40459,新加坡國家投資公司,1,611044,0.00016199,98.98559223
40460,新加坡豐隆集團,1,611045,0.00016199,98.98575423
40461,新外觀,1,611046,0.00016199,98.98591622
40462,新市鄉,1,611047,0.00016199,98.98607822
40463,新布,1,611048,0.00016199,98.98624021
40464,新民路,1,611049,0.00016199,98.98640221
40465,新生土地,1,611050,0.00016199,98.98656420
40466,新生命,1,611051,0.00016199,98.98672619
40467,新生路,1,611052,0.00016199,98.98688819
40468,新光人壽,1,611053,0.00016199,98.98705018
40469,新光部落,1,611054,0.00016199,98.98721218
40470,新光路口,1,611055,0.00016199,98.98737417
40471,新好女人,1,611056,0.00016199,98.98753617
40472,新尖兵,1,611057,0.00016199,98.98769816
40473,新竹市帆船委員會,1,611058,0.00016199,98.98786015
40474,新竹市長,1,611059,0.00016199,98.98802215
40475,新竹企銀,1,611060,0.00016199,98.98818414
40476,新竹科學工業園區,1,611061,0.00016199,98.98834614
40477,新血,1,611062,0.00016199,98.98850813
40478,新作,1,611063,0.00016199,98.98867012
40479,新局,1,611064,0.00016199,98.98883212
40480,新車款,1,611065,0.00016199,98.98899411
40481,新車整備工廠,1,611066,0.00016199,98.98915611
40482,新車整備廠,1,611067,0.00016199,98.98931810
40483,新居,1,611068,0.00016199,98.98948010
40484,新泛電事,1,611069,0.00016199,98.98964209
40485,新近,1,611070,0.00016199,98.98980408
40486,新南威爾士州,1,611071,0.00016199,98.98996608
40487,新城警分局,1,611072,0.00016199,98.99012807
40488,新政,1,611073,0.00016199,98.99029007
40489,新科,1,611074,0.00016199,98.99045206
40490,新科技,1,611075,0.00016199,98.99061406
40491,新原里志,1,611076,0.00016199,98.99077605
40492,新峰影業,1,611077,0.00016199,98.99093804
40493,新時代,1,611078,0.00016199,98.99110004
40494,新泰伸銅,1,611079,0.00016199,98.99126203
40495,新海橋,1,611080,0.00016199,98.99142403
40496,新紡,1,611081,0.00016199,98.99158602
40497,新偕,1,611082,0.00016199,98.99174801
40498,新偕中建設,1,611083,0.00016199,98.99191001
40499,新偕中將,1,611084,0.00016199,98.99207200
40500,新偕中集團,1,611085,0.00016199,98.99223400
40501,新動利,1,611086,0.00016199,98.99239599
40502,新眾電腦公司,1,611087,0.00016199,98.99255799
40503,新移民法,1,611088,0.00016199,98.99271998
40504,新莊分局,1,611089,0.00016199,98.99288197
40505,新莊市,1,611090,0.00016199,98.99304397
40506,新報,1,611091,0.00016199,98.99320596
40507,新華社,1,611092,0.00016199,98.99336796
40508,新貴族,1,611093,0.00016199,98.99352995
40509,新進,1,611094,0.00016199,98.99369195
40510,新順工業區,1,611095,0.00016199,98.99385394
40511,新意,1,611096,0.00016199,98.99401593
40512,新聞系,1,611097,0.00016199,98.99417793
40513,新聞官,1,611098,0.00016199,98.99433992
40514,新聞部,1,611099,0.00016199,98.99450192
40515,新聞照片,1,611100,0.00016199,98.99466391
40516,新聞群組,1,611101,0.00016199,98.99482590
40517,新聞網,1,611102,0.00016199,98.99498790
40518,新聞學者,1,611103,0.00016199,98.99514989
40519,新寫實派,1,611104,0.00016199,98.99531189
40520,新廠效益,1,611105,0.00016199,98.99547388
40521,新德里,1,611106,0.00016199,98.99563588
40522,新潮流,1,611107,0.00016199,98.99579787
40523,新銳,1,611108,0.00016199,98.99595986
40524,新墨西州,1,611109,0.00016199,98.99612186
40525,新學友書店,1,611110,0.00016199,98.99628385
40526,新學有,1,611111,0.00016199,98.99644585
40527,新機,1,611112,0.00016199,98.99660784
40528,新穎性,1,611113,0.00016199,98.99676984
40529,新興區,1,611114,0.00016199,98.99693183
40530,新興國家,1,611115,0.00016199,98.99709382
40531,新興銀行,1,611116,0.00016199,98.99725582
40532,新戲,1,611117,0.00016199,98.99741781
40533,新檔,1,611118,0.00016199,98.99757981
40534,新營交流道,1,611119,0.00016199,98.99774180
40535,新環境基金會,1,611120,0.00016199,98.99790379
40536,新聲大廈,1,611121,0.00016199,98.99806579
40537,新鮮度,1,611122,0.00016199,98.99822778
40538,新鮮感,1,611123,0.00016199,98.99838978
40539,新鮮葉,1,611124,0.00016199,98.99855177
40540,新點子,1,611125,0.00016199,98.99871377
40541,新豐,1,611126,0.00016199,98.99887576
40542,新黨黨團,1,611127,0.00016199,98.99903775
40543,新歡,1,611128,0.00016199,98.99919975
40544,暗室,1,611129,0.00016199,98.99936174
40545,暗星,1,611130,0.00016199,98.99952374
40546,暗流,1,611131,0.00016199,98.99968573
40547,暗紅色,1,611132,0.00016199,98.99984773
40548,暗香浮動,1,611133,0.00016199,99.00000972
40549,暗鬥,1,611134,0.00016199,99.00017171
40550,暗淡,1,611135,0.00016199,99.00033371
40551,暗處,1,611136,0.00016199,99.00049570
40552,暗渡陳倉,1,611137,0.00016199,99.00065770
40553,暗想,1,611138,0.00016199,99.00081969
40554,暗暗,1,611139,0.00016199,99.00098168
40555,暗號,1,611140,0.00016199,99.00114368
40556,暗綠色,1,611141,0.00016199,99.00130567
40557,暗盤,1,611142,0.00016199,99.00146767
40558,暗器,1,611143,0.00016199,99.00162966
40559,暉,1,611144,0.00016199,99.00179166
40560,暈眩,1,611145,0.00016199,99.00195365
40561,暈頭轉向,1,611146,0.00016199,99.00211564
40562,暖色系,1,611147,0.00016199,99.00227764
40563,暖身,1,611148,0.00016199,99.00243963
40564,暖身動作,1,611149,0.00016199,99.00260163
40565,暖和,1,611150,0.00016199,99.00276362
40566,暖紅色,1,611151,0.00016199,99.00292562
40567,會外賽,1,611152,0.00016199,99.00308761
40568,會合,1,611153,0.00016199,99.00324960
40569,會計主任,1,611154,0.00016199,99.00341160
40570,會員卡號,1,611155,0.00016199,99.00357359
40571,會做,1,611156,0.00016199,99.00373559
40572,會務,1,611157,0.00016199,99.00389758
40573,會產,1,611158,0.00016199,99.00405957
40574,會集,1,611159,0.00016199,99.00422157
40575,會意,1,611160,0.00016199,99.00438356
40576,會影響,1,611161,0.00016199,99.00454556
40577,會整,1,611162,0.00016199,99.00470755
40578,會懷,1,611163,0.00016199,99.00486955
40579,會籍,1,611164,0.00016199,99.00503154
40580,會議中心,1,611165,0.00016199,99.00519353
40581,業果,1,611166,0.00016199,99.00535553
40582,業務人員,1,611167,0.00016199,99.00551752
40583,業務處長,1,611168,0.00016199,99.00567952
40584,業務部,1,611169,0.00016199,99.00584151
40585,業務過失致死罪,1,611170,0.00016199,99.00600351
40586,業經,1,611171,0.00016199,99.00616550
40587,業障,1,611172,0.00016199,99.00632749
40588,楚河,1,611173,0.00016199,99.00648949
40589,楚香帥,1,611174,0.00016199,99.00665148
40590,楚雲,1,611175,0.00016199,99.00681348
40591,楚楚可憐,1,611176,0.00016199,99.00697547
40592,楠梓交流道,1,611177,0.00016199,99.00713747
40593,楠梓電,1,611178,0.00016199,99.00729946
40594,楠溪江中游鄉土建築,1,611179,0.00016199,99.00746145
40595,楔狀,1,611180,0.00016199,99.00762345
40596,極少,1,611181,0.00016199,99.00778544
40597,極光攝影俱樂部,1,611182,0.00016199,99.00794744
40598,極具,1,611183,0.00016199,99.00810943
40599,極盛,1,611184,0.00016199,99.00827142
40600,極樂,1,611185,0.00016199,99.00843342
40601,極樂世畀,1,611186,0.00016199,99.00859541
40602,極權主義,1,611187,0.00016199,99.00875741
40603,極權政治,1,611188,0.00016199,99.00891940
40604,椰子,1,611189,0.00016199,99.00908140
40605,椰林大道,1,611190,0.00016199,99.00924339
40606,椰絲,1,611191,0.00016199,99.00940538
40607,概念車,1,611192,0.00016199,99.00956738
40608,概念股,1,611193,0.00016199,99.00972937
40609,概要,1,611194,0.00016199,99.00989137
40610,概算,1,611195,0.00016199,99.01005336
40611,概觀,1,611196,0.00016199,99.01021536
40612,楊久美,1,611197,0.00016199,99.01037735
40613,楊久美瑜伽補習班,1,611198,0.00016199,99.01053934
40614,楊仁也,1,611199,0.00016199,99.01070134
40615,楊平和,1,611200,0.00016199,99.01086333
40616,楊兆景,1,611201,0.00016199,99.01102533
40617,楊安民,1,611202,0.00016199,99.01118732
40618,楊成芳,1,611203,0.00016199,99.01134931
40619,楊百萬,1,611204,0.00016199,99.01151131
40620,楊羽雯,1,611205,0.00016199,99.01167330
40621,楊佳,1,611206,0.00016199,99.01183530
40622,楊其文,1,611207,0.00016199,99.01199729
40623,楊宗,1,611208,0.00016199,99.01215929
40624,楊宗憲,1,611209,0.00016199,99.01232128
40625,楊宗樺,1,611210,0.00016199,99.01248327
40626,楊忠旋,1,611211,0.00016199,99.01264527
40627,楊武忠,1,611212,0.00016199,99.01280726
40628,楊金嚴,1,611213,0.00016199,99.01296926
40629,楊勁松,1,611214,0.00016199,99.01313125
40630,楊思敏,1,611215,0.00016199,99.01329325
40631,楊柳,1,611216,0.00016199,99.01345524
40632,楊美珍,1,611217,0.00016199,99.01361723
40633,楊修,1,611218,0.00016199,99.01377923
40634,楊培銘,1,611219,0.00016199,99.01394122
40635,楊清順,1,611220,0.00016199,99.01410322
40636,楊淑媛,1,611221,0.00016199,99.01426521
40637,楊逢春,1,611222,0.00016199,99.01442720
40638,楊雪玒,1,611223,0.00016199,99.01458920
40639,楊景鎮,1,611224,0.00016199,99.01475119
40640,楊朝祥,1,611225,0.00016199,99.01491319
40641,楊肅元,1,611226,0.00016199,99.01507518
40642,楊慧娟,1,611227,0.00016199,99.01523718
40643,楊曉輝,1,611228,0.00016199,99.01539917
40644,楊樹根,1,611229,0.00016199,99.01556116
40645,楊瓊華,1,611230,0.00016199,99.01572316
40646,楊寶發,1,611231,0.00016199,99.01588515
40647,楓丹白露森林中的岩石,1,611232,0.00016199,99.01604715
40648,楓香,1,611233,0.00016199,99.01620914
40649,楓港,1,611234,0.00016199,99.01637114
40650,楓葉糖漿,1,611235,0.00016199,99.01653313
40651,楓樹,1,611236,0.00016199,99.01669512
40652,楓糖,1,611237,0.00016199,99.01685712
40653,歲末,1,611238,0.00016199,99.01701911
40654,歲修,1,611239,0.00016199,99.01718111
40655,毀天滅地,1,611240,0.00016199,99.01734310
40656,毀容,1,611241,0.00016199,99.01750509
40657,毀掉,1,611242,0.00016199,99.01766709
40658,毀損,1,611243,0.00016199,99.01782908
40659,毀滅王國,1,611244,0.00016199,99.01799108
40660,毀滅性,1,611245,0.00016199,99.01815307
40661,毀謗性,1,611246,0.00016199,99.01831507
40662,毀譽參半,1,611247,0.00016199,99.01847706
40663,殿,1,611248,0.00016199,99.01863905
40664,殿後,1,611249,0.00016199,99.01880105
40665,殿堂,1,611250,0.00016199,99.01896304
40666,溢付,1,611251,0.00016199,99.01912504
40667,溢領,1,611252,0.00016199,99.01928703
40668,溶出,1,611253,0.00016199,99.01944903
40669,溶掉,1,611254,0.00016199,99.01961102
40670,溶進,1,611255,0.00016199,99.01977301
40671,溶解力,1,611256,0.00016199,99.01993501
40672,溶劑,1,611257,0.00016199,99.02009700
40673,滂沛,1,611258,0.00016199,99.02025900
40674,滂沱,1,611259,0.00016199,99.02042099
40675,滂沱大雨,1,611260,0.00016199,99.02058298
40676,源由,1,611261,0.00016199,99.02074498
40677,源自,1,611262,0.00016199,99.02090697
40678,源泉,1,611263,0.00016199,99.02106897
40679,源源,1,611264,0.00016199,99.02123096
40680,源興,1,611265,0.00016199,99.02139296
40681,源興科技,1,611266,0.00016199,99.02155495
40682,溝仔埂,1,611267,0.00016199,99.02171694
40683,溝通史,1,611268,0.00016199,99.02187894
40684,溝通法,1,611269,0.00016199,99.02204093
40685,滇菜,1,611270,0.00016199,99.02220293
40686,滅門,1,611271,0.00016199,99.02236492
40687,滅茵,1,611272,0.00016199,99.02252692
40688,滅頂,1,611273,0.00016199,99.02268891
40689,溼潤,1,611274,0.00016199,99.02285090
40690,溼壁畫,1,611275,0.00016199,99.02301290
40691,溫水游泳池,1,611276,0.00016199,99.02317489
40692,溫存,1,611277,0.00016199,99.02333689
40693,溫吞,1,611278,0.00016199,99.02349888
40694,溫室,1,611279,0.00016199,99.02366087
40695,溫泉區,1,611280,0.00016199,99.02382287
40696,溫洲街,1,611281,0.00016199,99.02398486
40697,溫哥華,1,611282,0.00016199,99.02414686
40698,溫帶,1,611283,0.00016199,99.02430885
40699,溫帶魚,1,611284,0.00016199,99.02447085
40700,溫情,1,611285,0.00016199,99.02463284
40701,溫習,1,611286,0.00016199,99.02479483
40702,溫斯圖,1,611287,0.00016199,99.02495683
40703,溫雅,1,611288,0.00016199,99.02511882
40704,溫煦,1,611289,0.00016199,99.02528082
40705,溫補,1,611290,0.00016199,99.02544281
40706,溫熱起來,1,611291,0.00016199,99.02560481
40707,溫馨家族,1,611292,0.00016199,99.02576680
40708,溫馨點心,1,611293,0.00016199,99.02592879
40709,滑不滑,1,611294,0.00016199,99.02609079
40710,滑行,1,611295,0.00016199,99.02625278
40711,滑倒,1,611296,0.00016199,99.02641478
40712,滑動,1,611297,0.00016199,99.02657677
40713,滑動片,1,611298,0.00016199,99.02673876
40714,滑球,1,611299,0.00016199,99.02690076
40715,滑軟,1,611300,0.00016199,99.02706275
40716,滑溜溜,1,611301,0.00016199,99.02722475
40717,滑壘,1,611302,0.00016199,99.02738674
40718,滑鐵爐,1,611303,0.00016199,99.02754874
40719,準位,1,611304,0.00016199,99.02771073
40720,準位轉電路,1,611305,0.00016199,99.02787272
40721,準決賽,1,611306,0.00016199,99.02803472
40722,準爸爸,1,611307,0.00016199,99.02819671
40723,準備金,1,611308,0.00016199,99.02835871
40724,準備理事會,1,611309,0.00016199,99.02852070
40725,準媽媽,1,611310,0.00016199,99.02868270
40726,準噶爾,1,611311,0.00016199,99.02884469
40727,準繩,1,611312,0.00016199,99.02900668
40728,溜出,1,611313,0.00016199,99.02916868
40729,溜冰場,1,611314,0.00016199,99.02933067
40730,滄桑,1,611315,0.00016199,99.02949267
40731,滔滔,1,611316,0.00016199,99.02965466
40732,滔滔不絕,1,611317,0.00016199,99.02981665
40733,溪北焚化爐,1,611318,0.00016199,99.02997865
40734,溪床,1,611319,0.00016199,99.03014064
40735,溪亭話舊,1,611320,0.00016199,99.03030264
40736,溪洲大橋,1,611321,0.00016199,99.03046463
40737,溪湖鎮,1,611322,0.00016199,99.03062663
40738,煎成,1,611323,0.00016199,99.03078862
40739,煎蛋,1,611324,0.00016199,99.03095061
40740,煙仔魚,1,611325,0.00016199,99.03111261
40741,煙灰缸,1,611326,0.00016199,99.03127460
40742,煙囪,1,611327,0.00016199,99.03143660
40743,煙氣,1,611328,0.00016199,99.03159859
40744,煙草,1,611329,0.00016199,99.03176059
40745,煙草業,1,611330,0.00016199,99.03192258
40746,煙商,1,611331,0.00016199,99.03208457
40747,煙業,1,611332,0.00016199,99.03224657
40748,煙幕彈,1,611333,0.00016199,99.03240856
40749,煙頭,1,611334,0.00016199,99.03257056
40750,煙燻,1,611335,0.00016199,99.03273255
40751,煙霧偵測器,1,611336,0.00016199,99.03289454
40752,煙霧彈,1,611337,0.00016199,99.03305654
40753,煙屺,1,611338,0.00016199,99.03321853
40754,煩瑣,1,611339,0.00016199,99.03338053
40755,煩雜,1,611340,0.00016199,99.03354252
40756,煤炭,1,611341,0.00016199,99.03370452
40757,煤炭渣,1,611342,0.00016199,99.03386651
40758,煤礦,1,611343,0.00016199,99.03402850
40759,煉丹,1,611344,0.00016199,99.03419050
40760,煉油廠,1,611345,0.00016199,99.03435249
40761,煉鋼業,1,611346,0.00016199,99.03451449
40762,煉鋼廠,1,611347,0.00016199,99.03467648
40763,照出,1,611348,0.00016199,99.03483848
40764,照本宣科,1,611349,0.00016199,99.03500047
40765,照進,1,611350,0.00016199,99.03516246
40766,照會,1,611351,0.00016199,99.03532446
40767,照照,1,611352,0.00016199,99.03548645
40768,照照相,1,611353,0.00016199,99.03564845
40769,照像機,1,611354,0.00016199,99.03581044
40770,照說,1,611355,0.00016199,99.03597244
40771,照樣,1,611356,0.00016199,99.03613443
40772,照耀,1,611357,0.00016199,99.03629642
40773,煦煦,1,611358,0.00016199,99.03645842
40774,煥發,1,611359,0.00016199,99.03662041
40775,煞星,1,611360,0.00016199,99.03678241
40776,煞氣,1,611361,0.00016199,99.03694440
40777,煨成,1,611362,0.00016199,99.03710639
40778,爺,1,611363,0.00016199,99.03726839
40779,爺娘,1,611364,0.00016199,99.03743038
40780,爺爺,1,611365,0.00016199,99.03759238
40781,猿聲,1,611366,0.00016199,99.03775437
40782,瑟縮,1,611367,0.00016199,99.03791637
40783,瑞,1,611368,0.00016199,99.03807836
40784,瑞士佬,1,611369,0.00016199,99.03824035
40785,瑞內克,1,611370,0.00016199,99.03840235
40786,瑞典克羅瑪塔樂團,1,611371,0.00016199,99.03856434
40787,瑞典皇家科學院,1,611372,0.00016199,99.03872634
40788,瑞奇,1,611373,0.00016199,99.03888833
40789,瑞郎,1,611374,0.00016199,99.03905033
40790,瑞智,1,611375,0.00016199,99.03921232
40791,當口,1,611376,0.00016199,99.03937431
40792,當心,1,611377,0.00016199,99.03953631
40793,當令,1,611378,0.00016199,99.03969830
40794,當有,1,611379,0.00016199,99.03986030
40795,當局者,1,611380,0.00016199,99.04002229
40796,當事者,1,611381,0.00016199,99.04018428
40797,當事國,1,611382,0.00016199,99.04034628
40798,當刻,1,611383,0.00016199,99.04050827
40799,當夜,1,611384,0.00016199,99.04067027
40800,當官,1,611385,0.00016199,99.04083226
40801,當店,1,611386,0.00016199,99.04099426
40802,當家作主,1,611387,0.00016199,99.04115625
40803,當班,1,611388,0.00016199,99.04131824
40804,當真,1,611389,0.00016199,99.04148024
40805,當推,1,611390,0.00016199,99.04164223
40806,當眾,1,611391,0.00016199,99.04180423
40807,當期,1,611392,0.00016199,99.04196622
40808,當頭棒喝,1,611393,0.00016199,99.04212822
40809,當權者,1,611394,0.00016199,99.04229021
40810,畸胎,1,611395,0.00016199,99.04245220
40811,瘀痛,1,611396,0.00016199,99.04261420
40812,痱子膏,1,611397,0.00016199,99.04277619
40813,痿縮,1,611398,0.00016199,99.04293819
40814,痴心,1,611399,0.00016199,99.04310018
40815,痴呆症,1,611400,0.00016199,99.04326217
40816,盟友,1,611401,0.00016199,99.04342417
40817,睫,1,611402,0.00016199,99.04358616
40818,睦鄰,1,611403,0.00016199,99.04374816
40819,督察人員,1,611404,0.00016199,99.04391015
40820,督察部,1,611405,0.00016199,99.04407215
40821,督學,1,611406,0.00016199,99.04423414
40822,睹物思情,1,611407,0.00016199,99.04439613
40823,矮人族,1,611408,0.00016199,99.04455813
40824,矮小,1,611409,0.00016199,99.04472012
40825,矮化,1,611410,0.00016199,99.04488212
40826,碎石,1,611411,0.00016199,99.04504411
40827,碎肉,1,611412,0.00016199,99.04520611
40828,碎花,1,611413,0.00016199,99.04536810
40829,碎蛋,1,611414,0.00016199,99.04553009
40830,碰見,1,611415,0.00016199,99.04569209
40831,碗形劇場,1,611416,0.00016199,99.04585408
40832,碗筷,1,611417,0.00016199,99.04601608
40833,祿來,1,611418,0.00016199,99.04617807
40834,禁入墳場,1,611419,0.00016199,99.04634006
40835,禁不住,1,611420,0.00016199,99.04650206
40836,禁不起,1,611421,0.00016199,99.04666405
40837,禁見,1,611422,0.00016199,99.04682605
40838,禁足令,1,611423,0.00016199,99.04698804
40839,禁治產人,1,611424,0.00016199,99.04715004
40840,禁售,1,611425,0.00016199,99.04731203
40841,禁絕,1,611426,0.00016199,99.04747402
40842,禁煙,1,611427,0.00016199,99.04763602
40843,禁慾主義者,1,611428,0.00016199,99.04779801
40844,禁臠,1,611429,0.00016199,99.04796001
40845,萬千,1,611430,0.00016199,99.04812200
40846,萬中一,1,611431,0.00016199,99.04828400
40847,萬丹,1,611432,0.00016199,99.04844599
40848,萬心揚愛慈善園遊會,1,611433,0.00016199,99.04860798
40849,萬民,1,611434,0.00016199,99.04876998
40850,萬用,1,611435,0.00016199,99.04893197
40851,萬幸,1,611436,0.00016199,99.04909397
40852,萬花筒,1,611437,0.00016199,99.04925596
40853,萬客隆,1,611438,0.00016199,99.04941795
40854,萬美雅,1,611439,0.00016199,99.04957995
40855,萬格勒,1,611440,0.00016199,99.04974194
40856,萬船齊發,1,611441,0.00016199,99.04990394
40857,萬通,1,611442,0.00016199,99.05006593
40858,萬華警分局,1,611443,0.00016199,99.05022793
40859,萬象系列,1,611444,0.00016199,99.05038992
40860,萬榮,1,611445,0.00016199,99.05055191
40861,萬箭穿心,1,611446,0.00016199,99.05071391
40862,萬點,1,611447,0.00016199,99.05087590
40863,萬獸之王,1,611448,0.00016199,99.05103790
40864,萬寶路,1,611449,0.00016199,99.05119989
40865,萬靈丹,1,611450,0.00016199,99.05136189
40866,禽類,1,611451,0.00016199,99.05152388
40867,稚,1,611452,0.00016199,99.05168587
40868,稚拙,1,611453,0.00016199,99.05184787
40869,稚氣,1,611454,0.00016199,99.05200986
40870,稚情,1,611455,0.00016199,99.05217186
40871,稠化劑,1,611456,0.00016199,99.05233385
40872,稠密,1,611457,0.00016199,99.05249584
40873,窟窿,1,611458,0.00016199,99.05265784
40874,筷子,1,611459,0.00016199,99.05281983
40875,節令,1,611460,0.00016199,99.05298183
40876,節用,1,611461,0.00016199,99.05314382
40877,節目表,1,611462,0.00016199,99.05330582
40878,節拍,1,611463,0.00016199,99.05346781
40879,節拍器,1,611464,0.00016199,99.05362980
40880,節奏感,1,611465,0.00016199,99.05379180
40881,節度使,1,611466,0.00016199,99.05395379
40882,節氣,1,611467,0.00016199,99.05411579
40883,筧橋,1,611468,0.00016199,99.05427778
40884,粵,1,611469,0.00016199,99.05443978
40885,經手,1,611470,0.00016199,99.05460177
40886,經史,1,611471,0.00016199,99.05476376
40887,經年,1,611472,0.00016199,99.05492576
40888,經年累月,1,611473,0.00016199,99.05508775
40889,經典之作,1,611474,0.00016199,99.05524975
40890,經卷,1,611475,0.00016199,99.05541174
40891,經建會主委,1,611476,0.00016199,99.05557373
40892,經研處長,1,611477,0.00016199,99.05573573
40893,經研部,1,611478,0.00016199,99.05589772
40894,經商者,1,611479,0.00016199,99.05605972
40895,經國號,1,611480,0.00016199,99.05622171
40896,經常性,1,611481,0.00016199,99.05638371
40897,經常帳,1,611482,0.00016199,99.05654570
40898,經理說,1,611483,0.00016199,99.05670769
40899,經惠,1,611484,0.00016199,99.05686969
40900,經惠公司,1,611485,0.00016199,99.05703168
40901,經痛,1,611486,0.00016199,99.05719368
40902,經貿部,1,611487,0.00016199,99.05735567
40903,經貿園區,1,611488,0.00016199,99.05751767
40904,經意,1,611489,0.00016199,99.05767966
40905,經綸,1,611490,0.00016199,99.05784165
40906,經輪,1,611491,0.00016199,99.05800365
40907,經銷,1,611492,0.00016199,99.05816564
40908,經濟大恐慌,1,611493,0.00016199,99.05832764
40909,經濟日報,1,611494,0.00016199,99.05848963
40910,經濟犯,1,611495,0.00016199,99.05865162
40911,經濟系,1,611496,0.00016199,99.05881362
40912,經濟性,1,611497,0.00016199,99.05897561
40913,經濟型,1,611498,0.00016199,99.05913761
40914,經濟效益,1,611499,0.00016199,99.05929960
40915,經濟時報,1,611500,0.00016199,99.05946160
40916,經濟圈,1,611501,0.00016199,99.05962359
40917,經濟軟著陸,1,611502,0.00016199,99.05978558
40918,經濟部次長,1,611503,0.00016199,99.05994758
40919,經濟部國貿局,1,611504,0.00016199,99.06010957
40920,經濟部常次,1,611505,0.00016199,99.06027157
40921,經濟發展處,1,611506,0.00016199,99.06043356
40922,經濟獎,1,611507,0.00016199,99.06059556
40923,經濟體,1,611508,0.00016199,99.06075755
40924,經鬆,1,611509,0.00016199,99.06091954
40925,經驗值,1,611510,0.00016199,99.06108154
40926,絹,1,611511,0.00016199,99.06124353
40927,綁起來,1,611512,0.00016199,99.06140553
40928,置之度外,1,611513,0.00016199,99.06156752
40929,罩,1,611514,0.00016199,99.06172952
40930,罩住,1,611515,0.00016199,99.06189151
40931,罩遮,1,611516,0.00016199,99.06205350
40932,罪大惡極,1,611517,0.00016199,99.06221550
40933,罪刑,1,611518,0.00016199,99.06237749
40934,罪責,1,611519,0.00016199,99.06253949
40935,罪無可逭,1,611520,0.00016199,99.06270148
40936,署名,1,611521,0.00016199,99.06286347
40937,署長,1,611522,0.00016199,99.06302547
40938,義士,1,611523,0.00016199,99.06318746
40939,義大利半島,1,611524,0.00016199,99.06334946
40940,義大利式,1,611525,0.00016199,99.06351145
40941,義大利餐廳,1,611526,0.00016199,99.06367345
40942,義大利廳,1,611527,0.00016199,99.06383544
40943,義式,1,611528,0.00016199,99.06399743
40944,義美,1,611529,0.00016199,99.06415943
40945,義美食品,1,611530,0.00016199,99.06432142
40946,義氣,1,611531,0.00016199,99.06448342
40947,義消,1,611532,0.00016199,99.06464541
40948,義理,1,611533,0.00016199,99.06480741
40949,義診,1,611534,0.00016199,99.06496940
40950,義意,1,611535,0.00016199,99.06513139
40951,羨,1,611536,0.00016199,99.06529339
40952,群弓,1,611537,0.00016199,99.06545538
40953,群島,1,611538,0.00016199,99.06561738
40954,群益證券公司,1,611539,0.00016199,99.06577937
40955,群情憤慨,1,611540,0.00016199,99.06594136
40956,群情激憤,1,611541,0.00016199,99.06610336
40957,群眾暴力,1,611542,0.00016199,99.06626535
40958,群陸自動化公司,1,611543,0.00016199,99.06642735
40959,群策群力,1,611544,0.00016199,99.06658934
40960,群集,1,611545,0.00016199,99.06675134
40961,群蟻,1,611546,0.00016199,99.06691333
40962,聖子,1,611547,0.00016199,99.06707532
40963,聖水,1,611548,0.00016199,99.06723732
40964,聖王,1,611549,0.00016199,99.06739931
40965,聖母．瑪麗亞,1,611550,0.00016199,99.06756131
40966,聖母像,1,611551,0.00016199,99.06772330
40967,聖母瑪麗亞,1,611552,0.00016199,99.06788530
40968,聖吉,1,611553,0.00016199,99.06804729
40969,聖旨,1,611554,0.00016199,99.06820928
40970,聖克里斯多福臨終關懷醫院,1,611555,0.00016199,99.06837128
40971,聖彼德堡,1,611556,0.00016199,99.06853327
40972,聖保羅大學,1,611557,0.00016199,99.06869527
40973,聖品,1,611558,0.00016199,99.06885726
40974,聖哈辛托號,1,611559,0.00016199,99.06901925
40975,聖馬丁,1,611560,0.00016199,99.06918125
40976,聖馬丁廣場,1,611561,0.00016199,99.06934324
40977,聖堂,1,611562,0.00016199,99.06950524
40978,聖淘沙,1,611563,0.00016199,99.06966723
40979,聖淘沙烏,1,611564,0.00016199,99.06982923
40980,聖都,1,611565,0.00016199,99.06999122
40981,聖陶沙,1,611566,0.00016199,99.07015321
40982,聖堡,1,611567,0.00016199,99.07031521
40983,聖塔克拉拉,1,611568,0.00016199,99.07047720
40984,聖塔芭芭拉,1,611569,0.00016199,99.07063920
40985,聖塔娜,1,611570,0.00016199,99.07080119
40986,聖奧古斯丁基地,1,611571,0.00016199,99.07096319
40987,聖詹姆士大教堂,1,611572,0.00016199,99.07112518
40988,聖歌,1,611573,0.00016199,99.07128717
40989,聖潘克拉斯,1,611574,0.00016199,99.07144917
40990,聖潘克拉斯車站,1,611575,0.00016199,99.07161116
40991,聖潘克拉斯路,1,611576,0.00016199,99.07177316
40992,聖鹽,1,611577,0.00016199,99.07193515
40993,聘用,1,611578,0.00016199,99.07209714
40994,聘任,1,611579,0.00016199,99.07225914
40995,聘兼,1,611580,0.00016199,99.07242113
40996,聘僱,1,611581,0.00016199,99.07258313
40997,肆虐,1,611582,0.00016199,99.07274512
40998,肄業,1,611583,0.00016199,99.07290712
40999,腱,1,611584,0.00016199,99.07306911
41000,腰子,1,611585,0.00016199,99.07323110
41001,腰果,1,611586,0.00016199,99.07339310
41002,腰花,1,611587,0.00016199,99.07355509
41003,腰帶,1,611588,0.00016199,99.07371709
41004,腰腹,1,611589,0.00016199,99.07387908
41005,腰臀,1,611590,0.00016199,99.07404108
41006,腰纏萬貫,1,611591,0.00016199,99.07420307
41007,腸胃,1,611592,0.00016199,99.07436506
41008,腥紅,1,611593,0.00016199,99.07452706
41009,腮,1,611594,0.00016199,99.07468905
41010,腮紅刷毛,1,611595,0.00016199,99.07485105
41011,腮紅粉,1,611596,0.00016199,99.07501304
41012,腳丫子的故事,1,611597,0.00016199,99.07517503
41013,腳底,1,611598,0.00016199,99.07533703
41014,腳指,1,611599,0.00016199,99.07549902
41015,腳釘,1,611600,0.00016199,99.07566102
41016,腳趾頭,1,611601,0.00016199,99.07582301
41017,腳軟,1,611602,0.00016199,99.07598501
41018,腳掌,1,611603,0.00016199,99.07614700
41019,腳痛,1,611604,0.00016199,99.07630899
41020,腳踏板,1,611605,0.00016199,99.07647099
41021,腳踏墊,1,611606,0.00016199,99.07663298
41022,腳鍊,1,611607,0.00016199,99.07679498
41023,腫大,1,611608,0.00016199,99.07695697
41024,腫毒,1,611609,0.00016199,99.07711897
41025,腫瘍期,1,611610,0.00016199,99.07728096
41026,腹股溝管,1,611611,0.00016199,99.07744295
41027,腹腔鏡,1,611612,0.00016199,99.07760495
41028,腹脹,1,611613,0.00016199,99.07776694
41029,腹膜炎,1,611614,0.00016199,99.07792894
41030,腺,1,611615,0.00016199,99.07809093
41031,腺嘌呤,1,611616,0.00016199,99.07825292
41032,腦中風,1,611617,0.00016199,99.07841492
41033,腦內啡,1,611618,0.00016199,99.07857691
41034,腦血管病變,1,611619,0.00016199,99.07873891
41035,腦性,1,611620,0.00016199,99.07890090
41036,腦波,1,611621,0.00016199,99.07906290
41037,腦波集團,1,611622,0.00016199,99.07922489
41038,腦門,1,611623,0.00016199,99.07938688
41039,腦病變,1,611624,0.00016199,99.07954888
41040,腦啡��,1,611625,0.00016199,99.07971087
41041,腦槳,1,611626,0.00016199,99.07987287
41042,舅舅,1,611627,0.00016199,99.08003486
41043,艇艏,1,611628,0.00016199,99.08019686
41044,蒂,1,611629,0.00016199,99.08035885
41045,落山風,1,611630,0.00016199,99.08052084
41046,落水狗,1,611631,0.00016199,99.08068284
41047,落伍性,1,611632,0.00016199,99.08084483
41048,落地式喇叭,1,611633,0.00016199,99.08100683
41049,落地的麥子不死,1,611634,0.00016199,99.08116882
41050,落地玻璃,1,611635,0.00016199,99.08133081
41051,落羽松,1,611636,0.00016199,99.08149281
41052,落居,1,611637,0.00016199,99.08165480
41053,落拓,1,611638,0.00016199,99.08181680
41054,落花有意,1,611639,0.00016199,99.08197879
41055,落後型,1,611640,0.00016199,99.08214079
41056,落英繽紛,1,611641,0.00016199,99.08230278
41057,落單,1,611642,0.00016199,99.08246477
41058,落跑,1,611643,0.00016199,99.08262677
41059,落落,1,611644,0.00016199,99.08278876
41060,落落大方,1,611645,0.00016199,99.08295076
41061,落葉喬木,1,611646,0.00016199,99.08311275
41062,落葉歸根,1,611647,0.00016199,99.08327475
41063,落塵量,1,611648,0.00016199,99.08343674
41064,落榜,1,611649,0.00016199,99.08359873
41065,落髮,1,611650,0.00016199,99.08376073
41066,落難,1,611651,0.00016199,99.08392272
41067,落櫻,1,611652,0.00016199,99.08408472
41068,葵花子,1,611653,0.00016199,99.08424671
41069,葵花寶典,1,611654,0.00016199,99.08440870
41070,葫蘆,1,611655,0.00016199,99.08457070
41071,葉丕也,1,611656,0.00016199,99.08473269
41072,葉全真,1,611657,0.00016199,99.08489469
41073,葉怡伶,1,611658,0.00016199,99.08505668
41074,葉金源,1,611659,0.00016199,99.08521868
41075,葉金鳳,1,611660,0.00016199,99.08538067
41076,葉春木,1,611661,0.00016199,99.08554266
41077,葉脈,1,611662,0.00016199,99.08570466
41078,葉啟泰,1,611663,0.00016199,99.08586665
41079,葉菊蘭,1,611664,0.00016199,99.08602865
41080,葉菜,1,611665,0.00016199,99.08619064
41081,葉菜類,1,611666,0.00016199,99.08635264
41082,葉榮廷,1,611667,0.00016199,99.08651463
41083,葉豪武,1,611668,0.00016199,99.08667662
41084,葉銘琛式,1,611669,0.00016199,99.08683862
41085,葉曉珊,1,611670,0.00016199,99.08700061
41086,葉樹涵,1,611671,0.00016199,99.08716261
41087,葉蕙蘭,1,611672,0.00016199,99.08732460
41088,葬送,1,611673,0.00016199,99.08748659
41089,葬送掉,1,611674,0.00016199,99.08764859
41090,葬儀杜,1,611675,0.00016199,99.08781058
41091,葬儀官,1,611676,0.00016199,99.08797258
41092,葬儀社,1,611677,0.00016199,99.08813457
41093,葛令卡,1,611678,0.00016199,99.08829657
41094,葛札格,1,611679,0.00016199,99.08845856
41095,葛民輝,1,611680,0.00016199,99.08862055
41096,葛拉茲諾夫,1,611681,0.00016199,99.08878255
41097,葛拉傑,1,611682,0.00016199,99.08894454
41098,葛林醫生,1,611683,0.00016199,99.08910654
41099,葛洛莉亞,1,611684,0.00016199,99.08926853
41100,葛倫,1,611685,0.00016199,99.08943053
41101,葛倫．丹尼斯,1,611686,0.00016199,99.08959252
41102,葛倫菲德,1,611687,0.00016199,99.08975451
41103,葛萊姆,1,611688,0.00016199,99.08991651
41104,葛瑞絲瓊絲,1,611689,0.00016199,99.09007850
41105,葛雷哥萊漢里斯,1,611690,0.00016199,99.09024050
41106,葛樂禮,1,611691,0.00016199,99.09040249
41107,葛繼正,1,611692,0.00016199,99.09056449
41108,葛蘭,1,611693,0.00016199,99.09072648
41109,葛蘭姆,1,611694,0.00016199,99.09088847
41110,萵,1,611695,0.00016199,99.09105047
41111,葡,1,611696,0.00016199,99.09121246
41112,葡萄牙話,1,611697,0.00016199,99.09137446
41113,葡萄牙籍,1,611698,0.00016199,99.09153645
41114,葡萄花,1,611699,0.00016199,99.09169844
41115,葡萄棚,1,611700,0.00016199,99.09186044
41116,葡萄鬚,1,611701,0.00016199,99.09202243
41117,董美貞,1,611702,0.00016199,99.09218443
41118,董晉福,1,611703,0.00016199,99.09234642
41119,董監,1,611704,0.00016199,99.09250842
41120,董監事會,1,611705,0.00016199,99.09267041
41121,董監事會議,1,611706,0.00016199,99.09283240
41122,虞煥榮,1,611707,0.00016199,99.09299440
41123,號子,1,611708,0.00016199,99.09315639
41124,號召力,1,611709,0.00016199,99.09331839
41125,號叫,1,611710,0.00016199,99.09348038
41126,號誌燈,1,611711,0.00016199,99.09364238
41127,號碼盤,1,611712,0.00016199,99.09380437
41128,蜈蚣丁壩,1,611713,0.00016199,99.09396636
41129,蛾摩拉城,1,611714,0.00016199,99.09412836
41130,蛻變成,1,611715,0.00016199,99.09429035
41131,蜂,1,611716,0.00016199,99.09445235
41132,蜂巢式電話,1,611717,0.00016199,99.09461434
41133,蜂湧而來,1,611718,0.00016199,99.09477633
41134,蜂窩頭,1,611719,0.00016199,99.09493833
41135,蜂蜜蛋糕,1,611720,0.00016199,99.09510032
41136,裙,1,611721,0.00016199,99.09526232
41137,裙子,1,611722,0.00016199,99.09542431
41138,裙擺,1,611723,0.00016199,99.09558631
41139,補丁,1,611724,0.00016199,99.09574830
41140,補上,1,611725,0.00016199,99.09591029
41141,補件,1,611726,0.00016199,99.09607229
41142,補助款項,1,611727,0.00016199,99.09623428
41143,補妝,1,611728,0.00016199,99.09639628
41144,補校,1,611729,0.00016199,99.09655827
41145,補益,1,611730,0.00016199,99.09672027
41146,補習教育法,1,611731,0.00016199,99.09688226
41147,補習費,1,611732,0.00016199,99.09704425
41148,補畫,1,611733,0.00016199,99.09720625
41149,補稅,1,611734,0.00016199,99.09736824
41150,補給,1,611735,0.00016199,99.09753024
41151,補腦,1,611736,0.00016199,99.09769223
41152,補漲,1,611737,0.00016199,99.09785422
41153,補錢,1,611738,0.00016199,99.09801622
41154,補擦,1,611739,0.00016199,99.09817821
41155,補賽,1,611740,0.00016199,99.09834021
41156,補粧,1,611741,0.00016199,99.09850220
41157,裘瑟琳摩郝絲,1,611742,0.00016199,99.09866420
41158,裝入,1,611743,0.00016199,99.09882619
41159,裝出,1,611744,0.00016199,99.09898818
41160,裝用,1,611745,0.00016199,99.09915018
41161,裝甲,1,611746,0.00016199,99.09931217
41162,裝有,1,611747,0.00016199,99.09947417
41163,裝作,1,611748,0.00016199,99.09963616
41164,裝車費,1,611749,0.00016199,99.09979816
41165,裝訂,1,611750,0.00016199,99.09996015
41166,裝訂法,1,611751,0.00016199,99.10012214
41167,裝備店,1,611752,0.00016199,99.10028414
41168,裝機量,1,611753,0.00016199,99.10044613
41169,裝點,1,611754,0.00016199,99.10060813
41170,裝聾作啞,1,611755,0.00016199,99.10077012
41171,裝罐,1,611756,0.00016199,99.10093211
41172,裝潢布,1,611757,0.00016199,99.10109411
41173,裡子,1,611758,0.00016199,99.10125610
41174,裡海,1,611759,0.00016199,99.10141810
41175,裡應外合,1,611760,0.00016199,99.10158009
41176,裊裊,1,611761,0.00016199,99.10174209
41177,裕台公司,1,611762,0.00016199,99.10190408
41178,裕隆恐龍,1,611763,0.00016199,99.10206607
41179,解放軍報,1,611764,0.00016199,99.10222807
41180,解析模式,1,611765,0.00016199,99.10239006
41181,解便,1,611766,0.00016199,99.10255206
41182,解約金,1,611767,0.00016199,99.10271405
41183,解凍,1,611768,0.00016199,99.10287605
41184,解剖學,1,611769,0.00016199,99.10303804
41185,解剖學家,1,611770,0.00016199,99.10320003
41186,解禁,1,611771,0.00016199,99.10336203
41187,解解,1,611772,0.00016199,99.10352402
41188,解解饞,1,611773,0.00016199,99.10368602
41189,解運,1,611774,0.00016199,99.10384801
41190,解語,1,611775,0.00016199,99.10401000
41191,解嘲,1,611776,0.00016199,99.10417200
41192,解憂,1,611777,0.00016199,99.10433399
41193,解熱,1,611778,0.00016199,99.10449599
41194,解熱止痛劑,1,611779,0.00016199,99.10465798
41195,解盤,1,611780,0.00016199,99.10481998
41196,解碼器,1,611781,0.00016199,99.10498197
41197,解壓縮,1,611782,0.00016199,99.10514396
41198,解壓縮卡,1,611783,0.00016199,99.10530596
41199,解謎,1,611784,0.00016199,99.10546795
41200,解離,1,611785,0.00016199,99.10562995
41201,解藥,1,611786,0.00016199,99.10579194
41202,該不該,1,611787,0.00016199,99.10595394
41203,該死,1,611788,0.00016199,99.10611593
41204,詳查,1,611789,0.00016199,99.10627792
41205,詳述,1,611790,0.00016199,99.10643992
41206,詳提,1,611791,0.00016199,99.10660191
41207,詳實,1,611792,0.00016199,99.10676391
41208,詳談,1,611793,0.00016199,99.10692590
41209,試片,1,611794,0.00016199,99.10708789
41210,試用品,1,611795,0.00016199,99.10724989
41211,試用期,1,611796,0.00016199,99.10741188
41212,試吃包,1,611797,0.00016199,99.10757388
41213,試行,1,611798,0.00016199,99.10773587
41214,試映,1,611799,0.00016199,99.10789787
41215,試看看,1,611800,0.00016199,99.10805986
41216,試穿,1,611801,0.00016199,99.10822185
41217,試音,1,611802,0.00016199,99.10838385
41218,試飛團,1,611803,0.00016199,99.10854584
41219,試問,1,611804,0.00016199,99.10870784
41220,試量,1,611805,0.00016199,99.10886983
41221,試飲,1,611806,0.00016199,99.10903183
41222,試算,1,611807,0.00016199,99.10919382
41223,試駕,1,611808,0.00016199,99.10935581
41224,試擦,1,611809,0.00016199,99.10951781
41225,試鏡,1,611810,0.00016199,99.10967980
41226,試驗場,1,611811,0.00016199,99.10984180
41227,誇言,1,611812,0.00016199,99.11000379
41228,誇飾,1,611813,0.00016199,99.11016578
41229,誇讚,1,611814,0.00016199,99.11032778
41230,誠心誠意,1,611815,0.00016199,99.11048977
41231,誠品,1,611816,0.00016199,99.11065177
41232,誠品書局,1,611817,0.00016199,99.11081376
41233,誠品畫廊,1,611818,0.00016199,99.11097576
41234,誠洲公司,1,611819,0.00016199,99.11113775
41235,誠敬悅服,1,611820,0.00016199,99.11129974
41236,誠實藥,1,611821,0.00016199,99.11146174
41237,話匣子,1,611822,0.00016199,99.11162373
41238,話梅,1,611823,0.00016199,99.11178573
41239,話筒,1,611824,0.00016199,99.11194772
41240,話說,1,611825,0.00016199,99.11210972
41241,話說回來,1,611826,0.00016199,99.11227171
41242,話鋒,1,611827,0.00016199,99.11243370
41243,誅滅,1,611828,0.00016199,99.11259570
41244,詢問者,1,611829,0.00016199,99.11275769
41245,詹三源,1,611830,0.00016199,99.11291969
41246,詹向天,1,611831,0.00016199,99.11308168
41247,詹姆士．布克,1,611832,0.00016199,99.11324367
41248,詹姆士布萊特,1,611833,0.00016199,99.11340567
41249,詹姆斯貝魯西,1,611834,0.00016199,99.11356766
41250,詹姆斯賈克奈,1,611835,0.00016199,99.11372966
41251,詹庚辛,1,611836,0.00016199,99.11389165
41252,訾議,1,611837,0.00016199,99.11405365
41253,貉藻,1,611838,0.00016199,99.11421564
41254,賊,1,611839,0.00016199,99.11437763
41255,資本帳,1,611840,0.00016199,99.11453963
41256,資金面,1,611841,0.00016199,99.11470162
41257,資政,1,611842,0.00016199,99.11486362
41258,資料量,1,611843,0.00016199,99.11502561
41259,資料操作元,1,611844,0.00016199,99.11518761
41260,資料檔,1,611845,0.00016199,99.11534960
41261,資格標,1,611846,0.00016199,99.11551159
41262,資訊工程系,1,611847,0.00016199,99.11567359
41263,資訊月,1,611848,0.00016199,99.11583558
41264,資訊室,1,611849,0.00016199,99.11599758
41265,資訊界,1,611850,0.00016199,99.11615957
41266,資訊書,1,611851,0.00016199,99.11632156
41267,資訊處理模型,1,611852,0.00016199,99.11648356
41268,資訊處理器,1,611853,0.00016199,99.11664555
41269,資訊窗,1,611854,0.00016199,99.11680755
41270,資訊量,1,611855,0.00016199,99.11696954
41271,資訊傳輸線路,1,611856,0.00016199,99.11713154
41272,資訊錄製區,1,611857,0.00016199,99.11729353
41273,資深副總裁,1,611858,0.00016199,99.11745552
41274,資產負債表,1,611859,0.00016199,99.11761752
41275,資產清冊,1,611860,0.00016199,99.11777951
41276,資產階級,1,611861,0.00016199,99.11794151
41277,資源大樓,1,611862,0.00016199,99.11810350
41278,資源回收日,1,611863,0.00016199,99.11826550
41279,資源回收網,1,611864,0.00016199,99.11842749
41280,資遣差額輔助費,1,611865,0.00016199,99.11858948
41281,資質,1,611866,0.00016199,99.11875148
41282,賈妃,1,611867,0.00016199,99.11891347
41283,賈培源,1,611868,0.00016199,99.11907547
41284,賈德．羅勃茲,1,611869,0.00016199,99.11923746
41285,賈靜雯,1,611870,0.00016199,99.11939946
41286,賄選案,1,611871,0.00016199,99.11956145
41287,跟本,1,611872,0.00016199,99.11972344
41288,跟風,1,611873,0.00016199,99.11988544
41289,跟監,1,611874,0.00016199,99.12004743
41290,跨上,1,611875,0.00016199,99.12020943
41291,跨近,1,611876,0.00016199,99.12037142
41292,跨國企業,1,611877,0.00016199,99.12053341
41293,跨國詐騙疑案,1,611878,0.00016199,99.12069541
41294,路伊斯安那州,1,611879,0.00016199,99.12085740
41295,路向,1,611880,0.00016199,99.12101940
41296,路名,1,611881,0.00016199,99.12118139
41297,路竹球場,1,611882,0.00016199,99.12134339
41298,路考官,1,611883,0.00016199,99.12150538
41299,路易士,1,611884,0.00016199,99.12166737
41300,路易馬盧,1,611885,0.00016199,99.12182937
41301,路易斯,1,611886,0.00016199,99.12199136
41302,路易斯．康,1,611887,0.00016199,99.12215336
41303,路易斯．瑞基特,1,611888,0.00016199,99.12231535
41304,路易維爾,1,611889,0.00016199,99.12247735
41305,路況,1,611890,0.00016199,99.12263934
41306,路段,1,611891,0.00016199,99.12280133
41307,路軌,1,611892,0.00016199,99.12296333
41308,路基,1,611893,0.00016199,99.12312532
41309,路牌,1,611894,0.00016199,99.12328732
41310,路瑟福德,1,611895,0.00016199,99.12344931
41311,路過,1,611896,0.00016199,99.12361130
41312,路標,1,611897,0.00016199,99.12377330
41313,路檢,1,611898,0.00016199,99.12393529
41314,路邊餐館,1,611899,0.00016199,99.12409729
41315,路邊攤,1,611900,0.00016199,99.12425928
41316,跳下來,1,611901,0.00016199,99.12442128
41317,跳上,1,611902,0.00016199,99.12458327
41318,跳上跳下,1,611903,0.00016199,99.12474526
41319,跳出,1,611904,0.00016199,99.12490726
41320,跳車鼓,1,611905,0.00016199,99.12506925
41321,跳空,1,611906,0.00016199,99.12523125
41322,跳姿,1,611907,0.00016199,99.12539324
41323,跳蚤,1,611908,0.00016199,99.12555524
41324,跳蚤市場,1,611909,0.00016199,99.12571723
41325,跳起,1,611910,0.00016199,99.12587922
41326,跳高,1,611911,0.00016199,99.12604122
41327,跳傘,1,611912,0.00016199,99.12620321
41328,跳跳舞,1,611913,0.00016199,99.12636521
41329,跳跳樂,1,611914,0.00016199,99.12652720
41330,跳遠,1,611915,0.00016199,99.12668919
41331,跳槽,1,611916,0.00016199,99.12685119
41332,跳樓,1,611917,0.00016199,99.12701318
41333,跳離,1,611918,0.00016199,99.12717518
41334,跪下,1,611919,0.00016199,99.12733717
41335,跪拜,1,611920,0.00016199,99.12749917
41336,躲開,1,611921,0.00016199,99.12766116
41337,躲債,1,611922,0.00016199,99.12782315
41338,躲過,1,611923,0.00016199,99.12798515
41339,較大,1,611924,0.00016199,99.12814714
41340,較少,1,611925,0.00016199,99.12830914
41341,較好,1,611926,0.00016199,99.12847113
41342,較淺,1,611927,0.00016199,99.12863313
41343,較寬,1,611928,0.00016199,99.12879512
41344,載台管理系統,1,611929,0.00016199,99.12895711
41345,載到,1,611930,0.00016199,99.12911911
41346,載客率,1,611931,0.00016199,99.12928110
41347,載客量,1,611932,0.00016199,99.12944310
41348,載氧量,1,611933,0.00016199,99.12960509
41349,載過,1,611934,0.00016199,99.12976708
41350,農化系,1,611935,0.00016199,99.12992908
41351,農夫褲,1,611936,0.00016199,99.13009107
41352,農作,1,611937,0.00016199,99.13025307
41353,農林漁牧業,1,611938,0.00016199,99.13041506
41354,農牧,1,611939,0.00016199,99.13057706
41355,農品,1,611940,0.00016199,99.13073905
41356,農家,1,611941,0.00016199,99.13090104
41357,農婦,1,611942,0.00016199,99.13106304
41358,農業局,1,611943,0.00016199,99.13122503
41359,農業社會,1,611944,0.00016199,99.13138703
41360,農業信貸銀行,1,611945,0.00016199,99.13154902
41361,農業時代,1,611946,0.00016199,99.13171102
41362,農業區,1,611947,0.00016199,99.13187301
41363,農業部,1,611948,0.00016199,99.13203500
41364,農業課,1,611949,0.00016199,99.13219700
41365,農漁業,1,611950,0.00016199,99.13235899
41366,運出,1,611951,0.00016199,99.13252099
41367,運匠,1,611952,0.00016199,99.13268298
41368,運走,1,611953,0.00016199,99.13284497
41369,運返,1,611954,0.00016199,99.13300697
41370,運動外套,1,611955,0.00016199,99.13316896
41371,運動衣,1,611956,0.00016199,99.13333096
41372,運動防雨型隨身聽,1,611957,0.00016199,99.13349295
41373,運動性,1,611958,0.00016199,99.13365495
41374,運動衫,1,611959,0.00016199,99.13381694
41375,運動員型,1,611960,0.00016199,99.13397893
41376,運動家隊,1,611961,0.00016199,99.13414093
41377,運將,1,611962,0.00016199,99.13430292
41378,運通,1,611963,0.00016199,99.13446492
41379,運勢,1,611964,0.00016199,99.13462691
41380,運載,1,611965,0.00016199,99.13478891
41381,運算子,1,611966,0.00016199,99.13495090
41382,運算平台,1,611967,0.00016199,99.13511289
41383,運銷,1,611968,0.00016199,99.13527489
41384,運輸界,1,611969,0.00016199,99.13543688
41385,運輸船,1,611970,0.00016199,99.13559888
41386,運輸費,1,611971,0.00016199,99.13576087
41387,運輸量,1,611972,0.00016199,99.13592286
41388,運輸隊,1,611973,0.00016199,99.13608486
41389,運輸業,1,611974,0.00016199,99.13624685
41390,運輸業界,1,611975,0.00016199,99.13640885
41391,運鏡,1,611976,0.00016199,99.13657084
41392,運籌帷幄,1,611977,0.00016199,99.13673284
41393,遊刃有餘,1,611978,0.00016199,99.13689483
41394,遊牧族群,1,611979,0.00016199,99.13705682
41395,遊客數,1,611980,0.00016199,99.13721882
41396,遊記,1,611981,0.00016199,99.13738081
41397,遊移,1,611982,0.00016199,99.13754281
41398,遊船,1,611983,0.00016199,99.13770480
41399,遊程,1,611984,0.00016199,99.13786680
41400,遊街,1,611985,0.00016199,99.13802879
41401,遊遍,1,611986,0.00016199,99.13819078
41402,遊樂場,1,611987,0.00016199,99.13835278
41403,遊樂園,1,611988,0.00016199,99.13851477
41404,遊整,1,611989,0.00016199,99.13867677
41405,遊戲類,1,611990,0.00016199,99.13883876
41406,遊盪,1,611991,0.00016199,99.13900075
41407,遊點,1,611992,0.00016199,99.13916275
41408,遊轉,1,611993,0.00016199,99.13932474
41409,道友,1,611994,0.00016199,99.13948674
41410,道亨,1,611995,0.00016199,99.13964873
41411,道格拉斯．凱諾,1,611996,0.00016199,99.13981073
41412,道斯,1,611997,0.00016199,99.13997272
41413,道義,1,611998,0.00016199,99.14013471
41414,道路系統,1,611999,0.00016199,99.14029671
41415,道德重整委員會,1,612000,0.00016199,99.14045870
41416,道德與健康,1,612001,0.00016199,99.14062070
41417,道瓊指數,1,612002,0.00016199,99.14078269
41418,道聽途說,1,612003,0.00016199,99.14094469
41419,達文法師,1,612004,0.00016199,99.14110668
41420,達令哈斯特,1,612005,0.00016199,99.14126867
41421,達卡,1,612006,0.00016199,99.14143067
41422,達成率,1,612007,0.00016199,99.14159266
41423,達里約鎮,1,612008,0.00016199,99.14175466
41424,達姆施塔特,1,612009,0.00016199,99.14191665
41425,達姆鼓,1,612010,0.00016199,99.14207864
41426,達官,1,612011,0.00016199,99.14224064
41427,達欣集團,1,612012,0.00016199,99.14240263
41428,達哈,1,612013,0.00016199,99.14256463
41429,達哈市,1,612014,0.00016199,99.14272662
41430,達美,1,612015,0.00016199,99.14288862
41431,達美樂,1,612016,0.00016199,99.14305061
41432,達梭公司,1,612017,0.00016199,99.14321260
41433,達福公司,1,612018,0.00016199,99.14337460
41434,達築物,1,612019,0.00016199,99.14353659
41435,達賴喇嘛,1,612020,0.00016199,99.14369859
41436,逼人,1,612021,0.00016199,99.14386058
41437,逼出,1,612022,0.00016199,99.14402258
41438,逼和,1,612023,0.00016199,99.14418457
41439,逼前,1,612024,0.00016199,99.14434656
41440,逼真度,1,612025,0.00016199,99.14450856
41441,違建,1,612026,0.00016199,99.14467055
41442,違約金,1,612027,0.00016199,99.14483255
41443,遐思,1,612028,0.00016199,99.14499454
41444,遐想,1,612029,0.00016199,99.14515653
41445,遇人不淑,1,612030,0.00016199,99.14531853
41446,遇險,1,612031,0.00016199,99.14548052
41447,遇襲,1,612032,0.00016199,99.14564252
41448,遏,1,612033,0.00016199,99.14580451
41449,遏制,1,612034,0.00016199,99.14596651
41450,過一會,1,612035,0.00016199,99.14612850
41451,過水,1,612036,0.00016199,99.14629049
41452,過半,1,612037,0.00016199,99.14645249
41453,過時,1,612038,0.00016199,99.14661448
41454,過氧化物,1,612039,0.00016199,99.14677648
41455,過敏免疫風濕科,1,612040,0.00016199,99.14693847
41456,過敏原,1,612041,0.00016199,99.14710047
41457,過敏症,1,612042,0.00016199,99.14726246
41458,過勞死,1,612043,0.00016199,99.14742445
41459,過瘦,1,612044,0.00016199,99.14758645
41460,過橋費,1,612045,0.00016199,99.14774844
41461,過錯,1,612046,0.00016199,99.14791044
41462,過濾水,1,612047,0.00016199,99.14807243
41463,過濾劑,1,612048,0.00016199,99.14823443
41464,過關斬將,1,612049,0.00016199,99.14839642
41465,遍地,1,612050,0.00016199,99.14855841
41466,遍行,1,612051,0.00016199,99.14872041
41467,遍訪,1,612052,0.00016199,99.14888240
41468,遍植,1,612053,0.00016199,99.14904440
41469,遑,1,612054,0.00016199,99.14920639
41470,遁隱,1,612055,0.00016199,99.14936838
41471,鄒國蘇,1,612056,0.00016199,99.14953038
41472,鄒像,1,612057,0.00016199,99.14969237
41473,酬報,1,612058,0.00016199,99.14985437
41474,酪脂豆,1,612059,0.00016199,99.15001636
41475,鈷,1,612060,0.00016199,99.15017836
41476,鈷鋼,1,612061,0.00016199,99.15034035
41477,鉗夾,1,612062,0.00016199,99.15050234
41478,鉛同位素則量法,1,612063,0.00016199,99.15066434
41479,鉛含量,1,612064,0.00016199,99.15082633
41480,鉛筆心,1,612065,0.00016199,99.15098833
41481,鉛線,1,612066,0.00016199,99.15115032
41482,鉛錫,1,612067,0.00016199,99.15131232
41483,鉋齒刀,1,612068,0.00016199,99.15147431
41484,鉤,1,612069,0.00016199,99.15163630
41485,鉤環機,1,612070,0.00016199,99.15179830
41486,鉤蟲病,1,612071,0.00016199,99.15196029
41487,鉑,1,612072,0.00016199,99.15212229
41488,鈴,1,612073,0.00016199,99.15228428
41489,鈴木超級金吉星,1,612074,0.00016199,99.15244627
41490,鈴鹿玉鈴,1,612075,0.00016199,99.15260827
41491,鉅作,1,612076,0.00016199,99.15277026
41492,鉅資,1,612077,0.00016199,99.15293226
41493,鉅變,1,612078,0.00016199,99.15309425
41494,鉚卯釘機,1,612079,0.00016199,99.15325625
41495,閘門,1,612080,0.00016199,99.15341824
41496,隘,1,612081,0.00016199,99.15358023
41497,隔成,1,612082,0.00016199,99.15374223
41498,隔板,1,612083,0.00016199,99.15390422
41499,隔空,1,612084,0.00016199,99.15406622
41500,隔阻,1,612085,0.00016199,99.15422821
41501,隔絕起來,1,612086,0.00016199,99.15439021
41502,隔閡,1,612087,0.00016199,99.15455220
41503,隔熱板,1,612088,0.00016199,99.15471419
41504,隔熱紙,1,612089,0.00016199,99.15487619
41505,隔膜,1,612090,0.00016199,99.15503818
41506,隔艙,1,612091,0.00016199,99.15520018
41507,隕石區,1,612092,0.00016199,99.15536217
41508,隕落,1,612093,0.00016199,99.15552416
41509,雍正,1,612094,0.00016199,99.15568616
41510,雍容,1,612095,0.00016199,99.15584815
41511,雍容華貴,1,612096,0.00016199,99.15601015
41512,雍塞,1,612097,0.00016199,99.15617214
41513,雷．庫克,1,612098,0.00016199,99.15633414
41514,雷公,1,612099,0.00016199,99.15649613
41515,雷化民,1,612100,0.00016199,99.15665812
41516,雷伯龍,1,612101,0.00016199,99.15682012
41517,雷奈,1,612102,0.00016199,99.15698211
41518,雷射刀,1,612103,0.00016199,99.15714411
41519,雷射束,1,612104,0.00016199,99.15730610
41520,雷峰塔,1,612105,0.00016199,99.15746810
41521,雷根,1,612106,0.00016199,99.15763009
41522,雷陣雨,1,612107,0.00016199,99.15779208
41523,雷登,1,612108,0.00016199,99.15795408
41524,雷達站,1,612109,0.00016199,99.15811607
41525,雷電柱,1,612110,0.00016199,99.15827807
41526,雷蒙．穆帝,1,612111,0.00016199,99.15844006
41527,雷鳴,1,612112,0.00016199,99.15860205
41528,雷厲風行,1,612113,0.00016199,99.15876405
41529,雷德,1,612114,0.00016199,99.15892604
41530,雷諾瓦,1,612115,0.00016199,99.15908804
41531,雷諾車廠,1,612116,0.00016199,99.15925003
41532,電子市場,1,612117,0.00016199,99.15941203
41533,電子所所長,1,612118,0.00016199,99.15957402
41534,電子所副所長,1,612119,0.00016199,99.15973601
41535,電子計分板,1,612120,0.00016199,99.15989801
41536,電子時代,1,612121,0.00016199,99.16006000
41537,電子媒體,1,612122,0.00016199,99.16022200
41538,電子業者,1,612123,0.00016199,99.16038399
41539,電子零件,1,612124,0.00016199,99.16054599
41540,電子銀行,1,612125,0.00016199,99.16070798
41541,電子戰,1,612126,0.00016199,99.16086997
41542,電木機,1,612127,0.00016199,99.16103197
41543,電貝斯,1,612128,0.00016199,99.16119396
41544,電車,1,612129,0.00016199,99.16135596
41545,電刮刀,1,612130,0.00016199,99.16151795
41546,電波媒體,1,612131,0.00016199,99.16167994
41547,電泡,1,612132,0.00016199,99.16184194
41548,電玩店,1,612133,0.00016199,99.16200393
41549,電阻值,1,612134,0.00016199,99.16216593
41550,電信局數據所,1,612135,0.00016199,99.16232792
41551,電信法規,1,612136,0.00016199,99.16248992
41552,電信埠,1,612137,0.00016199,99.16265191
41553,電信業,1,612138,0.00016199,99.16281390
41554,電洽,1,612139,0.00016199,99.16297590
41555,電風扇,1,612140,0.00016199,99.16313789
41556,電容,1,612141,0.00016199,99.16329989
41557,電容來,1,612142,0.00016199,99.16346188
41558,電氣,1,612143,0.00016199,99.16362388
41559,電動刮鬍刀,1,612144,0.00016199,99.16378587
41560,電動玩具,1,612145,0.00016199,99.16394786
41561,電動玩具店,1,612146,0.00016199,99.16410986
41562,電動機車,1,612147,0.00016199,99.16427185
41563,電焊,1,612148,0.00016199,99.16443385
41564,電荷,1,612149,0.00016199,99.16459584
41565,電通,1,612150,0.00016199,99.16475783
41566,電通所,1,612151,0.00016199,99.16491983
41567,電通所長,1,612152,0.00016199,99.16508182
41568,電通報,1,612153,0.00016199,99.16524382
41569,電晶體,1,612154,0.00016199,99.16540581
41570,電視公司,1,612155,0.00016199,99.16556781
41571,電視片,1,612156,0.00016199,99.16572980
41572,電視企業公司,1,612157,0.00016199,99.16589179
41573,電視迷,1,612158,0.00016199,99.16605379
41574,電視辯論會,1,612159,0.00016199,99.16621578
41575,電匯,1,612160,0.00016199,99.16637778
41576,電感,1,612161,0.00016199,99.16653977
41577,電腦工程師,1,612162,0.00016199,99.16670177
41578,電腦公司,1,612163,0.00016199,99.16686376
41579,電腦公會理事長,1,612164,0.00016199,99.16702575
41580,電腦百貨公司,1,612165,0.00016199,99.16718775
41581,電腦室,1,612166,0.00016199,99.16734974
41582,電腦界,1,612167,0.00016199,99.16751174
41583,電腦班,1,612168,0.00016199,99.16767373
41584,電腦動畫人員,1,612169,0.00016199,99.16783572
41585,電腦晶片,1,612170,0.00016199,99.16799772
41586,電腦業者,1,612171,0.00016199,99.16815971
41587,電腦數值控制車床,1,612172,0.00016199,99.16832171
41588,電腦課,1,612173,0.00016199,99.16848370
41589,電腦養護所,1,612174,0.00016199,99.16864570
41590,電腦螢幕,1,612175,0.00016199,99.16880769
41591,電解池,1,612176,0.00016199,99.16896968
41592,電話筒,1,612177,0.00016199,99.16913168
41593,電話費,1,612178,0.00016199,99.16929367
41594,電話鈴,1,612179,0.00016199,99.16945567
41595,電話銀行語音服務系統,1,612180,0.00016199,99.16961766
41596,電話機,1,612181,0.00016199,99.16977966
41597,電塵,1,612182,0.00016199,99.16994165
41598,電算機,1,612183,0.00016199,99.17010364
41599,電影人,1,612184,0.00016199,99.17026564
41600,電影中心,1,612185,0.00016199,99.17042763
41601,電影公司,1,612186,0.00016199,99.17058963
41602,電影界,1,612187,0.00016199,99.17075162
41603,電影音樂發燒書,1,612188,0.00016199,99.17091361
41604,電影原聲帶,1,612189,0.00016199,99.17107561
41605,電影迷,1,612190,0.00016199,99.17123760
41606,電影類,1,612191,0.00016199,99.17139960
41607,電熨斗,1,612192,0.00016199,99.17156159
41608,電線桿,1,612193,0.00016199,99.17172359
41609,電線管,1,612194,0.00016199,99.17188558
41610,電線廠,1,612195,0.00016199,99.17204757
41611,電學,1,612196,0.00016199,99.17220957
41612,電機房,1,612197,0.00016199,99.17237156
41613,電燒灼刀,1,612198,0.00016199,99.17253356
41614,電擊,1,612199,0.00016199,99.17269555
41615,電檢制度,1,612200,0.00016199,99.17285755
41616,電療,1,612201,0.00016199,99.17301954
41617,電鍍,1,612202,0.00016199,99.17318153
41618,電鍋,1,612203,0.00016199,99.17334353
41619,電鬍刀,1,612204,0.00016199,99.17350552
41620,電纜業,1,612205,0.00016199,99.17366752
41621,電鑽,1,612206,0.00016199,99.17382951
41622,零汙點,1,612207,0.00016199,99.17399151
41623,零折扣,1,612208,0.00016199,99.17415350
41624,零和賽局,1,612209,0.00016199,99.17431549
41625,零食,1,612210,0.00016199,99.17447749
41626,零缺點,1,612211,0.00016199,99.17463948
41627,零售工業,1,612212,0.00016199,99.17480148
41628,零售店,1,612213,0.00016199,99.17496347
41629,零散,1,612214,0.00016199,99.17512546
41630,零擔,1,612215,0.00016199,99.17528746
41631,零點,1,612216,0.00016199,99.17544945
41632,零點四,1,612217,0.00016199,99.17561145
41633,零點四二九,1,612218,0.00016199,99.17577344
41634,靖珩,1,612219,0.00016199,99.17593544
41635,靴子,1,612220,0.00016199,99.17609743
41636,預支,1,612221,0.00016199,99.17625942
41637,預付款,1,612222,0.00016199,99.17642142
41638,預估價,1,612223,0.00016199,99.17658341
41639,預作,1,612224,0.00016199,99.17674541
41640,預判,1,612225,0.00016199,99.17690740
41641,預告片,1,612226,0.00016199,99.17706940
41642,預見,1,612227,0.00016199,99.17723139
41643,預防性,1,612228,0.00016199,99.17739338
41644,預拌混凝土,1,612229,0.00016199,99.17755538
41645,預閃測光,1,612230,0.00016199,99.17771737
41646,預設值,1,612231,0.00016199,99.17787937
41647,預測局,1,612232,0.00016199,99.17804136
41648,預測型,1,612233,0.00016199,99.17820335
41649,預程式,1,612234,0.00016199,99.17836535
41650,預視掣,1,612235,0.00016199,99.17852734
41651,預載線,1,612236,0.00016199,99.17868934
41652,預算委員會,1,612237,0.00016199,99.17885133
41653,預錄,1,612238,0.00016199,99.17901333
41654,預藏,1,612239,0.00016199,99.17917532
41655,頑皮,1,612240,0.00016199,99.17933731
41656,頑皮炸彈,1,612241,0.00016199,99.17949931
41657,頑強,1,612242,0.00016199,99.17966130
41658,頓悟,1,612243,0.00016199,99.17982330
41659,頒獎典禮,1,612244,0.00016199,99.17998529
41660,頒贈,1,612245,0.00016199,99.18014729
41661,頌經,1,612246,0.00016199,99.18030928
41662,飼,1,612247,0.00016199,99.18047127
41663,飼料奶粉,1,612248,0.00016199,99.18063327
41664,飼鳥,1,612249,0.00016199,99.18079526
41665,飼養所,1,612250,0.00016199,99.18095726
41666,飽嚐,1,612251,0.00016199,99.18111925
41667,飾片,1,612252,0.00016199,99.18128124
41668,飾物,1,612253,0.00016199,99.18144324
41669,飾管,1,612254,0.00016199,99.18160523
41670,馴鹿,1,612255,0.00016199,99.18176723
41671,馴鷹,1,612256,0.00016199,99.18192922
41672,馴鷹師,1,612257,0.00016199,99.18209122
41673,鳩,1,612258,0.00016199,99.18225321
41674,鼎力,1,612259,0.00016199,99.18241520
41675,鼎力支援,1,612260,0.00016199,99.18257720
41676,鼎足而立,1,612261,0.00016199,99.18273919
41677,鼎昌公司,1,612262,0.00016199,99.18290119
41678,鼎康證券投顧公司,1,612263,0.00016199,99.18306318
41679,鼎營,1,612264,0.00016199,99.18322518
41680,鼓皮,1,612265,0.00016199,99.18338717
41681,鼓掌,1,612266,0.00016199,99.18354916
41682,鼓脹,1,612267,0.00016199,99.18371116
41683,鼠年,1,612268,0.00016199,99.18387315
41684,僧,1,612269,0.00016199,99.18403515
41685,僧多粥少,1,612270,0.00016199,99.18419714
41686,僥倖,1,612271,0.00016199,99.18435913
41687,僕僕,1,612272,0.00016199,99.18452113
41688,像差,1,612273,0.00016199,99.18468312
41689,像素,1,612274,0.00016199,99.18484512
41690,僑委會,1,612275,0.00016199,99.18500711
41691,僑威,1,612276,0.00016199,99.18516911
41692,僑威機械公司,1,612277,0.00016199,99.18533110
41693,僑界,1,612278,0.00016199,99.18549309
41694,僑泰,1,612279,0.00016199,99.18565509
41695,僑隆建設,1,612280,0.00016199,99.18581708
41696,僑銀股票,1,612281,0.00016199,99.18597908
41697,僱,1,612282,0.00016199,99.18614107
41698,僱用,1,612283,0.00016199,99.18630307
41699,僱佣,1,612284,0.00016199,99.18646506
41700,劃上,1,612285,0.00016199,99.18662705
41701,劃撥單,1,612286,0.00016199,99.18678905
41702,劃線,1,612287,0.00016199,99.18695104
41703,劃歸,1,612288,0.00016199,99.18711304
41704,厭,1,612289,0.00016199,99.18727503
41705,厭食,1,612290,0.00016199,99.18743702
41706,嘔吐型,1,612291,0.00016199,99.18759902
41707,嘉,1,612292,0.00016199,99.18776101
41708,嘉士伯啤酒,1,612293,0.00016199,99.18792301
41709,嘉禾,1,612294,0.00016199,99.18808500
41710,嘉年華,1,612295,0.00016199,99.18824700
41711,嘉年華大飯店,1,612296,0.00016199,99.18840899
41712,嘉年華大樓,1,612297,0.00016199,99.18857098
41713,嘉勉,1,612298,0.00016199,99.18873298
41714,嘉南地區,1,612299,0.00016199,99.18889497
41715,嘉峪關,1,612300,0.00016199,99.18905697
41716,嘉益,1,612301,0.00016199,99.18921896
41717,嘉連營造,1,612302,0.00016199,99.18938096
41718,嘉義交流道,1,612303,0.00016199,99.18954295
41719,嘉義縣市,1,612304,0.00016199,99.18970494
41720,嘉義縣長,1,612305,0.00016199,99.18986694
41721,嘉義縣黨部,1,612306,0.00016199,99.19002893
41722,嘉義鋼鐵股份有限公司,1,612307,0.00016199,99.19019093
41723,嘉榮科技,1,612308,0.00016199,99.19035292
41724,嘉賓,1,612309,0.00016199,99.19051491
41725,嘉賓廳,1,612310,0.00016199,99.19067691
41726,嘉慶十六年,1,612311,0.00016199,99.19083890
41727,嘉興,1,612312,0.00016199,99.19100090
41728,嘉寶瓜,1,612313,0.00016199,99.19116289
41729,嘉譽,1,612314,0.00016199,99.19132489
41730,嘎,1,612315,0.00016199,99.19148688
41731,嘖嘖,1,612316,0.00016199,99.19164887
41732,嘖嘖稱奇,1,612317,0.00016199,99.19181087
41733,團址,1,612318,0.00016199,99.19197286
41734,團結權,1,612319,0.00016199,99.19213486
41735,團隊合作,1,612320,0.00016199,99.19229685
41736,圖二,1,612321,0.00016199,99.19245885
41737,圖片集,1,612322,0.00016199,99.19262084
41738,圖示,1,612323,0.00016199,99.19278283
41739,圖形介面,1,612324,0.00016199,99.19294483
41740,圖形式,1,612325,0.00016199,99.19310682
41741,圖形庫,1,612326,0.00016199,99.19326882
41742,圖治,1,612327,0.00016199,99.19343081
41743,圖面,1,612328,0.00016199,99.19359280
41744,圖庫,1,612329,0.00016199,99.19375480
41745,圖框,1,612330,0.00016199,99.19391679
41746,圖素,1,612331,0.00016199,99.19407879
41747,圖畫性,1,612332,0.00016199,99.19424078
41748,圖像化,1,612333,0.00016199,99.19440278
41749,圖賓根,1,612334,0.00016199,99.19456477
41750,圖層,1,612335,0.00016199,99.19472676
41751,圖稿,1,612336,0.00016199,99.19488876
41752,圖謀,1,612337,0.00016199,99.19505075
41753,圖檔,1,612338,0.00016199,99.19521275
41754,圖繪性,1,612339,0.00016199,99.19537474
41755,塵土,1,612340,0.00016199,99.19553674
41756,塵世,1,612341,0.00016199,99.19569873
41757,塵俗,1,612342,0.00016199,99.19586072
41758,塵埃,1,612343,0.00016199,99.19602272
41759,塵埃落定,1,612344,0.00016199,99.19618471
41760,境外,1,612345,0.00016199,99.19634671
41761,境外企業,1,612346,0.00016199,99.19650870
41762,境外特區,1,612347,0.00016199,99.19667069
41763,境外轉運中心,1,612348,0.00016199,99.19683269
41764,墓園,1,612349,0.00016199,99.19699468
41765,墓碑,1,612350,0.00016199,99.19715668
41766,壽星,1,612351,0.00016199,99.19731867
41767,壽誕,1,612352,0.00016199,99.19748067
41768,夥計,1,612353,0.00016199,99.19764266
41769,夢工廠,1,612354,0.00016199,99.19780465
41770,夢寐以求,1,612355,0.00016199,99.19796665
41771,奪下,1,612356,0.00016199,99.19812864
41772,奪去,1,612357,0.00016199,99.19829064
41773,奪目,1,612358,0.00016199,99.19845263
41774,奪走,1,612359,0.00016199,99.19861463
41775,奪取,1,612360,0.00016199,99.19877662
41776,奪門,1,612361,0.00016199,99.19893861
41777,奪牌,1,612362,0.00016199,99.19910061
41778,奪權,1,612363,0.00016199,99.19926260
41779,嫩白,1,612364,0.00016199,99.19942460
41780,嫩刺,1,612365,0.00016199,99.19958659
41781,嫩果,1,612366,0.00016199,99.19974858
41782,嫩枝,1,612367,0.00016199,99.19991058
41783,嫩芽,1,612368,0.00016199,99.20007257
41784,嫩葉,1,612369,0.00016199,99.20023457
41785,嫩綠色,1,612370,0.00016199,99.20039656
41786,孵卵巢,1,612371,0.00016199,99.20055856
41787,寞,1,612372,0.00016199,99.20072055
41788,寧可,1,612373,0.00016199,99.20088254
41789,寧波,1,612374,0.00016199,99.20104454
41790,寧為玉碎,1,612375,0.00016199,99.20120653
41791,寧神,1,612376,0.00016199,99.20136853
41792,寡欲,1,612377,0.00016199,99.20153052
41793,寡慾,1,612378,0.00016199,99.20169252
41794,實力派,1,612379,0.00016199,99.20185451
41795,實地考察,1,612380,0.00016199,99.20201650
41796,實收資本額,1,612381,0.00016199,99.20217850
41797,實行家,1,612382,0.00016199,99.20234049
41798,實兵,1,612383,0.00016199,99.20250249
41799,實言,1,612384,0.00016199,99.20266448
41800,實足,1,612385,0.00016199,99.20282648
41801,實法,1,612386,0.00016199,99.20298847
41802,實是,1,612387,0.00016199,99.20315046
41803,實穿,1,612388,0.00016199,99.20331246
41804,實料,1,612389,0.00016199,99.20347445
41805,實務界,1,612390,0.00016199,99.20363645
41806,實景,1,612391,0.00016199,99.20379844
41807,實測,1,612392,0.00016199,99.20396043
41808,實測篇,1,612393,0.00016199,99.20412243
41809,實像式,1,612394,0.00016199,99.20428442
41810,實境,1,612395,0.00016199,99.20444642
41811,實實在在,1,612396,0.00016199,99.20460841
41812,實質面,1,612397,0.00016199,99.20477041
41813,實踐者,1,612398,0.00016199,99.20493240
41814,實踐學院,1,612399,0.00016199,99.20509439
41815,實屬難得,1,612400,0.00016199,99.20525639
41816,實權,1,612401,0.00016199,99.20541838
41817,實驗鼠,1,612402,0.00016199,99.20558038
41818,實驗劇場,1,612403,0.00016199,99.20574237
41819,寢,1,612404,0.00016199,99.20590437
41820,寢具,1,612405,0.00016199,99.20606636
41821,寢室家具,1,612406,0.00016199,99.20622835
41822,寢眠,1,612407,0.00016199,99.20639035
41823,察知,1,612408,0.00016199,99.20655234
41824,察看,1,612409,0.00016199,99.20671434
41825,察顏觀色,1,612410,0.00016199,99.20687633
41826,對口,1,612411,0.00016199,99.20703832
41827,對子,1,612412,0.00016199,99.20720032
41828,對中華民國,1,612413,0.00016199,99.20736231
41829,對台,1,612414,0.00016199,99.20752431
41830,對台策略,1,612415,0.00016199,99.20768630
41831,對地,1,612416,0.00016199,99.20784830
41832,對決,1,612417,0.00016199,99.20801029
41833,對味,1,612418,0.00016199,99.20817228
41834,對勁,1,612419,0.00016199,99.20833428
41835,對映,1,612420,0.00016199,99.20849627
41836,對映站,1,612421,0.00016199,99.20865827
41837,對美,1,612422,0.00016199,99.20882026
41838,對陣,1,612423,0.00016199,99.20898226
41839,對馬海峽,1,612424,0.00016199,99.20914425
41840,對焦轉盤,1,612425,0.00016199,99.20930624
41841,對視,1,612426,0.00016199,99.20946824
41842,對稱,1,612427,0.00016199,99.20963023
41843,對嘴,1,612428,0.00016199,99.20979223
41844,對質,1,612429,0.00016199,99.20995422
41845,對講機,1,612430,0.00016199,99.21011621
41846,對壘,1,612431,0.00016199,99.21027821
41847,對禮,1,612432,0.00016199,99.21044020
41848,屢屢,1,612433,0.00016199,99.21060220
41849,嶄,1,612434,0.00016199,99.21076419
41850,幕前,1,612435,0.00016199,99.21092619
41851,幕僚長,1,612436,0.00016199,99.21108818
41852,幕幕,1,612437,0.00016199,99.21125017
41853,幕幔,1,612438,0.00016199,99.21141217
41854,廖如陽,1,612439,0.00016199,99.21157416
41855,廖良意,1,612440,0.00016199,99.21173616
41856,廖和璧,1,612441,0.00016199,99.21189815
41857,廖泉裕,1,612442,0.00016199,99.21206015
41858,廖婉汝,1,612443,0.00016199,99.21222214
41859,廖清碧,1,612444,0.00016199,99.21238413
41860,廖雅欣,1,612445,0.00016199,99.21254613
41861,廖雲宏,1,612446,0.00016199,99.21270812
41862,廖嘉展,1,612447,0.00016199,99.21287012
41863,廖福澤,1,612448,0.00016199,99.21303211
41864,廖震乾,1,612449,0.00016199,99.21319410
41865,弊病,1,612450,0.00016199,99.21335610
41866,彆忸,1,612451,0.00016199,99.21351809
41867,彰化交流道,1,612452,0.00016199,99.21368009
41868,彰化區,1,612453,0.00016199,99.21384208
41869,彰州電廠,1,612454,0.00016199,99.21400408
41870,彰濱,1,612455,0.00016199,99.21416607
41871,彰濱工業區,1,612456,0.00016199,99.21432806
41872,徹夜,1,612457,0.00016199,99.21449006
41873,徹夜長談,1,612458,0.00016199,99.21465205
41874,慷,1,612459,0.00016199,99.21481405
41875,慷慨激昂,1,612460,0.00016199,99.21497604
41876,慢半拍,1,612461,0.00016199,99.21513804
41877,慢步,1,612462,0.00016199,99.21530003
41878,慢性重金屬中毒,1,612463,0.00016199,99.21546202
41879,慢性疾病,1,612464,0.00016199,99.21562402
41880,慢條斯理,1,612465,0.00016199,99.21578601
41881,慢速,1,612466,0.00016199,99.21594801
41882,慣竊,1,612467,0.00016199,99.21611000
41883,慚愧,1,612468,0.00016199,99.21627199
41884,慘兮兮,1,612469,0.00016199,99.21643399
41885,慘白,1,612470,0.00016199,99.21659598
41886,慘白感,1,612471,0.00016199,99.21675798
41887,慘況,1,612472,0.00016199,99.21691997
41888,慘狀,1,612473,0.00016199,99.21708197
41889,慘敗,1,612474,0.00016199,99.21724396
41890,慘淡,1,612475,0.00016199,99.21740595
41891,慘痛,1,612476,0.00016199,99.21756795
41892,慘絕,1,612477,0.00016199,99.21772994
41893,慘絕人寰,1,612478,0.00016199,99.21789194
41894,慘澹,1,612479,0.00016199,99.21805393
41895,慵懶,1,612480,0.00016199,99.21821593
41896,截取,1,612481,0.00016199,99.21837792
41897,截肢,1,612482,0.00016199,99.21853991
41898,截短,1,612483,0.00016199,99.21870191
41899,截稿,1,612484,0.00016199,99.21886390
41900,截斷,1,612485,0.00016199,99.21902590
41901,截彎取直,1,612486,0.00016199,99.21918789
41902,撇扭,1,612487,0.00016199,99.21934988
41903,撇清,1,612488,0.00016199,99.21951188
41904,撇纜槍,1,612489,0.00016199,99.21967387
41905,摘下,1,612490,0.00016199,99.21983587
41906,摘取,1,612491,0.00016199,99.21999786
41907,摘果,1,612492,0.00016199,99.22015986
41908,摘錄,1,612493,0.00016199,99.22032185
41909,摘籃,1,612494,0.00016199,99.22048384
41910,摔角,1,612495,0.00016199,99.22064584
41911,撤回,1,612496,0.00016199,99.22080783
41912,撤廢,1,612497,0.00016199,99.22096983
41913,撤銷訴權,1,612498,0.00016199,99.22113182
41914,撤銷權,1,612499,0.00016199,99.22129382
41915,摸不清,1,612500,0.00016199,99.22145581
41916,摸摸頭,1,612501,0.00016199,99.22161780
41917,摸擬,1,612502,0.00016199,99.22177980
41918,摟,1,612503,0.00016199,99.22194179
41919,摺,1,612504,0.00016199,99.22210379
41920,摺頁,1,612505,0.00016199,99.22226578
41921,摺疊式,1,612506,0.00016199,99.22242777
41922,摑,1,612507,0.00016199,99.22258977
41923,摧,1,612508,0.00016199,99.22275176
41924,摻,1,612509,0.00016199,99.22291376
41925,摻入,1,612510,0.00016199,99.22307575
41926,敲竹槓,1,612511,0.00016199,99.22323775
41927,敲缸,1,612512,0.00016199,99.22339974
41928,敲訂,1,612513,0.00016199,99.22356173
41929,敲擊樂,1,612514,0.00016199,99.22372373
41930,敲響,1,612515,0.00016199,99.22388572
41931,敲鑼打鼓,1,612516,0.00016199,99.22404772
41932,斡旋,1,612517,0.00016199,99.22420971
41933,旗子,1,612518,0.00016199,99.22437171
41934,旗山醫院,1,612519,0.00016199,99.22453370
41935,旗山鎮,1,612520,0.00016199,99.22469569
41936,旗號,1,612521,0.00016199,99.22485769
41937,旗鼓,1,612522,0.00016199,99.22501968
41938,旗鑑,1,612523,0.00016199,99.22518168
41939,旖旎,1,612524,0.00016199,99.22534367
41940,暢快,1,612525,0.00016199,99.22550566
41941,暢游,1,612526,0.00016199,99.22566766
41942,暨南,1,612527,0.00016199,99.22582965
41943,榨出,1,612528,0.00016199,99.22599165
41944,榕樹鬚,1,612529,0.00016199,99.22615364
41945,榕鬚,1,612530,0.00016199,99.22631564
41946,榮工系統,1,612531,0.00016199,99.22647763
41947,榮工處,1,612532,0.00016199,99.22663962
41948,榮民之家,1,612533,0.00016199,99.22680162
41949,榮民總醫院,1,612534,0.00016199,99.22696361
41950,榮任,1,612535,0.00016199,99.22712561
41951,榮剛,1,612536,0.00016199,99.22728760
41952,榮智健,1,612537,0.00016199,99.22744960
41953,榮華,1,612538,0.00016199,99.22761159
41954,榮電,1,612539,0.00016199,99.22777358
41955,榮麗珍,1,612540,0.00016199,99.22793558
41956,榮譽虎旗,1,612541,0.00016199,99.22809757
41957,榮譽演員獎,1,612542,0.00016199,99.22825957
41958,榮譽獎,1,612543,0.00016199,99.22842156
41959,構型,1,612544,0.00016199,99.22858355
41960,構建,1,612545,0.00016199,99.22874555
41961,構想者,1,612546,0.00016199,99.22890754
41962,榴花,1,612547,0.00016199,99.22906954
41963,榴彈發射器,1,612548,0.00016199,99.22923153
41964,槍托,1,612549,0.00016199,99.22939353
41965,槍身,1,612550,0.00016199,99.22955552
41966,槍砲彈藥管制條例,1,612551,0.00016199,99.22971751
41967,槍桿,1,612552,0.00016199,99.22987951
41968,槍械,1,612553,0.00016199,99.23004150
41969,槍眼,1,612554,0.00016199,99.23020350
41970,槍傷,1,612555,0.00016199,99.23036549
41971,槍戰,1,612556,0.00016199,99.23052749
41972,槍頭,1,612557,0.00016199,99.23068948
41973,槍擊,1,612558,0.00016199,99.23085147
41974,槍擊案,1,612559,0.00016199,99.23101347
41975,歉,1,612560,0.00016199,99.23117546
41976,歉疚,1,612561,0.00016199,99.23133746
41977,歉意,1,612562,0.00016199,99.23149945
41978,歌友,1,612563,0.00016199,99.23166145
41979,歌友會,1,612564,0.00016199,99.23182344
41980,歌仔戲,1,612565,0.00016199,99.23198543
41981,歌仔戲壇,1,612566,0.00016199,99.23214743
41982,歌玲娜西侯,1,612567,0.00016199,99.23230942
41983,歌神,1,612568,0.00016199,99.23247142
41984,歌喉,1,612569,0.00016199,99.23263341
41985,歌蒂韓,1,612570,0.00016199,99.23279540
41986,歌劇史,1,612571,0.00016199,99.23295740
41987,歌劇界,1,612572,0.00016199,99.23311939
41988,歌德式,1,612573,0.00016199,99.23328139
41989,歌樂界,1,612574,0.00016199,99.23344338
41990,歌壇,1,612575,0.00016199,99.23360538
41991,漳,1,612576,0.00016199,99.23376737
41992,漳州,1,612577,0.00016199,99.23392936
41993,漳樹灣,1,612578,0.00016199,99.23409136
41994,演奏員,1,612579,0.00016199,99.23425335
41995,演奏區,1,612580,0.00016199,99.23441535
41996,演奏會,1,612581,0.00016199,99.23457734
41997,演訓,1,612582,0.00016199,99.23473934
41998,演唱者,1,612583,0.00016199,99.23490133
41999,演習區,1,612584,0.00016199,99.23506332
42000,演發,1,612585,0.00016199,99.23522532
42001,演算,1,612586,0.00016199,99.23538731
42002,演講社,1,612587,0.00016199,99.23554931
42003,演講者,1,612588,0.00016199,99.23571130
42004,演講會,1,612589,0.00016199,99.23587329
42005,演講稿,1,612590,0.00016199,99.23603529
42006,演講廳,1,612591,0.00016199,99.23619728
42007,滾水,1,612592,0.00016199,99.23635928
42008,滾流,1,612593,0.00016199,99.23652127
42009,滾球,1,612594,0.00016199,99.23668327
42010,滾雪球,1,612595,0.00016199,99.23684526
42011,滾輪,1,612596,0.00016199,99.23700725
42012,滾騰騰,1,612597,0.00016199,99.23716925
42013,滴落,1,612598,0.00016199,99.23733124
42014,滴滴答答,1,612599,0.00016199,99.23749324
42015,滴管,1,612600,0.00016199,99.23765523
42016,漠不關心,1,612601,0.00016199,99.23781723
42017,漬痕,1,612602,0.00016199,99.23797922
42018,漏掉,1,612603,0.00016199,99.23814121
42019,漏網之魚,1,612604,0.00016199,99.23830321
42020,漂不漂,1,612605,0.00016199,99.23846520
42021,漂白劑,1,612606,0.00016199,99.23862720
42022,漢口,1,612607,0.00016199,99.23878919
42023,漢口道,1,612608,0.00016199,99.23895118
42024,漢文,1,612609,0.00016199,99.23911318
42025,漢光,1,612610,0.00016199,99.23927517
42026,漢來,1,612611,0.00016199,99.23943717
42027,漢來飯店,1,612612,0.00016199,99.23959916
42028,漢界,1,612613,0.00016199,99.23976116
42029,漢唐樂府藝術中心,1,612614,0.00016199,99.23992315
42030,漢娜姊妹,1,612615,0.00016199,99.24008514
42031,漢神,1,612616,0.00016199,99.24024714
42032,漢神百貨,1,612617,0.00016199,99.24040913
42033,漢級核動力潛艦,1,612618,0.00016199,99.24057113
42034,漢族,1,612619,0.00016199,99.24073312
42035,漢斯,1,612620,0.00016199,99.24089512
42036,漢朝,1,612621,0.00016199,99.24105711
42037,漢翔公司,1,612622,0.00016199,99.24121910
42038,漢翔公司設置條例修正案,1,612623,0.00016199,99.24138110
42039,漢翔航空工業股份有限公司,1,612624,0.00016199,99.24154309
42040,漢華銀行,1,612625,0.00016199,99.24170509
42041,漢語,1,612626,0.00016199,99.24186708
42042,漢彌頓,1,612627,0.00016199,99.24202907
42043,漢聲精選小小目擊者叢書,1,612628,0.00016199,99.24219107
42044,漢聲精選幼兒認知成長叢書—貼紙遊戲簿,1,612629,0.00016199,99.24235306
42045,漢聲精選青少年姆指文庫,1,612630,0.00016199,99.24251506
42046,漢聲精選圖畫書,1,612631,0.00016199,99.24267705
42047,漢聲雜誌社,1,612632,0.00016199,99.24283905
42048,漢寶,1,612633,0.00016199,99.24300104
42049,漢寶德,1,612634,0.00016199,99.24316303
42050,滿山,1,612635,0.00016199,99.24332503
42051,滿山滿谷,1,612636,0.00016199,99.24348702
42052,滿分,1,612637,0.00016199,99.24364902
42053,滿天,1,612638,0.00016199,99.24381101
42054,滿月,1,612639,0.00016199,99.24397301
42055,滿地,1,612640,0.00016199,99.24413500
42056,滿好,1,612641,0.00016199,99.24429699
42057,滿州鄉,1,612642,0.00016199,99.24445899
42058,滿佐料亭,1,612643,0.00016199,99.24462098
42059,滿坑滿谷,1,612644,0.00016199,99.24478298
42060,滿足感,1,612645,0.00016199,99.24494497
42061,滿城風暴,1,612646,0.00016199,99.24510696
42062,滿是,1,612647,0.00016199,99.24526896
42063,滿街,1,612648,0.00016199,99.24543095
42064,滿腹,1,612649,0.00016199,99.24559295
42065,滿腹經綸,1,612650,0.00016199,99.24575494
42066,滿腦子,1,612651,0.00016199,99.24591694
42067,滿載而歸,1,612652,0.00016199,99.24607893
42068,滿臉,1,612653,0.00016199,99.24624092
42069,滿壘,1,612654,0.00016199,99.24640292
42070,滿懷壯志,1,612655,0.00016199,99.24656491
42071,漆器,1,612656,0.00016199,99.24672691
42072,漸次,1,612657,0.00016199,99.24688890
42073,漸進式,1,612658,0.00016199,99.24705090
42074,漲上去,1,612659,0.00016199,99.24721289
42075,漲大,1,612660,0.00016199,99.24737488
42076,漲停,1,612661,0.00016199,99.24753688
42077,漫天,1,612662,0.00016199,99.24769887
42078,漫流,1,612663,0.00016199,99.24786087
42079,漫畫便利屋,1,612664,0.00016199,99.24802286
42080,漫畫家,1,612665,0.00016199,99.24818485
42081,漫畫書,1,612666,0.00016199,99.24834685
42082,漫畫紙,1,612667,0.00016199,99.24850884
42083,漫畫迷,1,612668,0.00016199,99.24867084
42084,漫漫,1,612669,0.00016199,99.24883283
42085,漫談,1,612670,0.00016199,99.24899483
42086,漫壇,1,612671,0.00016199,99.24915682
42087,澈,1,612672,0.00016199,99.24931881
42088,澈底,1,612673,0.00016199,99.24948081
42089,漁夫,1,612674,0.00016199,99.24964280
42090,漁區,1,612675,0.00016199,99.24980480
42091,漁業技術團,1,612676,0.00016199,99.24996679
42092,漁網,1,612677,0.00016199,99.25012879
42093,漁撈,1,612678,0.00016199,99.25029078
42094,滲出,1,612679,0.00016199,99.25045277
42095,滲透力,1,612680,0.00016199,99.25061477
42096,滲透率,1,612681,0.00016199,99.25077676
42097,滷,1,612682,0.00016199,99.25093876
42098,滷水,1,612683,0.00016199,99.25110075
42099,滷蛋,1,612684,0.00016199,99.25126274
42100,滷豬腳,1,612685,0.00016199,99.25142474
42101,熔岩,1,612686,0.00016199,99.25158673
42102,熔岩量,1,612687,0.00016199,99.25174873
42103,熔原,1,612688,0.00016199,99.25191072
42104,熔解,1,612689,0.00016199,99.25207272
42105,熙來攘往,1,612690,0.00016199,99.25223471
42106,煽動性,1,612691,0.00016199,99.25239670
42107,熊迺康,1,612692,0.00016199,99.25255870
42108,熊貓族,1,612693,0.00016199,99.25272069
42109,爾後,1,612694,0.00016199,99.25288269
42110,爾虞我詐,1,612695,0.00016199,99.25304468
42111,獄,1,612696,0.00016199,99.25320668
42112,瑪尼,1,612697,0.00016199,99.25336867
42113,瑪利亞啟智學園,1,612698,0.00016199,99.25353066
42114,瑪姬史密斯,1,612699,0.00016199,99.25369266
42115,瑪格麗特．蜜雪兒,1,612700,0.00016199,99.25385465
42116,瑪琪琳,1,612701,0.00016199,99.25401665
42117,瑪瑞塔,1,612702,0.00016199,99.25417864
42118,瑪腦,1,612703,0.00016199,99.25434063
42119,瑪蒂,1,612704,0.00016199,99.25450263
42120,瑪嘉烈,1,612705,0.00016199,99.25466462
42121,瑪嘉烈莉,1,612706,0.00016199,99.25482662
42122,瑪歌基德,1,612707,0.00016199,99.25498861
42123,瑪麗吉蘭,1,612708,0.00016199,99.25515061
42124,瑪麗路易絲派克,1,612709,0.00016199,99.25531260
42125,瑪麗蓮,1,612710,0.00016199,99.25547459
42126,瑰寶,1,612711,0.00016199,99.25563659
42127,疑涉,1,612712,0.00016199,99.25579858
42128,疑神疑鬼,1,612713,0.00016199,99.25596058
42129,疑難,1,612714,0.00016199,99.25612257
42130,瘧疾,1,612715,0.00016199,99.25628457
42131,盡出,1,612716,0.00016199,99.25644656
42132,盡可能,1,612717,0.00016199,99.25660855
42133,盡如人意,1,612718,0.00016199,99.25677055
42134,盡責,1,612719,0.00016199,99.25693254
42135,盡善盡美,1,612720,0.00016199,99.25709454
42136,盡管,1,612721,0.00016199,99.25725653
42137,盡興,1,612722,0.00016199,99.25741853
42138,盡職,1,612723,0.00016199,99.25758052
42139,監交人,1,612724,0.00016199,99.25774251
42140,監事,1,612725,0.00016199,99.25790451
42141,監所,1,612726,0.00016199,99.25806650
42142,監理站,1,612727,0.00016199,99.25822850
42143,監票,1,612728,0.00016199,99.25839049
42144,監測中心,1,612729,0.00016199,99.25855248
42145,監測委員會,1,612730,0.00016199,99.25871448
42146,監禁,1,612731,0.00016199,99.25887647
42147,監察,1,612732,0.00016199,99.25903847
42148,監製,1,612733,0.00016199,99.25920046
42149,監聽,1,612734,0.00016199,99.25936246
42150,瞄準核子心,1,612735,0.00016199,99.25952445
42151,瞄準儀,1,612736,0.00016199,99.25968644
42152,睽違,1,612737,0.00016199,99.25984844
42153,睡袍,1,612738,0.00016199,99.26001043
42154,睡著,1,612739,0.00016199,99.26017243
42155,睡夢,1,612740,0.00016199,99.26033442
42156,睡蓮,1,612741,0.00016199,99.26049642
42157,睡醒,1,612742,0.00016199,99.26065841
42158,磁力,1,612743,0.00016199,99.26082040
42159,磁化,1,612744,0.00016199,99.26098240
42160,磁片廠,1,612745,0.00016199,99.26114439
42161,磁吸,1,612746,0.00016199,99.26130639
42162,磁波,1,612747,0.00016199,99.26146838
42163,磁浮車,1,612748,0.00016199,99.26163037
42164,磁鐵,1,612749,0.00016199,99.26179237
42165,碟子,1,612750,0.00016199,99.26195436
42166,碟煞,1,612751,0.00016199,99.26211636
42167,碧,1,612752,0.00016199,99.26227835
42168,碧海,1,612753,0.00016199,99.26244035
42169,碧草,1,612754,0.00016199,99.26260234
42170,碧湖,1,612755,0.00016199,99.26276433
42171,碧綠,1,612756,0.00016199,99.26292633
42172,碧翠絲,1,612757,0.00016199,99.26308832
42173,碧潭,1,612758,0.00016199,99.26325032
42174,碧藍,1,612759,0.00016199,99.26341231
42175,碳鋼,1,612760,0.00016199,99.26357431
42176,碩,1,612761,0.00016199,99.26373630
42177,碩果僅存,1,612762,0.00016199,99.26389829
42178,福山,1,612763,0.00016199,99.26406029
42179,福田,1,612764,0.00016199,99.26422228
42180,福田泰山,1,612765,0.00016199,99.26438428
42181,福吉特,1,612766,0.00016199,99.26454627
42182,福州燈,1,612767,0.00016199,99.26470826
42183,福克,1,612768,0.00016199,99.26487026
42184,福克斯,1,612769,0.00016199,99.26503225
42185,福克蘭戰役,1,612770,0.00016199,99.26519425
42186,福利制度,1,612771,0.00016199,99.26535624
42187,福岡市,1,612772,0.00016199,99.26551824
42188,福岡縣,1,612773,0.00016199,99.26568023
42189,福建土樓,1,612774,0.00016199,99.26584222
42190,福星小子,1,612775,0.00016199,99.26600422
42191,福氣,1,612776,0.00016199,99.26616621
42192,福特六和,1,612777,0.00016199,99.26632821
42193,福特六和汽車公司,1,612778,0.00016199,99.26649020
42194,福特汽車,1,612779,0.00016199,99.26665220
42195,福特嘉年華,1,612780,0.00016199,99.26681419
42196,福益紡織,1,612781,0.00016199,99.26697618
42197,福馬林液,1,612782,0.00016199,99.26713818
42198,福馬藥廠,1,612783,0.00016199,99.26730017
42199,福基金屬門窗精品展示中心,1,612784,0.00016199,99.26746217
42200,福崗,1,612785,0.00016199,99.26762416
42201,福斯車,1,612786,0.00016199,99.26778615
42202,福斯特,1,612787,0.00016199,99.26794815
42203,福壽,1,612788,0.00016199,99.26811014
42204,福爾號,1,612789,0.00016199,99.26827214
42205,福爾摩沙,1,612790,0.00016199,99.26843413
42206,福聚,1,612791,0.00016199,99.26859613
42207,福德一路,1,612792,0.00016199,99.26875812
42208,福興鄉,1,612793,0.00016199,99.26892011
42209,禍福,1,612794,0.00016199,99.26908211
42210,種下,1,612795,0.00016199,99.26924410
42211,種子部隊,1,612796,0.00016199,99.26940610
42212,種市,1,612797,0.00016199,99.26956809
42213,種姓制度,1,612798,0.00016199,99.26973009
42214,種籽,1,612799,0.00016199,99.26989208
42215,種茶,1,612800,0.00016199,99.27005407
42216,種族主義者,1,612801,0.00016199,99.27021607
42217,種族區,1,612802,0.00016199,99.27037806
42218,種族優秀論者,1,612803,0.00016199,99.27054006
42219,種薑,1,612804,0.00016199,99.27070205
42220,稱奇,1,612805,0.00016199,99.27086404
42221,稱做,1,612806,0.00016199,99.27102604
42222,稱揚,1,612807,0.00016199,99.27118803
42223,稱號,1,612808,0.00016199,99.27135003
42224,稱職,1,612809,0.00016199,99.27151202
42225,稱譽,1,612810,0.00016199,99.27167402
42226,窩巢,1,612811,0.00016199,99.27183601
42227,竭盡心力,1,612812,0.00016199,99.27199800
42228,端出,1,612813,0.00016199,99.27216000
42229,端正,1,612814,0.00016199,99.27232199
42230,端陽,1,612815,0.00016199,99.27248399
42231,管制區,1,612816,0.00016199,99.27264598
42232,管制點,1,612817,0.00016199,99.27280798
42233,管弦曲,1,612818,0.00016199,99.27296997
42234,管弦樂團,1,612819,0.00016199,99.27313196
42235,管理人員,1,612820,0.00016199,99.27329396
42236,管理化,1,612821,0.00016199,99.27345595
42237,管理局長,1,612822,0.00016199,99.27361795
42238,管理站,1,612823,0.00016199,99.27377994
42239,管理部,1,612824,0.00016199,99.27394193
42240,管理費,1,612825,0.00016199,99.27410393
42241,管理類,1,612826,0.00016199,99.27426592
42242,管絃樂團,1,612827,0.00016199,99.27442792
42243,管腔,1,612828,0.00016199,99.27458991
42244,管路,1,612829,0.00016199,99.27475191
42245,管樂,1,612830,0.00016199,99.27491390
42246,管銷,1,612831,0.00016199,99.27507589
42247,管機,1,612832,0.00016199,99.27523789
42248,算不上,1,612833,0.00016199,99.27539988
42249,算不得,1,612834,0.00016199,99.27556188
42250,算不算,1,612835,0.00016199,99.27572387
42251,算打,1,612836,0.00016199,99.27588587
42252,算起來,1,612837,0.00016199,99.27604786
42253,算帳,1,612838,0.00016199,99.27620985
42254,算數,1,612839,0.00016199,99.27637185
42255,箔片,1,612840,0.00016199,99.27653384
42256,箇中高手,1,612841,0.00016199,99.27669584
42257,粹,1,612842,0.00016199,99.27685783
42258,粹取,1,612843,0.00016199,99.27701982
42259,粹鍊,1,612844,0.00016199,99.27718182
42260,精力湯,1,612845,0.00016199,99.27734381
42261,精技,1,612846,0.00016199,99.27750581
42262,精技公司,1,612847,0.00016199,99.27766780
42263,精明一街,1,612848,0.00016199,99.27782980
42264,精品區,1,612849,0.00016199,99.27799179
42265,精悍,1,612850,0.00016199,99.27815378
42266,精神力,1,612851,0.00016199,99.27831578
42267,精神分裂症,1,612852,0.00016199,99.27847777
42268,精神化,1,612853,0.00016199,99.27863977
42269,精神病院,1,612854,0.00016199,99.27880176
42270,精神耗弱症,1,612855,0.00016199,99.27896376
42271,精神醫師,1,612856,0.00016199,99.27912575
42272,精細施工,1,612857,0.00016199,99.27928774
42273,精裁,1,612858,0.00016199,99.27944974
42274,精業公司,1,612859,0.00016199,99.27961173
42275,精煉,1,612860,0.00016199,99.27977373
42276,精裝,1,612861,0.00016199,99.27993572
42277,精裝車,1,612862,0.00016199,99.28009771
42278,精算,1,612863,0.00016199,99.28025971
42279,精製,1,612864,0.00016199,99.28042170
42280,精緻工業,1,612865,0.00016199,99.28058370
42281,精緻度,1,612866,0.00016199,99.28074569
42282,精銳,1,612867,0.00016199,99.28090769
42283,精機,1,612868,0.00016199,99.28106968
42284,精雕,1,612869,0.00016199,99.28123167
42285,精蟲,1,612870,0.00016199,99.28139367
42286,精靈也瘋狂,1,612871,0.00016199,99.28155566
42287,精胺酸,1,612872,0.00016199,99.28171766
42288,綻開,1,612873,0.00016199,99.28187965
42289,綜,1,612874,0.00016199,99.28204165
42290,綜合大樓,1,612875,0.00016199,99.28220364
42291,綜合休閒度假中心,1,612876,0.00016199,99.28236563
42292,綜合所得,1,612877,0.00016199,99.28252763
42293,綜合類,1,612878,0.00016199,99.28268962
42294,綜合體,1,612879,0.00016199,99.28285162
42295,綜所稅,1,612880,0.00016199,99.28301361
42296,綜藝大聯盟,1,612881,0.00016199,99.28317560
42297,綜藝報,1,612882,0.00016199,99.28333760
42298,綜覽,1,612883,0.00016199,99.28349959
42299,綽約,1,612884,0.00016199,99.28366159
42300,綽號,1,612885,0.00016199,99.28382358
42301,綽綽有餘,1,612886,0.00016199,99.28398558
42302,綠水,1,612887,0.00016199,99.28414757
42303,綠光劇團,1,612888,0.00016199,99.28430956
42304,綠色消費者委員會,1,612889,0.00016199,99.28447156
42305,綠松石行動,1,612890,0.00016199,99.28463355
42306,綠泥岩,1,612891,0.00016199,99.28479555
42307,綠花菜,1,612892,0.00016199,99.28495754
42308,綠柱石,1,612893,0.00016199,99.28511954
42309,綠基會,1,612894,0.00016199,99.28528153
42310,綠彩,1,612895,0.00016199,99.28544352
42311,綠意盎然,1,612896,0.00016199,99.28560552
42312,綠鈴子,1,612897,0.00016199,99.28576751
42313,綠樹成蔭,1,612898,0.00016199,99.28592951
42314,緊扣,1,612899,0.00016199,99.28609150
42315,緊夾,1,612900,0.00016199,99.28625350
42316,緊身衣,1,612901,0.00016199,99.28641549
42317,緊附,1,612902,0.00016199,99.28657748
42318,緊俏,1,612903,0.00016199,99.28673948
42319,緊咬,1,612904,0.00016199,99.28690147
42320,緊急零星工程款,1,612905,0.00016199,99.28706347
42321,緊急零星工程補助款,1,612906,0.00016199,99.28722546
42322,緊要,1,612907,0.00016199,99.28738745
42323,緊迫,1,612908,0.00016199,99.28754945
42324,緊張性,1,612909,0.00016199,99.28771144
42325,緊握,1,612910,0.00016199,99.28787344
42326,緊貼,1,612911,0.00016199,99.28803543
42327,緊實度,1,612912,0.00016199,99.28819743
42328,緊緊繃繃,1,612913,0.00016199,99.28835942
42329,緊靠,1,612914,0.00016199,99.28852141
42330,緊臨,1,612915,0.00016199,99.28868341
42331,綴飾,1,612916,0.00016199,99.28884540
42332,網子,1,612917,0.00016199,99.28900740
42333,網卡,1,612918,0.00016199,99.28916939
42334,網版印刷,1,612919,0.00016199,99.28933139
42335,網狀,1,612920,0.00016199,99.28949338
42336,網竿,1,612921,0.00016199,99.28965537
42337,網球鞋,1,612922,0.00016199,99.28981737
42338,網路卡,1,612923,0.00016199,99.28997936
42339,網路狂,1,612924,0.00016199,99.29014136
42340,網路咖啡廳,1,612925,0.00016199,99.29030335
42341,網路配接卡,1,612926,0.00016199,99.29046534
42342,網路通訊協定,1,612927,0.00016199,99.29062734
42343,網路連線程式,1,612928,0.00016199,99.29078933
42344,網路概念股,1,612929,0.00016199,99.29095133
42345,網路癮,1,612930,0.00016199,99.29111332
42346,網際,1,612931,0.00016199,99.29127532
42347,網際遊龍,1,612932,0.00016199,99.29143731
42348,網際網路電話,1,612933,0.00016199,99.29159930
42349,網際樂透,1,612934,0.00016199,99.29176130
42350,網壇,1,612935,0.00016199,99.29192329
42351,網蟒蛇,1,612936,0.00016199,99.29208529
42352,綱,1,612937,0.00016199,99.29224728
42353,綿,1,612938,0.00016199,99.29240928
42354,綿亙,1,612939,0.00016199,99.29257127
42355,綿延不絕,1,612940,0.00016199,99.29273326
42356,綿長,1,612941,0.00016199,99.29289526
42357,綿綿,1,612942,0.00016199,99.29305725
42358,維也納炸豬排,1,612943,0.00016199,99.29321925
42359,維也納香腸,1,612944,0.00016199,99.29338124
42360,維士巴修,1,612945,0.00016199,99.29354323
42361,維吉尼亞,1,612946,0.00016199,99.29370523
42362,維吉尼亞州,1,612947,0.00016199,99.29386722
42363,維因,1,612948,0.00016199,99.29402922
42364,維多利亞,1,612949,0.00016199,99.29419121
42365,維多利亞．德．安赫麗絲,1,612950,0.00016199,99.29435321
42366,維多賈柏,1,612951,0.00016199,99.29451520
42367,維西妮芙斯卡雅,1,612952,0.00016199,99.29467719
42368,維吾爾族,1,612953,0.00016199,99.29483919
42369,維特,1,612954,0.00016199,99.29500118
42370,維幕新大樓,1,612955,0.00016199,99.29516318
42371,維管束,1,612956,0.00016199,99.29532517
42372,罰金,1,612957,0.00016199,99.29548717
42373,罰球線,1,612958,0.00016199,99.29564916
42374,罰錢,1,612959,0.00016199,99.29581115
42375,翠,1,612960,0.00016199,99.29597315
42376,翠笛銀箏,1,612961,0.00016199,99.29613514
42377,翠雀花,1,612962,0.00016199,99.29629714
42378,翠綠色,1,612963,0.00016199,99.29645913
42379,翠豐,1,612964,0.00016199,99.29662112
42380,翡翠,1,612965,0.00016199,99.29678312
42381,翡翠樹蛙,1,612966,0.00016199,99.29694511
42382,聞人,1,612967,0.00016199,99.29710711
42383,聞聲,1,612968,0.00016199,99.29726910
42384,聚乙烯,1,612969,0.00016199,99.29743110
42385,聚光燈,1,612970,0.00016199,99.29759309
42386,聚合物,1,612971,0.00016199,99.29775508
42387,聚成,1,612972,0.00016199,99.29791708
42388,聚亨,1,612973,0.00016199,99.29807907
42389,聚集點,1,612974,0.00016199,99.29824107
42390,聚餐,1,612975,0.00016199,99.29840306
42391,聚點,1,612976,0.00016199,99.29856506
42392,聚酯長纖,1,612977,0.00016199,99.29872705
42393,聚酯粒,1,612978,0.00016199,99.29888904
42394,腐化,1,612979,0.00016199,99.29905104
42395,腐朽,1,612980,0.00016199,99.29921303
42396,膀肌炎,1,612981,0.00016199,99.29937503
42397,臺中,1,612982,0.00016199,99.29953702
42398,臺夫特,1,612983,0.00016199,99.29969901
42399,臺北市立和平醫院,1,612984,0.00016199,99.29986101
42400,臺北客運,1,612985,0.00016199,99.30002300
42401,臺形,1,612986,0.00016199,99.30018500
42402,臺南市,1,612987,0.00016199,99.30034699
42403,臺南縣學甲鎮慈濟宮,1,612988,0.00016199,99.30050899
42404,臺海戰役,1,612989,0.00016199,99.30067098
42405,臺灣省,1,612990,0.00016199,99.30083297
42406,臺灣省長,1,612991,0.00016199,99.30099497
42407,臺灣省黨部,1,612992,0.00016199,99.30115696
42408,與有榮焉,1,612993,0.00016199,99.30131896
42409,與論,1,612994,0.00016199,99.30148095
42410,舞照,1,612995,0.00016199,99.30164295
42411,舞獅,1,612996,0.00016199,99.30180494
42412,舞臺劇,1,612997,0.00016199,99.30196693
42413,舞蹈史,1,612998,0.00016199,99.30212893
42414,舞蹈者,1,612999,0.00016199,99.30229092
42415,蓄,1,613000,0.00016199,99.30245292
42416,蓄積,1,613001,0.00016199,99.30261491
42417,蒙大拿州,1,613002,0.00016199,99.30277690
42418,蒙古包,1,613003,0.00016199,99.30293890
42419,蒙古族,1,613004,0.00016199,99.30310089
42420,蒙佛,1,613005,0.00016199,99.30326289
42421,蒙克托瓦,1,613006,0.00016199,99.30342488
42422,蒙受,1,613007,0.00016199,99.30358688
42423,蒙恬,1,613008,0.00016199,99.30374887
42424,蒙恬式環境,1,613009,0.00016199,99.30391086
42425,蒙恬筆硯,1,613010,0.00016199,99.30407286
42426,蒙面人,1,613011,0.00016199,99.30423485
42427,蒙混,1,613012,0.00016199,99.30439685
42428,蒙蔽,1,613013,0.00016199,99.30455884
42429,蒲朗克機構,1,613014,0.00016199,99.30472084
42430,蒜泥白肉,1,613015,0.00016199,99.30488283
42431,蒜農,1,613016,0.00016199,99.30504482
42432,蓋世,1,613017,0.00016199,99.30520682
42433,蓋住,1,613018,0.00016199,99.30536881
42434,蓋依,1,613019,0.00016199,99.30553081
42435,蓋瑞特公司,1,613020,0.00016199,99.30569280
42436,蓋瑞歐德曼,1,613021,0.00016199,99.30585479
42437,蒸汽,1,613022,0.00016199,99.30601679
42438,蒸汽直熱烹煮包裝機,1,613023,0.00016199,99.30617878
42439,蒸汽室,1,613024,0.00016199,99.30634078
42440,蒸炊,1,613025,0.00016199,99.30650277
42441,蒸食,1,613026,0.00016199,99.30666477
42442,蒸蛋,1,613027,0.00016199,99.30682676
42443,蒸煮,1,613028,0.00016199,99.30698875
42444,蒸發器,1,613029,0.00016199,99.30715075
42445,蒸熟,1,613030,0.00016199,99.30731274
42446,蒸鍋,1,613031,0.00016199,99.30747474
42447,蒐藏,1,613032,0.00016199,99.30763673
42448,蒐藏品,1,613033,0.00016199,99.30779873
42449,蒼白,1,613034,0.00016199,99.30796072
42450,蒼促,1,613035,0.00016199,99.30812271
42451,蒼涼,1,613036,0.00016199,99.30828471
42452,蒼莽,1,613037,0.00016199,99.30844670
42453,蓊蓊鬱鬱,1,613038,0.00016199,99.30860870
42454,蓊鬱,1,613039,0.00016199,99.30877069
42455,蜿延,1,613040,0.00016199,99.30893268
42456,蜜月旅行,1,613041,0.00016199,99.30909468
42457,蜜妮,1,613042,0.00016199,99.30925667
42458,蜜拉姆創作藝術中心,1,613043,0.00016199,99.30941867
42459,蜜粉刷,1,613044,0.00016199,99.30958066
42460,蜜雪兒菲佛,1,613045,0.00016199,99.30974266
42461,蜘蛛女之吻,1,613046,0.00016199,99.30990465
42462,蜘蛛絲,1,613047,0.00016199,99.31006664
42463,蜘蛛網,1,613048,0.00016199,99.31022864
42464,蝕,1,613049,0.00016199,99.31039063
42465,蜷川劇場,1,613050,0.00016199,99.31055263
42466,裴利,1,613051,0.00016199,99.31071462
42467,裴恩,1,613052,0.00016199,99.31087662
42468,裹覆,1,613053,0.00016199,99.31103861
42469,裸身,1,613054,0.00016199,99.31120060
42470,裸奔,1,613055,0.00016199,99.31136260
42471,製片商,1,613056,0.00016199,99.31152459
42472,製好,1,613057,0.00016199,99.31168659
42473,製成品,1,613058,0.00016199,99.31184858
42474,製作公司,1,613059,0.00016199,99.31201057
42475,製茶,1,613060,0.00016199,99.31217257
42476,製做,1,613061,0.00016199,99.31233456
42477,製造日期,1,613062,0.00016199,99.31249656
42478,製造批號,1,613063,0.00016199,99.31265855
42479,製造時間,1,613064,0.00016199,99.31282055
42480,製造部,1,613065,0.00016199,99.31298254
42481,製造線,1,613066,0.00016199,99.31314453
42482,製琴,1,613067,0.00016199,99.31330653
42483,製程技術,1,613068,0.00016199,99.31346852
42484,製幣家,1,613069,0.00016199,99.31363052
42485,製鹽文化,1,613070,0.00016199,99.31379251
42486,褚士瑩,1,613071,0.00016199,99.31395451
42487,褚幸,1,613072,0.00016199,99.31411650
42488,誦,1,613073,0.00016199,99.31427849
42489,誦經團,1,613074,0.00016199,99.31444049
42490,誦頌,1,613075,0.00016199,99.31460248
42491,誦讀困難症,1,613076,0.00016199,99.31476448
42492,語句,1,613077,0.00016199,99.31492647
42493,語言與人生,1,613078,0.00016199,99.31508847
42494,語音訊息,1,613079,0.00016199,99.31525046
42495,語音通訊,1,613080,0.00016199,99.31541245
42496,語音數據晶片,1,613081,0.00016199,99.31557445
42497,語帶玄機,1,613082,0.00016199,99.31573644
42498,語畢,1,613083,0.00016199,99.31589844
42499,語意學,1,613084,0.00016199,99.31606043
42500,語錄,1,613085,0.00016199,99.31622242
42501,誣陷,1,613086,0.00016199,99.31638442
42502,認分,1,613087,0.00016199,99.31654641
42503,認份,1,613088,0.00016199,99.31670841
42504,認知力,1,613089,0.00016199,99.31687040
42505,認股率,1,613090,0.00016199,99.31703240
42506,認股權證,1,613091,0.00016199,99.31719439
42507,認捐卡,1,613092,0.00016199,99.31735638
42508,認賠,1,613093,0.00016199,99.31751838
42509,認養,1,613094,0.00016199,99.31768037
42510,認識本土,1,613095,0.00016199,99.31784237
42511,誡慎,1,613096,0.00016199,99.31800436
42512,誓師,1,613097,0.00016199,99.31816636
42513,誓願,1,613098,0.00016199,99.31832835
42514,誤以為,1,613099,0.00016199,99.31849034
42515,誤失,1,613100,0.00016199,99.31865234
42516,誤打誤撞,1,613101,0.00016199,99.31881433
42517,誤診,1,613102,0.00016199,99.31897633
42518,誤點,1,613103,0.00016199,99.31913832
42519,說大話,1,613104,0.00016199,99.31930031
42520,說不上,1,613105,0.00016199,99.31946231
42521,說不停,1,613106,0.00016199,99.31962430
42522,說走就走,1,613107,0.00016199,99.31978630
42523,說帖,1,613108,0.00016199,99.31994829
42524,說明會,1,613109,0.00016199,99.32011029
42525,說客,1,613110,0.00016199,99.32027228
42526,說起來,1,613111,0.00016199,99.32043427
42527,說唱藝師,1,613112,0.00016199,99.32059627
42528,說道,1,613113,0.00016199,99.32075826
42529,說實在,1,613114,0.00016199,99.32092026
42530,說說笑笑,1,613115,0.00016199,99.32108225
42531,說謊,1,613116,0.00016199,99.32124425
42532,說辭,1,613117,0.00016199,99.32140624
42533,誘使,1,613118,0.00016199,99.32156823
42534,誘拐,1,613119,0.00016199,99.32173023
42535,誘惑力,1,613120,0.00016199,99.32189222
42536,誘發,1,613121,0.00016199,99.32205422
42537,誘騙,1,613122,0.00016199,99.32221621
42538,豪宅,1,613123,0.00016199,99.32237820
42539,豪放,1,613124,0.00016199,99.32254020
42540,豪門,1,613125,0.00016199,99.32270219
42541,豪展電腦公司,1,613126,0.00016199,99.32286419
42542,豪情,1,613127,0.00016199,99.32302618
42543,豪爽,1,613128,0.00016199,99.32318818
42544,豪傑,1,613129,0.00016199,99.32335017
42545,豪華車,1,613130,0.00016199,99.32351216
42546,豪爾克斯,1,613131,0.00016199,99.32367416
42547,貌合神離,1,613132,0.00016199,99.32383615
42548,貌美,1,613133,0.00016199,99.32399815
42549,賓,1,613134,0.00016199,99.32416014
42550,賓主盡歡,1,613135,0.00016199,99.32432214
42551,賓多,1,613136,0.00016199,99.32448413
42552,賓州,1,613137,0.00016199,99.32464612
42553,賓州大學,1,613138,0.00016199,99.32480812
42554,賓州艾克米,1,613139,0.00016199,99.32497011
42555,賓至如歸,1,613140,0.00016199,99.32513211
42556,賒,1,613141,0.00016199,99.32529410
42557,賒欠,1,613142,0.00016199,99.32545609
42558,赫丘力,1,613143,0.00016199,99.32561809
42559,赫丘力士,1,613144,0.00016199,99.32578008
42560,赫伯．戴維斯,1,613145,0.00016199,99.32594208
42561,赫克托耳,1,613146,0.00016199,99.32610407
42562,赫洛曼,1,613147,0.00016199,99.32626607
42563,赫迦斯,1,613148,0.00016199,99.32642806
42564,赫茲,1,613149,0.00016199,99.32659005
42565,赫然,1,613150,0.00016199,99.32675205
42566,赫爾岑,1,613151,0.00016199,99.32691404
42567,赫赫,1,613152,0.00016199,99.32707604
42568,趙士強,1,613153,0.00016199,99.32723803
42569,趙丹,1,613154,0.00016199,99.32740003
42570,趙文瑄,1,613155,0.00016199,99.32756202
42571,趙台男,1,613156,0.00016199,99.32772401
42572,趙守博,1,613157,0.00016199,99.32788601
42573,趙汝杰,1,613158,0.00016199,99.32804800
42574,趙自強,1,613159,0.00016199,99.32821000
42575,趙良駿,1,613160,0.00016199,99.32837199
42576,趙孟頫,1,613161,0.00016199,99.32853398
42577,趙春祺,1,613162,0.00016199,99.32869598
42578,趙玲玲,1,613163,0.00016199,99.32885797
42579,趙強,1,613164,0.00016199,99.32901997
42580,趙惇儀,1,613165,0.00016199,99.32918196
42581,趙揚清,1,613166,0.00016199,99.32934396
42582,趙寧,1,613167,0.00016199,99.32950595
42583,趙榮耀,1,613168,0.00016199,99.32966794
42584,趕不及,1,613169,0.00016199,99.32982994
42585,趕出,1,613170,0.00016199,99.32999193
42586,趕出來,1,613171,0.00016199,99.33015393
42587,輔,1,613172,0.00016199,99.33031592
42588,輔佐,1,613173,0.00016199,99.33047792
42589,輔助性,1,613174,0.00016199,99.33063991
42590,輔訓,1,613175,0.00016199,99.33080190
42591,輕工業,1,613176,0.00016199,99.33096390
42592,輕巧型,1,613177,0.00016199,99.33112589
42593,輕打,1,613178,0.00016199,99.33128789
42594,輕兵器,1,613179,0.00016199,99.33144988
42595,輕扶,1,613180,0.00016199,99.33161187
42596,輕言,1,613181,0.00016199,99.33177387
42597,輕取,1,613182,0.00016199,99.33193586
42598,輕咬,1,613183,0.00016199,99.33209786
42599,輕按,1,613184,0.00016199,99.33225985
42600,輕風,1,613185,0.00016199,99.33242185
42601,輕脆,1,613186,0.00016199,99.33258384
42602,輕爽,1,613187,0.00016199,99.33274583
42603,輕量化,1,613188,0.00016199,99.33290783
42604,輕艇,1,613189,0.00016199,99.33306982
42605,輕電機,1,613190,0.00016199,99.33323182
42606,輕撫,1,613191,0.00016199,99.33339381
42607,輕質,1,613192,0.00016199,99.33355581
42608,輕質磚牆,1,613193,0.00016199,99.33371780
42609,輕戰車,1,613194,0.00016199,99.33387979
42610,輕機槍,1,613195,0.00016199,99.33404179
42611,輕聲,1,613196,0.00016199,99.33420378
42612,輕薄,1,613197,0.00016199,99.33436578
42613,輕飄,1,613198,0.00016199,99.33452777
42614,輕轟炸機,1,613199,0.00016199,99.33468976
42615,輕靈,1,613200,0.00016199,99.33485176
42616,辣手美人心,1,613201,0.00016199,99.33501375
42617,遠不如,1,613202,0.00016199,99.33517575
42618,遠企,1,613203,0.00016199,99.33533774
42619,遠企購物中心,1,613204,0.00016199,99.33549974
42620,遠行,1,613205,0.00016199,99.33566173
42621,遠走,1,613206,0.00016199,99.33582372
42622,遠東仁愛,1,613207,0.00016199,99.33598572
42623,遠東英漢百科辭典,1,613208,0.00016199,99.33614771
42624,遠東時報,1,613209,0.00016199,99.33630971
42625,遠東區,1,613210,0.00016199,99.33647170
42626,遠東銀行,1,613211,0.00016199,99.33663370
42627,遠東寶慶,1,613212,0.00016199,99.33679569
42628,遠流出版社,1,613213,0.00016199,99.33695768
42629,遠哲科學教育基金會,1,613214,0.00016199,99.33711968
42630,遠射,1,613215,0.00016199,99.33728167
42631,遠距離,1,613216,0.00016199,99.33744367
42632,遠端存取,1,613217,0.00016199,99.33760566
42633,遙不可及,1,613218,0.00016199,99.33776765
42634,遙拜,1,613219,0.00016199,99.33792965
42635,遙控車,1,613220,0.00016199,99.33809164
42636,遙控直升機,1,613221,0.00016199,99.33825364
42637,遙控飛機,1,613222,0.00016199,99.33841563
42638,遙控器,1,613223,0.00016199,99.33857763
42639,遙遙領先,1,613224,0.00016199,99.33873962
42640,遞出,1,613225,0.00016199,99.33890161
42641,遞呈,1,613226,0.00016199,99.33906361
42642,遞減,1,613227,0.00016199,99.33922560
42643,遞減率,1,613228,0.00016199,99.33938760
42644,鄙,1,613229,0.00016199,99.33954959
42645,鄙兒,1,613230,0.00016199,99.33971159
42646,鄙陋,1,613231,0.00016199,99.33987358
42647,酵母片,1,613232,0.00016199,99.34003557
42648,酵素性,1,613233,0.00016199,99.34019757
42649,酸乳,1,613234,0.00016199,99.34035956
42650,酸味,1,613235,0.00016199,99.34052156
42651,酸性磷酸,1,613236,0.00016199,99.34068355
42652,酸梅汁,1,613237,0.00016199,99.34084554
42653,酸辣湯,1,613238,0.00016199,99.34100754
42654,酸酸甜甜,1,613239,0.00016199,99.34116953
42655,酷刑,1,613240,0.00016199,99.34133153
42656,酷似,1,613241,0.00016199,99.34149352
42657,酷寒,1,613242,0.00016199,99.34165552
42658,銀子,1,613243,0.00016199,99.34181751
42659,銀白色,1,613244,0.00016199,99.34197950
42660,銀合歡,1,613245,0.00016199,99.34214150
42661,銀行公會,1,613246,0.00016199,99.34230349
42662,銀行界,1,613247,0.00016199,99.34246549
42663,銀兩,1,613248,0.00016199,99.34262748
42664,銀河,1,613249,0.00016199,99.34278948
42665,銀河飛龍,1,613250,0.00016199,99.34295147
42666,銀河號,1,613251,0.00016199,99.34311346
42667,銀河璇宮,1,613252,0.00016199,99.34327546
42668,銀質,1,613253,0.00016199,99.34343745
42669,銅版紙,1,613254,0.00016199,99.34359945
42670,銅品業,1,613255,0.00016199,99.34376144
42671,銅貨交易員,1,613256,0.00016199,99.34392344
42672,銅號,1,613257,0.00016199,99.34408543
42673,銅鈴,1,613258,0.00016199,99.34424742
42674,銅像,1,613259,0.00016199,99.34440942
42675,銅管樂,1,613260,0.00016199,99.34457141
42676,銅器,1,613261,0.00016199,99.34473341
42677,銅鑼山,1,613262,0.00016199,99.34489540
42678,銘刻,1,613263,0.00016199,99.34505739
42679,銘記,1,613264,0.00016199,99.34521939
42680,銘傳管理學院,1,613265,0.00016199,99.34538138
42681,銜包,1,613266,0.00016199,99.34554338
42682,閨秀,1,613267,0.00016199,99.34570537
42683,閨房,1,613268,0.00016199,99.34586737
42684,閩南語,1,613269,0.00016199,99.34602936
42685,閩變,1,613270,0.00016199,99.34619135
42686,閣員,1,613271,0.00016199,99.34635335
42687,閤家,1,613272,0.00016199,99.34651534
42688,隙縫,1,613273,0.00016199,99.34667734
42689,際會,1,613274,0.00016199,99.34683933
42690,際遇,1,613275,0.00016199,99.34700133
42691,雌性,1,613276,0.00016199,99.34716332
42692,雌虎,1,613277,0.00016199,99.34732531
42693,雌獸,1,613278,0.00016199,99.34748731
42694,需求性,1,613279,0.00016199,99.34764930
42695,需要性,1,613280,0.00016199,99.34781130
42696,需要量,1,613281,0.00016199,99.34797329
42697,頗為,1,613282,0.00016199,99.34813528
42698,頗負盛名,1,613283,0.00016199,99.34829728
42699,頗深,1,613284,0.00016199,99.34845927
42700,領口,1,613285,0.00016199,99.34862127
42701,領用,1,613286,0.00016199,99.34878326
42702,領先指標,1,613287,0.00016199,99.34894526
42703,領地,1,613288,0.00016199,99.34910725
42704,領有,1,613289,0.00016199,99.34926924
42705,領到,1,613290,0.00016199,99.34943124
42706,領息,1,613291,0.00016199,99.34959323
42707,領國,1,613292,0.00016199,99.34975523
42708,領帶夾,1,613293,0.00016199,99.34991722
42709,領教,1,613294,0.00016199,99.35007922
42710,領袖慾,1,613295,0.00016199,99.35024121
42711,領圍,1,613296,0.00016199,99.35040320
42712,領標點,1,613297,0.00016199,99.35056520
42713,領導慾,1,613298,0.00016199,99.35072719
42714,領導權,1,613299,0.00016199,99.35088919
42715,餃子皮,1,613300,0.00016199,99.35105118
42716,餃皮,1,613301,0.00016199,99.35121317
42717,駁斥,1,613302,0.00016199,99.35137517
42718,魁北克,1,613303,0.00016199,99.35153716
42719,魁梧,1,613304,0.00016199,99.35169916
42720,魂牽夢縈,1,613305,0.00016199,99.35186115
42721,鳴炮,1,613306,0.00016199,99.35202315
42722,鳴鼓,1,613307,0.00016199,99.35218514
42723,鳴聲,1,613308,0.00016199,99.35234713
42724,鳴響,1,613309,0.00016199,99.35250913
42725,鳶,1,613310,0.00016199,99.35267112
42726,鳳山簡易法庭,1,613311,0.00016199,99.35283312
42727,鳳仔姑,1,613312,0.00016199,99.35299511
42728,鳳仙,1,613313,0.00016199,99.35315711
42729,鳳凰木,1,613314,0.00016199,99.35331910
42730,鳳凰花,1,613315,0.00016199,99.35348109
42731,鳳凰城,1,613316,0.00016199,99.35364309
42732,鳳頭蒼鷹,1,613317,0.00016199,99.35380508
42733,鼻毛,1,613318,0.00016199,99.35396708
42734,鼻水,1,613319,0.00016199,99.35412907
42735,鼻青臉腫,1,613320,0.00016199,99.35429106
42736,鼻咽部,1,613321,0.00016199,99.35445306
42737,鼻祖,1,613322,0.00016199,99.35461505
42738,鼻部,1,613323,0.00016199,99.35477705
42739,鼻塞,1,613324,0.00016199,99.35493904
42740,鼻煙壺,1,613325,0.00016199,99.35510104
42741,鼻樑,1,613326,0.00016199,99.35526303
42742,鼻竇炎,1,613327,0.00016199,99.35542502
42743,齊一,1,613328,0.00016199,99.35558702
42744,齊白石,1,613329,0.00016199,99.35574901
42745,齊全性,1,613330,0.00016199,99.35591101
42746,齊步,1,613331,0.00016199,99.35607300
42747,齊聚,1,613332,0.00016199,99.35623500
42748,齊觀,1,613333,0.00016199,99.35639699
42749,儀典,1,613334,0.00016199,99.35655898
42750,儀表台,1,613335,0.00016199,99.35672098
42751,儀容,1,613336,0.00016199,99.35688297
42752,儀態,1,613337,0.00016199,99.35704497
42753,僻處,1,613338,0.00016199,99.35720696
42754,僵直性脊椎炎病友會,1,613339,0.00016199,99.35736895
42755,僵直性關節炎,1,613340,0.00016199,99.35753095
42756,僵硬感,1,613341,0.00016199,99.35769294
42757,價目表,1,613342,0.00016199,99.35785494
42758,價值比,1,613343,0.00016199,99.35801693
42759,價格標,1,613344,0.00016199,99.35817893
42760,價格戰,1,613345,0.00016199,99.35834092
42761,價超過值,1,613346,0.00016199,99.35850291
42762,價量,1,613347,0.00016199,99.35866491
42763,價量齊揚,1,613348,0.00016199,99.35882690
42764,價廉物美,1,613349,0.00016199,99.35898890
42765,價額,1,613350,0.00016199,99.35915089
42766,凜然,1,613351,0.00016199,99.35931289
42767,劇作,1,613352,0.00016199,99.35947488
42768,劇毒,1,613353,0.00016199,99.35963687
42769,劇降,1,613354,0.00016199,99.35979887
42770,劇情二,1,613355,0.00016199,99.35996086
42771,劇情片,1,613356,0.00016199,99.36012286
42772,劇畫家,1,613357,0.00016199,99.36028485
42773,劇痛,1,613358,0.00016199,99.36044684
42774,劇集,1,613359,0.00016199,99.36060884
42775,劇壇,1,613360,0.00016199,99.36077083
42776,劇變,1,613361,0.00016199,99.36093283
42777,劈,1,613362,0.00016199,99.36109482
42778,劈叭,1,613363,0.00016199,99.36125682
42779,劈頭,1,613364,0.00016199,99.36141881
42780,劉子鳳,1,613365,0.00016199,99.36158080
42781,劉友威,1,613366,0.00016199,99.36174280
42782,劉光華,1,613367,0.00016199,99.36190479
42783,劉克熹,1,613368,0.00016199,99.36206679
42784,劉秀,1,613369,0.00016199,99.36222878
42785,劉秀英,1,613370,0.00016199,99.36239078
42786,劉佳任,1,613371,0.00016199,99.36255277
42787,劉其偉,1,613372,0.00016199,99.36271476
42788,劉和謙,1,613373,0.00016199,99.36287676
42789,劉岩,1,613374,0.00016199,99.36303875
42790,劉怡志,1,613375,0.00016199,99.36320075
42791,劉明侯,1,613376,0.00016199,99.36336274
42792,劉明珠,1,613377,0.00016199,99.36352473
42793,劉金清,1,613378,0.00016199,99.36368673
42794,劉政池,1,613379,0.00016199,99.36384872
42795,劉柔含,1,613380,0.00016199,99.36401072
42796,劉柏森,1,613381,0.00016199,99.36417271
42797,劉若英,1,613382,0.00016199,99.36433471
42798,劉峻谷,1,613383,0.00016199,99.36449670
42799,劉海粟,1,613384,0.00016199,99.36465869
42800,劉國松,1,613385,0.00016199,99.36482069
42801,劉景寬,1,613386,0.00016199,99.36498268
42802,劉朝金,1,613387,0.00016199,99.36514468
42803,劉菁菁,1,613388,0.00016199,99.36530667
42804,劉雅菊,1,613389,0.00016199,99.36546867
42805,劉暉富,1,613390,0.00016199,99.36563066
42806,劉煥榮,1,613391,0.00016199,99.36579265
42807,劉瑞復,1,613392,0.00016199,99.36595465
42808,劉義傳,1,613393,0.00016199,99.36611664
42809,劉聖芬,1,613394,0.00016199,99.36627864
42810,劉詩灣,1,613395,0.00016199,99.36644063
42811,劉嘉玲,1,613396,0.00016199,99.36660262
42812,劉滌昭,1,613397,0.00016199,99.36676462
42813,劉鳳琴,1,613398,0.00016199,99.36692661
42814,劉衛中,1,613399,0.00016199,99.36708861
42815,劉衛荼,1,613400,0.00016199,99.36725060
42816,劉曉寧,1,613401,0.00016199,99.36741260
42817,劉樹仁,1,613402,0.00016199,99.36757459
42818,劉靜敏,1,613403,0.00016199,99.36773658
42819,劉繕維,1,613404,0.00016199,99.36789858
42820,劉羅鍋,1,613405,0.00016199,99.36806057
42821,劍角羚羊,1,613406,0.00016199,99.36822257
42822,劍拔弩張,1,613407,0.00016199,99.36838456
42823,劍術,1,613408,0.00016199,99.36854656
42824,劍橋大學,1,613409,0.00016199,99.36870855
42825,厲,1,613410,0.00016199,99.36887054
42826,嘮叨,1,613411,0.00016199,99.36903254
42827,嘻,1,613412,0.00016199,99.36919453
42828,嘻笑,1,613413,0.00016199,99.36935653
42829,嘻嘻,1,613414,0.00016199,99.36951852
42830,嘻嘻哈哈,1,613415,0.00016199,99.36968052
42831,嘴角,1,613416,0.00016199,99.36984251
42832,嘴型,1,613417,0.00016199,99.37000450
42833,嘴部,1,613418,0.00016199,99.37016650
42834,嘴硬,1,613419,0.00016199,99.37032849
42835,嘴邊,1,613420,0.00016199,99.37049049
42836,噗通,1,613421,0.00016199,99.37065248
42837,噴走,1,613422,0.00016199,99.37081447
42838,噴染,1,613423,0.00016199,99.37097647
42839,噴射發動機,1,613424,0.00016199,99.37113846
42840,噴射機,1,613425,0.00016199,99.37130046
42841,噴氣孔,1,613426,0.00016199,99.37146245
42842,噴發,1,613427,0.00016199,99.37162445
42843,噴煙,1,613428,0.00016199,99.37178644
42844,噴漆,1,613429,0.00016199,99.37194843
42845,噴嘴,1,613430,0.00016199,99.37211043
42846,噴嚏,1,613431,0.00016199,99.37227242
42847,噴臘印表機,1,613432,0.00016199,99.37243442
42848,噴霧罐,1,613433,0.00016199,99.37259641
42849,嘶吼,1,613434,0.00016199,99.37275841
42850,嘶啞,1,613435,0.00016199,99.37292040
42851,增刊,1,613436,0.00016199,99.37308239
42852,增加率,1,613437,0.00016199,99.37324439
42853,增色,1,613438,0.00016199,99.37340638
42854,增為,1,613439,0.00016199,99.37356838
42855,增修,1,613440,0.00016199,99.37373037
42856,增高,1,613441,0.00016199,99.37389236
42857,增幅,1,613442,0.00016199,99.37405436
42858,增稅,1,613443,0.00016199,99.37421635
42859,增廣,1,613444,0.00016199,99.37437835
42860,增壓,1,613445,0.00016199,99.37454034
42861,增闢,1,613446,0.00016199,99.37470234
42862,增顯,1,613447,0.00016199,99.37486433
42863,墳堆,1,613448,0.00016199,99.37502632
42864,墜毀事件,1,613449,0.00016199,99.37518832
42865,墜毀物,1,613450,0.00016199,99.37535031
42866,墜機,1,613451,0.00016199,99.37551231
42867,墮胎,1,613452,0.00016199,99.37567430
42868,嬉皮,1,613453,0.00016199,99.37583630
42869,嬉笑,1,613454,0.00016199,99.37599829
42870,嫻熟,1,613455,0.00016199,99.37616028
42871,嫻靜,1,613456,0.00016199,99.37632228
42872,嬌,1,613457,0.00016199,99.37648427
42873,嬌小,1,613458,0.00016199,99.37664627
42874,嬌生慣養,1,613459,0.00016199,99.37680826
42875,嬌弱,1,613460,0.00016199,99.37697025
42876,嬌縱,1,613461,0.00016199,99.37713225
42877,嬌麗,1,613462,0.00016199,99.37729424
42878,嬌艷,1,613463,0.00016199,99.37745624
42879,嬌嗲,1,613464,0.00016199,99.37761823
42880,寮,1,613465,0.00016199,99.37778023
42881,寬厚,1,613466,0.00016199,99.37794222
42882,寬容心,1,613467,0.00016199,99.37810421
42883,寬貸,1,613468,0.00016199,99.37826621
42884,寬寬圓圓,1,613469,0.00016199,99.37842820
42885,寬闊,1,613470,0.00016199,99.37859020
42886,審酌,1,613471,0.00016199,99.37875219
42887,審視,1,613472,0.00016199,99.37891419
42888,審標,1,613473,0.00016199,99.37907618
42889,審閱,1,613474,0.00016199,99.37923817
42890,寫出,1,613475,0.00016199,99.37940017
42891,寫作者,1,613476,0.00016199,99.37956216
42892,寫來,1,613477,0.00016199,99.37972416
42893,寫法,1,613478,0.00016199,99.37988615
42894,寫書,1,613479,0.00016199,99.38004814
42895,寫真集,1,613480,0.00016199,99.38021014
42896,寫詞者,1,613481,0.00016199,99.38037213
42897,寫寫,1,613482,0.00016199,99.38053413
42898,寫稿,1,613483,0.00016199,99.38069612
42899,層次感,1,613484,0.00016199,99.38085812
42900,履行,1,613485,0.00016199,99.38102011
42901,履帶,1,613486,0.00016199,99.38118210
42902,嶔奇,1,613487,0.00016199,99.38134410
42903,幡幕,1,613488,0.00016199,99.38150609
42904,廢人,1,613489,0.00016199,99.38166809
42905,廢五金熔煉業,1,613490,0.00016199,99.38183008
42906,廢主王心,1,613491,0.00016199,99.38199208
42907,廢弛職務罪,1,613492,0.00016199,99.38215407
42908,廢河道,1,613493,0.00016199,99.38231606
42909,廢紙回收廠,1,613494,0.00016199,99.38247806
42910,廢棄,1,613495,0.00016199,99.38264005
42911,廢棄物清理法,1,613496,0.00016199,99.38280205
42912,廢棄物處理,1,613497,0.00016199,99.38296404
42913,廢棄婚姻,1,613498,0.00016199,99.38312603
42914,廢船,1,613499,0.00016199,99.38328803
42915,廢話,1,613500,0.00016199,99.38345002
42916,廢墊板,1,613501,0.00016199,99.38361202
42917,廢鋼,1,613502,0.00016199,99.38377401
42918,廚具,1,613503,0.00016199,99.38393601
42919,廚房家具,1,613504,0.00016199,99.38409800
42920,廟口,1,613505,0.00016199,99.38425999
42921,廟埕,1,613506,0.00016199,99.38442199
42922,廝,1,613507,0.00016199,99.38458398
42923,廝守,1,613508,0.00016199,99.38474598
42924,廣三大帝國,1,613509,0.00016199,99.38490797
42925,廣三崇光,1,613510,0.00016199,99.38506997
42926,廣大無際,1,613511,0.00016199,99.38523196
42927,廣井王子,1,613512,0.00016199,99.38539395
42928,廣安里,1,613513,0.00016199,99.38555595
42929,廣州軍區,1,613514,0.00016199,99.38571794
42930,廣西,1,613515,0.00016199,99.38587994
42931,廣西壯族,1,613516,0.00016199,99.38604193
42932,廣告化,1,613517,0.00016199,99.38620392
42933,廣告文案,1,613518,0.00016199,99.38636592
42934,廣告曲,1,613519,0.00016199,99.38652791
42935,廣告系,1,613520,0.00016199,99.38668991
42936,廣告品,1,613521,0.00016199,99.38685190
42937,廣告看板,1,613522,0.00016199,99.38701390
42938,廣告頁,1,613523,0.00016199,99.38717589
42939,廣告商,1,613524,0.00016199,99.38733788
42940,廣告歌,1,613525,0.00016199,99.38749988
42941,廣告欄,1,613526,0.00016199,99.38766187
42942,廣角鏡,1,613527,0.00016199,99.38782387
42943,廣受,1,613528,0.00016199,99.38798586
42944,廣東粥,1,613529,0.00016199,99.38814786
42945,廣島,1,613530,0.00016199,99.38830985
42946,廣島花祭,1,613531,0.00016199,99.38847184
42947,廣域型,1,613532,0.00016199,99.38863384
42948,廣深鐵路公司,1,613533,0.00016199,99.38879583
42949,廣發,1,613534,0.00016199,99.38895783
42950,廣義,1,613535,0.00016199,99.38911982
42951,廣達,1,613536,0.00016199,99.38928181
42952,廣電科,1,613537,0.00016199,99.38944381
42953,廣電基金,1,613538,0.00016199,99.38960580
42954,廣漠,1,613539,0.00016199,99.38976780
42955,廣播人,1,613540,0.00016199,99.38992979
42956,廣播史,1,613541,0.00016199,99.39009179
42957,廣播界,1,613542,0.00016199,99.39025378
42958,廣播電台,1,613543,0.00016199,99.39041577
42959,廣播網,1,613544,0.00016199,99.39057777
42960,廣播營,1,613545,0.00016199,99.39073976
42961,廠務,1,613546,0.00016199,99.39090176
42962,廠務組,1,613547,0.00016199,99.39106375
42963,廠際整合,1,613548,0.00016199,99.39122575
42964,彈力,1,613549,0.00016199,99.39138774
42965,彈丸之地,1,613550,0.00016199,99.39154973
42966,彈匣口,1,613551,0.00016199,99.39171173
42967,彈性化,1,613552,0.00016199,99.39187372
42968,彈指,1,613553,0.00016199,99.39203572
42969,彈唱,1,613554,0.00016199,99.39219771
42970,彈琴,1,613555,0.00016199,99.39235970
42971,彈著,1,613556,0.00016199,99.39252170
42972,彈開,1,613557,0.00016199,99.39268369
42973,彈跳,1,613558,0.00016199,99.39284569
42974,彈道,1,613559,0.00016199,99.39300768
42975,彈簧,1,613560,0.00016199,99.39316968
42976,彈簧製造機,1,613561,0.00016199,99.39333167
42977,彈藥庫,1,613562,0.00016199,99.39349366
42978,影子玫瑰,1,613563,0.00016199,99.39365566
42979,影印卡,1,613564,0.00016199,99.39381765
42980,影印紙,1,613565,0.00016199,99.39397965
42981,影狗,1,613566,0.00016199,99.39414164
42982,影圈,1,613567,0.00016199,99.39430364
42983,影帶,1,613568,0.00016199,99.39446563
42984,影視文藝圈,1,613569,0.00016199,99.39462762
42985,影視界,1,613570,0.00016199,99.39478962
42986,影像化,1,613571,0.00016199,99.39495161
42987,影像捕捉卡,1,613572,0.00016199,99.39511361
42988,影像圈,1,613573,0.00016199,99.39527560
42989,影像處理系統,1,613574,0.00016199,99.39543759
42990,影劇圈,1,613575,0.00016199,99.39559959
42991,影齡,1,613576,0.00016199,99.39576158
42992,德川幕府,1,613577,0.00016199,99.39592358
42993,德文,1,613578,0.00016199,99.39608557
42994,德比士公司,1,613579,0.00016199,99.39624757
42995,德安,1,613580,0.00016199,99.39640956
42996,德亨,1,613581,0.00016199,99.39657155
42997,德亨洋酒,1,613582,0.00016199,99.39673355
42998,德亨洋酒公司,1,613583,0.00016199,99.39689554
42999,德克米高諸奇,1,613584,0.00016199,99.39705754
43000,德希達,1,613585,0.00016199,99.39721953
43001,德里動物園,1,613586,0.00016199,99.39738153
43002,德姆特倫高塔,1,613587,0.00016199,99.39754352
43003,德拉瓦州,1,613588,0.00016199,99.39770551
43004,德倫塞拉芬,1,613589,0.00016199,99.39786751
43005,德記洋行,1,613590,0.00016199,99.39802950
43006,德國人,1,613591,0.00016199,99.39819150
43007,德國小寶馬,1,613592,0.00016199,99.39835349
43008,德國佬,1,613593,0.00016199,99.39851549
43009,德國麻疹,1,613594,0.00016199,99.39867748
43010,德國隊,1,613595,0.00016199,99.39883947
43011,德國路維德美術館,1,613596,0.00016199,99.39900147
43012,德瑞克．蘇魯勃,1,613597,0.00016199,99.39916346
43013,德爾菲,1,613598,0.00016199,99.39932546
43014,德製,1,613599,0.00016199,99.39948745
43015,德語,1,613600,0.00016199,99.39964944
43016,德蕾莎修女,1,613601,0.00016199,99.39981144
43017,德寶營造,1,613602,0.00016199,99.39997343
43018,徵人,1,613603,0.00016199,99.40013543
43019,徵信,1,613604,0.00016199,99.40029742
43020,徵候,1,613605,0.00016199,99.40045942
43021,徵稅,1,613606,0.00016199,99.40062141
43022,徵調,1,613607,0.00016199,99.40078340
43023,慶生,1,613608,0.00016199,99.40094540
43024,慶生會,1,613609,0.00016199,99.40110739
43025,慶事,1,613610,0.00016199,99.40126939
43026,慶典鼓號曲,1,613611,0.00016199,99.40143138
43027,慶美園,1,613612,0.00016199,99.40159338
43028,慶眾汽車,1,613613,0.00016199,99.40175537
43029,慶喜,1,613614,0.00016199,99.40191736
43030,慶樺資訊,1,613615,0.00016199,99.40207936
43031,慶豐,1,613616,0.00016199,99.40224135
43032,慶豐集團,1,613617,0.00016199,99.40240335
43033,慶豐銀行,1,613618,0.00016199,99.40256534
43034,慶齡工業研究中心,1,613619,0.00016199,99.40272733
43035,慧敬法師,1,613620,0.00016199,99.40288933
43036,慮,1,613621,0.00016199,99.40305132
43037,慕,1,613622,0.00016199,99.40321332
43038,慕名,1,613623,0.00016199,99.40337531
43039,慕迪,1,613624,0.00016199,99.40353731
43040,慕迪公司,1,613625,0.00016199,99.40369930
43041,憂心忡忡,1,613626,0.00016199,99.40386129
43042,憂戚,1,613627,0.00016199,99.40402329
43043,憂慮症,1,613628,0.00016199,99.40418528
43044,憂懼,1,613629,0.00016199,99.40434728
43045,慰留,1,613630,0.00016199,99.40450927
43046,慰問卡,1,613631,0.00016199,99.40467127
43047,慾海,1,613632,0.00016199,99.40483326
43048,慾望之翼,1,613633,0.00016199,99.40499525
43049,憐惜,1,613634,0.00016199,99.40515725
43050,憚,1,613635,0.00016199,99.40531924
43051,憤,1,613636,0.00016199,99.40548124
43052,憤恨,1,613637,0.00016199,99.40564323
43053,憔悴,1,613638,0.00016199,99.40580522
43054,戮破,1,613639,0.00016199,99.40596722
43055,摩,1,613640,0.00016199,99.40612921
43056,摩天大樓,1,613641,0.00016199,99.40629121
43057,摩天雄鷹,1,613642,0.00016199,99.40645320
43058,摩托車雜誌,1,613643,0.00016199,99.40661520
43059,摩托羅拉,1,613644,0.00016199,99.40677719
43060,摩西,1,613645,0.00016199,99.40693918
43061,摩西．巴若拉,1,613646,0.00016199,99.40710118
43062,摩哈維茲,1,613647,0.00016199,99.40726317
43063,摩洛哥,1,613648,0.00016199,99.40742517
43064,摩洛哥菜,1,613649,0.00016199,99.40758716
43065,摩根史坦利效應,1,613650,0.00016199,99.40774916
43066,摩根股,1,613651,0.00016199,99.40791115
43067,摩根證券公司,1,613652,0.00016199,99.40807314
43068,摩納哥,1,613653,0.00016199,99.40823514
43069,摩登大聖,1,613654,0.00016199,99.40839713
43070,摩菲,1,613655,0.00016199,99.40855913
43071,摩德斯托,1,613656,0.00016199,99.40872112
43072,摯友,1,613657,0.00016199,99.40888311
43073,摯愛,1,613658,0.00016199,99.40904511
43074,撞車,1,613659,0.00016199,99.40920710
43075,撞破,1,613660,0.00016199,99.40936910
43076,撞牆期,1,613661,0.00016199,99.40953109
43077,撞壞,1,613662,0.00016199,99.40969309
43078,撲了空,1,613663,0.00016199,99.40985508
43079,撲上,1,613664,0.00016199,99.41001707
43080,撲向,1,613665,0.00016199,99.41017907
43081,撲克,1,613666,0.00016199,99.41034106
43082,撲克牌,1,613667,0.00016199,99.41050306
43083,撲救,1,613668,0.00016199,99.41066505
43084,撈一票,1,613669,0.00016199,99.41082705
43085,撈捕,1,613670,0.00016199,99.41098904
43086,撈起,1,613671,0.00016199,99.41115103
43087,撐起,1,613672,0.00016199,99.41131303
43088,撐開,1,613673,0.00016199,99.41147502
43089,撐腰,1,613674,0.00016199,99.41163702
43090,撥弦,1,613675,0.00016199,99.41179901
43091,撥接,1,613676,0.00016199,99.41196100
43092,撥款,1,613677,0.00016199,99.41212300
43093,撥號,1,613678,0.00016199,99.41228499
43094,撥號網路,1,613679,0.00016199,99.41244699
43095,撥號器,1,613680,0.00016199,99.41260898
43096,撕扭,1,613681,0.00016199,99.41277098
43097,撕咬,1,613682,0.00016199,99.41293297
43098,撕剝式,1,613683,0.00016199,99.41309496
43099,撕票案,1,613684,0.00016199,99.41325696
43100,撩,1,613685,0.00016199,99.41341895
43101,撩人,1,613686,0.00016199,99.41358095
43102,撒手,1,613687,0.00016199,99.41374294
43103,撒手不管,1,613688,0.00016199,99.41390494
43104,撒拉．迪恩,1,613689,0.00016199,99.41406693
43105,撒哈拉,1,613690,0.00016199,99.41422892
43106,撒落,1,613691,0.00016199,99.41439092
43107,撒網,1,613692,0.00016199,99.41455291
43108,撒嬌,1,613693,0.00016199,99.41471491
43109,撒謊,1,613694,0.00016199,99.41487690
43110,撮撮,1,613695,0.00016199,99.41503889
43111,播放程式,1,613696,0.00016199,99.41520089
43112,播送,1,613697,0.00016199,99.41536288
43113,播散,1,613698,0.00016199,99.41552488
43114,播廣告,1,613699,0.00016199,99.41568687
43115,撫,1,613700,0.00016199,99.41584887
43116,撫平,1,613701,0.00016199,99.41601086
43117,撫慰金,1,613702,0.00016199,99.41617285
43118,撬,1,613703,0.00016199,99.41633485
43119,撙,1,613704,0.00016199,99.41649684
43120,敵手,1,613705,0.00016199,99.41665884
43121,敵前,1,613706,0.00016199,99.41682083
43122,敵陣,1,613707,0.00016199,99.41698283
43123,敵視,1,613708,0.00016199,99.41714482
43124,敷衍,1,613709,0.00016199,99.41730681
43125,數一數二,1,613710,0.00016199,99.41746881
43126,數位式相機,1,613711,0.00016199,99.41763080
43127,數位式攝影,1,613712,0.00016199,99.41779280
43128,數位板,1,613713,0.00016199,99.41795479
43129,數位相機,1,613714,0.00016199,99.41811678
43130,數位訊號,1,613715,0.00016199,99.41827878
43131,數度,1,613716,0.00016199,99.41844077
43132,數值化,1,613717,0.00016199,99.41860277
43133,數部,1,613718,0.00016199,99.41876476
43134,數量化,1,613719,0.00016199,99.41892676
43135,數據所,1,613720,0.00016199,99.41908875
43136,數據通信所,1,613721,0.00016199,99.41925074
43137,數據機晶片,1,613722,0.00016199,99.41941274
43138,暮,1,613723,0.00016199,99.41957473
43139,暮冬,1,613724,0.00016199,99.41973673
43140,暫且,1,613725,0.00016199,99.41989872
43141,暫存,1,613726,0.00016199,99.42006072
43142,暫行,1,613727,0.00016199,99.42022271
43143,暫忘,1,613728,0.00016199,99.42038470
43144,暫訂,1,613729,0.00016199,99.42054670
43145,暴力文化,1,613730,0.00016199,99.42070869
43146,暴力犯,1,613731,0.00016199,99.42087069
43147,暴行,1,613732,0.00016199,99.42103268
43148,暴君,1,613733,0.00016199,99.42119467
43149,暴投,1,613734,0.00016199,99.42135667
43150,暴戾,1,613735,0.00016199,99.42151866
43151,暴雨,1,613736,0.00016199,99.42168066
43152,暴怒,1,613737,0.00016199,99.42184265
43153,暴政,1,613738,0.00016199,99.42200465
43154,暴虐無道,1,613739,0.00016199,99.42216664
43155,暴發戶,1,613740,0.00016199,99.42232863
43156,暴飲暴食,1,613741,0.00016199,99.42249063
43157,暴亂,1,613742,0.00016199,99.42265262
43158,暴傳,1,613743,0.00016199,99.42281462
43159,暴露慾,1,613744,0.00016199,99.42297661
43160,暱稱,1,613745,0.00016199,99.42313861
43161,樣貌,1,613746,0.00016199,99.42330060
43162,樟茶鴨,1,613747,0.00016199,99.42346259
43163,樟腦油,1,613748,0.00016199,99.42362459
43164,樟樹,1,613749,0.00016199,99.42378658
43165,樞機,1,613750,0.00016199,99.42394858
43166,標示法,1,613751,0.00016199,99.42411057
43167,標示牌,1,613752,0.00016199,99.42427256
43168,標示窗,1,613753,0.00016199,99.42443456
43169,標新立異,1,613754,0.00016199,99.42459655
43170,標準版,1,613755,0.00016199,99.42475855
43171,標準音,1,613756,0.00016199,99.42492054
43172,標準廠,1,613757,0.00016199,99.42508254
43173,標準模式,1,613758,0.00016199,99.42524453
43174,標號,1,613759,0.00016199,99.42540652
43175,標達,1,613760,0.00016199,99.42556852
43176,標靶,1,613761,0.00016199,99.42573051
43177,標幟,1,613762,0.00016199,99.42589251
43178,標識燈,1,613763,0.00016199,99.42605450
43179,模子,1,613764,0.00016199,99.42621650
43180,模仿秀,1,613765,0.00016199,99.42637849
43181,模具加工廠,1,613766,0.00016199,99.42654048
43182,模具廠,1,613767,0.00016199,99.42670248
43183,模版,1,613768,0.00016199,99.42686447
43184,模型汽車,1,613769,0.00016199,99.42702647
43185,模造紙,1,613770,0.00016199,99.42718846
43186,模製,1,613771,0.00016199,99.42735046
43187,模糊味,1,613772,0.00016199,99.42751245
43188,樓下,1,613773,0.00016199,99.42767444
43189,樓台,1,613774,0.00016199,99.42783644
43190,樓宇,1,613775,0.00016199,99.42799843
43191,樓面積,1,613776,0.00016199,99.42816043
43192,樓學賢,1,613777,0.00016199,99.42832242
43193,樊劍萍,1,613778,0.00016199,99.42848441
43194,樂土,1,613779,0.00016199,99.42864641
43195,樂子,1,613780,0.00016199,99.42880840
43196,樂不可支,1,613781,0.00016199,99.42897040
43197,樂天地,1,613782,0.00016199,99.42913239
43198,樂天派,1,613783,0.00016199,99.42929439
43199,樂史,1,613784,0.00016199,99.42945638
43200,樂在其中,1,613785,0.00016199,99.42961837
43201,樂事,1,613786,0.00016199,99.42978037
43202,樂性,1,613787,0.00016199,99.42994236
43203,樂界,1,613788,0.00016199,99.43010436
43204,樂音,1,613789,0.00016199,99.43026635
43205,樂師,1,613790,0.00016199,99.43042835
43206,樂捐,1,613791,0.00016199,99.43059034
43207,樂時公司,1,613792,0.00016199,99.43075233
43208,樂記,1,613793,0.00016199,99.43091433
43209,樂透,1,613794,0.00016199,99.43107632
43210,樂隊,1,613795,0.00016199,99.43123832
43211,樂聖,1,613796,0.00016199,99.43140031
43212,樂舞,1,613797,0.00016199,99.43156230
43213,樂器曲,1,613798,0.00016199,99.43172430
43214,樂觀其成,1,613799,0.00016199,99.43188629
43215,樑,1,613800,0.00016199,99.43204829
43216,樑柱,1,613801,0.00016199,99.43221028
43217,歐巴桑,1,613802,0.00016199,99.43237228
43218,歐尼爾,1,613803,0.00016199,99.43253427
43219,歐布拉索娃,1,613804,0.00016199,99.43269626
43220,歐克利,1,613805,0.00016199,99.43285826
43221,歐系,1,613806,0.00016199,99.43302025
43222,歐里桑,1,613807,0.00016199,99.43318225
43223,歐建智,1,613808,0.00016199,99.43334424
43224,歐洲大陸,1,613809,0.00016199,99.43350624
43225,歐洲共同體,1,613810,0.00016199,99.43366823
43226,歐洲車,1,613811,0.00016199,99.43383022
43227,歐洲聯盟,1,613812,0.00016199,99.43399222
43228,歐美人,1,613813,0.00016199,99.43415421
43229,歐啟昌,1,613814,0.00016199,99.43431621
43230,歐規,1,613815,0.00016199,99.43447820
43231,歐普,1,613816,0.00016199,99.43464019
43232,歐陽瓊,1,613817,0.00016199,99.43480219
43233,歐蕾,1,613818,0.00016199,99.43496418
43234,毆人,1,613819,0.00016199,99.43512618
43235,澄清湖,1,613820,0.00016199,99.43528817
43236,澄澈,1,613821,0.00016199,99.43545017
43237,潑及,1,613822,0.00016199,99.43561216
43238,潑刺,1,613823,0.00016199,99.43577415
43239,潑墨,1,613824,0.00016199,99.43593615
43240,潑濕,1,613825,0.00016199,99.43609814
43241,潦倒,1,613826,0.00016199,99.43626014
43242,潔黛萍克,1,613827,0.00016199,99.43642213
43243,潔癖,1,613828,0.00016199,99.43658413
43244,澆,1,613829,0.00016199,99.43674612
43245,澆斗,1,613830,0.00016199,99.43690811
43246,澆洗,1,613831,0.00016199,99.43707011
43247,澆鑄機,1,613832,0.00016199,99.43723210
43248,潛入,1,613833,0.00016199,99.43739410
43249,潛力股,1,613834,0.00016199,99.43755609
43250,潛水手電筒,1,613835,0.00016199,99.43771808
43251,潛水衣,1,613836,0.00016199,99.43788008
43252,潛水設備,1,613837,0.00016199,99.43804207
43253,潛伏期,1,613838,0.00016199,99.43820407
43254,潛修,1,613839,0.00016199,99.43836606
43255,潛移默化,1,613840,0.00016199,99.43852806
43256,潛潛,1,613841,0.00016199,99.43869005
43257,潸然,1,613842,0.00016199,99.43885204
43258,潮差,1,613843,0.00016199,99.43901404
43259,潮起潮落,1,613844,0.00016199,99.43917603
43260,潮間帶,1,613845,0.00016199,99.43933803
43261,潮溼,1,613846,0.00016199,99.43950002
43262,潮解劑,1,613847,0.00016199,99.43966202
43263,澎湖小上海,1,613848,0.00016199,99.43982401
43264,澎澎,1,613849,0.00016199,99.43998600
43265,潰,1,613850,0.00016199,99.44014800
43266,潰瘍,1,613851,0.00016199,99.44030999
43267,潰縮區,1,613852,0.00016199,99.44047199
43268,潤滑油,1,613853,0.00016199,99.44063398
43269,潘．史懷蕊,1,613854,0.00016199,99.44079597
43270,潘丁白,1,613855,0.00016199,99.44095797
43271,潘文炎,1,613856,0.00016199,99.44111996
43272,潘文凱,1,613857,0.00016199,99.44128196
43273,潘秀桃,1,613858,0.00016199,99.44144395
43274,潘俊榮,1,613859,0.00016199,99.44160595
43275,潘皇龍,1,613860,0.00016199,99.44176794
43276,潘笛,1,613861,0.00016199,99.44192993
43277,潘森,1,613862,0.00016199,99.44209193
43278,潘儀君,1,613863,0.00016199,99.44225392
43279,熟肉,1,613864,0.00016199,99.44241592
43280,熟門熟路,1,613865,0.00016199,99.44257791
43281,熟食,1,613866,0.00016199,99.44273991
43282,熟睡,1,613867,0.00016199,99.44290190
43283,熟諳,1,613868,0.00016199,99.44306389
43284,熟讀,1,613869,0.00016199,99.44322589
43285,熬成,1,613870,0.00016199,99.44338788
43286,熬煮,1,613871,0.00016199,99.44354988
43287,熱力,1,613872,0.00016199,99.44371187
43288,熱力四射,1,613873,0.00016199,99.44387386
43289,熱水袋,1,613874,0.00016199,99.44403586
43290,熱交換,1,613875,0.00016199,99.44419785
43291,熱死了,1,613876,0.00016199,99.44435985
43292,熱身,1,613877,0.00016199,99.44452184
43293,熱昇華印表機,1,613878,0.00016199,99.44468384
43294,熱波活水,1,613879,0.00016199,99.44484583
43295,熱門國片大展,1,613880,0.00016199,99.44500782
43296,熱門貨,1,613881,0.00016199,99.44516982
43297,熱門話題,1,613882,0.00016199,99.44533181
43298,熱毒,1,613883,0.00016199,99.44549381
43299,熱風,1,613884,0.00016199,99.44565580
43300,熱效應,1,613885,0.00016199,99.44581780
43301,熱病,1,613886,0.00016199,99.44597979
43302,熱能,1,613887,0.00016199,99.44614178
43303,熱帶魚,1,613888,0.00016199,99.44630378
43304,熱帶斑海豚,1,613889,0.00016199,99.44646577
43305,熱帶樹木,1,613890,0.00016199,99.44662777
43306,熱淚,1,613891,0.00016199,99.44678976
43307,熱淚盈眶,1,613892,0.00016199,99.44695175
43308,熱痛,1,613893,0.00016199,99.44711375
43309,熱飲,1,613894,0.00016199,99.44727574
43310,熱滾滾,1,613895,0.00016199,99.44743774
43311,熱舞,1,613896,0.00016199,99.44759973
43312,熱熱,1,613897,0.00016199,99.44776173
43313,熱熱鬧鬧,1,613898,0.00016199,99.44792372
43314,熱賣,1,613899,0.00016199,99.44808571
43315,熱賣會,1,613900,0.00016199,99.44824771
43316,熱銷,1,613901,0.00016199,99.44840970
43317,熱鬧滾滾,1,613902,0.00016199,99.44857170
43318,熱戰,1,613903,0.00016199,99.44873369
43319,熱膨脹,1,613904,0.00016199,99.44889569
43320,熱膨脹係數,1,613905,0.00016199,99.44905768
43321,熱騰騰,1,613906,0.00016199,99.44921967
43322,獎狀,1,613907,0.00016199,99.44938167
43323,瘟疫,1,613908,0.00016199,99.44954366
43324,瘦下來,1,613909,0.00016199,99.44970566
43325,瘦身美容中心,1,613910,0.00016199,99.44986765
43326,瘦削,1,613911,0.00016199,99.45002964
43327,瘦瘠,1,613912,0.00016199,99.45019164
43328,瘡腫,1,613913,0.00016199,99.45035363
43329,瘡癰,1,613914,0.00016199,99.45051563
43330,皺摺,1,613915,0.00016199,99.45067762
43331,盤上,1,613916,0.00016199,99.45083962
43332,盤子,1,613917,0.00016199,99.45100161
43333,盤古開天,1,613918,0.00016199,99.45116360
43334,盤地,1,613919,0.00016199,99.45132560
43335,盤局,1,613920,0.00016199,99.45148759
43336,盤底,1,613921,0.00016199,99.45164959
43337,盤據,1,613922,0.00016199,99.45181158
43338,瞎眼,1,613923,0.00016199,99.45197358
43339,瞎湊,1,613924,0.00016199,99.45213557
43340,確有其事,1,613925,0.00016199,99.45229756
43341,確曾,1,613926,0.00016199,99.45245956
43342,稽,1,613927,0.00016199,99.45262155
43343,稽核室,1,613928,0.00016199,99.45278355
43344,稽察條例,1,613929,0.00016199,99.45294554
43345,稽徵,1,613930,0.00016199,99.45310753
43346,稽徵機關,1,613931,0.00016199,99.45326953
43347,稻田,1,613932,0.00016199,99.45343152
43348,稻作,1,613933,0.00016199,99.45359352
43349,稻草,1,613934,0.00016199,99.45375551
43350,稻草人,1,613935,0.00016199,99.45391751
43351,稻穀,1,613936,0.00016199,99.45407950
43352,窮光蛋,1,613937,0.00016199,99.45424149
43353,窮困,1,613938,0.00016199,99.45440349
43354,窮困者,1,613939,0.00016199,99.45456548
43355,箭靶,1,613940,0.00016199,99.45472748
43356,箱型,1,613941,0.00016199,99.45488947
43357,箴言,1,613942,0.00016199,99.45505147
43358,篆刻家,1,613943,0.00016199,99.45521346
43359,糊里糊塗,1,613944,0.00016199,99.45537545
43360,糊掉,1,613945,0.00016199,99.45553745
43361,糊塗,1,613946,0.00016199,99.45569944
43362,締,1,613947,0.00016199,99.45586144
43363,練唱版,1,613948,0.00016199,99.45602343
43364,練習生,1,613949,0.00016199,99.45618543
43365,練習彈,1,613950,0.00016199,99.45634742
43366,緯來日本台,1,613951,0.00016199,99.45650941
43367,緯度,1,613952,0.00016199,99.45667141
43368,緬甸,1,613953,0.00016199,99.45683340
43369,緝私艦,1,613954,0.00016199,99.45699540
43370,緝毒組,1,613955,0.00016199,99.45715739
43371,緝拿,1,613956,0.00016199,99.45731938
43372,緝捕,1,613957,0.00016199,99.45748138
43373,緝獲,1,613958,0.00016199,99.45764337
43374,編曲者,1,613959,0.00016199,99.45780537
43375,編結,1,613960,0.00016199,99.45796736
43376,編隊,1,613961,0.00016199,99.45812936
43377,編舞,1,613962,0.00016199,99.45829135
43378,編劇獎,1,613963,0.00016199,99.45845334
43379,編撰,1,613964,0.00016199,99.45861534
43380,編輯中心,1,613965,0.00016199,99.45877733
43381,編輯主任,1,613966,0.00016199,99.45893933
43382,編輯部的故事,1,613967,0.00016199,99.45910132
43383,編輯群,1,613968,0.00016199,99.45926332
43384,編織戀愛夢,1,613969,0.00016199,99.45942531
43385,編譯組,1,613970,0.00016199,99.45958730
43386,編譯器,1,613971,0.00016199,99.45974930
43387,編譯館,1,613972,0.00016199,99.45991129
43388,緣木求魚,1,613973,0.00016199,99.46007329
43389,緣起,1,613974,0.00016199,99.46023528
43390,線上中文手寫產品,1,613975,0.00016199,99.46039727
43391,線上手寫產品,1,613976,0.00016199,99.46055927
43392,線上手寫辨識技術,1,613977,0.00016199,99.46072126
43393,線上服務,1,613978,0.00016199,99.46088326
43394,線上服務公司,1,613979,0.00016199,99.46104525
43395,線上資源,1,613980,0.00016199,99.46120725
43396,線上輔助說明檔,1,613981,0.00016199,99.46136924
43397,線材業,1,613982,0.00016199,99.46153123
43398,線性,1,613983,0.00016199,99.46169323
43399,線圈,1,613984,0.00016199,99.46185522
43400,線報,1,613985,0.00016199,99.46201722
43401,線管,1,613986,0.00016199,99.46217921
43402,緩不濟急,1,613987,0.00016199,99.46234121
43403,緩刑,1,613988,0.00016199,99.46250320
43404,緩坡,1,613989,0.00016199,99.46266519
43405,緩拆,1,613990,0.00016199,99.46282719
43406,緩衝,1,613991,0.00016199,99.46298918
43407,緩衝墊,1,613992,0.00016199,99.46315118
43408,緩衝點,1,613993,0.00016199,99.46331317
43409,緹絲,1,613994,0.00016199,99.46347516
43410,罵人,1,613995,0.00016199,99.46363716
43411,罷了,1,613996,0.00016199,99.46379915
43412,罷免案,1,613997,0.00016199,99.46396115
43413,翩,1,613998,0.00016199,99.46412314
43414,翩然,1,613999,0.00016199,99.46428514
43415,翩然來臨,1,614000,0.00016199,99.46444713
43416,耦合,1,614001,0.00016199,99.46460912
43417,膝上型,1,614002,0.00016199,99.46477112
43418,膝上型電腦,1,614003,0.00016199,99.46493311
43419,膠,1,614004,0.00016199,99.46509511
43420,膠水,1,614005,0.00016199,99.46525710
43421,膠泥,1,614006,0.00016199,99.46541910
43422,膠著,1,614007,0.00016199,99.46558109
43423,膠酸,1,614008,0.00016199,99.46574308
43424,膠囊,1,614009,0.00016199,99.46590508
43425,蔽天,1,614010,0.00016199,99.46606707
43426,蓮園餐廳,1,614011,0.00016199,99.46622907
43427,蓮葉,1,614012,0.00016199,99.46639106
43428,蓮潭,1,614013,0.00016199,99.46655305
43429,蓮霧,1,614014,0.00016199,99.46671505
43430,蔬果汁,1,614015,0.00016199,99.46687704
43431,蔬果類,1,614016,0.00016199,99.46703904
43432,蔬菜沙拉,1,614017,0.00016199,99.46720103
43433,蔬菜課長,1,614018,0.00016199,99.46736303
43434,蔓生,1,614019,0.00016199,99.46752502
43435,蔓藤,1,614020,0.00016199,99.46768701
43436,蔣介石,1,614021,0.00016199,99.46784901
43437,蔣世勳,1,614022,0.00016199,99.46801100
43438,蔣以任,1,614023,0.00016199,99.46817300
43439,蔣延遠,1,614024,0.00016199,99.46833499
43440,蔣彥士,1,614025,0.00016199,99.46849699
43441,蔣勳,1,614026,0.00016199,99.46865898
43442,蔣藹炳,1,614027,0.00016199,99.46882097
43443,蔡文斌,1,614028,0.00016199,99.46898297
43444,蔡氏兄弟影業公司,1,614029,0.00016199,99.46914496
43445,蔡永常,1,614030,0.00016199,99.46930696
43446,蔡玉真,1,614031,0.00016199,99.46946895
43447,蔡兆陽,1,614032,0.00016199,99.46963094
43448,蔡安安,1,614033,0.00016199,99.46979294
43449,蔡宏圖,1,614034,0.00016199,99.46995493
43450,蔡辰洲,1,614035,0.00016199,99.47011693
43451,蔡宗昊,1,614036,0.00016199,99.47027892
43452,蔡承,1,614037,0.00016199,99.47044092
43453,蔡明華,1,614038,0.00016199,99.47060291
43454,蔡青平,1,614039,0.00016199,99.47076490
43455,蔡垂興,1,614040,0.00016199,99.47092690
43456,蔡為民,1,614041,0.00016199,99.47108889
43457,蔡振源,1,614042,0.00016199,99.47125089
43458,蔡崇振,1,614043,0.00016199,99.47141288
43459,蔡淑芬,1,614044,0.00016199,99.47157488
43460,蔡紹華,1,614045,0.00016199,99.47173687
43461,蔡勝義,1,614046,0.00016199,99.47189886
43462,蔡新源,1,614047,0.00016199,99.47206086
43463,蔡達雄,1,614048,0.00016199,99.47222285
43464,蔡慶輝,1,614049,0.00016199,99.47238485
43465,蔡慧貞,1,614050,0.00016199,99.47254684
43466,蔡鴻章,1,614051,0.00016199,99.47270883
43467,蔡繼全,1,614052,0.00016199,99.47287083
43468,蔡耀星,1,614053,0.00016199,99.47303282
43469,蓬,1,614054,0.00016199,99.47319482
43470,蓬勃發展,1,614055,0.00016199,99.47335681
43471,蓬鬆,1,614056,0.00016199,99.47351881
43472,蔥菜,1,614057,0.00016199,99.47368080
43473,蝴蝶夫人,1,614058,0.00016199,99.47384279
43474,蝦夷蔥,1,614059,0.00016199,99.47400479
43475,蝸牛,1,614060,0.00016199,99.47416678
43476,蝸居,1,614061,0.00016199,99.47432878
43477,蝙蝠,1,614062,0.00016199,99.47449077
43478,衛士,1,614063,0.00016199,99.47465277
43479,衛生局長,1,614064,0.00016199,99.47481476
43480,衛生所,1,614065,0.00016199,99.47497675
43481,衛生掩埋場,1,614066,0.00016199,99.47513875
43482,衛生部長,1,614067,0.00016199,99.47530074
43483,衛生棉,1,614068,0.00016199,99.47546274
43484,衛生棉條,1,614069,0.00016199,99.47562473
43485,衛生署長,1,614070,0.00016199,99.47578672
43486,衛希禮,1,614071,0.00016199,99.47594872
43487,衛岡動產投資顧問公司,1,614072,0.00016199,99.47611071
43488,衛城,1,614073,0.00016199,99.47627271
43489,衛浴,1,614074,0.00016199,99.47643470
43490,衛普電腦,1,614075,0.00016199,99.47659670
43491,衛普電腦台,1,614076,0.00016199,99.47675869
43492,衛普衛星電視,1,614077,0.00016199,99.47692068
43493,衛視體育台,1,614078,0.00016199,99.47708268
43494,衛爾康,1,614079,0.00016199,99.47724467
43495,衝口,1,614080,0.00016199,99.47740667
43496,衝出,1,614081,0.00016199,99.47756866
43497,衝過,1,614082,0.00016199,99.47773066
43498,衝鋒,1,614083,0.00016199,99.47789265
43499,衝鋒九號,1,614084,0.00016199,99.47805464
43500,衝鋒隊怒火街頭,1,614085,0.00016199,99.47821664
43501,衝擊性,1,614086,0.00016199,99.47837863
43502,衝擊波,1,614087,0.00016199,99.47854063
43503,褐紅色,1,614088,0.00016199,99.47870262
43504,褐黑,1,614089,0.00016199,99.47886461
43505,褐變,1,614090,0.00016199,99.47902661
43506,複,1,614091,0.00016199,99.47918860
43507,複方,1,614092,0.00016199,99.47935060
43508,複印機,1,614093,0.00016199,99.47951259
43509,複合字,1,614094,0.00016199,99.47967459
43510,複合體,1,614095,0.00016199,99.47983658
43511,複核,1,614096,0.00016199,99.47999857
43512,複勘,1,614097,0.00016199,99.48016057
43513,複習,1,614098,0.00016199,99.48032256
43514,複連,1,614099,0.00016199,99.48048456
43515,複試,1,614100,0.00016199,99.48064655
43516,複製畫,1,614101,0.00016199,99.48080855
43517,複製費,1,614102,0.00016199,99.48097054
43518,複誦,1,614103,0.00016199,99.48113253
43519,複數,1,614104,0.00016199,99.48129453
43520,複選,1,614105,0.00016199,99.48145652
43521,複雜化,1,614106,0.00016199,99.48161852
43522,褒,1,614107,0.00016199,99.48178051
43523,褒揚,1,614108,0.00016199,99.48194251
43524,誼,1,614109,0.00016199,99.48210450
43525,談及,1,614110,0.00016199,99.48226649
43526,談天,1,614111,0.00016199,99.48242849
43527,談他,1,614112,0.00016199,99.48259048
43528,談得來,1,614113,0.00016199,99.48275248
43529,談話錄,1,614114,0.00016199,99.48291447
43530,談戀愛,1,614115,0.00016199,99.48307646
43531,請客,1,614116,0.00016199,99.48323846
43532,請託,1,614117,0.00016199,99.48340045
43533,請辭,1,614118,0.00016199,99.48356245
43534,諸多,1,614119,0.00016199,99.48372444
43535,諸位,1,614120,0.00016199,99.48388644
43536,諸佛,1,614121,0.00016199,99.48404843
43537,諸葛亮,1,614122,0.00016199,99.48421042
43538,課外讀物,1,614123,0.00016199,99.48437242
43539,課目,1,614124,0.00016199,99.48453441
43540,課征,1,614125,0.00016199,99.48469641
43541,課員,1,614126,0.00016199,99.48485840
43542,課餘,1,614127,0.00016199,99.48502040
43543,調出,1,614128,0.00016199,99.48518239
43544,調式,1,614129,0.00016199,99.48534438
43545,調色,1,614130,0.00016199,99.48550638
43546,調防,1,614131,0.00016199,99.48566837
43547,調味汁,1,614132,0.00016199,99.48583037
43548,調味乳,1,614133,0.00016199,99.48599236
43549,調味品,1,614134,0.00016199,99.48615435
43550,調拌,1,614135,0.00016199,99.48631635
43551,調查人員,1,614136,0.00016199,99.48647834
43552,調查表,1,614137,0.00016199,99.48664034
43553,調查站,1,614138,0.00016199,99.48680233
43554,調查處站,1,614139,0.00016199,99.48696433
43555,調查部,1,614140,0.00016199,99.48712632
43556,調查單位,1,614141,0.00016199,99.48728831
43557,調查報告,1,614142,0.00016199,99.48745031
43558,調借,1,614143,0.00016199,99.48761230
43559,調差,1,614144,0.00016199,99.48777430
43560,調息,1,614145,0.00016199,99.48793629
43561,調料,1,614146,0.00016199,99.48809829
43562,調情酒,1,614147,0.00016199,99.48826028
43563,調理膠,1,614148,0.00016199,99.48842227
43564,調理學,1,614149,0.00016199,99.48858427
43565,調理霜,1,614150,0.00016199,99.48874626
43566,調焦系統,1,614151,0.00016199,99.48890826
43567,調節處,1,614152,0.00016199,99.48907025
43568,調調,1,614153,0.00016199,99.48923224
43569,調適力,1,614154,0.00016199,99.48939424
43570,調劑,1,614155,0.00016199,99.48955623
43571,論事,1,614156,0.00016199,99.48971823
43572,論定,1,614157,0.00016199,99.48988022
43573,論政,1,614158,0.00016199,99.49004222
43574,論勢,1,614159,0.00016199,99.49020421
43575,論罪,1,614160,0.00016199,99.49036620
43576,論說,1,614161,0.00016199,99.49052820
43577,論蝗,1,614162,0.00016199,99.49069019
43578,論調,1,614163,0.00016199,99.49085219
43579,論題,1,614164,0.00016199,99.49101418
43580,誹謗,1,614165,0.00016199,99.49117618
43581,豌豆角,1,614166,0.00016199,99.49133817
43582,豌豆苗,1,614167,0.00016199,99.49150016
43583,豌豆粉,1,614168,0.00016199,99.49166216
43584,豎琴,1,614169,0.00016199,99.49182415
43585,豬母,1,614170,0.00016199,99.49198615
43586,豬母山,1,614171,0.00016199,99.49214814
43587,豬母水村落,1,614172,0.00016199,99.49231013
43588,豬肉丸,1,614173,0.00016199,99.49247213
43589,豬肉羹,1,614174,0.00016199,99.49263412
43590,豬肝,1,614175,0.00016199,99.49279612
43591,豬圈,1,614176,0.00016199,99.49295811
43592,豬排,1,614177,0.00016199,99.49312011
43593,豬腰,1,614178,0.00016199,99.49328210
43594,賠率,1,614179,0.00016199,99.49344409
43595,賠償金額,1,614180,0.00016199,99.49360609
43596,賞玩,1,614181,0.00016199,99.49376808
43597,賞金,1,614182,0.00016199,99.49393008
43598,賞鳥,1,614183,0.00016199,99.49409207
43599,賞罰分明,1,614184,0.00016199,99.49425407
43600,賦,1,614185,0.00016199,99.49441606
43601,賦性,1,614186,0.00016199,99.49457805
43602,賦與,1,614187,0.00016199,99.49474005
43603,賭具,1,614188,0.00016199,99.49490204
43604,賭城島,1,614189,0.00016199,99.49506404
43605,賭博式,1,614190,0.00016199,99.49522603
43606,賭博者,1,614191,0.00016199,99.49538802
43607,賭博罪嫌,1,614192,0.00016199,99.49555002
43608,賭博電玩店,1,614193,0.00016199,99.49571201
43609,賢昆仲,1,614194,0.00016199,99.49587401
43610,賢能,1,614195,0.00016199,99.49603600
43611,賣命,1,614196,0.00016199,99.49619800
43612,賣況,1,614197,0.00016199,99.49635999
43613,賣相,1,614198,0.00016199,99.49652198
43614,賣量,1,614199,0.00016199,99.49668398
43615,賣熱,1,614200,0.00016199,99.49684597
43616,賣盤,1,614201,0.00016199,99.49700797
43617,賣藝,1,614202,0.00016199,99.49716996
43618,賜與,1,614203,0.00016199,99.49733196
43619,質色,1,614204,0.00016199,99.49749395
43620,質材,1,614205,0.00016199,99.49765594
43621,質性,1,614206,0.00016199,99.49781794
43622,質數積,1,614207,0.00016199,99.49797993
43623,趣聞,1,614208,0.00016199,99.49814193
43624,踫,1,614209,0.00016199,99.49830392
43625,踫面,1,614210,0.00016199,99.49846591
43626,踐,1,614211,0.00016199,99.49862791
43627,踢到鐵板,1,614212,0.00016199,99.49878990
43628,踢倒,1,614213,0.00016199,99.49895190
43629,踢球,1,614214,0.00016199,99.49911389
43630,踢館,1,614215,0.00016199,99.49927589
43631,踏足,1,614216,0.00016199,99.49943788
43632,踏勘,1,614217,0.00016199,99.49959987
43633,踏腳石,1,614218,0.00016199,99.49976187
43634,踏遍,1,614219,0.00016199,99.49992386
43635,踩住,1,614220,0.00016199,99.50008586
43636,踩街,1,614221,0.00016199,99.50024785
43637,踩腳,1,614222,0.00016199,99.50040985
43638,踩過,1,614223,0.00016199,99.50057184
43639,踡縮,1,614224,0.00016199,99.50073383
43640,踞,1,614225,0.00016199,99.50089583
43641,輝,1,614226,0.00016199,99.50105782
43642,輝泓公司,1,614227,0.00016199,99.50121982
43643,輝泓國際公司,1,614228,0.00016199,99.50138181
43644,輛車,1,614229,0.00016199,99.50154380
43645,輦宮,1,614230,0.00016199,99.50170580
43646,輦轎,1,614231,0.00016199,99.50186779
43647,輪式,1,614232,0.00016199,99.50202979
43648,輪型,1,614233,0.00016199,99.50219178
43649,輪唱,1,614234,0.00016199,99.50235378
43650,輪旋,1,614235,0.00016199,99.50251577
43651,輪換,1,614236,0.00016199,99.50267776
43652,輪替,1,614237,0.00016199,99.50283976
43653,輪軸,1,614238,0.00016199,99.50300175
43654,輪漲,1,614239,0.00016199,99.50316375
43655,輪盤,1,614240,0.00016199,99.50332574
43656,輪調制,1,614241,0.00016199,99.50348774
43657,適住性,1,614242,0.00016199,99.50364973
43658,適足,1,614243,0.00016199,99.50381172
43659,適逢,1,614244,0.00016199,99.50397372
43660,適當性,1,614245,0.00016199,99.50413571
43661,適應性,1,614246,0.00016199,99.50429771
43662,適應期,1,614247,0.00016199,99.50445970
43663,遮光,1,614248,0.00016199,99.50462169
43664,遮光罩,1,614249,0.00016199,99.50478369
43665,遮掩物,1,614250,0.00016199,99.50494568
43666,遮羞,1,614251,0.00016199,99.50510768
43667,遮陽帽,1,614252,0.00016199,99.50526967
43668,遮攔,1,614253,0.00016199,99.50543167
43669,遭拒,1,614254,0.00016199,99.50559366
43670,遭致,1,614255,0.00016199,99.50575565
43671,遭竊,1,614256,0.00016199,99.50591765
43672,遷走,1,614257,0.00016199,99.50607964
43673,遷居,1,614258,0.00016199,99.50624164
43674,遷延,1,614259,0.00016199,99.50640363
43675,遷調,1,614260,0.00016199,99.50656563
43676,遷離,1,614261,0.00016199,99.50672762
43677,鄰立,1,614262,0.00016199,99.50688961
43678,鄰里長,1,614263,0.00016199,99.50705161
43679,鄰里建設基金,1,614264,0.00016199,99.50721360
43680,鄰座,1,614265,0.00016199,99.50737560
43681,鄭乃銘,1,614266,0.00016199,99.50753759
43682,鄭文維,1,614267,0.00016199,99.50769958
43683,鄭水火,1,614268,0.00016199,99.50786158
43684,鄭如淵,1,614269,0.00016199,99.50802357
43685,鄭有利,1,614270,0.00016199,99.50818557
43686,鄭和于,1,614271,0.00016199,99.50834756
43687,鄭坤裕,1,614272,0.00016199,99.50850956
43688,鄭林經,1,614273,0.00016199,99.50867155
43689,鄭松茂,1,614274,0.00016199,99.50883354
43690,鄭美妹,1,614275,0.00016199,99.50899554
43691,鄭國樑,1,614276,0.00016199,99.50915753
43692,鄭淳元,1,614277,0.00016199,99.50931953
43693,鄭勝天,1,614278,0.00016199,99.50948152
43694,鄭博仁,1,614279,0.00016199,99.50964352
43695,鄭博文,1,614280,0.00016199,99.50980551
43696,鄭智隆,1,614281,0.00016199,99.50996750
43697,鄭善禧,1,614282,0.00016199,99.51012950
43698,鄭瑞雨,1,614283,0.00016199,99.51029149
43699,鄭蕙卿,1,614284,0.00016199,99.51045349
43700,鄭濟世,1,614285,0.00016199,99.51061548
43701,鄧先群,1,614286,0.00016199,99.51077748
43702,鄧志浩,1,614287,0.00016199,99.51093947
43703,鄧志祥,1,614288,0.00016199,99.51110146
43704,鄧肯,1,614289,0.00016199,99.51126346
43705,鄧肯吉賓斯,1,614290,0.00016199,99.51142545
43706,鄧後時代,1,614291,0.00016199,99.51158745
43707,鄧麗君基金會,1,614292,0.00016199,99.51174944
43708,鄱,1,614293,0.00016199,99.51191143
43709,醇酒,1,614294,0.00016199,99.51207343
43710,醉人,1,614295,0.00016199,99.51223542
43711,醉心,1,614296,0.00016199,99.51239742
43712,醉月湖,1,614297,0.00016199,99.51255941
43713,醉客,1,614298,0.00016199,99.51272141
43714,醉倒,1,614299,0.00016199,99.51288340
43715,醋酸,1,614300,0.00016199,99.51304539
43716,醋酸脂,1,614301,0.00016199,99.51320739
43717,銷日,1,614302,0.00016199,99.51336938
43718,銷用,1,614303,0.00016199,99.51353138
43719,銷售人,1,614304,0.00016199,99.51369337
43720,銷售人員,1,614305,0.00016199,99.51385537
43721,銷售商,1,614306,0.00016199,99.51401736
43722,銷售期,1,614307,0.00016199,99.51417935
43723,銷售群,1,614308,0.00016199,99.51434135
43724,銷售網,1,614309,0.00016199,99.51450334
43725,銷售網絡,1,614310,0.00016199,99.51466534
43726,銷售額,1,614311,0.00016199,99.51482733
43727,銷帳,1,614312,0.00016199,99.51498932
43728,銷貨量,1,614313,0.00016199,99.51515132
43729,鋪上,1,614314,0.00016199,99.51531331
43730,鋪張,1,614315,0.00016199,99.51547531
43731,鋪貨,1,614316,0.00016199,99.51563730
43732,鋪蓋,1,614317,0.00016199,99.51579930
43733,銬,1,614318,0.00016199,99.51596129
43734,銬住,1,614319,0.00016199,99.51612328
43735,鋤草,1,614320,0.00016199,99.51628528
43736,鋁,1,614321,0.00016199,99.51644727
43737,鋁材,1,614322,0.00016199,99.51660927
43738,鋁板,1,614323,0.00016199,99.51677126
43739,鋁門,1,614324,0.00016199,99.51693326
43740,鋁桶,1,614325,0.00016199,99.51709525
43741,鋁電線,1,614326,0.00016199,99.51725724
43742,鋁電纜,1,614327,0.00016199,99.51741924
43743,鋁製,1,614328,0.00016199,99.51758123
43744,鋁線,1,614329,0.00016199,99.51774323
43745,銳利度,1,614330,0.00016199,99.51790522
43746,銳跑,1,614331,0.00016199,99.51806721
43747,鋒芒,1,614332,0.00016199,99.51822921
43748,鋒頭,1,614333,0.00016199,99.51839120
43749,鋰電池,1,614334,0.00016199,99.51855320
43750,閱兵,1,614335,0.00016199,99.51871519
43751,閱兵大典,1,614336,0.00016199,99.51887719
43752,閱覽,1,614337,0.00016199,99.51903918
43753,震天價響,1,614338,0.00016199,99.51920117
43754,震耳,1,614339,0.00016199,99.51936317
43755,震源,1,614340,0.00016199,99.51952516
43756,震撼性,1,614341,0.00016199,99.51968716
43757,震撼性醜聞,1,614342,0.00016199,99.51984915
43758,震撼教育,1,614343,0.00016199,99.52001115
43759,震撼感,1,614344,0.00016199,99.52017314
43760,震蕩,1,614345,0.00016199,99.52033513
43761,震頻,1,614346,0.00016199,99.52049713
43762,霉斑,1,614347,0.00016199,99.52065912
43763,霉運,1,614348,0.00016199,99.52082112
43764,靠不住,1,614349,0.00016199,99.52098311
43765,靠放,1,614350,0.00016199,99.52114510
43766,靠門,1,614351,0.00016199,99.52130710
43767,鞍袋,1,614352,0.00016199,99.52146909
43768,鞋尖,1,614353,0.00016199,99.52163109
43769,鞋底,1,614354,0.00016199,99.52179308
43770,鞋業,1,614355,0.00016199,99.52195508
43771,鞋擦,1,614356,0.00016199,99.52211707
43772,頜骨,1,614357,0.00016199,99.52227906
43773,颳,1,614358,0.00016199,99.52244106
43774,養份,1,614359,0.00016199,99.52260305
43775,養羊,1,614360,0.00016199,99.52276505
43776,養老院,1,614361,0.00016199,99.52292704
43777,養育法,1,614362,0.00016199,99.52308904
43778,養身之道,1,614363,0.00016199,99.52325103
43779,養家活口,1,614364,0.00016199,99.52341302
43780,養殖場,1,614365,0.00016199,99.52357502
43781,養精蓄銳,1,614366,0.00016199,99.52373701
43782,養樂多公司,1,614367,0.00016199,99.52389901
43783,養豬業,1,614368,0.00016199,99.52406100
43784,養鵝池,1,614369,0.00016199,99.52422299
43785,餘力,1,614370,0.00016199,99.52438499
43786,餘地,1,614371,0.00016199,99.52454698
43787,餘屋,1,614372,0.00016199,99.52470898
43788,駝子,1,614373,0.00016199,99.52487097
43789,駝背,1,614374,0.00016199,99.52503297
43790,駝鳥心態,1,614375,0.00016199,99.52519496
43791,駝鳥主人俱樂部,1,614376,0.00016199,99.52535695
43792,駐台,1,614377,0.00016199,99.52551895
43793,駐立,1,614378,0.00016199,99.52568094
43794,駐守,1,614379,0.00016199,99.52584294
43795,駐防,1,614380,0.00016199,99.52600493
43796,駐美代表,1,614381,0.00016199,99.52616693
43797,駐留,1,614382,0.00016199,99.52632892
43798,駐進,1,614383,0.00016199,99.52649091
43799,駐蹕,1,614384,0.00016199,99.52665291
43800,駛入,1,614385,0.00016199,99.52681490
43801,駛出,1,614386,0.00016199,99.52697690
43802,駕車族,1,614387,0.00016199,99.52713889
43803,駕崩,1,614388,0.00016199,99.52730088
43804,駕御,1,614389,0.00016199,99.52746288
43805,駕著,1,614390,0.00016199,99.52762487
43806,駕馭者,1,614391,0.00016199,99.52778687
43807,駕照,1,614392,0.00016199,99.52794886
43808,駕駛者,1,614393,0.00016199,99.52811086
43809,髮夾,1,614394,0.00016199,99.52827285
43810,髮尾,1,614395,0.00016199,99.52843484
43811,髮型師,1,614396,0.00016199,99.52859684
43812,髮菜,1,614397,0.00016199,99.52875883
43813,髮際,1,614398,0.00016199,99.52892083
43814,髮髻,1,614399,0.00016199,99.52908282
43815,髮辮,1,614400,0.00016199,99.52924482
43816,髮綹,1,614401,0.00016199,99.52940681
43817,鬧事,1,614402,0.00016199,99.52956880
43818,鬧哄哄,1,614403,0.00016199,99.52973080
43819,鬧笑話,1,614404,0.00016199,99.52989279
43820,鬧街,1,614405,0.00016199,99.53005479
43821,鬧意見,1,614406,0.00016199,99.53021678
43822,鬧鈴,1,614407,0.00016199,99.53037877
43823,鬧劇,1,614408,0.00016199,99.53054077
43824,鬧熱滾滾,1,614409,0.00016199,99.53070276
43825,鬧翻,1,614410,0.00016199,99.53086476
43826,鬧雙包,1,614411,0.00016199,99.53102675
43827,魅力四射,1,614412,0.00016199,99.53118875
43828,魅影,1,614413,0.00016199,99.53135074
43829,魯仲連式,1,614414,0.00016199,99.53151273
43830,魯虹,1,614415,0.00016199,99.53167473
43831,魯迪亞城,1,614416,0.00016199,99.53183672
43832,魯茲,1,614417,0.00016199,99.53199872
43833,魯湘,1,614418,0.00016199,99.53216071
43834,魯道夫,1,614419,0.00016199,99.53232271
43835,鴉,1,614420,0.00016199,99.53248470
43836,鴉片戰爭,1,614421,0.00016199,99.53264669
43837,麩胺酸鈉,1,614422,0.00016199,99.53280869
43838,黎,1,614423,0.00016199,99.53297068
43839,黎世明,1,614424,0.00016199,99.53313268
43840,黎智英,1,614425,0.00016199,99.53329467
43841,黎筍,1,614426,0.00016199,99.53345666
43842,黎德英,1,614427,0.00016199,99.53361866
43843,黎燕珊,1,614428,0.00016199,99.53378065
43844,墨守成規,1,614429,0.00016199,99.53394265
43845,墨菲,1,614430,0.00016199,99.53410464
43846,墨綠,1,614431,0.00016199,99.53426664
43847,齒式,1,614432,0.00016199,99.53442863
43848,齒頰,1,614433,0.00016199,99.53459062
43849,儒家思想,1,614434,0.00016199,99.53475262
43850,冀望,1,614435,0.00016199,99.53491461
43851,凝成,1,614436,0.00016199,99.53507661
43852,凝思,1,614437,0.00016199,99.53523860
43853,凝神,1,614438,0.00016199,99.53540060
43854,凝結尾,1,614439,0.00016199,99.53556259
43855,凝聚力,1,614440,0.00016199,99.53572458
43856,凝膠狀,1,614441,0.00016199,99.53588658
43857,噪音比,1,614442,0.00016199,99.53604857
43858,噪音費,1,614443,0.00016199,99.53621057
43859,器皿,1,614444,0.00016199,99.53637256
43860,器材行,1,614445,0.00016199,99.53653455
43861,器材費,1,614446,0.00016199,99.53669655
43862,器物,1,614447,0.00016199,99.53685854
43863,器重,1,614448,0.00016199,99.53702054
43864,器樂,1,614449,0.00016199,99.53718253
43865,噢,1,614450,0.00016199,99.53734453
43866,壁上觀,1,614451,0.00016199,99.53750652
43867,壁櫥,1,614452,0.00016199,99.53766851
43868,墾,1,614453,0.00016199,99.53783051
43869,墾丁國家公園管理處,1,614454,0.00016199,99.53799250
43870,墾殖,1,614455,0.00016199,99.53815450
43871,奮力一搏,1,614456,0.00016199,99.53831649
43872,奮戰,1,614457,0.00016199,99.53847849
43873,學人,1,614458,0.00016199,99.53864048
43874,學生證,1,614459,0.00016199,99.53880247
43875,學甲慈濟宮丙子年香科上白礁謁祖遶境祭典,1,614460,0.00016199,99.53896447
43876,學甲鎮,1,614461,0.00016199,99.53912646
43877,學年度,1,614462,0.00016199,99.53928846
43878,學佛,1,614463,0.00016199,99.53945045
43879,學妹,1,614464,0.00016199,99.53961245
43880,學官型,1,614465,0.00016199,99.53977444
43881,學長,1,614466,0.00016199,99.53993643
43882,學風,1,614467,0.00016199,99.54009843
43883,學院派,1,614468,0.00016199,99.54026042
43884,學習力,1,614469,0.00016199,99.54042242
43885,學習者,1,614470,0.00016199,99.54058441
43886,學習型,1,614471,0.00016199,99.54074640
43887,學術性,1,614472,0.00016199,99.54090840
43888,學程,1,614473,0.00016199,99.54107039
43889,學經歷,1,614474,0.00016199,99.54123239
43890,學養,1,614475,0.00016199,99.54139438
43891,學學,1,614476,0.00016199,99.54155638
43892,學歷證件,1,614477,0.00016199,99.54171837
43893,學藝,1,614478,0.00016199,99.54188036
43894,學齡,1,614479,0.00016199,99.54204236
43895,學齡層,1,614480,0.00016199,99.54220435
43896,寰宇,1,614481,0.00016199,99.54236635
43897,導火線,1,614482,0.00016199,99.54252834
43898,導因,1,614483,0.00016199,99.54269034
43899,導尿管,1,614484,0.00016199,99.54285233
43900,導言,1,614485,0.00016199,99.54301432
43901,導流,1,614486,0.00016199,99.54317632
43902,導師,1,614487,0.00016199,99.54333831
43903,導源,1,614488,0.00016199,99.54350031
43904,導演筒,1,614489,0.00016199,99.54366230
43905,導領人,1,614490,0.00016199,99.54382429
43906,憲改,1,614491,0.00016199,99.54398629
43907,憲政報,1,614492,0.00016199,99.54414828
43908,憲政論壇,1,614493,0.00016199,99.54431028
43909,憲政機關,1,614494,0.00016199,99.54447227
43910,憑白無故,1,614495,0.00016199,99.54463427
43911,懈,1,614496,0.00016199,99.54479626
43912,戰史,1,614497,0.00016199,99.54495825
43913,戰地,1,614498,0.00016199,99.54512025
43914,戰死,1,614499,0.00016199,99.54528224
43915,戰技,1,614500,0.00016199,99.54544424
43916,戰帖,1,614501,0.00016199,99.54560623
43917,戰果,1,614502,0.00016199,99.54576823
43918,戰法,1,614503,0.00016199,99.54593022
43919,戰爭學院,1,614504,0.00016199,99.54609221
43920,戰盾,1,614505,0.00016199,99.54625421
43921,戰時,1,614506,0.00016199,99.54641620
43922,戰鬥群,1,614507,0.00016199,99.54657820
43923,戰鬥體,1,614508,0.00016199,99.54674019
43924,戰將,1,614509,0.00016199,99.54690218
43925,戰略偵察部隊,1,614510,0.00016199,99.54706418
43926,戰備槍,1,614511,0.00016199,99.54722617
43927,戰勝股市,1,614512,0.00016199,99.54738817
43928,戰無不勝,1,614513,0.00016199,99.54755016
43929,戰慄殺機,1,614514,0.00016199,99.54771216
43930,戰搜,1,614515,0.00016199,99.54787415
43931,戰損中心,1,614516,0.00016199,99.54803614
43932,戰損管制台,1,614517,0.00016199,99.54819814
43933,戰損管制區,1,614518,0.00016199,99.54836013
43934,戰歌,1,614519,0.00016199,99.54852213
43935,戰端,1,614520,0.00016199,99.54868412
43936,戰壕,1,614521,0.00016199,99.54884612
43937,擁入,1,614522,0.00016199,99.54900811
43938,擁有率,1,614523,0.00016199,99.54917010
43939,擁有權,1,614524,0.00016199,99.54933210
43940,擁吻,1,614525,0.00016199,99.54949409
43941,擁抱未來,1,614526,0.00016199,99.54965609
43942,擁進,1,614527,0.00016199,99.54981808
43943,擁塞,1,614528,0.00016199,99.54998007
43944,擁戴,1,614529,0.00016199,99.55014207
43945,擁護者,1,614530,0.00016199,99.55030406
43946,擋不住,1,614531,0.00016199,99.55046606
43947,擋不住的奇蹟,1,614532,0.00016199,99.55062805
43948,擋事,1,614533,0.00016199,99.55079005
43949,擋泥板,1,614534,0.00016199,99.55095204
43950,擋箭牌,1,614535,0.00016199,99.55111403
43951,撻伐,1,614536,0.00016199,99.55127603
43952,撻訂,1,614537,0.00016199,99.55143802
43953,據地,1,614538,0.00016199,99.55160002
43954,據傳,1,614539,0.00016199,99.55176201
43955,據實,1,614540,0.00016199,99.55192401
43956,據實以答,1,614541,0.00016199,99.55208600
43957,據聞,1,614542,0.00016199,99.55224799
43958,擄獲,1,614543,0.00016199,99.55240999
43959,擂擊,1,614544,0.00016199,99.55257198
43960,操作者,1,614545,0.00016199,99.55273398
43961,操作面板,1,614546,0.00016199,99.55289597
43962,操兵,1,614547,0.00016199,99.55305796
43963,操控權,1,614548,0.00016199,99.55321996
43964,操勞,1,614549,0.00016199,99.55338195
43965,操盤,1,614550,0.00016199,99.55354395
43966,操縱者,1,614551,0.00016199,99.55370594
43967,撿來,1,614552,0.00016199,99.55386794
43968,撿到,1,614553,0.00016199,99.55402993
43969,擒,1,614554,0.00016199,99.55419192
43970,擒下,1,614555,0.00016199,99.55435392
43971,擔子,1,614556,0.00016199,99.55451591
43972,擔目,1,614557,0.00016199,99.55467791
43973,擔保物權,1,614558,0.00016199,99.55483990
43974,整天,1,614559,0.00016199,99.55500190
43975,整日,1,614560,0.00016199,99.55516389
43976,整件,1,614561,0.00016199,99.55532588
43977,整份,1,614562,0.00016199,99.55548788
43978,整合式,1,614563,0.00016199,99.55564987
43979,整合性,1,614564,0.00016199,99.55581187
43980,整夜,1,614565,0.00016199,99.55597386
43981,整垮,1,614566,0.00016199,99.55613585
43982,整流,1,614567,0.00016199,99.55629785
43983,整軍,1,614568,0.00016199,99.55645984
43984,整排,1,614569,0.00016199,99.55662184
43985,整理操,1,614570,0.00016199,99.55678383
43986,整髮,1,614571,0.00016199,99.55694583
43987,整整齊齊,1,614572,0.00016199,99.55710782
43988,整體而言,1,614573,0.00016199,99.55726981
43989,曉以大義,1,614574,0.00016199,99.55743181
43990,樸,1,614575,0.00016199,99.55759380
43991,樸實無華,1,614576,0.00016199,99.55775580
43992,樺斑蝶,1,614577,0.00016199,99.55791779
43993,樺樹,1,614578,0.00016199,99.55807979
43994,橙紅,1,614579,0.00016199,99.55824178
43995,橙紅色,1,614580,0.00016199,99.55840377
43996,橙黃,1,614581,0.00016199,99.55856577
43997,橫山大觀,1,614582,0.00016199,99.55872776
43998,橫生枝節,1,614583,0.00016199,99.55888976
43999,橫亙,1,614584,0.00016199,99.55905175
44000,橫向協調,1,614585,0.00016199,99.55921374
44001,橫放,1,614586,0.00016199,99.55937574
44002,橫拿,1,614587,0.00016199,99.55953773
44003,橫財,1,614588,0.00016199,99.55969973
44004,橫匾,1,614589,0.00016199,99.55986172
44005,橫掃,1,614590,0.00016199,99.56002372
44006,橫掃千軍,1,614591,0.00016199,99.56018571
44007,橫絆式,1,614592,0.00016199,99.56034770
44008,橫貫,1,614593,0.00016199,99.56050970
44009,橫須賀軍港,1,614594,0.00016199,99.56067169
44010,橫置引擎,1,614595,0.00016199,99.56083369
44011,橫過,1,614596,0.00016199,99.56099568
44012,橫禍,1,614597,0.00016199,99.56115768
44013,橫衝直撞,1,614598,0.00016199,99.56131967
44014,橘子皮,1,614599,0.00016199,99.56148166
44015,橘色,1,614600,0.00016199,99.56164366
44016,樹肉,1,614601,0.00016199,99.56180565
44017,樹林站,1,614602,0.00016199,99.56196765
44018,樹林國小,1,614603,0.00016199,99.56212964
44019,樹林焚化廠,1,614604,0.00016199,99.56229163
44020,樹林焚化爐,1,614605,0.00016199,99.56245363
44021,樹冠,1,614606,0.00016199,99.56261562
44022,樹苗,1,614607,0.00016199,99.56277762
44023,樹脂纖維,1,614608,0.00016199,99.56293961
44024,樹節,1,614609,0.00016199,99.56310161
44025,樹種,1,614610,0.00016199,99.56326360
44026,樹膠期貨公司,1,614611,0.00016199,99.56342559
44027,樹蔭,1,614612,0.00016199,99.56358759
44028,樹叢,1,614613,0.00016199,99.56374958
44029,橄欖球狀,1,614614,0.00016199,99.56391158
44030,橡木,1,614615,0.00016199,99.56407357
44031,橡皮筋,1,614616,0.00016199,99.56423557
44032,橡皮擦,1,614617,0.00016199,99.56439756
44033,橡塑膠,1,614618,0.00016199,99.56455955
44034,橋本,1,614619,0.00016199,99.56472155
44035,橋牌,1,614620,0.00016199,99.56488354
44036,橋墩,1,614621,0.00016199,99.56504554
44037,橋頭,1,614622,0.00016199,99.56520753
44038,機子,1,614623,0.00016199,99.56536952
44039,機心,1,614624,0.00016199,99.56553152
44040,機件,1,614625,0.00016199,99.56569351
44041,機車隊,1,614626,0.00016199,99.56585551
44042,機車廠,1,614627,0.00016199,99.56601750
44043,機油,1,614628,0.00016199,99.56617950
44044,機械工程,1,614629,0.00016199,99.56634149
44045,機械工程師,1,614630,0.00016199,99.56650348
44046,機棚,1,614631,0.00016199,99.56666548
44047,機減,1,614632,0.00016199,99.56682747
44048,機電股,1,614633,0.00016199,99.56698947
44049,機電整合,1,614634,0.00016199,99.56715146
44050,機漁船,1,614635,0.00016199,99.56731346
44051,機鼻,1,614636,0.00016199,99.56747545
44052,機艙,1,614637,0.00016199,99.56763744
44053,機謀,1,614638,0.00016199,99.56779944
44054,機關槍,1,614639,0.00016199,99.56796143
44055,機靈,1,614640,0.00016199,99.56812343
44056,歷久不衰,1,614641,0.00016199,99.56828542
44057,歷史博物館,1,614642,0.00016199,99.56844742
44058,歷史學家,1,614643,0.00016199,99.56860941
44059,澱,1,614644,0.00016199,99.56877140
44060,澱粉類,1,614645,0.00016199,99.56893340
44061,澡缸,1,614646,0.00016199,99.56909539
44062,濃妝,1,614647,0.00016199,99.56925739
44063,濃妝艷抹,1,614648,0.00016199,99.56941938
44064,濃茶,1,614649,0.00016199,99.56958137
44065,濃密,1,614650,0.00016199,99.56974337
44066,濃密度,1,614651,0.00016199,99.56990536
44067,濃情,1,614652,0.00016199,99.57006736
44068,濃淡度,1,614653,0.00016199,99.57022935
44069,濃煙,1,614654,0.00016199,99.57039135
44070,濃稠,1,614655,0.00016199,99.57055334
44071,濃濃密密,1,614656,0.00016199,99.57071533
44072,濃縮度,1,614657,0.00016199,99.57087733
44073,澤,1,614658,0.00016199,99.57103932
44074,澤蛙,1,614659,0.00016199,99.57120132
44075,澳門人,1,614660,0.00016199,99.57136331
44076,澳門片,1,614661,0.00016199,99.57152531
44077,澳洲永聯基金公司,1,614662,0.00016199,99.57168730
44078,澳洲永聯黃金基金,1,614663,0.00016199,99.57184929
44079,澳洲國家現代舞團,1,614664,0.00016199,99.57201129
44080,澳洲國營鹽業公司,1,614665,0.00016199,99.57217328
44081,激化,1,614666,0.00016199,99.57233528
44082,激光,1,614667,0.00016199,99.57249727
44083,激流,1,614668,0.00016199,99.57265926
44084,激素,1,614669,0.00016199,99.57282126
44085,激憤,1,614670,0.00016199,99.57298325
44086,激戰,1,614671,0.00016199,99.57314525
44087,澹,1,614672,0.00016199,99.57330724
44088,熾,1,614673,0.00016199,99.57346924
44089,熾熱,1,614674,0.00016199,99.57363123
44090,燒酒蝦,1,614675,0.00016199,99.57379322
44091,燒飯,1,614676,0.00016199,99.57395522
44092,燒傷,1,614677,0.00016199,99.57411721
44093,燒傷中心,1,614678,0.00016199,99.57427921
44094,燒熱,1,614679,0.00016199,99.57444120
44095,燒壞,1,614680,0.00016199,99.57460320
44096,燈泡,1,614681,0.00016199,99.57476519
44097,燈柱,1,614682,0.00016199,99.57492718
44098,燈架,1,614683,0.00016199,99.57508918
44099,燈紅酒綠,1,614684,0.00016199,99.57525117
44100,燈節,1,614685,0.00016199,99.57541317
44101,燈謎,1,614686,0.00016199,99.57557516
44102,燕巢鄉,1,614687,0.00016199,99.57573715
44103,燕麥糊,1,614688,0.00016199,99.57589915
44104,燕類,1,614689,0.00016199,99.57606114
44105,燙彼,1,614690,0.00016199,99.57622314
44106,燃油運輸艦,1,614691,0.00016199,99.57638513
44107,燃眉之急,1,614692,0.00016199,99.57654713
44108,燃料,1,614693,0.00016199,99.57670912
44109,燃燒室,1,614694,0.00016199,99.57687111
44110,燃燒器,1,614695,0.00016199,99.57703311
44111,獨生女,1,614696,0.00016199,99.57719510
44112,獨白式,1,614697,0.00016199,99.57735710
44113,獨立作戰隊,1,614698,0.00016199,99.57751909
44114,獨立紀念日,1,614699,0.00016199,99.57768109
44115,獨立級,1,614700,0.00016199,99.57784308
44116,獨立戰爭,1,614701,0.00016199,99.57800507
44117,獨有,1,614702,0.00016199,99.57816707
44118,獨具一格,1,614703,0.00016199,99.57832906
44119,獨厚,1,614704,0.00016199,99.57849106
44120,獨奏,1,614705,0.00016199,99.57865305
44121,獨奏家,1,614706,0.00016199,99.57881504
44122,獨唱,1,614707,0.00016199,99.57897704
44123,獨唱家,1,614708,0.00016199,99.57913903
44124,獨唱會,1,614709,0.00016199,99.57930103
44125,獨得,1,614710,0.00016199,99.57946302
44126,獨創,1,614711,0.00016199,99.57962502
44127,獨創一格,1,614712,0.00016199,99.57978701
44128,獨裁者,1,614713,0.00016199,99.57994900
44129,獨領風騷,1,614714,0.00016199,99.58011100
44130,獨撐,1,614715,0.00016199,99.58027299
44131,獨樂樂,1,614716,0.00016199,99.58043499
44132,獨斷,1,614717,0.00016199,99.58059698
44133,瘸腿鴨,1,614718,0.00016199,99.58075898
44134,盧,1,614719,0.00016199,99.58092097
44135,盧大中,1,614720,0.00016199,99.58108296
44136,盧山,1,614721,0.00016199,99.58124496
44137,盧介華,1,614722,0.00016199,99.58140695
44138,盧志高,1,614723,0.00016199,99.58156895
44139,盧見特,1,614724,0.00016199,99.58173094
44140,盧柏仲,1,614725,0.00016199,99.58189293
44141,盧柏宜,1,614726,0.00016199,99.58205493
44142,盧修一,1,614727,0.00016199,99.58221692
44143,盧斯蘭與魯密拉,1,614728,0.00016199,99.58237892
44144,盧森堡,1,614729,0.00016199,99.58254091
44145,盧德允,1,614730,0.00016199,99.58270291
44146,盧繼先,1,614731,0.00016199,99.58286490
44147,瞠,1,614732,0.00016199,99.58302689
44148,瞞,1,614733,0.00016199,99.58318889
44149,瞥,1,614734,0.00016199,99.58335088
44150,磨刀霍霍,1,614735,0.00016199,99.58351288
44151,磨去,1,614736,0.00016199,99.58367487
44152,磨合,1,614737,0.00016199,99.58383687
44153,磨合期,1,614738,0.00016199,99.58399886
44154,磨成,1,614739,0.00016199,99.58416085
44155,磨耗,1,614740,0.00016199,99.58432285
44156,磨豉醬,1,614741,0.00016199,99.58448484
44157,磨滅,1,614742,0.00016199,99.58464684
44158,磨製,1,614743,0.00016199,99.58480883
44159,磨擦,1,614744,0.00016199,99.58497082
44160,磨菇,1,614745,0.00016199,99.58513282
44161,磬,1,614746,0.00016199,99.58529481
44162,磧,1,614747,0.00016199,99.58545681
44163,禦,1,614748,0.00016199,99.58561880
44164,積少成多,1,614749,0.00016199,99.58578080
44165,積木,1,614750,0.00016199,99.58594279
44166,積弱不振,1,614751,0.00016199,99.58610478
44167,積習,1,614752,0.00016199,99.58626678
44168,積極性,1,614753,0.00016199,99.58642877
44169,積極型,1,614754,0.00016199,99.58659077
44170,積聚,1,614755,0.00016199,99.58675276
44171,積聚起來,1,614756,0.00016199,99.58691476
44172,積德,1,614757,0.00016199,99.58707675
44173,積體電路,1,614758,0.00016199,99.58723874
44174,穆拉汶斯基,1,614759,0.00016199,99.58740074
44175,穆索斯基,1,614760,0.00016199,99.58756273
44176,穆梭斯基,1,614761,0.00016199,99.58772473
44177,窺出,1,614762,0.00016199,99.58788672
44178,窺知,1,614763,0.00016199,99.58804871
44179,窺視慾,1,614764,0.00016199,99.58821071
44180,窺檢,1,614765,0.00016199,99.58837270
44181,築成,1,614766,0.00016199,99.58853470
44182,築巢開發公司,1,614767,0.00016199,99.58869669
44183,篤定,1,614768,0.00016199,99.58885869
44184,篤實,1,614769,0.00016199,99.58902068
44185,篡改,1,614770,0.00016199,99.58918267
44186,篩除,1,614771,0.00016199,99.58934467
44187,篩選值,1,614772,0.00016199,99.58950666
44188,糕餅,1,614773,0.00016199,99.58966866
44189,糕點,1,614774,0.00016199,99.58983065
44190,糖果,1,614775,0.00016199,99.58999265
44191,糖果屋,1,614776,0.00016199,99.59015464
44192,糖粉,1,614777,0.00016199,99.59031663
44193,糖業,1,614778,0.00016199,99.59047863
44194,糖蒸酥烙,1,614779,0.00016199,99.59064062
44195,糖價,1,614780,0.00016199,99.59080262
44196,糖漿,1,614781,0.00016199,99.59096461
44197,糖質,1,614782,0.00016199,99.59112660
44198,糖類,1,614783,0.00016199,99.59128860
44199,縊,1,614784,0.00016199,99.59145059
44200,縈懷不去,1,614785,0.00016199,99.59161259
44201,縣太爺,1,614786,0.00016199,99.59177458
44202,縣府路,1,614787,0.00016199,99.59193658
44203,縣長室,1,614788,0.00016199,99.59209857
44204,縣城,1,614789,0.00016199,99.59226056
44205,縣衙,1,614790,0.00016199,99.59242256
44206,縣轄市,1,614791,0.00016199,99.59258455
44207,縐,1,614792,0.00016199,99.59274655
44208,罹患率,1,614793,0.00016199,99.59290854
44209,翱翔,1,614794,0.00016199,99.59307054
44210,膨化食品,1,614795,0.00016199,99.59323253
44211,膨脹壓,1,614796,0.00016199,99.59339452
44212,膨鬆,1,614797,0.00016199,99.59355652
44213,興大,1,614798,0.00016199,99.59371851
44214,興南實業公司,1,614799,0.00016199,99.59388051
44215,興致,1,614800,0.00016199,99.59404250
44216,興票,1,614801,0.00016199,99.59420450
44217,興訟,1,614802,0.00016199,99.59436649
44218,興業銀行,1,614803,0.00016199,99.59452848
44219,興農牛,1,614804,0.00016199,99.59469048
44220,興農牛隊,1,614805,0.00016199,99.59485247
44221,興達,1,614806,0.00016199,99.59501447
44222,興趣缺缺,1,614807,0.00016199,99.59517646
44223,興奮感,1,614808,0.00016199,99.59533845
44224,興奮劑,1,614809,0.00016199,99.59550045
44225,興辦人,1,614810,0.00016199,99.59566244
44226,興優除弊,1,614811,0.00016199,99.59582444
44227,艙房,1,614812,0.00016199,99.59598643
44228,艙蓋,1,614813,0.00016199,99.59614843
44229,蕨類,1,614814,0.00016199,99.59631042
44230,蕩人,1,614815,0.00016199,99.59647241
44231,蕩漾,1,614816,0.00016199,99.59663441
44232,蕃,1,614817,0.00016199,99.59679640
44233,蕭士塔高,1,614818,0.00016199,99.59695840
44234,蕭介仁,1,614819,0.00016199,99.59712039
44235,蕭美玲,1,614820,0.00016199,99.59728239
44236,蕭峰雄,1,614821,0.00016199,99.59744438
44237,蕭馬堤,1,614822,0.00016199,99.59760637
44238,蕭淑麗,1,614823,0.00016199,99.59776837
44239,蕭笙,1,614824,0.00016199,99.59793036
44240,蕭塔高維契,1,614825,0.00016199,99.59809236
44241,蕭裕振,1,614826,0.00016199,99.59825435
44242,蕭寧馨,1,614827,0.00016199,99.59841634
44243,螢火蟲,1,614828,0.00016199,99.59857834
44244,螢火蟲洞,1,614829,0.00016199,99.59874033
44245,螢光色,1,614830,0.00016199,99.59890233
44246,螢光幕,1,614831,0.00016199,99.59906432
44247,螢光燈,1,614832,0.00016199,99.59922632
44248,螢屏,1,614833,0.00016199,99.59938831
44249,螢幕區,1,614834,0.00016199,99.59955030
44250,融合度,1,614835,0.00016199,99.59971230
44251,融接,1,614836,0.00016199,99.59987429
44252,融匯,1,614837,0.00016199,99.60003629
44253,融會貫通,1,614838,0.00016199,99.60019828
44254,融解,1,614839,0.00016199,99.60036028
44255,融資篇,1,614840,0.00016199,99.60052227
44256,衡,1,614841,0.00016199,99.60068426
44257,衡酌,1,614842,0.00016199,99.60084626
44258,衡諸,1,614843,0.00016199,99.60100825
44259,褲腳,1,614844,0.00016199,99.60117025
44260,褲裝,1,614845,0.00016199,99.60133224
44261,褲襠,1,614846,0.00016199,99.60149423
44262,親子活動,1,614847,0.00016199,99.60165623
44263,親子旅遊,1,614848,0.00016199,99.60181822
44264,親子運動,1,614849,0.00016199,99.60198022
44265,親生,1,614850,0.00016199,99.60214221
44266,親自出馬,1,614851,0.00016199,99.60230421
44267,親和,1,614852,0.00016199,99.60246620
44268,親信,1,614853,0.00016199,99.60262819
44269,親赴,1,614854,0.00016199,99.60279019
44270,親家,1,614855,0.00016199,99.60295218
44271,親家母,1,614856,0.00016199,99.60311418
44272,親校,1,614857,0.00016199,99.60327617
44273,親密地,1,614858,0.00016199,99.60343817
44274,親密關係,1,614859,0.00016199,99.60360016
44275,親疏,1,614860,0.00016199,99.60376215
44276,親眼目睹,1,614861,0.00016199,99.60392415
44277,親筆函,1,614862,0.00016199,99.60408614
44278,親貴,1,614863,0.00016199,99.60424814
44279,親愛的名字,1,614864,0.00016199,99.60441013
44280,親蜜,1,614865,0.00016199,99.60457212
44281,親屬,1,614866,0.00016199,99.60473412
44282,諱言,1,614867,0.00016199,99.60489611
44283,謀士,1,614868,0.00016199,99.60505811
44284,謀和,1,614869,0.00016199,99.60522010
44285,謀財害命,1,614870,0.00016199,99.60538210
44286,諧協,1,614871,0.00016199,99.60554409
44287,諮商,1,614872,0.00016199,99.60570608
44288,諮商人員,1,614873,0.00016199,99.60586808
44289,諮詢業,1,614874,0.00016199,99.60603007
44290,諾史東百貨,1,614875,0.00016199,99.60619207
44291,諾汀,1,614876,0.00016199,99.60635406
44292,諾貝爾,1,614877,0.00016199,99.60651606
44293,諾貝爾化學獎,1,614878,0.00016199,99.60667805
44294,諾貝爾和平獎,1,614879,0.00016199,99.60684004
44295,諾門．霍爾,1,614880,0.00016199,99.60700204
44296,諾曼地,1,614881,0.00016199,99.60716403
44297,諾曼傑維森,1,614882,0.00016199,99.60732603
44298,諾斯羅普格魯曼公司,1,614883,0.00016199,99.60748802
44299,諾瑞爾,1,614884,0.00016199,99.60765001
44300,諷世,1,614885,0.00016199,99.60781201
44301,諳,1,614886,0.00016199,99.60797400
44302,豫劇組,1,614887,0.00016199,99.60813600
44303,貓兒,1,614888,0.00016199,99.60829799
44304,貓咪,1,614889,0.00016199,99.60845999
44305,貓科動物,1,614890,0.00016199,99.60862198
44306,貓眼,1,614891,0.00016199,99.60878397
44307,賴少其,1,614892,0.00016199,99.60894597
44308,賴以維生,1,614893,0.00016199,99.60910796
44309,賴正穎,1,614894,0.00016199,99.60926996
44310,賴利,1,614895,0.00016199,99.60943195
44311,賴佳宏,1,614896,0.00016199,99.60959395
44312,賴建榮,1,614897,0.00016199,99.60975594
44313,賴春生,1,614898,0.00016199,99.60991793
44314,賴珮珊,1,614899,0.00016199,99.61007993
44315,賴索托,1,614900,0.00016199,99.61024192
44316,賴清德,1,614901,0.00016199,99.61040392
44317,賴朝宏,1,614902,0.00016199,99.61056591
44318,賴雅雯,1,614903,0.00016199,99.61072790
44319,賴瑞,1,614904,0.00016199,99.61088990
44320,賴瑞昌,1,614905,0.00016199,99.61105189
44321,賴榮興,1,614906,0.00016199,99.61121389
44322,賴福順,1,614907,0.00016199,99.61137588
44323,踵,1,614908,0.00016199,99.61153788
44324,輸入型,1,614909,0.00016199,99.61169987
44325,輸入端,1,614910,0.00016199,99.61186186
44326,輸出力,1,614911,0.00016199,99.61202386
44327,輸出國,1,614912,0.00016199,99.61218585
44328,輸家,1,614913,0.00016199,99.61234785
44329,輸掉,1,614914,0.00016199,99.61250984
44330,輸誠,1,614915,0.00016199,99.61267184
44331,輸輸贏贏,1,614916,0.00016199,99.61283383
44332,辨,1,614917,0.00016199,99.61299582
44333,辨論,1,614918,0.00016199,99.61315782
44334,辦公室家具,1,614919,0.00016199,99.61331981
44335,辦公室通訊站,1,614920,0.00016199,99.61348181
44336,辦公家具,1,614921,0.00016199,99.61364380
44337,辦公桌椅,1,614922,0.00016199,99.61380579
44338,辦公處所,1,614923,0.00016199,99.61396779
44339,辦公廳舍,1,614924,0.00016199,99.61412978
44340,辦事員,1,614925,0.00016199,99.61429178
44341,辦到,1,614926,0.00016199,99.61445377
44342,辦家家酒,1,614927,0.00016199,99.61461577
44343,辦案人員,1,614928,0.00016199,99.61477776
44344,辦喜事,1,614929,0.00016199,99.61493975
44345,辦學,1,614930,0.00016199,99.61510175
44346,遵行,1,614931,0.00016199,99.61526374
44347,遵隨,1,614932,0.00016199,99.61542574
44348,選上,1,614933,0.00016199,99.61558773
44349,選才,1,614934,0.00016199,99.61574973
44350,選秀,1,614935,0.00016199,99.61591172
44351,選角,1,614936,0.00016199,99.61607371
44352,選配,1,614937,0.00016199,99.61623571
44353,選將,1,614938,0.00016199,99.61639770
44354,選控器,1,614939,0.00016199,99.61655970
44355,選單式,1,614940,0.00016199,99.61672169
44356,選對,1,614941,0.00016199,99.61688368
44357,選樣,1,614942,0.00016199,99.61704568
44358,選課,1,614943,0.00016199,99.61720767
44359,選賢與能,1,614944,0.00016199,99.61736967
44360,選擇題,1,614945,0.00016199,99.61753166
44361,選擇權交易,1,614946,0.00016199,99.61769366
44362,選舉味,1,614947,0.00016199,99.61785565
44363,選舉程序委員會,1,614948,0.00016199,99.61801764
44364,遲延,1,614949,0.00016199,99.61817964
44365,遲暮,1,614950,0.00016199,99.61834163
44366,遼寧街,1,614951,0.00016199,99.61850363
44367,遺忘的平原,1,614952,0.00016199,99.61866562
44368,遺志,1,614953,0.00016199,99.61882762
44369,遺容,1,614954,0.00016199,99.61898961
44370,遺書,1,614955,0.00016199,99.61915160
44371,遺珠,1,614956,0.00016199,99.61931360
44372,遺產稅,1,614957,0.00016199,99.61947559
44373,遺落,1,614958,0.00016199,99.61963759
44374,遺囑,1,614959,0.00016199,99.61979958
44375,醒悟,1,614960,0.00016199,99.61996157
44376,鋸子,1,614961,0.00016199,99.62012357
44377,鋸柴,1,614962,0.00016199,99.62028556
44378,鋸齒,1,614963,0.00016199,99.62044756
44379,錯失良機,1,614964,0.00016199,99.62060955
44380,錯愛,1,614965,0.00016199,99.62077155
44381,錯綜,1,614966,0.00016199,99.62093354
44382,錯綜複雜,1,614967,0.00016199,99.62109553
44383,錯誤訊息,1,614968,0.00016199,99.62125753
44384,錯錯落落,1,614969,0.00016199,99.62141952
44385,錯縱複雜,1,614970,0.00016199,99.62158152
44386,錢志堅,1,614971,0.00016199,99.62174351
44387,錢思亮,1,614972,0.00016199,99.62190551
44388,錢純,1,614973,0.00016199,99.62206750
44389,錢袋,1,614974,0.00016199,99.62222949
44390,錢途,1,614975,0.00016199,99.62239149
44391,錢街,1,614976,0.00016199,99.62255348
44392,錢賓四,1,614977,0.00016199,99.62271548
44393,錢雜誌,1,614978,0.00016199,99.62287747
44394,鋼片琴,1,614979,0.00016199,99.62303947
44395,鋼材,1,614980,0.00016199,99.62320146
44396,鋼杯,1,614981,0.00016199,99.62336345
44397,鋼架,1,614982,0.00016199,99.62352545
44398,鋼盔,1,614983,0.00016199,99.62368744
44399,鋼琴師,1,614984,0.00016199,99.62384944
44400,鋼琴師與她的情人,1,614985,0.00016199,99.62401143
44401,鋼樑,1,614986,0.00016199,99.62417342
44402,鋼鐵工會,1,614987,0.00016199,99.62433542
44403,鋼鐵業,1,614988,0.00016199,99.62449741
44404,錫安旅遊,1,614989,0.00016199,99.62465941
44405,錫拉島,1,614990,0.00016199,99.62482140
44406,錫箔紙,1,614991,0.00016199,99.62498340
44407,錫器,1,614992,0.00016199,99.62514539
44408,錄用,1,614993,0.00016199,99.62530738
44409,錄取,1,614994,0.00016199,99.62546938
44410,錄取率,1,614995,0.00016199,99.62563137
44411,錄音技師,1,614996,0.00016199,99.62579337
44412,錄製曲,1,614997,0.00016199,99.62595536
44413,錄影片,1,614998,0.00016199,99.62611736
44414,錄影監視器,1,614999,0.00016199,99.62627935
44415,錐,1,615000,0.00016199,99.62644134
44416,錦,1,615001,0.00016199,99.62660334
44417,錦緞,1,615002,0.00016199,99.62676533
44418,閻鳳婷,1,615003,0.00016199,99.62692733
44419,隧道口,1,615004,0.00016199,99.62708932
44420,隨心,1,615005,0.00016199,99.62725131
44421,隨手,1,615006,0.00016199,99.62741331
44422,隨手可得,1,615007,0.00016199,99.62757530
44423,隨手書,1,615008,0.00016199,99.62773730
44424,隨地,1,615009,0.00016199,99.62789929
44425,隨身變,1,615010,0.00016199,99.62806129
44426,隨風,1,615011,0.00016199,99.62822328
44427,隨遇而安,1,615012,0.00016199,99.62838527
44428,隨機存取記憶體,1,615013,0.00016199,99.62854727
44429,隨機性,1,615014,0.00016199,99.62870926
44430,隨興,1,615015,0.00016199,99.62887126
44431,險峻,1,615016,0.00016199,99.62903325
44432,險勝,1,615017,0.00016199,99.62919525
44433,險惡,1,615018,0.00016199,99.62935724
44434,險著,1,615019,0.00016199,99.62951923
44435,險謀,1,615020,0.00016199,99.62968123
44436,雕工,1,615021,0.00016199,99.62984322
44437,雕刻物,1,615022,0.00016199,99.63000522
44438,雕刻家,1,615023,0.00016199,99.63016721
44439,雕琢,1,615024,0.00016199,99.63032920
44440,雕繪,1,615025,0.00016199,99.63049120
44441,霎時,1,615026,0.00016199,99.63065319
44442,霖園飯店,1,615027,0.00016199,99.63081519
44443,霍,1,615028,0.00016199,99.63097718
44444,霍夫曼,1,615029,0.00016199,99.63113918
44445,霍格,1,615030,0.00016199,99.63130117
44446,霍爾,1,615031,0.00016199,99.63146316
44447,霍爾史卡狄諾,1,615032,0.00016199,99.63162516
44448,霓裳,1,615033,0.00016199,99.63178715
44449,靛,1,615034,0.00016199,99.63194915
44450,靜下來,1,615035,0.00016199,99.63211114
44451,靜佇,1,615036,0.00016199,99.63227314
44452,靜和,1,615037,0.00016199,99.63243513
44453,靜悄悄,1,615038,0.00016199,99.63259712
44454,靜畫,1,615039,0.00016199,99.63275912
44455,靜電式,1,615040,0.00016199,99.63292111
44456,靜態隨機存取記憶體,1,615041,0.00016199,99.63308311
44457,靜謐,1,615042,0.00016199,99.63324510
44458,靜觀其變,1,615043,0.00016199,99.63340709
44459,頰,1,615044,0.00016199,99.63356909
44460,頸脖,1,615045,0.00016199,99.63373108
44461,頻密,1,615046,0.00016199,99.63389308
44462,頭一回,1,615047,0.00016199,99.63405507
44463,頭一遭,1,615048,0.00016199,99.63421707
44464,頭子,1,615049,0.00016199,99.63437906
44465,頭皮,1,615050,0.00016199,99.63454105
44466,頭皮屑,1,615051,0.00016199,99.63470305
44467,頭皮針,1,615052,0.00016199,99.63486504
44468,頭份,1,615053,0.00016199,99.63502704
44469,頭尾,1,615054,0.00016199,99.63518903
44470,頭昏眼花,1,615055,0.00016199,99.63535103
44471,頭社,1,615056,0.00016199,99.63551302
44472,頭門山,1,615057,0.00016199,99.63567501
44473,頭型,1,615058,0.00016199,99.63583701
44474,頭城,1,615059,0.00016199,99.63599900
44475,頭城農場,1,615060,0.00016199,99.63616100
44476,頭套,1,615061,0.00016199,99.63632299
44477,頭胴,1,615062,0.00016199,99.63648498
44478,頭胴部,1,615063,0.00016199,99.63664698
44479,頭條,1,615064,0.00016199,99.63680897
44480,頭條新聞,1,615065,0.00016199,99.63697097
44481,頭等艙,1,615066,0.00016199,99.63713296
44482,頭號,1,615067,0.00016199,99.63729496
44483,頭路,1,615068,0.00016199,99.63745695
44484,頭獎,1,615069,0.00016199,99.63761894
44485,頭燈組,1,615070,0.00016199,99.63778094
44486,頭籌,1,615071,0.00016199,99.63794293
44487,頭顱,1,615072,0.00016199,99.63810493
44488,頭孢子素,1,615073,0.00016199,99.63826692
44489,頭孢子類,1,615074,0.00016199,99.63842892
44490,頹,1,615075,0.00016199,99.63859091
44491,頹然,1,615076,0.00016199,99.63875290
44492,頹萎,1,615077,0.00016199,99.63891490
44493,頹勢,1,615078,0.00016199,99.63907689
44494,頹廢派,1,615079,0.00016199,99.63923889
44495,餐前飲料,1,615080,0.00016199,99.63940088
44496,餐旅,1,615081,0.00016199,99.63956287
44497,餐旅業,1,615082,0.00016199,99.63972487
44498,餐旅管理,1,615083,0.00016199,99.63988686
44499,餐桌花,1,615084,0.00016199,99.64004886
44500,餐酒,1,615085,0.00016199,99.64021085
44501,餐盒業,1,615086,0.00016199,99.64037285
44502,餐飲界,1,615087,0.00016199,99.64053484
44503,餐飲管理,1,615088,0.00016199,99.64069683
44504,餐聚,1,615089,0.00016199,99.64085883
44505,餐盤,1,615090,0.00016199,99.64102082
44506,餐點,1,615091,0.00016199,99.64118282
44507,館主,1,615092,0.00016199,99.64134481
44508,餞行,1,615093,0.00016199,99.64150681
44509,餛飩湯,1,615094,0.00016199,99.64166880
44510,鮑比,1,615095,0.00016199,99.64183079
44511,鮑伯．福克斯,1,615096,0.00016199,99.64199279
44512,鮑起靜,1,615097,0.00016199,99.64215478
44513,鮑國安,1,615098,0.00016199,99.64231678
44514,鮑爾斯,1,615099,0.00016199,99.64247877
44515,鮑羅定,1,615100,0.00016199,99.64264076
44516,鴕鳥心態,1,615101,0.00016199,99.64280276
44517,鴕鳥皮,1,615102,0.00016199,99.64296475
44518,鴕鳥排,1,615103,0.00016199,99.64312675
44519,鴨子,1,615104,0.00016199,99.64328874
44520,鴨舌帽,1,615105,0.00016199,99.64345074
44521,鴨嘴,1,615106,0.00016199,99.64361273
44522,默片,1,615107,0.00016199,99.64377472
44523,默哀,1,615108,0.00016199,99.64393672
44524,默唸,1,615109,0.00016199,99.64409871
44525,默然不語,1,615110,0.00016199,99.64426071
44526,默默耕耘,1,615111,0.00016199,99.64442270
44527,默默無聞,1,615112,0.00016199,99.64458470
44528,黔,1,615113,0.00016199,99.64474669
44529,黔驢技窮,1,615114,0.00016199,99.64490868
44530,龍山號,1,615115,0.00016199,99.64507068
44531,龍天翔,1,615116,0.00016199,99.64523267
44532,龍心,1,615117,0.00016199,99.64539467
44533,龍王燈,1,615118,0.00016199,99.64555666
44534,龍兄虎弟,1,615119,0.00016199,99.64571865
44535,龍邦,1,615120,0.00016199,99.64588065
44536,龍卷地獄,1,615121,0.00016199,99.64604264
44537,龍岩村,1,615122,0.00016199,99.64620464
44538,龍門公園,1,615123,0.00016199,99.64636663
44539,龍門街,1,615124,0.00016199,99.64652863
44540,龍柏,1,615125,0.00016199,99.64669062
44541,龍柏無尾熊公園,1,615126,0.00016199,99.64685261
44542,龍泉街,1,615127,0.00016199,99.64701461
44543,龍宮,1,615128,0.00016199,99.64717660
44544,龍神,1,615129,0.00016199,99.64733860
44545,龍捲風,1,615130,0.00016199,99.64750059
44546,龍眼,1,615131,0.00016199,99.64766259
44547,龍祥加工廠,1,615132,0.00016199,99.64782458
44548,龍祥電影,1,615133,0.00016199,99.64798657
44549,龍祥影業,1,615134,0.00016199,99.64814857
44550,龍園,1,615135,0.00016199,99.64831056
44551,龍鳳食品,1,615136,0.00016199,99.64847256
44552,龍鳳酒,1,615137,0.00016199,99.64863455
44553,龍德曼,1,615138,0.00016199,99.64879654
44554,龍潭,1,615139,0.00016199,99.64895854
44555,龍蝦穴,1,615140,0.00016199,99.64912053
44556,龍頭寶座,1,615141,0.00016199,99.64928253
44557,龍應台,1,615142,0.00016199,99.64944452
44558,龍蟠虎踞,1,615143,0.00016199,99.64960652
44559,龍寶建設,1,615144,0.00016199,99.64976851
44560,龍響影視有限公司,1,615145,0.00016199,99.64993050
44561,龍巖,1,615146,0.00016199,99.65009250
44562,龜,1,615147,0.00016199,99.65025449
44563,龜山,1,615148,0.00016199,99.65041649
44564,龜山勳,1,615149,0.00016199,99.65057848
44565,優元,1,615150,0.00016199,99.65074048
44566,優元工業有限公司,1,615151,0.00016199,99.65090247
44567,優元公司,1,615152,0.00016199,99.65106446
44568,優化,1,615153,0.00016199,99.65122646
44569,優劣,1,615154,0.00016199,99.65138845
44570,優待卷,1,615155,0.00016199,99.65155045
44571,優美企業,1,615156,0.00016199,99.65171244
44572,優缺,1,615157,0.00016199,99.65187444
44573,優惠價,1,615158,0.00016199,99.65203643
44574,優斯頓路,1,615159,0.00016199,99.65219842
44575,優源牌,1,615160,0.00016199,99.65236042
44576,優遊,1,615161,0.00016199,99.65252241
44577,優選車,1,615162,0.00016199,99.65268441
44578,償付,1,615163,0.00016199,99.65284640
44579,償債,1,615164,0.00016199,99.65300839
44580,儲,1,615165,0.00016199,99.65317039
44581,儲存庫,1,615166,0.00016199,99.65333238
44582,儲存處,1,615167,0.00016199,99.65349438
44583,儲存量,1,615168,0.00016199,99.65365637
44584,儲君,1,615169,0.00016199,99.65381837
44585,儲貨,1,615170,0.00016199,99.65398036
44586,儲運,1,615171,0.00016199,99.65414235
44587,儲蓄投資特別扣除額,1,615172,0.00016199,99.65430435
44588,儲蓄部,1,615173,0.00016199,99.65446634
44589,勵精圖治,1,615174,0.00016199,99.65462834
44590,嚇一跳,1,615175,0.00016199,99.65479033
44591,嚇死人,1,615176,0.00016199,99.65495233
44592,嚇呆,1,615177,0.00016199,99.65511432
44593,嚇退,1,615178,0.00016199,99.65527631
44594,嚇然,1,615179,0.00016199,99.65543831
44595,嚇醒,1,615180,0.00016199,99.65560030
44596,壕溝,1,615181,0.00016199,99.65576230
44597,壓力帶,1,615182,0.00016199,99.65592429
44598,壓片,1,615183,0.00016199,99.65608628
44599,壓穴,1,615184,0.00016199,99.65624828
44600,壓舌板,1,615185,0.00016199,99.65641027
44601,壓克力,1,615186,0.00016199,99.65657227
44602,壓花,1,615187,0.00016199,99.65673426
44603,壓迫症,1,615188,0.00016199,99.65689626
44604,壓倒,1,615189,0.00016199,99.65705825
44605,壓根兒,1,615190,0.00016199,99.65722024
44606,壓陣,1,615191,0.00016199,99.65738224
44607,壓乾,1,615192,0.00016199,99.65754423
44608,壓榨,1,615193,0.00016199,99.65770623
44609,壓擠,1,615194,0.00016199,99.65786822
44610,壓縮機面,1,615195,0.00016199,99.65803022
44611,壓鑄,1,615196,0.00016199,99.65819221
44612,嬰兒床,1,615197,0.00016199,99.65835420
44613,嬰兒油,1,615198,0.00016199,99.65851620
44614,嬤,1,615199,0.00016199,99.65867819
44615,嬤嬤帆帆,1,615200,0.00016199,99.65884019
44616,孺慕,1,615201,0.00016199,99.65900218
44617,屨,1,615202,0.00016199,99.65916417
44618,嶺,1,615203,0.00016199,99.65932617
44619,幫浦,1,615204,0.00016199,99.65948816
44620,幫幫忙,1,615205,0.00016199,99.65965016
44621,彌,1,615206,0.00016199,99.65981215
44622,彌平,1,615207,0.00016199,99.65997415
44623,彌勒菩薩,1,615208,0.00016199,99.66013614
44624,彌漫,1,615209,0.00016199,99.66029813
44625,徽章,1,615210,0.00016199,99.66046013
44626,應允,1,615211,0.00016199,99.66062212
44627,應用類,1,615212,0.00016199,99.66078412
44628,應考,1,615213,0.00016199,99.66094611
44629,應屆,1,615214,0.00016199,99.66110811
44630,應留法定空地,1,615215,0.00016199,99.66127010
44631,應訊,1,615216,0.00016199,99.66143209
44632,應翠梅,1,615217,0.00016199,99.66159409
44633,應徵者,1,615218,0.00016199,99.66175608
44634,應戰,1,615219,0.00016199,99.66191808
44635,應聲重挫,1,615220,0.00016199,99.66208007
44636,應聲倒地,1,615221,0.00016199,99.66224206
44637,應屬,1,615222,0.00016199,99.66240406
44638,應驗,1,615223,0.00016199,99.66256605
44639,懇請,1,615224,0.00016199,99.66272805
44640,懇懋科技公司,1,615225,0.00016199,99.66289004
44641,懦弱,1,615226,0.00016199,99.66305204
44642,戲台,1,615227,0.00016199,99.66321403
44643,戲本,1,615228,0.00016199,99.66337602
44644,戲曲界,1,615229,0.00016199,99.66353802
44645,戲棚,1,615230,0.00016199,99.66370001
44646,戲劇界,1,615231,0.00016199,99.66386201
44647,戲劇科,1,615232,0.00016199,99.66402400
44648,戲劇節,1,615233,0.00016199,99.66418600
44649,戲劇學系,1,615234,0.00016199,99.66434799
44650,戲劇學者,1,615235,0.00016199,99.66450998
44651,戴以寬,1,615236,0.00016199,99.66467198
44652,戴安娜,1,615237,0.00016199,99.66483397
44653,戴考尼斯,1,615238,0.00016199,99.66499597
44654,戴利博士,1,615239,0.00016199,99.66515796
44655,戴明獎,1,615240,0.00016199,99.66531995
44656,戴門斯德爾,1,615241,0.00016199,99.66548195
44657,戴勒姆集團,1,615242,0.00016199,99.66564394
44658,戴勝益,1,615243,0.00016199,99.66580594
44659,戴奧尼索斯,1,615244,0.00016199,99.66596793
44660,戴蒙貝克鎮,1,615245,0.00016199,99.66612993
44661,戴鄭錫瑛,1,615246,0.00016199,99.66629192
44662,擊打,1,615247,0.00016199,99.66645391
44663,擊沈,1,615248,0.00016199,99.66661591
44664,擊昏,1,615249,0.00016199,99.66677790
44665,擊垮,1,615250,0.00016199,99.66693990
44666,擊退,1,615251,0.00016199,99.66710189
44667,擊針,1,615252,0.00016199,99.66726389
44668,擊發,1,615253,0.00016199,99.66742588
44669,擊傷,1,615254,0.00016199,99.66758787
44670,擊碎,1,615255,0.00016199,99.66774987
44671,擊樂,1,615256,0.00016199,99.66791186
44672,擊樂曲,1,615257,0.00016199,99.66807386
44673,擊潰,1,615258,0.00016199,99.66823585
44674,擠入,1,615259,0.00016199,99.66839784
44675,擠出,1,615260,0.00016199,99.66855984
44676,擠出來,1,615261,0.00016199,99.66872183
44677,擠兌,1,615262,0.00016199,99.66888383
44678,擠車,1,615263,0.00016199,99.66904582
44679,擠掉,1,615264,0.00016199,99.66920782
44680,擠滿,1,615265,0.00016199,99.66936981
44681,擦完,1,615266,0.00016199,99.66953180
44682,擦乾,1,615267,0.00016199,99.66969380
44683,擦掉,1,615268,0.00016199,99.66985579
44684,擦傷,1,615269,0.00016199,99.67001779
44685,擦撞,1,615270,0.00016199,99.67017978
44686,擦鞋布,1,615271,0.00016199,99.67034178
44687,擦鞋童,1,615272,0.00016199,99.67050377
44688,擦擦,1,615273,0.00016199,99.67066576
44689,擬人,1,615274,0.00016199,99.67082776
44690,擬出,1,615275,0.00016199,99.67098975
44691,擬妥,1,615276,0.00016199,99.67115175
44692,擱,1,615277,0.00016199,99.67131374
44693,擱置,1,615278,0.00016199,99.67147573
44694,斃命,1,615279,0.00016199,99.67163773
44695,曙光乍現,1,615280,0.00016199,99.67179972
44696,檔支,1,615281,0.00016199,99.67196172
44697,檔名,1,615282,0.00016199,99.67212371
44698,檔次,1,615283,0.00016199,99.67228571
44699,檔案伺服器,1,615284,0.00016199,99.67244770
44700,檔案風暴,1,615285,0.00016199,99.67260969
44701,檔案庫,1,615286,0.00016199,99.67277169
44702,檔案管理,1,615287,0.00016199,99.67293368
44703,檢具,1,615288,0.00016199,99.67309568
44704,檢查局,1,615289,0.00016199,99.67325767
44705,檢修,1,615290,0.00016199,99.67341967
44706,檢索,1,615291,0.00016199,99.67358166
44707,檢討會,1,615292,0.00016199,99.67374365
44708,檢送,1,615293,0.00016199,99.67390565
44709,檢測,1,615294,0.00016199,99.67406764
44710,檢察長,1,615295,0.00016199,99.67422964
44711,檢獲,1,615296,0.00016199,99.67439163
44712,檢證,1,615297,0.00016199,99.67455362
44713,檠,1,615298,0.00016199,99.67471562
44714,氈房,1,615299,0.00016199,99.67487761
44715,濱,1,615300,0.00016199,99.67503961
44716,濱海,1,615301,0.00016199,99.67520160
44717,濱臨,1,615302,0.00016199,99.67536360
44718,濟,1,615303,0.00016199,99.67552559
44719,濟世,1,615304,0.00016199,99.67568758
44720,濟州島,1,615305,0.00016199,99.67584958
44721,濟南軍區,1,615306,0.00016199,99.67601157
44722,濟陽級,1,615307,0.00016199,99.67617357
44723,濟寧,1,615308,0.00016199,99.67633556
44724,濟寧市,1,615309,0.00016199,99.67649756
44725,濤,1,615310,0.00016199,99.67665955
44726,濫情,1,615311,0.00016199,99.67682154
44727,濫權,1,615312,0.00016199,99.67698354
44728,澀,1,615313,0.00016199,99.67714553
44729,澀不澀,1,615314,0.00016199,99.67730753
44730,濕地林,1,615315,0.00016199,99.67746952
44731,濕豆包,1,615316,0.00016199,99.67763152
44732,濕雨,1,615317,0.00016199,99.67779351
44733,濕砂模鑄造製程自動化,1,615318,0.00016199,99.67795550
44734,濕砂模鑄造製程自動化技術,1,615319,0.00016199,99.67811750
44735,濕氣,1,615320,0.00016199,99.67827949
44736,濕紙巾,1,615321,0.00016199,99.67844149
44737,濕婆神,1,615322,0.00016199,99.67860348
44738,濕潤,1,615323,0.00016199,99.67876547
44739,濕燥,1,615324,0.00016199,99.67892747
44740,濕黏黏,1,615325,0.00016199,99.67908946
44741,營地,1,615326,0.00016199,99.67925146
44742,營收額,1,615327,0.00016199,99.67941345
44743,營建類股,1,615328,0.00016199,99.67957545
44744,營造公會,1,615329,0.00016199,99.67973744
44745,營造類股,1,615330,0.00016199,99.67989943
44746,營業力,1,615331,0.00016199,99.68006143
44747,營業比重,1,615332,0.00016199,99.68022342
44748,營業員,1,615333,0.00016199,99.68038542
44749,營業部,1,615334,0.00016199,99.68054741
44750,營業場所,1,615335,0.00016199,99.68070941
44751,營業登記,1,615336,0.00016199,99.68087140
44752,營業稅率,1,615337,0.00016199,99.68103339
44753,營業廳,1,615338,0.00016199,99.68119539
44754,營運費,1,615339,0.00016199,99.68135738
44755,營幕,1,615340,0.00016199,99.68151938
44756,營養界,1,615341,0.00016199,99.68168137
44757,營養組,1,615342,0.00016199,99.68184336
44758,營養源,1,615343,0.00016199,99.68200536
44759,營養劑,1,615344,0.00016199,99.68216735
44760,營繕工程,1,615345,0.00016199,99.68232935
44761,燦亮,1,615346,0.00016199,99.68249134
44762,燦麗,1,615347,0.00016199,99.68265334
44763,燥氣,1,615348,0.00016199,99.68281533
44764,燭火,1,615349,0.00016199,99.68297732
44765,燭檯,1,615350,0.00016199,99.68313932
44766,燴三鮮,1,615351,0.00016199,99.68330131
44767,燠熱,1,615352,0.00016199,99.68346331
44768,爵士音樂,1,615353,0.00016199,99.68362530
44769,爵士鼓,1,615354,0.00016199,99.68378730
44770,爵士藝廊,1,615355,0.00016199,99.68394929
44771,牆角,1,615356,0.00016199,99.68411128
44772,牆垣,1,615357,0.00016199,99.68427328
44773,牆面,1,615358,0.00016199,99.68443527
44774,獲益率,1,615359,0.00016199,99.68459727
44775,環形劇場,1,615360,0.00016199,99.68475926
44776,環泥公司,1,615361,0.00016199,99.68492125
44777,環狀線,1,615362,0.00016199,99.68508325
44778,環狀烴化合物,1,615363,0.00016199,99.68524524
44779,環保小英雄,1,615364,0.00016199,99.68540724
44780,環保回收,1,615365,0.00016199,99.68556923
44781,環保局局長,1,615366,0.00016199,99.68573123
44782,環保派,1,615367,0.00016199,99.68589322
44783,環保處,1,615368,0.00016199,99.68605521
44784,環保署長,1,615369,0.00016199,99.68621721
44785,環保補充包洗衣粉,1,615370,0.00016199,99.68637920
44786,環保標章制度,1,615371,0.00016199,99.68654120
44787,環保標章商品,1,615372,0.00016199,99.68670319
44788,環型,1,615373,0.00016199,99.68686519
44789,環帶,1,615374,0.00016199,99.68702718
44790,環球片場,1,615375,0.00016199,99.68718917
44791,環球金屬礦業,1,615376,0.00016199,99.68735117
44792,環球航空,1,615377,0.00016199,99.68751316
44793,環球商業大樓,1,615378,0.00016199,99.68767516
44794,環釦,1,615379,0.00016199,99.68783715
44795,環湖,1,615380,0.00016199,99.68799914
44796,環遊,1,615381,0.00016199,99.68816114
44797,環境印象,1,615382,0.00016199,99.68832313
44798,環境局,1,615383,0.00016199,99.68848513
44799,環境保護署,1,615384,0.00016199,99.68864712
44800,環境科學與健康,1,615385,0.00016199,99.68880912
44801,環境部,1,615386,0.00016199,99.68897111
44802,環境評估作業,1,615387,0.00016199,99.68913310
44803,環境影響評估審查會,1,615388,0.00016199,99.68929510
44804,環境調查協會,1,615389,0.00016199,99.68945709
44805,環境權,1,615390,0.00016199,99.68961909
44806,環環,1,615391,0.00016199,99.68978108
44807,環繞音場,1,615392,0.00016199,99.68994308
44808,環繫,1,615393,0.00016199,99.69010507
44809,療程,1,615394,0.00016199,99.69026706
44810,療傷,1,615395,0.00016199,99.69042906
44811,癌細胞,1,615396,0.00016199,99.69059105
44812,盪,1,615397,0.00016199,99.69075305
44813,瞳孔,1,615398,0.00016199,99.69091504
44814,瞪羚式,1,615399,0.00016199,99.69107703
44815,瞭望,1,615400,0.00016199,99.69123903
44816,瞭望臺,1,615401,0.00016199,99.69140102
44817,矯正轉盤,1,615402,0.00016199,99.69156302
44818,矯健,1,615403,0.00016199,99.69172501
44819,矯揉,1,615404,0.00016199,99.69188701
44820,磺胺類,1,615405,0.00016199,99.69204900
44821,礁,1,615406,0.00016199,99.69221099
44822,礁岩,1,615407,0.00016199,99.69237299
44823,礁溪,1,615408,0.00016199,99.69253498
44824,禪定力,1,615409,0.00016199,99.69269698
44825,禪園,1,615410,0.00016199,99.69285897
44826,穗,1,615411,0.00016199,99.69302097
44827,簇,1,615412,0.00016199,99.69318296
44828,簇簇,1,615413,0.00016199,99.69334495
44829,糟透,1,615414,0.00016199,99.69350695
44830,糟蹋,1,615415,0.00016199,99.69366894
44831,糙米,1,615416,0.00016199,99.69383094
44832,縮到,1,615417,0.00016199,99.69399293
44833,縮緊,1,615418,0.00016199,99.69415492
44834,縮編,1,615419,0.00016199,99.69431692
44835,縷縷,1,615420,0.00016199,99.69447891
44836,繃緊,1,615421,0.00016199,99.69464091
44837,縫上,1,615422,0.00016199,99.69480290
44838,縫衣針,1,615423,0.00016199,99.69496490
44839,縫紉,1,615424,0.00016199,99.69512689
44840,縫線,1,615425,0.00016199,99.69528888
44841,總主筆,1,615426,0.00016199,99.69545088
44842,總出口值,1,615427,0.00016199,99.69561287
44843,總召集人,1,615428,0.00016199,99.69577487
44844,總司令,1,615429,0.00016199,99.69593686
44845,總目錄,1,615430,0.00016199,99.69609886
44846,總合商社,1,615431,0.00016199,99.69626085
44847,總冠軍賽,1,615432,0.00016199,99.69642284
44848,總指揮,1,615433,0.00016199,99.69658484
44849,總負責人,1,615434,0.00016199,99.69674683
44850,總負債,1,615435,0.00016199,99.69690883
44851,總面積,1,615436,0.00016199,99.69707082
44852,總務主任,1,615437,0.00016199,99.69723281
44853,總執行長,1,615438,0.00016199,99.69739481
44854,總教頭,1,615439,0.00016199,99.69755680
44855,總統府副秘書長,1,615440,0.00016199,99.69771880
44856,總統府組織法,1,615441,0.00016199,99.69788079
44857,總策畫,1,615442,0.00016199,99.69804279
44858,總策劃,1,615443,0.00016199,99.69820478
44859,總會長,1,615444,0.00016199,99.69836677
44860,總經銷,1,615445,0.00016199,99.69852877
44861,總資本額,1,615446,0.00016199,99.69869076
44862,總預算,1,615447,0.00016199,99.69885276
44863,總預算案,1,615448,0.00016199,99.69901475
44864,總領隊,1,615449,0.00016199,99.69917675
44865,總編,1,615450,0.00016199,99.69933874
44866,總複習,1,615451,0.00016199,99.69950073
44867,總營收,1,615452,0.00016199,99.69966273
44868,總體而言,1,615453,0.00016199,99.69982472
44869,總體阻抗,1,615454,0.00016199,99.69998672
44870,總體經濟指標,1,615455,0.00016199,99.70014871
44871,縱走式,1,615456,0.00016199,99.70031070
44872,縱虎歸山,1,615457,0.00016199,99.70047270
44873,縱情,1,615458,0.00016199,99.70063469
44874,縱橫一時,1,615459,0.00016199,99.70079669
44875,縱橫書海—影響三十單元,1,615460,0.00016199,99.70095868
44876,繁忙,1,615461,0.00016199,99.70112068
44877,繁星點點,1,615462,0.00016199,99.70128267
44878,繁茂,1,615463,0.00016199,99.70144466
44879,繁重,1,615464,0.00016199,99.70160666
44880,繁殖率,1,615465,0.00016199,99.70176865
44881,縹緲,1,615466,0.00016199,99.70193065
44882,罄,1,615467,0.00016199,99.70209264
44883,翼形陣,1,615468,0.00016199,99.70225464
44884,翼翼,1,615469,0.00016199,99.70241663
44885,聲光,1,615470,0.00016199,99.70257862
44886,聲光科技,1,615471,0.00016199,99.70274062
44887,聲名大譟,1,615472,0.00016199,99.70290261
44888,聲名遠播,1,615473,0.00016199,99.70306461
44889,聲色,1,615474,0.00016199,99.70322660
44890,聲言,1,615475,0.00016199,99.70338859
44891,聲門,1,615476,0.00016199,99.70355059
44892,聲威,1,615477,0.00016199,99.70371258
44893,聲息,1,615478,0.00016199,99.70387458
44894,聲納,1,615479,0.00016199,99.70403657
44895,聲帶,1,615480,0.00016199,99.70419857
44896,聲望,1,615481,0.00016199,99.70436056
44897,聲腔,1,615482,0.00016199,99.70452255
44898,聲嘶力歇,1,615483,0.00016199,99.70468455
44899,聲樂,1,615484,0.00016199,99.70484654
44900,聲樂家,1,615485,0.00016199,99.70500854
44901,聲調,1,615486,0.00016199,99.70517053
44902,聲學,1,615487,0.00016199,99.70533253
44903,聲聲,1,615488,0.00016199,99.70549452
44904,聰明伶俐,1,615489,0.00016199,99.70565651
44905,聰慧,1,615490,0.00016199,99.70581851
44906,聰穎,1,615491,0.00016199,99.70598050
44907,聯中,1,615492,0.00016199,99.70614250
44908,聯外,1,615493,0.00016199,99.70630449
44909,聯外性,1,615494,0.00016199,99.70646649
44910,聯名,1,615495,0.00016199,99.70662848
44911,聯合航空,1,615496,0.00016199,99.70679047
44912,聯合圈,1,615497,0.00016199,99.70695247
44913,聯合晚報,1,615498,0.00016199,99.70711446
44914,聯合報系,1,615499,0.00016199,99.70727646
44915,聯合報系文化基金會,1,615500,0.00016199,99.70743845
44916,聯合論壇,1,615501,0.00016199,99.70760044
44917,聯成,1,615502,0.00016199,99.70776244
44918,聯邦準備銀行,1,615503,0.00016199,99.70792443
44919,聯邦銀行,1,615504,0.00016199,99.70808643
44920,聯姓會,1,615505,0.00016199,99.70824842
44921,聯軍,1,615506,0.00016199,99.70841042
44922,聯展,1,615507,0.00016199,99.70857241
44923,聯泰科技,1,615508,0.00016199,99.70873440
44924,聯通電子,1,615509,0.00016199,99.70889640
44925,聯發,1,615510,0.00016199,99.70905839
44926,聯絡人,1,615511,0.00016199,99.70922039
44927,聯絡人員,1,615512,0.00016199,99.70938238
44928,聯絡道路,1,615513,0.00016199,99.70954438
44929,聯絡道路系統,1,615514,0.00016199,99.70970637
44930,聯勤政戰,1,615515,0.00016199,99.70986836
44931,聯想力,1,615516,0.00016199,99.71003036
44932,聯盟性,1,615517,0.00016199,99.71019235
44933,聯經版,1,615518,0.00016199,99.71035435
44934,聯鼎國際,1,615519,0.00016199,99.71051634
44935,聯線,1,615520,0.00016199,99.71067833
44936,聯課活動,1,615521,0.00016199,99.71084033
44937,聯賣,1,615522,0.00016199,99.71100232
44938,聯戰,1,615523,0.00016199,99.71116432
44939,聯檢,1,615524,0.00016199,99.71132631
44940,聯營,1,615525,0.00016199,99.71148831
44941,聯歡會,1,615526,0.00016199,99.71165030
44942,聳,1,615527,0.00016199,99.71181229
44943,聳動,1,615528,0.00016199,99.71197429
44944,聳聳肩,1,615529,0.00016199,99.71213628
44945,臆,1,615530,0.00016199,99.71229828
44946,臆測,1,615531,0.00016199,99.71246027
44947,臆想,1,615532,0.00016199,99.71262227
44948,臀肌,1,615533,0.00016199,99.71278426
44949,膿,1,615534,0.00016199,99.71294625
44950,膽,1,615535,0.00016199,99.71310825
44951,膽子,1,615536,0.00016199,99.71327024
44952,膽小,1,615537,0.00016199,99.71343224
44953,膽量,1,615538,0.00016199,99.71359423
44954,膽顫心驚,1,615539,0.00016199,99.71375622
44955,臉皮,1,615540,0.00016199,99.71391822
44956,臉蛋,1,615541,0.00016199,99.71408021
44957,臉譜,1,615542,0.00016199,99.71424221
44958,臨危,1,615543,0.00016199,99.71440420
44959,臨危受命,1,615544,0.00016199,99.71456620
44960,臨行,1,615545,0.00016199,99.71472819
44961,臨走,1,615546,0.00016199,99.71489018
44962,臨空,1,615547,0.00016199,99.71505218
44963,臨空城改造計畫,1,615548,0.00016199,99.71521417
44964,臨盆,1,615549,0.00016199,99.71537617
44965,臨時提案,1,615550,0.00016199,99.71553816
44966,臨時會議,1,615551,0.00016199,99.71570016
44967,臨時演員,1,615552,0.00016199,99.71586215
44968,臨海,1,615553,0.00016199,99.71602414
44969,臨接,1,615554,0.00016199,99.71618614
44970,臨終修習,1,615555,0.00016199,99.71634813
44971,臨場感,1,615556,0.00016199,99.71651013
44972,臨檢,1,615557,0.00016199,99.71667212
44973,臨檢勤務,1,615558,0.00016199,99.71683411
44974,舉人,1,615559,0.00016199,99.71699611
44975,舉凡,1,615560,0.00016199,99.71715810
44976,舉世,1,615561,0.00016199,99.71732010
44977,舉世聞名,1,615562,0.00016199,99.71748209
44978,舉列,1,615563,0.00016199,99.71764409
44979,舉家,1,615564,0.00016199,99.71780608
44980,舉案齊眉,1,615565,0.00016199,99.71796807
44981,舉起,1,615566,0.00016199,99.71813007
44982,舉球員,1,615567,0.00016199,99.71829206
44983,舉槍,1,615568,0.00016199,99.71845406
44984,艱巨,1,615569,0.00016199,99.71861605
44985,艱深,1,615570,0.00016199,99.71877805
44986,艱鉅性,1,615571,0.00016199,99.71894004
44987,艱險,1,615572,0.00016199,99.71910203
44988,薄片,1,615573,0.00016199,99.71926403
44989,薄彼,1,615574,0.00016199,99.71942602
44990,薄紗,1,615575,0.00016199,99.71958802
44991,薄雪,1,615576,0.00016199,99.71975001
44992,薄壁,1,615577,0.00016199,99.71991200
44993,蕾妮沙坦迪,1,615578,0.00016199,99.72007400
44994,蕾妮羅素,1,615579,0.00016199,99.72023599
44995,薑茶,1,615580,0.00016199,99.72039799
44996,薯,1,615581,0.00016199,99.72055998
44997,薯蕷,1,615582,0.00016199,99.72072198
44998,薛香川,1,615583,0.00016199,99.72088397
44999,薛惠珍,1,615584,0.00016199,99.72104596
45000,薛琴,1,615585,0.00016199,99.72120796
45001,薛楨麗,1,615586,0.00016199,99.72136995
45002,薇諾娜賴德,1,615587,0.00016199,99.72153195
45003,虧欠,1,615588,0.00016199,99.72169394
45004,蟑螂,1,615589,0.00016199,99.72185594
45005,螳臂擋車,1,615590,0.00016199,99.72201793
45006,蟒蛇,1,615591,0.00016199,99.72217992
45007,蟒黑,1,615592,0.00016199,99.72234192
45008,螺旋推進式幫浦,1,615593,0.00016199,99.72250391
45009,螺旋推進器,1,615594,0.00016199,99.72266591
45010,螺類,1,615595,0.00016199,99.72282790
45011,襄,1,615596,0.00016199,99.72298989
45012,襄助,1,615597,0.00016199,99.72315189
45013,襄理,1,615598,0.00016199,99.72331388
45014,覬覦,1,615599,0.00016199,99.72347588
45015,謙,1,615600,0.00016199,99.72363787
45016,謙和,1,615601,0.00016199,99.72379987
45017,謙虛,1,615602,0.00016199,99.72396186
45018,謙謙,1,615603,0.00016199,99.72412385
45019,講一講,1,615604,0.00016199,99.72428585
45020,講什麼,1,615605,0.00016199,99.72444784
45021,講出,1,615606,0.00016199,99.72460984
45022,講台,1,615607,0.00016199,99.72477183
45023,講和,1,615608,0.00016199,99.72493383
45024,講起來,1,615609,0.00016199,99.72509582
45025,講道理,1,615610,0.00016199,99.72525781
45026,講談社,1,615611,0.00016199,99.72541981
45027,講課,1,615612,0.00016199,99.72558180
45028,講講,1,615613,0.00016199,99.72574380
45029,講講話,1,615614,0.00016199,99.72590579
45030,謊,1,615615,0.00016199,99.72606778
45031,謊報,1,615616,0.00016199,99.72622978
45032,謊稱,1,615617,0.00016199,99.72639177
45033,謠,1,615618,0.00016199,99.72655377
45034,謝大立,1,615619,0.00016199,99.72671576
45035,謝天謝地,1,615620,0.00016199,99.72687776
45036,謝文賢,1,615621,0.00016199,99.72703975
45037,謝水木,1,615622,0.00016199,99.72720174
45038,謝台德,1,615623,0.00016199,99.72736374
45039,謝安民,1,615624,0.00016199,99.72752573
45040,謝志裕,1,615625,0.00016199,99.72768773
45041,謝里法,1,615626,0.00016199,99.72784972
45042,謝里曼,1,615627,0.00016199,99.72801172
45043,謝佳珍,1,615628,0.00016199,99.72817371
45044,謝牧州,1,615629,0.00016199,99.72833570
45045,謝恩得,1,615630,0.00016199,99.72849770
45046,謝健輝,1,615631,0.00016199,99.72865969
45047,謝國正,1,615632,0.00016199,99.72882169
45048,謝國城,1,615633,0.00016199,99.72898368
45049,謝添祈,1,615634,0.00016199,99.72914567
45050,謝深山,1,615635,0.00016199,99.72930767
45051,謝菲爾,1,615636,0.00016199,99.72946966
45052,謝稚柳,1,615637,0.00016199,99.72963166
45053,謝潮儀,1,615638,0.00016199,99.72979365
45054,謝蕙蓮,1,615639,0.00016199,99.72995565
45055,謝龍田,1,615640,0.00016199,99.73011764
45056,謝瀛華,1,615641,0.00016199,99.73027963
45057,謝鈺鈺,1,615642,0.00016199,99.73044163
45058,豁出去,1,615643,0.00016199,99.73060362
45059,豁然,1,615644,0.00016199,99.73076562
45060,賺到,1,615645,0.00016199,99.73092761
45061,賺賠,1,615646,0.00016199,99.73108961
45062,賽局,1,615647,0.00016199,99.73125160
45063,賽車手,1,615648,0.00016199,99.73141359
45064,賽車迷,1,615649,0.00016199,99.73157559
45065,賽姆,1,615650,0.00016199,99.73173758
45066,賽拉芬,1,615651,0.00016199,99.73189958
45067,賽者,1,615652,0.00016199,99.73206157
45068,賽門鎮,1,615653,0.00016199,99.73222356
45069,賽馬師,1,615654,0.00016199,99.73238556
45070,賽馬場,1,615655,0.00016199,99.73254755
45071,賽務組,1,615656,0.00016199,99.73270955
45072,賽莉絲柏利島,1,615657,0.00016199,99.73287154
45073,賽程,1,615658,0.00016199,99.73303354
45074,賽會,1,615659,0.00016199,99.73319553
45075,賽餘,1,615660,0.00016199,99.73335752
45076,購用,1,615661,0.00016199,99.73351952
45077,購自,1,615662,0.00016199,99.73368151
45078,購物中心,1,615663,0.00016199,99.73384351
45079,購物券,1,615664,0.00016199,99.73400550
45080,購物者,1,615665,0.00016199,99.73416750
45081,購物樂,1,615666,0.00016199,99.73432949
45082,購貨,1,615667,0.00016199,99.73449148
45083,購貯,1,615668,0.00016199,99.73465348
45084,購買欲,1,615669,0.00016199,99.73481547
45085,購買慾,1,615670,0.00016199,99.73497747
45086,購進,1,615671,0.00016199,99.73513946
45087,趨之若鶩,1,615672,0.00016199,99.73530146
45088,趨往,1,615673,0.00016199,99.73546345
45089,趨附,1,615674,0.00016199,99.73562544
45090,趨跌,1,615675,0.00016199,99.73578744
45091,趨勢性,1,615676,0.00016199,99.73594943
45092,趨緩,1,615677,0.00016199,99.73611143
45093,趨頻,1,615678,0.00016199,99.73627342
45094,蹉跎,1,615679,0.00016199,99.73643541
45095,轄內,1,615680,0.00016199,99.73659741
45096,輾,1,615681,0.00016199,99.73675940
45097,避而不談,1,615682,0.00016199,99.73692140
45098,避邪,1,615683,0.00016199,99.73708339
45099,避暑,1,615684,0.00016199,99.73724539
45100,避震,1,615685,0.00016199,99.73740738
45101,避震性,1,615686,0.00016199,99.73756937
45102,避諱,1,615687,0.00016199,99.73773137
45103,遽,1,615688,0.00016199,99.73789336
45104,遽降,1,615689,0.00016199,99.73805536
45105,遽然,1,615690,0.00016199,99.73821735
45106,遽增,1,615691,0.00016199,99.73837935
45107,還不出,1,615692,0.00016199,99.73854134
45108,還原,1,615693,0.00016199,99.73870333
45109,還得,1,615694,0.00016199,99.73886533
45110,還款,1,615695,0.00016199,99.73902732
45111,還債,1,615696,0.00016199,99.73918932
45112,還錢,1,615697,0.00016199,99.73935131
45113,還擊,1,615698,0.00016199,99.73951330
45114,邁出,1,615699,0.00016199,99.73967530
45115,邁可,1,615700,0.00016199,99.73983729
45116,邁阿密,1,615701,0.00016199,99.73999929
45117,邁前,1,615702,0.00016199,99.74016128
45118,邁格那,1,615703,0.00016199,99.74032328
45119,邁錫尼學家,1,615704,0.00016199,99.74048527
45120,邂逅,1,615705,0.00016199,99.74064726
45121,邀宴,1,615706,0.00016199,99.74080926
45122,邀請函,1,615707,0.00016199,99.74097125
45123,醜化,1,615708,0.00016199,99.74113325
45124,醜惡,1,615709,0.00016199,99.74129524
45125,鍍金,1,615710,0.00016199,99.74145724
45126,鍍鋅,1,615711,0.00016199,99.74161923
45127,鎂,1,615712,0.00016199,99.74178122
45128,鎂光燈,1,615713,0.00016199,99.74194322
45129,鍵座,1,615714,0.00016199,99.74210521
45130,鍊,1,615715,0.00016199,99.74226721
45131,鍊條,1,615716,0.00016199,99.74242920
45132,鍋子,1,615717,0.00016199,99.74259119
45133,鍋杓,1,615718,0.00016199,99.74275319
45134,錘,1,615719,0.00016199,99.74291518
45135,鍾桐生,1,615720,0.00016199,99.74307718
45136,鍾惠良,1,615721,0.00016199,99.74323917
45137,鍾楚紅,1,615722,0.00016199,99.74340117
45138,鍾榮吉,1,615723,0.00016199,99.74356316
45139,鍾漢良,1,615724,0.00016199,99.74372515
45140,鍾曉陽,1,615725,0.00016199,99.74388715
45141,鍾鎮濤,1,615726,0.00016199,99.74404914
45142,鍬,1,615727,0.00016199,99.74421114
45143,鍛羽而歸,1,615728,0.00016199,99.74437313
45144,闊別,1,615729,0.00016199,99.74453513
45145,闊劍,1,615730,0.00016199,99.74469712
45146,隱入,1,615731,0.00016199,99.74485911
45147,隱士,1,615732,0.00016199,99.74502111
45148,隱士廬,1,615733,0.00016199,99.74518310
45149,隱形眼鏡,1,615734,0.00016199,99.74534510
45150,隱沒,1,615735,0.00016199,99.74550709
45151,隱私法,1,615736,0.00016199,99.74566908
45152,隱身,1,615737,0.00016199,99.74583108
45153,隱姓埋名,1,615738,0.00016199,99.74599307
45154,隱居,1,615739,0.00016199,99.74615507
45155,隱退,1,615740,0.00016199,99.74631706
45156,隱密戰艦,1,615741,0.00016199,99.74647906
45157,隱晦,1,615742,0.00016199,99.74664105
45158,隱寮,1,615743,0.00016199,99.74680304
45159,隱蔽,1,615744,0.00016199,99.74696504
45160,隱諱,1,615745,0.00016199,99.74712703
45161,隱隱,1,615746,0.00016199,99.74728903
45162,隱隱可見,1,615747,0.00016199,99.74745102
45163,隱隱約約,1,615748,0.00016199,99.74761302
45164,隱藏性,1,615749,0.00016199,99.74777501
45165,隸,1,615750,0.00016199,99.74793700
45166,雖有,1,615751,0.00016199,99.74809900
45167,雖敗猶榮,1,615752,0.00016199,99.74826099
45168,雖無可厚,1,615753,0.00016199,99.74842299
45169,霜,1,615754,0.00016199,99.74858498
45170,韓米頓,1,615755,0.00016199,99.74874697
45171,韓信點兵,1,615756,0.00016199,99.74890897
45172,韓湘寧,1,615757,0.00016199,99.74907096
45173,韓瑞德,1,615758,0.00016199,99.74923296
45174,韓裔,1,615759,0.00016199,99.74939495
45175,韓福瑞,1,615760,0.00016199,99.74955695
45176,韓製,1,615761,0.00016199,99.74971894
45177,韓德爾,1,615762,0.00016199,99.74988093
45178,韓籍,1,615763,0.00016199,99.75004293
45179,顆麗星胸罩,1,615764,0.00016199,99.75020492
45180,餵食,1,615765,0.00016199,99.75036692
45181,駿馬,1,615766,0.00016199,99.75052891
45182,鮮妍,1,615767,0.00016199,99.75069091
45183,鮮乳,1,615768,0.00016199,99.75085290
45184,鮮魷,1,615769,0.00016199,99.75101489
45185,鮮橙,1,615770,0.00016199,99.75117689
45186,鮪魚派,1,615771,0.00016199,99.75133888
45187,鮭魚,1,615772,0.00016199,99.75150088
45188,鴻友,1,615773,0.00016199,99.75166287
45189,鴻友科技,1,615774,0.00016199,99.75182486
45190,鴻友科技公司,1,615775,0.00016199,99.75198686
45191,鴻海,1,615776,0.00016199,99.75214885
45192,鴻運,1,615777,0.00016199,99.75231085
45193,鴻福,1,615778,0.00016199,99.75247284
45194,鴻禧山莊事件,1,615779,0.00016199,99.75263484
45195,鴻禧美術館,1,615780,0.00016199,99.75279683
45196,鴻禧集團,1,615781,0.00016199,99.75295882
45197,鴻鴻,1,615782,0.00016199,99.75312082
45198,黏土牆,1,615783,0.00016199,99.75328281
45199,黏不黏,1,615784,0.00016199,99.75344481
45200,黏合,1,615785,0.00016199,99.75360680
45201,黏性,1,615786,0.00016199,99.75376880
45202,黏泥,1,615787,0.00016199,99.75393079
45203,黏液素,1,615788,0.00016199,99.75409278
45204,黏液量,1,615789,0.00016199,99.75425478
45205,黏補,1,615790,0.00016199,99.75441677
45206,黏膜,1,615791,0.00016199,99.75457877
45207,黏膩感,1,615792,0.00016199,99.75474076
45208,點出,1,615793,0.00016199,99.75490275
45209,點取,1,615794,0.00016199,99.75506475
45210,點狀,1,615795,0.00016199,99.75522674
45211,點亮,1,615796,0.00016199,99.75538874
45212,點破,1,615797,0.00016199,99.75555073
45213,點起,1,615798,0.00016199,99.75571273
45214,點描畫法,1,615799,0.00016199,99.75587472
45215,點菜,1,615800,0.00016199,99.75603671
45216,點選,1,615801,0.00016199,99.75619871
45217,點點,1,615802,0.00016199,99.75636070
45218,點點滴滴,1,615803,0.00016199,99.75652270
45219,黝亮,1,615804,0.00016199,99.75668469
45220,黝暗,1,615805,0.00016199,99.75684669
45221,黛比,1,615806,0.00016199,99.75700868
45222,黛安．艾克曼,1,615807,0.00016199,99.75717067
45223,黛安芬,1,615808,0.00016199,99.75733267
45224,黛安娜,1,615809,0.00016199,99.75749466
45225,黛安基頓,1,615810,0.00016199,99.75765666
45226,黛芙尼級,1,615811,0.00016199,99.75781865
45227,黛咪,1,615812,0.00016199,99.75798064
45228,黛娜梅兒,1,615813,0.00016199,99.75814264
45229,叢山,1,615814,0.00016199,99.75830463
45230,叢書,1,615815,0.00016199,99.75846663
45231,嚮慕,1,615816,0.00016199,99.75862862
45232,壘球鞋,1,615817,0.00016199,99.75879062
45233,擴充插槽,1,615818,0.00016199,99.75895261
45234,擴延,1,615819,0.00016199,99.75911460
45235,擴音機,1,615820,0.00016199,99.75927660
45236,擴散式,1,615821,0.00016199,99.75943859
45237,擴散雲,1,615822,0.00016199,99.75960059
45238,擴權,1,615823,0.00016199,99.75976258
45239,擲槍,1,615824,0.00016199,99.75992458
45240,擾亂,1,615825,0.00016199,99.76008657
45241,擾攘,1,615826,0.00016199,99.76024856
45242,擺一邊,1,615827,0.00016199,99.76041056
45243,擺入,1,615828,0.00016199,99.76057255
45244,擺不平,1,615829,0.00016199,99.76073455
45245,擺佈,1,615830,0.00016199,99.76089654
45246,擺明,1,615831,0.00016199,99.76105853
45247,擺起,1,615832,0.00016199,99.76122053
45248,擺置,1,615833,0.00016199,99.76138252
45249,擺飾品,1,615834,0.00016199,99.76154452
45250,擺滿,1,615835,0.00016199,99.76170651
45251,擺盤,1,615836,0.00016199,99.76186851
45252,擺攤,1,615837,0.00016199,99.76203050
45253,擷,1,615838,0.00016199,99.76219249
45254,斷句,1,615839,0.00016199,99.76235449
45255,斷交,1,615840,0.00016199,99.76251648
45256,斷言,1,615841,0.00016199,99.76267848
45257,斷定,1,615842,0.00016199,99.76284047
45258,斷垣殘壁,1,615843,0.00016199,99.76300247
45259,斷面,1,615844,0.00016199,99.76316446
45260,斷送,1,615845,0.00016199,99.76332645
45261,斷崖,1,615846,0.00016199,99.76348845
45262,斷掉,1,615847,0.00016199,99.76365044
45263,斷落,1,615848,0.00016199,99.76381244
45264,斷層掃瞄,1,615849,0.00016199,99.76397443
45265,斷線,1,615850,0.00016199,99.76413643
45266,斷頭,1,615851,0.00016199,99.76429842
45267,斷頭臺,1,615852,0.00016199,99.76446041
45268,檳榔攤,1,615853,0.00016199,99.76462241
45269,檸檬加味啤酒,1,615854,0.00016199,99.76478440
45270,檸檬黃,1,615855,0.00016199,99.76494640
45271,檯底交易,1,615856,0.00016199,99.76510839
45272,檯面上,1,615857,0.00016199,99.76527038
45273,檯燈,1,615858,0.00016199,99.76543238
45274,歸入,1,615859,0.00016199,99.76559437
45275,歸仁鄉,1,615860,0.00016199,99.76575637
45276,歸功,1,615861,0.00016199,99.76591836
45277,歸因,1,615862,0.00016199,99.76608036
45278,歸納性,1,615863,0.00016199,99.76624235
45279,歸宿,1,615864,0.00016199,99.76640434
45280,歸趨,1,615865,0.00016199,99.76656634
45281,歸屬權,1,615866,0.00016199,99.76672833
45282,瀉湖,1,615867,0.00016199,99.76689033
45283,瀉藥,1,615868,0.00016199,99.76705232
45284,瀋陽軍區,1,615869,0.00016199,99.76721432
45285,濾波器片,1,615870,0.00016199,99.76737631
45286,濾芯,1,615871,0.00016199,99.76753830
45287,濾清器,1,615872,0.00016199,99.76770030
45288,濾淨器,1,615873,0.00016199,99.76786229
45289,濾篩,1,615874,0.00016199,99.76802429
45290,瀑布泉,1,615875,0.00016199,99.76818628
45291,瀏河口,1,615876,0.00016199,99.76834827
45292,瀏覽軟體,1,615877,0.00016199,99.76851027
45293,瀏灠,1,615878,0.00016199,99.76867226
45294,燻,1,615879,0.00016199,99.76883426
45295,獵人,1,615880,0.00016199,99.76899625
45296,獵人頭公司,1,615881,0.00016199,99.76915825
45297,獵戶座,1,615882,0.00016199,99.76932024
45298,獵取,1,615883,0.00016199,99.76948223
45299,獵食性,1,615884,0.00016199,99.76964423
45300,獵食動物,1,615885,0.00016199,99.76980622
45301,獵殺,1,615886,0.00016199,99.76996822
45302,獵殺區,1,615887,0.00016199,99.77013021
45303,獵電艇,1,615888,0.00016199,99.77029221
45304,甕,1,615889,0.00016199,99.77045420
45305,癖好,1,615890,0.00016199,99.77061619
45306,瞽,1,615891,0.00016199,99.77077819
45307,瞿友濘,1,615892,0.00016199,99.77094018
45308,瞿塘,1,615893,0.00016199,99.77110218
45309,瞻,1,615894,0.00016199,99.77126417
45310,禮佛,1,615895,0.00016199,99.77142616
45311,禮車,1,615896,0.00016199,99.77158816
45312,禮券,1,615897,0.00016199,99.77175015
45313,禮尚往來,1,615898,0.00016199,99.77191215
45314,禮俗,1,615899,0.00016199,99.77207414
45315,禮砲,1,615900,0.00016199,99.77223614
45316,禮節,1,615901,0.00016199,99.77239813
45317,禮義廉恥,1,615902,0.00016199,99.77256012
45318,禮賓,1,615903,0.00016199,99.77272212
45319,禮賓司長,1,615904,0.00016199,99.77288411
45320,禮賓車,1,615905,0.00016199,99.77304611
45321,禮讓,1,615906,0.00016199,99.77320810
45322,禮讚,1,615907,0.00016199,99.77337010
45323,穢言,1,615908,0.00016199,99.77353209
45324,竄入,1,615909,0.00016199,99.77369408
45325,竄出,1,615910,0.00016199,99.77385608
45326,竅門,1,615911,0.00016199,99.77401807
45327,簡永祥,1,615912,0.00016199,99.77418007
45328,簡立人,1,615913,0.00016199,99.77434206
45329,簡任,1,615914,0.00016199,99.77450405
45330,簡志郎,1,615915,0.00016199,99.77466605
45331,簡志朗,1,615916,0.00016199,99.77482804
45332,簡言之,1,615917,0.00016199,99.77499004
45333,簡易式,1,615918,0.00016199,99.77515203
45334,簡秋旭,1,615919,0.00016199,99.77531403
45335,簡振炎,1,615920,0.00016199,99.77547602
45336,簡略,1,615921,0.00016199,99.77563801
45337,簡單化,1,615922,0.00016199,99.77580001
45338,簡報室,1,615923,0.00016199,99.77596200
45339,簡嘉年,1,615924,0.00016199,99.77612400
45340,簡鍚��,1,615925,0.00016199,99.77628599
45341,簡簡單單,1,615926,0.00016199,99.77644799
45342,糧食局長,1,615927,0.00016199,99.77660998
45343,織女,1,615928,0.00016199,99.77677197
45344,織布,1,615929,0.00016199,99.77693397
45345,織布廠,1,615930,0.00016199,99.77709596
45346,繕稿人,1,615931,0.00016199,99.77725796
45347,繞進,1,615932,0.00016199,99.77741995
45348,繞製,1,615933,0.00016199,99.77758194
45349,繡球花,1,615934,0.00016199,99.77774394
45350,繒圖,1,615935,0.00016199,99.77790593
45351,翹首,1,615936,0.00016199,99.77806793
45352,翹楚,1,615937,0.00016199,99.77822992
45353,翹翹,1,615938,0.00016199,99.77839192
45354,翻一番,1,615939,0.00016199,99.77855391
45355,翻山,1,615940,0.00016199,99.77871590
45356,翻本,1,615941,0.00016199,99.77887790
45357,翻車,1,615942,0.00016199,99.77903989
45358,翻炒,1,615943,0.00016199,99.77920189
45359,翻查,1,615944,0.00016199,99.77936388
45360,翻背椅座,1,615945,0.00016199,99.77952588
45361,翻修,1,615946,0.00016199,99.77968787
45362,翻耕,1,615947,0.00016199,99.77984986
45363,翻造,1,615948,0.00016199,99.78001186
45364,翻揚,1,615949,0.00016199,99.78017385
45365,翻雲覆雨,1,615950,0.00016199,99.78033585
45366,翻轉,1,615951,0.00016199,99.78049784
45367,翻騰,1,615952,0.00016199,99.78065983
45368,職司,1,615953,0.00016199,99.78082183
45369,職掌,1,615954,0.00016199,99.78098382
45370,職棒大聯盟,1,615955,0.00016199,99.78114582
45371,職棒卡,1,615956,0.00016199,99.78130781
45372,職棒明星,1,615957,0.00016199,99.78146981
45373,職棒社,1,615958,0.00016199,99.78163180
45374,職棒界,1,615959,0.00016199,99.78179379
45375,職棒退役球員引用條例,1,615960,0.00016199,99.78195579
45376,職棒選手,1,615961,0.00016199,99.78211778
45377,職棒聯盟,1,615962,0.00016199,99.78227978
45378,職業化,1,615963,0.00016199,99.78244177
45379,職業災害,1,615964,0.00016199,99.78260377
45380,職業殺手,1,615965,0.00016199,99.78276576
45381,職業運動,1,615966,0.00016199,99.78292775
45382,職籃二年,1,615967,0.00016199,99.78308975
45383,職籃卡,1,615968,0.00016199,99.78325174
45384,職籃賽,1,615969,0.00016199,99.78341374
45385,聶湖濱,1,615970,0.00016199,99.78357573
45386,臍,1,615971,0.00016199,99.78373772
45387,臍帶,1,615972,0.00016199,99.78389972
45388,舊市區,1,615973,0.00016199,99.78406171
45389,舊式,1,615974,0.00016199,99.78422371
45390,舊作,1,615975,0.00016199,99.78438570
45391,舊事,1,615976,0.00016199,99.78454770
45392,舊金山新聞,1,615977,0.00016199,99.78470969
45393,舊約聖經,1,615978,0.00016199,99.78487168
45394,舊疾,1,615979,0.00016199,99.78503368
45395,舊帳,1,615980,0.00016199,99.78519567
45396,舊情,1,615981,0.00016199,99.78535767
45397,舊情人,1,615982,0.00016199,99.78551966
45398,舊貨,1,615983,0.00016199,99.78568166
45399,舊惡,1,615984,0.00016199,99.78584365
45400,舊港,1,615985,0.00016199,99.78600564
45401,舊債,1,615986,0.00016199,99.78616764
45402,舊夢,1,615987,0.00016199,99.78632963
45403,舊稱,1,615988,0.00016199,99.78649163
45404,舊曆年,1,615989,0.00016199,99.78665362
45405,藏文,1,615990,0.00016199,99.78681561
45406,藏污納垢,1,615991,0.00016199,99.78697761
45407,藏身處,1,615992,0.00016199,99.78713960
45408,藏拙,1,615993,0.00016199,99.78730160
45409,藏品,1,615994,0.00016199,99.78746359
45410,藏匿,1,615995,0.00016199,99.78762559
45411,藏量,1,615996,0.00016199,99.78778758
45412,薩巴塔,1,615997,0.00016199,99.78794957
45413,薩提,1,615998,0.00016199,99.78811157
45414,薩爾瓦多,1,615999,0.00016199,99.78827356
45415,薩爾茲堡,1,616000,0.00016199,99.78843556
45416,薩謨奈人,1,616001,0.00016199,99.78859755
45417,薩羅尼克,1,616002,0.00016199,99.78875955
45418,藍山,1,616003,0.00016199,99.78892154
45419,藍山咖啡,1,616004,0.00016199,99.78908353
45420,藍天極景,1,616005,0.00016199,99.78924553
45421,藍本,1,616006,0.00016199,99.78940752
45422,藍田豐雄,1,616007,0.00016199,99.78956952
45423,藍白,1,616008,0.00016199,99.78973151
45424,藍乳酪千層派,1,616009,0.00016199,99.78989351
45425,藍振輝,1,616010,0.00016199,99.79005550
45426,藍納,1,616011,0.00016199,99.79021749
45427,藍帶,1,616012,0.00016199,99.79037949
45428,藍帶豬裶,1,616013,0.00016199,99.79054148
45429,藍鳥隊,1,616014,0.00016199,99.79070348
45430,藍斯漢瑞森,1,616015,0.00016199,99.79086547
45431,藍紫色,1,616016,0.00016199,99.79102746
45432,藍黑色,1,616017,0.00016199,99.79118946
45433,藍腹鷴,1,616018,0.00016199,99.79135145
45434,藍綠,1,616019,0.00016199,99.79151345
45435,藍領階級,1,616020,0.00016199,99.79167544
45436,藍點,1,616021,0.00016199,99.79183744
45437,藍鬍子城堡,1,616022,0.00016199,99.79199943
45438,藍黴菌,1,616023,0.00016199,99.79216142
45439,薦,1,616024,0.00016199,99.79232342
45440,蟬,1,616025,0.00016199,99.79248541
45441,蟲,1,616026,0.00016199,99.79264741
45442,蟲唧,1,616027,0.00016199,99.79280940
45443,覆核,1,616028,0.00016199,99.79297140
45444,覆徹,1,616029,0.00016199,99.79313339
45445,覆議核可權,1,616030,0.00016199,99.79329538
45446,謹言慎行,1,616031,0.00016199,99.79345738
45447,謬誤,1,616032,0.00016199,99.79361937
45448,豐山,1,616033,0.00016199,99.79378137
45449,豐水期,1,616034,0.00016199,99.79394336
45450,豐功偉業,1,616035,0.00016199,99.79410535
45451,豐田市,1,616036,0.00016199,99.79426735
45452,豐田汽車,1,616037,0.00016199,99.79442934
45453,豐衣,1,616038,0.00016199,99.79459134
45454,豐足感,1,616039,0.00016199,99.79475333
45455,豐厚,1,616040,0.00016199,99.79491533
45456,豐盈,1,616041,0.00016199,99.79507732
45457,豐原,1,616042,0.00016199,99.79523931
45458,豐原市,1,616043,0.00016199,99.79540131
45459,豐隆集團,1,616044,0.00016199,99.79556330
45460,豐實,1,616045,0.00016199,99.79572530
45461,豐滿型,1,616046,0.00016199,99.79588729
45462,豐潤,1,616047,0.00016199,99.79604929
45463,豐興,1,616048,0.00016199,99.79621128
45464,豐濱鄉,1,616049,0.00016199,99.79637327
45465,豐饒,1,616050,0.00016199,99.79653527
45466,蹦出來,1,616051,0.00016199,99.79669726
45467,蹦蹦跳跳,1,616052,0.00016199,99.79685926
45468,轉口地,1,616053,0.00016199,99.79702125
45469,轉口量,1,616054,0.00016199,99.79718324
45470,轉回,1,616055,0.00016199,99.79734524
45471,轉行,1,616056,0.00016199,99.79750723
45472,轉攻,1,616057,0.00016199,99.79766923
45473,轉來轉去,1,616058,0.00016199,99.79783122
45474,轉承,1,616059,0.00016199,99.79799322
45475,轉型期,1,616060,0.00016199,99.79815521
45476,轉為,1,616061,0.00016199,99.79831720
45477,轉個,1,616062,0.00016199,99.79847920
45478,轉差,1,616063,0.00016199,99.79864119
45479,轉送,1,616064,0.00016199,99.79880319
45480,轉動式,1,616065,0.00016199,99.79896518
45481,轉售,1,616066,0.00016199,99.79912718
45482,轉帳,1,616067,0.00016199,99.79928917
45483,轉帳支出傳票,1,616068,0.00016199,99.79945116
45484,轉帳卡,1,616069,0.00016199,99.79961316
45485,轉眼,1,616070,0.00016199,99.79977515
45486,轉換為,1,616071,0.00016199,99.79993715
45487,轉業,1,616072,0.00016199,99.80009914
45488,轉運集散站,1,616073,0.00016199,99.80026113
45489,轉製,1,616074,0.00016199,99.80042313
45490,轉賣,1,616075,0.00016199,99.80058512
45491,轉學,1,616076,0.00016199,99.80074712
45492,轉虧,1,616077,0.00016199,99.80090911
45493,轉壞,1,616078,0.00016199,99.80107111
45494,轉譯,1,616079,0.00016199,99.80123310
45495,邈遠,1,616080,0.00016199,99.80139509
45496,醫務組,1,616081,0.00016199,99.80155709
45497,醫學生,1,616082,0.00016199,99.80171908
45498,醫學會,1,616083,0.00016199,99.80188108
45499,醫療人員,1,616084,0.00016199,99.80204307
45500,醫療站,1,616085,0.00016199,99.80220507
45501,醫療基金,1,616086,0.00016199,99.80236706
45502,醬瓜,1,616087,0.00016199,99.80252905
45503,醬菜,1,616088,0.00016199,99.80269105
45504,釐米,1,616089,0.00016199,99.80285304
45505,釐定,1,616090,0.00016199,99.80301504
45506,釐訂,1,616091,0.00016199,99.80317703
45507,鎖孔,1,616092,0.00016199,99.80333902
45508,鎖住,1,616093,0.00016199,99.80350102
45509,鎖緊,1,616094,0.00016199,99.80366301
45510,鎖鑰,1,616095,0.00016199,99.80382501
45511,鎮日,1,616096,0.00016199,99.80398700
45512,鎮代表,1,616097,0.00016199,99.80414900
45513,鎮江,1,616098,0.00016199,99.80431099
45514,鎮海南樂社,1,616099,0.00016199,99.80447298
45515,鎮農會,1,616100,0.00016199,99.80463498
45516,鎮遠,1,616101,0.00016199,99.80479697
45517,鎚狀,1,616102,0.00016199,99.80495897
45518,闔家,1,616103,0.00016199,99.80512096
45519,闖入,1,616104,0.00016199,99.80528296
45520,闖入者,1,616105,0.00016199,99.80544495
45521,闖進,1,616106,0.00016199,99.80560694
45522,闕山雄,1,616107,0.00016199,99.80576894
45523,闕如,1,616108,0.00016199,99.80593093
45524,離合器,1,616109,0.00016199,99.80609293
45525,離家出走,1,616110,0.00016199,99.80625492
45526,離島工業區,1,616111,0.00016199,99.80641691
45527,離情,1,616112,0.00016199,99.80657891
45528,離華,1,616113,0.00016199,99.80674090
45529,離群,1,616114,0.00016199,99.80690290
45530,離群索居,1,616115,0.00016199,99.80706489
45531,離線辨識技術,1,616116,0.00016199,99.80722689
45532,雜交,1,616117,0.00016199,99.80738888
45533,雜污,1,616118,0.00016199,99.80755087
45534,雜事,1,616119,0.00016199,99.80771287
45535,雜貨店,1,616120,0.00016199,99.80787486
45536,雜貨船,1,616121,0.00016199,99.80803686
45537,雙刀鋒,1,616122,0.00016199,99.80819885
45538,雙十國慶,1,616123,0.00016199,99.80836085
45539,雙子星號,1,616124,0.00016199,99.80852284
45540,雙子星辨識引擎,1,616125,0.00016199,99.80868483
45541,雙月刊,1,616126,0.00016199,99.80884683
45542,雙凸,1,616127,0.00016199,99.80900882
45543,雙向呼叫器,1,616128,0.00016199,99.80917082
45544,雙向通訊,1,616129,0.00016199,99.80933281
45545,雙向無線通訊,1,616130,0.00016199,99.80949480
45546,雙向傳呼裝置,1,616131,0.00016199,99.80965680
45547,雙向傳呼器,1,616132,0.00016199,99.80981879
45548,雙名制,1,616133,0.00016199,99.80998079
45549,雙色,1,616134,0.00016199,99.81014278
45550,雙位元碼,1,616135,0.00016199,99.81030478
45551,雙李,1,616136,0.00016199,99.81046677
45552,雙肘,1,616137,0.00016199,99.81062876
45553,雙角,1,616138,0.00016199,99.81079076
45554,雙和弦,1,616139,0.00016199,99.81095275
45555,雙和聲,1,616140,0.00016199,99.81111475
45556,雙底谷,1,616141,0.00016199,99.81127674
45557,雙狗,1,616142,0.00016199,99.81143874
45558,雙盲,1,616143,0.00016199,99.81160073
45559,雙股劍,1,616144,0.00016199,99.81176272
45560,雙冠王,1,616145,0.00016199,99.81192472
45561,雙流村,1,616146,0.00016199,99.81208671
45562,雙流森林遊樂區,1,616147,0.00016199,99.81224871
45563,雙流瀑布,1,616148,0.00016199,99.81241070
45564,雙面,1,616149,0.00016199,99.81257269
45565,雙音圈,1,616150,0.00016199,99.81273469
45566,雙峰,1,616151,0.00016199,99.81289668
45567,雙翅,1,616152,0.00016199,99.81305868
45568,雙能,1,616153,0.00016199,99.81322067
45569,雙桿,1,616154,0.00016199,99.81338267
45570,雙殺,1,616155,0.00016199,99.81354466
45571,雙眼線液,1,616156,0.00016199,99.81370665
45572,雙眸,1,616157,0.00016199,99.81386865
45573,雙連桿式,1,616158,0.00016199,99.81403064
45574,雙陰道,1,616159,0.00016199,99.81419264
45575,雙鹿五加皮,1,616160,0.00016199,99.81435463
45576,雙喜臨門,1,616161,0.00016199,99.81451663
45577,雙殼貝狀,1,616162,0.00016199,99.81467862
45578,雙發動機,1,616163,0.00016199,99.81484061
45579,雙程,1,616164,0.00016199,99.81500261
45580,雙絞線,1,616165,0.00016199,99.81516460
45581,雙腕式造粒機,1,616166,0.00016199,99.81532660
45582,雙溪,1,616167,0.00016199,99.81548859
45583,雙鉗,1,616168,0.00016199,99.81565058
45584,雙管,1,616169,0.00016199,99.81581258
45585,雙語制,1,616170,0.00016199,99.81597457
45586,雙頜,1,616171,0.00016199,99.81613657
45587,雙機作業,1,616172,0.00016199,99.81629856
45588,雙燃料系統,1,616173,0.00016199,99.81646056
45589,雙頭肌,1,616174,0.00016199,99.81662255
45590,雙簧,1,616175,0.00016199,99.81678454
45591,雙簧管,1,616176,0.00016199,99.81694654
45592,雙雙,1,616177,0.00016199,99.81710853
45593,雙邊會談,1,616178,0.00016199,99.81727053
45594,雛型,1,616179,0.00016199,99.81743252
45595,雞犬不寧,1,616180,0.00016199,99.81759452
45596,雞飛狗跳,1,616181,0.00016199,99.81775651
45597,雞場,1,616182,0.00016199,99.81791850
45598,雞雞大力麵,1,616183,0.00016199,99.81808050
45599,雞籠,1,616184,0.00016199,99.81824249
45600,鞭子,1,616185,0.00016199,99.81840449
45601,鞭炮,1,616186,0.00016199,99.81856648
45602,鞭策,1,616187,0.00016199,99.81872848
45603,鞭策者,1,616188,0.00016199,99.81889047
45604,額骨,1,616189,0.00016199,99.81905246
45605,顏,1,616190,0.00016199,99.81921446
45606,顏文閂,1,616191,0.00016199,99.81937645
45607,顏色是怎麼來的,1,616192,0.00016199,99.81953845
45608,顏秉璠,1,616193,0.00016199,99.81970044
45609,題綱,1,616194,0.00016199,99.81986243
45610,顎,1,616195,0.00016199,99.82002443
45611,顎畢河,1,616196,0.00016199,99.82018642
45612,餽贈,1,616197,0.00016199,99.82034842
45613,騎手,1,616198,0.00016199,99.82051041
45614,騎乘,1,616199,0.00016199,99.82067241
45615,騎馬賽,1,616200,0.00016199,99.82083440
45616,騎樓,1,616201,0.00016199,99.82099639
45617,鬆一,1,616202,0.00016199,99.82115839
45618,鬆土,1,616203,0.00016199,99.82132038
45619,鬆動,1,616204,0.00016199,99.82148238
45620,鬆掉,1,616205,0.00016199,99.82164437
45621,鬆軟,1,616206,0.00016199,99.82180637
45622,魏良道,1,616207,0.00016199,99.82196836
45623,魏明倫,1,616208,0.00016199,99.82213035
45624,魏東陽,1,616209,0.00016199,99.82229235
45625,魏格曼,1,616210,0.00016199,99.82245434
45626,魏特蘭,1,616211,0.00016199,99.82261634
45627,魏理仕不動產顧問公司,1,616212,0.00016199,99.82277833
45628,魏理仕國際不動產顧問有限公司,1,616213,0.00016199,99.82294032
45629,魏斯蕭斯,1,616214,0.00016199,99.82310232
45630,魏瑛娟,1,616215,0.00016199,99.82326431
45631,魏義,1,616216,0.00016199,99.82342631
45632,魏銘,1,616217,0.00016199,99.82358830
45633,壞蛋,1,616218,0.00016199,99.82375030
45634,寵物店,1,616219,0.00016199,99.82391229
45635,龐克頭,1,616220,0.00016199,99.82407428
45636,龐貝,1,616221,0.00016199,99.82423628
45637,龐建國,1,616222,0.00016199,99.82439827
45638,龐然大物,1,616223,0.00016199,99.82456027
45639,龐雜,1,616224,0.00016199,99.82472226
45640,懲,1,616225,0.00016199,99.82488426
45641,懲罰性,1,616226,0.00016199,99.82504625
45642,懲罰性關稅,1,616227,0.00016199,99.82520824
45643,懷中,1,616228,0.00016199,99.82537024
45644,懷古,1,616229,0.00016199,99.82553223
45645,懷孕期,1,616230,0.00016199,99.82569423
45646,懷恨,1,616231,0.00016199,99.82585622
45647,懷春,1,616232,0.00016199,99.82601821
45648,懷胎,1,616233,0.00016199,99.82618021
45649,懷裡,1,616234,0.00016199,99.82634220
45650,懷爐,1,616235,0.00016199,99.82650420
45651,懶條沙拉,1,616236,0.00016199,99.82666619
45652,懶散,1,616237,0.00016199,99.82682819
45653,懶腰,1,616238,0.00016199,99.82699018
45654,攀岩者,1,616239,0.00016199,99.82715217
45655,攀附,1,616240,0.00016199,99.82731417
45656,攀談,1,616241,0.00016199,99.82747616
45657,曠達,1,616242,0.00016199,99.82763816
45658,曝,1,616243,0.00016199,99.82780015
45659,曝光值,1,616244,0.00016199,99.82796215
45660,曝光量,1,616245,0.00016199,99.82812414
45661,曝光矯正量,1,616246,0.00016199,99.82828613
45662,曝光矯正標示,1,616247,0.00016199,99.82844813
45663,曝露,1,616248,0.00016199,99.82861012
45664,曝曬,1,616249,0.00016199,99.82877212
45665,櫝林家,1,616250,0.00016199,99.82893411
45666,櫝林家的滄桑,1,616251,0.00016199,99.82909610
45667,瀝青泂,1,616252,0.00016199,99.82925810
45668,爆香,1,616253,0.00016199,99.82942009
45669,爆破,1,616254,0.00016199,99.82958209
45670,爆彈,1,616255,0.00016199,99.82974408
45671,獸皮,1,616256,0.00016199,99.82990608
45672,獸界,1,616257,0.00016199,99.83006807
45673,獸骨,1,616258,0.00016199,99.83023006
45674,獸族,1,616259,0.00016199,99.83039206
45675,瓊文,1,616260,0.00016199,99.83055405
45676,瓊安娜葛里森,1,616261,0.00016199,99.83071605
45677,瓊崖海裳,1,616262,0.00016199,99.83087804
45678,瓊麻絲,1,616263,0.00016199,99.83104004
45679,瓊斯,1,616264,0.00016199,99.83120203
45680,瓊斯杯,1,616265,0.00016199,99.83136402
45681,瓊斯杯籃賽,1,616266,0.00016199,99.83152602
45682,瓊斯盃籃賽,1,616267,0.00016199,99.83168801
45683,瓊斯術式,1,616268,0.00016199,99.83185001
45684,瓊瑤,1,616269,0.00016199,99.83201200
45685,疆土,1,616270,0.00016199,99.83217399
45686,疆界,1,616271,0.00016199,99.83233599
45687,癡心,1,616272,0.00016199,99.83249798
45688,癡狂,1,616273,0.00016199,99.83265998
45689,癡情會心疼,1,616274,0.00016199,99.83282197
45690,矇眼,1,616275,0.00016199,99.83298397
45691,矇騙,1,616276,0.00016199,99.83314596
45692,矇矓,1,616277,0.00016199,99.83330795
45693,穩定度,1,616278,0.00016199,99.83346995
45694,穩定期,1,616279,0.00016199,99.83363194
45695,穩定鰭,1,616280,0.00016199,99.83379394
45696,穩獲,1,616281,0.00016199,99.83395593
45697,簽入,1,616282,0.00016199,99.83411793
45698,簽名球,1,616283,0.00016199,99.83427992
45699,簽名會,1,616284,0.00016199,99.83444191
45700,簽名檔,1,616285,0.00016199,99.83460391
45701,簽收,1,616286,0.00016199,99.83476590
45702,簽帳,1,616287,0.00016199,99.83492790
45703,簽證,1,616288,0.00016199,99.83508989
45704,簽證費,1,616289,0.00016199,99.83525188
45705,簷,1,616290,0.00016199,99.83541388
45706,羅大吉,1,616291,0.00016199,99.83557587
45707,羅丹,1,616292,0.00016199,99.83573787
45708,羅文山,1,616293,0.00016199,99.83589986
45709,羅文章,1,616294,0.00016199,99.83606186
45710,羅比列克,1,616295,0.00016199,99.83622385
45711,羅生門,1,616296,0.00016199,99.83638584
45712,羅列,1,616297,0.00016199,99.83654784
45713,羅吐魯阿,1,616298,0.00016199,99.83670983
45714,羅伯．史坦伯,1,616299,0.00016199,99.83687183
45715,羅伯．利柏殊,1,616300,0.00016199,99.83703382
45716,羅伯．威爾森,1,616301,0.00016199,99.83719582
45717,羅伯．羅森梭,1,616302,0.00016199,99.83735781
45718,羅伯杜瓦,1,616303,0.00016199,99.83751980
45719,羅伯定律,1,616304,0.00016199,99.83768180
45720,羅伯柯恩,1,616305,0.00016199,99.83784379
45721,羅伯派克,1,616306,0.00016199,99.83800579
45722,羅伯特,1,616307,0.00016199,99.83816778
45723,羅伯特．派特生,1,616308,0.00016199,99.83832977
45724,羅伯特．羅森索,1,616309,0.00016199,99.83849177
45725,羅東運動公園,1,616310,0.00016199,99.83865376
45726,羅勃阿特曼,1,616311,0.00016199,99.83881576
45727,羅勃特考帝頓,1,616312,0.00016199,99.83897775
45728,羅勃蕭,1,616313,0.00016199,99.83913975
45729,羅柏斯康,1,616314,0.00016199,99.83930174
45730,羅茲威爾台,1,616315,0.00016199,99.83946373
45731,羅茲威爾市,1,616316,0.00016199,99.83962573
45732,羅茲威爾墜毀案,1,616317,0.00016199,99.83978772
45733,羅茲凱帝,1,616318,0.00016199,99.83994972
45734,羅馬時代,1,616319,0.00016199,99.84011171
45735,羅曼史,1,616320,0.00016199,99.84027371
45736,羅曼波蘭斯基,1,616321,0.00016199,99.84043570
45737,羅曼蒂克,1,616322,0.00016199,99.84059769
45738,羅國甫,1,616323,0.00016199,99.84075969
45739,羅密歐,1,616324,0.00016199,99.84092168
45740,羅彩麗,1,616325,0.00016199,99.84108368
45741,羅敏卿,1,616326,0.00016199,99.84124567
45742,羅盛豐,1,616327,0.00016199,99.84140766
45743,羅莎,1,616328,0.00016199,99.84156966
45744,羅斯,1,616329,0.00016199,99.84173165
45745,羅斯萊斯,1,616330,0.00016199,99.84189365
45746,羅斯萊斯公司,1,616331,0.00016199,99.84205564
45747,羅斯維爾市,1,616332,0.00016199,99.84221764
45748,羅森索,1,616333,0.00016199,99.84237963
45749,羅漢,1,616334,0.00016199,99.84254162
45750,羅翠瑩,1,616335,0.00016199,99.84270362
45751,羅際棠,1,616336,0.00016199,99.84286561
45752,羅魁,1,616337,0.00016199,99.84302761
45753,羅德丹尼爾,1,616338,0.00016199,99.84318960
45754,羅德伯,1,616339,0.00016199,99.84335160
45755,羅德利果,1,616340,0.00016199,99.84351359
45756,羅德島,1,616341,0.00016199,99.84367558
45757,羅穗糊,1,616342,0.00016199,99.84383758
45758,羅蘭,1,616343,0.00016199,99.84399957
45759,羅蘭約菲,1,616344,0.00016199,99.84416157
45760,羅蘭德,1,616345,0.00016199,99.84432356
45761,繳付,1,616346,0.00016199,99.84448555
45762,繳庫,1,616347,0.00016199,99.84464755
45763,繳費,1,616348,0.00016199,99.84480954
45764,繳驗,1,616349,0.00016199,99.84497154
45765,臘,1,616350,0.00016199,99.84513353
45766,臘花,1,616351,0.00016199,99.84529553
45767,臘筆,1,616352,0.00016199,99.84545752
45768,臘像館,1,616353,0.00016199,99.84561951
45769,藝奴居,1,616354,0.00016199,99.84578151
45770,藝坊,1,616355,0.00016199,99.84594350
45771,藝品店,1,616356,0.00016199,99.84610550
45772,藝品商,1,616357,0.00016199,99.84626749
45773,藝能,1,616358,0.00016199,99.84642949
45774,藝術史家,1,616359,0.00016199,99.84659148
45775,藝術走廊,1,616360,0.00016199,99.84675347
45776,藝術季,1,616361,0.00016199,99.84691547
45777,藝術院,1,616362,0.00016199,99.84707746
45778,藝術圈,1,616363,0.00016199,99.84723946
45779,藝術新聞,1,616364,0.00016199,99.84740145
45780,藝術電影,1,616365,0.00016199,99.84756345
45781,藝術館,1,616366,0.00016199,99.84772544
45782,藝術鏡,1,616367,0.00016199,99.84788743
45783,藝評,1,616368,0.00016199,99.84804943
45784,藝閣,1,616369,0.00016199,99.84821142
45785,藝館,1,616370,0.00016199,99.84837342
45786,藤井道夫,1,616371,0.00016199,99.84853541
45787,藤木,1,616372,0.00016199,99.84869740
45788,藤枝森林遊樂區,1,616373,0.00016199,99.84885940
45789,藤實,1,616374,0.00016199,99.84902139
45790,藥力,1,616375,0.00016199,99.84918339
45791,藥材費,1,616376,0.00016199,99.84934538
45792,藥事人員,1,616377,0.00016199,99.84950738
45793,藥店,1,616378,0.00016199,99.84966937
45794,藥物與,1,616379,0.00016199,99.84983136
45795,藥政處長,1,616380,0.00016199,99.84999336
45796,藥界,1,616381,0.00016199,99.85015535
45797,藥盆,1,616382,0.00016199,99.85031735
45798,藥粉,1,616383,0.00016199,99.85047934
45799,藥草,1,616384,0.00016199,99.85064134
45800,藥瓶,1,616385,0.00016199,99.85080333
45801,藥單,1,616386,0.00016199,99.85096532
45802,藥蒸房,1,616387,0.00016199,99.85112732
45803,藥學,1,616388,0.00016199,99.85128931
45804,藥膳,1,616389,0.00016199,99.85145131
45805,藥療,1,616390,0.00016199,99.85161330
45806,蟻園,1,616391,0.00016199,99.85177529
45807,蟻道,1,616392,0.00016199,99.85193729
45808,蠅,1,616393,0.00016199,99.85209928
45809,蠍式,1,616394,0.00016199,99.85226128
45810,蟹子,1,616395,0.00016199,99.85242327
45811,蟹黃,1,616396,0.00016199,99.85258527
45812,襟衫,1,616397,0.00016199,99.85274726
45813,譁,1,616398,0.00016199,99.85290925
45814,譁眾取寵,1,616399,0.00016199,99.85307125
45815,識別碼,1,616400,0.00016199,99.85323324
45816,識別證,1,616401,0.00016199,99.85339524
45817,證交法,1,616402,0.00016199,99.85355723
45818,證具,1,616403,0.00016199,99.85371923
45819,證券自營商,1,616404,0.00016199,99.85388122
45820,證券投信公司,1,616405,0.00016199,99.85404321
45821,證券投資顧問,1,616406,0.00016199,99.85420521
45822,證券業者,1,616407,0.00016199,99.85436720
45823,證券管理委員會,1,616408,0.00016199,99.85452920
45824,證明書,1,616409,0.00016199,99.85469119
45825,證果,1,616410,0.00016199,99.85485318
45826,證金業,1,616411,0.00016199,99.85501518
45827,證金業務,1,616412,0.00016199,99.85517717
45828,證照,1,616413,0.00016199,99.85533917
45829,證管會主委,1,616414,0.00016199,99.85550116
45830,證嚴法師,1,616415,0.00016199,99.85566316
45831,譚再生,1,616416,0.00016199,99.85582515
45832,譏誚,1,616417,0.00016199,99.85598714
45833,譏謗性,1,616418,0.00016199,99.85614914
45834,贈品表,1,616419,0.00016199,99.85631113
45835,贈品戰,1,616420,0.00016199,99.85647313
45836,贈給,1,616421,0.00016199,99.85663512
45837,贊成票,1,616422,0.00016199,99.85679712
45838,贊助人,1,616423,0.00016199,99.85695911
45839,贊歎,1,616424,0.00016199,99.85712110
45840,蹬,1,616425,0.00016199,99.85728310
45841,蹺,1,616426,0.00016199,99.85744509
45842,蹺課,1,616427,0.00016199,99.85760709
45843,蹴,1,616428,0.00016199,99.85776908
45844,轎,1,616429,0.00016199,99.85793107
45845,辭令,1,616430,0.00016199,99.85809307
45846,辭典,1,616431,0.00016199,99.85825506
45847,邊沁,1,616432,0.00016199,99.85841706
45848,邊角,1,616433,0.00016199,99.85857905
45849,邊防大隊,1,616434,0.00016199,99.85874105
45850,邊哨,1,616435,0.00016199,99.85890304
45851,邊陲,1,616436,0.00016199,99.85906503
45852,邊陲地帶,1,616437,0.00016199,99.85922703
45853,邊境,1,616438,0.00016199,99.85938902
45854,邊緣份子,1,616439,0.00016199,99.85955102
45855,邊線,1,616440,0.00016199,99.85971301
45856,邊疆,1,616441,0.00016199,99.85987501
45857,邋遢,1,616442,0.00016199,99.86003700
45858,醱酵,1,616443,0.00016199,99.86019899
45859,鏡射,1,616444,0.00016199,99.86036099
45860,鏡框,1,616445,0.00016199,99.86052298
45861,鏡像,1,616446,0.00016199,99.86068498
45862,鏡箱,1,616447,0.00016199,99.86084697
45863,鏡頭罩,1,616448,0.00016199,99.86100896
45864,鏡牆,1,616449,0.00016199,99.86117096
45865,鏟平,1,616450,0.00016199,99.86133295
45866,鏈黴素,1,616451,0.00016199,99.86149495
45867,鏖戰,1,616452,0.00016199,99.86165694
45868,鏢局,1,616453,0.00016199,99.86181894
45869,鏤,1,616454,0.00016199,99.86198093
45870,鏗,1,616455,0.00016199,99.86214292
45871,關口,1,616456,0.00016199,99.86230492
45872,關山鎮,1,616457,0.00016199,99.86246691
45873,關西機械科技,1,616458,0.00016199,99.86262891
45874,關西機場,1,616459,0.00016199,99.86279090
45875,關到,1,616460,0.00016199,99.86295290
45876,關東,1,616461,0.00016199,99.86311489
45877,關係戶,1,616462,0.00016199,99.86327688
45878,關鬼門,1,616463,0.00016199,99.86343888
45879,關連工業區,1,616464,0.00016199,99.86360087
45880,關連式資料庫管理系統,1,616465,0.00016199,99.86376287
45881,關閉起來,1,616466,0.00016199,99.86392486
45882,關渡,1,616467,0.00016199,99.86408685
45883,關渡站區,1,616468,0.00016199,99.86424885
45884,關貿網路,1,616469,0.00016199,99.86441084
45885,關廟,1,616470,0.00016199,99.86457284
45886,關機,1,616471,0.00016199,99.86473483
45887,關錦鵬,1,616472,0.00016199,99.86489683
45888,關鍵元件,1,616473,0.00016199,99.86505882
45889,難上加難,1,616474,0.00016199,99.86522081
45890,難分,1,616475,0.00016199,99.86538281
45891,難以形容,1,616476,0.00016199,99.86554480
45892,難以掌握,1,616477,0.00016199,99.86570680
45893,難以想像,1,616478,0.00016199,99.86586879
45894,難忘,1,616479,0.00016199,99.86603079
45895,難忍,1,616480,0.00016199,99.86619278
45896,難見,1,616481,0.00016199,99.86635477
45897,難到,1,616482,0.00016199,99.86651677
45898,難易度,1,616483,0.00016199,99.86667876
45899,難為,1,616484,0.00016199,99.86684076
45900,難耐,1,616485,0.00016199,99.86700275
45901,難脫,1,616486,0.00016199,99.86716474
45902,難尋,1,616487,0.00016199,99.86732674
45903,難聞,1,616488,0.00016199,99.86748873
45904,難敵,1,616489,0.00016199,99.86765073
45905,難賺,1,616490,0.00016199,99.86781272
45906,難纏,1,616491,0.00016199,99.86797472
45907,霧面,1,616492,0.00016199,99.86813671
45908,霧嵐,1,616493,0.00016199,99.86829870
45909,靡,1,616494,0.00016199,99.86846070
45910,靡靡之音,1,616495,0.00016199,99.86862269
45911,韜光養晦,1,616496,0.00016199,99.86878469
45912,韜略,1,616497,0.00016199,99.86894668
45913,韜略集團,1,616498,0.00016199,99.86910868
45914,韻律教室,1,616499,0.00016199,99.86927067
45915,韻律鞋,1,616500,0.00016199,99.86943266
45916,類人型核武機器人,1,616501,0.00016199,99.86959466
45917,類比電話,1,616502,0.00016199,99.86975665
45918,類比數據機,1,616503,0.00016199,99.86991865
45919,類域,1,616504,0.00016199,99.87008064
45920,願不願,1,616505,0.00016199,99.87024263
45921,願會,1,616506,0.00016199,99.87040463
45922,顛三倒四,1,616507,0.00016199,99.87056662
45923,顛倒,1,616508,0.00016199,99.87072862
45924,顛峰期,1,616509,0.00016199,99.87089061
45925,顛覆性,1,616510,0.00016199,99.87105261
45926,颼颼,1,616511,0.00016199,99.87121460
45927,騙人,1,616512,0.00016199,99.87137659
45928,騙子,1,616513,0.00016199,99.87153859
45929,騙取,1,616514,0.00016199,99.87170058
45930,騙傲,1,616515,0.00016199,99.87186258
45931,騙騙,1,616516,0.00016199,99.87202457
45932,鬍,1,616517,0.00016199,99.87218657
45933,鬍情,1,616518,0.00016199,99.87234856
45934,鬍鬚張魯肉飯,1,616519,0.00016199,99.87251055
45935,鯨吞,1,616520,0.00016199,99.87267255
45936,鯨魚和其他動物的剖面,1,616521,0.00016199,99.87283454
45937,鯛魚,1,616522,0.00016199,99.87299654
45938,鶉蛋,1,616523,0.00016199,99.87315853
45939,鵲橋,1,616524,0.00016199,99.87332052
45940,麒麟,1,616525,0.00016199,99.87348252
45941,麒麟貿易,1,616526,0.00016199,99.87364451
45942,麗仕,1,616527,0.00016199,99.87380651
45943,麗池酒店,1,616528,0.00016199,99.87396850
45944,麗芙,1,616529,0.00016199,99.87413050
45945,麗芙泰勒,1,616530,0.00016199,99.87429249
45946,麗姿韻律舞蹈美容中心,1,616531,0.00016199,99.87445448
45947,麗星遊輪,1,616532,0.00016199,99.87461648
45948,勸世歌,1,616533,0.00016199,99.87477847
45949,勸阻,1,616534,0.00016199,99.87494047
45950,勸慰,1,616535,0.00016199,99.87510246
45951,勸撫,1,616536,0.00016199,99.87526446
45952,勸導,1,616537,0.00016199,99.87542645
45953,勸勸,1,616538,0.00016199,99.87558844
45954,嚴父,1,616539,0.00016199,99.87575044
45955,嚴加,1,616540,0.00016199,99.87591243
45956,嚴守,1,616541,0.00016199,99.87607443
45957,嚴秀峰,1,616542,0.00016199,99.87623642
45958,嚴責,1,616543,0.00016199,99.87639842
45959,嚴智徑,1,616544,0.00016199,99.87656041
45960,嚴詞,1,616545,0.00016199,99.87672240
45961,嚴道,1,616546,0.00016199,99.87688440
45962,嚴酷,1,616547,0.00016199,99.87704639
45963,嚴辦,1,616548,0.00016199,99.87720839
45964,嚴辭,1,616549,0.00016199,99.87737038
45965,嚼蠟,1,616550,0.00016199,99.87753237
45966,孽債,1,616551,0.00016199,99.87769437
45967,寶山,1,616552,0.00016199,99.87785636
45968,寶尼佳,1,616553,0.00016199,99.87801836
45969,寶來證券,1,616554,0.00016199,99.87818035
45970,寶兒,1,616555,0.00016199,99.87834235
45971,寶建,1,616556,0.00016199,99.87850434
45972,寶庫,1,616557,0.00016199,99.87866633
45973,寶特瓶,1,616558,0.00016199,99.87882833
45974,寶馬,1,616559,0.00016199,99.87899032
45975,寶馬汽車,1,616560,0.00016199,99.87915232
45976,寶隆,1,616561,0.00016199,99.87931431
45977,寶塔,1,616562,0.00016199,99.87947631
45978,寶飾,1,616563,0.00016199,99.87963830
45979,寶嘉康蒂,1,616564,0.00016199,99.87980029
45980,寶翠劇院,1,616565,0.00016199,99.87996229
45981,寶慶大樓,1,616566,0.00016199,99.88012428
45982,寶慶路,1,616567,0.00016199,99.88028628
45983,寶藍色,1,616568,0.00016199,99.88044827
45984,寶麗金唱片,1,616569,0.00016199,99.88061026
45985,寶麗金唱片公司,1,616570,0.00016199,99.88077226
45986,寶礦力,1,616571,0.00016199,99.88093425
45987,寶鹼,1,616572,0.00016199,99.88109625
45988,懸吊,1,616573,0.00016199,99.88125824
45989,懸崖,1,616574,0.00016199,99.88142024
45990,懸崖勒馬,1,616575,0.00016199,99.88158223
45991,懸載系統,1,616576,0.00016199,99.88174422
45992,懸疑劇,1,616577,0.00016199,99.88190622
45993,懸賞海報,1,616578,0.00016199,99.88206821
45994,攔,1,616579,0.00016199,99.88223021
45995,攔水壩,1,616580,0.00016199,99.88239220
45996,攔查,1,616581,0.00016199,99.88255420
45997,攔檢,1,616582,0.00016199,99.88271619
45998,攙拌,1,616583,0.00016199,99.88287818
45999,朧,1,616584,0.00016199,99.88304018
46000,瀰足珍貴,1,616585,0.00016199,99.88320217
46001,爐火純青,1,616586,0.00016199,99.88336417
46002,獻上,1,616587,0.00016199,99.88352616
46003,獻吻,1,616588,0.00016199,99.88368815
46004,獻花,1,616589,0.00016199,99.88385015
46005,獻藝,1,616590,0.00016199,99.88401214
46006,癥兆,1,616591,0.00016199,99.88417414
46007,礦化度,1,616592,0.00016199,99.88433613
46008,礦層,1,616593,0.00016199,99.88449813
46009,礦質,1,616594,0.00016199,99.88466012
46010,競投,1,616595,0.00016199,99.88482211
46011,競放,1,616596,0.00016199,99.88498411
46012,競食,1,616597,0.00016199,99.88514610
46013,競速,1,616598,0.00016199,99.88530810
46014,競逐者,1,616599,0.00016199,99.88547009
46015,競價,1,616600,0.00016199,99.88563209
46016,競標者,1,616601,0.00016199,99.88579408
46017,競銷,1,616602,0.00016199,99.88595607
46018,競選人,1,616603,0.00016199,99.88611807
46019,籌委,1,616604,0.00016199,99.88628006
46020,籌設,1,616605,0.00016199,99.88644206
46021,籌碼戰,1,616606,0.00016199,99.88660405
46022,籃子,1,616607,0.00016199,99.88676604
46023,籃框,1,616608,0.00016199,99.88692804
46024,籃球季,1,616609,0.00016199,99.88709003
46025,籃球博士,1,616610,0.00016199,99.88725203
46026,籃球隊,1,616611,0.00016199,99.88741402
46027,籃球賽,1,616612,0.00016199,99.88757602
46028,籃運,1,616613,0.00016199,99.88773801
46029,籍貫,1,616614,0.00016199,99.88790000
46030,糯米,1,616615,0.00016199,99.88806200
46031,繼父,1,616616,0.00016199,99.88822399
46032,繼承架構,1,616617,0.00016199,99.88838599
46033,耀文,1,616618,0.00016199,99.88854798
46034,耀文電子,1,616619,0.00016199,99.88870998
46035,耀武揚威,1,616620,0.00016199,99.88887197
46036,艦長,1,616621,0.00016199,99.88903396
46037,艦砲,1,616622,0.00016199,99.88919596
46038,艦艇管制中心,1,616623,0.00016199,99.88935795
46039,藻,1,616624,0.00016199,99.88951995
46040,蘆草,1,616625,0.00016199,99.88968194
46041,蘆荀,1,616626,0.00016199,99.88984393
46042,蘆笛,1,616627,0.00016199,99.89000593
46043,蘆筍,1,616628,0.00016199,99.89016792
46044,蘋果電腦公司,1,616629,0.00016199,99.89032992
46045,蘋果綠,1,616630,0.00016199,99.89049191
46046,蘇小培,1,616631,0.00016199,99.89065391
46047,蘇丹,1,616632,0.00016199,99.89081590
46048,蘇比克灣,1,616633,0.00016199,99.89097789
46049,蘇先澤,1,616634,0.00016199,99.89113989
46050,蘇州工業園區,1,616635,0.00016199,99.89130188
46051,蘇東坡,1,616636,0.00016199,99.89146388
46052,蘇金鳳,1,616637,0.00016199,99.89162587
46053,蘇格蘭土腔,1,616638,0.00016199,99.89178787
46054,蘇格蘭腔,1,616639,0.00016199,99.89194986
46055,蘇富出,1,616640,0.00016199,99.89211185
46056,蘇菲雅婚紗,1,616641,0.00016199,99.89227385
46057,蘇愷二十七型戰機,1,616642,0.00016199,99.89243584
46058,蘇軾,1,616643,0.00016199,99.89259784
46059,蘇嘉祥,1,616644,0.00016199,99.89275983
46060,蘇魯勃紀念獎學金,1,616645,0.00016199,99.89292182
46061,蘇魯勒,1,616646,0.00016199,99.89308382
46062,蘇黎士,1,616647,0.00016199,99.89324581
46063,蘇黎世,1,616648,0.00016199,99.89340781
46064,蘇澳區漁會,1,616649,0.00016199,99.89356980
46065,蘇澳港,1,616650,0.00016199,99.89373180
46066,蘇聯教士,1,616651,0.00016199,99.89389379
46067,蘊味,1,616652,0.00016199,99.89405578
46068,蘊涵,1,616653,0.00016199,99.89421778
46069,蠔油,1,616654,0.00016199,99.89437977
46070,觸手可及,1,616655,0.00016199,99.89454177
46071,觸目,1,616656,0.00016199,99.89470376
46072,觸目驚心,1,616657,0.00016199,99.89486576
46073,觸技曲與復格,1,616658,0.00016199,99.89502775
46074,觸身球,1,616659,0.00016199,99.89518974
46075,觸媒,1,616660,0.00016199,99.89535174
46076,觸媒轉換器,1,616661,0.00016199,99.89551373
46077,觸碰,1,616662,0.00016199,99.89567573
46078,觸電,1,616663,0.00016199,99.89583772
46079,觸鬚,1,616664,0.00016199,99.89599971
46080,議事紀錄,1,616665,0.00016199,99.89616171
46081,議事規則,1,616666,0.00016199,99.89632370
46082,議定,1,616667,0.00016199,99.89648570
46083,議案,1,616668,0.00016199,99.89664769
46084,議會民主,1,616669,0.00016199,99.89680969
46085,警分局,1,616670,0.00016199,99.89697168
46086,警犬,1,616671,0.00016199,99.89713367
46087,警告標示,1,616672,0.00016199,99.89729567
46088,警告標示牌,1,616673,0.00016199,99.89745766
46089,警告標誌,1,616674,0.00016199,99.89761966
46090,警戒心,1,616675,0.00016199,99.89778165
46091,警政,1,616676,0.00016199,99.89794365
46092,警政單位,1,616677,0.00016199,99.89810564
46093,警匪電影,1,616678,0.00016199,99.89826763
46094,警員服務證,1,616679,0.00016199,99.89842963
46095,警消,1,616680,0.00016199,99.89859162
46096,警務,1,616681,0.00016199,99.89875362
46097,警務人員,1,616682,0.00016199,99.89891561
46098,警務處,1,616683,0.00016199,99.89907760
46099,警務處長,1,616684,0.00016199,99.89923960
46100,警備,1,616685,0.00016199,99.89940159
46101,警備隊,1,616686,0.00016199,99.89956359
46102,警署,1,616687,0.00016199,99.89972558
46103,警鈴,1,616688,0.00016199,99.89988758
46104,警察人員,1,616689,0.00016199,99.90004957
46105,警察局長,1,616690,0.00016199,99.90021156
46106,警察單位,1,616691,0.00016199,99.90037356
46107,警察廳,1,616692,0.00016199,99.90053555
46108,警語,1,616693,0.00016199,99.90069755
46109,警鐘,1,616694,0.00016199,99.90085954
46110,警譽,1,616695,0.00016199,99.90102154
46111,譯法,1,616696,0.00016199,99.90118353
46112,贏球獎,1,616697,0.00016199,99.90134552
46113,躁進,1,616698,0.00016199,99.90150752
46114,釋文,1,616699,0.00016199,99.90166951
46115,釋回,1,616700,0.00016199,99.90183151
46116,釋迦,1,616701,0.00016199,99.90199350
46117,釋迦族,1,616702,0.00016199,99.90215550
46118,釋尊,1,616703,0.00016199,99.90231749
46119,釋詞,1,616704,0.00016199,99.90247948
46120,釋憲案,1,616705,0.00016199,99.90264148
46121,釋懷,1,616706,0.00016199,99.90280347
46122,鐘表界,1,616707,0.00016199,99.90296547
46123,鐘聲,1,616708,0.00016199,99.90312746
46124,鏽,1,616709,0.00016199,99.90328945
46125,闡明,1,616710,0.00016199,99.90345145
46126,飄洋過海,1,616711,0.00016199,99.90361344
46127,飄零,1,616712,0.00016199,99.90377544
46128,飄蕩,1,616713,0.00016199,99.90393743
46129,飄盪,1,616714,0.00016199,99.90409943
46130,飄飄欲仙,1,616715,0.00016199,99.90426142
46131,饒,1,616716,0.00016199,99.90442341
46132,饒恕,1,616717,0.00016199,99.90458541
46133,饒富,1,616718,0.00016199,99.90474740
46134,饒富趣味,1,616719,0.00016199,99.90490940
46135,饒磐安,1,616720,0.00016199,99.90507139
46136,饒穎奇,1,616721,0.00016199,99.90523339
46137,饑荒,1,616722,0.00016199,99.90539538
46138,馨平,1,616723,0.00016199,99.90555737
46139,騰起,1,616724,0.00016199,99.90571937
46140,騰騰,1,616725,0.00016199,99.90588136
46141,騷包,1,616726,0.00016199,99.90604336
46142,騷客,1,616727,0.00016199,99.90620535
46143,麵包果,1,616728,0.00016199,99.90636734
46144,麵包粉,1,616729,0.00016199,99.90652934
46145,麵包樹,1,616730,0.00016199,99.90669133
46146,麵包機,1,616731,0.00016199,99.90685333
46147,麵筋,1,616732,0.00016199,99.90701532
46148,麵團,1,616733,0.00016199,99.90717732
46149,麵輪,1,616734,0.00016199,99.90733931
46150,黨友,1,616735,0.00016199,99.90750130
46151,黨代表大會,1,616736,0.00016199,99.90766330
46152,黨外雜誌,1,616737,0.00016199,99.90782529
46153,黨紀,1,616738,0.00016199,99.90798729
46154,黨証,1,616739,0.00016199,99.90814928
46155,黨管會,1,616740,0.00016199,99.90831128
46156,黨慶,1,616741,0.00016199,99.90847327
46157,黨營,1,616742,0.00016199,99.90863526
46158,儷,1,616743,0.00016199,99.90879726
46159,囂,1,616744,0.00016199,99.90895925
46160,屬地,1,616745,0.00016199,99.90912125
46161,屬地主義,1,616746,0.00016199,99.90928324
46162,屬專,1,616747,0.00016199,99.90944523
46163,屬實,1,616748,0.00016199,99.90960723
46164,巍峨,1,616749,0.00016199,99.90976922
46165,攝形,1,616750,0.00016199,99.90993122
46166,攝食,1,616751,0.00016199,99.91009321
46167,攝影史,1,616752,0.00016199,99.91025521
46168,攝影家看明星,1,616753,0.00016199,99.91041720
46169,攝影家雜誌,1,616754,0.00016199,99.91057919
46170,攝影記者,1,616755,0.00016199,99.91074119
46171,攝影處理系統,1,616756,0.00016199,99.91090318
46172,攝影術,1,616757,0.00016199,99.91106518
46173,攝影創作者,1,616758,0.00016199,99.91122717
46174,攝影會,1,616759,0.00016199,99.91138917
46175,攝影業,1,616760,0.00016199,99.91155116
46176,攝影範圍框,1,616761,0.00016199,99.91171315
46177,攝錄影機,1,616762,0.00016199,99.91187515
46178,櫻,1,616763,0.00016199,99.91203714
46179,櫻唇,1,616764,0.00016199,99.91219914
46180,櫻島火山,1,616765,0.00016199,99.91236113
46181,櫻草,1,616766,0.00016199,99.91252312
46182,殲七,1,616767,0.00016199,99.91268512
46183,殲擊機,1,616768,0.00016199,99.91284711
46184,殲轟機,1,616769,0.00016199,99.91300911
46185,灌木,1,616770,0.00016199,99.91317110
46186,灌回,1,616771,0.00016199,99.91333310
46187,灌注,1,616772,0.00016199,99.91349509
46188,灌染,1,616773,0.00016199,99.91365708
46189,灌洗,1,616774,0.00016199,99.91381908
46190,爛布,1,616775,0.00016199,99.91398107
46191,犧牲打,1,616776,0.00016199,99.91414307
46192,犧牲者,1,616777,0.00016199,99.91430506
46193,籐家具,1,616778,0.00016199,99.91446706
46194,纏捲,1,616779,0.00016199,99.91462905
46195,纏綿,1,616780,0.00016199,99.91479104
46196,纏繞,1,616781,0.00016199,99.91495304
46197,續約,1,616782,0.00016199,99.91511503
46198,續租,1,616783,0.00016199,99.91527703
46199,續租權,1,616784,0.00016199,99.91543902
46200,續發性,1,616785,0.00016199,99.91560101
46201,續篇,1,616786,0.00016199,99.91576301
46202,蘭州,1,616787,0.00016199,99.91592500
46203,蘭花,1,616788,0.00016199,99.91608700
46204,蘭花室,1,616789,0.00016199,99.91624899
46205,蘭陵劇坊,1,616790,0.00016199,99.91641099
46206,蘭陽,1,616791,0.00016199,99.91657298
46207,蘭德,1,616792,0.00016199,99.91673497
46208,蘭嶼,1,616793,0.00016199,99.91689697
46209,蘭懋國際,1,616794,0.00016199,99.91705896
46210,蠢動,1,616795,0.00016199,99.91722096
46211,蠢貨,1,616796,0.00016199,99.91738295
46212,蠟筆小嵐,1,616797,0.00016199,99.91754495
46213,蠟黃,1,616798,0.00016199,99.91770694
46214,蠟像館,1,616799,0.00016199,99.91786893
46215,蠟療,1,616800,0.00016199,99.91803093
46216,護手蓋,1,616801,0.00016199,99.91819292
46217,護木,1,616802,0.00016199,99.91835492
46218,護甲,1,616803,0.00016199,99.91851691
46219,護目鏡,1,616804,0.00016199,99.91867890
46220,護守,1,616805,0.00016199,99.91884090
46221,護耳,1,616806,0.00016199,99.91900289
46222,護住,1,616807,0.00016199,99.91916489
46223,護佑,1,616808,0.00016199,99.91932688
46224,護法,1,616809,0.00016199,99.91948888
46225,護柩者,1,616810,0.00016199,99.91965087
46226,護竿,1,616811,0.00016199,99.91981286
46227,護套,1,616812,0.00016199,99.91997486
46228,護條,1,616813,0.00016199,99.92013685
46229,護理長,1,616814,0.00016199,99.92029885
46230,護脣膏,1,616815,0.00016199,99.92046084
46231,護膝,1,616816,0.00016199,99.92062284
46232,護衛,1,616817,0.00016199,99.92078483
46233,護衛艦,1,616818,0.00016199,99.92094682
46234,護欄,1,616819,0.00016199,99.92110882
46235,贓車,1,616820,0.00016199,99.92127081
46236,贓款,1,616821,0.00016199,99.92143281
46237,躍入,1,616822,0.00016199,99.92159480
46238,躍出,1,616823,0.00016199,99.92175679
46239,躍起,1,616824,0.00016199,99.92191879
46240,躍進,1,616825,0.00016199,99.92208078
46241,躍增,1,616826,0.00016199,99.92224278
46242,躍躍,1,616827,0.00016199,99.92240477
46243,躋入,1,616828,0.00016199,99.92256677
46244,轟炸,1,616829,0.00016199,99.92272876
46245,轟擊,1,616830,0.00016199,99.92289075
46246,辯解,1,616831,0.00016199,99.92305275
46247,辯論社,1,616832,0.00016199,99.92321474
46248,辯識,1,616833,0.00016199,99.92337674
46249,鐮倉一市,1,616834,0.00016199,99.92353873
46250,鐵水,1,616835,0.00016199,99.92370073
46251,鐵皮屋,1,616836,0.00016199,99.92386272
46252,鐵板,1,616837,0.00016199,99.92402471
46253,鐵板燒,1,616838,0.00016199,99.92418671
46254,鐵花,1,616839,0.00016199,99.92434870
46255,鐵面無私,1,616840,0.00016199,99.92451070
46256,鐵骨風扇,1,616841,0.00016199,99.92467269
46257,鐵梯,1,616842,0.00016199,99.92483468
46258,鐵椅,1,616843,0.00016199,99.92499668
46259,鐵腕,1,616844,0.00016199,99.92515867
46260,鐵路網,1,616845,0.00016199,99.92532067
46261,鐵幕,1,616846,0.00016199,99.92548266
46262,鐵槌,1,616847,0.00016199,99.92564466
46263,鐵製,1,616848,0.00016199,99.92580665
46264,鐵餅,1,616849,0.00016199,99.92596864
46265,鐵線,1,616850,0.00016199,99.92613064
46266,鐵鞋,1,616851,0.00016199,99.92629263
46267,鐵齒,1,616852,0.00016199,99.92645463
46268,鐵器,1,616853,0.00016199,99.92661662
46269,鐵頭功,1,616854,0.00016199,99.92677862
46270,鐵膽遊龍,1,616855,0.00016199,99.92694061
46271,鐵錨,1,616856,0.00016199,99.92710260
46272,鐵藍色,1,616857,0.00016199,99.92726460
46273,鐵鏈,1,616858,0.00016199,99.92742659
46274,鐵罐廠,1,616859,0.00016199,99.92758859
46275,闢建,1,616860,0.00016199,99.92775058
46276,闢設,1,616861,0.00016199,99.92791257
46277,霸氣,1,616862,0.00016199,99.92807457
46278,霸菱投顧,1,616863,0.00016199,99.92823656
46279,霸荾,1,616864,0.00016199,99.92839856
46280,霹靂,1,616865,0.00016199,99.92856055
46281,霹靂校園,1,616866,0.00016199,99.92872255
46282,霹靂神兵,1,616867,0.00016199,99.92888454
46283,霹靂遊龍,1,616868,0.00016199,99.92904653
46284,露天啤酒屋,1,616869,0.00016199,99.92920853
46285,露西卡,1,616870,0.00016199,99.92937052
46286,露身,1,616871,0.00016199,99.92953252
46287,露肩,1,616872,0.00016199,99.92969451
46288,露得比,1,616873,0.00016199,99.92985651
46289,露裸,1,616874,0.00016199,99.93001850
46290,露臉,1,616875,0.00016199,99.93018049
46291,響噹噹,1,616876,0.00016199,99.93034249
46292,顧丞峰,1,616877,0.00016199,99.93050448
46293,顧問公司,1,616878,0.00016199,99.93066648
46294,顧間,1,616879,0.00016199,99.93082847
46295,顧德投顧,1,616880,0.00016199,99.93099047
46296,饗,1,616881,0.00016199,99.93115246
46297,驅逐令,1,616882,0.00016199,99.93131445
46298,驅逐艦隊,1,616883,0.00016199,99.93147645
46299,驀然,1,616884,0.00016199,99.93163844
46300,騾子,1,616885,0.00016199,99.93180044
46301,魔幻,1,616886,0.00016199,99.93196243
46302,魔爪,1,616887,0.00016199,99.93212442
46303,魔咒,1,616888,0.00016199,99.93228642
46304,魔奇,1,616889,0.00016199,99.93244841
46305,魔物,1,616890,0.00016199,99.93261041
46306,魔神英雄傳,1,616891,0.00016199,99.93277240
46307,魔鬼一族,1,616892,0.00016199,99.93293440
46308,魔鬼訓練營,1,616893,0.00016199,99.93309639
46309,魔鬼操,1,616894,0.00016199,99.93325838
46310,魔鬼氈,1,616895,0.00016199,99.93342038
46311,魔術隊,1,616896,0.00016199,99.93358237
46312,魔術數字,1,616897,0.00016199,99.93374437
46313,魔誡追緝令,1,616898,0.00016199,99.93390636
46314,魔龍傳奇,1,616899,0.00016199,99.93406836
46315,魔櫃,1,616900,0.00016199,99.93423035
46316,魔櫃小奇兵,1,616901,0.00016199,99.93439234
46317,魔獸,1,616902,0.00016199,99.93455434
46318,鰥夫,1,616903,0.00016199,99.93471633
46319,鶯歌鎮,1,616904,0.00016199,99.93487833
46320,鶴見岳山,1,616905,0.00016199,99.93504032
46321,鶴齡公司,1,616906,0.00016199,99.93520231
46322,鶴齡健康器材有限公司,1,616907,0.00016199,99.93536431
46323,囊帶,1,616908,0.00016199,99.93552630
46324,囊腫,1,616909,0.00016199,99.93568830
46325,囉嗦,1,616910,0.00016199,99.93585029
46326,巔峰,1,616911,0.00016199,99.93601229
46327,彎刀,1,616912,0.00016199,99.93617428
46328,彎刀客,1,616913,0.00016199,99.93633627
46329,彎下腰,1,616914,0.00016199,99.93649827
46330,彎弓,1,616915,0.00016199,99.93666026
46331,彎折,1,616916,0.00016199,99.93682226
46332,彎彎,1,616917,0.00016199,99.93698425
46333,彎彎曲曲,1,616918,0.00016199,99.93714625
46334,攤屍式,1,616919,0.00016199,99.93730824
46335,攤架,1,616920,0.00016199,99.93747023
46336,攤開來,1,616921,0.00016199,99.93763223
46337,權力鬥爭,1,616922,0.00016199,99.93779422
46338,權力圈,1,616923,0.00016199,99.93795622
46339,權威政體,1,616924,0.00016199,99.93811821
46340,權威感,1,616925,0.00016199,99.93828020
46341,權柄,1,616926,0.00016199,99.93844220
46342,權息值,1,616927,0.00016199,99.93860419
46343,權謀,1,616928,0.00016199,99.93876619
46344,權變,1,616929,0.00016199,99.93892818
46345,歡欣鼓舞,1,616930,0.00016199,99.93909018
46346,歡送會,1,616931,0.00016199,99.93925217
46347,歡唱,1,616932,0.00016199,99.93941416
46348,歡愉感,1,616933,0.00016199,99.93957616
46349,歡慶,1,616934,0.00016199,99.93973815
46350,歡樂一級棒,1,616935,0.00016199,99.93990015
46351,歡樂傳真,1,616936,0.00016199,99.94006214
46352,歡樂舞蹈,1,616937,0.00016199,99.94022414
46353,歡騰,1,616938,0.00016199,99.94038613
46354,灑下,1,616939,0.00016199,99.94054812
46355,灑水車,1,616940,0.00016199,99.94071012
46356,灑向人間都是愛—宋慶齡的故事,1,616941,0.00016199,99.94087211
46357,灑脫,1,616942,0.00016199,99.94103411
46358,灑進,1,616943,0.00016199,99.94119610
46359,灘頭堡,1,616944,0.00016199,99.94135809
46360,籠子,1,616945,0.00016199,99.94152009
46361,籠型,1,616946,0.00016199,99.94168208
46362,籠燈,1,616947,0.00016199,99.94184408
46363,籠籠統統,1,616948,0.00016199,99.94200607
46364,聽一聽,1,616949,0.00016199,99.94216807
46365,聽力,1,616950,0.00016199,99.94233006
46366,聽出,1,616951,0.00016199,99.94249205
46367,聽任,1,616952,0.00016199,99.94265405
46368,聽來,1,616953,0.00016199,99.94281604
46369,聽來聽去,1,616954,0.00016199,99.94297804
46370,聽命,1,616955,0.00016199,99.94314003
46371,聽者,1,616956,0.00016199,99.94330203
46372,聽從,1,616957,0.00016199,99.94346402
46373,聽著,1,616958,0.00016199,99.94362601
46374,聽聞,1,616959,0.00016199,99.94378801
46375,聽障者,1,616960,0.00016199,99.94395000
46376,聽講,1,616961,0.00016199,99.94411200
46377,臟,1,616962,0.00016199,99.94427399
46378,臟腑,1,616963,0.00016199,99.94443598
46379,臟器,1,616964,0.00016199,99.94459798
46380,襲擊,1,616965,0.00016199,99.94475997
46381,襯衣,1,616966,0.00016199,99.94492197
46382,襯底,1,616967,0.00016199,99.94508396
46383,襯墊,1,616968,0.00016199,99.94524596
46384,讀一讀,1,616969,0.00016199,99.94540795
46385,讀音,1,616970,0.00016199,99.94556994
46386,讀起來,1,616971,0.00016199,99.94573194
46387,讀誦,1,616972,0.00016199,99.94589393
46388,贖,1,616973,0.00016199,99.94605593
46389,贖款,1,616974,0.00016199,99.94621792
46390,贖罪,1,616975,0.00016199,99.94637992
46391,躑躅,1,616976,0.00016199,99.94654191
46392,鑄壓機,1,616977,0.00016199,99.94670390
46393,鑄鐵管,1,616978,0.00016199,99.94686590
46394,鑑賞性,1,616979,0.00016199,99.94702789
46395,鑑識,1,616980,0.00016199,99.94718989
46396,鑑證,1,616981,0.00016199,99.94735188
46397,鑒,1,616982,0.00016199,99.94751387
46398,韃靼人,1,616983,0.00016199,99.94767587
46399,韁,1,616984,0.00016199,99.94783786
46400,顫音,1,616985,0.00016199,99.94799986
46401,顫動,1,616986,0.00016199,99.94816185
46402,饕家,1,616987,0.00016199,99.94832385
46403,髒污,1,616988,0.00016199,99.94848584
46404,髒話,1,616989,0.00016199,99.94864783
46405,鬚生,1,616990,0.00016199,99.94880983
46406,龔,1,616991,0.00016199,99.94897182
46407,戀戀,1,616992,0.00016199,99.94913382
46408,攣縮,1,616993,0.00016199,99.94929581
46409,攪局,1,616994,0.00016199,99.94945781
46410,攪和,1,616995,0.00016199,99.94961980
46411,攪動,1,616996,0.00016199,99.94978179
46412,攪混,1,616997,0.00016199,99.94994379
46413,攪碎,1,616998,0.00016199,99.95010578
46414,攪碎機,1,616999,0.00016199,99.95026778
46415,曬衣夾,1,617000,0.00016199,99.95042977
46416,曬黑,1,617001,0.00016199,99.95059176
46417,曬鹽,1,617002,0.00016199,99.95075376
46418,曬鹽期,1,617003,0.00016199,99.95091575
46419,竊,1,617004,0.00016199,99.95107775
46420,竊案,1,617005,0.00016199,99.95123974
46421,竊盜集團,1,617006,0.00016199,99.95140174
46422,竊盜罪嫌,1,617007,0.00016199,99.95156373
46423,竊聽,1,617008,0.00016199,99.95172572
46424,纖,1,617009,0.00016199,99.95188772
46425,纖物,1,617010,0.00016199,99.95204971
46426,纖柔,1,617011,0.00016199,99.95221171
46427,纖維素,1,617012,0.00016199,99.95237370
46428,纖維部,1,617013,0.00016199,99.95253570
46429,纖維醣酸,1,617014,0.00016199,99.95269769
46430,纖體精華液,1,617015,0.00016199,99.95285968
46431,蘸醬,1,617016,0.00016199,99.95302168
46432,蘿拉,1,617017,0.00016199,99.95318367
46433,蘿拉．韓得森,1,617018,0.00016199,99.95334567
46434,蘿莉艾爾斯,1,617019,0.00016199,99.95350766
46435,蘿蔔乾,1,617020,0.00016199,99.95366965
46436,蘿蘋,1,617021,0.00016199,99.95383165
46437,變大,1,617022,0.00016199,99.95399364
46438,變化萬千,1,617023,0.00016199,99.95415564
46439,變出,1,617024,0.00016199,99.95431763
46440,變色,1,617025,0.00016199,99.95447963
46441,變色龍,1,617026,0.00016199,99.95464162
46442,變形蟲,1,617027,0.00016199,99.95480361
46443,變卦,1,617028,0.00016199,99.95496561
46444,變法,1,617029,0.00016199,99.95512760
46445,變型,1,617030,0.00016199,99.95528960
46446,變星,1,617031,0.00016199,99.95545159
46447,變現,1,617032,0.00016199,99.95561359
46448,變速箱,1,617033,0.00016199,99.95577558
46449,變速器,1,617034,0.00016199,99.95593757
46450,變換器,1,617035,0.00016199,99.95609957
46451,變像,1,617036,0.00016199,99.95626156
46452,變種,1,617037,0.00016199,99.95642356
46453,變壓器,1,617038,0.00016199,99.95658555
46454,邏輯連接控制,1,617039,0.00016199,99.95674754
46455,顯示欄,1,617040,0.00016199,99.95690954
46456,顯性,1,617041,0.00016199,99.95707153
46457,顯眼,1,617042,0.00016199,99.95723353
46458,顯貴,1,617043,0.00016199,99.95739552
46459,顯爵,1,617044,0.00016199,99.95755752
46460,顯靈,1,617045,0.00016199,99.95771951
46461,驚幻,1,617046,0.00016199,99.95788150
46462,驚世,1,617047,0.00016199,99.95804350
46463,驚世篇,1,617048,0.00016199,99.95820549
46464,驚怒,1,617049,0.00016199,99.95836749
46465,驚風,1,617050,0.00016199,99.95852948
46466,驚異,1,617051,0.00016199,99.95869148
46467,驚愕,1,617052,0.00016199,99.95885347
46468,驚惶,1,617053,0.00016199,99.95901546
46469,驚惶失措,1,617054,0.00016199,99.95917746
46470,驚傳,1,617055,0.00016199,99.95933945
46471,驚嘆,1,617056,0.00016199,99.95950145
46472,驚魂甫定,1,617057,0.00016199,99.95966344
46473,驚濤駭浪,1,617058,0.00016199,99.95982544
46474,驚懾,1,617059,0.00016199,99.95998743
46475,驚艷,1,617060,0.00016199,99.96014942
46476,驚豔,1,617061,0.00016199,99.96031142
46477,驛馬車,1,617062,0.00016199,99.96047341
46478,驗血,1,617063,0.00016199,99.96063541
46479,體外,1,617064,0.00016199,99.96079740
46480,體位,1,617065,0.00016199,99.96095939
46481,體育天地,1,617066,0.00016199,99.96112139
46482,體育版,1,617067,0.00016199,99.96128338
46483,體恤,1,617068,0.00016199,99.96144538
46484,體溫計,1,617069,0.00016199,99.96160737
46485,體察,1,617070,0.00016199,99.96176937
46486,體罰,1,617071,0.00016199,99.96193136
46487,體魄,1,617072,0.00016199,99.96209335
46488,體操課,1,617073,0.00016199,99.96225535
46489,體隱性,1,617074,0.00016199,99.96241734
46490,麟片,1,617075,0.00016199,99.96257934
46491,麟甲,1,617076,0.00016199,99.96274133
46492,黴素,1,617077,0.00016199,99.96290333
46493,囑咐,1,617078,0.00016199,99.96306532
46494,壩,1,617079,0.00016199,99.96322731
46495,癱,1,617080,0.00016199,99.96338931
46496,癱患,1,617081,0.00016199,99.96355130
46497,矗,1,617082,0.00016199,99.96371330
46498,羈滯,1,617083,0.00016199,99.96387529
46499,蠶豆,1,617084,0.00016199,99.96403728
46500,讓出,1,617085,0.00016199,99.96419928
46501,讓售,1,617086,0.00016199,99.96436127
46502,艷紫荊,1,617087,0.00016199,99.96452327
46503,艷羨,1,617088,0.00016199,99.96468526
46504,艷歌行,1,617089,0.00016199,99.96484726
46505,艷舞,1,617090,0.00016199,99.96500925
46506,贛,1,617091,0.00016199,99.96517124
46507,釀酒,1,617092,0.00016199,99.96533324
46508,靈不靈,1,617093,0.00016199,99.96549523
46509,靈車,1,617094,0.00016199,99.96565723
46510,靈柩,1,617095,0.00016199,99.96581922
46511,靈泉月刊,1,617096,0.00016199,99.96598122
46512,靈堂,1,617097,0.00016199,99.96614321
46513,靈異,1,617098,0.00016199,99.96630520
46514,靈鳥,1,617099,0.00016199,99.96646720
46515,靈機,1,617100,0.00016199,99.96662919
46516,靈驗,1,617101,0.00016199,99.96679119
46517,顰,1,617102,0.00016199,99.96695318
46518,驟雨,1,617103,0.00016199,99.96711517
46519,驟降,1,617104,0.00016199,99.96727717
46520,驟變,1,617105,0.00016199,99.96743916
46521,鷹架,1,617106,0.00016199,99.96760116
46522,鷹眼,1,617107,0.00016199,99.96776315
46523,鷺,1,617108,0.00016199,99.96792515
46524,鹼性電池,1,617109,0.00016199,99.96808714
46525,鹼菜,1,617110,0.00016199,99.96824913
46526,鹽分顯示計,1,617111,0.00016199,99.96841113
46527,鹽巴,1,617112,0.00016199,99.96857312
46528,鹽味蝦,1,617113,0.00016199,99.96873512
46529,鹽埔鄉,1,617114,0.00016199,99.96889711
46530,鹽海,1,617115,0.00016199,99.96905911
46531,鹽湖村,1,617116,0.00016199,99.96922110
46532,鹽業文物,1,617117,0.00016199,99.96938309
46533,鹽業博物館,1,617118,0.00016199,99.96954509
46534,廳堂,1,617119,0.00016199,99.96970708
46535,灣區,1,617120,0.00016199,99.96986908
46536,灣裡,1,617121,0.00016199,99.97003107
46537,灣裡底路,1,617122,0.00016199,99.97019306
46538,蠻有,1,617123,0.00016199,99.97035506
46539,蠻荒,1,617124,0.00016199,99.97051705
46540,觀光休閒業,1,617125,0.00016199,99.97067905
46541,觀光局,1,617126,0.00016199,99.97084104
46542,觀光區,1,617127,0.00016199,99.97100304
46543,觀光船,1,617128,0.00016199,99.97116503
46544,觀光勝地,1,617129,0.00016199,99.97132702
46545,觀光飯店,1,617130,0.00016199,99.97148902
46546,觀光業,1,617131,0.00016199,99.97165101
46547,觀光遊憩區,1,617132,0.00016199,99.97181301
46548,觀光預測局,1,617133,0.00016199,99.97197500
46549,觀念篇,1,617134,0.00016199,99.97213700
46550,觀者,1,617135,0.00016199,99.97229899
46551,觀查,1,617136,0.00016199,99.97246098
46552,觀查員,1,617137,0.00016199,99.97262298
46553,觀音蓮座山,1,617138,0.00016199,99.97278497
46554,觀音禪寺,1,617139,0.00016199,99.97294697
46555,觀海寺,1,617140,0.00016199,99.97310896
46556,觀眾區,1,617141,0.00016199,99.97327095
46557,觀景台,1,617142,0.00016199,99.97343295
46558,觀測,1,617143,0.00016199,99.97359494
46559,觀察入微,1,617144,0.00016199,99.97375694
46560,觀察員,1,617145,0.00016199,99.97391893
46561,觀慧,1,617146,0.00016199,99.97408093
46562,觀賞性,1,617147,0.00016199,99.97424292
46563,觀戰,1,617148,0.00016199,99.97440491
46564,觀禮者,1,617149,0.00016199,99.97456691
46565,觀疇,1,617150,0.00016199,99.97472890
46566,鑲鑽,1,617151,0.00016199,99.97489090
46567,鑰匙圈,1,617152,0.00016199,99.97505289
46568,顱,1,617153,0.00016199,99.97521489
46569,顱鸚,1,617154,0.00016199,99.97537688
46570,髖關節,1,617155,0.00016199,99.97553887
46571,鬣毛,1,617156,0.00016199,99.97570087
46572,讚不絕口,1,617157,0.00016199,99.97586286
46573,纜繩,1,617158,0.00016199,99.97602486
46574,鑽戒,1,617159,0.00016199,99.97618685
46575,鑽咬,1,617160,0.00016199,99.97634884
46576,鑽動,1,617161,0.00016199,99.97651084
46577,鑽進去,1,617162,0.00016199,99.97667283
46578,鑽飾,1,617163,0.00016199,99.97683483
46579,鑽營,1,617164,0.00016199,99.97699682
46580,鑼,1,617165,0.00016199,99.97715882
46581,鑼鼓,1,617166,0.00016199,99.97732081
46582,鱷魚潭,1,617167,0.00016199,99.97748280
46583,豔,1,617168,0.00016199,99.97764480
46584,豔紅,1,617169,0.00016199,99.97780679
46585,豔柴荊,1,617170,0.00016199,99.97796879
46586,豔陽,1,617171,0.00016199,99.97813078
46587,豔舞,1,617172,0.00016199,99.97829278
46588,豔舞秀,1,617173,0.00016199,99.97845477
46589,鑿穿,1,617174,0.00016199,99.97861676
46590,驪歌,1,617175,0.00016199,99.97877876
46591,鬱卒,1,617176,0.00016199,99.97894075
46592,鬱悶,1,617177,0.00016199,99.97910275
46593,鬱積,1,617178,0.00016199,99.97926474
46594,鬱鬱寡歡,1,617179,0.00016199,99.97942673
46595,籲請,1,617180,0.00016199,99.97958873
46596,卍,1,617181,0.00016199,99.97975072
46597,佤族,1,617182,0.00016199,99.97991272
46598,忐忑,1,617183,0.00016199,99.98007471
46599,忐忑不安,1,617184,0.00016199,99.98023671
46600,忤逆,1,617185,0.00016199,99.98039870
46601,町,1,617186,0.00016199,99.98056069
46602,町田,1,617187,0.00016199,99.98072269
46603,冾,1,617188,0.00016199,99.98088468
46604,囹圄,1,617189,0.00016199,99.98104668
46605,坨,1,617190,0.00016199,99.98120867
46606,怦怦然,1,617191,0.00016199,99.98137067
46607,沓,1,617192,0.00016199,99.98153266
46608,狒狒,1,617193,0.00016199,99.98169465
46609,矸,1,617194,0.00016199,99.98185665
46610,芮德克里夫醫院,1,617195,0.00016199,99.98201864
46611,茍延殘喘,1,617196,0.00016199,99.98218064
46612,峇里島,1,617197,0.00016199,99.98234263
46613,洄瀾傳播,1,617198,0.00016199,99.98250462
46614,茌,1,617199,0.00016199,99.98266662
46615,悒鬱,1,617200,0.00016199,99.98282861
46616,悃悃,1,617201,0.00016199,99.98299061
46617,栴檀社,1,617202,0.00016199,99.98315260
46618,涂金泉,1,617203,0.00016199,99.98331460
46619,笈,1,617204,0.00016199,99.98347659
46620,胺基配醣體,1,617205,0.00016199,99.98363858
46621,荖濃溪,1,617206,0.00016199,99.98380058
46622,茜陀．莫夫,1,617207,0.00016199,99.98396257
46623,訒,1,617208,0.00016199,99.98412457
46624,隼式,1,617209,0.00016199,99.98428656
46625,堀起,1,617210,0.00016199,99.98444856
46626,悱,1,617211,0.00016199,99.98461055
46627,掐,1,617212,0.00016199,99.98477254
46628,掮客,1,617213,0.00016199,99.98493454
46629,掟掟,1,617214,0.00016199,99.98509653
46630,欸,1,617215,0.00016199,99.98525853
46631,硒,1,617216,0.00016199,99.98542052
46632,紺,1,617217,0.00016199,99.98558252
46633,趿,1,617218,0.00016199,99.98574451
46634,釹,1,617219,0.00016199,99.98590650
46635,啷噹入獄,1,617220,0.00016199,99.98606850
46636,棱皮龜,1,617221,0.00016199,99.98623049
46637,稊,1,617222,0.00016199,99.98639249
46638,筊杯,1,617223,0.00016199,99.98655448
46639,羡,1,617224,0.00016199,99.98671647
46640,菇菌,1,617225,0.00016199,99.98687847
46641,嗔,1,617226,0.00016199,99.98704046
46642,搥打,1,617227,0.00016199,99.98720246
46643,棰,1,617228,0.00016199,99.98736445
46644,棰擊刀絲瑪,1,617229,0.00016199,99.98752645
46645,瑋納公司,1,617230,0.00016199,99.98768844
46646,翛翛,1,617231,0.00016199,99.98785043
46647,艉,1,617232,0.00016199,99.98801243
46648,酯,1,617233,0.00016199,99.98817442
46649,摜,1,617234,0.00016199,99.98833642
46650,殞命,1,617235,0.00016199,99.98849841
46651,粼粼,1,617236,0.00016199,99.98866041
46652,緋聞,1,617237,0.00016199,99.98882240
46653,綹,1,617238,0.00016199,99.98898439
46654,蓍,1,617239,0.00016199,99.98914639
46655,銥,1,617240,0.00016199,99.98930838
46656,嶙峋,1,617241,0.00016199,99.98947038
46657,憋,1,617242,0.00016199,99.98963237
46658,撣來撣去,1,617243,0.00016199,99.98979436
46659,斲喪,1,617244,0.00016199,99.98995636
46660,槴子,1,617245,0.00016199,99.99011835
46661,獛,1,617246,0.00016199,99.99028035
46662,翦除,1,617247,0.00016199,99.99044234
46663,舖設,1,617248,0.00016199,99.99060434
46664,舖貨,1,617249,0.00016199,99.99076633
46665,舖陳,1,617250,0.00016199,99.99092832
46666,踦,1,617251,0.00016199,99.99109032
46667,鋃璫入獄,1,617252,0.00016199,99.99125231
46668,靚,1,617253,0.00016199,99.99141431
46669,靚坤,1,617254,0.00016199,99.99157630
46670,靚碟,1,617255,0.00016199,99.99173830
46671,靚聲,1,617256,0.00016199,99.99190029
46672,憨厚,1,617257,0.00016199,99.99206228
46673,憨憨厚厚,1,617258,0.00016199,99.99222428
46674,樻生,1,617259,0.00016199,99.99238627
46675,燁隆,1,617260,0.00016199,99.99254827
46676,燁隆鋼鐵公司,1,617261,0.00016199,99.99271026
46677,燁興,1,617262,0.00016199,99.99287225
46678,燔祭,1,617263,0.00016199,99.99303425
46679,糗,1,617264,0.00016199,99.99319624
46680,糗事,1,617265,0.00016199,99.99335824
46681,蕖,1,617266,0.00016199,99.99352023
46682,錸德,1,617267,0.00016199,99.99368223
46683,錸德公司,1,617268,0.00016199,99.99384422
46684,篳路藍縷,1,617269,0.00016199,99.99400621
46685,薝棚,1,617270,0.00016199,99.99416821
46686,薈萃,1,617271,0.00016199,99.99433020
46687,鎯鐺入獄,1,617272,0.00016199,99.99449220
46688,闃寂,1,617273,0.00016199,99.99465419
46689,餬口,1,617274,0.00016199,99.99481619
46690,擸捕,1,617275,0.00016199,99.99497818
46691,燹,1,617276,0.00016199,99.99514017
46692,繖形,1,617277,0.00016199,99.99530217
46693,轆轤,1,617278,0.00016199,99.99546416
46694,瀣,1,617279,0.00016199,99.99562616
46695,鯤,1,617280,0.00016199,99.99578815
46696,矌,1,617281,0.00016199,99.99595014
46697,繾綣,1,617282,0.00016199,99.99611214
46698,譭謗,1,617283,0.00016199,99.99627413
46699,饋贈,1,617284,0.00016199,99.99643613
46700,鰈魚,1,617285,0.00016199,99.99659812
46701,飆升,1,617286,0.00016199,99.99676012
46702,飆舞,1,617287,0.00016199,99.99692211
46703,飆戲,1,617288,0.00016199,99.99708410
46704,鰤魚,1,617289,0.00016199,99.99724610
46705,黮,1,617290,0.00016199,99.99740809
46706,孌,1,617291,0.00016199,99.99757009
46707,艫,1,617292,0.00016199,99.99773208
46708,鱈魚,1,617293,0.00016199,99.99789408
46709,欒丕智,1,617294,0.00016199,99.99805607
46710,癰腫,1,617295,0.00016199,99.99821806
46711,鷲,1,617296,0.00016199,99.99838006
46712,顴骨,1,617297,0.00016199,99.99854205
46713,碁峰資訊,1,617298,0.00016199,99.99870405
46714,銹,1,617299,0.00016199,99.99886604
46715,裏外,1,617300,0.00016199,99.99902803
46716,恒生股價指數,1,617301,0.00016199,99.99919003
46717,��,1,617302,0.00016199,99.99935202
46718,��,1,617303,0.00016199,99.99951402
46719,�W起,1,617304,0.00016199,99.99967601
46720,�\,1,617305,0.00016199,99.99983801
46721,��管,1,617306,0.00016199,100.00000000
