字頻序號,字,部首,筆畫,出現頻次,累積頻次,累積百分比
1,的,白,08,39632,39632,3.94012662
2,一,一,01,12955,52587,5.22808434
3,是,日,09,11865,64452,6.40767665
4,不,一,04,9889,74341,7.39081936
5,有,月,06,9414,83755,8.32673862
6,在,土,06,9364,93119,9.25768699
7,人,人,02,8004,101123,10.05342713
8,以,人,05,6442,107565,10.69387666
9,為,火,09,5914,113479,11.28183358
10,中,｜,04,5884,119363,11.86680797
11,大,大,03,5854,125217,12.44879983
12,會,曰,13,5239,130456,12.96964973
13,上,一,03,5110,135566,13.47767474
14,了,??,02,5057,140623,13.98043060
15,可,口,05,4835,145458,14.46111571
16,這,??,11,4775,150233,14.93583575
17,時,日,10,4729,154962,15.40598257
18,來,人,08,4565,159527,15.85982487
19,年,干,06,4541,164068,16.31128114
20,個,人,10,4541,168609,16.76273741
21,他,人,05,4490,173099,17.20912337
22,出,凵,05,4269,177368,17.63353800
23,到,刀,08,4229,181597,18.05397592
24,國,囗,11,4222,185819,18.47371791
25,我,戈,07,4120,189939,18.88331928
26,也,乙,03,4114,194053,19.29232415
27,要,襾,09,3982,198035,19.68820587
28,成,戈,06,3755,201790,20.06151974
29,而,而,06,3743,205533,20.43364060
30,能,肉,10,3664,209197,20.79790745
31,就,尢,12,3337,212534,21.12966468
32,地,土,06,3308,215842,21.45853880
33,對,寸,14,3293,219135,21.78592164
34,後,彳,09,3261,222396,22.11012312
35,於,方,08,3217,225613,22.42995021
36,之,??,04,3192,228805,22.74729186
37,多,夕,06,3141,231946,23.05956320
38,用,用,05,3139,235085,23.37163570
39,生,生,05,3134,238219,23.68321112
40,台,口,05,3117,241336,23.99309643
41,行,行,06,3003,244339,24.29164811
42,和,口,08,2917,247256,24.58164986
43,過,??,13,2871,250127,24.86707839
44,所,戶,08,2864,252991,25.15181099
45,們,人,10,2855,255846,25.43564884
46,作,人,07,2849,258695,25.71889018
47,業,木,13,2841,261536,26.00133618
48,公,八,04,2835,264371,26.28318566
49,因,囗,06,2828,267199,26.56433923
50,自,自,06,2767,269966,26.83942831
51,得,彳,11,2740,272706,27.11183311
52,與,臼,14,2725,275431,27.38274664
53,十,十,02,2715,278146,27.65266599
54,家,??,10,2706,280852,27.92169058
55,發,??,12,2695,283547,28.18962158
56,下,一,03,2688,286235,28.45685665
57,現,玉,11,2663,288898,28.72160627
58,如,女,06,2637,291535,28.98377104
59,者,老,08,2612,294147,29.24345035
60,前,刀,09,2596,296743,29.50153899
61,都,邑,11,2570,299313,29.75704276
62,經,糸,13,2543,301856,30.00986225
63,方,方,04,2496,304352,30.25800910
64,及,又,04,2487,306839,30.50526119
65,最,??,12,2446,309285,30.74843715
66,外,夕,05,2425,311710,30.98952534
67,將,寸,11,2420,314130,31.23011644
68,長,長,08,2387,316517,31.46742675
69,當,田,13,2380,318897,31.70404114
70,分,刀,04,2376,321273,31.94025785
71,高,高,10,2329,323602,32.17180193
72,動,力,11,2321,325923,32.40255066
73,市,巾,05,2312,328235,32.63240464
74,但,人,07,2311,330546,32.86215920
75,說,言,14,2294,332840,33.09022365
76,新,斤,13,2234,335074,33.31232304
77,心,心,04,2229,337303,33.53392533
78,然,火,12,2228,339531,33.75542821
79,法,水,08,2196,341727,33.97374972
80,其,八,08,2174,343901,34.18988404
81,子,子,03,2173,346074,34.40591894
82,力,力,02,2158,348232,34.62046257
83,天,大,04,2151,350383,34.83431028
84,日,日,04,2142,352525,35.04726323
85,場,土,12,2138,354663,35.25981850
86,開,門,12,2129,356792,35.47147902
87,表,衣,08,2119,358911,35.68214536
88,同,口,06,2111,361022,35.89201635
89,三,一,03,2109,363131,36.10168851
90,資,貝,13,2107,365238,36.31116184
91,理,玉,11,2093,367331,36.51924331
92,此,止,06,2085,369416,36.72652944
93,主,??,05,2063,371479,36.93162838
94,小,小,03,2054,373533,37.13583256
95,本,木,05,2050,375583,37.33963907
96,事,??,08,2043,377626,37.54274966
97,定,??,08,2010,379636,37.74257945
98,好,女,06,2008,381644,37.94221042
99,電,雨,13,2007,383651,38.14174196
100,加,力,05,1967,385618,38.33729679
101,美,羊,09,1929,387547,38.52907374
102,面,面,09,1914,389461,38.71935943
103,部,邑,11,1902,391363,38.90845210
104,二,二,02,1899,393262,39.09724652
105,民,氏,05,1884,395146,39.28454968
106,工,工,03,1883,397029,39.47175341
107,進,??,12,1872,398901,39.65786355
108,由,田,05,1858,400759,39.84258184
109,機,木,16,1857,402616,40.02720071
110,體,骨,23,1835,404451,40.20963239
111,品,口,09,1819,406270,40.39047339
112,性,心,08,1798,408068,40.56922661
113,種,禾,14,1787,409855,40.74688623
114,等,竹,12,1777,411632,40.92355168
115,使,人,08,1775,413407,41.10001829
116,內,入,04,1771,415178,41.27608723
117,重,里,09,1754,416932,41.45046607
118,間,門,12,1733,418665,41.62275713
119,你,人,07,1719,420384,41.79365635
120,相,目,09,1717,422101,41.96435673
121,金,金,08,1712,423813,42.13456002
122,產,生,11,1707,425520,42.30426622
123,無,火,12,1688,427208,42.47208348
124,已,己,03,1687,428895,42.63980132
125,全,入,06,1686,430581,42.80741975
126,位,人,07,1646,432227,42.97106146
127,著,艸,12,1638,433865,43.13390784
128,學,子,16,1631,435496,43.29605828
129,並,一,08,1626,437122,43.45771164
130,情,心,11,1617,438739,43.61847024
131,或,戈,08,1615,440354,43.77903000
132,月,月,04,1606,441960,43.93869500
133,車,車,07,1597,443557,44.09746524
134,合,口,06,1595,445152,44.25603665
135,員,口,10,1594,446746,44.41450864
136,影,??,15,1593,448339,44.57288121
137,去,??,05,1580,449919,44.72996135
138,比,比,04,1576,451495,44.88664381
139,果,木,08,1575,453070,45.04322686
140,只,口,05,1573,454643,45.19961108
141,實,??,14,1567,456210,45.35539878
142,意,心,13,1561,457771,45.51058999
143,還,??,17,1557,459328,45.66538351
144,看,目,09,1550,460878,45.81948112
145,度,??,09,1540,462418,45.97258454
146,利,刀,07,1528,463946,46.12449496
147,政,??,09,1521,465467,46.27570945
148,些,二,08,1519,466986,46.42672510
149,兩,入,08,1516,468502,46.57744250
150,起,走,10,1505,470007,46.72706630
151,期,月,12,1503,471510,46.87649127
152,化,匕,04,1483,472993,47.02392788
153,式,弋,06,1461,474454,47.16917730
154,目,目,05,1457,475911,47.31402905
155,很,彳,09,1448,477359,47.45798603
156,五,二,04,1443,478802,47.60144593
157,點,黑,17,1438,480240,47.74440874
158,司,口,05,1430,481670,47.88657621
159,元,儿,04,1428,483098,48.02854484
160,更,曰,07,1413,484511,48.16902221
161,提,手,12,1408,485919,48.30900248
162,股,肉,08,1398,487317,48.44798858
163,總,糸,17,1397,488714,48.58687526
164,統,糸,11,1389,490103,48.72496660
165,應,心,17,1386,491489,48.86275968
166,四,囗,05,1381,492870,49.00005567
167,代,人,05,1380,494250,49.13725225
168,水,水,04,1378,495628,49.27424999
169,沒,水,07,1377,497005,49.41114832
170,正,止,05,1375,498380,49.54784780
171,常,巾,11,1374,499754,49.68444787
172,入,入,02,1372,501126,49.82084911
173,報,土,12,1372,502498,49.95725034
174,關,門,19,1364,503862,50.09285623
175,投,手,07,1337,505199,50.22577784
176,從,彳,11,1333,506532,50.35830178
177,則,刀,09,1331,507863,50.49062689
178,至,至,06,1327,509190,50.62255432
179,文,文,04,1324,510514,50.75418350
180,選,??,16,1310,511824,50.88442083
181,名,口,06,1304,513128,51.01406165
182,物,牛,08,1298,514426,51.14310597
183,特,牛,10,1285,515711,51.27085786
184,示,示,05,1273,516984,51.39741673
185,手,手,04,1269,518253,51.52357793
186,想,心,13,1269,519522,51.64973913
187,再,??,06,1267,520789,51.77570149
188,道,??,13,1259,522048,51.90086851
189,灣,水,25,1227,523275,52.02285417
190,第,竹,11,1223,524498,52.14444215
191,每,毋,07,1220,525718,52.26573187
192,數,??,15,1220,526938,52.38702160
193,身,身,07,1207,528145,52.50701890
194,價,人,15,1200,529345,52.62632027
195,指,手,09,1190,530535,52.74462746
196,立,立,05,1185,531720,52.86243757
197,次,欠,06,1184,532904,52.98014825
198,受,又,08,1171,534075,53.09656651
199,計,言,09,1167,535242,53.21258709
200,路,足,13,1155,536397,53.32741466
201,今,人,04,1150,537547,53.44174514
202,感,心,13,1150,538697,53.55607562
203,那,邑,07,1143,539840,53.66971018
204,百,白,06,1125,540965,53.78155521
205,問,口,11,1124,542089,53.89330083
206,讓,言,24,1123,543212,54.00494703
207,處,虍,11,1120,544332,54.11629498
208,做,人,11,1117,545449,54.22734467
209,程,禾,12,1114,546563,54.33809611
210,她,女,06,1111,547674,54.44854930
211,各,口,06,1103,548777,54.55820714
212,原,厂,10,1103,549880,54.66786498
213,樣,木,15,1096,550976,54.77682690
214,少,小,04,1092,552068,54.88539115
215,被,衣,11,1092,553160,54.99395540
216,商,口,11,1083,554243,55.10162488
217,任,人,06,1078,555321,55.20879728
218,展,尸,10,1076,556397,55.31577085
219,麼,麻,14,1074,557471,55.42254557
220,導,寸,16,1059,558530,55.52782903
221,建,??,09,1058,559588,55.63301308
222,區,??,11,1054,560642,55.73779945
223,設,言,11,1053,561695,55.84248640
224,量,里,12,1050,562745,55.94687510
225,較,車,13,1049,563794,56.05116438
226,萬,禸,13,1044,564838,56.15495657
227,樂,木,15,1044,565882,56.25874877
228,北,匕,05,1038,566920,56.36194445
229,活,水,09,1028,567948,56.46414596
230,才,手,03,1021,568969,56.56565154
231,接,手,11,1013,569982,56.66636179
232,題,頁,18,1012,570994,56.76697261
233,九,乙,02,1009,572003,56.86728518
234,己,己,03,1008,573011,56.96749833
235,演,水,14,1007,574018,57.06761206
236,女,女,03,1000,575018,57.16702987
237,色,色,06,997,576015,57.26614943
238,保,人,09,997,577012,57.36526898
239,術,行,11,995,578007,57.46418971
240,六,八,04,990,578997,57.56261334
241,回,囗,06,986,579983,57.66063930
242,別,刀,07,981,580964,57.75816817
243,球,玉,11,980,581944,57.85559762
244,片,片,04,977,582921,57.95272882
245,運,??,13,976,583897,58.04976060
246,通,??,11,974,584871,58.14659355
247,認,言,14,969,585840,58.24292941
248,未,木,05,968,586808,58.33916584
249,像,人,14,965,587773,58.43510403
250,何,人,07,963,588736,58.53084338
251,氣,气,10,961,589697,58.62638390
252,基,土,11,961,590658,58.72192441
253,近,??,08,959,591617,58.81726609
254,調,言,15,957,592574,58.91240893
255,明,日,08,954,593528,59.00725352
256,頭,頁,16,952,594480,59.10189928
257,管,竹,14,948,595428,59.19614736
258,八,八,02,946,596374,59.29019661
259,許,言,11,942,597316,59.38384819
260,務,力,11,940,598256,59.47730093
261,記,言,10,939,599195,59.57065425
262,變,言,23,933,600128,59.66341106
263,解,角,13,932,601060,59.75606846
264,畫,田,12,919,601979,59.84743343
265,該,言,13,917,602896,59.93859956
266,知,矢,08,916,603812,60.02966627
267,交,??,06,912,604724,60.12033532
268,觀,見,25,911,605635,60.21090494
269,達,??,13,910,606545,60.30137515
270,向,口,06,908,607453,60.39164652
271,老,老,06,906,608359,60.48171905
272,七,一,02,898,609257,60.57099625
273,造,??,11,897,610154,60.66017402
274,型,土,09,895,611049,60.74915296
275,黨,黑,20,895,611944,60.83813190
276,結,糸,12,894,612838,60.92701142
277,營,火,17,893,613731,61.01579152
278,東,木,08,887,614618,61.10397512
279,海,水,10,881,615499,61.19156221
280,除,阜,10,881,616380,61.27914930
281,即,??,07,880,617260,61.36663697
282,平,干,05,877,618137,61.45382639
283,先,儿,06,876,619013,61.54091639
284,打,手,05,875,619888,61.62790698
285,又,又,02,870,620758,61.71440047
286,世,一,05,866,621624,61.80049629
287,安,??,06,862,622486,61.88619445
288,風,風,09,858,623344,61.97149493
289,戰,戈,16,853,624197,62.05629832
290,局,尸,07,851,625048,62.14090287
291,教,??,11,848,625896,62.22520918
292,且,一,05,846,626742,62.30931664
293,院,阜,10,846,627588,62.39342411
294,改,??,07,840,628428,62.47693507
295,必,心,05,839,629267,62.56034661
296,口,口,03,831,630098,62.64296281
297,告,口,07,831,630929,62.72557901
298,斯,斤,12,828,631757,62.80789696
299,空,穴,08,826,632583,62.89001607
300,音,音,09,825,633408,62.97203576
301,真,目,10,825,634233,63.05405545
302,林,木,08,821,635054,63.13567747
303,信,人,09,817,635871,63.21690182
304,視,見,12,817,636688,63.29812617
305,質,貝,15,815,637503,63.37915169
306,太,大,04,814,638317,63.46007778
307,單,口,12,814,639131,63.54100388
308,共,八,06,813,639944,63.62183056
309,求,水,07,810,640754,63.70235899
310,界,田,09,809,641563,63.78278799
311,持,手,09,808,642371,63.86311758
312,連,??,11,806,643177,63.94324834
313,反,又,04,802,643979,64.02298142
314,直,目,08,802,644781,64.10271450
315,卻,??,09,800,645581,64.18224875
316,完,??,07,799,646380,64.26168358
317,強,弓,11,799,647179,64.34111841
318,非,非,08,790,647969,64.41965848
319,把,手,07,789,648758,64.49809913
320,隊,阜,12,786,649544,64.57624153
321,見,見,07,780,650324,64.65378742
322,率,玄,11,778,651102,64.73113448
323,裡,衣,13,776,651878,64.80828270
324,組,糸,11,775,652653,64.88533150
325,件,人,06,772,653425,64.96208205
326,幾,??,12,772,654197,65.03883260
327,士,士,03,771,654968,65.11548373
328,具,八,08,770,655738,65.19203544
329,約,糸,09,770,656508,65.26858715
330,話,言,13,769,657277,65.34503945
331,整,??,16,765,658042,65.42109407
332,功,力,05,764,658806,65.49704928
333,馬,馬,10,758,659564,65.57240798
334,光,儿,06,755,660319,65.64746842
335,容,??,10,751,661070,65.72213120
336,標,木,15,748,661818,65.79649572
337,形,??,07,746,662564,65.87066141
338,放,??,08,745,663309,65.94472767
339,格,木,10,745,664054,66.01879394
340,需,雨,14,743,664797,66.09266137
341,傳,人,13,742,665539,66.16642939
342,往,彳,08,737,666276,66.23970031
343,張,弓,11,734,667010,66.31267299
344,收,??,06,733,667743,66.38554624
345,服,月,08,732,668475,66.45832008
346,它,??,05,729,669204,66.53079566
347,望,月,11,726,669930,66.60297299
348,覺,見,20,723,670653,66.67485207
349,專,寸,11,721,671374,66.74653231
350,給,糸,12,720,672094,66.81811313
351,西,襾,06,717,672811,66.88939570
352,便,人,09,717,673528,66.96067827
353,腦,肉,13,716,674244,67.03186142
354,師,巾,10,713,674957,67.10274632
355,議,言,20,711,675668,67.17343238
356,案,木,10,709,676377,67.24391961
357,華,艸,12,708,677085,67.31430742
358,克,儿,07,704,677789,67.38429755
359,另,口,05,696,678485,67.45349235
360,易,日,08,695,679180,67.52258773
361,類,頁,19,694,679874,67.59158369
362,流,水,09,693,680567,67.66048023
363,山,山,03,692,681259,67.72927735
364,團,囗,14,690,681949,67.79787564
365,線,糸,15,690,682639,67.86647393
366,仍,人,04,685,683324,67.93457513
367,門,門,08,677,684001,68.00188098
368,費,貝,12,677,684678,68.06918684
369,南,十,09,675,685353,68.13629386
370,效,??,10,673,686026,68.20320205
371,票,示,11,672,686698,68.27001082
372,雖,隹,17,671,687369,68.33672017
373,象,豕,12,669,688038,68.40323068
374,府,??,08,668,688706,68.46964178
375,辦,辛,16,668,689374,68.53605287
376,帶,巾,11,664,690038,68.60206630
377,言,言,07,662,690700,68.66788089
378,際,阜,14,662,691362,68.73369548
379,客,??,09,661,692023,68.79941065
380,廠,??,15,655,692678,68.86452932
381,料,斗,10,653,693331,68.92944915
382,藝,艸,19,651,693982,68.99417014
383,引,弓,04,650,694632,69.05879172
384,制,刀,08,649,695281,69.12331387
385,顯,頁,23,648,695929,69.18773661
386,書,曰,10,646,696575,69.25196052
387,包,??,05,645,697220,69.31608501
388,轉,車,18,642,697862,69.37991124
389,備,人,12,641,698503,69.44363806
390,花,艸,08,636,699139,69.50686778
391,系,糸,07,634,699773,69.56989867
392,推,手,11,632,700405,69.63273073
393,決,水,07,627,701032,69.69506570
394,精,米,14,627,701659,69.75740066
395,德,彳,15,627,702286,69.81973563
396,據,手,16,623,702909,69.88167292
397,清,水,11,622,703531,69.94351080
398,走,走,07,620,704151,70.00514984
399,眾,目,11,619,704770,70.06668947
400,裝,衣,13,619,705389,70.12822909
401,規,見,11,614,706003,70.18927163
402,查,木,09,613,706616,70.25021474
403,陸,阜,11,612,707228,70.31105844
404,低,人,07,609,707837,70.37160389
405,廣,??,15,609,708446,70.43214933
406,供,人,08,608,709054,70.49259536
407,難,隹,19,608,709662,70.55304139
408,病,??,10,606,710268,70.61328858
409,財,貝,10,605,710873,70.67343636
410,陳,阜,11,601,711474,70.73318646
411,李,木,07,600,712074,70.79283715
412,兒,儿,08,599,712673,70.85238841
413,社,示,08,598,713271,70.91184026
414,創,刀,12,597,713868,70.97119270
415,預,頁,13,594,714462,71.03024687
416,權,木,22,590,715052,71.08890338
417,訊,言,10,589,715641,71.14746047
418,增,土,15,588,716229,71.20591814
419,例,人,08,586,716815,71.26417698
420,房,戶,08,586,717401,71.32243582
421,技,手,07,584,717985,71.38049582
422,買,貝,12,584,718569,71.43855582
423,始,女,08,582,719151,71.49641698
424,億,人,15,578,719729,71.55388048
425,治,水,08,576,720305,71.61114513
426,義,羊,13,575,720880,71.66831037
427,響,音,21,575,721455,71.72547561
428,什,人,04,574,722029,71.78254144
429,眼,目,11,574,722603,71.83960726
430,舉,臼,17,574,723177,71.89667308
431,神,示,10,571,723748,71.95344065
432,食,食,09,570,724318,72.01010880
433,遊,??,13,570,724888,72.06677695
434,消,水,10,569,725457,72.12334569
435,獲,犬,17,568,726025,72.17981500
436,愛,心,13,566,726591,72.23608548
437,器,口,16,566,727157,72.29235596
438,曾,曰,12,565,727722,72.34852703
439,銀,金,14,564,728286,72.40459867
440,快,心,07,562,728848,72.46047148
441,白,白,05,561,729409,72.51624487
442,取,又,08,561,729970,72.57201826
443,攝,手,21,561,730531,72.62779165
444,千,十,03,558,731089,72.68326679
445,王,玉,04,558,731647,72.73874193
446,希,巾,07,558,732205,72.79421706
447,配,酉,10,554,732759,72.84929453
448,論,言,15,552,733311,72.90417316
449,住,人,07,551,733862,72.95895237
450,準,水,13,550,734412,73.01363217
451,須,頁,12,548,734960,73.06811313
452,勢,力,13,547,735507,73.12249467
453,值,人,10,546,736053,73.17677680
454,亞,二,08,545,736598,73.23095950
455,集,隹,12,545,737143,73.28514221
456,滿,水,14,545,737688,73.33932491
457,續,糸,21,543,738231,73.39330878
458,參,??,11,542,738773,73.44719324
459,環,玉,17,542,739315,73.50107769
460,確,石,15,541,739856,73.55486272
461,考,老,06,538,740394,73.60834951
462,星,日,09,536,740930,73.66163745
463,領,頁,14,535,741465,73.71482598
464,委,女,08,534,741999,73.76791509
465,步,止,07,533,742532,73.82090478
466,友,又,04,532,743064,73.87379506
467,港,水,12,532,743596,73.92668533
468,節,竹,13,532,744128,73.97957561
469,份,人,06,531,744659,74.03236646
470,醫,酉,18,530,745189,74.08505790
471,軍,車,09,529,745718,74.13764992
472,支,支,04,525,746243,74.18984427
473,項,頁,12,525,746768,74.24203862
474,親,見,16,521,747289,74.29383530
475,企,人,06,520,747809,74.34553256
476,錢,金,16,519,748328,74.39713040
477,土,土,03,516,748844,74.44842999
478,失,大,05,513,749357,74.49943133
479,角,角,07,511,749868,74.55023383
480,爭,爪,08,510,750378,74.60093691
481,輕,車,14,509,750887,74.65154058
482,研,石,09,507,751394,74.70194541
483,速,??,11,507,751901,74.75235024
484,列,刀,06,506,752407,74.80265565
485,製,衣,14,506,752913,74.85296106
486,卡,卜,05,505,753418,74.90316705
487,存,子,06,505,753923,74.95337305
488,聲,耳,17,504,754427,75.00347962
489,男,田,07,503,754930,75.05348678
490,英,艸,09,501,755431,75.10329510
491,網,糸,14,500,755931,75.15300401
492,助,力,07,499,756430,75.20261350
493,排,手,11,499,756929,75.25222298
494,級,糸,10,496,757425,75.30153422
495,貨,貝,11,496,757921,75.35084545
496,興,臼,16,492,758413,75.39975901
497,否,口,07,489,758902,75.44837432
498,半,十,05,488,759390,75.49689021
499,銷,金,15,488,759878,75.54540610
500,照,火,13,487,760365,75.59382258
501,請,言,15,487,760852,75.64223905
502,根,木,10,486,761338,75.69055610
503,底,??,08,485,761823,75.73877374
504,極,木,13,485,762308,75.78699138
505,境,土,14,484,762792,75.83510960
506,景,日,12,482,763274,75.88302898
507,熱,火,15,482,763756,75.93094837
508,致,至,09,481,764237,75.97876833
509,劇,刀,15,481,764718,76.02658830
510,香,香,09,480,765198,76.07430885
511,科,禾,09,479,765677,76.12192998
512,候,人,10,479,766156,76.16955111
513,深,水,11,479,766635,76.21717224
514,圖,囗,14,478,767113,76.26469395
515,況,水,08,477,767590,76.31211625
516,算,竹,14,475,768065,76.35933971
517,聯,耳,17,475,768540,76.40656317
518,證,言,19,474,769014,76.45368721
519,店,??,08,473,769487,76.50071183
520,般,舟,10,469,769956,76.54733878
521,令,人,05,465,770421,76.59356807
522,若,艸,09,465,770886,76.63979735
523,戲,戈,17,465,771351,76.68602663
524,超,走,12,464,771815,76.73215649
525,孩,子,09,463,772278,76.77818694
526,警,言,20,463,772741,76.82421738
527,早,日,06,453,773194,76.86925365
528,職,耳,18,452,773646,76.91419050
529,爾,爻,14,451,774097,76.95902793
530,賽,貝,17,451,774548,77.00386536
531,款,欠,12,450,774998,77.04860338
532,屬,尸,21,450,775448,77.09334139
533,段,殳,09,447,775895,77.13778115
534,切,刀,04,444,776339,77.18192266
535,驗,馬,23,443,776782,77.22596475
536,命,口,08,441,777223,77.26980800
537,狀,犬,08,441,777664,77.31365126
538,首,首,09,441,778105,77.35749451
539,雄,隹,12,441,778546,77.40133777
540,黃,黃,12,439,778985,77.44498218
541,究,穴,07,438,779423,77.48852718
542,園,囗,13,438,779861,77.53207219
543,換,手,12,437,780298,77.57551777
544,號,虍,13,437,780735,77.61896335
545,賣,貝,15,436,781171,77.66230952
546,甚,甘,09,435,781606,77.70555626
547,態,心,14,435,782041,77.74880301
548,富,??,12,434,782475,77.79195034
549,味,口,08,431,782906,77.83479941
550,念,心,08,430,783336,77.87754907
551,濟,水,17,429,783765,77.92019931
552,免,儿,07,427,784192,77.96265072
553,習,羽,11,427,784619,78.00510212
554,昨,日,09,425,785044,78.04735469
555,依,人,08,424,785468,78.08950784
556,省,目,09,424,785892,78.13166099
557,字,子,06,419,786311,78.17331706
558,隨,阜,16,419,786730,78.21497312
559,乎,??,05,418,787148,78.25652976
560,購,貝,17,418,787566,78.29808641
561,找,手,07,416,787982,78.33944421
562,紀,糸,09,415,788397,78.38070261
563,喜,口,12,413,788810,78.42176216
564,遠,??,14,413,789223,78.46282172
565,軟,車,11,412,789635,78.50378185
566,離,隹,19,412,790047,78.54474199
567,落,艸,13,411,790458,78.58560271
568,洲,水,09,405,790863,78.62586692
569,紅,糸,09,404,791267,78.66603172
570,布,巾,05,403,791670,78.70609710
571,適,??,15,403,792073,78.74616247
572,源,水,13,402,792475,78.78612843
573,層,尸,15,399,792874,78.82579614
574,升,十,04,398,793272,78.86536443
575,稅,禾,12,396,793668,78.90473388
576,積,禾,16,396,794064,78.94410333
577,擊,手,17,395,794459,78.98337337
578,死,歹,06,394,794853,79.02254398
579,足,足,07,394,795247,79.06171460
580,拉,手,08,393,795640,79.10078580
581,縣,糸,16,393,796033,79.13985700
582,斷,斤,18,393,796426,79.17892820
583,素,糸,10,392,796818,79.21789998
584,優,人,17,391,797209,79.25677234
585,模,木,15,389,797598,79.29544587
586,邊,??,19,389,797987,79.33411940
587,夠,夕,11,387,798374,79.37259409
588,史,口,05,385,798759,79.41086995
589,息,心,10,385,799144,79.44914580
590,福,示,14,384,799528,79.48732224
591,雙,隹,18,384,799912,79.52549868
592,構,木,14,383,800295,79.56357570
593,防,阜,07,382,800677,79.60155330
594,險,阜,16,382,801059,79.63953091
595,售,口,11,381,801440,79.67740909
596,曲,曰,06,380,801820,79.71518786
597,係,人,09,380,802200,79.75296663
598,護,言,21,378,802578,79.79054656
599,居,尸,08,377,802955,79.82802707
600,季,子,08,376,803331,79.86540817
601,試,言,13,376,803707,79.90278927
602,注,水,08,374,804081,79.93997153
603,座,??,10,374,804455,79.97715379
604,材,木,07,373,804828,80.01423663
605,官,??,08,373,805201,80.05131947
606,歡,欠,22,373,805574,80.08840232
607,條,木,11,372,805946,80.12538574
608,酒,酉,10,370,806316,80.16217033
609,母,毋,05,369,806685,80.19885550
610,吃,口,06,369,807054,80.23554067
611,採,手,11,369,807423,80.27222585
612,差,工,10,368,807791,80.30881160
613,絕,糸,12,368,808159,80.34539735
614,版,片,08,367,808526,80.38188369
615,嚴,口,20,367,808893,80.41837003
616,似,人,07,366,809259,80.45475694
617,壓,土,17,365,809624,80.49104444
618,談,言,15,363,809987,80.52713311
619,聽,耳,22,363,810350,80.56322177
620,初,衣,08,362,810712,80.59921102
621,蘭,艸,21,362,811074,80.63520027
622,均,土,07,361,811435,80.67109010
623,佳,人,08,359,811794,80.70678109
624,里,里,07,358,812152,80.74237267
625,練,糸,15,358,812510,80.77796424
626,識,言,19,358,812868,80.81355582
627,思,心,09,357,813225,80.84904798
628,減,水,12,357,813582,80.88454013
629,館,食,16,357,813939,80.92003229
630,登,??,12,356,814295,80.95542503
631,群,羊,13,356,814651,80.99081777
632,檢,木,17,356,815007,81.02621051
633,僅,人,13,353,815360,81.06130500
634,波,水,08,352,815712,81.09630007
635,歲,止,13,352,816064,81.13129514
636,拍,手,08,351,816415,81.16619079
637,限,阜,09,351,816766,81.20108644
638,石,石,05,350,817116,81.23588267
639,育,肉,07,350,817466,81.27067890
640,羅,网,19,350,817816,81.30547514
641,負,貝,09,349,818165,81.34017195
642,藥,艸,19,349,818514,81.37486877
643,擇,手,16,348,818862,81.40946617
644,周,口,08,347,819209,81.44396415
645,置,网,13,346,819555,81.47836271
646,戶,戶,04,344,819899,81.51256243
647,黑,黑,12,344,820243,81.54676216
648,養,食,15,344,820587,81.58096189
649,讀,言,22,343,820930,81.61506220
650,印,??,06,341,821271,81.64896367
651,油,水,08,341,821612,81.68286514
652,稱,禾,14,341,821953,81.71676661
653,皮,皮,05,339,822292,81.75046925
654,飛,飛,09,339,822631,81.78417189
655,顧,頁,21,338,822969,81.81777511
656,語,言,14,335,823304,81.85108008
657,待,彳,09,334,823638,81.88428562
658,細,糸,11,334,823972,81.91749117
659,健,人,11,332,824304,81.95049788
660,血,血,06,331,824635,81.98340518
661,筆,竹,12,331,824966,82.01631247
662,獨,犬,16,331,825297,82.04921977
663,密,??,11,328,825625,82.08182881
664,施,方,09,327,825952,82.11433843
665,室,??,09,324,826276,82.14654980
666,錯,金,16,324,826600,82.17876117
667,透,??,11,323,826923,82.21087313
668,編,糸,15,322,827245,82.24288566
669,族,方,11,319,827564,82.27459994
670,維,糸,14,319,827883,82.30631422
671,額,頁,18,319,828202,82.33802851
672,修,人,10,318,828520,82.36964337
673,責,貝,11,317,828837,82.40115881
674,擔,手,16,317,829154,82.43267426
675,錄,金,16,317,829471,82.46418971
676,火,火,04,316,829787,82.49560573
677,牌,片,12,316,830103,82.52702176
678,留,田,10,315,830418,82.55833837
679,策,竹,12,315,830733,82.58965498
680,假,人,11,314,831047,82.62087217
681,○,囗,01,313,831360,82.65198995
682,括,手,09,312,831672,82.68300830
683,刻,刀,08,310,831982,82.71382782
684,益,皿,10,310,832292,82.74464735
685,餘,食,15,310,832602,82.77546687
686,午,十,04,309,832911,82.80618697
687,善,羊,12,307,833218,82.83670824
688,農,辰,13,305,833523,82.86703067
689,故,??,09,304,833827,82.89725368
690,止,止,04,303,834130,82.92737728
691,奇,大,08,303,834433,82.95750087
692,愈,心,13,303,834736,82.98762447
693,板,木,08,301,835037,83.01754923
694,拿,手,10,301,835338,83.04747399
695,朋,月,08,300,835638,83.07729934
696,終,糸,11,300,835938,83.10712468
697,復,彳,12,299,836237,83.13685060
698,補,衣,13,299,836536,83.16657653
699,協,十,08,297,836833,83.19610362
700,休,人,06,296,837129,83.22553129
701,康,??,11,296,837425,83.25495896
702,跟,足,13,296,837721,83.28438663
703,雜,隹,18,295,838016,83.31371489
704,充,儿,05,294,838310,83.34294372
705,尼,尸,05,294,838604,83.37217256
706,餐,食,16,294,838898,83.40140139
707,旅,方,10,293,839191,83.43053081
708,送,??,10,293,839484,83.45966023
709,吸,口,07,292,839776,83.48869023
710,異,田,11,292,840068,83.51772023
711,亦,??,06,291,840359,83.54665081
712,龍,龍,16,291,840650,83.57558140
713,越,走,12,290,840940,83.60441256
714,舞,舛,14,290,841230,83.63324372
715,玩,玉,08,288,841518,83.66187605
716,追,??,10,288,841806,83.69050838
717,寫,??,15,288,842094,83.71914071
718,繼,糸,20,288,842382,83.74777304
719,衛,行,15,287,842669,83.77630595
720,課,言,15,286,842955,83.80473945
721,威,女,09,284,843239,83.83297410
722,班,玉,10,284,843523,83.86120876
723,久,??,03,283,843806,83.88934400
724,父,父,04,283,844089,83.91747924
725,校,木,10,283,844372,83.94561448
726,洋,水,09,282,844654,83.97365030
727,短,矢,12,282,844936,84.00168613
728,察,??,14,282,845218,84.02972195
729,退,??,10,280,845498,84.05755893
730,競,立,20,280,845778,84.08539592
731,青,青,08,279,846057,84.11313349
732,降,阜,09,279,846336,84.14087106
733,簡,竹,18,279,846615,84.16860863
734,寶,??,20,278,846893,84.19624678
735,破,石,10,277,847170,84.22378551
736,古,口,05,275,847445,84.25112541
737,執,土,11,274,847719,84.27836589
738,融,虫,16,274,847993,84.30560637
739,臨,臣,17,272,848265,84.33264801
740,歌,欠,14,271,848536,84.35959024
741,良,艮,07,270,848806,84.38643305
742,副,刀,11,270,849076,84.41327586
743,劃,刀,14,270,849346,84.44011867
744,獎,犬,15,270,849616,84.46696147
745,盤,皿,15,269,849885,84.49370486
746,溫,水,13,268,850153,84.52034884
747,評,言,12,267,850420,84.54689339
748,願,頁,19,267,850687,84.57343795
749,突,穴,09,266,850953,84.59988308
750,控,手,11,266,851219,84.62632822
751,魚,魚,11,266,851485,84.65277336
752,航,舟,10,264,851749,84.67901966
753,菜,艸,12,264,852013,84.70526596
754,岸,山,08,263,852276,84.73141285
755,訴,言,12,263,852539,84.75755973
756,劉,刀,15,259,852798,84.78330894
757,討,言,10,258,853056,84.80895874
758,苦,艸,09,257,853313,84.83450911
759,勝,力,12,257,853570,84.86005949
760,績,糸,17,257,853827,84.88560987
761,停,人,11,255,854082,84.91096141
762,漸,水,14,255,854337,84.93631295
763,承,手,08,254,854591,84.96156507
764,毛,毛,04,253,854844,84.98671778
765,迷,??,10,253,855097,85.01187049
766,漲,水,14,253,855350,85.03702319
767,榮,木,14,252,855602,85.06207648
768,歷,止,16,251,855853,85.08703035
769,春,日,09,250,856103,85.11188480
770,症,??,10,250,856353,85.13673925
771,站,立,10,250,856603,85.16159371
772,測,水,12,250,856853,85.18644816
773,納,糸,10,249,857102,85.21120319
774,輸,車,16,249,857351,85.23595823
775,謝,言,17,249,857600,85.26071326
776,肉,肉,06,248,857848,85.28536888
777,講,言,17,248,858096,85.31002450
778,移,禾,11,247,858343,85.33458070
779,晚,日,11,246,858589,85.35903748
780,左,工,05,244,858833,85.38329542
781,含,口,07,244,859077,85.40755337
782,武,止,08,244,859321,85.43181131
783,阿,阜,08,244,859565,85.45606926
784,趣,走,15,244,859809,85.48032720
785,幫,巾,17,244,860053,85.50458515
786,介,人,04,243,860296,85.52874368
787,木,木,04,243,860539,85.55290220
788,您,心,11,243,860782,85.57706073
789,傷,人,13,243,861025,85.60121926
790,彈,弓,15,243,861268,85.62537779
791,城,土,09,242,861510,85.64943690
792,染,木,09,242,861752,85.67349601
793,答,竹,12,241,861993,85.69745570
794,聞,耳,14,241,862234,85.72141539
795,缺,缶,10,240,862474,85.74527567
796,麗,鹿,19,240,862714,85.76913594
797,妳,女,08,239,862953,85.79289680
798,某,木,09,239,863192,85.81665765
799,唱,口,11,239,863431,85.84041851
800,倒,人,10,238,863669,85.86407995
801,擁,手,16,238,863907,85.88774139
802,牛,牛,04,237,864144,85.91130341
803,右,口,05,237,864381,85.93486543
804,附,阜,08,237,864618,85.95842745
805,野,里,11,237,864855,85.98198947
806,幅,巾,12,237,865092,86.00555149
807,巴,己,04,236,865328,86.02901409
808,硬,石,12,236,865564,86.05247670
809,鄉,邑,12,236,865800,86.07593930
810,緊,糸,14,236,866036,86.09940190
811,歐,欠,15,236,866272,86.12286451
812,呢,口,08,233,866505,86.14602886
813,棒,木,12,232,866737,86.16909379
814,避,??,17,232,866969,86.19215872
815,尚,小,08,231,867200,86.21512423
816,害,??,10,231,867431,86.23808975
817,夫,大,04,229,867660,86.26085642
818,永,水,05,228,867888,86.28352369
819,派,水,09,227,868115,86.30609153
820,套,大,10,227,868342,86.32865937
821,豐,豆,18,227,868569,86.35122721
822,宜,??,08,226,868795,86.37369564
823,紙,糸,10,226,869021,86.39616406
824,尤,尢,04,225,869246,86.41853307
825,江,水,06,225,869471,86.44090208
826,背,肉,09,225,869696,86.46327108
827,略,田,11,225,869921,86.48564009
828,抗,手,07,224,870145,86.50790968
829,勞,力,12,224,870369,86.53017927
830,微,彳,13,224,870593,86.55244886
831,穩,禾,19,223,870816,86.57461903
832,屋,尸,09,221,871037,86.59659037
833,宣,??,09,220,871257,86.61846228
834,乾,乙,11,220,871477,86.64033420
835,疑,疋,14,220,871697,86.66220612
836,普,日,12,219,871916,86.68397862
837,週,??,12,219,872135,86.70575112
838,摩,手,15,219,872354,86.72752362
839,笑,竹,10,218,872572,86.74919670
840,幣,巾,14,218,872790,86.77086979
841,守,??,06,217,873007,86.79244345
842,享,??,08,217,873224,86.81401712
843,穿,穴,09,217,873441,86.83559078
844,訓,言,10,217,873658,86.85716445
845,樓,木,15,215,873873,86.87853927
846,奧,大,13,214,874087,86.89981469
847,博,十,12,213,874300,86.92099068
848,吳,口,07,212,874512,86.94206725
849,痛,??,12,212,874724,86.96314383
850,呼,口,08,211,874935,86.98412099
851,訂,言,09,211,875146,87.00509815
852,射,寸,10,211,875357,87.02607530
853,圍,囗,12,211,875568,87.04705246
854,尋,寸,12,211,875779,87.06802962
855,盡,皿,14,211,875990,87.08900678
856,述,??,09,210,876200,87.10988452
857,攻,??,07,209,876409,87.13066284
858,飯,食,12,209,876618,87.15144116
859,瑞,玉,13,209,876827,87.17221948
860,跑,足,12,208,877035,87.19289839
861,陽,阜,12,208,877243,87.21357729
862,檔,木,17,208,877451,87.23425620
863,療,??,17,208,877659,87.25493510
864,織,糸,18,208,877867,87.27561400
865,急,心,09,207,878074,87.29619349
866,債,人,13,207,878281,87.31677298
867,藏,艸,18,207,878488,87.33735246
868,鎮,金,18,207,878695,87.35793195
869,懷,心,19,207,878902,87.37851144
870,判,刀,07,206,879108,87.39899151
871,逐,??,11,206,879314,87.41947157
872,針,金,10,205,879519,87.43985223
873,掉,手,11,205,879724,87.46023288
874,輝,車,15,205,879929,87.48061353
875,遭,??,15,205,880134,87.50099418
876,村,木,07,204,880338,87.52127541
877,律,彳,09,204,880542,87.54155664
878,剛,刀,10,204,880746,87.56183788
879,跌,足,12,203,880949,87.58201969
880,操,手,16,203,881152,87.60220151
881,互,二,04,202,881354,87.62228391
882,損,手,13,202,881556,87.64236630
883,碼,石,15,202,881758,87.66244870
884,佛,人,07,201,881959,87.68243168
885,牠,牛,07,200,882159,87.70231524
886,券,刀,08,200,882359,87.72219880
887,竟,音,11,200,882559,87.74208237
888,誌,言,14,200,882759,87.76196593
889,冷,??,07,199,882958,87.78175007
890,激,水,16,199,883157,87.80153422
891,延,??,08,198,883355,87.82121894
892,衝,行,15,198,883553,87.84090367
893,頻,頁,16,198,883751,87.86058839
894,怕,心,08,197,883948,87.88017370
895,亮,??,09,197,884145,87.89975901
896,烈,火,10,197,884342,87.91934432
897,腳,肉,13,197,884539,87.93892963
898,席,巾,10,196,884735,87.95841552
899,陣,阜,10,196,884931,87.97790141
900,順,頁,12,196,885127,87.99738730
901,揮,手,12,195,885322,88.01677377
902,架,木,09,194,885516,88.03606083
903,楚,木,13,194,885710,88.05534788
904,盛,皿,11,193,885903,88.07453552
905,媒,女,12,193,886096,88.09372316
906,貴,貝,12,193,886289,88.11291079
907,樹,木,16,193,886482,88.13209843
908,擴,手,18,193,886675,88.15128607
909,鐘,金,20,193,886868,88.17047371
910,汽,水,07,192,887060,88.18956193
911,央,大,05,191,887251,88.20855073
912,幸,干,08,191,887442,88.22753953
913,夏,??,10,191,887633,88.24652833
914,幕,巾,14,191,887824,88.26551713
915,估,人,07,190,888014,88.28440652
916,寬,??,15,190,888204,88.30329590
917,典,八,08,189,888393,88.32208587
918,散,??,12,189,888582,88.34087583
919,階,阜,12,189,888771,88.35966580
920,慢,心,14,189,888960,88.37845576
921,慮,心,15,189,889149,88.39724573
922,釋,釆,20,189,889338,88.41603569
923,敗,??,11,188,889526,88.43472624
924,付,人,05,187,889713,88.45331737
925,嗎,口,13,187,889900,88.47190850
926,章,音,11,186,890086,88.49040022
927,雅,隹,12,186,890272,88.50889193
928,播,手,15,186,890458,88.52738364
929,訪,言,11,184,890642,88.54567652
930,舊,臼,18,184,890826,88.56396940
931,殺,殳,11,182,891008,88.58206344
932,庭,??,10,181,891189,88.60005806
933,淨,水,11,181,891370,88.61805268
934,露,雨,21,181,891551,88.63604731
935,倍,人,10,180,891731,88.65394251
936,禮,示,18,180,891911,88.67183772
937,藉,艸,18,180,892091,88.68973292
938,粉,米,10,179,892270,88.70752871
939,患,心,11,179,892449,88.72532450
940,童,立,12,179,892628,88.74312029
941,頓,頁,13,179,892807,88.76091608
942,賺,貝,17,179,892986,88.77871186
943,衣,衣,06,178,893164,88.79640823
944,呈,口,07,178,893342,88.81410460
945,宮,??,10,177,893519,88.83170156
946,彩,??,11,177,893696,88.84929851
947,碟,石,14,177,893873,88.86689546
948,熟,火,15,177,894050,88.88449241
949,河,水,08,176,894226,88.90198995
950,按,手,09,176,894402,88.91948748
951,堅,土,11,175,894577,88.93688560
952,吧,口,07,174,894751,88.95418430
953,泰,水,10,174,894925,88.97148300
954,範,竹,15,174,895099,88.98878169
955,靈,雨,24,174,895273,89.00608039
956,靠,非,15,173,895446,89.02327967
957,虎,虍,08,172,895618,89.04037954
958,促,人,09,172,895790,89.05747940
959,叫,口,05,171,895961,89.07447985
960,草,艸,10,171,896132,89.09148029
961,掌,手,12,171,896303,89.10848074
962,艦,舟,20,171,896474,89.12548118
963,志,心,07,170,896644,89.14238221
964,析,木,08,170,896814,89.15928324
965,託,言,10,170,896984,89.17618426
966,船,舟,11,170,897154,89.19308529
967,智,日,12,170,897324,89.20998632
968,飲,食,12,170,897494,89.22688735
969,監,皿,14,170,897664,89.24378838
970,審,??,15,170,897834,89.26068940
971,壞,土,19,170,898004,89.27759043
972,兵,八,07,169,898173,89.29439204
973,恐,心,10,169,898342,89.31119365
974,鏡,金,19,169,898511,89.32799526
975,炎,火,08,168,898679,89.34469745
976,骨,骨,10,168,898847,89.36139964
977,符,竹,11,168,899015,89.37810184
978,飾,食,13,168,899183,89.39480403
979,緒,糸,14,168,899351,89.41150622
980,潛,水,15,168,899519,89.42820841
981,廳,??,25,168,899687,89.44491060
982,刊,刀,05,167,899854,89.46151338
983,夜,夕,08,167,900021,89.47811615
984,鬆,髟,18,167,900188,89.49471893
985,島,山,10,166,900354,89.51122228
986,隆,阜,12,166,900520,89.52772564
987,雷,雨,13,166,900686,89.54422900
988,田,田,05,165,900851,89.56063293
989,困,囗,07,165,901016,89.57703687
990,坐,土,07,165,901181,89.59344081
991,庫,??,10,165,901346,89.60984475
992,隻,隹,10,165,901511,89.62624869
993,膚,肉,15,165,901676,89.64265263
994,核,木,10,164,901840,89.65895715
995,潮,水,15,164,902004,89.67526167
996,縮,糸,17,164,902168,89.69156619
997,臉,肉,17,164,902332,89.70787071
998,觸,角,20,164,902496,89.72417523
999,驚,馬,23,164,902660,89.74047975
1000,吉,口,06,163,902823,89.75668485
1001,京,??,08,163,902986,89.77288996
1002,肯,肉,08,163,903149,89.78909506
1003,挑,手,09,163,903312,89.80530016
1004,圓,囗,13,163,903475,89.82150527
1005,夢,夕,14,163,903638,89.83771037
1006,漢,水,14,163,903801,89.85391547
1007,靜,青,16,162,903963,89.87002116
1008,亡,??,03,161,904124,89.88602742
1009,宏,??,07,161,904285,89.90203369
1010,怎,心,09,161,904446,89.91803996
1011,婦,女,11,160,904606,89.93394681
1012,搭,手,13,159,904765,89.94975424
1013,廿,廾,04,158,904923,89.96546225
1014,奏,大,09,158,905081,89.98117027
1015,紛,糸,10,158,905239,89.99687828
1016,慶,心,15,158,905397,90.01258629
1017,折,手,07,157,905554,90.02819489
1018,距,足,12,157,905711,90.04380349
1019,固,囗,08,156,905867,90.05931267
1020,雲,雨,12,156,906023,90.07482184
1021,鐵,金,21,156,906179,90.09033102
1022,街,行,12,155,906334,90.10574078
1023,澳,水,16,155,906489,90.12115054
1024,鮮,魚,17,155,906644,90.13656030
1025,塊,土,13,154,906798,90.15187065
1026,媽,女,13,154,906952,90.16718099
1027,董,艸,13,154,907106,90.18249133
1028,域,土,11,153,907259,90.19770226
1029,敏,??,11,153,907412,90.21291318
1030,趨,走,17,153,907565,90.22812411
1031,尺,尸,04,152,907717,90.24323561
1032,申,田,05,152,907869,90.25834712
1033,端,立,14,152,908021,90.27345863
1034,竹,竹,06,151,908172,90.28847072
1035,圈,囗,11,151,908323,90.30348280
1036,荷,艸,11,151,908474,90.31849489
1037,亂,乙,13,151,908625,90.33350698
1038,葉,艸,13,151,908776,90.34851907
1039,徵,彳,15,151,908927,90.36353116
1040,築,竹,16,151,909078,90.37854325
1041,諾,言,16,151,909229,90.39355534
1042,輯,車,16,151,909380,90.40856743
1043,蘇,艸,20,151,909531,90.42357952
1044,惡,心,12,150,909681,90.43849219
1045,朝,月,12,150,909831,90.45340486
1046,米,米,06,149,909980,90.46821811
1047,尿,尸,07,149,910129,90.48303137
1048,努,力,07,148,910277,90.49774520
1049,洗,水,09,148,910425,90.51245904
1050,隔,阜,13,148,910573,90.52717288
1051,犯,犬,05,147,910720,90.54178729
1052,浪,水,10,147,910867,90.55640171
1053,婚,女,11,147,911014,90.57101613
1054,森,木,12,147,911161,90.58563055
1055,批,手,07,146,911307,90.60014555
1056,束,木,07,146,911453,90.61466055
1057,哈,口,09,146,911599,90.62917555
1058,啟,??,11,146,911745,90.64369055
1059,雪,雨,11,146,911891,90.65820555
1060,謂,言,16,146,912037,90.67272055
1061,仁,人,04,145,912182,90.68713613
1062,援,手,12,145,912327,90.70155171
1063,肌,肉,06,144,912471,90.71586788
1064,索,糸,10,144,912615,90.73018404
1065,唯,口,11,144,912759,90.74450021
1066,脫,肉,11,144,912903,90.75881637
1067,游,水,12,144,913047,90.77313254
1068,聖,耳,13,144,913191,90.78744870
1069,予,??,04,143,913334,90.80166545
1070,伊,人,06,143,913477,90.81588219
1071,沙,水,07,143,913620,90.83009894
1072,絲,糸,12,143,913763,90.84431569
1073,賓,貝,14,143,913906,90.85853243
1074,招,手,08,142,914048,90.87264976
1075,堂,土,11,142,914190,90.88676709
1076,遇,??,13,142,914332,90.90088442
1077,複,衣,15,142,914474,90.91500175
1078,籌,竹,20,142,914616,90.92911908
1079,培,土,11,141,914757,90.94313699
1080,憶,心,16,141,914898,90.95715490
1081,秀,禾,07,140,915038,90.97107339
1082,貿,貝,12,140,915178,90.98499189
1083,聚,耳,14,140,915318,90.99891038
1084,泥,水,08,139,915457,91.01272946
1085,緣,糸,15,139,915596,91.02654853
1086,刷,刀,08,138,915734,91.04026819
1087,既,??,09,138,915872,91.05398785
1088,握,手,12,138,916010,91.06770750
1089,跳,足,13,138,916148,91.08142716
1090,蓋,艸,14,138,916286,91.09514682
1091,籍,竹,20,138,916424,91.10886648
1092,憲,心,16,137,916561,91.12248672
1093,拜,手,09,136,916697,91.13600754
1094,弱,弓,10,136,916833,91.14952836
1095,累,糸,11,136,916969,91.16304918
1096,麥,麥,11,136,917105,91.17657001
1097,迎,??,08,135,917240,91.18999141
1098,振,手,10,135,917375,91.20341281
1099,純,糸,10,135,917510,91.21683422
1100,探,手,11,135,917645,91.23025562
1101,慣,心,14,135,917780,91.24367703
1102,賞,貝,15,135,917915,91.25709843
1103,賴,貝,16,135,918050,91.27051984
1104,革,革,09,134,918184,91.28384182
1105,旁,方,10,134,918318,91.29716381
1106,概,木,13,134,918452,91.31048580
1107,誤,言,14,134,918586,91.32380778
1108,雨,雨,08,133,918719,91.33703035
1109,嫌,女,13,133,918852,91.35025292
1110,嘉,口,14,133,918985,91.36347549
1111,私,禾,07,132,919117,91.37659864
1112,陰,阜,11,132,919249,91.38972179
1113,趕,走,14,132,919381,91.40284494
1114,哪,口,10,131,919512,91.41586867
1115,湖,水,12,131,919643,91.42889241
1116,漫,水,14,131,919774,91.44191614
1117,燈,火,16,131,919905,91.45493987
1118,巧,工,05,130,920035,91.46786419
1119,液,水,11,130,920165,91.48078850
1120,閒,門,12,130,920295,91.49371282
1121,誠,言,13,130,920425,91.50663713
1122,零,雨,13,130,920555,91.51956145
1123,頗,頁,14,130,920685,91.53248576
1124,遺,??,16,130,920815,91.54541008
1125,鍵,金,17,130,920945,91.55833439
1126,佔,人,07,129,921074,91.57115929
1127,屆,尸,08,129,921203,91.58398419
1128,毒,毋,08,129,921332,91.59680909
1129,喝,口,12,129,921461,91.60963398
1130,窗,穴,12,129,921590,91.62245888
1131,鼓,鼓,13,129,921719,91.63528378
1132,危,??,06,128,921847,91.64800926
1133,抱,手,08,128,921975,91.66073474
1134,鹽,鹵,24,128,922103,91.67346022
1135,弟,弓,07,127,922230,91.68608628
1136,刺,刀,08,127,922357,91.69871234
1137,暴,日,15,127,922484,91.71133840
1138,顏,頁,18,127,922611,91.72396446
1139,途,??,11,126,922737,91.73649111
1140,晶,日,12,126,922863,91.74901775
1141,巨,工,05,125,922988,91.76144498
1142,洛,水,09,125,923113,91.77387220
1143,混,水,11,125,923238,91.78629943
1144,惠,心,12,125,923363,91.79872666
1145,遍,??,13,125,923488,91.81115388
1146,姓,女,08,124,923612,91.82348169
1147,宗,??,08,124,923736,91.83580950
1148,救,??,11,124,923860,91.84813731
1149,湯,水,12,124,923984,91.86046512
1150,刀,刀,02,123,924107,91.87269351
1151,州,??,06,123,924230,91.88492190
1152,貝,貝,07,123,924353,91.89715029
1153,倫,人,10,123,924476,91.90937868
1154,畢,田,11,123,924599,91.92160707
1155,坡,土,08,122,924721,91.93373604
1156,秘,禾,10,122,924843,91.94586501
1157,偏,人,11,122,924965,91.95799399
1158,曼,又,11,122,925087,91.97012296
1159,澤,水,16,122,925209,91.98225193
1160,(粧),米,12,122,925331,91.99438091
1161,皆,白,09,121,925452,92.00641046
1162,暗,日,13,121,925573,92.01844002
1163,櫃,木,18,121,925694,92.03046957
1164,召,口,05,120,925814,92.04239971
1165,辛,辛,07,120,925934,92.05432984
1166,乳,乙,08,120,926054,92.06625998
1167,欣,欠,08,120,926174,92.07819012
1168,紐,糸,10,120,926294,92.09012026
1169,欲,欠,11,120,926414,92.10205039
1170,琴,玉,12,120,926534,92.11398053
1171,盟,皿,13,120,926654,92.12591067
1172,緩,糸,15,120,926774,92.13784080
1173,瞭,目,17,120,926894,92.14977094
1174,贏,貝,20,120,927014,92.16170108
1175,(裏),衣,13,120,927134,92.17363122
1176,仔,人,05,119,927253,92.18546193
1177,碰,石,13,119,927372,92.19729265
1178,載,車,13,119,927491,92.20912337
1179,酬,酉,13,119,927610,92.22095409
1180,鋼,金,16,119,927729,92.23278481
1181,抽,手,08,118,927847,92.24451611
1182,珍,玉,09,118,927965,92.25624742
1183,頂,頁,11,118,928083,92.26797872
1184,輪,車,15,118,928201,92.27971002
1185,旦,日,05,117,928318,92.29134190
1186,莫,艸,11,117,928435,92.30297379
1187,焦,火,12,117,928552,92.31460567
1188,塔,土,13,117,928669,92.32623755
1189,詢,言,13,117,928786,92.33786944
1190,蔡,艸,15,117,928903,92.34950132
1191,忙,心,06,116,929019,92.36103379
1192,伸,人,07,116,929135,92.37256625
1193,哥,口,10,116,929251,92.38409872
1194,廢,??,15,116,929367,92.39563118
1195,儘,人,16,116,929483,92.40716365
1196,勇,力,09,115,929598,92.41859670
1197,棄,木,11,115,929713,92.43002975
1198,瑪,玉,14,115,929828,92.44146279
1199,障,阜,14,115,929943,92.45289584
1200,丹,??,04,114,930057,92.46422947
1201,伴,人,07,114,930171,92.47556310
1202,序,??,07,114,930285,92.48689673
1203,邦,邑,07,114,930399,92.49823036
1204,桃,木,10,114,930513,92.50956399
1205,殊,歹,10,114,930627,92.52089762
1206,揚,手,12,114,930741,92.53223125
1207,禁,示,13,114,930855,92.54356488
1208,綠,糸,14,114,930969,92.55489851
1209,輛,車,15,114,931083,92.56623214
1210,兼,八,10,113,931196,92.57746636
1211,涉,水,10,113,931309,92.58870057
1212,紹,糸,11,113,931422,92.59993478
1213,悲,心,12,113,931535,92.61116899
1214,描,手,12,113,931648,92.62240321
1215,隱,阜,17,113,931761,92.63363742
1216,徒,彳,10,112,931873,92.64477221
1217,淡,水,11,112,931985,92.65590701
1218,腹,肉,13,112,932097,92.66704180
1219,邀,??,17,112,932209,92.67817660
1220,歸,止,18,112,932321,92.68931139
1221,覽,見,21,112,932433,92.70044619
1222,佈,人,07,111,932544,92.71148156
1223,忘,心,07,111,932655,92.72251694
1224,泡,水,08,111,932766,92.73355232
1225,逃,??,10,111,932877,92.74458769
1226,擺,手,18,111,932988,92.75562307
1227,繪,糸,19,111,933099,92.76665845
1228,艾,艸,06,110,933209,92.77759441
1229,授,手,11,110,933319,92.78853037
1230,植,木,12,110,933429,92.79946633
1231,楊,木,13,110,933539,92.81040228
1232,誰,言,15,110,933649,92.82133824
1233,氏,氏,04,109,933758,92.83217478
1234,句,口,05,109,933867,92.84301133
1235,伯,人,07,109,933976,92.85384787
1236,冒,??,09,109,934085,92.86468441
1237,捕,手,10,109,934194,92.87552095
1238,喬,口,12,109,934303,92.88635749
1239,敦,??,12,109,934412,92.89719403
1240,幹,干,13,109,934521,92.90803057
1241,醒,酉,16,109,934630,92.91886711
1242,覆,襾,18,109,934739,92.92970366
1243,怪,心,08,108,934847,92.94044078
1244,借,人,10,108,934955,92.95117790
1245,尊,寸,12,108,935063,92.96191503
1246,籃,竹,20,108,935171,92.97265215
1247,阻,阜,08,107,935278,92.98328985
1248,柏,木,09,107,935385,92.99392756
1249,鬥,鬥,10,107,935492,93.00456527
1250,袋,衣,11,107,935599,93.01520297
1251,稍,禾,12,107,935706,93.02584068
1252,簽,竹,19,107,935813,93.03647838
1253,桌,木,10,106,935919,93.04701667
1254,敢,??,12,106,936025,93.05755496
1255,替,曰,12,106,936131,93.06809325
1256,燒,火,16,106,936237,93.07863153
1257,闆,門,17,106,936343,93.08916982
1258,(唇),口,10,105,936448,93.09960869
1259,溝,水,13,105,936553,93.11004756
1260,箱,竹,15,105,936658,93.12048643
1261,鞋,革,15,105,936763,93.13092530
1262,帝,巾,09,104,936867,93.14126475
1263,偵,人,11,104,936971,93.15160421
1264,署,网,13,104,937075,93.16194366
1265,槍,木,14,104,937179,93.17228311
1266,擬,手,17,104,937283,93.18262256
1267,裁,衣,12,103,937386,93.19286260
1268,豪,豕,14,103,937489,93.20310263
1269,暫,日,15,103,937592,93.21334267
1270,賭,貝,15,103,937695,93.22358270
1271,奶,女,05,102,937797,93.23372332
1272,厚,厂,09,102,937899,93.24386393
1273,塑,土,13,102,938001,93.25400455
1274,罪,网,13,102,938103,93.26414517
1275,翻,羽,18,102,938205,93.27428578
1276,乏,??,05,101,938306,93.28432698
1277,玉,玉,05,101,938407,93.29436818
1278,映,日,09,101,938508,93.30440938
1279,秋,禾,09,101,938609,93.31445058
1280,毫,毛,11,101,938710,93.32449178
1281,傑,人,12,101,938811,93.33453297
1282,滑,水,13,101,938912,93.34457417
1283,震,雨,15,101,939013,93.35461537
1284,魯,魚,15,101,939114,93.36465657
1285,衡,行,16,101,939215,93.37469777
1286,藍,艸,18,101,939316,93.38473897
1287,冰,??,06,100,939416,93.39468075
1288,茲,艸,10,100,939516,93.40462253
1289,凡,??,03,99,939615,93.41446489
1290,偉,人,11,99,939714,93.42430726
1291,獅,犬,13,99,939813,93.43414962
1292,詳,言,13,99,939912,93.44399198
1293,敵,??,15,99,940011,93.45383435
1294,豬,豕,15,99,940110,93.46367671
1295,糖,米,16,99,940209,93.47351907
1296,繁,糸,17,99,940308,93.48336144
1297,斤,斤,04,98,940406,93.49310438
1298,沈,水,07,98,940504,93.50284733
1299,坦,土,08,98,940602,93.51259027
1300,忽,心,08,98,940700,93.52233322
1301,惜,心,11,98,940798,93.53207616
1302,旋,方,11,98,940896,93.54181911
1303,詞,言,12,98,940994,93.55156205
1304,違,??,13,98,941092,93.56130500
1305,彰,??,14,98,941190,93.57104794
1306,孕,子,05,97,941287,93.58069147
1307,疾,??,10,97,941384,93.59033500
1308,婆,女,11,97,941481,93.59997853
1309,儀,人,15,97,941578,93.60962205
1310,蕭,艸,16,97,941675,93.61926558
1311,鎖,金,18,97,941772,93.62890911
1312,末,木,05,96,941868,93.63845322
1313,耳,耳,06,96,941964,93.64799733
1314,彼,彳,08,96,942060,93.65754144
1315,爸,父,08,96,942156,93.66708555
1316,盈,皿,09,96,942252,93.67662966
1317,敬,??,13,96,942348,93.68617377
1318,齡,齒,20,96,942444,93.69571788
1319,萊,艸,12,95,942539,93.70516257
1320,魔,鬼,21,95,942634,93.71460726
1321,貸,貝,12,94,942728,93.72395253
1322,匯,匚,13,94,942822,93.73329781
1323,睛,目,13,94,942916,93.74264308
1324,橋,木,16,94,943010,93.75198836
1325,濃,水,16,94,943104,93.76133363
1326,顆,頁,17,94,943198,93.77067890
1327,幻,??,04,93,943291,93.77992476
1328,尾,尸,07,93,943384,93.78917062
1329,松,木,08,93,943477,93.79841647
1330,峰,山,10,93,943570,93.80766233
1331,舒,舌,12,93,943663,93.81690819
1332,壘,土,18,93,943756,93.82615404
1333,杯,木,08,92,943848,93.83530048
1334,冠,??,09,92,943940,93.84444692
1335,柯,木,09,92,944032,93.85359336
1336,迫,??,09,92,944124,93.86273980
1337,浴,水,10,92,944216,93.87188623
1338,絡,糸,12,92,944308,93.88103267
1339,扮,手,07,91,944399,93.89007969
1340,泉,水,09,91,944490,93.89912671
1341,搶,手,13,91,944581,93.90817373
1342,頸,頁,16,91,944672,93.91722076
1343,兄,儿,05,90,944762,93.92616836
1344,拓,手,08,90,944852,93.93511596
1345,側,人,11,90,944942,93.94406356
1346,診,言,12,90,945032,93.95301117
1347,貼,貝,12,90,945122,93.96195877
1348,托,手,06,89,945211,93.97080695
1349,肥,肉,08,89,945300,93.97965514
1350,勒,力,11,89,945389,93.98850332
1351,蒙,艸,14,89,945478,93.99735151
1352,干,干,03,88,945566,94.00610028
1353,池,水,06,88,945654,94.01484904
1354,床,??,07,88,945742,94.02359781
1355,徐,彳,10,88,945830,94.03234658
1356,殘,歹,12,88,945918,94.04109535
1357,諸,言,15,88,946006,94.04984411
1358,肝,肉,07,87,946093,94.05849346
1359,忠,心,08,87,946180,94.06714281
1360,偶,人,11,87,946267,94.07579216
1361,添,水,11,87,946354,94.08444151
1362,麻,麻,11,87,946441,94.09309086
1363,詩,言,13,87,946528,94.10174021
1364,勵,力,17,87,946615,94.11038956
1365,牙,牙,04,86,946701,94.11893949
1366,俗,人,09,86,946787,94.12748942
1367,膜,肉,15,86,946873,94.13603935
1368,駕,馬,15,86,946959,94.14458929
1369,韓,韋,17,86,947045,94.15313922
1370,麵,麥,20,86,947131,94.16168915
1371,併,人,08,85,947216,94.17013966
1372,恢,心,09,85,947301,94.17859018
1373,胎,肉,09,85,947386,94.18704069
1374,珠,玉,10,85,947471,94.19549120
1375,蛋,虫,11,85,947556,94.20394172
1376,裕,衣,13,85,947641,94.21239223
1377,潤,水,15,85,947726,94.22084274
1378,懂,心,17,85,947811,94.22929326
1379,乃,??,02,84,947895,94.23764435
1380,冬,??,05,84,947979,94.24599545
1381,巡,??,07,84,948063,94.25434655
1382,鳥,鳥,11,84,948147,94.26269764
1383,郵,邑,12,84,948231,94.27104874
1384,輔,車,14,84,948315,94.27939983
1385,慧,心,15,84,948399,94.28775093
1386,膠,肉,15,84,948483,94.29610203
1387,踏,足,15,84,948567,94.30445312
1388,駐,馬,15,84,948651,94.31280422
1389,壇,土,16,84,948735,94.32115531
1390,擾,手,18,84,948819,94.32950641
1391,役,彳,07,83,948902,94.33775809
1392,俊,人,09,83,948985,94.34600977
1393,凱,几,12,83,949068,94.35426144
1394,斑,文,12,83,949151,94.36251312
1395,酸,酉,14,83,949234,94.37076480
1396,礎,石,18,83,949317,94.37901648
1397,刑,刀,06,82,949399,94.38716874
1398,圾,土,07,82,949481,94.39532100
1399,垃,土,08,82,949563,94.40347326
1400,封,寸,09,82,949645,94.41162552
1401,胞,肉,09,82,949727,94.41977778
1402,迪,??,09,82,949809,94.42793004
1403,脈,肉,10,82,949891,94.43608230
1404,剩,刀,12,82,949973,94.44423456
1405,番,田,12,82,950055,94.45238682
1406,搖,手,13,82,950137,94.46053908
1407,憂,心,15,82,950219,94.46869134
1408,虧,虍,17,82,950301,94.47684360
1409,幼,??,05,81,950382,94.48489645
1410,拒,手,08,81,950463,94.49294929
1411,侵,人,09,81,950544,94.50100213
1412,胡,肉,09,81,950625,94.50905497
1413,塞,土,13,81,950706,94.51710782
1414,綜,糸,14,81,950787,94.52516066
1415,君,口,07,80,950867,94.53311408
1416,妙,女,07,80,950947,94.54106751
1417,茶,艸,10,80,951027,94.54902093
1418,捷,手,11,80,951107,94.55697436
1419,循,彳,12,80,951187,94.56492778
1420,勤,力,13,80,951267,94.57288121
1421,閣,門,14,80,951347,94.58083463
1422,齊,齊,14,80,951427,94.58878806
1423,篇,竹,15,80,951507,94.59674148
1424,鄰,邑,15,80,951587,94.60469491
1425,戴,戈,17,80,951667,94.61264833
1426,杜,木,07,79,951746,94.62050234
1427,耐,而,09,79,951825,94.62835635
1428,偷,人,11,79,951904,94.63621035
1429,措,手,11,79,951983,94.64406436
1430,旗,方,14,79,952062,94.65191837
1431,礙,石,19,79,952141,94.65977237
1432,丁,一,02,78,952219,94.66752696
1433,冊,??,05,78,952297,94.67528155
1434,甲,田,05,78,952375,94.68303614
1435,秒,禾,09,78,952453,94.69079073
1436,浮,水,10,78,952531,94.69854532
1437,償,人,17,78,952609,94.70629991
1438,炒,火,08,77,952686,94.71395508
1439,怨,心,09,77,952763,94.72161025
1440,乘,??,10,77,952840,94.72926542
1441,帳,巾,11,77,952917,94.73692059
1442,閉,門,11,77,952994,94.74457576
1443,鹿,鹿,11,77,953071,94.75223094
1444,喪,口,12,77,953148,94.75988611
1445,壽,士,14,77,953225,94.76754128
1446,劑,刀,16,77,953302,94.77519645
1447,擦,手,17,77,953379,94.78285162
1448,爆,火,19,77,953456,94.79050679
1449,鱷,魚,27,77,953533,94.79816196
1450,(污),水,06,76,953609,94.80571772
1451,抓,手,07,76,953685,94.81327347
1452,朗,月,10,76,953761,94.82082922
1453,脂,肉,10,76,953837,94.82838498
1454,啡,口,11,76,953913,94.83594073
1455,悉,心,11,76,953989,94.84349648
1456,掛,手,11,76,954065,94.85105224
1457,跡,足,13,76,954141,94.85860799
1458,儲,人,17,76,954217,94.86616375
1459,繳,糸,19,76,954293,94.87371950
1460,贈,貝,19,76,954369,94.88127525
1461,扣,手,06,75,954444,94.88873159
1462,妨,女,07,75,954519,94.89618792
1463,谷,谷,07,75,954594,94.90364426
1464,抵,手,08,75,954669,94.91110059
1465,姿,女,09,75,954744,94.91855693
1466,租,禾,10,75,954819,94.92601327
1467,彭,??,12,75,954894,94.93346960
1468,截,戈,14,75,954969,94.94092594
1469,臺,至,14,75,955044,94.94838227
1470,擎,手,17,75,955119,94.95583861
1471,占,卜,05,74,955193,94.96319553
1472,宋,??,07,74,955267,94.97055244
1473,忍,心,07,74,955341,94.97790936
1474,函,凵,08,74,955415,94.98526628
1475,咖,口,08,74,955489,94.99262320
1476,妻,女,08,74,955563,94.99998012
1477,姐,女,08,74,955637,95.00733703
1478,崇,山,11,74,955711,95.01469395
1479,殖,歹,12,74,955785,95.02205087
1480,菌,艸,12,74,955859,95.02940779
1481,壁,土,16,74,955933,95.03676471
1482,奮,大,16,74,956007,95.04412162
1483,默,黑,16,74,956081,95.05147854
1484,薪,艸,17,74,956155,95.05883546
1485,芳,艸,08,73,956228,95.06609296
1486,頁,頁,09,73,956301,95.07335046
1487,衰,衣,10,73,956374,95.08060796
1488,啊,口,11,73,956447,95.08786546
1489,插,手,12,73,956520,95.09512296
1490,寧,??,14,73,956593,95.10238046
1491,蜜,虫,14,73,956666,95.10963796
1492,嚇,口,17,73,956739,95.11689546
1493,牆,爿,17,73,956812,95.12415296
1494,邁,??,17,73,956885,95.13141046
1495,臘,肉,19,73,956958,95.13866796
1496,獻,犬,20,73,957031,95.14592546
1497,串,｜,07,72,957103,95.15308354
1498,狂,犬,07,72,957175,95.16024163
1499,弦,弓,08,72,957247,95.16739971
1500,昇,日,08,72,957319,95.17455779
1501,沿,水,08,72,957391,95.18171587
1502,采,釆,08,72,957463,95.18887395
1503,俄,人,09,72,957535,95.19603204
1504,唐,口,10,72,957607,95.20319012
1505,祖,示,10,72,957679,95.21034820
1506,莊,艸,11,72,957751,95.21750628
1507,陷,阜,11,72,957823,95.22466437
1508,棉,木,12,72,957895,95.23182245
1509,滋,水,12,72,957967,95.23898053
1510,嬰,女,17,72,958039,95.24613861
1511,薄,艸,17,72,958111,95.25329669
1512,瓦,瓦,05,71,958182,95.26035536
1513,邱,邑,08,71,958253,95.26741402
1514,紋,糸,10,71,958324,95.27447269
1515,啤,口,11,71,958395,95.28153135
1516,陪,阜,11,71,958466,95.28859002
1517,菲,艸,12,71,958537,95.29564868
1518,跨,足,13,71,958608,95.30270735
1519,潔,水,15,71,958679,95.30976601
1520,駛,馬,15,71,958750,95.31682467
1521,艘,舟,16,71,958821,95.32388334
1522,鵬,鳥,19,71,958892,95.33094200
1523,奈,大,08,70,958962,95.33790125
1524,氛,气,08,70,959032,95.34486050
1525,械,木,11,70,959102,95.35181974
1526,盜,皿,12,70,959172,95.35877899
1527,睡,目,14,70,959242,95.36573824
1528,貌,豸,14,70,959312,95.37269748
1529,鄭,邑,15,70,959382,95.37965673
1530,閱,門,15,70,959452,95.38661598
1531,灰,火,06,69,959521,95.39347581
1532,姆,女,08,69,959590,95.40033563
1533,返,??,08,69,959659,95.40719546
1534,炸,火,09,69,959728,95.41405529
1535,徑,彳,10,69,959797,95.42091512
1536,梅,木,11,69,959866,95.42777495
1537,瓶,瓦,11,69,959935,95.43463478
1538,郭,邑,11,69,960004,95.44149461
1539,暢,日,14,69,960073,95.44835444
1540,稿,禾,15,69,960142,95.45521427
1541,鍋,金,17,69,960211,95.46207409
1542,纖,糸,23,69,960280,95.46893392
1543,卵,??,07,68,960348,95.47569433
1544,胸,肉,10,68,960416,95.48245475
1545,匙,匕,11,68,960484,95.48921516
1546,虛,虍,12,68,960552,95.49597557
1547,撐,手,15,68,960620,95.50273598
1548,鬧,鬥,15,68,960688,95.50949639
1549,臟,肉,22,68,960756,95.51625680
1550,坪,土,08,67,960823,95.52291779
1551,漁,水,14,67,960890,95.52957879
1552,鳳,鳥,14,67,960957,95.53623978
1553,爐,火,20,67,961024,95.54290077
1554,匹,??,04,66,961090,95.54946235
1555,瓜,瓜,05,66,961156,95.55602392
1556,皇,白,09,66,961222,95.56258550
1557,恩,心,10,66,961288,95.56914707
1558,疲,??,10,66,961354,95.57570865
1559,貧,貝,11,66,961420,95.58227023
1560,葡,艸,13,66,961486,95.58883180
1561,熊,火,14,66,961552,95.59539338
1562,撞,手,15,66,961618,95.60195495
1563,遷,??,15,66,961684,95.60851653
1564,螢,虫,16,66,961750,95.61507810
1565,薩,艸,18,66,961816,95.62163968
1566,宅,??,06,65,961881,95.62810184
1567,烤,火,10,65,961946,95.63456399
1568,寄,??,11,65,962011,95.64102615
1569,販,貝,11,65,962076,95.64748831
1570,萄,艸,12,65,962141,95.65395047
1571,滅,水,13,65,962206,95.66041262
1572,煩,火,13,65,962271,95.66687478
1573,嘗,口,14,65,962336,95.67333694
1574,鼻,鼻,14,65,962401,95.67979910
1575,蓮,艸,15,65,962466,95.68626125
1576,墨,黑,15,65,962531,95.69272341
1577,龐,??,19,65,962596,95.69918557
1578,羊,羊,06,64,962660,95.70554831
1579,拔,手,08,64,962724,95.71191105
1580,柔,木,09,64,962788,95.71827379
1581,廉,??,13,64,962852,95.72463653
1582,銅,金,14,64,962916,95.73099927
1583,髮,髟,15,64,962980,95.73736201
1584,(薦),艸,17,64,963044,95.74372475
1585,雞,隹,18,64,963108,95.75008749
1586,驅,馬,21,64,963172,95.75645023
1587,赴,走,09,63,963235,95.76271355
1588,迴,??,10,63,963298,95.76897687
1589,聊,耳,11,63,963361,95.77524019
1590,窩,穴,14,63,963424,95.78150352
1591,謀,言,16,63,963487,95.78776684
1592,宇,??,06,62,963549,95.79393074
1593,眉,目,09,62,963611,95.80009465
1594,砂,石,09,62,963673,95.80625855
1595,堆,土,11,62,963735,95.81242245
1596,督,目,13,62,963797,95.81858636
1597,奪,大,14,62,963859,95.82475026
1598,廖,??,14,62,963921,95.83091417
1599,膀,肉,14,62,963983,95.83707807
1600,濕,水,17,62,964045,95.84324197
1601,蹤,足,18,62,964107,95.84940588
1602,騎,馬,18,62,964169,95.85556978
1603,甘,甘,05,61,964230,95.86163427
1604,尖,小,06,61,964291,95.86769876
1605,弄,廾,07,61,964352,95.87376324
1606,豆,豆,07,61,964413,95.87982773
1607,爬,爪,08,61,964474,95.88589222
1608,狗,犬,08,61,964535,95.89195670
1609,紡,糸,10,61,964596,95.89802119
1610,晨,日,11,61,964657,95.90408567
1611,粗,米,11,61,964718,95.91015016
1612,傾,人,13,61,964779,95.91621465
1613,黎,黍,15,61,964840,95.92227913
1614,橫,木,16,61,964901,95.92834362
1615,拖,手,08,60,964961,95.93430869
1616,峽,山,10,60,965021,95.94027376
1617,梨,木,11,60,965081,95.94623883
1618,猛,犬,11,60,965141,95.95220389
1619,貫,貝,11,60,965201,95.95816896
1620,椅,木,12,60,965261,95.96413403
1621,煮,火,12,60,965321,95.97009910
1622,痘,??,12,60,965381,95.97606417
1623,蛙,虫,12,60,965441,95.98202924
1624,溪,水,13,60,965501,95.98799431
1625,瑜,玉,13,60,965561,95.99395937
1626,碎,石,13,60,965621,95.99992444
1627,榜,木,14,60,965681,96.00588951
1628,辨,辛,16,60,965741,96.01185458
1629,辭,辛,19,60,965801,96.01781965
1630,卸,??,08,59,965860,96.02368530
1631,契,大,09,59,965919,96.02955095
1632,翁,羽,10,59,965978,96.03541660
1633,蘿,艸,23,59,966037,96.04128225
1634,址,土,07,58,966095,96.04704848
1635,閃,門,10,58,966153,96.05281472
1636,煙,火,13,58,966211,96.05858095
1637,葛,艸,13,58,966269,96.06434718
1638,鼠,鼠,13,58,966327,96.07011342
1639,磁,石,14,58,966385,96.07587965
1640,趙,走,14,58,966443,96.08164588
1641,撲,手,15,58,966501,96.08741211
1642,窮,穴,15,58,966559,96.09317835
1643,賠,貝,15,58,966617,96.09894458
1644,癌,??,17,58,966675,96.10471081
1645,繞,糸,18,58,966733,96.11047705
1646,鷹,鳥,24,58,966791,96.11624328
1647,妹,女,08,57,966848,96.12191009
1648,勁,力,09,57,966905,96.12757691
1649,孫,子,10,57,966962,96.13324372
1650,祕,示,10,57,967019,96.13891054
1651,淑,水,11,57,967076,96.14457736
1652,渡,水,12,57,967133,96.15024417
1653,鈔,金,12,57,967190,96.15591099
1654,搬,手,13,57,967247,96.16157780
1655,毀,殳,13,57,967304,96.16724462
1656,魅,鬼,15,57,967361,96.17291143
1657,噸,口,16,57,967418,96.17857825
1658,鑑,金,22,57,967475,96.18424506
1659,寸,寸,03,56,967531,96.18981246
1660,仙,人,05,56,967587,96.19537986
1661,胖,肉,09,56,967643,96.20094725
1662,掃,手,11,56,967699,96.20651465
1663,桿,木,11,56,967755,96.21208205
1664,堡,土,12,56,967811,96.21764944
1665,艇,舟,13,56,967867,96.22321684
1666,滾,水,14,56,967923,96.22878424
1667,慕,心,15,56,967979,96.23435164
1668,遲,??,16,56,968035,96.23991903
1669,川,??,03,55,968090,96.24538701
1670,壯,士,07,55,968145,96.25085499
1671,怒,心,09,55,968200,96.25632297
1672,洞,水,09,55,968255,96.26179095
1673,准,??,10,55,968310,96.26725893
1674,捐,手,10,55,968365,96.27272691
1675,氧,气,10,55,968420,96.27819489
1676,涼,水,11,55,968475,96.28366287
1677,莉,艸,11,55,968530,96.28913085
1678,縱,糸,17,55,968585,96.29459883
1679,曝,日,19,55,968640,96.30006681
1680,卅,十,04,54,968694,96.30543537
1681,朱,木,06,54,968748,96.31080393
1682,吹,口,07,54,968802,96.31617249
1683,扭,手,07,54,968856,96.32154106
1684,屏,尸,09,54,968910,96.32690962
1685,洪,水,09,54,968964,96.33227818
1686,祥,示,11,54,969018,96.33764674
1687,腿,肉,14,54,969072,96.34301530
1688,憑,心,16,54,969126,96.34838386
1689,躍,足,21,54,969180,96.35375243
1690,仲,人,06,53,969233,96.35902157
1691,災,火,07,53,969286,96.36429071
1692,刮,刀,08,53,969339,96.36955986
1693,孟,子,08,53,969392,96.37482900
1694,扁,戶,09,53,969445,96.38009815
1695,洽,水,09,53,969498,96.38536729
1696,娜,女,10,53,969551,96.39063643
1697,烏,火,10,53,969604,96.39590558
1698,脅,肉,10,53,969657,96.40117472
1699,宿,??,11,53,969710,96.40644386
1700,涵,水,11,53,969763,96.41171301
1701,堪,土,12,53,969816,96.41698215
1702,猶,犬,12,53,969869,96.42225130
1703,賀,貝,12,53,969922,96.42752044
1704,夥,夕,14,53,969975,96.43278958
1705,徹,彳,14,53,970028,96.43805873
1706,摸,手,14,53,970081,96.44332787
1707,嘴,口,16,53,970134,96.44859702
1708,誕,言,15,53,970187,96.45386616
1709,盧,皿,16,53,970240,96.45913530
1710,讚,言,26,53,970293,96.46440445
1711,沖,水,07,52,970345,96.46957417
1712,迅,??,07,52,970397,96.47474390
1713,幽,??,09,52,970449,96.47991363
1714,苗,艸,09,52,970501,96.48508335
1715,郎,邑,09,52,970553,96.49025308
1716,俱,人,10,52,970605,96.49542280
1717,粒,米,11,52,970657,96.50059253
1718,袖,衣,11,52,970709,96.50576226
1719,絨,糸,12,52,970761,96.51093198
1720,脹,肉,12,52,970813,96.51610171
1721,暖,日,13,52,970865,96.52127143
1722,輩,車,15,52,970917,96.52644116
1723,擠,手,17,52,970969,96.53161089
1724,耀,羽,20,52,971021,96.53678061
1725,蘋,艸,20,52,971073,96.54195034
1726,伍,人,06,51,971124,96.54702065
1727,夾,大,07,51,971175,96.55209096
1728,押,手,08,51,971226,96.55716126
1729,哲,口,10,51,971277,96.56223157
1730,砲,石,10,51,971328,96.56730188
1731,腎,肉,12,51,971379,96.57237219
1732,搜,手,13,51,971430,96.57744250
1733,睫,目,13,51,971481,96.58251281
1734,廚,??,15,51,971532,96.58758311
1735,鄧,邑,15,51,971583,96.59265342
1736,濾,水,18,51,971634,96.59772373
1737,霸,雨,21,51,971685,96.60279404
1738,仰,人,06,50,971735,96.60776493
1739,旭,日,06,50,971785,96.61273582
1740,昂,日,08,50,971835,96.61770671
1741,悅,心,11,50,971885,96.62267760
1742,紗,糸,10,50,971935,96.62764849
1743,梯,木,11,50,971985,96.63261938
1744,祭,示,11,50,972035,96.63759027
1745,惑,心,12,50,972085,96.64256116
1746,搞,手,13,50,972135,96.64753205
1747,腰,肉,13,50,972185,96.65250294
1748,慘,心,14,50,972235,96.65747383
1749,遞,??,14,50,972285,96.66244472
1750,劍,刀,15,50,972335,96.66741561
1751,磨,石,16,50,972385,96.67238650
1752,懼,心,21,50,972435,96.67735740
1753,(碁),石,13,50,972485,96.68232829
1754,孔,子,04,49,972534,96.68719976
1755,吐,口,06,49,972583,96.69207123
1756,伺,人,07,49,972632,96.69694270
1757,彷,彳,07,49,972681,96.70181418
1758,枝,木,08,49,972730,96.70668565
1759,垂,土,09,49,972779,96.71155712
1760,牽,牛,11,49,972828,96.71642859
1761,貪,貝,11,49,972877,96.72130007
1762,猴,犬,12,49,972926,96.72617154
1763,趁,走,12,49,972975,96.73104301
1764,鈣,金,12,49,973024,96.73591448
1765,緻,糸,15,49,973073,96.74078596
1766,蟲,虫,18,49,973122,96.74565743
1767,譬,言,20,49,973171,96.75052890
1768,孝,子,07,48,973219,96.75530096
1769,牧,牛,08,48,973267,96.76007301
1770,盆,皿,09,48,973315,96.76484507
1771,軌,車,09,48,973363,96.76961712
1772,祝,示,10,48,973411,96.77438918
1773,茵,艸,10,48,973459,96.77916123
1774,紫,糸,12,48,973507,96.78393329
1775,綁,糸,13,48,973555,96.78870534
1776,膏,肉,14,48,973603,96.79347740
1777,銘,金,14,48,973651,96.79824945
1778,燕,火,16,48,973699,96.80302151
1779,蹈,足,17,48,973747,96.80779356
1780,戒,戈,07,47,973794,96.81246620
1781,挫,手,10,47,973841,96.81713883
1782,疼,??,10,47,973888,96.82181147
1783,脆,肉,10,47,973935,96.82648411
1784,釣,金,11,47,973982,96.83115675
1785,割,刀,12,47,974029,96.83582938
1786,棟,木,12,47,974076,96.84050202
1787,註,言,12,47,974123,96.84517466
1788,腫,肉,13,47,974170,96.84984729
1789,遜,??,14,47,974217,96.85451993
1790,擋,手,16,47,974264,96.85919257
1791,雕,隹,16,47,974311,96.86386521
1792,戀,心,23,47,974358,96.86853784
1793,歹,歹,04,46,974404,96.87311106
1794,泛,水,08,46,974450,96.87768428
1795,肢,肉,08,46,974496,96.88225750
1796,捉,手,10,46,974542,96.88683072
1797,耗,耒,10,46,974588,96.89140394
1798,逆,??,10,46,974634,96.89597716
1799,淺,水,11,46,974680,96.90055038
1800,甜,甘,11,46,974726,96.90512360
1801,廊,??,12,46,974772,96.90969682
1802,逼,??,13,46,974818,96.91427003
1803,蔬,艸,15,46,974864,96.91884325
1804,瓊,玉,19,46,974910,96.92341647
1805,灘,水,22,46,974956,96.92798969
1806,寺,寸,06,45,975001,96.93246349
1807,汗,水,06,45,975046,96.93693730
1808,呂,口,07,45,975091,96.94141110
1809,怡,心,08,45,975136,96.94588490
1810,巷,己,09,45,975181,96.95035870
1811,敘,??,11,45,975226,96.95483250
1812,陶,阜,11,45,975271,96.95930630
1813,愉,心,12,45,975316,96.96378010
1814,慎,心,13,45,975361,96.96825391
1815,蒂,艸,13,45,975406,96.97272771
1816,塵,土,14,45,975451,96.97720151
1817,誘,言,14,45,975496,96.98167531
1818,雌,隹,14,45,975541,96.98614911
1819,糊,米,15,45,975586,96.99062291
1820,濱,水,17,45,975631,96.99509671
1821,叢,又,18,45,975676,96.99957052
1822,獸,犬,19,45,975721,97.00404432
1823,譜,言,19,45,975766,97.00851812
1824,籲,竹,32,45,975811,97.01299192
1825,奉,大,08,44,975855,97.01736630
1826,孤,子,08,44,975899,97.02174069
1827,拆,手,08,44,975943,97.02611507
1828,昌,日,08,44,975987,97.03048945
1829,泌,水,08,44,976031,97.03486384
1830,罩,网,13,44,976075,97.03923822
1831,漂,水,14,44,976119,97.04361260
1832,噴,口,15,44,976163,97.04798699
1833,慾,心,15,44,976207,97.05236137
1834,賢,貝,15,44,976251,97.05673576
1835,鋒,金,15,44,976295,97.06111014
1836,燃,火,16,44,976339,97.06548452
1837,膽,肉,17,44,976383,97.06985891
1838,欄,木,21,44,976427,97.07423329
1839,允,儿,04,43,976470,97.07850826
1840,仿,人,06,43,976513,97.08278322
1841,兆,儿,06,43,976556,97.08705819
1842,妝,女,07,43,976599,97.09133315
1843,沉,水,07,43,976642,97.09560812
1844,卓,十,08,43,976685,97.09988308
1845,彿,彳,08,43,976728,97.10415805
1846,旺,日,08,43,976771,97.10843302
1847,勃,力,09,43,976814,97.11270798
1848,珊,玉,09,43,976857,97.11698295
1849,棋,木,12,43,976900,97.12125791
1850,僑,人,14,43,976943,97.12553288
1851,罷,网,15,43,976986,97.12980785
1852,醉,酉,15,43,977029,97.13408281
1853,凝,??,16,43,977072,97.13835778
1854,膨,肉,16,43,977115,97.14263274
1855,鍾,金,17,43,977158,97.14690771
1856,獵,犬,18,43,977201,97.15118267
1857,攜,手,21,43,977244,97.15545764
1858,卷,??,08,42,977286,97.15963319
1859,拼,手,09,42,977328,97.16380874
1860,凌,??,10,42,977370,97.16798428
1861,郝,邑,10,42,977412,97.17215983
1862,疏,疋,11,42,977454,97.17633538
1863,椎,木,12,42,977496,97.18051093
1864,腔,肉,12,42,977538,97.18468648
1865,軸,車,12,42,977580,97.18886202
1866,蜂,虫,13,42,977622,97.19303757
1867,鉛,金,13,42,977664,97.19721312
1868,嘛,口,14,42,977706,97.20138867
1869,敲,??,14,42,977748,97.20556422
1870,僵,人,15,42,977790,97.20973976
1871,撥,手,15,42,977832,97.21391531
1872,褲,衣,16,42,977874,97.21809086
1873,勸,力,20,42,977916,97.22226641
1874,攤,手,22,42,977958,97.22644196
1875,朵,木,06,41,977999,97.23051809
1876,忌,心,07,41,978040,97.23459422
1877,阮,阜,07,41,978081,97.23867035
1878,坤,土,08,41,978122,97.24274648
1879,芬,艸,08,41,978163,97.24682261
1880,莎,艸,11,41,978204,97.25089874
1881,寒,??,12,41,978245,97.25497487
1882,棲,木,12,41,978286,97.25905100
1883,馳,馬,13,41,978327,97.26312713
1884,禍,示,14,41,978368,97.26720326
1885,廟,??,15,41,978409,97.27127939
1886,潑,水,15,41,978450,97.27535552
1887,聰,耳,17,41,978491,97.27943165
1888,韻,音,19,41,978532,97.28350778
1889,鬍,髟,19,41,978573,97.28758391
1890,譯,言,20,41,978614,97.29166004
1891,欠,欠,04,40,978654,97.29563675
1892,汁,水,05,40,978694,97.29961346
1893,旬,日,06,40,978734,97.30359018
1894,兌,儿,07,40,978774,97.30756689
1895,玻,玉,09,40,978814,97.31154360
1896,疫,??,09,40,978854,97.31552031
1897,茂,艸,09,40,978894,97.31949703
1898,剪,刀,11,40,978934,97.32347374
1899,錫,金,16,40,978974,97.32745045
1900,霜,雨,17,40,979014,97.33142716
1901,礦,石,20,40,979054,97.33540387
1902,轟,車,21,40,979094,97.33938059
1903,彎,弓,22,40,979134,97.34335730
1904,癮,??,22,40,979174,97.34733401
1905,襲,衣,22,40,979214,97.35131072
1906,乙,乙,01,39,979253,97.35518802
1907,勾,??,04,39,979292,97.35906531
1908,丟,一,06,39,979331,97.36294261
1909,呆,口,07,39,979370,97.36681990
1910,泳,水,08,39,979409,97.37069720
1911,耶,耳,09,39,979448,97.37457449
1912,埋,土,10,39,979487,97.37845179
1913,胱,肉,10,39,979526,97.38232908
1914,荒,艸,10,39,979565,97.38620638
1915,啦,口,11,39,979604,97.39008367
1916,欽,欠,12,39,979643,97.39396096
1917,煌,火,13,39,979682,97.39783826
1918,慰,心,15,39,979721,97.40171555
1919,璃,玉,15,39,979760,97.40559285
1920,黏,黍,17,39,979799,97.40947014
1921,糧,米,18,39,979838,97.41334744
1922,勻,??,04,38,979876,97.41712531
1923,妥,女,07,38,979914,97.42090319
1924,奔,大,08,38,979952,97.42468107
1925,柱,木,09,38,979990,97.42845894
1926,茄,艸,09,38,980028,97.43223682
1927,哭,口,10,38,980066,97.43601470
1928,宴,??,10,38,980104,97.43979257
1929,柴,木,10,38,980142,97.44357045
1930,淚,水,11,38,980180,97.44734833
1931,腸,肉,13,38,980218,97.45112620
1932,飽,食,13,38,980256,97.45490408
1933,鳴,鳥,14,38,980294,97.45868196
1934,厲,厂,15,38,980332,97.46245984
1935,蔔,艸,15,38,980370,97.46623771
1936,醇,酉,15,38,980408,97.47001559
1937,穎,禾,16,38,980446,97.47379347
1938,艱,艮,17,38,980484,97.47757134
1939,魏,鬼,18,38,980522,97.48134922
1940,襯,衣,22,38,980560,97.48512710
1941,髒,骨,23,38,980598,97.48890497
1942,鑰,金,25,38,980636,97.49268285
1943,丈,一,03,37,980673,97.49636131
1944,夕,夕,03,37,980710,97.50003977
1945,汙,水,06,37,980747,97.50371823
1946,佐,人,07,37,980784,97.50739669
1947,吻,口,07,37,980821,97.51107514
1948,抑,手,07,37,980858,97.51475360
1949,侯,人,09,37,980895,97.51843206
1950,恨,心,09,37,980932,97.52211052
1951,惟,心,11,37,980969,97.52578898
1952,梁,木,11,37,981006,97.52946744
1953,逢,??,11,37,981043,97.53314590
1954,喊,口,12,37,981080,97.53682436
1955,暑,日,12,37,981117,97.54050282
1956,裂,衣,12,37,981154,97.54418127
1957,塗,土,13,37,981191,97.54785973
1958,聘,耳,13,37,981228,97.55153819
1959,蔥,艸,15,37,981265,97.55521665
1960,曉,日,16,37,981302,97.55889511
1961,謹,言,18,37,981339,97.56257357
1962,籠,竹,22,37,981376,97.56625203
1963,饋,食,20,37,981413,97.56993049
1964,叭,口,05,36,981449,97.57350953
1965,伏,人,06,36,981485,97.57708857
1966,赤,赤,07,36,981521,97.58066761
1967,阪,阜,07,36,981557,97.58424665
1968,衍,行,09,36,981593,97.58782569
1969,巢,??,11,36,981629,97.59140473
1970,痕,??,11,36,981665,97.59498378
1971,豚,豕,11,36,981701,97.59856282
1972,喇,口,12,36,981737,97.60214186
1973,焚,火,12,36,981773,97.60572090
1974,筋,竹,12,36,981809,97.60929994
1975,罰,网,14,36,981845,97.61287898
1976,蓄,艸,14,36,981881,97.61645802
1977,酷,酉,14,36,981917,97.62003706
1978,蝦,虫,15,36,981953,97.62361610
1979,龜,龜,16,36,981989,97.62719515
1980,鴻,鳥,17,36,982025,97.63077419
1981,贊,貝,19,36,982061,97.63435323
1982,馨,香,20,36,982097,97.63793227
1983,譽,言,21,36,982133,97.64151131
1984,凸,凵,05,35,982168,97.64499093
1985,肩,肉,08,35,982203,97.64847056
1986,咳,口,09,35,982238,97.65195018
1987,津,水,09,35,982273,97.65542980
1988,范,艸,09,35,982308,97.65890943
1989,哦,口,10,35,982343,97.66238905
1990,浩,水,10,35,982378,97.66586867
1991,鬼,鬼,10,35,982413,97.66934830
1992,捲,手,11,35,982448,97.67282792
1993,廂,??,12,35,982483,97.67630754
1994,填,土,13,35,982518,97.67978717
1995,裸,衣,14,35,982553,97.68326679
1996,赫,赤,14,35,982588,97.68674641
1997,瘦,??,15,35,982623,97.69022604
1998,齒,齒,15,35,982658,97.69370566
1999,翼,羽,17,35,982693,97.69718528
2000,臂,肉,17,35,982728,97.70066491
2001,罐,缶,24,35,982763,97.70414453
2002,鬱,鬯,29,35,982798,97.70762415
2003,弗,弓,05,34,982832,97.71100436
2004,汰,水,07,34,982866,97.71438456
2005,肚,肉,07,34,982900,97.71776477
2006,姊,女,08,34,982934,97.72114498
2007,恰,心,09,34,982968,97.72452518
2008,恆,心,09,34,983002,97.72790539
2009,貢,貝,10,34,983036,97.73128559
2010,掩,手,11,34,983070,97.73466580
2011,喔,口,12,34,983104,97.73804600
2012,帽,巾,12,34,983138,97.74142621
2013,棚,木,12,34,983172,97.74480641
2014,琳,玉,12,34,983206,97.74818662
2015,稀,禾,12,34,983240,97.75156682
2016,逸,??,12,34,983274,97.75494703
2017,鼎,鼎,13,34,983308,97.75832724
2018,弊,廾,14,34,983342,97.76170744
2019,誼,言,15,34,983376,97.76508765
2020,罹,网,16,34,983410,97.76846785
2021,諧,言,16,34,983444,97.77184806
2022,燥,火,17,34,983478,97.77522826
2023,瞧,目,17,34,983512,97.77860847
2024,檯,木,18,34,983546,97.78198867
2025,鵝,鳥,18,34,983580,97.78536888
2026,仇,人,04,33,983613,97.78864967
2027,羽,羽,06,33,983646,97.79193046
2028,佩,人,08,33,983679,97.79521124
2029,姑,女,08,33,983712,97.79849203
2030,岩,山,08,33,983745,97.80177282
2031,杰,木,08,33,983778,97.80505361
2032,肺,肉,08,33,983811,97.80833439
2033,挖,手,09,33,983844,97.81161518
2034,娛,女,10,33,983877,97.81489597
2035,掀,手,11,33,983910,97.81817676
2036,頃,頁,11,33,983943,97.82145754
2037,晰,日,12,33,983976,97.82473833
2038,募,力,13,33,984009,97.82801912
2039,憤,心,15,33,984042,97.83129991
2040,潘,水,15,33,984075,97.83458070
2041,瘤,??,15,33,984108,97.83786148
2042,罵,网,15,33,984141,97.84114227
2043,濫,水,17,33,984174,97.84442306
2044,闊,門,17,33,984207,97.84770385
2045,懸,心,20,33,984240,97.85098463
2046,鑽,金,27,33,984273,97.85426542
2047,札,木,05,32,984305,97.85744679
2048,乖,??,08,32,984337,97.86062816
2049,抬,手,08,32,984369,97.86380953
2050,陌,阜,09,32,984401,97.86699090
2051,倚,人,10,32,984433,97.87017227
2052,唸,口,11,32,984465,97.87335364
2053,悠,心,11,32,984497,97.87653501
2054,涯,水,11,32,984529,97.87971638
2055,淘,水,11,32,984561,97.88289775
2056,烹,火,11,32,984593,97.88607912
2057,盒,皿,11,32,984625,97.88926049
2058,湧,水,12,32,984657,97.89244186
2059,慈,心,13,32,984689,97.89562323
2060,溢,水,13,32,984721,97.89880460
2061,睹,目,13,32,984753,97.90198597
2062,嘆,口,14,32,984785,97.90516734
2063,蒐,艸,14,32,984817,97.90834871
2064,餅,食,14,32,984849,97.91153008
2065,爵,爪,17,32,984881,97.91471145
2066,飄,風,20,32,984913,97.91789282
2067,騰,馬,20,32,984945,97.92107419
2068,灌,水,21,32,984977,97.92425556
2069,余,人,07,31,985008,97.92733751
2070,巫,工,07,31,985039,97.93041946
2071,帕,巾,08,31,985070,97.93350142
2072,芭,艸,08,31,985101,97.93658337
2073,勉,力,09,31,985132,97.93966532
2074,哀,口,09,31,985163,97.94274727
2075,拾,手,09,31,985194,97.94582922
2076,胃,肉,09,31,985225,97.94891118
2077,娘,女,10,31,985256,97.95199313
2078,浸,水,10,31,985287,97.95507508
2079,桶,木,11,31,985318,97.95815703
2080,喻,口,12,31,985349,97.96123898
2081,腕,肉,12,31,985380,97.96432094
2082,葬,艸,13,31,985411,97.96740289
2083,逾,??,13,31,985442,97.97048484
2084,漠,水,14,31,985473,97.97356679
2085,蒜,艸,14,31,985504,97.97664874
2086,遙,??,14,31,985535,97.97973070
2087,銳,金,15,31,985566,97.98281265
2088,醬,酉,18,31,985597,97.98589460
2089,驟,馬,24,31,985628,97.98897655
2090,吋,口,06,30,985658,97.99195909
2091,杉,木,07,30,985688,97.99494162
2092,沮,水,08,30,985718,97.99792416
2093,玲,玉,09,30,985748,98.00090669
2094,悟,心,10,30,985778,98.00388922
2095,桑,木,10,30,985808,98.00687176
2096,偽,人,11,30,985838,98.00985429
2097,聆,耳,11,30,985868,98.01283683
2098,喚,口,12,30,985898,98.01581936
2099,揭,手,12,30,985928,98.01880190
2100,肅,聿,12,30,985958,98.02178443
2101,殿,殳,13,30,985988,98.02476696
2102,誇,言,13,30,986018,98.02774950
2103,詮,言,13,30,986048,98.03073203
2104,賄,貝,13,30,986078,98.03371457
2105,頒,頁,13,30,986108,98.03669710
2106,漏,水,14,30,986138,98.03967964
2107,腐,肉,14,30,986168,98.04266217
2108,擅,手,16,30,986198,98.04564470
2109,諷,言,16,30,986228,98.04862724
2110,鎳,金,18,30,986258,98.05160977
2111,霧,雨,19,30,986288,98.05459231
2112,丸,??,03,29,986317,98.05747542
2113,斥,斤,05,29,986346,98.06035854
2114,沾,水,08,29,986375,98.06324166
2115,肪,肉,08,29,986404,98.06612477
2116,咬,口,09,29,986433,98.06900789
2117,娃,女,09,29,986462,98.07189101
2118,姻,女,09,29,986491,98.07477412
2119,屍,尸,09,29,986520,98.07765724
2120,脊,肉,10,29,986549,98.08054036
2121,傘,人,12,29,986578,98.08342347
2122,惱,心,12,29,986607,98.08630659
2123,揆,手,12,29,986636,98.08918971
2124,甦,生,12,29,986665,98.09207282
2125,碑,石,13,29,986694,98.09495594
2126,嫩,女,14,29,986723,98.09783905
2127,撤,手,14,29,986752,98.10072217
2128,碧,石,14,29,986781,98.10360529
2129,粹,米,14,29,986810,98.10648840
2130,綿,糸,14,29,986839,98.10937152
2131,撒,手,15,29,986868,98.11225464
2132,緝,糸,15,29,986897,98.11513775
2133,壢,土,19,29,986926,98.11802087
2134,櫻,木,21,29,986955,98.12090399
2135,囊,口,22,29,986984,98.12378710
2136,邏,??,23,29,987013,98.12667022
2137,后,口,06,28,987041,98.12945392
2138,亨,??,07,28,987069,98.13223762
2139,呀,口,07,28,987097,98.13502132
2140,廷,??,07,28,987125,98.13780501
2141,征,彳,08,28,987153,98.14058871
2142,怖,心,08,28,987181,98.14337241
2143,剎,刀,09,28,987209,98.14615611
2144,祈,示,09,28,987237,98.14893981
2145,貞,貝,09,28,987265,98.15172351
2146,埔,土,10,28,987293,98.15450721
2147,埃,土,10,28,987321,98.15729090
2148,挺,手,10,28,987349,98.16007460
2149,衷,衣,10,28,987377,98.16285830
2150,寂,??,11,28,987405,98.16564200
2151,爽,爻,11,28,987433,98.16842570
2152,煥,火,13,28,987461,98.17120940
2153,瑚,玉,13,28,987489,98.17399310
2154,墓,土,14,28,987517,98.17677680
2155,滯,水,14,28,987545,98.17956049
2156,蒸,艸,14,28,987573,98.18234419
2157,翰,羽,16,28,987601,98.18512789
2158,諮,言,16,28,987629,98.18791159
2159,矯,矢,17,28,987657,98.19069529
2160,瀏,水,18,28,987685,98.19347899
2161,纜,糸,27,28,987713,98.19626269
2162,酯,酉,13,28,987741,98.19904638
2163,劫,力,07,27,987768,98.20173067
2164,坎,土,07,27,987795,98.20441495
2165,妮,女,08,27,987822,98.20709923
2166,削,刀,09,27,987849,98.20978351
2167,倉,人,10,27,987876,98.21246779
2168,扇,戶,10,27,987903,98.21515207
2169,眠,目,10,27,987930,98.21783635
2170,捨,手,11,27,987957,98.22052063
2171,淋,水,11,27,987984,98.22320491
2172,傲,人,13,27,988011,98.22588919
2173,腺,肉,13,27,988038,98.22857347
2174,滴,水,14,27,988065,98.23125775
2175,漆,水,14,27,988092,98.23394204
2176,魂,鬼,14,27,988119,98.23662632
2177,熬,火,15,27,988146,98.23931060
2178,賦,貝,15,27,988173,98.24199488
2179,鋁,金,15,27,988200,98.24467916
2180,撼,手,16,27,988227,98.24736344
2181,薰,艸,18,27,988254,98.25004772
2182,藤,艸,19,27,988281,98.25273200
2183,辯,辛,21,27,988308,98.25541628
2184,蠻,虫,25,27,988335,98.25810056
2185,兇,儿,06,26,988361,98.26068543
2186,旨,日,06,26,988387,98.26327029
2187,玫,玉,08,26,988413,98.26585515
2188,糾,糸,08,26,988439,98.26844002
2189,舍,舌,08,26,988465,98.27102488
2190,盾,目,09,26,988491,98.27360974
2191,郊,邑,09,26,988517,98.27619460
2192,栗,木,10,26,988543,98.27877947
2193,耕,耒,10,26,988569,98.28136433
2194,崎,山,11,26,988595,98.28394919
2195,傅,人,12,26,988621,98.28653406
2196,敞,??,12,26,988647,98.28911892
2197,渴,水,12,26,988673,98.29170378
2198,翔,羽,12,26,988699,98.29428865
2199,萎,艸,12,26,988725,98.29687351
2200,躲,身,13,26,988751,98.29945837
2201,鉅,金,13,26,988777,98.30204323
2202,獄,犬,14,26,988803,98.30462810
2203,瑰,玉,14,26,988829,98.30721296
2204,銜,金,14,26,988855,98.30979782
2205,敷,??,15,26,988881,98.31238269
2206,澎,水,15,26,988907,98.31496755
2207,踐,足,15,26,988933,98.31755241
2208,墾,土,16,26,988959,98.32013728
2209,橡,木,16,26,988985,98.32272214
2210,彌,弓,17,26,989011,98.32530700
2211,轄,車,17,26,989037,98.32789187
2212,蹟,足,18,26,989063,98.33047673
2213,攀,手,19,26,989089,98.33306159
2214,轎,車,19,26,989115,98.33564645
2215,顛,頁,19,26,989141,98.33823132
2216,灑,水,22,26,989167,98.34081618
2217,菇,艸,12,26,989193,98.34340104
2218,臣,臣,06,25,989218,98.34588649
2219,屈,尸,08,25,989243,98.34837193
2220,岡,山,08,25,989268,98.35085738
2221,拚,手,08,25,989293,98.35334282
2222,盲,目,08,25,989318,98.35582827
2223,帥,巾,09,25,989343,98.35831371
2224,缸,缶,09,25,989368,98.36079916
2225,茅,艸,09,25,989393,98.36328461
2226,衫,衣,09,25,989418,98.36577005
2227,郁,邑,09,25,989443,98.36825550
2228,梭,木,11,25,989468,98.37074094
2229,逝,??,11,25,989493,98.37322639
2230,逛,??,11,25,989518,98.37571183
2231,陵,阜,11,25,989543,98.37819728
2232,窟,穴,13,25,989568,98.38068272
2233,鈴,金,13,25,989593,98.38316817
2234,瘋,??,14,25,989618,98.38565361
2235,箭,竹,15,25,989643,98.38813906
2236,羯,羊,15,25,989668,98.39062450
2237,躺,身,15,25,989693,98.39310995
2238,糟,米,17,25,989718,98.39559539
2239,黛,黑,17,25,989743,98.39808084
2240,瀕,水,19,25,989768,98.40056628
2241,爛,火,21,25,989793,98.40305173
2242,(曬),日,23,25,989818,98.40553717
2243,竊,穴,23,25,989843,98.40802262
2244,攬,手,24,25,989868,98.41050806
2245,斗,斗,04,24,989892,98.41289409
2246,劣,力,06,24,989916,98.41528012
2247,舌,舌,06,24,989940,98.41766615
2248,吵,口,07,24,989964,98.42005217
2249,沐,水,07,24,989988,98.42243820
2250,肖,肉,07,24,990012,98.42482423
2251,叔,又,08,24,990036,98.42721026
2252,宙,??,08,24,990060,98.42959628
2253,卿,??,10,24,990084,98.43198231
2254,恭,心,10,24,990108,98.43436834
2255,拳,手,10,24,990132,98.43675437
2256,戚,戈,11,24,990156,98.43914039
2257,斜,斗,11,24,990180,98.44152642
2258,訝,言,11,24,990204,98.44391245
2259,寓,??,12,24,990228,98.44629848
2260,雇,隹,12,24,990252,98.44868450
2261,煉,火,13,24,990276,98.45107053
2262,碗,石,13,24,990300,98.45345656
2263,撫,手,15,24,990324,98.45584259
2264,潰,水,15,24,990348,98.45822861
2265,蔣,艸,15,24,990372,98.46061464
2266,蓬,艸,15,24,990396,98.46300067
2267,憾,心,16,24,990420,98.46538670
2268,艙,舟,16,24,990444,98.46777272
2269,蕩,艸,16,24,990468,98.47015875
2270,遵,??,16,24,990492,98.47254478
2271,縫,糸,17,24,990516,98.47493081
2272,蕾,艸,17,24,990540,98.47731683
2273,謎,言,17,24,990564,98.47970286
2274,繫,糸,19,24,990588,98.48208889
2275,疊,田,22,24,990612,98.48447491
2276,鑄,金,22,24,990636,98.48686094
2277,釀,酉,24,24,990660,98.48924697
2278,牢,牛,07,23,990683,98.49153358
2279,迄,??,07,23,990706,98.49382019
2280,昔,日,08,23,990729,98.49610680
2281,歧,止,08,23,990752,98.49839341
2282,姚,女,09,23,990775,98.50068002
2283,牲,牛,09,23,990798,98.50296663
2284,盼,目,09,23,990821,98.50525324
2285,倘,人,10,23,990844,98.50753985
2286,剖,刀,10,23,990867,98.50982646
2287,窄,穴,10,23,990890,98.51211307
2288,崩,山,11,23,990913,98.51439968
2289,崗,山,11,23,990936,98.51668629
2290,貶,貝,12,23,990959,98.51897289
2291,鈕,金,12,23,990982,98.52125950
2292,慌,心,13,23,991005,98.52354611
2293,爺,父,13,23,991028,98.52583272
2294,羨,羊,13,23,991051,98.52811933
2295,寡,??,14,23,991074,98.53040594
2296,寮,??,15,23,991097,98.53269255
2297,撕,手,15,23,991120,98.53497916
2298,(樑),木,15,23,991143,98.53726577
2299,澄,水,15,23,991166,98.53955238
2300,遮,??,15,23,991189,98.54183899
2301,曆,日,16,23,991212,98.54412560
2302,嚐,口,17,23,991235,98.54641221
2303,瞬,目,17,23,991258,98.54869882
2304,疆,田,19,23,991281,98.55098543
2305,藩,艸,19,23,991304,98.55327204
2306,齣,齒,20,23,991327,98.55555865
2307,纏,糸,21,23,991350,98.55784526
2308,闢,門,21,23,991373,98.56013187
2309,矚,目,26,23,991396,98.56241848
2310,勿,??,04,22,991418,98.56460567
2311,奴,女,05,22,991440,98.56679286
2312,刪,刀,07,22,991462,98.56898005
2313,吞,口,07,22,991484,98.57116724
2314,抄,手,07,22,991506,98.57335444
2315,扶,手,07,22,991528,98.57554163
2316,昏,日,08,22,991550,98.57772882
2317,咪,口,09,22,991572,98.57991601
2318,炭,火,09,22,991594,98.58210320
2319,倆,人,10,22,991616,98.58429040
2320,剝,刀,10,22,991638,98.58647759
2321,悄,心,10,22,991660,98.58866478
2322,秩,禾,10,22,991682,98.59085197
2323,臭,自,10,22,991704,98.59303916
2324,笛,竹,11,22,991726,98.59522635
2325,脾,肉,12,22,991748,98.59741355
2326,愁,心,13,22,991770,98.59960074
2327,腮,肉,13,22,991792,98.60178793
2328,虞,虍,13,22,991814,98.60397512
2329,遂,??,13,22,991836,98.60616231
2330,厭,厂,14,22,991858,98.60834951
2331,翠,羽,14,22,991880,98.61053670
2332,颱,風,14,22,991902,98.61272389
2333,履,尸,15,22,991924,98.61491108
2334,撰,手,15,22,991946,98.61709827
2335,潭,水,15,22,991968,98.61928546
2336,磚,石,16,22,991990,98.62147266
2337,錦,金,16,22,992012,98.62365985
2338,鴕,鳥,16,22,992034,98.62584704
2339,磯,石,17,22,992056,98.62803423
2340,蟻,虫,19,22,992078,98.63022142
2341,騷,馬,20,22,992100,98.63240862
2342,鬚,髟,22,22,992122,98.63459581
2343,戈,戈,04,21,992143,98.63668358
2344,丘,一,05,21,992164,98.63877135
2345,弘,弓,05,21,992185,98.64085913
2346,灸,火,07,21,992206,98.64294690
2347,拌,手,08,21,992227,98.64503468
2348,抹,手,08,21,992248,98.64712245
2349,疝,??,08,21,992269,98.64921022
2350,叛,又,09,21,992290,98.65129800
2351,狠,犬,09,21,992311,98.65338577
2352,哩,口,10,21,992332,98.65547355
2353,悔,心,10,21,992353,98.65756132
2354,晉,日,10,21,992374,98.65964909
2355,框,木,10,21,992395,98.66173687
2356,烙,火,10,21,992416,98.66382464
2357,捧,手,11,21,992437,98.66591242
2358,欺,欠,12,21,992458,98.66800019
2359,菁,艸,12,21,992479,98.67008796
2360,塢,土,13,21,992500,98.67217574
2361,煞,火,13,21,992521,98.67426351
2362,肆,聿,13,21,992542,98.67635129
2363,詹,言,13,21,992563,98.67843906
2364,槓,木,14,21,992584,98.68052683
2365,碳,石,14,21,992605,98.68261461
2366,遣,??,14,21,992626,98.68470238
2367,墜,土,15,21,992647,98.68679016
2368,毅,殳,15,21,992668,98.68887793
2369,締,糸,15,21,992689,98.69096570
2370,噪,口,16,21,992710,98.69305348
2371,樸,木,16,21,992731,98.69514125
2372,骸,骨,16,21,992752,98.69722903
2373,燦,火,17,21,992773,98.69931680
2374,騙,馬,19,21,992794,98.70140457
2375,犧,牛,20,21,992815,98.70349235
2376,蔘,艸,15,21,992836,98.70558012
2377,魽,魚,16,21,992857,98.70766790
2378,伙,人,06,20,992877,98.70965625
2379,舟,舟,06,20,992897,98.71164461
2380,尬,尢,07,20,992917,98.71363297
2381,芝,艸,08,20,992937,98.71562132
2382,芽,艸,08,20,992957,98.71760968
2383,俯,人,10,20,992977,98.71959803
2384,娟,女,10,20,992997,98.72158639
2385,宰,??,10,20,993017,98.72357475
2386,挾,手,10,20,993037,98.72556310
2387,挽,手,10,20,993057,98.72755146
2388,栽,木,10,20,993077,98.72953981
2389,桐,木,10,20,993097,98.73152817
2390,殷,殳,10,20,993117,98.73351653
2391,笨,竹,11,20,993137,98.73550488
2392,蛇,虫,11,20,993157,98.73749324
2393,壺,士,12,20,993177,98.73948160
2394,棕,木,12,20,993197,98.74146995
2395,逮,??,12,20,993217,98.74345831
2396,媳,女,13,20,993237,98.74544666
2397,瑕,玉,13,20,993257,98.74743502
2398,嗽,口,14,20,993277,98.74942338
2399,髦,髟,14,20,993297,98.75141173
2400,稽,禾,15,20,993317,98.75340009
2401,窺,穴,16,20,993337,98.75538845
2402,尷,尢,17,20,993357,98.75737680
2403,竄,穴,18,20,993377,98.75936516
2404,贖,貝,22,20,993397,98.76135351
2405,井,二,04,19,993416,98.76324245
2406,玄,玄,05,19,993435,98.76513139
2407,矛,矛,05,19,993454,98.76702033
2408,吊,口,06,19,993473,98.76890927
2409,夷,大,06,19,993492,98.77079821
2410,沛,水,07,19,993511,98.77268714
2411,芒,艸,07,19,993530,98.77457608
2412,虐,虍,09,19,993549,98.77646502
2413,凍,??,10,19,993568,98.77835396
2414,梳,木,10,19,993587,98.78024290
2415,狼,犬,10,19,993606,98.78213184
2416,矩,矢,10,19,993625,98.78402077
2417,秤,禾,10,19,993644,98.78590971
2418,辱,辰,10,19,993663,98.78779865
2419,庸,??,11,19,993682,98.78968759
2420,彬,??,11,19,993701,98.79157653
2421,覓,見,11,19,993720,98.79346547
2422,奠,大,12,19,993739,98.79535440
2423,慨,心,12,19,993758,98.79724334
2424,椒,木,12,19,993777,98.79913228
2425,毯,毛,12,19,993796,98.80102122
2426,渥,水,12,19,993815,98.80291016
2427,渾,水,12,19,993834,98.80479910
2428,韌,韋,12,19,993853,98.80668803
2429,廈,??,13,19,993872,98.80857697
2430,嘲,口,15,19,993891,98.81046591
2431,趟,走,15,19,993910,98.81235485
2432,踩,足,15,19,993929,98.81424379
2433,鋪,金,15,19,993948,98.81613273
2434,糕,米,16,19,993967,98.81802167
2435,錶,金,16,19,993986,98.81991060
2436,霍,雨,16,19,994005,98.82179954
2437,澀,水,17,19,994024,98.82368848
2438,餵,食,17,19,994043,98.82557742
2439,軀,身,18,19,994062,98.82746636
2440,禱,示,19,19,994081,98.82935530
2441,攔,手,20,19,994100,98.83124423
2442,豔,豆,28,19,994119,98.83313317
2443,丙,一,05,18,994137,98.83492269
2444,扳,手,07,18,994155,98.83671221
2445,汪,水,07,18,994173,98.83850173
2446,狄,犬,07,18,994191,98.84029125
2447,矣,矢,07,18,994209,98.84208077
2448,咒,口,08,18,994227,98.84387030
2449,恤,心,09,18,994245,98.84565982
2450,洩,水,09,18,994263,98.84744934
2451,盃,皿,09,18,994281,98.84923886
2452,陋,阜,09,18,994299,98.85102838
2453,挪,手,10,18,994317,98.85281790
2454,虔,虍,10,18,994335,98.85460742
2455,逗,??,11,18,994353,98.85639694
2456,殼,殳,12,18,994371,98.85818646
2457,湊,水,12,18,994389,98.85997598
2458,辜,辛,12,18,994407,98.86176550
2459,暉,日,13,18,994425,98.86355502
2460,楓,木,13,18,994443,98.86534454
2461,歇,欠,13,18,994461,98.86713406
2462,寞,??,14,18,994479,98.86892358
2463,碩,石,14,18,994497,98.87071310
2464,辣,辛,14,18,994515,98.87250262
2465,儂,人,15,18,994533,98.87429215
2466,皺,皮,15,18,994551,98.87608167
2467,澡,水,16,18,994569,98.87787119
2468,膩,肉,16,18,994587,98.87966071
2469,螺,虫,17,18,994605,98.88145023
2470,瀆,水,18,18,994623,98.88323975
2471,癒,??,18,18,994641,98.88502927
2472,懶,心,19,18,994659,98.88681879
2473,譚,言,19,18,994677,98.88860831
2474,蹲,足,19,18,994695,98.89039783
2475,蠟,虫,21,18,994713,98.89218735
2476,(艷),色,24,18,994731,98.89397687
2477,尹,??,04,17,994748,98.89566697
2478,屁,尸,07,17,994765,98.89735708
2479,牡,牛,07,17,994782,98.89904718
2480,罕,网,07,17,994799,98.90073728
2481,呵,口,08,17,994816,98.90242739
2482,昆,日,08,17,994833,98.90411749
2483,秉,禾,08,17,994850,98.90580759
2484,臥,臣,08,17,994867,98.90749769
2485,俠,人,09,17,994884,98.90918780
2486,峻,山,10,17,994901,98.91087790
2487,桂,木,10,17,994918,98.91256800
2488,狹,犬,10,17,994935,98.91425810
2489,豹,豸,10,17,994952,98.91594821
2490,盔,皿,11,17,994969,98.91763831
2491,羞,羊,11,17,994986,98.91932841
2492,脖,肉,11,17,995003,98.92101852
2493,堤,土,12,17,995020,98.92270862
2494,婷,女,12,17,995037,98.92439872
2495,筒,竹,12,17,995054,98.92608882
2496,詐,言,12,17,995071,98.92777893
2497,溯,水,13,17,995088,98.92946903
2498,碌,石,13,17,995105,98.93115913
2499,鉤,金,13,17,995122,98.93284923
2500,墊,土,14,17,995139,98.93453934
2501,廓,??,14,17,995156,98.93622944
2502,暨,日,14,17,995173,98.93791954
2503,瑣,玉,14,17,995190,98.93960965
2504,綱,糸,14,17,995207,98.94129975
2505,蒼,艸,14,17,995224,98.94298985
2506,酵,酉,14,17,995241,98.94467995
2507,槽,木,15,17,995258,98.94637006
2508,稻,禾,15,17,995275,98.94806016
2509,魄,鬼,15,17,995292,98.94975026
2510,(勳),力,16,17,995309,98.95144037
2511,橙,木,16,17,995326,98.95313047
2512,禦,示,16,17,995343,98.95482057
2513,貓,豸,16,17,995360,98.95651067
2514,盪,皿,17,17,995377,98.95820078
2515,聳,耳,17,17,995394,98.95989088
2516,鍊,金,17,17,995411,98.96158098
2517,(癡),??,19,17,995428,98.96327108
2518,襪,衣,21,17,995445,98.96496119
2519,潢,水,15,17,995462,98.96665129
2520,飆,風,21,17,995479,98.96834139
2521,凶,凵,04,16,995495,98.96993208
2522,凹,凵,05,16,995511,98.97152276
2523,穴,穴,05,16,995527,98.97311345
2524,帆,巾,06,16,995543,98.97470413
2525,汐,水,06,16,995559,98.97629482
2526,坊,土,07,16,995575,98.97788550
2527,抒,手,07,16,995591,98.97947619
2528,甫,用,07,16,995607,98.98106687
2529,邪,邑,07,16,995623,98.98265756
2530,拋,手,08,16,995639,98.98424824
2531,恬,心,09,16,995655,98.98583893
2532,昭,日,09,16,995671,98.98742961
2533,枯,木,09,16,995687,98.98902030
2534,柵,木,09,16,995703,98.99061098
2535,炫,火,09,16,995719,98.99220167
2536,倦,人,10,16,995735,98.99379235
2537,畔,田,10,16,995751,98.99538304
2538,崑,山,11,16,995767,98.99697372
2539,訣,言,11,16,995783,98.99856441
2540,逕,??,11,16,995799,99.00015509
2541,雀,隹,11,16,995815,99.00174578
2542,傍,人,12,16,995831,99.00333646
2543,廁,??,12,16,995847,99.00492715
2544,焜,火,12,16,995863,99.00651783
2545,菸,艸,12,16,995879,99.00810852
2546,萍,艸,12,16,995895,99.00969920
2547,嫁,女,13,16,995911,99.01128989
2548,溶,水,13,16,995927,99.01288057
2549,禽,禸,13,16,995943,99.01447126
2550,誓,言,14,16,995959,99.01606194
2551,輒,車,14,16,995975,99.01765263
2552,穀,禾,15,16,995991,99.01924331
2553,膝,肉,15,16,996007,99.02083400
2554,諒,言,15,16,996023,99.02242468
2555,踢,足,15,16,996039,99.02401537
2556,撿,手,16,16,996055,99.02560605
2557,豫,豕,16,16,996071,99.02719674
2558,靡,非,19,16,996087,99.02878742
2559,囉,口,22,16,996103,99.03037811
2560,胺,肉,10,16,996119,99.03196879
2561,茜,艸,10,16,996135,99.03355948
2562,巾,巾,03,15,996150,99.03505074
2563,屯,屮,04,15,996165,99.03654201
2564,吟,口,07,15,996180,99.03803328
2565,抖,手,07,15,996195,99.03952454
2566,扯,手,07,15,996210,99.04101581
2567,披,手,08,15,996225,99.04250708
2568,枚,木,08,15,996240,99.04399835
2569,侶,人,09,15,996255,99.04548961
2570,侷,人,09,15,996270,99.04698088
2571,姜,女,09,15,996285,99.04847215
2572,疹,??,10,15,996300,99.04996341
2573,釘,金,10,15,996315,99.05145468
2574,堵,土,11,15,996330,99.05294595
2575,御,彳,11,15,996345,99.05443722
2576,瓷,瓦,11,15,996360,99.05592848
2577,証,言,12,15,996375,99.05741975
2578,惹,心,13,15,996390,99.05891102
2579,溺,水,13,15,996405,99.06040228
2580,瑟,玉,13,15,996420,99.06189355
2581,酪,酉,13,15,996435,99.06338482
2582,滲,水,14,15,996450,99.06487609
2583,蝕,虫,14,15,996465,99.06636735
2584,閥,門,14,15,996480,99.06785862
2585,魁,鬼,14,15,996495,99.06934989
2586,褪,衣,16,15,996510,99.07084115
2587,鴨,鳥,16,15,996525,99.07233242
2588,謠,言,17,15,996540,99.07382369
2589,闖,門,18,15,996555,99.07531496
2590,躁,足,20,15,996570,99.07680622
2591,闡,門,20,15,996585,99.07829749
2592,鹹,鹵,20,15,996600,99.07978876
2593,驕,馬,22,15,996615,99.08128002
2594,髓,骨,23,15,996630,99.08277129
2595,舖,舌,15,15,996645,99.08426256
2596,划,刀,06,14,996659,99.08565441
2597,卑,十,08,14,996673,99.08704626
2598,岳,山,08,14,996687,99.08843811
2599,抨,手,08,14,996701,99.08982996
2600,拙,手,08,14,996715,99.09122181
2601,拘,手,08,14,996729,99.09261365
2602,胚,肉,09,14,996743,99.09400550
2603,迦,??,09,14,996757,99.09539735
2604,剔,刀,10,14,996771,99.09678920
2605,恥,心,10,14,996785,99.09818105
2606,浦,水,10,14,996799,99.09957290
2607,酌,酉,10,14,996813,99.10096475
2608,勘,力,11,14,996827,99.10235660
2609,尉,寸,11,14,996841,99.10374845
2610,掙,手,11,14,996855,99.10514030
2611,喘,口,12,14,996869,99.10653215
2612,喉,口,12,14,996883,99.10792400
2613,悶,心,12,14,996897,99.10931585
2614,晴,日,12,14,996911,99.11070770
2615,棺,木,12,14,996925,99.11209955
2616,棵,木,12,14,996939,99.11349139
2617,琪,玉,12,14,996953,99.11488324
2618,催,人,13,14,996967,99.11627509
2619,嗜,口,13,14,996981,99.11766694
2620,溜,水,13,14,996995,99.11905879
2621,稚,禾,13,14,997009,99.12045064
2622,兢,儿,14,14,997023,99.12184249
2623,嘔,口,14,14,997037,99.12323434
2624,熔,火,14,14,997051,99.12462619
2625,裴,衣,14,14,997065,99.12601804
2626,誦,言,14,14,997079,99.12740989
2627,樞,木,15,14,997093,99.12880174
2628,緘,糸,15,14,997107,99.13019359
2629,賜,貝,15,14,997121,99.13158544
2630,醋,酉,15,14,997135,99.13297729
2631,燙,火,16,14,997149,99.13436913
2632,霖,雨,16,14,997163,99.13576098
2633,餚,食,16,14,997177,99.13715283
2634,禪,示,17,14,997191,99.13854468
2635,糙,米,17,14,997205,99.13993653
2636,薑,艸,17,14,997219,99.14132838
2637,隸,??,17,14,997233,99.14272023
2638,簿,竹,19,14,997247,99.14411208
2639,蠅,虫,19,14,997261,99.14550393
2640,譏,言,19,14,997275,99.14689578
2641,伐,人,06,13,997288,99.14818821
2642,伽,人,07,13,997301,99.14948064
2643,吾,口,07,13,997314,99.15077307
2644,坑,土,07,13,997327,99.15206550
2645,姒,女,08,13,997340,99.15335794
2646,俏,人,09,13,997353,99.15465037
2647,彥,??,09,13,997366,99.15594280
2648,炳,火,09,13,997379,99.15723523
2649,畏,田,09,13,997392,99.15852766
2650,祇,示,09,13,997405,99.15982009
2651,倡,人,10,13,997418,99.16111253
2652,匪,匚,10,13,997431,99.16240496
2653,蚊,虫,10,13,997444,99.16369739
2654,豈,豆,10,13,997457,99.16498982
2655,婉,女,11,13,997470,99.16628225
2656,彗,??,11,13,997483,99.16757468
2657,掘,手,11,13,997496,99.16886711
2658,淹,水,11,13,997509,99.17015955
2659,淵,水,11,13,997522,99.17145198
2660,婿,女,12,13,997535,99.17274441
2661,傻,人,13,13,997548,99.17403684
2662,暈,日,13,13,997561,99.17532927
2663,煎,火,13,13,997574,99.17662170
2664,矮,矢,13,13,997587,99.17791413
2665,祿,示,13,13,997600,99.17920657
2666,摔,手,14,13,997613,99.18049900
2667,竭,立,14,13,997626,99.18179143
2668,駁,馬,14,13,997639,99.18308386
2669,幢,巾,15,13,997652,99.18437629
2670,撈,手,15,13,997665,99.18566872
2671,瑩,玉,15,13,997678,99.18696116
2672,蔓,艸,15,13,997691,99.18825359
2673,噶,口,16,13,997704,99.18954602
2674,橘,木,16,13,997717,99.19083845
2675,篩,竹,16,13,997730,99.19213088
2676,磷,石,17,13,997743,99.19342331
2677,薇,艸,17,13,997756,99.19471574
2678,醜,酉,17,13,997769,99.19600818
2679,翹,羽,18,13,997782,99.19730061
2680,臍,肉,18,13,997795,99.19859304
2681,贅,貝,18,13,997808,99.19988547
2682,繩,糸,19,13,997821,99.20117790
2683,蟾,虫,19,13,997834,99.20247033
2684,鏈,金,19,13,997847,99.20376277
2685,蘊,艸,20,13,997860,99.20505520
2686,鈺,金,13,13,997873,99.20634763
2687,兮,八,04,12,997885,99.20754064
2688,仗,人,05,12,997897,99.20873366
2689,匆,??,05,12,997909,99.20992667
2690,牟,牛,06,12,997921,99.21111968
2691,呎,口,07,12,997933,99.21231270
2692,攸,??,07,12,997945,99.21350571
2693,阱,阜,07,12,997957,99.21469872
2694,宛,??,08,12,997969,99.21589174
2695,枕,木,08,12,997981,99.21708475
2696,炙,火,08,12,997993,99.21827777
2697,陀,阜,08,12,998005,99.21947078
2698,炮,火,09,12,998017,99.22066379
2699,捏,手,10,12,998029,99.22185681
2700,偕,人,11,12,998041,99.22304982
2701,淇,水,11,12,998053,99.22424283
2702,眷,目,11,12,998065,99.22543585
2703,笠,竹,11,12,998077,99.22662886
2704,紮,糸,11,12,998089,99.22782188
2705,莖,艸,11,12,998101,99.22901489
2706,渦,水,12,12,998113,99.23020790
2707,愚,心,13,12,998125,99.23140092
2708,椰,木,13,12,998137,99.23259393
2709,毓,毋,13,12,998149,99.23378694
2710,畸,田,13,12,998161,99.23497996
2711,痺,??,13,12,998173,99.23617297
2712,睞,目,13,12,998185,99.23736598
2713,頌,頁,13,12,998197,99.23855900
2714,摘,手,14,12,998209,99.23975201
2715,歉,欠,14,12,998221,99.24094503
2716,瞄,目,14,12,998233,99.24213804
2717,隙,阜,14,12,998245,99.24333105
2718,墳,土,15,12,998257,99.24452407
2719,嬌,女,15,12,998269,99.24571708
2720,歎,欠,15,12,998281,99.24691009
2721,澆,水,15,12,998293,99.24810311
2722,璋,玉,15,12,998305,99.24929612
2723,駝,馬,15,12,998317,99.25048914
2724,諱,言,16,12,998329,99.25168215
2725,頰,頁,16,12,998341,99.25287516
2726,駱,馬,16,12,998353,99.25406818
2727,懇,心,17,12,998365,99.25526119
2728,懋,心,17,12,998377,99.25645420
2729,臀,肉,17,12,998389,99.25764722
2730,遽,??,17,12,998401,99.25884023
2731,鍍,金,17,12,998413,99.26003325
2732,嚮,口,18,12,998425,99.26122626
2733,瀾,水,19,12,998437,99.26241927
2734,繽,糸,20,12,998449,99.26361229
2735,顫,頁,22,12,998461,99.26480530
2736,攪,手,23,12,998473,99.26599831
2737,麟,鹿,23,12,998485,99.26719133
2738,鑲,金,25,12,998497,99.26838434
2739,叉,又,03,11,998508,99.26947794
2740,毋,毋,04,11,998519,99.27057153
2741,卉,十,05,11,998530,99.27166513
2742,叮,口,05,11,998541,99.27275872
2743,妄,女,06,11,998552,99.27385232
2744,吼,口,07,11,998563,99.27494592
2745,妊,女,07,11,998574,99.27603951
2746,杏,木,07,11,998585,99.27713311
2747,辰,辰,07,11,998596,99.27822670
2748,佯,人,08,11,998607,99.27932030
2749,泊,水,08,11,998618,99.28041390
2750,咨,口,09,11,998629,99.28150749
2751,竿,竹,09,11,998640,99.28260109
2752,虹,虫,09,11,998651,99.28369468
2753,冤,??,10,11,998662,99.28478828
2754,姬,女,10,11,998673,99.28588188
2755,娠,女,10,11,998684,99.28697547
2756,悍,心,10,11,998695,99.28806907
2757,畜,田,10,11,998706,99.28916266
2758,秦,禾,10,11,998717,99.29025626
2759,翅,羽,10,11,998728,99.29134986
2760,屠,尸,11,11,998739,99.29244345
2761,惕,心,11,11,998750,99.29353705
2762,曹,曰,11,11,998761,99.29463064
2763,疵,??,11,11,998772,99.29572424
2764,翌,羽,11,11,998783,99.29681783
2765,惶,心,12,11,998794,99.29791143
2766,窘,穴,12,11,998805,99.29900503
2767,酥,酉,12,11,998816,99.30009862
2768,飼,食,13,11,998827,99.30119222
2769,僚,人,14,11,998838,99.30228581
2770,寥,??,14,11,998849,99.30337941
2771,嶄,山,14,11,998860,99.30447301
2772,愿,心,14,11,998871,99.30556660
2773,摧,手,14,11,998882,99.30666020
2774,榕,木,14,11,998893,99.30775379
2775,膈,肉,14,11,998904,99.30884739
2776,樁,木,15,11,998915,99.30994099
2777,蔭,艸,15,11,998926,99.31103458
2778,褐,衣,15,11,998937,99.31212818
2779,燉,火,16,11,998948,99.31322177
2780,縛,糸,16,11,998959,99.31431537
2781,鋸,金,16,11,998970,99.31540897
2782,骼,骨,16,11,998981,99.31650256
2783,嬤,女,17,11,998992,99.31759616
2784,濤,水,17,11,999003,99.31868975
2785,篷,竹,17,11,999014,99.31978335
2786,襄,衣,17,11,999025,99.32087694
2787,謊,言,17,11,999036,99.32197054
2788,鮭,魚,17,11,999047,99.32306414
2789,檬,木,18,11,999058,99.32415773
2790,瀉,水,18,11,999069,99.32525133
2791,瞻,目,18,11,999080,99.32634492
2792,寵,??,19,11,999091,99.32743852
2793,懲,心,19,11,999102,99.32853212
2794,疇,田,19,11,999113,99.32962571
2795,穫,禾,19,11,999124,99.33071931
2796,鯨,魚,19,11,999135,99.33181290
2797,饒,食,20,11,999146,99.33290650
2798,癱,??,24,11,999157,99.33400010
2799,町,田,07,11,999168,99.33509369
2800,弓,弓,03,10,999178,99.33608787
2801,扎,手,04,10,999188,99.33708205
2802,犬,犬,04,10,999198,99.33807623
2803,卯,??,05,10,999208,99.33907040
2804,囚,囗,05,10,999218,99.34006458
2805,扒,手,05,10,999228,99.34105876
2806,旱,日,07,10,999238,99.34205294
2807,汲,水,07,10,999248,99.34304712
2808,佬,人,08,10,999258,99.34404129
2809,矽,石,08,10,999268,99.34503547
2810,竺,竹,08,10,999278,99.34602965
2811,亟,二,09,10,999288,99.34702383
2812,咱,口,09,10,999298,99.34801801
2813,垮,土,09,10,999308,99.34901218
2814,奕,大,09,10,999318,99.35000636
2815,拭,手,09,10,999328,99.35100054
2816,砍,石,09,10,999338,99.35199472
2817,苛,艸,09,10,999348,99.35298890
2818,晃,日,10,10,999358,99.35398308
2819,茱,艸,10,10,999368,99.35497725
2820,郡,邑,10,10,999378,99.35597143
2821,娶,女,11,10,999388,99.35696561
2822,徠,彳,11,10,999398,99.35795979
2823,淪,水,11,10,999408,99.35895397
2824,猜,犬,11,10,999418,99.35994814
2825,眺,目,11,10,999428,99.36094232
2826,袍,衣,11,10,999438,99.36193650
2827,媚,女,12,10,999448,99.36293068
2828,掣,手,12,10,999458,99.36392486
2829,猩,犬,12,10,999468,99.36491903
2830,萃,艸,12,10,999478,99.36591321
2831,袱,衣,12,10,999488,99.36690739
2832,搏,手,13,10,999498,99.36790157
2833,楠,木,13,10,999508,99.36889575
2834,腥,肉,13,10,999518,99.36988992
2835,詭,言,13,10,999528,99.37088410
2836,澈,水,14,10,999538,99.37187828
2837,熄,火,14,10,999548,99.37287246
2838,蒲,艸,14,10,999558,99.37386664
2839,裹,衣,14,10,999568,99.37486082
2840,餓,食,15,10,999578,99.37585499
2841,懈,心,16,10,999588,99.37684917
2842,橄,木,16,10,999598,99.37784335
2843,諺,言,16,10,999608,99.37883753
2844,踴,足,16,10,999618,99.37983171
2845,燭,火,17,10,999628,99.38082588
2846,瞰,目,17,10,999638,99.38182006
2847,礁,石,17,10,999648,99.38281424
2848,薯,艸,17,10,999658,99.38380842
2849,擲,手,18,10,999668,99.38480260
2850,檸,木,18,10,999678,99.38579677
2851,轍,車,18,10,999688,99.38679095
2852,釐,里,18,10,999698,99.38778513
2853,瀝,水,19,10,999708,99.38877931
2854,籤,竹,23,10,999718,99.38977349
2855,欖,木,25,10,999728,99.39076766
2856,佼,人,08,10,999738,99.39176184
2857,狒,犬,08,10,999748,99.39275602
2858,芮,艸,08,10,999758,99.39375020
2859,紓,糸,10,10,999768,99.39474438
2860,碇,石,13,10,999778,99.39573856
2861,叩,口,05,9,999787,99.39663332
2862,禾,禾,05,9,999796,99.39752808
2863,曳,曰,06,9,999805,99.39842284
2864,朽,木,06,9,999814,99.39931760
2865,佑,人,07,9,999823,99.40021236
2866,妓,女,07,9,999832,99.40110712
2867,庇,??,07,9,999841,99.40200188
2868,灶,火,07,9,999850,99.40289664
2869,卦,卜,08,9,999859,99.40379140
2870,姍,女,08,9,999868,99.40468616
2871,帖,巾,08,9,999877,99.40558092
2872,枉,木,08,9,999886,99.40647568
2873,俞,人,09,9,999895,99.40737044
2874,咽,口,09,9,999904,99.40826520
2875,垢,土,09,9,999913,99.40915996
2876,姨,女,09,9,999922,99.41005472
2877,拷,手,09,9,999931,99.41094948
2878,柳,木,09,9,999940,99.41184424
2879,洶,水,09,9,999949,99.41273900
2880,耍,而,09,9,999958,99.41363376
2881,迭,??,09,9,999967,99.41452852
2882,倖,人,10,9,999976,99.41542328
2883,哨,口,10,9,999985,99.41631804
2884,崛,山,11,9,999994,99.41721280
2885,斬,斤,11,9,1000003,99.41810756
2886,壹,士,12,9,1000012,99.41900232
2887,嵌,山,12,9,1000021,99.41989708
2888,氮,气,12,9,1000030,99.42079184
2889,犀,牛,12,9,1000039,99.42168660
2890,痠,??,12,9,1000048,99.42258136
2891,菠,艸,12,9,1000057,99.42347612
2892,訶,言,12,9,1000066,99.42437088
2893,塘,土,13,9,1000075,99.42526564
2894,塭,口,13,9,1000084,99.42616040
2895,愧,心,13,9,1000093,99.42705516
2896,稠,禾,13,9,1000102,99.42794993
2897,腱,肉,13,9,1000111,99.42884469
2898,遏,??,13,9,1000120,99.42973945
2899,頑,頁,13,9,1000129,99.43063421
2900,寢,??,14,9,1000138,99.43152897
2901,榴,木,14,9,1000147,99.43242373
2902,瘓,??,14,9,1000156,99.43331849
2903,綴,糸,14,9,1000165,99.43421325
2904,肇,聿,14,9,1000174,99.43510801
2905,蜿,虫,14,9,1000183,99.43600277
2906,儉,人,15,9,1000192,99.43689753
2907,憐,心,15,9,1000201,99.43779229
2908,樊,木,15,9,1000210,99.43868705
2909,磅,石,15,9,1000219,99.43958181
2910,緞,糸,15,9,1000228,99.44047657
2911,翩,羽,15,9,1000237,99.44137133
2912,豎,豆,15,9,1000246,99.44226609
2913,賤,貝,15,9,1000255,99.44316085
2914,鴉,鳥,15,9,1000264,99.44405561
2915,憊,心,16,9,1000273,99.44495037
2916,澱,水,16,9,1000282,99.44584513
2917,穆,禾,16,9,1000291,99.44673989
2918,蕉,艸,16,9,1000300,99.44763465
2919,錠,金,16,9,1000309,99.44852941
2920,鮑,魚,16,9,1000318,99.44942417
2921,斂,??,17,9,1000327,99.45031893
2922,繃,糸,17,9,1000336,99.45121369
2923,薛,艸,17,9,1000345,99.45210845
2924,謙,言,17,9,1000354,99.45300321
2925,輿,車,17,9,1000363,99.45389797
2926,擷,手,18,9,1000372,99.45479273
2927,瀑,水,18,9,1000381,99.45568749
2928,鎊,金,18,9,1000390,99.45658225
2929,鞭,革,18,9,1000399,99.45747701
2930,簾,竹,19,9,1000408,99.45837177
2931,鏢,金,19,9,1000417,99.45926654
2932,蘆,艸,20,9,1000426,99.46016130
2933,殲,歹,21,9,1000435,99.46105606
2934,贓,貝,21,9,1000444,99.46195082
2935,鶴,鳥,21,9,1000453,99.46284558
2936,黯,黑,21,9,1000462,99.46374034
2937,羈,网,24,9,1000471,99.46463510
2938,鹼,鹵,24,9,1000480,99.46552986
2939,于,二,03,8,1000488,99.46632520
2940,厄,厂,04,8,1000496,99.46712054
2941,乍,??,05,8,1000504,99.46791588
2942,仟,十,05,8,1000512,99.46871123
2943,朮,十,05,8,1000520,99.46950657
2944,屹,山,06,8,1000528,99.47030191
2945,弛,弓,06,8,1000536,99.47109725
2946,臼,臼,06,8,1000544,99.47189260
2947,匣,匚,07,8,1000552,99.47268794
2948,灼,火,07,8,1000560,99.47348328
2949,皂,白,07,8,1000568,99.47427862
2950,肘,肉,07,8,1000576,99.47507397
2951,咎,口,08,8,1000584,99.47586931
2952,戾,戶,08,8,1000592,99.47666465
2953,拐,手,08,8,1000600,99.47745999
2954,昊,日,08,8,1000608,99.47825534
2955,沫,水,08,8,1000616,99.47905068
2956,芙,艸,08,8,1000624,99.47984602
2957,芸,艸,08,8,1000632,99.48064136
2958,亭,??,09,8,1000640,99.48143671
2959,俐,人,09,8,1000648,99.48223205
2960,哉,口,09,8,1000656,99.48302739
2961,屎,尸,09,8,1000664,99.48382273
2962,恍,心,09,8,1000672,99.48461808
2963,恃,心,09,8,1000680,99.48541342
2964,苯,艸,09,8,1000688,99.48620876
2965,韋,韋,09,8,1000696,99.48700410
2966,倪,人,10,8,1000704,99.48779945
2967,俾,人,10,8,1000712,99.48859479
2968,耘,耒,10,8,1000720,99.48939013
2969,兜,儿,11,8,1000728,99.49018547
2970,凰,几,11,8,1000736,99.49098082
2971,寇,??,11,8,1000744,99.49177616
2972,掏,手,11,8,1000752,99.49257150
2973,淫,水,11,8,1000760,99.49336684
2974,焉,火,11,8,1000768,99.49416219
2975,窒,穴,11,8,1000776,99.49495753
2976,唾,口,12,8,1000784,99.49575287
2977,媛,女,12,8,1000792,99.49654821
2978,棍,木,12,8,1000800,99.49734356
2979,溉,水,12,8,1000808,99.49813890
2980,琥,玉,12,8,1000816,99.49893424
2981,筍,竹,12,8,1000824,99.49972958
2982,絞,糸,12,8,1000832,99.50052493
2983,菱,艸,12,8,1000840,99.50132027
2984,詠,言,12,8,1000848,99.50211561
2985,鈉,金,12,8,1000856,99.50291095
2986,鈑,金,12,8,1000864,99.50370630
2987,嗅,口,13,8,1000872,99.50450164
2988,塚,土,13,8,1000880,99.50529698
2989,彙,??,13,8,1000888,99.50609232
2990,斟,斗,13,8,1000896,99.50688767
2991,暇,日,13,8,1000904,99.50768301
2992,楣,木,13,8,1000912,99.50847835
2993,痴,??,13,8,1000920,99.50927369
2994,睦,目,13,8,1000928,99.51006904
2995,碘,石,13,8,1000936,99.51086438
2996,窠,穴,13,8,1000944,99.51165972
2997,葵,艸,13,8,1000952,99.51245506
2998,裔,衣,13,8,1000960,99.51325041
2999,賈,貝,13,8,1000968,99.51404575
3000,馴,馬,13,8,1000976,99.51484109
3001,凳,几,14,8,1000984,99.51563643
3002,墅,土,14,8,1000992,99.51643178
3003,瘍,??,14,8,1001000,99.51722712
3004,誡,言,14,8,1001008,99.51802246
3005,嘻,口,15,8,1001016,99.51881780
3006,憧,心,15,8,1001024,99.51961315
3007,憬,心,15,8,1001032,99.52040849
3008,撮,手,15,8,1001040,99.52120383
3009,毆,殳,15,8,1001048,99.52199917
3010,鞏,革,15,8,1001056,99.52279452
3011,憩,心,16,8,1001064,99.52358986
3012,蕊,艸,16,8,1001072,99.52438520
3013,蕙,艸,16,8,1001080,99.52518054
3014,嶼,山,17,8,1001088,99.52597589
3015,瞪,目,17,8,1001096,99.52677123
3016,縷,糸,17,8,1001104,99.52756657
3017,醞,酉,17,8,1001112,99.52836191
3018,黝,黑,17,8,1001120,99.52915726
3019,檳,木,18,8,1001128,99.52995260
3020,檻,木,18,8,1001136,99.53074794
3021,繡,糸,18,8,1001144,99.53154328
3022,櫥,木,19,8,1001152,99.53233863
3023,爍,火,19,8,1001160,99.53313397
3024,麒,鹿,19,8,1001168,99.53392931
3025,癥,??,20,8,1001176,99.53472465
3026,霹,雨,21,8,1001184,99.53551999
3027,儼,人,22,8,1001192,99.53631534
3028,攣,手,23,8,1001200,99.53711068
3029,靂,雨,24,8,1001208,99.53790602
3030,鑼,金,27,8,1001216,99.53870136
3031,烷,火,11,8,1001224,99.53949671
3032,斌,文,12,8,1001232,99.54029205
3033,蜒,虫,14,8,1001240,99.54108739
3034,(銹),金,16,8,1001248,99.54188273
3035,??,犬,13,7,1001255,99.54257866
3036,刁,刀,02,7,1001262,99.54327458
3037,云,二,04,7,1001269,99.54397051
3038,爪,爪,04,7,1001276,99.54466643
3039,丕,一,05,7,1001283,99.54536236
3040,仕,人,05,7,1001290,99.54605828
3041,汀,水,05,7,1001297,99.54675421
3042,氾,水,05,7,1001304,99.54745013
3043,甩,用,05,7,1001311,99.54814606
3044,匠,匚,06,7,1001318,99.54884198
3045,扛,手,06,7,1001325,99.54953791
3046,佇,人,07,7,1001332,99.55023383
3047,妖,女,07,7,1001339,99.55092976
3048,忱,心,07,7,1001346,99.55162568
3049,抉,手,07,7,1001353,99.55232160
3050,沃,水,07,7,1001360,99.55301753
3051,侏,人,08,7,1001367,99.55371345
3052,庚,??,08,7,1001374,99.55440938
3053,泣,水,08,7,1001381,99.55510530
3054,沼,水,08,7,1001388,99.55580123
3055,哇,口,09,7,1001395,99.55649715
3056,哄,口,09,7,1001402,99.55719308
3057,垣,土,09,7,1001409,99.55788900
3058,奎,大,09,7,1001416,99.55858493
3059,柄,木,09,7,1001423,99.55928085
3060,炬,火,09,7,1001430,99.55997678
3061,狩,犬,09,7,1001437,99.56067270
3062,迥,??,09,7,1001444,99.56136863
3063,冥,??,10,7,1001451,99.56206455
3064,唉,口,10,7,1001458,99.56276047
3065,圃,囗,10,7,1001465,99.56345640
3066,峭,山,10,7,1001472,99.56415232
3067,捆,手,10,7,1001479,99.56484825
3068,烘,火,10,7,1001486,99.56554417
3069,珮,玉,10,7,1001493,99.56624010
3070,砸,石,10,7,1001500,99.56693602
3071,耿,耳,10,7,1001507,99.56763195
3072,茫,艸,10,7,1001514,99.56832787
3073,軒,車,10,7,1001521,99.56902380
3074,孰,子,11,7,1001528,99.56971972
3075,崖,山,11,7,1001535,99.57041565
3076,崔,山,11,7,1001542,99.57111157
3077,崙,山,11,7,1001549,99.57180750
3078,硫,石,11,7,1001556,99.57250342
3079,羚,羊,11,7,1001563,99.57319934
3080,逞,??,11,7,1001570,99.57389527
3081,傢,人,12,7,1001577,99.57459119
3082,喀,口,12,7,1001584,99.57528712
3083,喧,口,12,7,1001591,99.57598304
3084,喲,口,12,7,1001598,99.57667897
3085,斐,文,12,7,1001605,99.57737489
3086,棧,木,12,7,1001612,99.57807082
3087,棻,木,12,7,1001619,99.57876674
3088,渠,水,12,7,1001626,99.57946267
3089,琦,玉,12,7,1001633,99.58015859
3090,痙,??,12,7,1001640,99.58085452
3091,粥,米,12,7,1001647,99.58155044
3092,絮,糸,12,7,1001654,99.58224637
3093,菊,艸,12,7,1001661,99.58294229
3094,蛤,虫,12,7,1001668,99.58363821
3095,飪,食,12,7,1001675,99.58433414
3096,馭,馬,12,7,1001682,99.58503006
3097,嗯,口,13,7,1001689,99.58572599
3098,滔,水,13,7,1001696,99.58642191
3099,煦,火,13,7,1001703,99.58711784
3100,瑯,玉,13,7,1001710,99.58781376
3101,瑛,玉,13,7,1001717,99.58850969
3102,盞,皿,13,7,1001724,99.58920561
3103,睪,目,13,7,1001731,99.58990154
3104,蛾,虫,13,7,1001738,99.59059746
3105,詬,言,13,7,1001745,99.59129339
3106,賊,貝,13,7,1001752,99.59198931
3107,遑,??,13,7,1001759,99.59268524
3108,隕,阜,13,7,1001766,99.59338116
3109,孵,子,13,7,1001773,99.00000000
3110,屢,尸,14,7,1001780,99.59477301
3111,漬,水,14,7,1001787,99.59546893
3112,綻,糸,14,7,1001794,99.59616486
3113,鄙,邑,14,7,1001801,99.59686078
3114,墮,土,15,7,1001808,99.59755671
3115,廝,??,15,7,1001815,99.59825263
3116,蔽,艸,15,7,1001822,99.59894856
3117,蔚,艸,15,7,1001829,99.59964448
3118,蝶,虫,15,7,1001836,99.60034041
3119,霉,雨,15,7,1001843,99.60103633
3120,儒,人,16,7,1001850,99.60173226
3121,噹,口,16,7,1001857,99.60242818
3122,臻,至,16,7,1001864,99.60312411
3123,鞘,革,16,7,1001871,99.60382003
3124,頹,頁,16,7,1001878,99.60451595
3125,斃,??,17,7,1001885,99.60521188
3126,曠,日,19,7,1001892,99.60590780
3127,瀟,水,19,7,1001899,99.60660373
3128,襟,衣,19,7,1001906,99.60729965
3129,嚨,口,19,7,1001913,99.60799558
3130,嚼,口,20,7,1001920,99.60869150
3131,癢,??,20,7,1001927,99.60938743
3132,辮,糸,20,7,1001934,99.61008335
3133,鶯,鳥,21,7,1001941,99.61077928
3134,饕,食,22,7,1001948,99.61147520
3135,鱗,魚,23,7,1001955,99.61217113
3136,黴,黑,23,7,1001962,99.61286705
3137,囑,口,24,7,1001969,99.61356298
3138,驢,馬,26,7,1001976,99.61425890
3139,鑿,金,28,7,1001983,99.61495482
3140,粘,米,11,7,1001990,99.61565075
3141,筱,竹,13,7,1001997,99.61634667
3142,燁,火,16,7,1002004,99.61704260
3143,丰,｜,04,6,1002010,99.61763911
3144,夭,大,04,6,1002016,99.61823561
3145,亥,??,06,6,1002022,99.61883212
3146,圳,土,06,6,1002028,99.61942863
3147,汎,水,06,6,1002034,99.62002513
3148,盯,目,07,6,1002040,99.62062164
3149,邑,邑,07,6,1002046,99.62121815
3150,侍,人,08,6,1002052,99.62181465
3151,侃,人,08,6,1002058,99.62241116
3152,岱,山,08,6,1002064,99.62300767
3153,枋,木,08,6,1002070,99.62360417
3154,邸,邑,08,6,1002076,99.62420068
3155,阜,阜,08,6,1002082,99.62479719
3156,侮,人,09,6,1002088,99.62539369
3157,姦,女,09,6,1002094,99.62599020
3158,歪,止,09,6,1002100,99.62658671
3159,苑,艸,09,6,1002106,99.62718322
3160,倩,人,10,6,1002112,99.62777972
3161,厝,厂,10,6,1002118,99.62837623
3162,哺,口,10,6,1002124,99.62897274
3163,宵,??,10,6,1002130,99.62956924
3164,恕,心,10,6,1002136,99.63016575
3165,悖,心,10,6,1002142,99.63076226
3166,栩,木,10,6,1002148,99.63135876
3167,株,木,10,6,1002154,99.63195527
3168,荔,艸,10,6,1002160,99.63255178
3169,飢,食,10,6,1002166,99.63314828
3170,奢,大,11,6,1002172,99.63374479
3171,晤,日,11,6,1002178,99.63434130
3172,氫,气,11,6,1002184,99.63493780
3173,眶,目,11,6,1002190,99.63553431
3174,莞,艸,11,6,1002196,99.63613082
3175,訟,言,11,6,1002202,99.63672732
3176,厥,厂,12,6,1002208,99.63732383
3177,喋,口,12,6,1002214,99.63792034
3178,孳,子,12,6,1002220,99.63851685
3179,揉,手,12,6,1002226,99.63911335
3180,氯,气,12,6,1002232,99.63970986
3181,焰,火,12,6,1002238,99.64030637
3182,琛,玉,12,6,1002244,99.64090287
3183,嗚,口,13,6,1002250,99.64149938
3184,媲,女,13,6,1002256,99.64209589
3185,搗,手,13,6,1002262,99.64269239
3186,榔,木,13,6,1002268,99.64328890
3187,滄,水,13,6,1002274,99.64388541
3188,痰,??,13,6,1002280,99.64448191
3189,碉,石,13,6,1002286,99.64507842
3190,裙,衣,13,6,1002292,99.64567493
3191,詼,言,13,6,1002298,99.64627143
3192,靶,革,13,6,1002304,99.64686794
3193,僧,人,14,6,1002310,99.64746445
3194,僕,人,14,6,1002316,99.64806096
3195,撇,手,14,6,1002322,99.64865746
3196,摺,手,14,6,1002328,99.64925397
3197,甄,瓦,14,6,1002334,99.64985048
3198,箝,竹,14,6,1002340,99.65044698
3199,閩,門,14,6,1002346,99.65104349
3200,嬉,女,15,6,1002352,99.65164000
3201,憚,心,15,6,1002358,99.65223650
3202,摯,手,15,6,1002364,99.65283301
3203,摹,手,15,6,1002370,99.65342952
3204,樟,木,15,6,1002376,99.65402602
3205,漿,水,15,6,1002382,99.65462253
3206,緯,糸,15,6,1002388,99.65521904
3207,輟,車,15,6,1002394,99.65581554
3208,穌,禾,16,6,1002400,99.65641205
3209,縐,糸,16,6,1002406,99.65700856
3210,蕃,艸,16,6,1002412,99.65760506
3211,蹂,足,16,6,1002418,99.65820157
3212,遼,??,16,6,1002424,99.65879808
3213,嶺,山,17,6,1002430,99.65939459
3214,擱,手,17,6,1002436,99.65999109
3215,曙,日,17,6,1002442,99.66058760
3216,簇,竹,17,6,1002448,99.66118411
3217,嬸,女,18,6,1002454,99.66178061
3218,曜,日,18,6,1002460,99.66237712
3219,殯,歹,18,6,1002466,99.66297363
3220,謬,言,18,6,1002472,99.66357013
3221,闔,門,18,6,1002478,99.66416664
3222,嚥,口,19,6,1002484,99.66476315
3223,簷,竹,19,6,1002490,99.66535965
3224,繹,糸,19,6,1002496,99.66595616
3225,懺,心,20,6,1002502,99.66655267
3226,瀰,水,20,6,1002508,99.66714917
3227,囂,口,21,6,1002514,99.66774568
3228,籐,竹,21,6,1002520,99.66834219
3229,躋,足,21,6,1002526,99.66893870
3230,鰭,魚,21,6,1002532,99.66953520
3231,巒,山,22,6,1002538,99.67013171
3232,躪,足,27,6,1002544,99.67072822
3233,啥,口,11,6,1002550,99.67132472
3234,蜍,虫,13,6,1002556,99.67192123
3235,嬅,女,15,6,1002562,99.67251774
3236,醚,酉,17,6,1002568,99.67311424
3237,(恒),心,09,6,1002574,99.67371075
3238,刃,刀,03,5,1002579,99.67420784
3239,朴,木,06,5,1002584,99.67470493
3240,佣,人,07,5,1002589,99.67520202
3241,岔,山,07,5,1002594,99.67569911
3242,沌,水,07,5,1002599,99.67619620
3243,禿,禾,07,5,1002604,99.67669328
3244,芋,艸,07,5,1002609,99.67719037
3245,佰,人,08,5,1002614,99.67768746
3246,咋,口,08,5,1002619,99.67818455
3247,弧,弓,08,5,1002624,99.67868164
3248,怯,心,08,5,1002629,99.67917873
3249,拂,手,08,5,1002634,99.67967582
3250,杭,木,08,5,1002639,99.68017291
3251,狐,犬,08,5,1002644,99.68067000
3252,軋,車,08,5,1002649,99.68116709
3253,剌,刀,09,5,1002654,99.68166417
3254,咸,口,09,5,1002659,99.68216126
3255,囿,囗,09,5,1002664,99.68265835
3256,盅,皿,09,5,1002669,99.68315544
3257,茁,艸,09,5,1002674,99.68365253
3258,堉,土,10,5,1002679,99.68414962
3259,屑,尸,10,5,1002684,99.68464671
3260,恣,心,10,5,1002689,99.68514380
3261,玆,玄,10,5,1002694,99.68564089
3262,琉,玉,10,5,1002699,99.68613798
3263,眩,目,10,5,1002704,99.68663507
3264,紊,糸,10,5,1002709,99.68713215
3265,荊,艸,10,5,1002714,99.68762924
3266,訖,言,10,5,1002719,99.68812633
3267,啞,口,11,5,1002724,99.68862342
3268,埠,土,11,5,1002729,99.68912051
3269,屜,尸,11,5,1002734,99.68961760
3270,帷,巾,11,5,1002739,99.69011469
3271,徙,彳,11,5,1002744,99.69061178
3272,恿,心,11,5,1002749,99.69110887
3273,敝,??,11,5,1002754,99.69160596
3274,晝,日,11,5,1002759,99.69210304
3275,涎,水,11,5,1002764,99.69260013
3276,淒,水,11,5,1002769,99.69309722
3277,淆,水,11,5,1002774,99.69359431
3278,絆,糸,11,5,1002779,99.69409140
3279,脣,肉,11,5,1002784,99.69458849
3280,舵,舟,11,5,1002789,99.69508558
3281,莓,艸,11,5,1002794,99.69558267
3282,逍,??,11,5,1002799,99.69607976
3283,啻,口,12,5,1002804,99.69657685
3284,愕,心,12,5,1002809,99.69707394
3285,揀,手,12,5,1002814,99.69757102
3286,揍,手,12,5,1002819,99.69806811
3287,揣,手,12,5,1002824,99.69856520
3288,摒,手,12,5,1002829,99.69906229
3289,湍,水,12,5,1002834,99.69955938
3290,渺,水,12,5,1002839,99.70005647
3291,琢,玉,12,5,1002844,99.70055356
3292,筏,竹,12,5,1002849,99.70105065
3293,萌,艸,12,5,1002854,99.70154774
3294,鈍,金,12,5,1002859,99.70204483
3295,馮,馬,12,5,1002864,99.70254191
3296,嗤,口,13,5,1002869,99.70303900
3297,嗆,口,13,5,1002874,99.70353609
3298,塌,土,13,5,1002879,99.70403318
3299,睬,目,13,5,1002884,99.70453027
3300,祺,示,13,5,1002889,99.70502736
3301,蛻,虫,13,5,1002894,99.70552445
3302,跤,足,13,5,1002899,99.70602154
3303,遐,??,13,5,1002904,99.70651863
3304,隘,阜,13,5,1002909,99.70701572
3305,雍,隹,13,5,1002914,99.70751281
3306,靴,革,13,5,1002919,99.70800989
3307,匱,匚,14,5,1002924,99.70850698
3308,嫖,女,14,5,1002929,99.70900407
3309,嶇,山,14,5,1002934,99.70950116
3310,漪,水,14,5,1002939,99.70999825
3311,滌,水,14,5,1002944,99.71049534
3312,熙,火,14,5,1002949,99.71099243
3313,睿,目,14,5,1002954,99.71148952
3314,綽,糸,14,5,1002959,99.71198661
3315,舔,舌,14,5,1002964,99.71248370
3316,蜥,虫,14,5,1002969,99.71298078
3317,鉻,金,14,5,1002974,99.71347787
3318,餃,食,14,5,1002979,99.71397496
3319,僻,人,15,5,1002984,99.71447205
3320,劈,刀,15,5,1002989,99.71496914
3321,嘶,口,15,5,1002994,99.71546623
3322,幟,巾,15,5,1002999,99.71596332
3323,慫,心,15,5,1003004,99.71646041
3324,憫,心,15,5,1003009,99.71695750
3325,撩,手,15,5,1003014,99.71745459
3326,瞎,目,15,5,1003019,99.71795167
3327,緬,糸,15,5,1003024,99.71844876
3328,膛,肉,15,5,1003029,99.71894585
3329,蝠,虫,15,5,1003034,99.71944294
3330,蝙,虫,15,5,1003039,99.71994003
3331,餒,食,15,5,1003044,99.72043712
3332,冀,八,16,5,1003049,99.72093421
3333,噩,口,16,5,1003054,99.72143130
3334,噱,口,16,5,1003059,99.72192839
3335,樺,木,16,5,1003064,99.72242548
3336,篤,竹,16,5,1003069,99.72292257
3337,褫,衣,16,5,1003074,99.72341965
3338,諳,言,16,5,1003079,99.72391674
3339,蹄,足,16,5,1003084,99.72441383
3340,輻,車,16,5,1003089,99.72491092
3341,隧,阜,16,5,1003094,99.72540801
3342,徽,彳,17,5,1003099,99.72590510
3343,檜,木,17,5,1003104,99.72640219
3344,璨,玉,17,5,1003109,99.72689928
3345,豁,谷,17,5,1003114,99.72739637
3346,輾,車,17,5,1003119,99.72789346
3347,醣,酉,17,5,1003124,99.72839054
3348,鍛,金,17,5,1003129,99.72888763
3349,騁,馬,17,5,1003134,99.72938472
3350,戳,戈,18,5,1003139,99.72988181
3351,燼,火,18,5,1003144,99.73037890
3352,獷,犬,18,5,1003149,99.73087599
3353,璧,玉,18,5,1003154,99.73137308
3354,癖,??,18,5,1003159,99.73187017
3355,簧,竹,18,5,1003164,99.73236726
3356,鎢,金,18,5,1003169,99.73286435
3357,闕,門,18,5,1003174,99.73336144
3358,雛,隹,18,5,1003179,99.73385852
3359,瀛,水,19,5,1003184,99.73435561
3360,矇,目,19,5,1003189,99.73485270
3361,蠍,虫,19,5,1003194,99.73534979
3362,蟹,虫,19,5,1003199,99.73584688
3363,譁,言,19,5,1003204,99.73634397
3364,鏗,金,19,5,1003209,99.73684106
3365,壤,土,20,5,1003214,99.73733815
3366,朧,月,20,5,1003219,99.73783524
3367,藹,艸,20,5,1003224,99.73833233
3368,蠢,虫,21,5,1003229,99.73882941
3369,譴,言,21,5,1003234,99.73932650
3370,饗,食,21,5,1003239,99.73982359
3371,霾,雨,22,5,1003244,99.74032068
3372,壩,土,24,5,1003249,99.74081777
3373,釁,酉,25,5,1003254,99.74131486
3374,顱,頁,25,5,1003259,99.74181195
3375,挹,手,10,5,1003264,99.74230904
3376,鈀,金,12,5,1003269,99.74280613
3377,謔,言,16,5,1003274,99.74330322
3378,遶,??,17,5,1003279,99.74380031
3379,(??),木,10,5,1003284,99.74429739
3380,乞,乙,03,4,1003288,99.74469507
3381,弔,弓,04,4,1003292,99.74509274
3382,皿,皿,05,4,1003296,99.74549041
3383,矢,矢,05,4,1003300,99.74588808
3384,匈,??,06,4,1003304,99.74628575
3385,夸,大,06,4,1003308,99.74668342
3386,奸,女,06,4,1003312,99.74708109
3387,伶,人,07,4,1003316,99.74747876
3388,吝,口,07,4,1003320,99.74787644
3389,吶,口,07,4,1003324,99.74827411
3390,妒,女,07,4,1003328,99.74867178
3391,妞,女,07,4,1003332,99.74906945
3392,妍,女,07,4,1003336,99.74946712
3393,扼,手,07,4,1003340,99.74986479
3394,杖,木,07,4,1003344,99.75026246
3395,汶,水,07,4,1003348,99.75066013
3396,卒,十,08,4,1003352,99.75105781
3397,咀,口,08,4,1003356,99.75145548
3398,咐,口,08,4,1003360,99.75185315
3399,斧,斤,08,4,1003364,99.75225082
3400,泓,水,08,4,1003368,99.75264849
3401,泱,水,08,4,1003372,99.75304616
3402,泯,水,08,4,1003376,99.75344383
3403,祀,示,08,4,1003380,99.75384150
3404,芹,艸,08,4,1003384,99.75423918
3405,俑,人,09,4,1003388,99.75463685
3406,俟,人,09,4,1003392,99.75503452
3407,剋,刀,09,4,1003396,99.75543219
3408,峙,山,09,4,1003400,99.75582986
3409,弭,弓,09,4,1003404,99.75622753
3410,恫,心,09,4,1003408,99.75662520
3411,拯,手,09,4,1003412,99.75702287
3412,昧,日,09,4,1003416,99.75742055
3413,柿,木,09,4,1003420,99.75781822
3414,氟,气,09,4,1003424,99.75821589
3415,炯,火,09,4,1003428,99.75861356
3416,疤,??,09,4,1003432,99.75901123
3417,祉,示,09,4,1003436,99.75940890
3418,籽,米,09,4,1003440,99.75980657
3419,苔,艸,09,4,1003444,99.76020424
3420,苓,艸,09,4,1003448,99.76060192
3421,迢,??,09,4,1003452,99.76099959
3422,哽,口,10,4,1003456,99.76139726
3423,娓,女,10,4,1003460,99.76179493
3424,宸,??,10,4,1003464,99.76219260
3425,捍,手,10,4,1003468,99.76259027
3426,盎,皿,10,4,1003472,99.76298794
3427,眨,目,10,4,1003476,99.76338561
3428,胴,肉,10,4,1003480,99.76378329
3429,荐,艸,10,4,1003484,99.76418096
3430,茹,艸,10,4,1003488,99.76457863
3431,荀,艸,10,4,1003492,99.76497630
3432,躬,身,10,4,1003496,99.76537397
3433,匿,??,11,4,1003500,99.76577164
3434,匾,??,11,4,1003504,99.76616931
3435,啪,口,11,4,1003508,99.76656698
3436,婪,女,11,4,1003512,99.76696465
3437,惚,心,11,4,1003516,99.76736233
3438,掠,手,11,4,1003520,99.76776000
3439,梢,木,11,4,1003524,99.76815767
3440,梓,木,11,4,1003528,99.76855534
3441,梵,木,11,4,1003532,99.76895301
3442,焊,火,11,4,1003536,99.76935068
3443,烽,火,11,4,1003540,99.76974835
3444,琅,玉,11,4,1003544,99.77014602
3445,痊,??,11,4,1003548,99.77054370
3446,脩,肉,10,4,1003552,99.77094137
3447,舶,舟,11,4,1003556,99.77133904
3448,莽,艸,11,4,1003560,99.77173671
3449,莒,艸,11,4,1003564,99.77213438
3450,趾,足,11,4,1003568,99.77253205
3451,喟,口,12,4,1003572,99.77292972
3452,嵐,山,12,4,1003576,99.77332739
3453,棘,木,12,4,1003580,99.77372507
3454,渲,水,12,4,1003584,99.77412274
3455,湛,水,12,4,1003588,99.77452041
3456,渝,水,12,4,1003592,99.77491808
3457,猥,犬,12,4,1003596,99.77531575
3458,琵,玉,12,4,1003600,99.77571342
3459,蛛,虫,12,4,1003604,99.77611109
3460,貯,貝,12,4,1003608,99.77650876
3461,跛,足,12,4,1003612,99.77690644
3462,鈞,金,12,4,1003616,99.77730411
3463,雯,雨,12,4,1003620,99.77770178
3464,嗓,口,13,4,1003624,99.77809945
3465,嫉,女,13,4,1003628,99.77849712
3466,嫂,女,13,4,1003632,99.77889479
3467,暄,日,13,4,1003636,99.77929246
3468,溼,水,13,4,1003640,99.77969013
3469,瘀,??,13,4,1003644,99.78008781
3470,睜,目,13,4,1003648,99.78048548
3471,稜,禾,13,4,1003652,99.78088315
3472,跪,足,13,4,1003656,99.78128082
3473,鉀,金,13,4,1003660,99.78167849
3474,僱,人,14,4,1003664,99.78207616
3475,嘍,口,14,4,1003668,99.78247383
3476,嘖,口,14,4,1003672,99.78287150
3477,慷,心,14,4,1003676,99.78326918
3478,摻,手,14,4,1003680,99.78366685
3479,斡,斗,14,4,1003684,99.78406452
3480,榻,木,14,4,1003688,99.78446219
3481,漓,水,14,4,1003692,99.78485986
3482,漩,水,14,4,1003696,99.78525753
3483,漣,水,14,4,1003700,99.78565520
3484,滷,水,14,4,1003704,99.78605287
3485,箏,竹,14,4,1003708,99.78645055
3486,箇,竹,14,4,1003712,99.78684822
3487,綢,糸,14,4,1003716,99.78724589
3488,綵,糸,14,4,1003720,99.78764356
3489,翡,羽,14,4,1003724,99.78804123
3490,蜷,虫,14,4,1003728,99.78843890
3491,骯,骨,14,4,1003732,99.78883657
3492,骰,骨,14,4,1003736,99.78923424
3493,凜,??,15,4,1003740,99.78963192
3494,噓,口,15,4,1003744,99.79002959
3495,嘯,口,15,4,1003748,99.79042726
3496,墟,土,15,4,1003752,99.79082493
3497,瘠,??,15,4,1003756,99.79122260
3498,瘡,??,15,4,1003760,99.79162027
3499,磋,石,15,4,1003764,99.79201794
3500,窯,穴,15,4,1003768,99.79241561
3501,諄,言,15,4,1003772,99.79281329
3502,醃,酉,15,4,1003776,99.79321096
3503,銬,金,14,4,1003780,99.79360863
3504,霆,雨,15,4,1003784,99.79400630
3505,頜,頁,15,4,1003788,99.79440397
3506,麩,麥,15,4,1003792,99.79480164
3507,懊,心,16,4,1003796,99.79519931
3508,擄,手,16,4,1003800,99.79559698
3509,擒,手,16,4,1003804,99.79599466
3510,濁,水,16,4,1003808,99.79639233
3511,熾,火,16,4,1003812,99.79679000
3512,瞠,目,16,4,1003816,99.79718767
3513,瞞,目,16,4,1003820,99.79758534
3514,膳,肉,16,4,1003824,99.79798301
3515,霓,雨,16,4,1003828,99.79838068
3516,頤,頁,16,4,1003832,99.79877835
3517,嬪,女,17,4,1003836,99.79917603
3518,孺,子,17,4,1003840,99.79957370
3519,濘,水,17,4,1003844,99.79997137
3520,瞳,目,17,4,1003848,99.80036904
3521,禧,示,17,4,1003852,99.80076671
3522,臆,肉,17,4,1003856,99.80116438
3523,膿,肉,17,4,1003860,99.80156205
3524,膾,肉,17,4,1003864,99.80195972
3525,蟒,虫,17,4,1003868,99.80235740
3526,謗,言,17,4,1003872,99.80275507
3527,鍥,金,17,4,1003876,99.80315274
3528,朦,月,18,4,1003880,99.80355041
3529,竅,穴,18,4,1003884,99.80394808
3530,蟬,虫,18,4,1003888,99.80434575
3531,蹦,足,18,4,1003892,99.80474342
3532,邇,??,18,4,1003896,99.80514109
3533,顎,頁,18,4,1003900,99.80553876
3534,鯊,魚,18,4,1003904,99.80593644
3535,壟,土,19,4,1003908,99.80633411
3536,攏,手,19,4,1003912,99.80673178
3537,櫝,木,19,4,1003916,99.80712945
3538,譎,言,19,4,1003920,99.80752712
3539,韜,韋,19,4,1003924,99.80792479
3540,糰,米,20,4,1003928,99.80832246
3541,蘑,艸,20,4,1003932,99.80872013
3542,儷,人,21,4,1003936,99.80911781
3543,儸,人,21,4,1003940,99.80951548
3544,巖,山,23,4,1003944,99.80991315
3545,蘸,艸,23,4,1003948,99.81031082
3546,矗,目,24,4,1003952,99.81070849
3547,靄,雨,24,4,1003956,99.81110616
3548,芎,艸,07,4,1003960,99.81150383
3549,芡,艸,08,4,1003964,99.81190150
3550,眈,目,09,4,1003968,99.81229918
3551,淼,水,12,4,1003972,99.81269685
3552,瑋,玉,13,4,1003976,99.81309452
3553,箍,竹,14,4,1003980,99.81349219
3554,靚,青,15,4,1003984,99.81388986
3555,騏,馬,18,4,1003988,99.81428753
3556,覷,見,19,4,1003992,99.81468520
3557,癰,??,23,4,1003996,99.81508287
3558,鑫,金,24,4,1004000,99.81548055
3559,卜,卜,02,3,1004003,99.81577880
3560,么,??,03,3,1004006,99.81607705
3561,丑,一,04,3,1004009,99.81637531
3562,冗,??,04,3,1004012,99.81667356
3563,曰,曰,04,3,1004015,99.81697181
3564,叨,口,05,3,1004018,99.81727007
3565,亙,二,06,3,1004021,99.81756832
3566,伉,人,06,3,1004024,99.81786657
3567,圯,土,06,3,1004027,99.81816483
3568,肋,肉,06,3,1004030,99.81846308
3569,佗,人,07,3,1004033,99.81876133
3570,圻,土,07,3,1004036,99.81905959
3571,孜,子,07,3,1004039,99.81935784
3572,孚,子,07,3,1004042,99.81965609
3573,杆,木,07,3,1004045,99.81995435
3574,汞,水,07,3,1004048,99.82025260
3575,沁,水,07,3,1004051,99.82055085
3576,肛,肉,07,3,1004054,99.82084911
3577,侈,人,08,3,1004057,99.82114736
3578,冽,??,08,3,1004060,99.82144561
3579,呻,口,08,3,1004063,99.82174387
3580,帚,巾,08,3,1004066,99.82204212
3581,帑,巾,08,3,1004069,99.82234037
3582,沱,水,08,3,1004072,99.82263863
3583,沸,水,08,3,1004075,99.82293688
3584,泄,水,08,3,1004078,99.82323514
3585,泗,水,08,3,1004081,99.82353339
3586,肴,肉,08,3,1004084,99.82383164
3587,邵,邑,08,3,1004087,99.82412990
3588,咫,口,09,3,1004090,99.82442815
3589,姪,女,09,3,1004093,99.82472640
3590,徊,彳,09,3,1004096,99.82502466
3591,怠,心,09,3,1004099,99.82532291
3592,拱,手,09,3,1004102,99.82562116
3593,柢,木,09,3,1004105,99.82591942
3594,殃,歹,09,3,1004108,99.82621767
3595,狡,犬,09,3,1004111,99.82651592
3596,盹,目,09,3,1004114,99.82681418
3597,茉,艸,09,3,1004117,99.82711243
3598,亳,??,10,3,1004120,99.82741068
3599,凋,??,10,3,1004123,99.82770894
3600,哼,口,10,3,1004126,99.82800719
3601,恙,心,10,3,1004129,99.82830544
3602,悚,心,10,3,1004132,99.82860370
3603,挨,手,10,3,1004135,99.82890195
3604,晌,日,10,3,1004138,99.82920020
3605,栓,木,10,3,1004141,99.82949846
3606,浙,水,10,3,1004144,99.82979671
3607,狽,犬,10,3,1004147,99.83009496
3608,畝,田,10,3,1004150,99.83039322
3609,祟,示,10,3,1004153,99.83069147
3610,耆,老,10,3,1004156,99.83098972
3611,胭,肉,10,3,1004159,99.83128798
3612,蚪,虫,10,3,1004162,99.83158623
3613,袁,衣,10,3,1004165,99.83188448
3614,訐,言,10,3,1004168,99.83218274
3615,訕,言,10,3,1004171,99.83248099
3616,陡,阜,10,3,1004174,99.83277924
3617,偌,人,11,3,1004177,99.83307750
3618,啃,口,11,3,1004180,99.83337575
3619,婁,女,11,3,1004183,99.83367401
3620,徘,彳,11,3,1004186,99.83397226
3621,惋,心,11,3,1004189,99.83427051
3622,捩,手,11,3,1004192,99.83456877
3623,捺,手,11,3,1004195,99.83486702
3624,晦,日,11,3,1004198,99.83516527
3625,梧,木,11,3,1004201,99.83546353
3626,梔,木,11,3,1004204,99.83576178
3627,淳,水,11,3,1004207,99.83606003
3628,烯,火,11,3,1004210,99.83635829
3629,犁,牛,11,3,1004213,99.83665654
3630,猖,犬,11,3,1004216,99.83695479
3631,眸,目,11,3,1004219,99.83725305
3632,莢,艸,11,3,1004222,99.83755130
3633,荼,艸,11,3,1004225,99.83784955
3634,袒,衣,11,3,1004228,99.83814781
3635,赦,赤,11,3,1004231,99.83844606
3636,酗,酉,11,3,1004234,99.83874431
3637,勛,力,12,3,1004237,99.83904257
3638,堯,土,12,3,1004240,99.83934082
3639,巽,己,12,3,1004243,99.83963907
3640,揹,手,12,3,1004246,99.83993733
3641,晾,日,12,3,1004249,99.84023558
3642,渣,水,12,3,1004252,99.84053383
3643,湘,水,12,3,1004255,99.84083209
3644,琶,玉,12,3,1004258,99.84113034
3645,硯,石,12,3,1004261,99.84142859
3646,粟,米,12,3,1004264,99.84172685
3647,腆,肉,12,3,1004267,99.84202510
3648,腴,肉,12,3,1004270,99.84232335
3649,舜,舛,12,3,1004273,99.84262161
3650,菩,艸,12,3,1004276,99.84291986
3651,貽,貝,12,3,1004279,99.84321811
3652,隋,阜,12,3,1004282,99.84351637
3653,隅,阜,12,3,1004285,99.84381462
3654,飭,食,12,3,1004288,99.84411288
3655,幌,巾,13,3,1004291,99.84441113
3656,搓,手,13,3,1004294,99.84470938
3657,楷,木,13,3,1004297,99.84500764
3658,楔,木,13,3,1004300,99.84530589
3659,楨,木,13,3,1004303,99.84560414
3660,楞,木,13,3,1004306,99.84590240
3661,滂,水,13,3,1004309,99.84620065
3662,煤,火,13,3,1004312,99.84649890
3663,痲,??,13,3,1004315,99.84679716
3664,稔,禾,13,3,1004318,99.84709541
3665,綑,糸,13,3,1004321,99.84739366
3666,葦,艸,13,3,1004324,99.84769192
3667,裘,衣,13,3,1004327,99.84799017
3668,賃,貝,13,3,1004330,99.84828842
3669,靖,青,13,3,1004333,99.84858668
3670,槌,木,14,3,1004336,99.84888493
3671,漳,水,14,3,1004339,99.84918318
3672,煽,火,14,3,1004342,99.84948144
3673,睽,目,14,3,1004345,99.84977969
3674,箔,竹,14,3,1004348,99.85007794
3675,蓉,艸,14,3,1004351,99.85037620
3676,蒞,艸,14,3,1004354,99.85067445
3677,蓊,艸,14,3,1004357,99.85097270
3678,蜴,虫,14,3,1004360,99.85127096
3679,蜘,虫,14,3,1004363,99.85156921
3680,裳,衣,14,3,1004366,99.85186746
3681,戮,戈,15,3,1004369,99.85216572
3682,暮,日,15,3,1004372,99.85246397
3683,熨,火,15,3,1004375,99.85276222
3684,璀,玉,15,3,1004378,99.85306048
3685,瘟,??,15,3,1004381,99.85335873
3686,篆,竹,15,3,1004384,99.85365698
3687,緲,糸,15,3,1004387,99.85395524
3688,蔗,艸,15,3,1004390,99.85425349
3689,蝴,虫,15,3,1004393,99.85455174
3690,蝌,虫,15,3,1004396,99.85485000
3691,諉,言,15,3,1004399,99.85514825
3692,豌,豆,15,3,1004402,99.85544651
3693,踝,足,15,3,1004405,99.85574476
3694,遨,??,15,3,1004408,99.85604301
3695,鋅,金,15,3,1004411,99.85634127
3696,鞍,革,15,3,1004414,99.85663952
3697,魷,魚,15,3,1004417,99.85693777
3698,濂,水,16,3,1004420,99.85723603
3699,燎,火,16,3,1004423,99.85753428
3700,燜,火,16,3,1004426,99.85783253
3701,瞥,目,16,3,1004429,99.85813079
3702,蕨,艸,16,3,1004432,99.85842904
3703,蕪,艸,16,3,1004435,99.85872729
3704,諜,言,16,3,1004438,99.85902555
3705,謁,言,16,3,1004441,99.85932380
3706,踱,足,16,3,1004444,99.85962205
3707,靦,面,16,3,1004447,99.85992031
3708,餡,食,16,3,1004450,99.86021856
3709,駭,馬,16,3,1004453,99.86051681
3710,髻,髟,16,3,1004456,99.86081507
3711,嚀,口,17,3,1004459,99.86111332
3712,穗,禾,17,3,1004462,99.86141157
3713,蟆,虫,17,3,1004465,99.86170983
3714,蹋,足,17,3,1004468,99.86200808
3715,轅,車,17,3,1004471,99.86230633
3716,錨,金,17,3,1004474,99.86260459
3717,鍬,金,17,3,1004477,99.86290284
3718,鍰,金,17,3,1004480,99.86320109
3719,霞,雨,17,3,1004483,99.86349935
3720,鞠,革,17,3,1004486,99.86379760
3721,駿,馬,17,3,1004489,99.86409585
3722,瀋,水,18,3,1004492,99.86439411
3723,繕,糸,18,3,1004495,99.86469236
3724,繚,糸,18,3,1004498,99.86499061
3725,櫚,木,19,3,1004501,99.86528887
3726,簸,竹,19,3,1004504,99.86558712
3727,襖,衣,19,3,1004507,99.86588538
3728,襞,衣,19,3,1004510,99.86618363
3729,蹶,足,19,3,1004513,99.86648188
3730,鏟,金,19,3,1004516,99.86678014
3731,鏃,金,19,3,1004519,99.86707839
3732,攘,手,20,3,1004522,99.86737664
3733,藻,艸,20,3,1004525,99.86767490
3734,贍,貝,20,3,1004528,99.86797315
3735,鏽,金,20,3,1004531,99.86827140
3736,齟,齒,20,3,1004534,99.86856966
3737,懾,心,21,3,1004537,99.86886791
3738,齬,齒,22,3,1004540,99.86916616
3739,鷺,鳥,24,3,1004543,99.86946442
3740,籬,竹,25,3,1004546,99.86976267
3741,髖,骨,25,3,1004549,99.87006092
3742,鬣,髟,25,3,1004552,99.87035918
3743,(庄),??,06,3,1004555,99.87065743
3744,枷,木,09,3,1004558,99.87095568
3745,炷,火,09,3,1004561,99.87125394
3746,捅,手,10,3,1004564,99.87155219
3747,涂,水,10,3,1004567,99.87185044
3748,笈,竹,10,3,1004570,99.87214870
3749,淖,水,11,3,1004573,99.87244695
3750,棪,木,12,3,1004576,99.87274520
3751,羡,羊,12,3,1004579,99.87304346
3752,搐,手,13,3,1004582,99.87334171
3753,煒,火,13,3,1004585,99.87363996
3754,榖,木,13,3,1004588,99.87393822
3755,蒟,艸,14,3,1004591,99.87423647
3756,蒻,艸,14,3,1004594,99.87453472
3757,噌,口,15,3,1004597,99.87483298
3758,槤,木,15,3,1004600,99.87513123
3759,憨,心,16,3,1004603,99.87542948
3760,鯤,魚,19,3,1004606,99.87572774
3761,饌,食,20,3,1004609,99.87602599
3762,鷲,鳥,23,3,1004612,99.87632425
3763,(?y),艸,15,3,1004615,99.87662250
3764,(??),金,12,3,1004618,99.87692075
3765,(??),火,13,2,1004620,99.87711959
3766,(??),玉,14,2,1004622,99.87731842
3767,(??),邑,07,2,1004624,99.87751726
3768,?F,口,10,2,1004626,99.87771609
3769,勺,??,03,2,1004628,99.87791493
3770,孑,子,03,2,1004630,99.87811377
3771,巳,己,03,2,1004632,99.87831260
3772,丐,一,04,2,1004634,99.87851144
3773,亢,??,04,2,1004636,99.87871027
3774,叱,口,05,2,1004638,99.87890911
3775,扔,手,05,2,1004640,99.87910794
3776,吏,口,06,2,1004642,99.87930678
3777,吒,口,06,2,1004644,99.87950562
3778,妃,女,06,2,1004646,99.87970445
3779,忖,心,06,2,1004648,99.87990329
3780,汝,水,06,2,1004650,99.88010212
3781,汕,水,06,2,1004652,99.88030096
3782,刨,刀,07,2,1004654,99.88049979
3783,吩,口,07,2,1004656,99.88069863
3784,吮,口,07,2,1004658,99.88089746
3785,吱,口,07,2,1004660,99.88109630
3786,囤,囗,07,2,1004662,99.88129514
3787,坍,土,07,2,1004664,99.88149397
3788,岌,山,07,2,1004666,99.88169281
3789,汨,水,07,2,1004668,99.88189164
3790,玖,玉,07,2,1004670,99.88209048
3791,迂,??,07,2,1004672,99.88228931
3792,釆,釆,07,2,1004674,99.88248815
3793,佾,人,08,2,1004676,99.88268699
3794,剁,刀,08,2,1004678,99.88288582
3795,卹,??,08,2,1004680,99.88308466
3796,咄,口,08,2,1004682,99.88328349
3797,咆,口,08,2,1004684,99.88348233
3798,坩,土,08,2,1004686,99.88368116
3799,妯,女,08,2,1004688,99.88388000
3800,帛,巾,08,2,1004690,99.88407883
3801,弩,弓,08,2,1004692,99.88427767
3802,怏,心,08,2,1004694,99.88447651
3803,拄,手,08,2,1004696,99.88467534
3804,抿,手,08,2,1004698,99.88487418
3805,拈,手,08,2,1004700,99.88507301
3806,拇,手,08,2,1004702,99.88527185
3807,炊,火,08,2,1004704,99.88547068
3808,狙,犬,08,2,1004706,99.88566952
3809,疚,??,08,2,1004708,99.88586835
3810,盂,皿,08,2,1004710,99.88606719
3811,罔,网,08,2,1004712,99.88626603
3812,俘,人,09,2,1004714,99.88646486
3813,剃,刀,09,2,1004716,99.88666370
3814,咦,口,09,2,1004718,99.88686253
3815,咧,口,09,2,1004720,99.88706137
3816,柩,木,09,2,1004722,99.88726020
3817,柑,木,09,2,1004724,99.88745904
3818,殆,歹,09,2,1004726,99.88765788
3819,毗,田,09,2,1004728,99.88785671
3820,泵,水,09,2,1004730,99.88805555
3821,甭,用,09,2,1004732,99.88825438
3822,矜,矛,09,2,1004734,99.88845322
3823,砌,石,09,2,1004736,99.88865205
3824,胝,肉,09,2,1004738,99.88885089
3825,苟,艸,09,2,1004740,99.88904972
3826,趴,足,09,2,1004742,99.88924856
3827,俸,人,10,2,1004744,99.88944740
3828,哮,口,10,2,1004746,99.88964623
3829,唏,口,10,2,1004748,99.88984507
3830,埂,土,10,2,1004750,99.89004390
3831,娥,女,10,2,1004752,99.89024274
3832,娌,女,10,2,1004754,99.89044157
3833,娉,女,10,2,1004756,99.89064041
3834,捎,手,10,2,1004758,99.89083925
3835,晒,日,10,2,1004760,99.89103808
3836,桓,木,10,2,1004762,99.89123692
3837,桀,木,10,2,1004764,99.89143575
3838,氨,气,10,2,1004766,99.89163459
3839,浚,水,10,2,1004768,99.89183342
3840,浹,水,10,2,1004770,99.89203226
3841,涅,水,10,2,1004772,99.89223109
3842,烊,火,10,2,1004774,99.89242993
3843,爹,父,10,2,1004776,99.89262877
3844,狸,犬,10,2,1004778,99.89282760
3845,砰,石,10,2,1004780,99.89302644
3846,祗,示,10,2,1004782,99.89322527
3847,窈,穴,10,2,1004784,99.89342411
3848,胼,肉,10,2,1004786,99.89362294
3849,芻,艸,10,2,1004788,99.89382178
3850,蚤,虫,10,2,1004790,99.89402062
3851,冕,??,11,2,1004792,99.89421945
3852,啄,口,11,2,1004794,99.89441829
3853,唬,口,11,2,1004796,99.89461712
3854,埤,土,11,2,1004798,99.89481596
3855,娼,女,11,2,1004800,99.89501479
3856,崧,山,11,2,1004802,99.89521363
3857,庵,??,11,2,1004804,99.89541246
3858,悽,心,11,2,1004806,99.89561130
3859,惘,心,11,2,1004808,99.89581014
3860,悸,心,11,2,1004810,99.89600897
3861,戛,戈,11,2,1004812,99.89620781
3862,梗,木,11,2,1004814,99.89640664
3863,淤,水,11,2,1004816,99.89660548
3864,淬,水,11,2,1004818,99.89680431
3865,淦,水,11,2,1004820,99.89700315
3866,窕,穴,11,2,1004822,99.89720199
3867,紳,糸,11,2,1004824,99.89740082
3868,脯,肉,11,2,1004826,99.89759966
3869,舷,舟,11,2,1004828,99.89779849
3870,荸,艸,11,2,1004830,99.89799733
3871,莠,艸,11,2,1004832,99.89819616
3872,豉,豆,11,2,1004834,99.89839500
3873,傀,人,12,2,1004836,99.89859383
3874,啼,口,12,2,1004838,99.89879267
3875,喂,口,12,2,1004840,99.89899151
3876,喃,口,12,2,1004842,99.89919034
3877,喳,口,12,2,1004844,99.89938918
3878,幀,巾,12,2,1004846,99.89958801
3879,廄,??,12,2,1004848,99.89978685
3880,愣,心,12,2,1004850,99.89998568
3881,惰,心,12,2,1004852,99.90018452
3882,惻,心,12,2,1004854,99.90038336
3883,扉,戶,12,2,1004856,99.90058219
3884,揪,手,12,2,1004858,99.90078103
3885,棗,木,12,2,1004860,99.90097986
3886,湃,水,12,2,1004862,99.90117870
3887,湄,水,12,2,1004864,99.90137753
3888,痢,??,12,2,1004866,99.90157637
3889,竣,立,12,2,1004868,99.90177520
3890,絢,糸,12,2,1004870,99.90197404
3891,聒,耳,12,2,1004872,99.90217288
3892,腋,肉,12,2,1004874,99.90237171
3893,腓,肉,12,2,1004876,99.90257055
3894,貂,豸,12,2,1004878,99.90276938
3895,賁,貝,12,2,1004880,99.90296822
3896,酣,酉,12,2,1004882,99.90316705
3897,陲,阜,12,2,1004884,99.90336589
3898,傭,人,13,2,1004886,99.90356472
3899,剿,刀,13,2,1004888,99.90376356
3900,剷,刀,13,2,1004890,99.90396240
3901,嗦,口,13,2,1004892,99.90416123
3902,慄,心,13,2,1004894,99.90436007
3903,搽,手,13,2,1004896,99.90455890
3904,搔,手,13,2,1004898,99.90475774
3905,猿,犬,13,2,1004900,99.90495657
3906,睥,目,13,2,1004902,99.90515541
3907,睨,目,13,2,1004904,99.90535425
3908,硼,石,13,2,1004906,99.90555308
3909,筷,竹,13,2,1004908,99.90575192
3910,筠,竹,13,2,1004910,99.90595075
3911,筧,竹,13,2,1004912,99.90614959
3912,粱,米,13,2,1004914,99.90634842
3913,舅,臼,13,2,1004916,99.90654726
3914,蜓,虫,13,2,1004918,99.90674609
3915,裊,衣,13,2,1004920,99.90694493
3916,詫,言,13,2,1004922,99.90714377
3917,豢,豕,13,2,1004924,99.90734260
3918,貲,貝,13,2,1004926,99.90754144
3919,遁,??,13,2,1004928,99.90774027
3920,鄒,邑,13,2,1004930,99.90793911
3921,鈷,金,13,2,1004932,99.90813794
3922,鉗,金,13,2,1004934,99.90833678
3923,雉,隹,13,2,1004936,99.90853562
3924,飴,食,13,2,1004938,99.90873445
3925,鳩,鳥,13,2,1004940,99.90893329
3926,嘟,口,14,2,1004942,99.90913212
3927,嘈,口,14,2,1004944,99.90933096
3928,嫦,女,14,2,1004946,99.90952979
3929,榨,木,14,2,1004948,99.90972863
3930,榭,木,14,2,1004950,99.90992746
3931,漾,水,14,2,1004952,99.91012630
3932,犒,牛,14,2,1004954,99.91032514
3933,瑤,玉,14,2,1004956,99.91052397
3934,禎,示,14,2,1004958,99.91072281
3935,箋,竹,14,2,1004960,99.91092164
3936,綺,糸,14,2,1004962,99.91112048
3937,綸,糸,14,2,1004964,99.91131931
3938,蒿,艸,14,2,1004966,99.91151815
3939,蓆,艸,14,2,1004968,99.91171699
3940,蜻,虫,14,2,1004970,99.91191582
3941,蜢,虫,14,2,1004972,99.91211466
3942,褚,衣,14,2,1004974,99.91231349
3943,誨,言,14,2,1004976,99.91251233
3944,賒,貝,14,2,1004978,99.91271116
3945,銖,金,14,2,1004980,99.91291000
3946,銓,金,14,2,1004982,99.91310883
3947,閨,門,14,2,1004984,99.91330767
3948,嘿,口,15,2,1004986,99.91350651
3949,嘩,口,15,2,1004988,99.91370534
3950,墩,土,15,2,1004990,99.91390418
3951,嫻,女,15,2,1004992,99.91410301
3952,嫵,女,15,2,1004994,99.91430185
3953,憎,心,15,2,1004996,99.91450068
3954,撓,手,15,2,1004998,99.91469952
3955,潟,水,15,2,1005000,99.91489836
3956,獗,犬,15,2,1005002,99.91509719
3957,瞋,目,15,2,1005004,99.91529603
3958,磊,石,15,2,1005006,99.91549486
3959,箴,竹,15,2,1005008,99.91569370
3960,螂,虫,15,2,1005010,99.91589253
3961,蝸,虫,15,2,1005012,99.91609137
3962,蝨,虫,15,2,1005014,99.91629020
3963,褒,衣,15,2,1005016,99.91648904
3964,賬,貝,15,2,1005018,99.91668788
3965,踫,足,15,2,1005020,99.91688671
3966,踞,足,15,2,1005022,99.91708555
3967,輦,車,15,2,1005024,99.91728438
3968,鋰,金,15,2,1005026,99.91748322
3969,駒,馬,15,2,1005028,99.91768205
3970,骷,骨,15,2,1005030,99.91788089
3971,儕,人,16,2,1005032,99.91807973
3972,噬,口,16,2,1005034,99.91827856
3973,壅,土,16,2,1005036,99.91847740
3974,寰,??,16,2,1005038,99.91867623
3975,撻,手,16,2,1005040,99.91887507
3976,曇,日,16,2,1005042,99.91907390
3977,暸,日,16,2,1005044,99.91927274
3978,橢,木,16,2,1005046,99.91947157
3979,澹,水,16,2,1005048,99.91967041
3980,縈,糸,16,2,1005050,99.91986925
3981,縝,糸,16,2,1005052,99.92006808
3982,螞,虫,16,2,1005054,99.92026692
3983,諦,言,16,2,1005056,99.92046575
3984,諶,言,16,2,1005058,99.92066459
3985,踵,足,16,2,1005060,99.92086342
3986,遴,??,16,2,1005062,99.92106226
3987,錐,金,16,2,1005064,99.92126110
3988,錡,金,16,2,1005066,99.92145993
3989,黔,黑,16,2,1005068,99.92165877
3990,儡,人,17,2,1005070,99.92185760
3991,嚎,口,17,2,1005072,99.92205644
3992,壕,土,17,2,1005074,99.92225527
3993,擘,手,17,2,1005076,99.92245411
3994,擰,手,17,2,1005078,99.92265294
3995,曖,日,17,2,1005080,99.92285178
3996,氈,毛,17,2,1005082,99.92305062
3997,糞,米,17,2,1005084,99.92324945
3998,膺,肉,17,2,1005086,99.92344829
3999,薔,艸,17,2,1005088,99.92364712
4000,蟑,虫,17,2,1005090,99.92384596
4001,褻,衣,17,2,1005092,99.92404479
4002,謐,言,17,2,1005094,99.92424363
4003,鎂,金,17,2,1005096,99.92444246
4004,闌,門,17,2,1005098,99.92464130
4005,鴿,鳥,17,2,1005100,99.92484014
4006,齋,齊,17,2,1005102,99.92503897
4007,攆,手,18,2,1005104,99.92523781
4008,濺,水,18,2,1005106,99.92543664
4009,燻,火,18,2,1005108,99.92563548
4010,甕,瓦,18,2,1005110,99.92583431
4011,瞿,目,18,2,1005112,99.92603315
4012,穢,禾,18,2,1005114,99.92623199
4013,邃,??,18,2,1005116,99.92643082
4014,颺,風,18,2,1005118,99.92662966
4015,餿,食,18,2,1005120,99.92682849
4016,餽,食,18,2,1005122,99.92702733
4017,馥,香,18,2,1005124,99.92722616
4018,鯉,魚,18,2,1005126,99.92742500
4019,瀚,水,19,2,1005128,99.92762383
4020,瓣,瓜,19,2,1005130,99.92782267
4021,癟,??,19,2,1005132,99.92802151
4022,羹,羊,19,2,1005134,99.92822034
4023,蹼,足,19,2,1005136,99.92841918
4024,蹺,足,19,2,1005138,99.92861801
4025,蹴,足,19,2,1005140,99.92881685
4026,醮,酉,19,2,1005142,99.92901568
4027,鏘,金,19,2,1005144,99.92921452
4028,颼,風,19,2,1005146,99.92941336
4029,饅,食,19,2,1005148,99.92961219
4030,騖,馬,19,2,1005150,99.92981103
4031,鵲,鳥,19,2,1005152,99.93000986
4032,麓,鹿,19,2,1005154,99.93020870
4033,嚷,口,20,2,1005156,99.93040753
4034,孃,女,20,2,1005158,99.93060637
4035,礪,石,20,2,1005160,99.93080520
4036,竇,穴,20,2,1005162,99.93100404
4037,纂,糸,20,2,1005164,99.93120288
4038,蠔,虫,20,2,1005166,99.93140171
4039,蠕,虫,20,2,1005168,99.93160055
4040,蠡,虫,21,2,1005170,99.93179938
4041,髏,骨,21,2,1005172,99.93199822
4042,聾,耳,22,2,1005174,99.93219705
4043,鑒,金,22,2,1005176,99.93239589
4044,韁,革,22,2,1005178,99.93259473
4045,蠱,虫,23,2,1005180,99.93279356
4046,鬢,髟,24,2,1005182,99.93299240
4047,魘,鬼,24,2,1005184,99.93319123
4048,驪,馬,29,2,1005186,99.93339007
4049,忑,心,07,2,1005188,99.93358890
4050,忐,心,07,2,1005190,99.93378774
4051,忡,心,07,2,1005192,99.93398657
4052,扺,手,07,2,1005194,99.93418541
4053,邠,邑,07,2,1005196,99.93438425
4054,呤,口,08,2,1005198,99.93458308
4055,孢,子,08,2,1005200,99.93478192
4056,怦,心,08,2,1005202,99.93498075
4057,泙,水,08,2,1005204,99.93517959
4058,邰,邑,08,2,1005206,99.93537842
4059,埕,土,10,2,1005208,99.93557726
4060,悃,心,10,2,1005210,99.93577610
4061,珩,玉,10,2,1005212,99.93597493
4062,茼,艸,10,2,1005214,99.93617377
4063,啶,口,11,2,1005216,99.93637260
4064,堇,土,11,2,1005218,99.93657144
4065,婕,女,11,2,1005220,99.93677027
4066,据,手,11,2,1005222,99.93696911
4067,掟,手,11,2,1005224,99.93716794
4068,焗,火,11,2,1005226,99.93736678
4069,紺,糸,11,2,1005228,99.93756562
4070,袪,衣,11,2,1005230,99.93776445
4071,湳,水,12,2,1005232,99.93796329
4072,焢,火,12,2,1005234,99.93816212
4073,絜,糸,12,2,1005236,99.93836096
4074,鈦,金,12,2,1005238,99.93855979
4075,搢,手,13,2,1005240,99.93875863
4076,棰,木,13,2,1005242,99.93895747
4077,殛,歹,13,2,1005244,99.93915630
4078,煚,火,13,2,1005246,99.93935514
4079,翛,羽,13,2,1005248,99.93955397
4080,萩,艸,13,2,1005250,99.93975281
4081,豊,豆,13,2,1005252,99.93995164
4082,酮,酉,13,2,1005254,99.94015048
4083,靳,革,13,2,1005256,99.94034931
4084,嘧,口,14,2,1005258,99.94054815
4085,嘌,口,14,2,1005260,99.94074699
4086,墉,土,14,2,1005262,99.94094582
4087,暟,日,14,2,1005264,99.94114466
4088,粼,米,14,2,1005266,99.94134349
4089,綹,糸,14,2,1005268,99.94154233
4090,裱,衣,14,2,1005270,99.94174116
4091,噁,口,15,2,1005272,99.94194000
4092,撣,手,15,2,1005274,99.94213883
4093,璉,玉,15,2,1005276,99.94233767
4094,圜,囗,16,2,1005278,99.94253651
4095,璠,玉,16,2,1005280,99.94273534
4096,糗,米,16,2,1005282,99.94293418
4097,醐,酉,16,2,1005284,99.94313301
4098,醍,酉,16,2,1005286,99.94333185
4099,鍺,金,16,2,1005288,99.94353068
4100,錸,金,16,2,1005290,99.94372952
4101,癇,??,17,2,1005292,99.94392836
4102,褵,衣,17,2,1005294,99.94412719
4103,瀦,水,18,2,1005296,99.94432603
4104,謾,言,18,2,1005298,99.94452486
4105,蹧,足,18,2,1005300,99.94472370
4106,醯,酉,18,2,1005302,99.94492253
4107,鯓,魚,18,2,1005304,99.94512137
4108,鏞,金,19,2,1005306,99.94532020
4109,鎩,金,19,2,1005308,99.94551904
4110,顗,頁,19,2,1005310,99.94571788
4111,鰈,魚,20,2,1005312,99.94591671
4112,讞,言,27,2,1005314,99.94611555
4113,(?W),手,17,2,1005316,99.94631438
4114,(?w),木,08,2,1005318,99.94651322
4115,(?f),山,10,2,1005320,99.94671205
4116,??,肉,08,2,1005322,99.94691089
4117,??,手,16,1,1005323,99.94701031
4118,?k,口,10,1,1005324,99.94710973
4119,(??),土,12,1,1005325,99.94720914
4120,(?C),麥,17,1,1005326,99.94730856
4121,??,身,13,1,1005327,99.94740798
4122,??,火,12,1,1005328,99.94750740
4123,??,口,06,1,1005329,99.94760681
4124,丫,｜,03,1,1005330,99.94770623
4125,弋,弋,03,1,1005331,99.94780565
4126,叻,口,05,1,1005332,99.94790507
4127,丞,一,06,1,1005333,99.94800449
4128,乒,??,06,1,1005334,99.94810390
4129,乓,??,06,1,1005335,99.94820332
4130,乩,乙,06,1,1005336,99.94830274
4131,伋,人,06,1,1005337,99.94840216
4132,匡,匚,06,1,1005338,99.94850157
4133,囝,囗,06,1,1005339,99.94860099
4134,夙,夕,06,1,1005340,99.94870041
4135,并,干,06,1,1005341,99.94879983
4136,舛,舛,06,1,1005342,99.94889925
4137,虫,虫,06,1,1005343,99.94899866
4138,佞,人,07,1,1005344,99.94909808
4139,佃,人,07,1,1005345,99.94919750
4140,佝,人,07,1,1005346,99.94929692
4141,佚,人,07,1,1005347,99.94939634
4142,冶,??,07,1,1005348,99.94949575
4143,囪,囗,07,1,1005349,99.94959517
4144,妣,女,07,1,1005350,99.94969459
4145,岑,山,07,1,1005351,99.94979401
4146,忸,心,07,1,1005352,99.94989342
4147,忪,心,07,1,1005353,99.94999284
4148,杓,木,07,1,1005354,99.95009226
4149,沂,水,07,1,1005355,99.95019168
4150,甸,田,07,1,1005356,99.95029110
4151,肓,肉,07,1,1005357,99.95039051
4152,芍,艸,07,1,1005358,99.95048993
4153,邢,邑,07,1,1005359,99.95058935
4154,侖,人,08,1,1005360,99.95068877
4155,兔,儿,08,1,1005361,99.95078818
4156,咕,口,08,1,1005362,99.95088760
4157,呷,口,08,1,1005363,99.95098702
4158,坷,土,08,1,1005364,99.95108644
4159,妾,女,08,1,1005365,99.95118586
4160,庖,??,08,1,1005366,99.95128527
4161,忝,心,08,1,1005367,99.95138469
4162,忿,心,08,1,1005368,99.95148411
4163,怩,心,08,1,1005369,99.95158353
4164,戕,戈,08,1,1005370,99.95168294
4165,拗,手,08,1,1005371,99.95178236
4166,拎,手,08,1,1005372,99.95188178
4167,氓,氏,08,1,1005373,99.95198120
4168,沽,水,08,1,1005374,99.95208062
4169,泠,水,08,1,1005375,99.95218003
4170,炕,火,08,1,1005376,99.95227945
4171,玟,玉,08,1,1005377,99.95237887
4172,疙,??,08,1,1005378,99.95247829
4173,穹,穴,08,1,1005379,99.95257770
4174,芥,艸,08,1,1005380,99.95267712
4175,芯,艸,08,1,1005381,99.95277654
4176,芾,艸,08,1,1005382,99.95287596
4177,虱,虫,08,1,1005383,99.95297538
4178,俚,人,09,1,1005384,99.95307479
4179,哎,口,09,1,1005385,99.95317421
4180,垠,土,09,1,1005386,99.95327363
4181,奐,大,09,1,1005387,99.95337305
4182,徇,彳,09,1,1005388,99.95347247
4183,牴,牛,09,1,1005389,99.95357188
4184,玷,玉,09,1,1005390,99.95367130
4185,癸,??,09,1,1005391,99.95377072
4186,皈,白,09,1,1005392,99.95387014
4187,紉,糸,09,1,1005393,99.95396955
4188,胛,肉,09,1,1005394,99.95406897
4189,胤,肉,09,1,1005395,99.95416839
4190,舢,舟,09,1,1005396,99.95426781
4191,苣,艸,09,1,1005397,99.95436723
4192,苜,艸,09,1,1005398,99.95446664
4193,苞,艸,09,1,1005399,99.95456606
4194,訃,言,09,1,1005400,99.95466548
4195,迤,??,09,1,1005401,99.95476490
4196,酋,酉,09,1,1005402,99.95486431
4197,閂,門,09,1,1005403,99.95496373
4198,倣,人,10,1,1005404,99.95506315
4199,倨,人,10,1,1005405,99.95516257
4200,唧,口,10,1,1005406,99.95526199
4201,圄,囗,10,1,1005407,99.95536140
4202,娑,女,10,1,1005408,99.95546082
4203,娩,女,10,1,1005409,99.95556024
4204,屘,子,10,1,1005410,99.95565966
4205,屐,尸,10,1,1005411,99.95575907
4206,峪,山,10,1,1005412,99.95585849
4207,峨,山,10,1,1005413,99.95595791
4208,捌,手,10,1,1005414,99.95605733
4209,敉,米,10,1,1005415,99.95615675
4210,晏,日,10,1,1005416,99.95625616
4211,桔,木,10,1,1005417,99.95635558
4212,殉,歹,10,1,1005418,99.95645500
4213,涕,水,10,1,1005419,99.95655442
4214,畚,田,10,1,1005420,99.95665384
4215,砭,石,10,1,1005421,99.95675325
4216,祐,示,10,1,1005422,99.95685267
4217,祠,示,10,1,1005423,99.95695209
4218,祚,示,10,1,1005424,99.95705151
4219,紜,糸,10,1,1005425,99.95715092
4220,羔,羊,10,1,1005426,99.95725034
4221,耙,耒,10,1,1005427,99.95734976
4222,胳,肉,10,1,1005428,99.95744918
4223,舐,舌,10,1,1005429,99.95754860
4224,舨,舟,10,1,1005430,99.95764801
4225,茗,艸,10,1,1005431,99.95774743
4226,蚌,虫,10,1,1005432,99.95784685
4227,蚣,虫,10,1,1005433,99.95794627
4228,袂,衣,10,1,1005434,99.95804568
4229,衹,衣,10,1,1005435,99.95814510
4230,迺,??,10,1,1005436,99.95824452
4231,逅,??,10,1,1005437,99.95834394
4232,迸,??,10,1,1005438,99.95844336
4233,偎,人,11,1,1005439,99.95854277
4234,倏,人,11,1,1005440,99.95864219
4235,匏,??,11,1,1005441,99.95874161
4236,啖,口,11,1,1005442,99.95884103
4237,啜,口,11,1,1005443,99.95894044
4238,唳,口,11,1,1005444,99.95903986
4239,寅,??,11,1,1005445,99.95913928
4240,崢,山,11,1,1005446,99.95923870
4241,庶,??,11,1,1005447,99.95933812
4242,徜,彳,11,1,1005448,99.95943753
4243,悴,心,11,1,1005449,99.95953695
4244,惦,心,11,1,1005450,99.95963637
4245,惇,心,11,1,1005451,99.95973579
4246,捱,手,11,1,1005452,99.95983521
4247,掬,手,11,1,1005453,99.95993462
4248,旎,方,11,1,1005454,99.96003404
4249,梟,木,11,1,1005455,99.96013346
4250,淌,水,11,1,1005456,99.96023288
4251,淞,水,11,1,1005457,99.96033229
4252,涸,水,11,1,1005458,99.96043171
4253,猙,犬,11,1,1005459,99.96053113
4254,畦,田,11,1,1005460,99.96063055
4255,皎,白,11,1,1005461,99.96072997
4256,笙,竹,11,1,1005462,99.96082938
4257,絃,糸,11,1,1005463,99.96092880
4258,缽,缶,11,1,1005464,99.96102822
4259,莆,艸,11,1,1005465,99.96112764
4260,莧,艸,11,1,1005466,99.96122705
4261,彪,虍,11,1,1005467,99.96132647
4262,蚵,虫,11,1,1005468,99.96142589
4263,訥,言,11,1,1005469,99.96152531
4264,訛,言,11,1,1005470,99.96162473
4265,赧,赤,11,1,1005471,99.96172414
4266,趺,足,11,1,1005472,99.96182356
4267,釵,金,11,1,1005473,99.96192298
4268,釦,金,11,1,1005474,99.96202240
4269,剴,刀,11,1,1005475,99.96212181
4270,喙,口,12,1,1005476,99.96222123
4271,堰,土,12,1,1005477,99.96232065
4272,寐,??,12,1,1005478,99.96242007
4273,弼,弓,12,1,1005479,99.96251949
4274,徨,彳,12,1,1005480,99.96261890
4275,惺,心,12,1,1005481,99.96271832
4276,愒,心,12,1,1005482,99.96281774
4277,棠,木,12,1,1005483,99.96291716
4278,氬,气,12,1,1005484,99.96301657
4279,渭,水,12,1,1005485,99.96311599
4280,湎,水,12,1,1005486,99.96321541
4281,甥,生,12,1,1005487,99.96331483
4282,皴,皮,12,1,1005488,99.96341425
4283,睏,目,12,1,1005489,99.96351366
4284,筐,竹,12,1,1005490,99.96361308
4285,腑,肉,12,1,1005491,99.96371250
4286,蛟,虫,12,1,1005492,99.96381192
4287,詔,言,12,1,1005493,99.96391134
4288,詛,言,12,1,1005494,99.96401075
4289,詆,言,12,1,1005495,99.96411017
4290,貳,貝,12,1,1005496,99.96420959
4291,跎,足,12,1,1005497,99.96430901
4292,軼,車,12,1,1005498,99.96440842
4293,閏,門,12,1,1005499,99.96450784
4294,飩,食,12,1,1005500,99.96460726
4295,嗟,口,13,1,1005501,99.96470668
4296,嗨,口,13,1,1005502,99.96480610
4297,嗇,口,13,1,1005503,99.96490551
4298,嗣,口,13,1,1005504,99.96500493
4299,嗡,口,13,1,1005505,99.96510435
4300,嗥,口,13,1,1005506,99.96520377
4301,徬,彳,13,1,1005507,99.96530318
4302,愾,心,13,1,1005508,99.96540260
4303,愴,心,13,1,1005509,99.96550202
4304,愷,心,13,1,1005510,99.96560144
4305,搆,手,13,1,1005511,99.96570086
4306,楹,木,13,1,1005512,99.96580027
4307,滓,水,13,1,1005513,99.96589969
4308,滇,水,13,1,1005514,99.96599911
4309,煬,火,13,1,1005515,99.96609853
4310,煨,火,13,1,1005516,99.96619794
4311,牒,片,13,1,1005517,99.96629736
4312,瑙,玉,13,1,1005518,99.96639678
4313,痱,??,13,1,1005519,99.96649620
4314,痿,??,13,1,1005520,99.96659562
4315,粵,米,13,1,1005521,99.96669503
4316,絹,糸,13,1,1005522,99.96679445
4317,肄,聿,13,1,1005523,99.96689387
4318,萱,艸,13,1,1005524,99.96699329
4319,葫,艸,13,1,1005525,99.96709271
4320,萵,艸,13,1,1005526,99.96719212
4321,虜,虍,13,1,1005527,99.96729154
4322,蜈,虫,13,1,1005528,99.96739096
4323,衙,行,13,1,1005529,99.96749038
4324,詣,言,13,1,1005530,99.96758979
4325,誅,言,13,1,1005531,99.96768921
4326,訾,言,13,1,1005532,99.96778863
4327,貉,豸,13,1,1005533,99.96788805
4328,賅,貝,13,1,1005534,99.96798747
4329,軾,車,13,1,1005535,99.96808688
4330,鉋,金,13,1,1005536,99.96818630
4331,鉑,金,13,1,1005537,99.96828572
4332,鉚,金,13,1,1005538,99.96838514
4333,閘,門,13,1,1005539,99.96848455
4334,雋,隹,13,1,1005540,99.96858397
4335,僮,人,14,1,1005541,99.96868339
4336,僥,人,14,1,1005542,99.96878281
4337,嘎,口,14,1,1005543,99.96888223
4338,幔,巾,14,1,1005544,99.96898164
4339,彆,弓,14,1,1005545,99.96908106
4340,慚,心,14,1,1005546,99.96918048
4341,慵,心,14,1,1005547,99.96927990
4342,摟,手,14,1,1005548,99.96937931
4343,摑,手,14,1,1005549,99.96947873
4344,旖,方,14,1,1005550,99.96957815
4345,瘧,??,14,1,1005551,99.96967757
4346,箕,竹,14,1,1005552,99.96977699
4347,筵,竹,14,1,1005553,99.96987640
4348,粽,米,14,1,1005554,99.96997582
4349,綾,糸,14,1,1005555,99.97007524
4350,綬,糸,14,1,1005556,99.97017466
4351,膊,肉,14,1,1005557,99.97027408
4352,臧,臣,14,1,1005558,99.97037349
4353,褂,衣,14,1,1005559,99.97047291
4354,誣,言,14,1,1005560,99.97057233
4355,誚,言,14,1,1005561,99.97067175
4356,遢,??,14,1,1005562,99.97077116
4357,閡,門,14,1,1005563,99.97087058
4358,閤,門,14,1,1005564,99.97097000
4359,靼,革,14,1,1005565,99.97106942
4360,餌,食,14,1,1005566,99.97116884
4361,鳶,鳥,14,1,1005567,99.97126825
4362,儈,人,15,1,1005568,99.97136767
4363,嘮,口,15,1,1005569,99.97146709
4364,噎,口,15,1,1005570,99.97156651
4365,噗,口,15,1,1005571,99.97166592
4366,嬈,女,15,1,1005572,99.97176534
4367,嶔,山,15,1,1005573,99.97186476
4368,幡,巾,15,1,1005574,99.97196418
4369,憔,心,15,1,1005575,99.97206360
4370,撬,手,15,1,1005576,99.97216301
4371,撙,手,15,1,1005577,99.97226243
4372,暱,日,15,1,1005578,99.97236185
4373,槳,木,15,1,1005579,99.97246127
4374,潦,水,15,1,1005580,99.97256068
4375,潸,水,15,1,1005581,99.97266010
4376,澗,水,15,1,1005582,99.97275952
4377,瑾,玉,15,1,1005583,99.97285894
4378,瘩,??,15,1,1005584,99.97295836
4379,磐,石,15,1,1005585,99.97305777
4380,稼,禾,15,1,1005586,99.97315719
4381,緹,糸,15,1,1005587,99.97325661
4382,耦,耒,15,1,1005588,99.97335603
4383,蓿,艸,15,1,1005589,99.97345544
4384,蝗,虫,15,1,1005590,99.97355486
4385,誹,言,15,1,1005591,99.97365428
4386,踡,足,15,1,1005592,99.97375370
4387,鄱,邑,15,1,1005593,99.97385312
4388,鋤,金,15,1,1005594,99.97395253
4389,霄,雨,15,1,1005595,99.97405195
4390,頡,頁,15,1,1005596,99.97415137
4391,頫,頁,15,1,1005597,99.97425079
4392,颳,風,15,1,1005598,99.97435021
4393,噥,口,16,1,1005599,99.97444962
4394,噢,口,16,1,1005600,99.97454904
4395,擂,手,16,1,1005601,99.97464846
4396,樽,木,16,1,1005602,99.97474788
4397,澠,水,16,1,1005603,99.97484729
4398,熹,火,16,1,1005604,99.97494671
4399,燄,火,16,1,1005605,99.97504613
4400,瓢,瓜,16,1,1005606,99.97514555
4401,甌,瓦,16,1,1005607,99.97524497
4402,瘸,??,16,1,1005608,99.97534438
4403,磬,石,16,1,1005609,99.97544380
4404,磧,石,16,1,1005610,99.97554322
4405,篡,竹,16,1,1005611,99.97564264
4406,縊,糸,16,1,1005612,99.97574205
4407,翱,羽,16,1,1005613,99.97584147
4408,覦,見,16,1,1005614,99.97594089
4409,諭,言,16,1,1005615,99.97604031
4410,閻,門,16,1,1005616,99.97613973
4411,霎,雨,16,1,1005617,99.97623914
4412,靛,青,16,1,1005618,99.97633856
4413,餞,食,16,1,1005619,99.97643798
4414,餛,食,16,1,1005620,99.97653740
4415,嚏,口,17,1,1005621,99.97663681
4416,屨,尸,17,1,1005622,99.97673623
4417,嶸,山,17,1,1005623,99.97683565
4418,懦,心,17,1,1005624,99.97693507
4419,擢,手,17,1,1005625,99.97703449
4420,檀,木,17,1,1005626,99.97713390
4421,檠,木,17,1,1005627,99.97723332
4422,燴,火,17,1,1005628,99.97733274
4423,燠,火,17,1,1005629,99.97743216
4424,獰,犬,17,1,1005630,99.97753158
4425,磺,石,17,1,1005631,99.97763099
4426,窿,穴,17,1,1005632,99.97773041
4427,簍,竹,17,1,1005633,99.97782983
4428,繆,糸,17,1,1005634,99.97792925
4429,縹,糸,17,1,1005635,99.97802866
4430,縯,糸,17,1,1005636,99.97812808
4431,罄,缶,17,1,1005637,99.97822750
4432,螳,虫,17,1,1005638,99.97832692
4433,褸,衣,17,1,1005639,99.97842634
4434,覬,見,17,1,1005640,99.97852575
4435,蹉,足,17,1,1005641,99.97862517
4436,蹊,足,17,1,1005642,99.97872459
4437,邂,??,17,1,1005643,99.97882401
4438,錘,金,17,1,1005644,99.97892342
4439,鍚,金,17,1,1005645,99.97902284
4440,闈,門,17,1,1005646,99.97912226
4441,鮪,魚,17,1,1005647,99.97922168
4442,鼾,鼻,17,1,1005648,99.97932110
4443,擻,手,18,1,1005649,99.97942051
4444,璿,玉,18,1,1005650,99.97951993
4445,瞽,目,18,1,1005651,99.97961935
4446,瞼,目,18,1,1005652,99.97971877
4447,繒,糸,18,1,1005653,99.97981818
4448,聶,耳,18,1,1005654,99.97991760
4449,薺,艸,18,1,1005655,99.98001702
4450,蟠,虫,18,1,1005656,99.98011644
4451,謨,言,18,1,1005657,99.98021586
4452,蹕,足,18,1,1005658,99.98031527
4453,邈,??,18,1,1005659,99.98041469
4454,鎚,金,18,1,1005660,99.98051411
4455,鵑,鳥,18,1,1005661,99.98061353
4456,廬,??,19,1,1005662,99.98071294
4457,繭,糸,19,1,1005663,99.98081236
4458,襠,衣,19,1,1005664,99.98091178
4459,蹬,足,19,1,1005665,99.98101120
4460,邋,??,19,1,1005666,99.98111062
4461,醱,酉,19,1,1005667,99.98121003
4462,鏜,金,19,1,1005668,99.98130945
4463,鏖,金,19,1,1005669,99.98140887
4464,鏤,金,19,1,1005670,99.98150829
4465,鯛,魚,19,1,1005671,99.98160771
4466,鶉,鳥,19,1,1005672,99.98170712
4467,孽,子,20,1,1005673,99.98180654
4468,攙,手,20,1,1005674,99.98190596
4469,礬,石,20,1,1005675,99.98200538
4470,糯,米,20,1,1005676,99.98210479
4471,襤,衣,20,1,1005677,99.98220421
4472,譟,言,20,1,1005678,99.98230363
4473,躅,足,20,1,1005679,99.98240305
4474,饑,食,20,1,1005680,99.98250247
4475,囀,口,21,1,1005681,99.98260188
4476,巍,山,21,1,1005682,99.98270130
4477,矓,目,21,1,1005683,99.98280072
4478,鐮,金,21,1,1005684,99.98290014
4479,鐺,金,21,1,1005685,99.98299955
4480,驀,馬,21,1,1005686,99.98309897
4481,騾,馬,21,1,1005687,99.98319839
4482,鰥,魚,21,1,1005688,99.98329781
4483,巔,山,22,1,1005689,99.98339723
4484,籟,竹,22,1,1005690,99.98349664
4485,躑,足,22,1,1005691,99.98359606
4486,韃,革,22,1,1005692,99.98369548
4487,龔,龍,22,1,1005693,99.98379490
4488,鑣,金,23,1,1005694,99.98389431
4489,靨,面,23,1,1005695,99.98399373
4490,驛,馬,23,1,1005696,99.98409315
4491,鷥,鳥,23,1,1005697,99.98419257
4492,蠶,虫,24,1,1005698,99.98429199
4493,衢,行,24,1,1005699,99.98439140
4494,贛,貝,24,1,1005700,99.98449082
4495,顰,頁,24,1,1005701,99.98459024
4496,籮,竹,25,1,1005702,99.98468966
4497,饞,食,25,1,1005703,99.98478908
4498,驥,馬,26,1,1005704,99.98488849
4499,鑾,金,27,1,1005705,99.98498791
4500,鸚,鳥,28,1,1005706,99.98508733
4501,鸛,鳥,29,1,1005707,99.98518675
4502,鸞,鳥,30,1,1005708,99.98528616
4503,兀,儿,03,1,1005709,99.98538558
4504,仝,人,05,1,1005710,99.98548500
4505,卍,十,05,1,1005711,99.98558442
4506,屺,山,06,1,1005712,99.98568384
4507,(体),人,07,1,1005713,99.98578325
4508,佤,人,07,1,1005714,99.98588267
4509,忤,心,07,1,1005715,99.98598209
4510,玒,玉,07,1,1005716,99.98608151
4511,冾,??,08,1,1005717,99.98618092
4512,囹,囗,08,1,1005718,99.98628034
4513,坨,土,08,1,1005719,99.98637976
4514,宕,??,08,1,1005720,99.98647918
4515,沓,水,08,1,1005721,99.98657860
4516,泮,水,08,1,1005722,99.98667801
4517,泂,水,08,1,1005723,99.98677743
4518,炅,火,08,1,1005724,99.98687685
4519,畀,田,08,1,1005725,99.98697627
4520,矸,石,08,1,1005726,99.98707568
4521,厘,厂,09,1,1005727,99.98717510
4522,茍,口,09,1,1005728,99.98727452
4523,峋,山,09,1,1005729,99.98737394
4524,峇,山,09,1,1005730,99.98747336
4525,昶,日,09,1,1005731,99.98757277
4526,洄,水,09,1,1005732,99.98767219
4527,胜,肉,09,1,1005733,99.98777161
4528,茌,艸,09,1,1005734,99.98787103
4529,苳,艸,09,1,1005735,99.98797045
4530,唄,口,10,1,1005736,99.98806986
4531,悒,心,10,1,1005737,99.98816928
4532,旂,方,10,1,1005738,99.98826870
4533,栴,木,10,1,1005739,99.98836812
4534,荖,艸,10,1,1005740,99.98846753
4535,訒,言,10,1,1005741,99.98856695
4536,隼,隹,10,1,1005742,99.98866637
4537,匭,匚,11,1,1005743,99.98876579
4538,堀,土,11,1,1005744,99.98886521
4539,悱,心,11,1,1005745,99.98896462
4540,掐,手,11,1,1005746,99.98906404
4541,掮,手,11,1,1005747,99.98916346
4542,欸,欠,11,1,1005748,99.98926288
4543,烴,火,11,1,1005749,99.98936229
4544,珺,玉,11,1,1005750,99.98946171
4545,硒,石,11,1,1005751,99.98956113
4546,翊,羽,11,1,1005752,99.98966055
4547,荾,艸,11,1,1005753,99.98975997
4548,袛,衣,11,1,1005754,99.98985938
4549,趿,足,11,1,1005755,99.98995880
4550,酚,酉,11,1,1005756,99.99005822
4551,釹,金,11,1,1005757,99.99015764
4552,喑,口,12,1,1005758,99.99025705
4553,啷,口,12,1,1005759,99.99035647
4554,埵,土,12,1,1005760,99.99045589
4555,幄,巾,12,1,1005761,99.99055531
4556,棱,木,12,1,1005762,99.99065473
4557,棽,木,12,1,1005763,99.99075414
4558,琡,玉,12,1,1005764,99.99085356
4559,稊,禾,12,1,1005765,99.99095298
4560,筊,竹,12,1,1005766,99.99105240
4561,萣,艸,12,1,1005767,99.99115181
4562,逭,??,12,1,1005768,99.99125123
4563,僂,人,13,1,1005769,99.99135065
4564,嗔,口,13,1,1005770,99.99145007
4565,嗲,口,13,1,1005771,99.99154949
4566,愫,心,13,1,1005772,99.99164890
4567,搥,手,13,1,1005773,99.99174832
4568,椿,木,13,1,1005774,99.99184774
4569,椹,木,13,1,1005775,99.99194716
4570,煇,火,13,1,1005776,99.99204658
4571,瑄,玉,13,1,1005777,99.99214599
4572,皙,白,13,1,1005778,99.99224541
4573,艉,舟,13,1,1005779,99.99234483
4574,詡,言,13,1,1005780,99.99244425
4575,鉈,金,13,1,1005781,99.99254366
4576,鉞,金,13,1,1005782,99.99264308
4577,摜,手,14,1,1005783,99.99274250
4578,殞,歹,14,1,1005784,99.99284192
4579,綣,糸,14,1,1005785,99.99294134
4580,緋,糸,14,1,1005786,99.99304075
4581,蓍,艸,14,1,1005787,99.99314017
4582,蒨,艸,14,1,1005788,99.99323959
4583,蜚,虫,14,1,1005789,99.99333901
4584,裶,衣,14,1,1005790,99.99343842
4585,銥,金,14,1,1005791,99.99353784
4586,嶙,山,15,1,1005792,99.99363726
4587,憋,心,15,1,1005793,99.99373668
4588,斲,斤,15,1,1005794,99.99383610
4589,槴,木,15,1,1005795,99.99393551
4590,獛,犬,15,1,1005796,99.99403493
4591,璇,玉,15,1,1005797,99.99413435
4592,窳,穴,15,1,1005798,99.99423377
4593,翦,羽,15,1,1005799,99.99433318
4594,艏,舟,15,1,1005800,99.99443260
4595,蔻,艸,15,1,1005801,99.99453202
4596,踦,足,15,1,1005802,99.99463144
4597,醂,酉,15,1,1005803,99.99473086
4598,鋃,金,15,1,1005804,99.99483027
4599,樻,木,16,1,1005805,99.99492969
4600,潞,水,16,1,1005806,99.99502911
4601,燔,火,16,1,1005807,99.99512853
4602,蕖,艸,16,1,1005808,99.99522795
4603,諴,言,16,1,1005809,99.99532736
4604,麈,鹿,16,1,1005810,99.99542678
4605,歛,欠,17,1,1005811,99.99552620
4606,璫,玉,17,1,1005812,99.99562562
4607,穖,禾,17,1,1005813,99.99572503
4608,篳,竹,17,1,1005814,99.99582445
4609,蕷,艸,17,1,1005815,99.99592387
4610,薝,艸,17,1,1005816,99.99602329
4611,薈,艸,17,1,1005817,99.99612271
4612,醛,酉,17,1,1005818,99.99622212
4613,鎯,金,17,1,1005819,99.99632154
4614,闇,門,17,1,1005820,99.99642096
4615,闃,門,17,1,1005821,99.99652038
4616,餬,食,17,1,1005822,99.99661979
4617,擸,手,18,1,1005823,99.99671921
4618,瀅,水,18,1,1005824,99.99681863
4619,燹,火,18,1,1005825,99.99691805
4620,繖,糸,18,1,1005826,99.99701747
4621,轆,車,18,1,1005827,99.99711688
4622,鎣,金,18,1,1005828,99.99721630
4623,鬈,髟,18,1,1005829,99.99731572
4624,鬩,鬥,18,1,1005830,99.99741514
4625,嬿,女,19,1,1005831,99.99751455
4626,瀣,水,19,1,1005832,99.99761397
4627,鯰,魚,19,1,1005833,99.99771339
4628,矌,目,20,1,1005834,99.99781281
4629,繾,糸,20,1,1005835,99.99791223
4630,譭,言,20,1,1005836,99.99801164
4631,鶩,鳥,20,1,1005837,99.99811106
4632,衊,血,21,1,1005838,99.99821048
4633,鰤,魚,21,1,1005839,99.99830990
4634,黮,黑,21,1,1005840,99.99840932
4635,孌,女,22,1,1005841,99.99850873
4636,欉,木,22,1,1005842,99.99860815
4637,灒,水,22,1,1005843,99.99870757
4638,艫,舟,22,1,1005844,99.99880699
4639,鱈,魚,22,1,1005845,99.99890640
4640,欒,木,23,1,1005846,99.99900582
4641,轤,車,23,1,1005847,99.99910524
4642,鷴,鳥,23,1,1005848,99.99920466
4643,灠,水,24,1,1005849,99.99930408
4644,臠,肉,25,1,1005850,99.99940349
4645,顴,頁,27,1,1005851,99.99950291
4646,(??),黽,24,1,1005852,99.99960233
4647,(?\),手,12,1,1005853,99.99970175
4648,(?|),穴,21,1,1005854,99.99980116
4649,??,酉,14,1,1005855,99.99990058
4650,(??),??,16,1,1005856,100.00000000
